705130,True,0,No user reviews,0,0,0
705140,True,0,No user reviews,0,0,0
705150,True,0,3 user reviews,1,2,3
705160,True,5,Mixed,5,5,10
705170,True,0,No user reviews,0,0,0
705200,True,0,No user reviews,0,0,0
705210,True,0,2 user reviews,1,1,2
705220,True,0,No user reviews,0,0,0
705230,True,0,3 user reviews,1,2,3
705240,True,0,2 user reviews,1,1,2
705250,True,6,Mostly Positive,10,3,13
705260,True,0,1 user reviews,1,0,1
705280,True,8,Very Positive,127,25,152
705290,True,8,Very Positive,90,18,108
705300,True,5,Mixed,11,12,23
705340,True,7,Positive,12,2,14
705360,True,0,No user reviews,0,0,0
705370,True,0,No user reviews,0,0,0
705380,True,6,Mostly Positive,9,3,12
705390,True,5,Mixed,6,6,12
705410,True,0,No user reviews,0,0,0
705440,True,0,3 user reviews,2,1,3
705450,True,7,Positive,28,5,33
705500,True,7,Positive,19,1,20
705520,True,0,1 user reviews,0,1,1
705530,True,0,4 user reviews,4,0,4
705540,True,0,2 user reviews,1,1,2
705550,True,7,Positive,12,2,14
705560,True,0,1 user reviews,1,0,1
705570,True,0,No user reviews,0,0,0
705580,True,0,No user reviews,0,0,0
705590,True,0,No user reviews,0,0,0
705610,True,6,Mostly Positive,20,6,26
705620,True,7,Positive,12,3,15
705640,True,5,Mixed,6,4,10
705670,True,7,Positive,12,1,13
705700,True,0,8 user reviews,4,4,8
705710,True,4,Mostly Negative,11,34,45
705720,True,0,No user reviews,0,0,0
705740,True,5,Mixed,20,11,31
705750,True,7,Positive,33,4,37
705770,True,0,3 user reviews,3,0,3
705780,True,0,4 user reviews,4,0,4
705800,True,0,3 user reviews,2,1,3
705810,True,0,No user reviews,0,0,0
705830,True,0,No user reviews,0,0,0
705850,True,0,No user reviews,0,0,0
705860,True,0,No user reviews,0,0,0
705870,True,7,Positive,42,5,47
705880,True,0,No user reviews,0,0,0
705900,True,0,No user reviews,0,0,0
705920,True,0,1 user reviews,1,0,1
705930,True,0,1 user reviews,0,1,1
705950,True,0,2 user reviews,1,1,2
705980,True,0,No user reviews,0,0,0
705990,True,0,No user reviews,0,0,0
706000,True,0,No user reviews,0,0,0
706010,True,0,2 user reviews,0,2,2
706020,True,5,Mixed,266,139,405
706030,True,0,8 user reviews,6,2,8
706060,True,0,4 user reviews,1,3,4
706070,True,0,1 user reviews,0,1,1
706080,True,0,4 user reviews,0,4,4
706090,True,0,4 user reviews,4,0,4
706100,True,0,1 user reviews,1,0,1
706110,True,0,1 user reviews,1,0,1
706120,True,0,No user reviews,0,0,0
706121,True,0,No user reviews,0,0,0
706122,True,0,No user reviews,0,0,0
706130,True,7,Positive,44,5,49
706140,True,0,No user reviews,0,0,0
706150,True,0,No user reviews,0,0,0
706180,True,0,8 user reviews,1,7,8
706200,True,0,2 user reviews,1,1,2
706210,True,0,No user reviews,0,0,0
706220,True,6,Mostly Positive,13342,5202,18544
706230,True,0,6 user reviews,4,2,6
706240,True,0,4 user reviews,3,1,4
706260,True,5,Mixed,9,6,15
706261,True,0,2 user reviews,2,0,2
706262,True,0,No user reviews,0,0,0
706270,True,0,No user reviews,0,0,0
706280,True,7,Positive,15,2,17
706290,True,0,1 user reviews,0,1,1
706310,True,0,No user reviews,0,0,0
706320,True,5,Mixed,7,9,16
706330,True,0,9 user reviews,5,4,9
706350,True,0,2 user reviews,1,1,2
706360,True,0,No user reviews,0,0,0
706370,True,0,6 user reviews,5,1,6
706380,True,0,1 user reviews,1,0,1
706390,True,0,8 user reviews,7,1,8
706400,True,0,3 user reviews,3,0,3
706440,True,5,Mixed,9,5,14
706450,True,0,8 user reviews,6,2,8
706480,True,0,No user reviews,0,0,0
706490,True,5,Mixed,43,29,72
706510,True,0,8 user reviews,8,0,8
706520,True,5,Mixed,15,8,23
706550,True,0,No user reviews,0,0,0
706560,True,8,Very Positive,218,13,231
706570,True,0,5 user reviews,3,2,5
706580,True,0,3 user reviews,3,0,3
706590,True,0,No user reviews,0,0,0
706600,True,0,No user reviews,0,0,0
706620,True,0,No user reviews,0,0,0
706650,True,0,No user reviews,0,0,0
706660,True,0,No user reviews,0,0,0
706680,True,0,No user reviews,0,0,0
706690,True,0,1 user reviews,0,1,1
706700,True,0,No user reviews,0,0,0
706710,True,7,Positive,15,2,17
706770,True,7,Positive,19,1,20
706780,True,0,No user reviews,0,0,0
706800,True,0,No user reviews,0,0,0
706830,True,0,No user reviews,0,0,0
706850,True,7,Positive,16,0,16
706860,True,0,No user reviews,0,0,0
706870,True,0,3 user reviews,3,0,3
706880,True,6,Mostly Positive,11,4,15
706910,True,0,1 user reviews,1,0,1
706920,True,0,No user reviews,0,0,0
706950,True,0,6 user reviews,2,4,6
706960,True,6,Mostly Positive,18,6,24
706970,True,0,No user reviews,0,0,0
706980,True,0,No user reviews,0,0,0
706990,True,0,No user reviews,0,0,0
707000,True,0,4 user reviews,1,3,4
707010,True,6,Mostly Positive,457,195,652
707030,True,8,Very Positive,2406,273,2679
707040,True,0,1 user reviews,0,1,1
707060,True,0,9 user reviews,3,6,9
707070,True,0,No user reviews,0,0,0
707080,True,5,Mixed,7,6,13
707090,True,0,No user reviews,0,0,0
707100,True,0,No user reviews,0,0,0
707110,True,7,Positive,15,2,17
707140,True,0,9 user reviews,1,8,9
707160,True,0,No user reviews,0,0,0
707170,True,0,No user reviews,0,0,0
707172,True,0,1 user reviews,0,1,1
707173,True,0,1 user reviews,0,1,1
707174,True,0,1 user reviews,0,1,1
707175,True,0,1 user reviews,0,1,1
707176,True,0,1 user reviews,0,1,1
707177,True,0,1 user reviews,0,1,1
707178,True,0,1 user reviews,0,1,1
707179,True,0,1 user reviews,0,1,1
707180,True,0,1 user reviews,0,1,1
707181,True,0,2 user reviews,1,1,2
707182,True,0,2 user reviews,1,1,2
707183,True,0,2 user reviews,1,1,2
707184,True,0,No user reviews,0,0,0
707185,True,0,2 user reviews,2,0,2
707186,True,0,1 user reviews,0,1,1
707187,True,0,1 user reviews,0,1,1
707188,True,0,1 user reviews,0,1,1
707189,True,0,No user reviews,0,0,0
707190,True,0,1 user reviews,0,1,1
707191,True,0,1 user reviews,0,1,1
707192,True,0,1 user reviews,0,1,1
707193,True,0,1 user reviews,0,1,1
707194,True,0,1 user reviews,0,1,1
707195,True,0,1 user reviews,0,1,1
707220,True,0,4 user reviews,2,2,4
707230,True,0,2 user reviews,2,0,2
707240,True,0,7 user reviews,6,1,7
707250,True,0,No user reviews,0,0,0
707280,True,0,4 user reviews,1,3,4
707300,True,5,Mixed,94,54,148
707310,True,0,No user reviews,0,0,0
707320,True,0,3 user reviews,1,2,3
707330,True,0,No user reviews,0,0,0
707340,True,0,No user reviews,0,0,0
707350,True,0,7 user reviews,4,3,7
707360,True,0,No user reviews,0,0,0
707390,True,0,6 user reviews,5,1,6
707400,True,7,Positive,10,0,10
707410,True,0,3 user reviews,2,1,3
707450,True,4,Mostly Negative,6,10,16
707470,True,0,No user reviews,0,0,0
707480,True,0,2 user reviews,2,0,2
707490,True,0,2 user reviews,2,0,2
707560,True,0,1 user reviews,1,0,1
707580,True,6,Mostly Positive,66,17,83
707590,True,6,Mostly Positive,37,13,50
707610,True,0,7 user reviews,4,3,7
707620,True,0,No user reviews,0,0,0
707670,True,0,8 user reviews,1,7,8
707680,True,0,7 user reviews,7,0,7
707720,True,0,5 user reviews,1,4,5
707730,True,0,No user reviews,0,0,0
707740,True,0,1 user reviews,1,0,1
707750,True,0,7 user reviews,1,6,7
707770,True,0,6 user reviews,2,4,6
707830,True,0,No user reviews,0,0,0
707840,True,0,No user reviews,0,0,0
707850,True,0,6 user reviews,3,3,6
707860,True,0,5 user reviews,2,3,5
707870,True,7,Positive,20,5,25
707900,True,0,No user reviews,0,0,0
707910,True,0,No user reviews,0,0,0
707920,True,0,3 user reviews,1,2,3
707950,True,0,No user reviews,0,0,0
707960,True,0,6 user reviews,2,4,6
708020,True,0,No user reviews,0,0,0
708030,True,0,No user reviews,0,0,0
708040,True,0,No user reviews,0,0,0
708070,True,0,No user reviews,0,0,0
708100,True,0,No user reviews,0,0,0
708110,True,0,No user reviews,0,0,0
708120,True,0,7 user reviews,3,4,7
708140,True,0,1 user reviews,1,0,1
708150,True,7,Positive,19,3,22
708160,True,0,No user reviews,0,0,0
708170,True,0,No user reviews,0,0,0
708171,True,0,No user reviews,0,0,0
708172,True,0,5 user reviews,4,1,5
708173,True,5,Mixed,13,10,23
708190,True,5,Mixed,12,6,18
708200,True,0,No user reviews,0,0,0
708250,True,0,No user reviews,0,0,0
708260,True,0,5 user reviews,5,0,5
708280,True,0,1 user reviews,1,0,1
708300,True,0,7 user reviews,5,2,7
708310,True,0,6 user reviews,3,3,6
708320,True,0,No user reviews,0,0,0
708340,True,7,Positive,12,1,13
708350,True,0,No user reviews,0,0,0
708360,True,0,No user reviews,0,0,0
708370,True,5,Mixed,24,12,36
708410,True,0,No user reviews,0,0,0
708420,True,0,No user reviews,0,0,0
708430,True,0,6 user reviews,3,3,6
708450,True,5,Mixed,16,11,27
708460,True,0,No user reviews,0,0,0
708490,True,0,1 user reviews,1,0,1
708500,True,0,No user reviews,0,0,0
708510,True,0,9 user reviews,3,6,9
708520,True,0,No user reviews,0,0,0
708521,True,0,1 user reviews,0,1,1
708522,True,0,No user reviews,0,0,0
708523,True,0,No user reviews,0,0,0
708530,True,0,No user reviews,0,0,0
708550,True,0,No user reviews,0,0,0
708580,True,6,Mostly Positive,130,39,169
708590,True,0,1 user reviews,1,0,1
708620,True,0,No user reviews,0,0,0
708621,True,0,No user reviews,0,0,0
708622,True,0,No user reviews,0,0,0
708630,True,0,4 user reviews,0,4,4
708640,True,0,5 user reviews,3,2,5
708650,True,0,No user reviews,0,0,0
708680,True,0,No user reviews,0,0,0
708690,True,0,No user reviews,0,0,0
708710,True,5,Mixed,12,8,20
708720,True,0,No user reviews,0,0,0
708760,True,6,Mostly Positive,32,9,41
708770,True,6,Mostly Positive,713,298,1011
708780,True,7,Positive,12,0,12
708820,True,7,Positive,18,3,21
708830,True,0,4 user reviews,2,2,4
708850,True,7,Positive,15,2,17
708870,True,0,5 user reviews,5,0,5
708880,True,7,Positive,32,1,33
708890,True,7,Positive,17,1,18
708900,True,0,No user reviews,0,0,0
708910,True,0,No user reviews,0,0,0
708920,True,0,4 user reviews,4,0,4
708930,True,0,1 user reviews,1,0,1
708950,True,7,Positive,25,1,26
708970,True,0,4 user reviews,2,2,4
708980,True,0,No user reviews,0,0,0
709010,True,0,No user reviews,0,0,0
709020,True,0,1 user reviews,0,1,1
709040,True,0,No user reviews,0,0,0
709050,True,0,1 user reviews,0,1,1
709060,True,0,No user reviews,0,0,0
709080,True,0,No user reviews,0,0,0
709090,True,0,No user reviews,0,0,0
709100,True,0,No user reviews,0,0,0
709130,True,0,No user reviews,0,0,0
709140,True,0,5 user reviews,4,1,5
709150,True,8,Very Positive,99,10,109
709160,True,0,No user reviews,0,0,0
709170,True,7,Positive,22,0,22
709171,True,0,No user reviews,0,0,0
709172,True,0,No user reviews,0,0,0
709173,True,0,No user reviews,0,0,0
709174,True,0,1 user reviews,1,0,1
709175,True,0,No user reviews,0,0,0
709190,True,0,9 user reviews,3,6,9
709210,True,0,No user reviews,0,0,0
709240,True,0,No user reviews,0,0,0
709280,True,0,3 user reviews,1,2,3
709290,True,0,1 user reviews,1,0,1
709300,True,0,1 user reviews,1,0,1
709340,True,0,1 user reviews,1,0,1
709350,True,0,1 user reviews,1,0,1
709370,True,0,1 user reviews,1,0,1
709380,True,5,Mixed,11,6,17
709390,True,0,No user reviews,0,0,0
709400,True,0,3 user reviews,3,0,3
709410,True,5,Mixed,30,23,53
709440,True,8,Very Positive,214,27,241
709450,True,0,1 user reviews,1,0,1
709470,True,0,5 user reviews,5,0,5
709490,True,0,4 user reviews,2,2,4
709500,True,0,No user reviews,0,0,0
709510,True,7,Positive,20,1,21
709520,True,0,1 user reviews,1,0,1
709550,True,0,4 user reviews,4,0,4
709560,True,0,5 user reviews,0,5,5
709590,True,0,No user reviews,0,0,0
709600,True,0,1 user reviews,1,0,1
709610,True,0,2 user reviews,0,2,2
709620,True,0,5 user reviews,4,1,5
709650,True,0,No user reviews,0,0,0
709670,True,7,Positive,18,2,20
709680,True,0,No user reviews,0,0,0
709690,True,0,No user reviews,0,0,0
709700,True,5,Mixed,6,7,13
709710,True,7,Positive,16,3,19
709720,True,0,2 user reviews,0,2,2
709730,True,0,No user reviews,0,0,0
709750,True,0,No user reviews,0,0,0
709780,True,4,Mostly Negative,9,17,26
709790,True,0,2 user reviews,2,0,2
709800,True,3,Negative,2,9,11
709820,True,5,Mixed,11,7,18
709830,True,0,3 user reviews,3,0,3
709831,True,0,No user reviews,0,0,0
709840,True,4,Mostly Negative,17,39,56
709850,True,0,No user reviews,0,0,0
709870,True,5,Mixed,12,9,21
709880,True,6,Mostly Positive,16,6,22
709890,True,0,1 user reviews,0,1,1
709900,True,5,Mixed,21,14,35
709920,True,8,Very Positive,179,5,184
709940,True,0,5 user reviews,5,0,5
709960,True,0,No user reviews,0,0,0
709970,True,0,No user reviews,0,0,0
709980,True,0,No user reviews,0,0,0
710000,True,0,No user reviews,0,0,0
710010,True,0,No user reviews,0,0,0
710020,True,0,No user reviews,0,0,0
710030,True,8,Very Positive,45,5,50
710040,True,0,No user reviews,0,0,0
710050,True,0,No user reviews,0,0,0
710060,True,0,No user reviews,0,0,0
710070,True,7,Positive,9,2,11
710090,True,0,No user reviews,0,0,0
710110,True,5,Mixed,7,5,12
710120,True,5,Mixed,8,4,12
710130,True,0,2 user reviews,1,1,2
710140,True,0,No user reviews,0,0,0
710160,True,0,No user reviews,0,0,0
710170,True,8,Very Positive,49,5,54
710190,True,0,2 user reviews,1,1,2
710220,True,0,9 user reviews,9,0,9
710230,True,0,No user reviews,0,0,0
710240,True,0,2 user reviews,1,1,2
710250,True,0,7 user reviews,4,3,7
710280,True,0,No user reviews,0,0,0
710300,True,0,8 user reviews,7,1,8
710310,True,0,No user reviews,0,0,0
710350,True,0,4 user reviews,4,0,4
710360,True,0,5 user reviews,4,1,5
710400,True,0,No user reviews,0,0,0
710410,True,0,No user reviews,0,0,0
710430,True,0,No user reviews,0,0,0
710460,True,0,3 user reviews,2,1,3
710470,True,6,Mostly Positive,160,43,203
710480,True,0,3 user reviews,3,0,3
710490,True,8,Very Positive,69,15,84
710500,True,0,No user reviews,0,0,0
710510,True,0,No user reviews,0,0,0
710520,True,0,2 user reviews,1,1,2
710530,True,0,No user reviews,0,0,0
710550,True,0,No user reviews,0,0,0
710560,True,0,No user reviews,0,0,0
710580,True,0,2 user reviews,2,0,2
710600,True,7,Positive,19,1,20
710610,True,8,Very Positive,84,19,103
710620,True,0,No user reviews,0,0,0
710630,True,0,4 user reviews,4,0,4
710640,True,0,2 user reviews,0,2,2
710650,True,0,1 user reviews,0,1,1
710670,True,0,No user reviews,0,0,0
710680,True,0,No user reviews,0,0,0
710690,True,0,4 user reviews,3,1,4
710700,True,6,Mostly Positive,15,6,21
710710,True,8,Very Positive,183,4,187
710730,True,0,No user reviews,0,0,0
710740,True,0,6 user reviews,5,1,6
710750,True,0,No user reviews,0,0,0
710760,True,6,Mostly Positive,27,10,37
710780,True,7,Positive,28,7,35
710790,True,0,No user reviews,0,0,0
710800,True,7,Positive,14,3,17
710820,True,0,3 user reviews,3,0,3
710830,True,0,6 user reviews,5,1,6
710840,True,0,No user reviews,0,0,0
710880,True,0,1 user reviews,0,1,1
710890,True,0,4 user reviews,3,1,4
710920,True,8,Very Positive,1484,198,1682
710940,True,0,1 user reviews,1,0,1
710950,True,7,Positive,20,3,23
710960,True,0,No user reviews,0,0,0
710970,True,0,7 user reviews,1,6,7
710990,True,0,No user reviews,0,0,0
711000,True,0,1 user reviews,0,1,1
711010,True,5,Mixed,7,8,15
711020,True,0,3 user reviews,3,0,3
711021,True,0,4 user reviews,3,1,4
711022,True,0,4 user reviews,4,0,4
711023,True,0,1 user reviews,1,0,1
711030,True,0,No user reviews,0,0,0
711040,True,0,No user reviews,0,0,0
711050,True,0,6 user reviews,4,2,6
711064,True,0,1 user reviews,1,0,1
711070,True,0,7 user reviews,2,5,7
711130,True,0,8 user reviews,8,0,8
711140,True,0,2 user reviews,1,1,2
711150,True,0,2 user reviews,1,1,2
711172,True,5,Mixed,21,13,34
711190,True,0,No user reviews,0,0,0
711210,True,7,Positive,16,3,19
711220,True,0,No user reviews,0,0,0
711230,True,0,1 user reviews,0,1,1
711240,True,6,Mostly Positive,11,4,15
711250,True,0,No user reviews,0,0,0
711260,True,0,1 user reviews,1,0,1
711270,True,0,No user reviews,0,0,0
711280,True,0,No user reviews,0,0,0
711300,True,0,5 user reviews,5,0,5
711310,True,0,1 user reviews,0,1,1
711320,True,5,Mixed,9,4,13
711330,True,0,5 user reviews,2,3,5
711340,True,0,No user reviews,0,0,0
711350,True,0,3 user reviews,0,3,3
711360,True,0,No user reviews,0,0,0
711380,True,0,9 user reviews,4,5,9
711390,True,0,No user reviews,0,0,0
711400,True,0,No user reviews,0,0,0
711430,True,7,Positive,20,3,23
711440,True,5,Mixed,79,40,119
711450,True,0,1 user reviews,1,0,1
711460,True,0,1 user reviews,0,1,1
711480,True,0,8 user reviews,6,2,8
711490,True,0,No user reviews,0,0,0
711500,True,0,1 user reviews,1,0,1
711510,True,0,No user reviews,0,0,0
711530,True,0,6 user reviews,4,2,6
711540,True,8,Very Positive,383,37,420
711550,True,0,2 user reviews,2,0,2
711560,True,0,7 user reviews,3,4,7
711570,True,5,Mixed,9,6,15
711580,True,0,No user reviews,0,0,0
711590,True,0,No user reviews,0,0,0
711600,True,0,No user reviews,0,0,0
711610,True,0,No user reviews,0,0,0
711630,True,0,No user reviews,0,0,0
711660,True,6,Mostly Positive,532,154,686
711680,True,5,Mixed,12,13,25
711681,True,6,Mostly Positive,12,5,17
711690,True,0,No user reviews,0,0,0
711700,True,0,No user reviews,0,0,0
711710,True,0,No user reviews,0,0,0
711720,True,0,6 user reviews,5,1,6
711730,True,4,Mostly Negative,11,17,28
711731,True,0,No user reviews,0,0,0
711732,True,0,No user reviews,0,0,0
711733,True,0,No user reviews,0,0,0
711734,True,0,1 user reviews,0,1,1
711735,True,0,No user reviews,0,0,0
711736,True,0,No user reviews,0,0,0
711737,True,0,No user reviews,0,0,0
711738,True,0,No user reviews,0,0,0
711739,True,0,No user reviews,0,0,0
711740,True,0,No user reviews,0,0,0
711741,True,0,1 user reviews,0,1,1
711742,True,0,1 user reviews,0,1,1
711743,True,0,No user reviews,0,0,0
711744,True,0,No user reviews,0,0,0
711745,True,0,No user reviews,0,0,0
711746,True,0,No user reviews,0,0,0
711750,True,6,Mostly Positive,167,66,233
711760,True,0,No user reviews,0,0,0
711770,True,0,6 user reviews,3,3,6
711810,True,0,1 user reviews,1,0,1
711860,True,0,1 user reviews,1,0,1
711870,True,0,No user reviews,0,0,0
711890,True,7,Positive,10,0,10
711920,True,0,5 user reviews,4,1,5
711930,True,4,Mostly Negative,2,8,10
711940,True,0,No user reviews,0,0,0
711950,True,0,No user reviews,0,0,0
711960,True,0,No user reviews,0,0,0
711970,True,0,No user reviews,0,0,0
711980,True,8,Very Positive,166,24,190
711990,True,8,Very Positive,116,19,135
712000,True,5,Mixed,6,7,13
712010,True,5,Mixed,16,13,29
712050,True,6,Mostly Positive,199,60,259
712060,True,0,No user reviews,0,0,0
712070,True,0,4 user reviews,3,1,4
712080,True,0,No user reviews,0,0,0
712090,True,0,No user reviews,0,0,0
712100,True,5,Mixed,2971,1693,4664
712120,True,0,No user reviews,0,0,0
712130,True,0,4 user reviews,3,1,4
712150,True,5,Mixed,7,5,12
712160,True,0,7 user reviews,6,1,7
712180,True,6,Mostly Positive,20,6,26
712190,True,5,Mixed,233,107,340
712201,True,0,No user reviews,0,0,0
712210,True,0,1 user reviews,1,0,1
712230,True,0,No user reviews,0,0,0
712240,True,7,Positive,12,1,13
712260,True,7,Positive,12,0,12
712270,True,0,No user reviews,0,0,0
712330,True,0,1 user reviews,1,0,1
712340,True,7,Positive,10,1,11
712350,True,0,No user reviews,0,0,0
712360,True,0,No user reviews,0,0,0
712380,True,0,5 user reviews,5,0,5
712390,True,0,No user reviews,0,0,0
712400,True,0,No user reviews,0,0,0
712410,True,0,2 user reviews,1,1,2
712420,True,0,No user reviews,0,0,0
712430,True,0,1 user reviews,1,0,1
712440,True,0,No user reviews,0,0,0
712450,True,0,No user reviews,0,0,0
712470,True,0,No user reviews,0,0,0
712471,True,0,No user reviews,0,0,0
712480,True,0,No user reviews,0,0,0
712490,True,0,No user reviews,0,0,0
712500,True,0,No user reviews,0,0,0
712501,True,0,No user reviews,0,0,0
712502,True,0,No user reviews,0,0,0
712503,True,0,No user reviews,0,0,0
712510,True,0,No user reviews,0,0,0
712511,True,0,No user reviews,0,0,0
712512,True,0,No user reviews,0,0,0
712513,True,0,No user reviews,0,0,0
712520,True,0,No user reviews,0,0,0
712521,True,0,No user reviews,0,0,0
712530,True,5,Mixed,12,9,21
712540,True,0,1 user reviews,1,0,1
712550,True,0,No user reviews,0,0,0
712560,True,0,No user reviews,0,0,0
712561,True,0,No user reviews,0,0,0
712562,True,0,No user reviews,0,0,0
712563,True,0,No user reviews,0,0,0
712564,True,0,No user reviews,0,0,0
712565,True,0,No user reviews,0,0,0
712566,True,0,No user reviews,0,0,0
712567,True,0,No user reviews,0,0,0
712568,True,0,No user reviews,0,0,0
712569,True,0,No user reviews,0,0,0
712570,True,0,No user reviews,0,0,0
712571,True,0,No user reviews,0,0,0
712590,True,0,No user reviews,0,0,0
712610,True,0,1 user reviews,1,0,1
712620,True,0,3 user reviews,3,0,3
712630,True,0,6 user reviews,5,1,6
712640,True,8,Very Positive,236,47,283
712650,True,0,7 user reviews,4,3,7
712660,True,0,1 user reviews,1,0,1
712670,True,0,4 user reviews,4,0,4
712680,True,0,No user reviews,0,0,0
712681,True,0,No user reviews,0,0,0
712682,True,0,No user reviews,0,0,0
712683,True,0,No user reviews,0,0,0
712684,True,0,No user reviews,0,0,0
712685,True,0,No user reviews,0,0,0
712686,True,0,No user reviews,0,0,0
712687,True,0,No user reviews,0,0,0
712688,True,0,No user reviews,0,0,0
712689,True,0,No user reviews,0,0,0
712690,True,0,No user reviews,0,0,0
712691,True,0,No user reviews,0,0,0
712692,True,0,No user reviews,0,0,0
712693,True,0,No user reviews,0,0,0
712694,True,0,No user reviews,0,0,0
712695,True,0,No user reviews,0,0,0
712696,True,0,No user reviews,0,0,0
712700,True,0,1 user reviews,1,0,1
712710,True,0,No user reviews,0,0,0
712711,True,0,No user reviews,0,0,0
712720,True,0,5 user reviews,5,0,5
712730,True,8,Very Positive,988,53,1041
712760,True,0,1 user reviews,1,0,1
712770,True,0,No user reviews,0,0,0
712790,True,5,Mixed,14,17,31
712800,True,0,No user reviews,0,0,0
712810,True,5,Mixed,21,12,33
712840,True,6,Mostly Positive,115,37,152
712870,True,0,1 user reviews,0,1,1
712880,True,0,No user reviews,0,0,0
712890,True,0,5 user reviews,4,1,5
712900,True,0,No user reviews,0,0,0
712910,True,0,No user reviews,0,0,0
712920,True,0,1 user reviews,1,0,1
712970,True,7,Positive,14,0,14
712980,True,5,Mixed,9,4,13
713000,True,0,No user reviews,0,0,0
713010,True,0,9 user reviews,7,2,9
713030,True,0,9 user reviews,8,1,9
713050,True,6,Mostly Positive,8,3,11
713060,True,0,No user reviews,0,0,0
713070,True,0,1 user reviews,0,1,1
713080,True,0,3 user reviews,0,3,3
713090,True,7,Positive,12,0,12
713100,True,0,7 user reviews,1,6,7
713110,True,0,1 user reviews,0,1,1
713130,True,0,No user reviews,0,0,0
713150,True,0,1 user reviews,1,0,1
713160,True,7,Positive,31,1,32
713170,True,0,1 user reviews,1,0,1
713180,True,7,Positive,24,3,27
713220,True,7,Positive,9,2,11
713230,True,0,8 user reviews,2,6,8
713240,True,0,No user reviews,0,0,0
713260,True,0,4 user reviews,4,0,4
713270,True,0,2 user reviews,1,1,2
713280,True,0,No user reviews,0,0,0
713290,True,0,No user reviews,0,0,0
713300,True,0,No user reviews,0,0,0
713310,True,0,8 user reviews,8,0,8
713320,True,0,No user reviews,0,0,0
713340,True,0,1 user reviews,1,0,1
713350,True,0,No user reviews,0,0,0
713360,True,0,No user reviews,0,0,0
713370,True,0,1 user reviews,1,0,1
713380,True,0,1 user reviews,1,0,1
713390,True,0,1 user reviews,0,1,1
713400,True,0,4 user reviews,3,1,4
713410,True,0,No user reviews,0,0,0
713420,True,5,Mixed,15,9,24
713430,True,0,8 user reviews,8,0,8
713450,True,0,4 user reviews,2,2,4
713460,True,8,Very Positive,84,16,100
713500,True,0,6 user reviews,3,3,6
713530,True,8,Very Positive,72,14,86
713540,True,0,2 user reviews,2,0,2
713550,True,0,1 user reviews,1,0,1
713560,True,7,Positive,9,2,11
713570,True,0,2 user reviews,1,1,2
713580,True,4,Mostly Negative,4,10,14
713590,True,0,8 user reviews,1,7,8
713600,True,0,8 user reviews,3,5,8
713610,True,0,9 user reviews,4,5,9
713630,True,0,No user reviews,0,0,0
713650,True,0,No user reviews,0,0,0
713680,True,4,Mostly Negative,11,18,29
713690,True,0,5 user reviews,5,0,5
713700,True,0,1 user reviews,1,0,1
713710,True,0,No user reviews,0,0,0
713760,True,0,2 user reviews,1,1,2
713800,True,0,6 user reviews,4,2,6
713830,True,0,No user reviews,0,0,0
713840,True,0,5 user reviews,3,2,5
713860,True,6,Mostly Positive,26,8,34
713880,True,0,No user reviews,0,0,0
713900,True,0,No user reviews,0,0,0
713930,True,0,No user reviews,0,0,0
713960,True,0,No user reviews,0,0,0
713970,True,0,No user reviews,0,0,0
713980,True,0,No user reviews,0,0,0
713990,True,0,No user reviews,0,0,0
714010,True,5,Mixed,24,14,38
714020,True,0,No user reviews,0,0,0
714030,True,0,No user reviews,0,0,0
714050,True,0,5 user reviews,2,3,5
714060,True,0,1 user reviews,1,0,1
714070,True,0,No user reviews,0,0,0
714080,True,8,Very Positive,104,26,130
714100,True,0,No user reviews,0,0,0
714120,True,8,Very Positive,983,160,1143
714130,True,0,No user reviews,0,0,0
714150,True,0,No user reviews,0,0,0
714160,True,0,No user reviews,0,0,0
714170,True,0,1 user reviews,0,1,1
714210,True,0,No user reviews,0,0,0
714230,True,0,1 user reviews,1,0,1
714240,True,7,Positive,32,4,36
714250,True,5,Mixed,11,10,21
714270,True,0,No user reviews,0,0,0
714280,True,0,6 user reviews,4,2,6
714290,True,0,4 user reviews,3,1,4
714300,True,5,Mixed,13,8,21
714320,True,0,No user reviews,0,0,0
714331,True,0,1 user reviews,1,0,1
714332,True,0,No user reviews,0,0,0
714333,True,0,No user reviews,0,0,0
714334,True,0,No user reviews,0,0,0
714335,True,0,No user reviews,0,0,0
714336,True,0,No user reviews,0,0,0
714337,True,0,No user reviews,0,0,0
714340,True,0,No user reviews,0,0,0
714360,True,0,5 user reviews,2,3,5
714370,True,4,Mostly Negative,52,179,231
714380,True,0,No user reviews,0,0,0
714390,True,0,No user reviews,0,0,0
714410,True,0,No user reviews,0,0,0
714420,True,0,No user reviews,0,0,0
714430,True,0,No user reviews,0,0,0
714440,True,0,No user reviews,0,0,0
714450,True,0,No user reviews,0,0,0
714460,True,0,No user reviews,0,0,0
714470,True,0,No user reviews,0,0,0
714480,True,0,No user reviews,0,0,0
714500,True,0,No user reviews,0,0,0
714510,True,0,3 user reviews,2,1,3
714530,True,0,1 user reviews,0,1,1
714570,True,0,5 user reviews,3,2,5
714580,True,0,No user reviews,0,0,0
714600,True,0,No user reviews,0,0,0
714610,True,0,No user reviews,0,0,0
714620,True,5,Mixed,5,5,10
714640,True,5,Mixed,9,6,15
714660,True,0,No user reviews,0,0,0
714710,True,0,No user reviews,0,0,0
714720,True,0,No user reviews,0,0,0
714730,True,0,1 user reviews,1,0,1
714740,True,0,No user reviews,0,0,0
714760,True,0,1 user reviews,1,0,1
714770,True,0,5 user reviews,3,2,5
714780,True,0,No user reviews,0,0,0
714800,True,8,Very Positive,104,5,109
714810,True,0,No user reviews,0,0,0
714830,True,0,1 user reviews,1,0,1
714831,True,0,No user reviews,0,0,0
714840,True,0,2 user reviews,1,1,2
714850,True,0,1 user reviews,1,0,1
714860,True,0,No user reviews,0,0,0
714861,True,0,1 user reviews,1,0,1
714880,True,0,No user reviews,0,0,0
714900,True,0,No user reviews,0,0,0
714910,True,0,No user reviews,0,0,0
714920,True,0,No user reviews,0,0,0
714940,True,0,No user reviews,0,0,0
714941,True,0,No user reviews,0,0,0
714942,True,0,No user reviews,0,0,0
714943,True,0,No user reviews,0,0,0
714944,True,0,No user reviews,0,0,0
714960,True,0,8 user reviews,6,2,8
714970,True,0,No user reviews,0,0,0
714980,True,0,7 user reviews,4,3,7
715010,True,8,Very Positive,197,8,205
715020,True,5,Mixed,7,4,11
715050,True,6,Mostly Positive,97,36,133
715060,True,0,3 user reviews,1,2,3
715070,True,7,Positive,24,1,25
715080,True,0,2 user reviews,2,0,2
715090,True,0,3 user reviews,3,0,3
715100,True,0,No user reviews,0,0,0
715110,True,5,Mixed,17,10,27
715130,True,0,No user reviews,0,0,0
715150,True,0,No user reviews,0,0,0
715190,True,8,Very Positive,53,9,62
715191,True,8,Very Positive,103,24,127
715192,True,0,No user reviews,0,0,0
715193,True,7,Positive,32,5,37
715194,True,5,Mixed,141,77,218
715210,True,0,No user reviews,0,0,0
715260,True,0,No user reviews,0,0,0
715270,True,0,4 user reviews,4,0,4
715280,True,0,6 user reviews,3,3,6
715290,True,0,1 user reviews,0,1,1
715310,True,0,No user reviews,0,0,0
715320,True,0,No user reviews,0,0,0
715350,True,0,No user reviews,0,0,0
715370,True,7,Positive,26,1,27
715380,True,5,Mixed,62,30,92
715390,True,0,No user reviews,0,0,0
715400,True,0,No user reviews,0,0,0
715410,True,0,4 user reviews,1,3,4
715420,True,0,1 user reviews,1,0,1
715430,True,0,2 user reviews,2,0,2
715440,True,7,Positive,12,1,13
715450,True,0,No user reviews,0,0,0
715460,True,7,Positive,14,0,14
715470,True,0,3 user reviews,1,2,3
715480,True,0,1 user reviews,0,1,1
715490,True,0,3 user reviews,2,1,3
715510,True,0,4 user reviews,3,1,4
715520,True,4,Mostly Negative,10,19,29
715540,True,0,No user reviews,0,0,0
715550,True,0,No user reviews,0,0,0
715560,True,8,Very Positive,1661,167,1828
715580,True,7,Positive,34,0,34
715590,True,0,No user reviews,0,0,0
715650,True,7,Positive,11,2,13
715660,True,0,5 user reviews,3,2,5
715670,True,0,5 user reviews,5,0,5
715680,True,0,No user reviews,0,0,0
715690,True,6,Mostly Positive,28,8,36
715740,True,0,No user reviews,0,0,0
715750,True,0,No user reviews,0,0,0
715760,True,0,9 user reviews,8,1,9
715770,True,0,No user reviews,0,0,0
715810,True,0,No user reviews,0,0,0
715840,True,5,Mixed,9,6,15
715850,True,6,Mostly Positive,19,6,25
715870,True,0,8 user reviews,6,2,8
715900,True,0,3 user reviews,3,0,3
715910,True,0,No user reviews,0,0,0
715920,True,0,5 user reviews,5,0,5
715940,True,0,5 user reviews,1,4,5
715950,True,8,Very Positive,75,7,82
715970,True,0,No user reviews,0,0,0
715980,True,4,Mostly Negative,5,15,20
715990,True,0,2 user reviews,2,0,2
716000,True,0,6 user reviews,5,1,6
716010,True,7,Positive,12,1,13
716030,True,7,Positive,21,0,21
716040,True,0,7 user reviews,5,2,7
716050,True,6,Mostly Positive,10,3,13
716060,True,0,No user reviews,0,0,0
716070,True,7,Positive,24,1,25
716080,True,0,No user reviews,0,0,0
716081,True,0,No user reviews,0,0,0
716082,True,0,No user reviews,0,0,0
716090,True,0,9 user reviews,6,3,9
716100,True,0,8 user reviews,3,5,8
716120,True,0,No user reviews,0,0,0
716130,True,0,No user reviews,0,0,0
716140,True,0,2 user reviews,2,0,2
716150,True,7,Positive,13,1,14
716160,True,0,No user reviews,0,0,0
716161,True,0,No user reviews,0,0,0
716162,True,0,No user reviews,0,0,0
716163,True,0,No user reviews,0,0,0
716164,True,0,No user reviews,0,0,0
716165,True,0,No user reviews,0,0,0
716166,True,0,No user reviews,0,0,0
716167,True,0,No user reviews,0,0,0
716170,True,0,No user reviews,0,0,0
716190,True,0,4 user reviews,3,1,4
716200,True,0,No user reviews,0,0,0
716220,True,0,1 user reviews,0,1,1
716230,True,0,7 user reviews,6,1,7
716240,True,0,6 user reviews,4,2,6
716250,True,7,Positive,10,1,11
716260,True,0,No user reviews,0,0,0
716270,True,5,Mixed,31,17,48
716310,True,0,1 user reviews,0,1,1
716320,True,0,No user reviews,0,0,0
716330,True,6,Mostly Positive,11,4,15
716340,True,8,Very Positive,89,2,91
716350,True,0,No user reviews,0,0,0
716360,True,0,6 user reviews,6,0,6
716370,True,0,No user reviews,0,0,0
716380,True,5,Mixed,37,24,61
716390,True,0,1 user reviews,0,1,1
716400,True,0,8 user reviews,4,4,8
716410,True,0,5 user reviews,1,4,5
716420,True,0,No user reviews,0,0,0
716430,True,0,No user reviews,0,0,0
716450,True,0,No user reviews,0,0,0
716480,True,0,1 user reviews,0,1,1
716490,True,9,Overwhelmingly Positive,648,24,672
716500,True,8,Very Positive,371,25,396
716510,True,0,No user reviews,0,0,0
716550,True,0,No user reviews,0,0,0
716560,True,0,6 user reviews,5,1,6
716580,True,7,Positive,11,0,11
716600,True,0,9 user reviews,4,5,9
716610,True,0,No user reviews,0,0,0
716620,True,0,No user reviews,0,0,0
716630,True,5,Mixed,46,30,76
716640,True,6,Mostly Positive,193,68,261
716650,True,8,Very Positive,132,4,136
716660,True,6,Mostly Positive,16,6,22
716670,True,5,Mixed,409,202,611
716680,True,8,Very Positive,53,10,63
716690,True,0,No user reviews,0,0,0
716691,True,0,No user reviews,0,0,0
716710,True,8,Very Positive,254,10,264
716750,True,5,Mixed,9,4,13
716760,True,0,9 user reviews,5,4,9
716770,True,0,6 user reviews,5,1,6
716780,True,0,No user reviews,0,0,0
716790,True,0,1 user reviews,1,0,1
716800,True,0,No user reviews,0,0,0
716820,True,0,No user reviews,0,0,0
716830,True,0,No user reviews,0,0,0
716840,True,0,3 user reviews,1,2,3
716850,True,0,1 user reviews,0,1,1
716870,True,0,1 user reviews,1,0,1
716880,True,0,No user reviews,0,0,0
716890,True,5,Mixed,6,6,12
716900,True,0,No user reviews,0,0,0
716910,True,0,No user reviews,0,0,0
716920,True,0,4 user reviews,2,2,4
716930,True,0,6 user reviews,6,0,6
716940,True,5,Mixed,7,4,11
716950,True,0,No user reviews,0,0,0
716960,True,0,1 user reviews,1,0,1
716970,True,0,1 user reviews,1,0,1
716980,True,0,2 user reviews,2,0,2
716990,True,0,No user reviews,0,0,0
717000,True,0,1 user reviews,1,0,1
717010,True,0,No user reviews,0,0,0
717011,True,0,No user reviews,0,0,0
717012,True,0,No user reviews,0,0,0
717013,True,0,No user reviews,0,0,0
717014,True,0,No user reviews,0,0,0
717015,True,0,No user reviews,0,0,0
717016,True,0,No user reviews,0,0,0
717017,True,0,No user reviews,0,0,0
717018,True,0,No user reviews,0,0,0
717019,True,0,No user reviews,0,0,0
717020,True,0,5 user reviews,4,1,5
717030,True,0,No user reviews,0,0,0
717031,True,0,3 user reviews,2,1,3
717032,True,0,1 user reviews,1,0,1
717040,True,0,3 user reviews,1,2,3
717050,True,0,No user reviews,0,0,0
717060,True,0,3 user reviews,3,0,3
717070,True,7,Positive,16,1,17
717080,True,0,No user reviews,0,0,0
717090,True,0,No user reviews,0,0,0
717100,True,0,No user reviews,0,0,0
717110,True,0,No user reviews,0,0,0
717120,True,5,Mixed,8,6,14
717130,True,0,No user reviews,0,0,0
717160,True,0,No user reviews,0,0,0
717170,True,0,No user reviews,0,0,0
717180,True,0,No user reviews,0,0,0
717190,True,0,No user reviews,0,0,0
717200,True,0,3 user reviews,2,1,3
717210,True,0,No user reviews,0,0,0
717230,True,0,No user reviews,0,0,0
717240,True,0,2 user reviews,1,1,2
717250,True,9,Overwhelmingly Positive,899,4,903
717260,True,0,No user reviews,0,0,0
717280,True,0,1 user reviews,1,0,1
717300,True,0,No user reviews,0,0,0
717310,True,6,Mostly Positive,69,18,87
717320,True,0,No user reviews,0,0,0
717330,True,0,2 user reviews,1,1,2
717340,True,7,Positive,35,1,36
717380,True,0,No user reviews,0,0,0
717400,True,0,1 user reviews,1,0,1
717430,True,0,No user reviews,0,0,0
717440,True,0,No user reviews,0,0,0
717490,True,6,Mostly Positive,26,9,35
717500,True,0,No user reviews,0,0,0
717530,True,0,No user reviews,0,0,0
717540,True,0,3 user reviews,3,0,3
717560,True,6,Mostly Positive,73,30,103
717570,True,0,No user reviews,0,0,0
717580,True,0,No user reviews,0,0,0
717590,True,0,No user reviews,0,0,0
717610,True,8,Very Positive,113,17,130
717620,True,0,No user reviews,0,0,0
717630,True,0,No user reviews,0,0,0
717640,True,8,Very Positive,181,38,219
717650,True,0,No user reviews,0,0,0
717670,True,0,2 user reviews,1,1,2
717680,True,0,No user reviews,0,0,0
717690,True,5,Mixed,700,721,1421
717710,True,0,No user reviews,0,0,0
717720,True,0,3 user reviews,2,1,3
717740,True,0,No user reviews,0,0,0
717741,True,0,No user reviews,0,0,0
717742,True,0,No user reviews,0,0,0
717743,True,0,No user reviews,0,0,0
717744,True,0,No user reviews,0,0,0
717745,True,0,No user reviews,0,0,0
717746,True,0,No user reviews,0,0,0
717747,True,0,No user reviews,0,0,0
717748,True,0,No user reviews,0,0,0
717749,True,0,No user reviews,0,0,0
717751,True,0,No user reviews,0,0,0
717752,True,0,No user reviews,0,0,0
717753,True,0,No user reviews,0,0,0
717760,True,0,2 user reviews,2,0,2
717780,True,7,Positive,18,2,20
717790,True,6,Mostly Positive,161,68,229
717800,True,0,No user reviews,0,0,0
717820,True,5,Mixed,8,5,13
717830,True,0,6 user reviews,6,0,6
717840,True,0,4 user reviews,4,0,4
717850,True,8,Very Positive,68,2,70
717910,True,0,No user reviews,0,0,0
717930,True,0,No user reviews,0,0,0
717940,True,0,No user reviews,0,0,0
717950,True,8,Very Positive,46,11,57
717960,True,0,1 user reviews,1,0,1
717980,True,0,No user reviews,0,0,0
717990,True,0,No user reviews,0,0,0
718010,True,7,Positive,21,1,22
718020,True,0,4 user reviews,4,0,4
718030,True,0,6 user reviews,6,0,6
718040,True,0,No user reviews,0,0,0
718050,True,0,No user reviews,0,0,0
718070,True,0,3 user reviews,1,2,3
718080,True,0,9 user reviews,7,2,9
718100,True,0,1 user reviews,1,0,1
718120,True,0,4 user reviews,4,0,4
718130,True,0,1 user reviews,1,0,1
718140,True,0,3 user reviews,1,2,3
718150,True,0,No user reviews,0,0,0
718180,True,5,Mixed,32,14,46
718200,True,8,Very Positive,90,7,97
718210,True,0,7 user reviews,6,1,7
718220,True,0,4 user reviews,2,2,4
718230,True,0,No user reviews,0,0,0
718240,True,0,5 user reviews,4,1,5
718250,True,7,Positive,13,1,14
718270,True,0,No user reviews,0,0,0
718290,True,0,No user reviews,0,0,0
718310,True,0,No user reviews,0,0,0
718320,True,5,Mixed,10,12,22
718330,True,8,Very Positive,60,6,66
718350,True,0,3 user reviews,0,3,3
718370,True,5,Mixed,39,42,81
718380,True,5,Mixed,7,7,14
718390,True,0,No user reviews,0,0,0
718410,True,0,1 user reviews,1,0,1
718420,True,0,No user reviews,0,0,0
718460,True,0,No user reviews,0,0,0
718470,True,0,1 user reviews,1,0,1
718480,True,0,No user reviews,0,0,0
718490,True,0,2 user reviews,2,0,2
718500,True,0,No user reviews,0,0,0
718520,True,0,No user reviews,0,0,0
718530,True,0,3 user reviews,3,0,3
718540,True,5,Mixed,5,5,10
718550,True,0,No user reviews,0,0,0
718560,True,8,Very Positive,1095,115,1210
718570,True,7,Positive,12,0,12
718590,True,6,Mostly Positive,306,87,393
718600,True,0,6 user reviews,5,1,6
718630,True,0,No user reviews,0,0,0
718650,True,6,Mostly Positive,360,124,484
718660,True,5,Mixed,5,5,10
718670,True,8,Very Positive,2054,506,2560
718680,True,0,4 user reviews,3,1,4
718690,True,0,1 user reviews,1,0,1
718700,True,0,No user reviews,0,0,0
718710,True,0,1 user reviews,1,0,1
718720,True,7,Positive,15,3,18
718730,True,7,Positive,24,1,25
718740,True,0,No user reviews,0,0,0
718750,True,0,No user reviews,0,0,0
718790,True,0,No user reviews,0,0,0
718800,True,0,1 user reviews,1,0,1
718830,True,0,4 user reviews,2,2,4
718840,True,0,No user reviews,0,0,0
718850,True,6,Mostly Positive,1225,313,1538
718900,True,0,No user reviews,0,0,0
718910,True,0,3 user reviews,1,2,3
718920,True,0,2 user reviews,0,2,2
718940,True,0,No user reviews,0,0,0
718950,True,0,No user reviews,0,0,0
718960,True,0,4 user reviews,2,2,4
718970,True,0,6 user reviews,4,2,6
718980,True,0,1 user reviews,0,1,1
718990,True,0,2 user reviews,0,2,2
719000,True,0,No user reviews,0,0,0
719010,True,0,No user reviews,0,0,0
719020,True,0,No user reviews,0,0,0
719030,True,0,No user reviews,0,0,0
719040,True,8,Very Positive,2725,621,3346
719070,True,0,2 user reviews,2,0,2
719080,True,7,Positive,18,2,20
719090,True,0,5 user reviews,4,1,5
719100,True,0,1 user reviews,0,1,1
719110,True,0,5 user reviews,4,1,5
719120,True,3,Negative,1,9,10
719130,True,0,5 user reviews,4,1,5
719140,True,0,9 user reviews,8,1,9
719160,True,0,No user reviews,0,0,0
719180,True,6,Mostly Positive,35,9,44
719200,True,6,Mostly Positive,104,37,141
719210,True,7,Positive,11,0,11
719220,True,0,1 user reviews,1,0,1
719240,True,0,No user reviews,0,0,0
719250,True,0,8 user reviews,6,2,8
719260,True,0,2 user reviews,1,1,2
719270,True,0,No user reviews,0,0,0
719280,True,0,No user reviews,0,0,0
719290,True,0,1 user reviews,1,0,1
719300,True,0,1 user reviews,1,0,1
719310,True,0,1 user reviews,1,0,1
719320,True,0,4 user reviews,2,2,4
719330,True,7,Positive,45,4,49
719340,True,0,No user reviews,0,0,0
719350,True,0,1 user reviews,1,0,1
719370,True,0,No user reviews,0,0,0
719410,True,5,Mixed,8,5,13
719430,True,7,Positive,35,8,43
719470,True,0,1 user reviews,1,0,1
719480,True,0,1 user reviews,1,0,1
719490,True,0,No user reviews,0,0,0
719520,True,7,Positive,28,5,33
719530,True,0,No user reviews,0,0,0
719540,True,0,4 user reviews,1,3,4
719550,True,0,8 user reviews,7,1,8
719570,True,0,No user reviews,0,0,0
719590,True,4,Mostly Negative,63,241,304
719600,True,0,4 user reviews,1,3,4
719610,True,5,Mixed,25,21,46
719630,True,0,No user reviews,0,0,0
719640,True,0,No user reviews,0,0,0
719660,True,8,Very Positive,56,1,57
719670,True,0,2 user reviews,1,1,2
719690,True,6,Mostly Positive,17,5,22
719710,True,0,3 user reviews,3,0,3
719720,True,0,No user reviews,0,0,0
719730,True,0,No user reviews,0,0,0
719740,True,0,1 user reviews,1,0,1
719750,True,8,Very Positive,160,14,174
719800,True,7,Positive,13,2,15
719820,True,0,1 user reviews,0,1,1
719830,True,0,1 user reviews,0,1,1
719840,True,0,2 user reviews,2,0,2
719890,True,6,Mostly Positive,779,294,1073
719920,True,0,No user reviews,0,0,0
719930,True,0,5 user reviews,5,0,5
719970,True,0,3 user reviews,0,3,3
719990,True,0,No user reviews,0,0,0
720000,True,0,6 user reviews,3,3,6
720020,True,0,1 user reviews,1,0,1
720030,True,8,Very Positive,115,21,136
720040,True,3,Negative,2,16,18
720060,True,0,3 user reviews,1,2,3
720100,True,0,No user reviews,0,0,0
720110,True,0,No user reviews,0,0,0
720130,True,0,1 user reviews,1,0,1
720140,True,0,No user reviews,0,0,0
720150,True,7,Positive,37,3,40
720160,True,0,No user reviews,0,0,0
720170,True,0,No user reviews,0,0,0
720180,True,0,1 user reviews,1,0,1
720200,True,6,Mostly Positive,10,4,14
720230,True,0,No user reviews,0,0,0
720240,True,5,Mixed,8,9,17
720250,True,8,Very Positive,734,162,896
720260,True,0,No user reviews,0,0,0
720270,True,5,Mixed,11,9,20
720280,True,8,Very Positive,365,82,447
720290,True,5,Mixed,8,5,13
720300,True,0,No user reviews,0,0,0
720310,True,0,2 user reviews,0,2,2
720330,True,0,1 user reviews,0,1,1
720340,True,0,No user reviews,0,0,0
720350,True,0,No user reviews,0,0,0
720380,True,0,No user reviews,0,0,0
720400,True,0,1 user reviews,1,0,1
720440,True,0,No user reviews,0,0,0
720450,True,0,1 user reviews,0,1,1
720470,True,0,9 user reviews,1,8,9
720480,True,0,3 user reviews,3,0,3
720490,True,0,No user reviews,0,0,0
720510,True,0,7 user reviews,6,1,7
720530,True,7,Positive,16,2,18
720540,True,0,No user reviews,0,0,0
720560,True,8,Very Positive,193,29,222
720590,True,0,2 user reviews,2,0,2
720600,True,0,6 user reviews,5,1,6
720610,True,0,No user reviews,0,0,0
720611,True,0,No user reviews,0,0,0
720612,True,0,No user reviews,0,0,0
720613,True,0,No user reviews,0,0,0
720614,True,0,No user reviews,0,0,0
720615,True,0,No user reviews,0,0,0
720616,True,0,No user reviews,0,0,0
720618,True,0,No user reviews,0,0,0
720620,True,0,No user reviews,0,0,0
720640,True,0,1 user reviews,1,0,1
720660,True,0,No user reviews,0,0,0
720670,True,0,No user reviews,0,0,0
720680,True,7,Positive,20,5,25
720690,True,0,2 user reviews,2,0,2
720700,True,0,2 user reviews,2,0,2
720710,True,0,6 user reviews,5,1,6
720720,True,0,No user reviews,0,0,0
720730,True,4,Mostly Negative,5,8,13
720740,True,0,6 user reviews,6,0,6
720750,True,0,5 user reviews,1,4,5
720760,True,0,5 user reviews,3,2,5
720770,True,0,5 user reviews,5,0,5
720780,True,6,Mostly Positive,7,3,10
720790,True,0,3 user reviews,2,1,3
720800,True,0,5 user reviews,1,4,5
720810,True,0,No user reviews,0,0,0
720820,True,0,No user reviews,0,0,0
720850,True,0,2 user reviews,2,0,2
720860,True,0,9 user reviews,9,0,9
720900,True,0,No user reviews,0,0,0
720930,True,0,No user reviews,0,0,0
720940,True,7,Positive,27,3,30
720950,True,0,1 user reviews,1,0,1
720960,True,6,Mostly Positive,8,3,11
720980,True,0,No user reviews,0,0,0
720990,True,0,No user reviews,0,0,0
721000,True,0,No user reviews,0,0,0
721010,True,8,Very Positive,48,5,53
721030,True,0,No user reviews,0,0,0
721050,True,0,1 user reviews,1,0,1
721051,True,0,1 user reviews,1,0,1
721052,True,0,2 user reviews,1,1,2
721053,True,0,No user reviews,0,0,0
721054,True,0,No user reviews,0,0,0
721060,True,4,Mostly Negative,4,7,11
721080,True,0,4 user reviews,1,3,4
721090,True,5,Mixed,9,5,14
721100,True,0,2 user reviews,2,0,2
721101,True,0,1 user reviews,1,0,1
721102,True,0,No user reviews,0,0,0
721103,True,0,No user reviews,0,0,0
721104,True,0,3 user reviews,2,1,3
721105,True,0,2 user reviews,2,0,2
721106,True,0,1 user reviews,1,0,1
721107,True,0,1 user reviews,1,0,1
721108,True,0,1 user reviews,1,0,1
721109,True,0,No user reviews,0,0,0
721110,True,0,No user reviews,0,0,0
721111,True,0,No user reviews,0,0,0
721112,True,0,No user reviews,0,0,0
721113,True,0,No user reviews,0,0,0
721114,True,0,1 user reviews,1,0,1
721115,True,0,No user reviews,0,0,0
721116,True,0,No user reviews,0,0,0
721117,True,0,No user reviews,0,0,0
721118,True,0,1 user reviews,1,0,1
721119,True,0,No user reviews,0,0,0
721130,True,0,No user reviews,0,0,0
721131,True,0,No user reviews,0,0,0
721132,True,0,5 user reviews,5,0,5
721133,True,0,2 user reviews,2,0,2
721140,True,0,No user reviews,0,0,0
721141,True,0,No user reviews,0,0,0
721142,True,0,No user reviews,0,0,0
721143,True,0,No user reviews,0,0,0
721144,True,0,No user reviews,0,0,0
721145,True,0,1 user reviews,1,0,1
721146,True,0,No user reviews,0,0,0
721147,True,0,No user reviews,0,0,0
721148,True,0,No user reviews,0,0,0
721149,True,0,1 user reviews,0,1,1
721150,True,0,1 user reviews,1,0,1
721151,True,0,No user reviews,0,0,0
721180,True,0,No user reviews,0,0,0
721260,True,0,3 user reviews,3,0,3
721270,True,0,5 user reviews,4,1,5
721280,True,0,4 user reviews,4,0,4
721290,True,0,No user reviews,0,0,0
721300,True,0,2 user reviews,1,1,2
721310,True,0,No user reviews,0,0,0
721320,True,0,No user reviews,0,0,0
721330,True,0,No user reviews,0,0,0
721340,True,5,Mixed,65,28,93
721341,True,5,Mixed,6,6,12
721350,True,0,1 user reviews,1,0,1
721380,True,0,5 user reviews,5,0,5
721390,True,7,Positive,38,1,39
721400,True,0,5 user reviews,4,1,5
721410,True,0,5 user reviews,4,1,5
721420,True,0,3 user reviews,1,2,3
721430,True,6,Mostly Positive,17,5,22
721460,True,0,No user reviews,0,0,0
721470,True,0,2 user reviews,1,1,2
721480,True,0,4 user reviews,4,0,4
721490,True,0,No user reviews,0,0,0
721510,True,0,No user reviews,0,0,0
721540,True,0,1 user reviews,0,1,1
721550,True,0,No user reviews,0,0,0
721560,True,0,No user reviews,0,0,0
721570,True,0,No user reviews,0,0,0
721580,True,0,No user reviews,0,0,0
721590,True,0,No user reviews,0,0,0
721600,True,0,No user reviews,0,0,0
721610,True,0,No user reviews,0,0,0
721620,True,8,Very Positive,40,10,50
721630,True,0,No user reviews,0,0,0
721640,True,0,No user reviews,0,0,0
721650,True,0,No user reviews,0,0,0
721670,True,0,2 user reviews,1,1,2
721700,True,0,No user reviews,0,0,0
721710,True,0,No user reviews,0,0,0
721711,True,0,No user reviews,0,0,0
721720,True,0,No user reviews,0,0,0
721740,True,0,6 user reviews,5,1,6
721750,True,0,No user reviews,0,0,0
721760,True,6,Mostly Positive,14,4,18
721770,True,0,No user reviews,0,0,0
721800,True,0,No user reviews,0,0,0
721801,True,0,No user reviews,0,0,0
721802,True,0,No user reviews,0,0,0
721803,True,0,No user reviews,0,0,0
721804,True,0,No user reviews,0,0,0
721805,True,0,No user reviews,0,0,0
721806,True,0,No user reviews,0,0,0
721807,True,0,No user reviews,0,0,0
721808,True,0,No user reviews,0,0,0
721809,True,0,No user reviews,0,0,0
721810,True,0,No user reviews,0,0,0
721811,True,0,No user reviews,0,0,0
721812,True,0,No user reviews,0,0,0
721813,True,0,No user reviews,0,0,0
721814,True,0,No user reviews,0,0,0
721815,True,0,No user reviews,0,0,0
721816,True,0,No user reviews,0,0,0
721817,True,0,No user reviews,0,0,0
721818,True,0,No user reviews,0,0,0
721819,True,0,No user reviews,0,0,0
721820,True,0,No user reviews,0,0,0
721821,True,0,No user reviews,0,0,0
721822,True,0,No user reviews,0,0,0
721823,True,0,No user reviews,0,0,0
721850,True,0,No user reviews,0,0,0
721870,True,0,No user reviews,0,0,0
721880,True,0,No user reviews,0,0,0
721890,True,0,6 user reviews,4,2,6
721910,True,0,No user reviews,0,0,0
721930,True,0,No user reviews,0,0,0
721940,True,5,Mixed,13,6,19
721950,True,5,Mixed,7,7,14
721960,True,0,3 user reviews,2,1,3
721980,True,0,No user reviews,0,0,0
721990,True,0,No user reviews,0,0,0
722010,True,0,3 user reviews,0,3,3
722020,True,0,6 user reviews,0,6,6
722040,True,0,9 user reviews,7,2,9
722050,True,0,3 user reviews,3,0,3
722060,True,8,Very Positive,889,52,941
722070,True,0,No user reviews,0,0,0
722080,True,0,No user reviews,0,0,0
722090,True,0,1 user reviews,1,0,1
722120,True,0,No user reviews,0,0,0
722130,True,0,No user reviews,0,0,0
722180,True,8,Very Positive,244,49,293
722190,True,0,5 user reviews,3,2,5
722200,True,0,No user reviews,0,0,0
722230,True,5,Mixed,244,201,445
722250,True,5,Mixed,18,8,26
722270,True,0,No user reviews,0,0,0
722290,True,0,5 user reviews,2,3,5
722310,True,0,No user reviews,0,0,0
722330,True,7,Positive,15,1,16
722340,True,0,1 user reviews,0,1,1
722350,True,0,5 user reviews,3,2,5
722360,True,0,No user reviews,0,0,0
722361,True,0,No user reviews,0,0,0
722362,True,0,No user reviews,0,0,0
722370,True,0,1 user reviews,1,0,1
722380,True,0,No user reviews,0,0,0
722390,True,0,No user reviews,0,0,0
722400,True,0,1 user reviews,1,0,1
722410,True,0,2 user reviews,0,2,2
722420,True,0,No user reviews,0,0,0
722421,True,0,No user reviews,0,0,0
722422,True,0,No user reviews,0,0,0
722423,True,0,No user reviews,0,0,0
722424,True,0,No user reviews,0,0,0
722425,True,0,No user reviews,0,0,0
722426,True,0,No user reviews,0,0,0
722427,True,0,No user reviews,0,0,0
722428,True,0,No user reviews,0,0,0
722429,True,0,No user reviews,0,0,0
722430,True,0,No user reviews,0,0,0
722431,True,0,No user reviews,0,0,0
722460,True,0,No user reviews,0,0,0
722461,True,0,No user reviews,0,0,0
722462,True,0,No user reviews,0,0,0
722463,True,0,No user reviews,0,0,0
722464,True,0,No user reviews,0,0,0
722465,True,0,No user reviews,0,0,0
722466,True,0,No user reviews,0,0,0
722467,True,0,No user reviews,0,0,0
722468,True,0,No user reviews,0,0,0
722469,True,0,No user reviews,0,0,0
722470,True,0,No user reviews,0,0,0
722471,True,0,No user reviews,0,0,0
722490,True,0,1 user reviews,0,1,1
722491,True,0,No user reviews,0,0,0
722492,True,0,No user reviews,0,0,0
722493,True,0,No user reviews,0,0,0
722494,True,0,No user reviews,0,0,0
722495,True,0,No user reviews,0,0,0
722496,True,0,No user reviews,0,0,0
722497,True,0,No user reviews,0,0,0
722498,True,0,No user reviews,0,0,0
722499,True,0,No user reviews,0,0,0
722500,True,0,No user reviews,0,0,0
722501,True,0,No user reviews,0,0,0
722502,True,0,No user reviews,0,0,0
722520,True,0,No user reviews,0,0,0
722530,True,0,No user reviews,0,0,0
722540,True,5,Mixed,4,6,10
722550,True,0,No user reviews,0,0,0
722560,True,6,Mostly Positive,220,58,278
722570,True,0,7 user reviews,3,4,7
722580,True,0,No user reviews,0,0,0
722590,True,0,No user reviews,0,0,0
722600,True,0,5 user reviews,5,0,5
722610,True,0,No user reviews,0,0,0
722620,True,0,3 user reviews,3,0,3
722650,True,0,No user reviews,0,0,0
722660,True,5,Mixed,16,11,27
722670,True,7,Positive,9,2,11
722680,True,0,2 user reviews,1,1,2
722690,True,0,No user reviews,0,0,0
722710,True,0,No user reviews,0,0,0
722720,True,0,No user reviews,0,0,0
722730,True,9,Overwhelmingly Positive,556,20,576
722740,True,0,No user reviews,0,0,0
722750,True,0,No user reviews,0,0,0
722760,True,0,2 user reviews,2,0,2
722770,True,0,No user reviews,0,0,0
722800,True,0,2 user reviews,2,0,2
722810,True,0,4 user reviews,1,3,4
722820,True,0,No user reviews,0,0,0
722840,True,0,No user reviews,0,0,0
722841,True,0,No user reviews,0,0,0
722842,True,0,No user reviews,0,0,0
722843,True,0,No user reviews,0,0,0
722844,True,0,No user reviews,0,0,0
722850,True,0,1 user reviews,1,0,1
722851,True,0,4 user reviews,3,1,4
722870,True,7,Positive,35,2,37
722880,True,0,No user reviews,0,0,0
722881,True,0,No user reviews,0,0,0
722890,True,0,6 user reviews,6,0,6
722900,True,0,No user reviews,0,0,0
722910,True,0,1 user reviews,1,0,1
722920,True,7,Positive,24,6,30
722960,True,6,Mostly Positive,140,48,188
722990,True,7,Positive,9,1,10
723000,True,0,No user reviews,0,0,0
723020,True,0,3 user reviews,0,3,3
723030,True,0,No user reviews,0,0,0
723040,True,0,No user reviews,0,0,0
723050,True,0,No user reviews,0,0,0
723070,True,0,3 user reviews,2,1,3
723080,True,0,1 user reviews,1,0,1
723090,True,9,Overwhelmingly Positive,598,14,612
723100,True,6,Mostly Positive,10,3,13
723110,True,0,8 user reviews,6,2,8
723120,True,0,No user reviews,0,0,0
723130,True,0,No user reviews,0,0,0
723170,True,0,No user reviews,0,0,0
723180,True,0,1 user reviews,0,1,1
723190,True,0,5 user reviews,2,3,5
723210,True,0,No user reviews,0,0,0
723260,True,0,No user reviews,0,0,0
723270,True,8,Very Positive,322,34,356
723280,True,0,2 user reviews,1,1,2
723320,True,0,No user reviews,0,0,0
723330,True,0,No user reviews,0,0,0
723340,True,0,No user reviews,0,0,0
723350,True,7,Positive,29,6,35
723370,True,0,2 user reviews,1,1,2
723380,True,0,2 user reviews,1,1,2
723390,True,4,Mostly Negative,378,634,1012
723410,True,0,No user reviews,0,0,0
723420,True,0,No user reviews,0,0,0
723430,True,0,No user reviews,0,0,0
723440,True,0,No user reviews,0,0,0
723450,True,5,Mixed,12,7,19
723460,True,0,1 user reviews,1,0,1
723470,True,0,No user reviews,0,0,0
723510,True,0,2 user reviews,1,1,2
723520,True,0,No user reviews,0,0,0
723530,True,0,2 user reviews,2,0,2
723540,True,0,2 user reviews,0,2,2
723550,True,0,No user reviews,0,0,0
723560,True,0,No user reviews,0,0,0
723600,True,0,No user reviews,0,0,0
723610,True,0,No user reviews,0,0,0
723620,True,0,No user reviews,0,0,0
723650,True,0,1 user reviews,1,0,1
723750,True,0,No user reviews,0,0,0
723760,True,0,4 user reviews,4,0,4
723770,True,0,No user reviews,0,0,0
723780,True,0,No user reviews,0,0,0
723790,True,0,No user reviews,0,0,0
723800,True,0,2 user reviews,0,2,2
723810,True,0,6 user reviews,1,5,6
723820,True,0,2 user reviews,2,0,2
723830,True,0,8 user reviews,4,4,8
723880,True,0,2 user reviews,1,1,2
723890,True,8,Very Positive,68,11,79
723910,True,0,1 user reviews,1,0,1
723920,True,0,No user reviews,0,0,0
723930,True,7,Positive,9,1,10
723940,True,0,3 user reviews,3,0,3
723950,True,0,No user reviews,0,0,0
723960,True,0,No user reviews,0,0,0
723990,True,0,No user reviews,0,0,0
724000,True,0,No user reviews,0,0,0
724010,True,7,Positive,12,2,14
724020,True,0,No user reviews,0,0,0
724030,True,0,2 user reviews,2,0,2
724060,True,0,No user reviews,0,0,0
724070,True,5,Mixed,8,4,12
724080,True,0,7 user reviews,4,3,7
724090,True,0,2 user reviews,0,2,2
724100,True,0,No user reviews,0,0,0
724110,True,0,3 user reviews,0,3,3
724120,True,0,3 user reviews,3,0,3
724130,True,0,5 user reviews,4,1,5
724170,True,0,No user reviews,0,0,0
724180,True,0,No user reviews,0,0,0
724190,True,0,No user reviews,0,0,0
724191,True,0,No user reviews,0,0,0
724192,True,0,No user reviews,0,0,0
724193,True,0,No user reviews,0,0,0
724194,True,0,No user reviews,0,0,0
724195,True,0,No user reviews,0,0,0
724196,True,0,No user reviews,0,0,0
724197,True,0,No user reviews,0,0,0
724198,True,0,No user reviews,0,0,0
724199,True,0,No user reviews,0,0,0
724200,True,0,No user reviews,0,0,0
724201,True,0,No user reviews,0,0,0
724230,True,0,No user reviews,0,0,0
724240,True,0,No user reviews,0,0,0
724250,True,6,Mostly Positive,47,19,66
724260,True,0,9 user reviews,8,1,9
724290,True,0,No user reviews,0,0,0
724300,True,8,Very Positive,163,12,175
724310,True,0,No user reviews,0,0,0
724330,True,0,6 user reviews,5,1,6
724340,True,0,1 user reviews,1,0,1
724350,True,5,Mixed,11,9,20
724360,True,0,No user reviews,0,0,0
724370,True,0,7 user reviews,7,0,7
724380,True,0,No user reviews,0,0,0
724390,True,6,Mostly Positive,21,7,28
724420,True,5,Mixed,6,4,10
724430,True,4,Mostly Negative,6,16,22
724440,True,0,6 user reviews,6,0,6
724460,True,0,3 user reviews,1,2,3
724470,True,8,Very Positive,66,15,81
724480,True,0,4 user reviews,1,3,4
724490,True,5,Mixed,13,9,22
724510,True,5,Mixed,16,8,24
724520,True,0,No user reviews,0,0,0
724580,True,0,7 user reviews,2,5,7
724590,True,0,2 user reviews,1,1,2
724600,True,0,No user reviews,0,0,0
724610,True,0,No user reviews,0,0,0
724620,True,0,No user reviews,0,0,0
724630,True,0,8 user reviews,4,4,8
724640,True,0,5 user reviews,5,0,5
724650,True,0,No user reviews,0,0,0
724680,True,0,No user reviews,0,0,0
724690,True,0,9 user reviews,5,4,9
724710,True,5,Mixed,13,9,22
724720,True,0,6 user reviews,6,0,6
724740,True,5,Mixed,123,60,183
724750,True,0,No user reviews,0,0,0
724760,True,0,3 user reviews,2,1,3
724780,True,0,1 user reviews,1,0,1
724781,True,0,No user reviews,0,0,0
724782,True,0,No user reviews,0,0,0
724783,True,0,No user reviews,0,0,0
724784,True,0,No user reviews,0,0,0
724785,True,0,No user reviews,0,0,0
724786,True,0,No user reviews,0,0,0
724787,True,0,No user reviews,0,0,0
724788,True,0,No user reviews,0,0,0
724789,True,0,No user reviews,0,0,0
724790,True,0,No user reviews,0,0,0
724791,True,0,No user reviews,0,0,0
724800,True,0,No user reviews,0,0,0
724801,True,0,No user reviews,0,0,0
724802,True,0,No user reviews,0,0,0
724803,True,0,No user reviews,0,0,0
724804,True,0,No user reviews,0,0,0
724805,True,0,No user reviews,0,0,0
724806,True,0,No user reviews,0,0,0
724807,True,0,No user reviews,0,0,0
724808,True,0,No user reviews,0,0,0
724809,True,0,No user reviews,0,0,0
724810,True,0,No user reviews,0,0,0
724811,True,0,No user reviews,0,0,0
724812,True,0,No user reviews,0,0,0
724813,True,0,No user reviews,0,0,0
724814,True,0,No user reviews,0,0,0
724815,True,0,No user reviews,0,0,0
724816,True,0,No user reviews,0,0,0
724817,True,0,No user reviews,0,0,0
724818,True,0,No user reviews,0,0,0
724819,True,0,No user reviews,0,0,0
724820,True,0,No user reviews,0,0,0
724821,True,0,No user reviews,0,0,0
724822,True,0,No user reviews,0,0,0
724823,True,0,No user reviews,0,0,0
724824,True,0,No user reviews,0,0,0
724825,True,0,No user reviews,0,0,0
724826,True,0,No user reviews,0,0,0
724827,True,0,No user reviews,0,0,0
724828,True,0,No user reviews,0,0,0
724829,True,0,No user reviews,0,0,0
724830,True,0,No user reviews,0,0,0
724831,True,0,No user reviews,0,0,0
724840,True,0,2 user reviews,2,0,2
724850,True,0,1 user reviews,1,0,1
724851,True,0,No user reviews,0,0,0
724852,True,0,No user reviews,0,0,0
724853,True,0,No user reviews,0,0,0
724854,True,0,No user reviews,0,0,0
724855,True,0,No user reviews,0,0,0
724856,True,0,No user reviews,0,0,0
724857,True,0,No user reviews,0,0,0
724858,True,0,No user reviews,0,0,0
724859,True,0,No user reviews,0,0,0
724860,True,0,No user reviews,0,0,0
724861,True,0,No user reviews,0,0,0
724870,True,0,No user reviews,0,0,0
724890,True,0,No user reviews,0,0,0
724900,True,0,4 user reviews,2,2,4
724910,True,0,No user reviews,0,0,0
724920,True,0,2 user reviews,1,1,2
724930,True,0,No user reviews,0,0,0
724940,True,0,6 user reviews,2,4,6
724950,True,0,No user reviews,0,0,0
724960,True,0,No user reviews,0,0,0
724970,True,6,Mostly Positive,57,16,73
724980,True,7,Positive,17,1,18
725010,True,0,No user reviews,0,0,0
725020,True,0,No user reviews,0,0,0
725030,True,0,1 user reviews,1,0,1
725040,True,7,Positive,19,2,21
725050,True,0,1 user reviews,1,0,1
725080,True,6,Mostly Positive,7,3,10
725090,True,0,No user reviews,0,0,0
725100,True,0,No user reviews,0,0,0
725110,True,0,6 user reviews,4,2,6
725120,True,7,Positive,36,3,39
725130,True,0,No user reviews,0,0,0
725140,True,0,No user reviews,0,0,0
725150,True,0,No user reviews,0,0,0
725170,True,7,Positive,10,1,11
725260,True,0,No user reviews,0,0,0
725270,True,8,Very Positive,270,22,292
725280,True,0,9 user reviews,5,4,9
725310,True,0,No user reviews,0,0,0
725320,True,0,1 user reviews,0,1,1
725330,True,8,Very Positive,54,2,56
725340,True,0,No user reviews,0,0,0
725353,True,5,Mixed,74,34,108
725370,True,5,Mixed,12,15,27
725380,True,0,7 user reviews,7,0,7
725400,True,5,Mixed,9,10,19
725410,True,7,Positive,28,2,30
725420,True,0,No user reviews,0,0,0
725430,True,0,1 user reviews,1,0,1
725460,True,0,No user reviews,0,0,0
725461,True,0,No user reviews,0,0,0
725462,True,0,No user reviews,0,0,0
725463,True,0,No user reviews,0,0,0
725464,True,0,No user reviews,0,0,0
725465,True,0,No user reviews,0,0,0
725466,True,0,No user reviews,0,0,0
725467,True,0,No user reviews,0,0,0
725468,True,0,No user reviews,0,0,0
725469,True,0,No user reviews,0,0,0
725470,True,0,No user reviews,0,0,0
725471,True,0,No user reviews,0,0,0
725480,True,9,Overwhelmingly Positive,1790,89,1879
725510,True,0,No user reviews,0,0,0
725520,True,0,No user reviews,0,0,0
725521,True,0,No user reviews,0,0,0
725522,True,0,No user reviews,0,0,0
725523,True,0,No user reviews,0,0,0
725524,True,0,No user reviews,0,0,0
725525,True,0,No user reviews,0,0,0
725526,True,0,No user reviews,0,0,0
725527,True,0,No user reviews,0,0,0
725528,True,0,No user reviews,0,0,0
725529,True,0,No user reviews,0,0,0
725530,True,0,No user reviews,0,0,0
725531,True,0,No user reviews,0,0,0
725540,True,0,No user reviews,0,0,0
725550,True,0,2 user reviews,1,1,2
725580,True,0,No user reviews,0,0,0
725581,True,0,No user reviews,0,0,0
725582,True,0,No user reviews,0,0,0
725583,True,0,No user reviews,0,0,0
725584,True,0,No user reviews,0,0,0
725585,True,0,No user reviews,0,0,0
725586,True,0,No user reviews,0,0,0
725587,True,0,No user reviews,0,0,0
725588,True,0,No user reviews,0,0,0
725589,True,0,No user reviews,0,0,0
725590,True,0,No user reviews,0,0,0
725591,True,0,No user reviews,0,0,0
725610,True,7,Positive,11,2,13
725620,True,0,1 user reviews,1,0,1
725640,True,0,4 user reviews,3,1,4
725660,True,0,No user reviews,0,0,0
725680,True,0,8 user reviews,5,3,8
725720,True,0,No user reviews,0,0,0
725721,True,0,No user reviews,0,0,0
725722,True,0,No user reviews,0,0,0
725723,True,0,No user reviews,0,0,0
725724,True,0,No user reviews,0,0,0
725725,True,0,No user reviews,0,0,0
725726,True,0,No user reviews,0,0,0
725727,True,0,No user reviews,0,0,0
725728,True,0,No user reviews,0,0,0
725729,True,0,No user reviews,0,0,0
725730,True,0,No user reviews,0,0,0
725731,True,0,No user reviews,0,0,0
725740,True,0,No user reviews,0,0,0
725741,True,0,No user reviews,0,0,0
725742,True,0,No user reviews,0,0,0
725743,True,0,No user reviews,0,0,0
725744,True,0,No user reviews,0,0,0
725745,True,0,No user reviews,0,0,0
725746,True,0,No user reviews,0,0,0
725747,True,0,No user reviews,0,0,0
725748,True,0,No user reviews,0,0,0
725749,True,0,No user reviews,0,0,0
725750,True,0,No user reviews,0,0,0
725751,True,0,No user reviews,0,0,0
725780,True,6,Mostly Positive,34,13,47
725790,True,0,No user reviews,0,0,0
725850,True,7,Positive,11,0,11
725860,True,0,No user reviews,0,0,0
725870,True,0,No user reviews,0,0,0
725880,True,0,No user reviews,0,0,0
725890,True,0,No user reviews,0,0,0
725910,True,0,1 user reviews,1,0,1
725920,True,0,No user reviews,0,0,0
725950,True,0,2 user reviews,0,2,2
725960,True,4,Mostly Negative,12,23,35
725970,True,0,6 user reviews,5,1,6
725980,True,0,No user reviews,0,0,0
726000,True,7,Positive,36,4,40
726020,True,7,Positive,20,4,24
726030,True,0,3 user reviews,0,3,3
726050,True,7,Positive,21,4,25
726060,True,0,4 user reviews,0,4,4
726070,True,3,Negative,2,13,15
726100,True,0,No user reviews,0,0,0
726110,True,8,Very Positive,512,50,562
726120,True,6,Mostly Positive,9,3,12
726140,True,0,No user reviews,0,0,0
726160,True,0,No user reviews,0,0,0
726190,True,0,1 user reviews,1,0,1
726200,True,8,Very Positive,76,18,94
726230,True,7,Positive,19,1,20
726240,True,0,No user reviews,0,0,0
726250,True,8,Very Positive,120,17,137
726260,True,0,No user reviews,0,0,0
726300,True,0,3 user reviews,3,0,3
726310,True,0,No user reviews,0,0,0
726320,True,6,Mostly Positive,9,3,12
726330,True,0,1 user reviews,1,0,1
726340,True,6,Mostly Positive,24,7,31
726360,True,5,Mixed,242,133,375
726370,True,0,No user reviews,0,0,0
726380,True,0,9 user reviews,8,1,9
726390,True,0,No user reviews,0,0,0
726400,True,0,No user reviews,0,0,0
726410,True,0,No user reviews,0,0,0
726430,True,5,Mixed,9,7,16
726440,True,0,No user reviews,0,0,0
726450,True,0,1 user reviews,1,0,1
726460,True,0,8 user reviews,5,3,8
726470,True,0,No user reviews,0,0,0
726480,True,7,Positive,33,3,36
726490,True,0,3 user reviews,2,1,3
726500,True,0,1 user reviews,1,0,1
726510,True,7,Positive,13,3,16
726520,True,0,1 user reviews,1,0,1
726530,True,0,No user reviews,0,0,0
726550,True,0,No user reviews,0,0,0
726560,True,7,Positive,23,0,23
726570,True,0,1 user reviews,0,1,1
726580,True,5,Mixed,10,7,17
726590,True,6,Mostly Positive,140,44,184
726600,True,0,9 user reviews,5,4,9
726610,True,0,No user reviews,0,0,0
726620,True,5,Mixed,6,6,12
726630,True,7,Positive,12,1,13
726660,True,0,No user reviews,0,0,0
726670,True,0,No user reviews,0,0,0
726690,True,7,Positive,22,1,23
726700,True,0,1 user reviews,1,0,1
726710,True,0,7 user reviews,4,3,7
726720,True,6,Mostly Positive,11,4,15
726740,True,0,No user reviews,0,0,0
726760,True,5,Mixed,9,9,18
726770,True,0,No user reviews,0,0,0
726780,True,0,No user reviews,0,0,0
726790,True,0,No user reviews,0,0,0
726791,True,0,No user reviews,0,0,0
726792,True,0,No user reviews,0,0,0
726793,True,0,No user reviews,0,0,0
726794,True,0,No user reviews,0,0,0
726795,True,0,No user reviews,0,0,0
726796,True,0,No user reviews,0,0,0
726797,True,0,No user reviews,0,0,0
726798,True,0,No user reviews,0,0,0
726799,True,0,No user reviews,0,0,0
726800,True,0,6 user reviews,1,5,6
726810,True,0,1 user reviews,1,0,1
726820,True,0,2 user reviews,2,0,2
726830,True,8,Very Positive,337,27,364
726840,True,8,Very Positive,133,23,156
726870,True,7,Positive,19,1,20
726880,True,7,Positive,12,0,12
726910,True,0,No user reviews,0,0,0
726920,True,0,No user reviews,0,0,0
726950,True,5,Mixed,20,23,43
726970,True,0,No user reviews,0,0,0
726980,True,0,No user reviews,0,0,0
726990,True,8,Very Positive,86,13,99
727010,True,0,1 user reviews,0,1,1
727020,True,7,Positive,18,0,18
727030,True,0,No user reviews,0,0,0
727040,True,7,Positive,12,1,13
727050,True,0,1 user reviews,0,1,1
727060,True,0,4 user reviews,2,2,4
727070,True,0,9 user reviews,7,2,9
727080,True,0,1 user reviews,1,0,1
727090,True,4,Mostly Negative,11,17,28
727100,True,7,Positive,8,2,10
727110,True,0,2 user reviews,1,1,2
727130,True,8,Very Positive,522,102,624
727140,True,0,3 user reviews,3,0,3
727150,True,0,2 user reviews,2,0,2
727160,True,0,No user reviews,0,0,0
727170,True,5,Mixed,7,10,17
727180,True,4,Mostly Negative,5,9,14
727190,True,5,Mixed,9,5,14
727200,True,0,5 user reviews,5,0,5
727210,True,0,No user reviews,0,0,0
727220,True,6,Mostly Positive,7,3,10
727230,True,0,No user reviews,0,0,0
727260,True,0,No user reviews,0,0,0
727270,True,0,No user reviews,0,0,0
727280,True,0,No user reviews,0,0,0
727290,True,7,Positive,10,1,11
727310,True,0,No user reviews,0,0,0
727320,True,0,3 user reviews,2,1,3
727330,True,0,1 user reviews,1,0,1
727340,True,6,Mostly Positive,37,10,47
727370,True,0,No user reviews,0,0,0
727400,True,0,No user reviews,0,0,0
727420,True,0,6 user reviews,6,0,6
727430,True,0,1 user reviews,1,0,1
727440,True,0,1 user reviews,1,0,1
727450,True,0,1 user reviews,1,0,1
727460,True,0,9 user reviews,5,4,9
727470,True,0,No user reviews,0,0,0
727480,True,0,5 user reviews,3,2,5
727490,True,0,1 user reviews,0,1,1
727510,True,5,Mixed,20,22,42
727520,True,0,No user reviews,0,0,0
727530,True,0,3 user reviews,1,2,3
727540,True,0,No user reviews,0,0,0
727550,True,0,6 user reviews,4,2,6
727570,True,8,Very Positive,41,10,51
727600,True,0,No user reviews,0,0,0
727610,True,0,1 user reviews,1,0,1
727630,True,0,No user reviews,0,0,0
727640,True,7,Positive,19,2,21
727660,True,0,No user reviews,0,0,0
727670,True,0,3 user reviews,3,0,3
727690,True,0,No user reviews,0,0,0
727710,True,0,No user reviews,0,0,0
727720,True,5,Mixed,14,7,21
727730,True,6,Mostly Positive,27,10,37
727740,True,0,No user reviews,0,0,0
727760,True,6,Mostly Positive,20,6,26
727770,True,0,No user reviews,0,0,0
727790,True,0,5 user reviews,5,0,5
727800,True,0,6 user reviews,4,2,6
727810,True,0,No user reviews,0,0,0
727820,True,0,No user reviews,0,0,0
727830,True,0,No user reviews,0,0,0
727840,True,0,1 user reviews,0,1,1
727850,True,8,Very Positive,447,52,499
727860,True,0,1 user reviews,0,1,1
727870,True,0,No user reviews,0,0,0
727880,True,0,No user reviews,0,0,0
727890,True,0,No user reviews,0,0,0
727900,True,0,3 user reviews,2,1,3
727910,True,5,Mixed,78,50,128
727930,True,7,Positive,45,4,49
727940,True,0,No user reviews,0,0,0
727960,True,0,No user reviews,0,0,0
727970,True,0,2 user reviews,1,1,2
727980,True,0,2 user reviews,2,0,2
727990,True,0,1 user reviews,0,1,1
728000,True,0,No user reviews,0,0,0
728020,True,0,2 user reviews,2,0,2
728032,True,0,3 user reviews,3,0,3
728050,True,0,6 user reviews,1,5,6
728060,True,0,No user reviews,0,0,0
728070,True,6,Mostly Positive,14,5,19
728080,True,0,No user reviews,0,0,0
728090,True,0,No user reviews,0,0,0
728100,True,0,No user reviews,0,0,0
728110,True,0,No user reviews,0,0,0
728150,True,0,7 user reviews,3,4,7
728170,True,0,No user reviews,0,0,0
728190,True,7,Positive,19,0,19
728200,True,0,No user reviews,0,0,0
728210,True,0,No user reviews,0,0,0
728220,True,0,3 user reviews,3,0,3
728240,True,8,Very Positive,90,22,112
728260,True,0,No user reviews,0,0,0
728270,True,0,No user reviews,0,0,0
728290,True,0,No user reviews,0,0,0
728300,True,7,Positive,15,1,16
728301,True,0,5 user reviews,4,1,5
728302,True,6,Mostly Positive,12,4,16
728310,True,0,No user reviews,0,0,0
728320,True,0,No user reviews,0,0,0
728330,True,0,No user reviews,0,0,0
728340,True,0,No user reviews,0,0,0
728350,True,0,1 user reviews,1,0,1
728360,True,0,No user reviews,0,0,0
728370,True,0,No user reviews,0,0,0
728380,True,0,No user reviews,0,0,0
728420,True,6,Mostly Positive,16,6,22
728430,True,0,No user reviews,0,0,0
728440,True,8,Very Positive,52,12,64
728450,True,0,No user reviews,0,0,0
728460,True,0,No user reviews,0,0,0
728461,True,0,No user reviews,0,0,0
728462,True,0,No user reviews,0,0,0
728463,True,0,No user reviews,0,0,0
728470,True,0,No user reviews,0,0,0
728500,True,0,No user reviews,0,0,0
728520,True,0,No user reviews,0,0,0
728530,True,8,Very Positive,923,72,995
728540,True,5,Mixed,1817,1707,3524
728550,True,0,No user reviews,0,0,0
728590,True,0,No user reviews,0,0,0
728600,True,0,8 user reviews,7,1,8
728610,True,0,1 user reviews,1,0,1
728620,True,0,No user reviews,0,0,0
728630,True,4,Mostly Negative,4,7,11
728640,True,0,No user reviews,0,0,0
728670,True,0,2 user reviews,1,1,2
728700,True,0,1 user reviews,1,0,1
728710,True,0,1 user reviews,1,0,1
728720,True,0,No user reviews,0,0,0
728730,True,0,No user reviews,0,0,0
728740,True,5,Mixed,259,153,412
728770,True,0,No user reviews,0,0,0
728780,True,0,2 user reviews,2,0,2
728781,True,0,4 user reviews,3,1,4
728810,True,0,No user reviews,0,0,0
728830,True,0,4 user reviews,4,0,4
728850,True,7,Positive,35,7,42
728870,True,7,Positive,22,3,25
728880,True,8,Very Positive,4117,285,4402
728910,True,7,Positive,16,0,16
728920,True,0,7 user reviews,5,2,7
728950,True,0,4 user reviews,2,2,4
728980,True,0,No user reviews,0,0,0
728990,True,0,5 user reviews,2,3,5
729000,True,0,No user reviews,0,0,0
729020,True,0,2 user reviews,2,0,2
729030,True,4,Mostly Negative,3,9,12
729040,True,8,Very Positive,3600,675,4275
729050,True,0,2 user reviews,2,0,2
729060,True,6,Mostly Positive,34,14,48
729090,True,4,Mostly Negative,4,9,13
729130,True,0,1 user reviews,1,0,1
729160,True,8,Very Positive,48,2,50
729180,True,0,No user reviews,0,0,0
729190,True,0,7 user reviews,4,3,7
729200,True,0,No user reviews,0,0,0
729210,True,0,No user reviews,0,0,0
729220,True,5,Mixed,8,6,14
729230,True,0,1 user reviews,0,1,1
729240,True,0,3 user reviews,2,1,3
729250,True,0,No user reviews,0,0,0
729260,True,0,No user reviews,0,0,0
729270,True,0,No user reviews,0,0,0
729290,True,0,No user reviews,0,0,0
729300,True,7,Positive,18,0,18
729310,True,0,9 user reviews,4,5,9
729320,True,0,No user reviews,0,0,0
729330,True,5,Mixed,15,13,28
729340,True,0,1 user reviews,0,1,1
729360,True,0,No user reviews,0,0,0
729370,True,7,Positive,35,2,37
729390,True,0,4 user reviews,4,0,4
729410,True,0,1 user reviews,1,0,1
729420,True,0,No user reviews,0,0,0
729440,True,0,No user reviews,0,0,0
729450,True,7,Positive,38,6,44
729460,True,5,Mixed,14,8,22
729470,True,5,Mixed,7,4,11
729490,True,0,7 user reviews,6,1,7
729500,True,0,No user reviews,0,0,0
729520,True,0,No user reviews,0,0,0
729530,True,6,Mostly Positive,38,15,53
729540,True,0,No user reviews,0,0,0
729560,True,0,No user reviews,0,0,0
729570,True,7,Positive,14,3,17
729580,True,0,4 user reviews,4,0,4
729590,True,0,No user reviews,0,0,0
729600,True,0,1 user reviews,1,0,1
729610,True,0,No user reviews,0,0,0
729620,True,0,1 user reviews,0,1,1
729630,True,0,1 user reviews,1,0,1
729640,True,0,6 user reviews,6,0,6
729650,True,0,No user reviews,0,0,0
729660,True,7,Positive,31,4,35
729670,True,5,Mixed,7,9,16
729680,True,0,No user reviews,0,0,0
729690,True,0,No user reviews,0,0,0
729720,True,5,Mixed,15,11,26
729760,True,0,4 user reviews,3,1,4
729780,True,0,1 user reviews,1,0,1
729800,True,0,1 user reviews,1,0,1
729820,True,0,No user reviews,0,0,0
729830,True,0,No user reviews,0,0,0
729840,True,0,2 user reviews,2,0,2
729850,True,0,9 user reviews,8,1,9
729910,True,0,1 user reviews,0,1,1
729920,True,0,2 user reviews,2,0,2
729930,True,0,2 user reviews,1,1,2
729940,True,0,2 user reviews,2,0,2
729950,True,0,2 user reviews,2,0,2
729960,True,0,1 user reviews,1,0,1
729970,True,0,4 user reviews,4,0,4
729980,True,0,8 user reviews,8,0,8
729990,True,0,1 user reviews,1,0,1
730000,True,8,Very Positive,184,35,219
730010,True,0,1 user reviews,0,1,1
730020,True,0,No user reviews,0,0,0
730030,True,5,Mixed,11,5,16
730040,True,0,1 user reviews,1,0,1
730050,True,8,Very Positive,187,41,228
730070,True,0,No user reviews,0,0,0
730080,True,0,No user reviews,0,0,0
730090,True,0,No user reviews,0,0,0
730100,True,0,No user reviews,0,0,0
730101,True,0,No user reviews,0,0,0
730102,True,0,No user reviews,0,0,0
730103,True,0,No user reviews,0,0,0
730104,True,0,No user reviews,0,0,0
730105,True,0,No user reviews,0,0,0
730106,True,0,No user reviews,0,0,0
730107,True,0,No user reviews,0,0,0
730108,True,0,No user reviews,0,0,0
730109,True,0,No user reviews,0,0,0
730110,True,0,No user reviews,0,0,0
730111,True,0,No user reviews,0,0,0
730112,True,0,No user reviews,0,0,0
730113,True,0,No user reviews,0,0,0
730120,True,0,7 user reviews,5,2,7
730160,True,0,No user reviews,0,0,0
730170,True,0,2 user reviews,1,1,2
730180,True,0,1 user reviews,1,0,1
730190,True,0,4 user reviews,2,2,4
730210,True,0,No user reviews,0,0,0
730220,True,5,Mixed,6,6,12
730230,True,0,No user reviews,0,0,0
730240,True,0,No user reviews,0,0,0
730260,True,6,Mostly Positive,15,5,20
730261,True,0,9 user reviews,2,7,9
730262,True,0,7 user reviews,4,3,7
730270,True,0,9 user reviews,9,0,9
730280,True,0,1 user reviews,0,1,1
730290,True,6,Mostly Positive,9,3,12
730300,True,7,Positive,12,0,12
730310,True,5,Mixed,421,395,816
730340,True,0,No user reviews,0,0,0
730350,True,0,2 user reviews,2,0,2
730390,True,8,Very Positive,405,13,418
730410,True,4,Mostly Negative,49,85,134
730420,True,0,No user reviews,0,0,0
730450,True,0,9 user reviews,6,3,9
730460,True,0,1 user reviews,0,1,1
730480,True,0,3 user reviews,2,1,3
730490,True,0,1 user reviews,1,0,1
730500,True,0,No user reviews,0,0,0
730510,True,0,8 user reviews,8,0,8
730520,True,0,1 user reviews,1,0,1
730530,True,0,2 user reviews,2,0,2
730540,True,0,No user reviews,0,0,0
730550,True,0,No user reviews,0,0,0
730570,True,0,No user reviews,0,0,0
730580,True,0,6 user reviews,4,2,6
730590,True,0,No user reviews,0,0,0
730611,True,0,2 user reviews,2,0,2
730612,True,0,1 user reviews,1,0,1
730613,True,0,2 user reviews,1,1,2
730614,True,0,7 user reviews,7,0,7
730615,True,0,1 user reviews,0,1,1
730616,True,0,4 user reviews,3,1,4
730617,True,0,No user reviews,0,0,0
730618,True,0,2 user reviews,2,0,2
730619,True,0,3 user reviews,2,1,3
730620,True,5,Mixed,27,12,39
730640,True,0,No user reviews,0,0,0
730670,True,0,1 user reviews,1,0,1
730690,True,0,No user reviews,0,0,0
730700,True,0,3 user reviews,3,0,3
730710,True,0,2 user reviews,0,2,2
730720,True,7,Positive,20,1,21
730730,True,0,No user reviews,0,0,0
730750,True,0,6 user reviews,5,1,6
730760,True,0,2 user reviews,0,2,2
730780,True,0,1 user reviews,1,0,1
730790,True,0,2 user reviews,2,0,2
730800,True,0,No user reviews,0,0,0
730810,True,0,No user reviews,0,0,0
730820,True,9,Overwhelmingly Positive,567,11,578
730830,True,5,Mixed,58,38,96
730840,True,7,Positive,41,0,41
730850,True,0,No user reviews,0,0,0
730860,True,7,Positive,10,2,12
730870,True,8,Very Positive,59,3,62
730890,True,0,No user reviews,0,0,0
730900,True,0,No user reviews,0,0,0
730901,True,0,No user reviews,0,0,0
730902,True,0,No user reviews,0,0,0
730903,True,0,No user reviews,0,0,0
730904,True,0,No user reviews,0,0,0
730905,True,0,No user reviews,0,0,0
730920,True,7,Positive,46,3,49
730930,True,0,No user reviews,0,0,0
730940,True,0,No user reviews,0,0,0
730960,True,0,No user reviews,0,0,0
731000,True,5,Mixed,5,6,11
731010,True,0,No user reviews,0,0,0
731020,True,0,No user reviews,0,0,0
731030,True,0,No user reviews,0,0,0
731040,True,0,No user reviews,0,0,0
731080,True,0,No user reviews,0,0,0
731090,True,0,No user reviews,0,0,0
731100,True,0,1 user reviews,1,0,1
731101,True,0,2 user reviews,2,0,2
731110,True,0,No user reviews,0,0,0
731120,True,0,3 user reviews,1,2,3
731130,True,0,1 user reviews,1,0,1
731140,True,0,No user reviews,0,0,0
731150,True,0,3 user reviews,1,2,3
731160,True,0,1 user reviews,0,1,1
731170,True,0,1 user reviews,1,0,1
731171,True,0,2 user reviews,1,1,2
731172,True,0,3 user reviews,2,1,3
731180,True,0,No user reviews,0,0,0
731190,True,0,2 user reviews,1,1,2
731200,True,0,No user reviews,0,0,0
731210,True,0,No user reviews,0,0,0
731220,True,0,No user reviews,0,0,0
731230,True,5,Mixed,9,5,14
731240,True,0,No user reviews,0,0,0
731250,True,5,Mixed,16,8,24
731270,True,0,No user reviews,0,0,0
731300,True,0,No user reviews,0,0,0
731310,True,5,Mixed,8,5,13
731320,True,7,Positive,12,1,13
731350,True,0,No user reviews,0,0,0
731360,True,0,No user reviews,0,0,0
731370,True,0,No user reviews,0,0,0
731390,True,0,1 user reviews,1,0,1
731410,True,0,No user reviews,0,0,0
731420,True,7,Positive,14,3,17
731430,True,0,No user reviews,0,0,0
731440,True,0,No user reviews,0,0,0
731450,True,0,4 user reviews,1,3,4
731460,True,0,2 user reviews,1,1,2
731490,True,8,Very Positive,3068,216,3284
731500,True,0,No user reviews,0,0,0
731510,True,0,5 user reviews,5,0,5
731520,True,0,4 user reviews,4,0,4
731540,True,0,No user reviews,0,0,0
731550,True,0,No user reviews,0,0,0
731551,True,0,No user reviews,0,0,0
731552,True,0,No user reviews,0,0,0
731560,True,7,Positive,27,1,28
731590,True,5,Mixed,46,23,69
731600,True,7,Positive,12,0,12
731610,True,0,No user reviews,0,0,0
731620,True,5,Mixed,454,292,746
731630,True,0,No user reviews,0,0,0
731650,True,5,Mixed,11,7,18
731670,True,0,2 user reviews,2,0,2
731680,True,0,No user reviews,0,0,0
731690,True,0,2 user reviews,1,1,2
731700,True,0,4 user reviews,2,2,4
731720,True,5,Mixed,22,20,42
731730,True,0,No user reviews,0,0,0
731750,True,0,No user reviews,0,0,0
731760,True,0,6 user reviews,1,5,6
731770,True,0,No user reviews,0,0,0
731780,True,0,No user reviews,0,0,0
731790,True,0,1 user reviews,0,1,1
731810,True,0,No user reviews,0,0,0
731820,True,0,3 user reviews,3,0,3
731850,True,0,No user reviews,0,0,0
731860,True,0,No user reviews,0,0,0
731880,True,5,Mixed,23,24,47
731890,True,0,8 user reviews,6,2,8
731900,True,0,No user reviews,0,0,0
731901,True,0,No user reviews,0,0,0
731902,True,0,No user reviews,0,0,0
731903,True,0,No user reviews,0,0,0
731904,True,0,No user reviews,0,0,0
731910,True,0,No user reviews,0,0,0
731920,True,5,Mixed,54,62,116
731930,True,0,5 user reviews,4,1,5
731940,True,7,Positive,24,6,30
731950,True,0,6 user reviews,5,1,6
731960,True,0,No user reviews,0,0,0
731970,True,0,No user reviews,0,0,0
731980,True,0,No user reviews,0,0,0
731990,True,0,No user reviews,0,0,0
732010,True,0,No user reviews,0,0,0
732030,True,0,9 user reviews,8,1,9
732040,True,0,2 user reviews,2,0,2
732050,True,0,No user reviews,0,0,0
732060,True,0,4 user reviews,1,3,4
732070,True,0,5 user reviews,4,1,5
732080,True,0,No user reviews,0,0,0
732090,True,0,5 user reviews,2,3,5
732110,True,0,3 user reviews,2,1,3
732120,True,0,No user reviews,0,0,0
732160,True,5,Mixed,36,26,62
732170,True,0,No user reviews,0,0,0
732180,True,0,No user reviews,0,0,0
732190,True,0,2 user reviews,2,0,2
732200,True,0,No user reviews,0,0,0
732220,True,0,No user reviews,0,0,0
732240,True,6,Mostly Positive,236,60,296
732270,True,0,No user reviews,0,0,0
732280,True,0,No user reviews,0,0,0
732290,True,0,3 user reviews,3,0,3
732340,True,0,No user reviews,0,0,0
732360,True,0,No user reviews,0,0,0
732370,True,8,Very Positive,134,22,156
732390,True,0,1 user reviews,1,0,1
732400,True,8,Very Positive,44,9,53
732410,True,0,1 user reviews,0,1,1
732430,True,9,Overwhelmingly Positive,5310,152,5462
732440,True,0,No user reviews,0,0,0
732460,True,8,Very Positive,54,5,59
732470,True,7,Positive,8,2,10
732480,True,0,6 user reviews,3,3,6
732500,True,0,No user reviews,0,0,0
732510,True,0,5 user reviews,3,2,5
732520,True,5,Mixed,12,9,21
732570,True,0,No user reviews,0,0,0
732590,True,0,No user reviews,0,0,0
732610,True,0,No user reviews,0,0,0
732620,True,0,No user reviews,0,0,0
732630,True,0,No user reviews,0,0,0
732640,True,0,No user reviews,0,0,0
732650,True,0,No user reviews,0,0,0
732670,True,0,No user reviews,0,0,0
732680,True,0,1 user reviews,0,1,1
732690,True,9,Overwhelmingly Positive,2439,71,2510
732700,True,0,3 user reviews,3,0,3
732710,True,0,No user reviews,0,0,0
732730,True,0,No user reviews,0,0,0
732760,True,0,No user reviews,0,0,0
732770,True,7,Positive,15,1,16
732790,True,0,No user reviews,0,0,0
732791,True,0,No user reviews,0,0,0
732800,True,0,2 user reviews,1,1,2
732810,True,8,Very Positive,405,31,436
732820,True,0,1 user reviews,1,0,1
732840,True,0,5 user reviews,3,2,5
732850,True,0,1 user reviews,1,0,1
732860,True,0,4 user reviews,3,1,4
732890,True,0,6 user reviews,6,0,6
732900,True,0,No user reviews,0,0,0
732930,True,7,Positive,19,0,19
732950,True,0,No user reviews,0,0,0
732960,True,0,No user reviews,0,0,0
732970,True,0,No user reviews,0,0,0
732980,True,0,No user reviews,0,0,0
733000,True,0,No user reviews,0,0,0
733010,True,0,No user reviews,0,0,0
733020,True,0,6 user reviews,5,1,6
733030,True,0,4 user reviews,2,2,4
733040,True,0,1 user reviews,0,1,1
733050,True,8,Very Positive,83,6,89
733060,True,0,5 user reviews,0,5,5
733070,True,8,Very Positive,184,21,205
733080,True,0,1 user reviews,1,0,1
733090,True,5,Mixed,13,6,19
733100,True,0,No user reviews,0,0,0
733110,True,0,No user reviews,0,0,0
733130,True,0,No user reviews,0,0,0
733140,True,8,Very Positive,60,6,66
733170,True,0,No user reviews,0,0,0
733180,True,0,7 user reviews,5,2,7
733200,True,0,2 user reviews,2,0,2
733210,True,8,Very Positive,284,26,310
733220,True,0,No user reviews,0,0,0
733230,True,0,3 user reviews,0,3,3
733250,True,0,5 user reviews,4,1,5
733300,True,8,Very Positive,127,9,136
733330,True,0,No user reviews,0,0,0
733340,True,8,Very Positive,103,10,113
733360,True,0,No user reviews,0,0,0
733390,True,0,No user reviews,0,0,0
733391,True,0,No user reviews,0,0,0
733400,True,0,No user reviews,0,0,0
733420,True,0,No user reviews,0,0,0
733430,True,0,7 user reviews,1,6,7
733440,True,0,6 user reviews,0,6,6
733460,True,6,Mostly Positive,81,33,114
733480,True,0,No user reviews,0,0,0
733490,True,0,No user reviews,0,0,0
733500,True,0,2 user reviews,2,0,2
733510,True,0,4 user reviews,4,0,4
733520,True,0,4 user reviews,3,1,4
733530,True,0,3 user reviews,3,0,3
733540,True,0,7 user reviews,6,1,7
733550,True,0,4 user reviews,1,3,4
733560,True,0,No user reviews,0,0,0
733570,True,0,1 user reviews,1,0,1
733600,True,0,No user reviews,0,0,0
733610,True,5,Mixed,6,4,10
733620,True,0,No user reviews,0,0,0
733670,True,0,4 user reviews,2,2,4
733690,True,5,Mixed,6,4,10
733700,True,0,No user reviews,0,0,0
733710,True,0,No user reviews,0,0,0
733740,True,8,Very Positive,56,5,61
733750,True,0,No user reviews,0,0,0
733760,True,0,9 user reviews,8,1,9
733770,True,0,9 user reviews,2,7,9
733790,True,8,Very Positive,604,87,691
733800,True,6,Mostly Positive,33,11,44
733810,True,0,2 user reviews,2,0,2
733820,True,0,No user reviews,0,0,0
733830,True,0,No user reviews,0,0,0
733840,True,0,No user reviews,0,0,0
733870,True,0,2 user reviews,2,0,2
733880,True,0,1 user reviews,1,0,1
733910,True,0,2 user reviews,2,0,2
733940,True,0,6 user reviews,0,6,6
733950,True,0,No user reviews,0,0,0
733990,True,8,Very Positive,907,69,976
734020,True,5,Mixed,14,19,33
734030,True,0,No user reviews,0,0,0
734060,True,0,No user reviews,0,0,0
734070,True,0,5 user reviews,5,0,5
734080,True,0,5 user reviews,2,3,5
734090,True,0,1 user reviews,1,0,1
734120,True,6,Mostly Positive,38,12,50
734130,True,0,No user reviews,0,0,0
734150,True,0,No user reviews,0,0,0
734151,True,0,No user reviews,0,0,0
734160,True,0,No user reviews,0,0,0
734170,True,0,No user reviews,0,0,0
734190,True,0,No user reviews,0,0,0
734200,True,0,No user reviews,0,0,0
734201,True,0,No user reviews,0,0,0
734202,True,0,No user reviews,0,0,0
734203,True,0,No user reviews,0,0,0
734204,True,0,No user reviews,0,0,0
734205,True,0,No user reviews,0,0,0
734206,True,0,No user reviews,0,0,0
734207,True,0,No user reviews,0,0,0
734208,True,0,No user reviews,0,0,0
734209,True,0,No user reviews,0,0,0
734210,True,0,No user reviews,0,0,0
734211,True,0,No user reviews,0,0,0
734220,True,0,No user reviews,0,0,0
734270,True,0,No user reviews,0,0,0
734280,True,0,5 user reviews,4,1,5
734281,True,0,No user reviews,0,0,0
734282,True,5,Mixed,9,6,15
734283,True,6,Mostly Positive,8,3,11
734290,True,0,No user reviews,0,0,0
734330,True,0,No user reviews,0,0,0
734350,True,0,No user reviews,0,0,0
734380,True,4,Mostly Negative,3,7,10
734400,True,0,8 user reviews,8,0,8
734430,True,0,No user reviews,0,0,0
734440,True,0,No user reviews,0,0,0
734450,True,0,5 user reviews,4,1,5
734460,True,0,No user reviews,0,0,0
734461,True,0,No user reviews,0,0,0
734462,True,0,No user reviews,0,0,0
734470,True,0,No user reviews,0,0,0
734490,True,0,5 user reviews,5,0,5
734500,True,0,No user reviews,0,0,0
734510,True,6,Mostly Positive,41,16,57
734520,True,0,No user reviews,0,0,0
734530,True,0,No user reviews,0,0,0
734540,True,5,Mixed,5,6,11
734550,True,0,No user reviews,0,0,0
734570,True,5,Mixed,11,10,21
734580,True,0,2 user reviews,1,1,2
734590,True,4,Mostly Negative,6,18,24
734700,True,7,Positive,16,1,17
734730,True,5,Mixed,14,8,22
734740,True,7,Positive,36,3,39
734750,True,0,No user reviews,0,0,0
734810,True,0,No user reviews,0,0,0
734820,True,0,4 user reviews,3,1,4
734830,True,5,Mixed,25,19,44
734840,True,0,6 user reviews,4,2,6
734860,True,0,No user reviews,0,0,0
734861,True,0,No user reviews,0,0,0
734862,True,0,No user reviews,0,0,0
734863,True,0,No user reviews,0,0,0
734864,True,0,No user reviews,0,0,0
734865,True,0,No user reviews,0,0,0
734866,True,0,No user reviews,0,0,0
734867,True,0,No user reviews,0,0,0
734868,True,0,No user reviews,0,0,0
734869,True,0,No user reviews,0,0,0
734870,True,0,1 user reviews,1,0,1
734880,True,8,Very Positive,57,3,60
734890,True,0,2 user reviews,2,0,2
734900,True,7,Positive,26,1,27
734910,True,0,No user reviews,0,0,0
734920,True,8,Very Positive,132,7,139
734930,True,0,No user reviews,0,0,0
734940,True,0,No user reviews,0,0,0
734941,True,0,No user reviews,0,0,0
734942,True,0,No user reviews,0,0,0
734943,True,0,No user reviews,0,0,0
734944,True,0,No user reviews,0,0,0
734945,True,0,No user reviews,0,0,0
734946,True,0,No user reviews,0,0,0
734947,True,0,No user reviews,0,0,0
734948,True,0,No user reviews,0,0,0
734949,True,0,1 user reviews,1,0,1
734950,True,0,No user reviews,0,0,0
734951,True,0,No user reviews,0,0,0
734960,True,0,No user reviews,0,0,0
734970,True,0,No user reviews,0,0,0
734980,True,7,Positive,38,8,46
734990,True,0,No user reviews,0,0,0
735000,True,8,Very Positive,53,4,57
735010,True,0,5 user reviews,4,1,5
735030,True,0,3 user reviews,3,0,3
735060,True,6,Mostly Positive,10,3,13
735070,True,0,1 user reviews,1,0,1
735110,True,0,3 user reviews,0,3,3
735150,True,0,1 user reviews,1,0,1
735170,True,0,No user reviews,0,0,0
735190,True,0,No user reviews,0,0,0
735200,True,0,No user reviews,0,0,0
735210,True,0,1 user reviews,1,0,1
735220,True,0,No user reviews,0,0,0
735230,True,0,1 user reviews,1,0,1
735250,True,0,No user reviews,0,0,0
735260,True,5,Mixed,6,4,10
735270,True,0,No user reviews,0,0,0
735280,True,6,Mostly Positive,129,54,183
735290,True,0,No user reviews,0,0,0
735300,True,0,No user reviews,0,0,0
735320,True,0,4 user reviews,4,0,4
735330,True,0,No user reviews,0,0,0
735350,True,5,Mixed,50,29,79
735360,True,0,7 user reviews,5,2,7
735370,True,5,Mixed,11,10,21
735390,True,0,No user reviews,0,0,0
735400,True,0,No user reviews,0,0,0
735410,True,5,Mixed,6,6,12
735420,True,0,No user reviews,0,0,0
735433,True,0,2 user reviews,2,0,2
735450,True,5,Mixed,21,10,31
735460,True,0,No user reviews,0,0,0
735470,True,0,No user reviews,0,0,0
735480,True,0,No user reviews,0,0,0
735490,True,0,1 user reviews,1,0,1
735500,True,5,Mixed,7,9,16
735510,True,0,7 user reviews,7,0,7
735520,True,0,No user reviews,0,0,0
735530,True,0,3 user reviews,2,1,3
735540,True,0,1 user reviews,0,1,1
735550,True,0,2 user reviews,1,1,2
735570,True,0,8 user reviews,6,2,8
735580,True,8,Very Positive,111,3,114
735590,True,0,5 user reviews,4,1,5
735600,True,7,Positive,22,3,25
735620,True,0,No user reviews,0,0,0
735630,True,0,No user reviews,0,0,0
735640,True,0,No user reviews,0,0,0
735650,True,0,1 user reviews,1,0,1
735680,True,0,No user reviews,0,0,0
735690,True,0,No user reviews,0,0,0
735700,True,0,3 user reviews,3,0,3
735710,True,0,No user reviews,0,0,0
735711,True,0,No user reviews,0,0,0
735712,True,0,No user reviews,0,0,0
735713,True,0,No user reviews,0,0,0
735714,True,0,No user reviews,0,0,0
735715,True,0,No user reviews,0,0,0
735716,True,0,No user reviews,0,0,0
735717,True,0,No user reviews,0,0,0
735718,True,0,No user reviews,0,0,0
735719,True,0,No user reviews,0,0,0
735720,True,0,No user reviews,0,0,0
735721,True,0,No user reviews,0,0,0
735722,True,0,No user reviews,0,0,0
735730,True,6,Mostly Positive,245,70,315
735740,True,0,No user reviews,0,0,0
735741,True,0,No user reviews,0,0,0
735760,True,0,No user reviews,0,0,0
735770,True,0,No user reviews,0,0,0
735780,True,0,No user reviews,0,0,0
735790,True,0,No user reviews,0,0,0
735791,True,0,No user reviews,0,0,0
735792,True,0,No user reviews,0,0,0
735793,True,0,No user reviews,0,0,0
735794,True,0,No user reviews,0,0,0
735795,True,0,No user reviews,0,0,0
735796,True,0,No user reviews,0,0,0
735797,True,0,No user reviews,0,0,0
735810,True,0,No user reviews,0,0,0
735830,True,0,1 user reviews,0,1,1
735850,True,0,No user reviews,0,0,0
735860,True,0,No user reviews,0,0,0
735880,True,0,No user reviews,0,0,0
735890,True,0,No user reviews,0,0,0
735900,True,0,No user reviews,0,0,0
735910,True,0,No user reviews,0,0,0
735920,True,0,No user reviews,0,0,0
735930,True,0,No user reviews,0,0,0
735940,True,0,No user reviews,0,0,0
735950,True,0,No user reviews,0,0,0
735960,True,0,No user reviews,0,0,0
735970,True,0,No user reviews,0,0,0
735980,True,0,No user reviews,0,0,0
735990,True,0,No user reviews,0,0,0
736000,True,0,No user reviews,0,0,0
736030,True,0,No user reviews,0,0,0
736050,True,0,1 user reviews,1,0,1
736080,True,0,No user reviews,0,0,0
736090,True,0,1 user reviews,1,0,1
736100,True,7,Positive,32,0,32
736110,True,5,Mixed,9,7,16
736140,True,0,No user reviews,0,0,0
736170,True,0,4 user reviews,3,1,4
736180,True,0,2 user reviews,2,0,2
736190,True,8,Very Positive,898,57,955
736200,True,0,8 user reviews,8,0,8
736210,True,0,4 user reviews,2,2,4
736220,True,8,Very Positive,4932,1146,6078
736230,True,0,1 user reviews,1,0,1
736240,True,0,No user reviews,0,0,0
736250,True,7,Positive,29,5,34
736260,True,9,Overwhelmingly Positive,5530,100,5630
736270,True,0,No user reviews,0,0,0
736280,True,0,9 user reviews,5,4,9
736290,True,0,No user reviews,0,0,0
736300,True,0,No user reviews,0,0,0
736310,True,0,No user reviews,0,0,0
736320,True,0,1 user reviews,1,0,1
736330,True,0,No user reviews,0,0,0
736340,True,7,Positive,19,2,21
736370,True,0,3 user reviews,2,1,3
736390,True,0,8 user reviews,7,1,8
736400,True,0,9 user reviews,5,4,9
736420,True,0,5 user reviews,5,0,5
736430,True,0,4 user reviews,1,3,4
736450,True,0,2 user reviews,1,1,2
736460,True,0,No user reviews,0,0,0
736470,True,0,6 user reviews,5,1,6
736480,True,0,No user reviews,0,0,0
736530,True,0,No user reviews,0,0,0
736540,True,0,No user reviews,0,0,0
736550,True,0,No user reviews,0,0,0
736570,True,8,Very Positive,214,12,226
736580,True,0,1 user reviews,1,0,1
736590,True,0,No user reviews,0,0,0
736610,True,0,1 user reviews,0,1,1
736630,True,0,No user reviews,0,0,0
736640,True,0,No user reviews,0,0,0
736650,True,0,No user reviews,0,0,0
736660,True,0,No user reviews,0,0,0
736670,True,0,No user reviews,0,0,0
736680,True,0,3 user reviews,2,1,3
736690,True,0,4 user reviews,3,1,4
736700,True,0,No user reviews,0,0,0
736710,True,7,Positive,9,2,11
736720,True,7,Positive,14,2,16
736730,True,0,No user reviews,0,0,0
736750,True,0,No user reviews,0,0,0
736770,True,5,Mixed,5,5,10
736780,True,0,No user reviews,0,0,0
736800,True,0,No user reviews,0,0,0
736810,True,6,Mostly Positive,46,12,58
736820,True,0,No user reviews,0,0,0
736830,True,0,No user reviews,0,0,0
736840,True,7,Positive,14,1,15
736850,True,6,Mostly Positive,372,115,487
736860,True,5,Mixed,33,23,56
736910,True,0,No user reviews,0,0,0
736920,True,0,No user reviews,0,0,0
736930,True,5,Mixed,9,5,14
736990,True,0,No user reviews,0,0,0
737000,True,7,Positive,15,3,18
737001,True,4,Mostly Negative,5,8,13
737002,True,7,Positive,11,2,13
737010,True,0,No user reviews,0,0,0
737020,True,0,No user reviews,0,0,0
737040,True,5,Mixed,124,69,193
737050,True,0,No user reviews,0,0,0
737070,True,0,3 user reviews,1,2,3
737080,True,0,No user reviews,0,0,0
737090,True,0,No user reviews,0,0,0
737100,True,0,No user reviews,0,0,0
737120,True,0,No user reviews,0,0,0
737130,True,0,1 user reviews,1,0,1
737230,True,0,No user reviews,0,0,0
737250,True,0,2 user reviews,2,0,2
737260,True,4,Mostly Negative,7,13,20
737270,True,8,Very Positive,68,6,74
737272,True,7,Positive,26,4,30
737280,True,0,3 user reviews,3,0,3
737320,True,0,No user reviews,0,0,0
737330,True,0,5 user reviews,4,1,5
737340,True,0,No user reviews,0,0,0
737350,True,0,No user reviews,0,0,0
737360,True,0,No user reviews,0,0,0
737361,True,0,No user reviews,0,0,0
737362,True,0,No user reviews,0,0,0
737363,True,0,No user reviews,0,0,0
737364,True,0,No user reviews,0,0,0
737365,True,0,No user reviews,0,0,0
737366,True,0,No user reviews,0,0,0
737367,True,0,No user reviews,0,0,0
737368,True,0,No user reviews,0,0,0
737369,True,0,No user reviews,0,0,0
737370,True,0,No user reviews,0,0,0
737371,True,0,No user reviews,0,0,0
737380,True,0,2 user reviews,2,0,2
737390,True,0,3 user reviews,2,1,3
737400,True,0,No user reviews,0,0,0
737410,True,0,No user reviews,0,0,0
737411,True,0,No user reviews,0,0,0
737412,True,0,No user reviews,0,0,0
737413,True,0,No user reviews,0,0,0
737414,True,0,No user reviews,0,0,0
737415,True,0,No user reviews,0,0,0
737416,True,0,No user reviews,0,0,0
737417,True,0,No user reviews,0,0,0
737418,True,0,No user reviews,0,0,0
737419,True,0,No user reviews,0,0,0
737420,True,0,No user reviews,0,0,0
737421,True,0,No user reviews,0,0,0
737430,True,0,No user reviews,0,0,0
737460,True,0,No user reviews,0,0,0
737461,True,0,No user reviews,0,0,0
737462,True,0,No user reviews,0,0,0
737463,True,0,No user reviews,0,0,0
737464,True,0,No user reviews,0,0,0
737465,True,0,No user reviews,0,0,0
737466,True,0,No user reviews,0,0,0
737467,True,0,No user reviews,0,0,0
737468,True,0,No user reviews,0,0,0
737469,True,0,No user reviews,0,0,0
737470,True,0,No user reviews,0,0,0
737480,True,0,3 user reviews,2,1,3
737490,True,0,No user reviews,0,0,0
737500,True,0,No user reviews,0,0,0
737510,True,0,6 user reviews,2,4,6
737520,True,0,No user reviews,0,0,0
737530,True,4,Mostly Negative,3,7,10
737600,True,0,2 user reviews,1,1,2
737640,True,0,No user reviews,0,0,0
737660,True,0,1 user reviews,1,0,1
737670,True,0,3 user reviews,2,1,3
737690,True,0,5 user reviews,5,0,5
737710,True,0,1 user reviews,1,0,1
737730,True,0,2 user reviews,2,0,2
737740,True,7,Positive,11,0,11
737760,True,0,No user reviews,0,0,0
737780,True,8,Very Positive,42,9,51
737790,True,0,No user reviews,0,0,0
737800,True,8,Very Positive,1201,199,1400
737810,True,0,3 user reviews,0,3,3
737820,True,0,5 user reviews,2,3,5
737830,True,0,3 user reviews,3,0,3
737840,True,0,4 user reviews,3,1,4
737860,True,0,No user reviews,0,0,0
737870,True,7,Positive,30,5,35
737880,True,5,Mixed,18,8,26
737890,True,6,Mostly Positive,48,14,62
737920,True,0,1 user reviews,1,0,1
737930,True,0,5 user reviews,5,0,5
737980,True,0,2 user reviews,2,0,2
737990,True,7,Positive,29,5,34
738000,True,5,Mixed,18,11,29
738020,True,5,Mixed,10,6,16
738030,True,0,1 user reviews,1,0,1
738050,True,0,1 user reviews,1,0,1
738060,True,0,No user reviews,0,0,0
738070,True,0,No user reviews,0,0,0
738080,True,0,3 user reviews,2,1,3
738100,True,0,No user reviews,0,0,0
738110,True,0,No user reviews,0,0,0
738120,True,0,No user reviews,0,0,0
738130,True,0,1 user reviews,1,0,1
738140,True,0,No user reviews,0,0,0
738150,True,0,No user reviews,0,0,0
738170,True,0,No user reviews,0,0,0
738171,True,0,No user reviews,0,0,0
738172,True,0,No user reviews,0,0,0
738173,True,0,No user reviews,0,0,0
738174,True,0,No user reviews,0,0,0
738175,True,0,No user reviews,0,0,0
738176,True,0,No user reviews,0,0,0
738177,True,0,No user reviews,0,0,0
738178,True,0,No user reviews,0,0,0
738179,True,0,No user reviews,0,0,0
738180,True,0,No user reviews,0,0,0
738181,True,0,No user reviews,0,0,0
738190,True,0,No user reviews,0,0,0
738200,True,0,No user reviews,0,0,0
738210,True,0,1 user reviews,1,0,1
738230,True,0,No user reviews,0,0,0
738240,True,0,No user reviews,0,0,0
738250,True,0,No user reviews,0,0,0
738260,True,0,3 user reviews,1,2,3
738270,True,6,Mostly Positive,17,5,22
738290,True,0,1 user reviews,1,0,1
738310,True,0,No user reviews,0,0,0
738320,True,0,2 user reviews,1,1,2
738350,True,0,7 user reviews,1,6,7
738360,True,0,1 user reviews,0,1,1
738361,True,0,No user reviews,0,0,0
738362,True,0,No user reviews,0,0,0
738363,True,0,No user reviews,0,0,0
738364,True,0,No user reviews,0,0,0
738365,True,0,No user reviews,0,0,0
738366,True,0,No user reviews,0,0,0
738367,True,0,No user reviews,0,0,0
738368,True,0,No user reviews,0,0,0
738369,True,0,No user reviews,0,0,0
738370,True,0,No user reviews,0,0,0
738371,True,0,No user reviews,0,0,0
738372,True,0,No user reviews,0,0,0
738380,True,0,No user reviews,0,0,0
738390,True,0,No user reviews,0,0,0
738440,True,0,6 user reviews,6,0,6
738450,True,0,8 user reviews,3,5,8
738470,True,0,No user reviews,0,0,0
738480,True,0,No user reviews,0,0,0
738500,True,0,No user reviews,0,0,0
738510,True,0,8 user reviews,8,0,8
738520,True,8,Very Positive,1450,217,1667
738530,True,5,Mixed,246,158,404
738540,True,8,Very Positive,663,88,751
738550,True,5,Mixed,16,13,29
738560,True,6,Mostly Positive,10,3,13
738580,True,0,6 user reviews,5,1,6
738590,True,0,4 user reviews,3,1,4
738600,True,0,5 user reviews,2,3,5
738610,True,5,Mixed,66,37,103
738620,True,0,2 user reviews,2,0,2
738640,True,0,No user reviews,0,0,0
738650,True,8,Very Positive,48,4,52
738680,True,0,No user reviews,0,0,0
738690,True,0,No user reviews,0,0,0
738700,True,0,3 user reviews,3,0,3
738710,True,0,2 user reviews,2,0,2
738711,True,0,2 user reviews,2,0,2
738720,True,0,2 user reviews,2,0,2
738730,True,0,1 user reviews,0,1,1
738740,True,0,No user reviews,0,0,0
738741,True,0,No user reviews,0,0,0
738742,True,0,No user reviews,0,0,0
738743,True,0,No user reviews,0,0,0
738744,True,0,No user reviews,0,0,0
738745,True,0,No user reviews,0,0,0
738746,True,0,No user reviews,0,0,0
738747,True,0,No user reviews,0,0,0
738748,True,0,No user reviews,0,0,0
738749,True,0,No user reviews,0,0,0
738750,True,0,No user reviews,0,0,0
738751,True,0,No user reviews,0,0,0
738760,True,5,Mixed,8,4,12
738770,True,0,No user reviews,0,0,0
738780,True,0,No user reviews,0,0,0
738790,True,0,4 user reviews,1,3,4
738800,True,0,No user reviews,0,0,0
738810,True,0,1 user reviews,1,0,1
738820,True,0,No user reviews,0,0,0
738830,True,0,2 user reviews,1,1,2
738840,True,0,No user reviews,0,0,0
738850,True,0,No user reviews,0,0,0
738860,True,7,Positive,13,1,14
738870,True,0,No user reviews,0,0,0
738880,True,0,No user reviews,0,0,0
738890,True,0,No user reviews,0,0,0
738900,True,0,No user reviews,0,0,0
738920,True,5,Mixed,31,28,59
738940,True,0,1 user reviews,1,0,1
738950,True,0,No user reviews,0,0,0
738960,True,0,No user reviews,0,0,0
738980,True,0,No user reviews,0,0,0
739000,True,6,Mostly Positive,26,8,34
739010,True,0,4 user reviews,4,0,4
739030,True,0,5 user reviews,0,5,5
739050,True,0,5 user reviews,0,5,5
739060,True,0,No user reviews,0,0,0
739080,True,7,Positive,27,0,27
739090,True,0,No user reviews,0,0,0
739100,True,7,Positive,10,1,11
739120,True,0,No user reviews,0,0,0
739130,True,5,Mixed,54,50,104
739160,True,0,No user reviews,0,0,0
739170,True,0,7 user reviews,5,2,7
739180,True,7,Positive,15,1,16
739190,True,6,Mostly Positive,63,19,82
739210,True,7,Positive,15,2,17
739220,True,6,Mostly Positive,12,5,17
739230,True,0,No user reviews,0,0,0
739240,True,5,Mixed,7,5,12
739250,True,0,1 user reviews,0,1,1
739251,True,0,8 user reviews,6,2,8
739253,True,0,2 user reviews,2,0,2
739255,True,0,2 user reviews,1,1,2
739256,True,0,4 user reviews,2,2,4
739260,True,0,2 user reviews,2,0,2
739270,True,0,1 user reviews,1,0,1
739280,True,8,Very Positive,46,7,53
739281,True,6,Mostly Positive,24,9,33
739282,True,6,Mostly Positive,48,17,65
739290,True,0,2 user reviews,2,0,2
739300,True,0,No user reviews,0,0,0
739360,True,0,9 user reviews,7,2,9
739390,True,0,No user reviews,0,0,0
739400,True,0,No user reviews,0,0,0
739410,True,0,7 user reviews,4,3,7
739430,True,0,No user reviews,0,0,0
739440,True,0,7 user reviews,6,1,7
739450,True,0,No user reviews,0,0,0
739460,True,0,No user reviews,0,0,0
739470,True,0,No user reviews,0,0,0
739480,True,0,No user reviews,0,0,0
739490,True,0,No user reviews,0,0,0
739500,True,0,No user reviews,0,0,0
739510,True,0,No user reviews,0,0,0
739520,True,0,No user reviews,0,0,0
739530,True,0,No user reviews,0,0,0
739540,True,6,Mostly Positive,207,68,275
739560,True,0,No user reviews,0,0,0
739561,True,0,No user reviews,0,0,0
739562,True,0,No user reviews,0,0,0
739563,True,0,No user reviews,0,0,0
739564,True,0,No user reviews,0,0,0
739565,True,0,No user reviews,0,0,0
739566,True,0,No user reviews,0,0,0
739567,True,0,No user reviews,0,0,0
739568,True,0,No user reviews,0,0,0
739569,True,0,No user reviews,0,0,0
739570,True,0,No user reviews,0,0,0
739571,True,0,No user reviews,0,0,0
739572,True,0,No user reviews,0,0,0
739573,True,0,No user reviews,0,0,0
739581,True,7,Positive,32,5,37
739590,True,0,No user reviews,0,0,0
739600,True,0,1 user reviews,1,0,1
739601,True,0,No user reviews,0,0,0
739602,True,0,No user reviews,0,0,0
739603,True,0,No user reviews,0,0,0
739604,True,0,No user reviews,0,0,0
739605,True,0,No user reviews,0,0,0
739606,True,0,No user reviews,0,0,0
739607,True,0,No user reviews,0,0,0
739608,True,0,No user reviews,0,0,0
739609,True,0,No user reviews,0,0,0
739610,True,0,No user reviews,0,0,0
739611,True,0,No user reviews,0,0,0
739620,True,0,1 user reviews,0,1,1
739630,True,9,Overwhelmingly Positive,38545,1000,39545
739640,True,0,No user reviews,0,0,0
739650,True,6,Mostly Positive,122,50,172
739660,True,0,1 user reviews,1,0,1
739690,True,0,8 user reviews,5,3,8
739700,True,0,No user reviews,0,0,0
739710,True,0,1 user reviews,1,0,1
739720,True,7,Positive,16,1,17
739730,True,0,2 user reviews,1,1,2
739760,True,0,1 user reviews,1,0,1
739761,True,0,No user reviews,0,0,0
739762,True,0,No user reviews,0,0,0
739763,True,0,No user reviews,0,0,0
739764,True,0,No user reviews,0,0,0
739765,True,0,No user reviews,0,0,0
739766,True,0,No user reviews,0,0,0
739767,True,0,No user reviews,0,0,0
739768,True,0,No user reviews,0,0,0
739769,True,0,No user reviews,0,0,0
739770,True,0,No user reviews,0,0,0
739771,True,0,No user reviews,0,0,0
739780,True,0,1 user reviews,0,1,1
739800,True,0,3 user reviews,2,1,3
739820,True,0,1 user reviews,1,0,1
739830,True,0,No user reviews,0,0,0
739831,True,0,No user reviews,0,0,0
739850,True,7,Positive,15,1,16
739860,True,0,No user reviews,0,0,0
739880,True,0,No user reviews,0,0,0
739890,True,0,No user reviews,0,0,0
739910,True,0,No user reviews,0,0,0
739930,True,0,No user reviews,0,0,0
739940,True,0,No user reviews,0,0,0
739950,True,0,3 user reviews,3,0,3
739960,True,0,No user reviews,0,0,0
739970,True,0,No user reviews,0,0,0
739980,True,8,Very Positive,61,15,76
739990,True,0,7 user reviews,4,3,7
740000,True,0,2 user reviews,1,1,2
740020,True,0,6 user reviews,6,0,6
740040,True,7,Positive,39,8,47
740050,True,0,7 user reviews,6,1,7
740060,True,0,3 user reviews,0,3,3
740070,True,0,8 user reviews,3,5,8
740080,True,8,Very Positive,64,9,73
740090,True,6,Mostly Positive,19,5,24
740140,True,4,Mostly Negative,3,10,13
740141,True,0,5 user reviews,3,2,5
740143,True,5,Mixed,28,17,45
740150,True,0,1 user reviews,1,0,1
740160,True,6,Mostly Positive,14,6,20
740170,True,0,2 user reviews,1,1,2
740190,True,0,5 user reviews,0,5,5
740200,True,5,Mixed,23,18,41
740210,True,0,No user reviews,0,0,0
740220,True,0,2 user reviews,1,1,2
740230,True,8,Very Positive,76,11,87
740240,True,6,Mostly Positive,10,3,13
740250,True,0,No user reviews,0,0,0
740260,True,7,Positive,18,3,21
740270,True,0,No user reviews,0,0,0
740280,True,5,Mixed,5,5,10
740290,True,8,Very Positive,85,13,98
740300,True,0,3 user reviews,2,1,3
740310,True,0,No user reviews,0,0,0
740320,True,6,Mostly Positive,7,3,10
740340,True,0,5 user reviews,3,2,5
740350,True,0,3 user reviews,2,1,3
740370,True,0,4 user reviews,4,0,4
740390,True,0,4 user reviews,1,3,4
740400,True,7,Positive,15,3,18
740410,True,7,Positive,25,4,29
740440,True,0,No user reviews,0,0,0
740450,True,0,No user reviews,0,0,0
740470,True,0,No user reviews,0,0,0
740480,True,0,1 user reviews,1,0,1
740481,True,0,1 user reviews,1,0,1
740482,True,0,1 user reviews,1,0,1
740483,True,0,1 user reviews,1,0,1
740484,True,0,1 user reviews,1,0,1
740485,True,0,1 user reviews,1,0,1
740486,True,0,1 user reviews,1,0,1
740487,True,0,1 user reviews,1,0,1
740488,True,0,1 user reviews,1,0,1
740489,True,0,1 user reviews,1,0,1
740490,True,0,1 user reviews,1,0,1
740491,True,0,1 user reviews,1,0,1
740500,True,0,No user reviews,0,0,0
740510,True,0,No user reviews,0,0,0
740520,True,0,2 user reviews,2,0,2
740550,True,5,Mixed,26,16,42
740560,True,0,No user reviews,0,0,0
740570,True,7,Positive,17,4,21
740580,True,0,No user reviews,0,0,0
740590,True,0,8 user reviews,6,2,8
740591,True,0,9 user reviews,8,1,9
740592,True,0,7 user reviews,7,0,7
740600,True,5,Mixed,34,23,57
740630,True,0,No user reviews,0,0,0
740640,True,0,No user reviews,0,0,0
740650,True,0,4 user reviews,4,0,4
740660,True,0,8 user reviews,7,1,8
740680,True,0,No user reviews,0,0,0
740700,True,0,No user reviews,0,0,0
740710,True,0,No user reviews,0,0,0
740720,True,0,1 user reviews,0,1,1
740730,True,0,2 user reviews,0,2,2
740740,True,0,No user reviews,0,0,0
740780,True,0,7 user reviews,6,1,7
740790,True,5,Mixed,27,16,43
740800,True,0,No user reviews,0,0,0
740810,True,5,Mixed,8,5,13
740850,True,0,No user reviews,0,0,0
740950,True,0,2 user reviews,2,0,2
740960,True,0,1 user reviews,1,0,1
740990,True,0,No user reviews,0,0,0
741010,True,0,1 user reviews,1,0,1
741020,True,0,No user reviews,0,0,0
741030,True,0,2 user reviews,1,1,2
741060,True,0,No user reviews,0,0,0
741080,True,0,1 user reviews,0,1,1
741090,True,0,No user reviews,0,0,0
741100,True,0,7 user reviews,3,4,7
741110,True,0,2 user reviews,2,0,2
741120,True,4,Mostly Negative,3,7,10
741140,True,8,Very Positive,115,8,123
741150,True,8,Very Positive,42,8,50
741160,True,0,No user reviews,0,0,0
741170,True,0,No user reviews,0,0,0
741180,True,0,No user reviews,0,0,0
741200,True,0,No user reviews,0,0,0
741250,True,8,Very Positive,56,3,59
741260,True,5,Mixed,8,8,16
741320,True,0,No user reviews,0,0,0
741340,True,0,No user reviews,0,0,0
741350,True,6,Mostly Positive,220,69,289
741360,True,0,No user reviews,0,0,0
741370,True,6,Mostly Positive,9,3,12
741380,True,0,No user reviews,0,0,0
741390,True,0,No user reviews,0,0,0
741400,True,7,Positive,20,5,25
741420,True,0,8 user reviews,6,2,8
741430,True,8,Very Positive,89,22,111
741440,True,0,No user reviews,0,0,0
741450,True,0,5 user reviews,0,5,5
741470,True,0,1 user reviews,1,0,1
741490,True,5,Mixed,8,7,15
741500,True,5,Mixed,21,20,41
741510,True,6,Mostly Positive,206,74,280
741520,True,0,8 user reviews,7,1,8
741530,True,0,No user reviews,0,0,0
741540,True,0,2 user reviews,2,0,2
741550,True,0,No user reviews,0,0,0
741590,True,0,No user reviews,0,0,0
741620,True,0,2 user reviews,1,1,2
741650,True,0,3 user reviews,1,2,3
741660,True,0,No user reviews,0,0,0
741670,True,8,Very Positive,364,75,439
741710,True,0,2 user reviews,2,0,2
741711,True,0,1 user reviews,1,0,1
741730,True,0,No user reviews,0,0,0
741760,True,0,6 user reviews,3,3,6
741770,True,0,5 user reviews,3,2,5
741780,True,0,1 user reviews,1,0,1
741790,True,0,No user reviews,0,0,0
741791,True,0,No user reviews,0,0,0
741792,True,0,No user reviews,0,0,0
741793,True,0,No user reviews,0,0,0
741794,True,0,No user reviews,0,0,0
741795,True,0,No user reviews,0,0,0
741796,True,0,No user reviews,0,0,0
741797,True,0,No user reviews,0,0,0
741798,True,0,No user reviews,0,0,0
741799,True,0,No user reviews,0,0,0
741800,True,0,No user reviews,0,0,0
741801,True,0,No user reviews,0,0,0
741820,True,4,Mostly Negative,86,213,299
741930,True,0,2 user reviews,0,2,2
741980,True,0,No user reviews,0,0,0
741990,True,8,Very Positive,47,5,52
742000,True,0,No user reviews,0,0,0
742010,True,0,4 user reviews,1,3,4
742020,True,0,No user reviews,0,0,0
742021,True,0,No user reviews,0,0,0
742030,True,0,9 user reviews,5,4,9
742060,True,0,No user reviews,0,0,0
742120,True,8,Very Positive,3580,380,3960
742150,True,7,Positive,30,0,30
742160,True,0,No user reviews,0,0,0
742170,True,0,No user reviews,0,0,0
742220,True,0,3 user reviews,3,0,3
742230,True,0,3 user reviews,1,2,3
742240,True,0,No user reviews,0,0,0
742250,True,8,Very Positive,60,9,69
742280,True,0,1 user reviews,1,0,1
742300,True,8,Very Positive,828,87,915
742310,True,0,No user reviews,0,0,0
742320,True,0,No user reviews,0,0,0
742330,True,0,No user reviews,0,0,0
742340,True,6,Mostly Positive,7,3,10
742350,True,0,2 user reviews,2,0,2
742360,True,0,No user reviews,0,0,0
742370,True,0,No user reviews,0,0,0
742380,True,7,Positive,9,1,10
742410,True,0,No user reviews,0,0,0
742430,True,0,No user reviews,0,0,0
742460,True,8,Very Positive,122,19,141
742470,True,0,5 user reviews,5,0,5
742480,True,7,Positive,37,5,42
742490,True,8,Very Positive,57,13,70
742500,True,0,No user reviews,0,0,0
742510,True,0,5 user reviews,4,1,5
742520,True,8,Very Positive,172,4,176
742530,True,6,Mostly Positive,20,7,27
742540,True,0,7 user reviews,6,1,7
742630,True,0,No user reviews,0,0,0
742660,True,0,1 user reviews,1,0,1
742670,True,0,1 user reviews,1,0,1
742680,True,0,1 user reviews,1,0,1
742690,True,0,1 user reviews,1,0,1
742700,True,7,Positive,40,4,44
742710,True,0,No user reviews,0,0,0
742730,True,0,No user reviews,0,0,0
742751,True,0,No user reviews,0,0,0
742752,True,0,No user reviews,0,0,0
742753,True,0,No user reviews,0,0,0
742754,True,0,No user reviews,0,0,0
742755,True,0,No user reviews,0,0,0
742756,True,0,No user reviews,0,0,0
742757,True,0,No user reviews,0,0,0
742758,True,0,No user reviews,0,0,0
742759,True,0,No user reviews,0,0,0
742760,True,0,No user reviews,0,0,0
742761,True,0,No user reviews,0,0,0
742762,True,0,No user reviews,0,0,0
742780,True,0,No user reviews,0,0,0
742790,True,0,2 user reviews,2,0,2
742800,True,0,2 user reviews,2,0,2
742810,True,0,No user reviews,0,0,0
742820,True,0,No user reviews,0,0,0
742830,True,7,Positive,13,3,16
742890,True,0,5 user reviews,5,0,5
742891,True,0,8 user reviews,8,0,8
742892,True,0,6 user reviews,6,0,6
742900,True,5,Mixed,18,8,26
742910,True,0,No user reviews,0,0,0
742950,True,0,No user reviews,0,0,0
742951,True,0,No user reviews,0,0,0
742952,True,0,No user reviews,0,0,0
742953,True,0,No user reviews,0,0,0
742954,True,0,No user reviews,0,0,0
742955,True,0,No user reviews,0,0,0
742956,True,0,No user reviews,0,0,0
742957,True,0,No user reviews,0,0,0
742958,True,0,No user reviews,0,0,0
742959,True,0,No user reviews,0,0,0
742960,True,0,No user reviews,0,0,0
742961,True,0,No user reviews,0,0,0
742980,True,0,1 user reviews,1,0,1
742990,True,0,No user reviews,0,0,0
743000,True,0,No user reviews,0,0,0
743030,True,0,6 user reviews,3,3,6
743040,True,0,1 user reviews,1,0,1
743050,True,0,No user reviews,0,0,0
743060,True,0,3 user reviews,0,3,3
743070,True,0,1 user reviews,1,0,1
743090,True,5,Mixed,28,37,65
743100,True,0,1 user reviews,1,0,1
743110,True,7,Positive,11,0,11
743130,True,8,Very Positive,317,17,334
743140,True,0,No user reviews,0,0,0
743160,True,0,No user reviews,0,0,0
743170,True,0,No user reviews,0,0,0
743190,True,0,No user reviews,0,0,0
743200,True,0,No user reviews,0,0,0
743201,True,0,No user reviews,0,0,0
743230,True,0,6 user reviews,5,1,6
743240,True,0,No user reviews,0,0,0
743270,True,0,No user reviews,0,0,0
743280,True,0,No user reviews,0,0,0
743290,True,0,No user reviews,0,0,0
743330,True,0,2 user reviews,1,1,2
743340,True,0,No user reviews,0,0,0
743350,True,5,Mixed,8,4,12
743360,True,0,3 user reviews,3,0,3
743370,True,0,No user reviews,0,0,0
743380,True,0,No user reviews,0,0,0
743390,True,8,Very Positive,235,10,245
743420,True,0,No user reviews,0,0,0
743450,True,9,Overwhelmingly Positive,4259,185,4444
743460,True,0,No user reviews,0,0,0
743480,True,0,No user reviews,0,0,0
743500,True,0,No user reviews,0,0,0
743520,True,0,No user reviews,0,0,0
743550,True,0,4 user reviews,4,0,4
743570,True,0,No user reviews,0,0,0
743580,True,0,No user reviews,0,0,0
743590,True,0,No user reviews,0,0,0
743620,True,0,1 user reviews,0,1,1
743640,True,8,Very Positive,377,85,462
743650,True,0,No user reviews,0,0,0
743660,True,0,5 user reviews,5,0,5
743680,True,0,No user reviews,0,0,0
743790,True,0,No user reviews,0,0,0
743810,True,0,No user reviews,0,0,0
743830,True,5,Mixed,12,6,18
743840,True,0,No user reviews,0,0,0
743841,True,0,No user reviews,0,0,0
743842,True,0,No user reviews,0,0,0
743843,True,0,No user reviews,0,0,0
743844,True,0,No user reviews,0,0,0
743845,True,0,No user reviews,0,0,0
743850,True,7,Positive,18,1,19
743860,True,4,Mostly Negative,46,93,139
743870,True,0,No user reviews,0,0,0
743880,True,0,2 user reviews,1,1,2
743890,True,6,Mostly Positive,432,180,612
743900,True,6,Mostly Positive,178,64,242
743920,True,0,No user reviews,0,0,0
743930,True,0,No user reviews,0,0,0
743940,True,0,5 user reviews,5,0,5
743960,True,5,Mixed,9,4,13
743990,True,0,2 user reviews,1,1,2
744010,True,0,4 user reviews,2,2,4
744020,True,0,No user reviews,0,0,0
744040,True,6,Mostly Positive,7,3,10
744050,True,8,Very Positive,50,8,58
744060,True,6,Mostly Positive,311,105,416
744070,True,0,No user reviews,0,0,0
744080,True,0,No user reviews,0,0,0
744090,True,0,No user reviews,0,0,0
744150,True,0,3 user reviews,3,0,3
744160,True,0,No user reviews,0,0,0
744170,True,0,1 user reviews,1,0,1
744190,True,8,Very Positive,382,34,416
744200,True,0,No user reviews,0,0,0
744220,True,3,Negative,2,9,11
744240,True,0,No user reviews,0,0,0
744260,True,0,1 user reviews,0,1,1
744270,True,5,Mixed,26,34,60
744280,True,0,1 user reviews,0,1,1
744290,True,0,No user reviews,0,0,0
744310,True,0,No user reviews,0,0,0
744330,True,0,No user reviews,0,0,0
744340,True,0,No user reviews,0,0,0
744380,True,0,No user reviews,0,0,0
744390,True,0,1 user reviews,0,1,1
744400,True,0,1 user reviews,1,0,1
744420,True,6,Mostly Positive,32,11,43
744430,True,7,Positive,25,4,29
744440,True,0,1 user reviews,1,0,1
744450,True,0,1 user reviews,0,1,1
744460,True,5,Mixed,7,7,14
744490,True,0,No user reviews,0,0,0
744520,True,7,Positive,35,3,38
744550,True,0,1 user reviews,1,0,1
744570,True,8,Very Positive,58,10,68
744580,True,0,1 user reviews,1,0,1
744590,True,5,Mixed,6,5,11
744600,True,7,Positive,12,0,12
744610,True,0,5 user reviews,1,4,5
744630,True,0,1 user reviews,0,1,1
744640,True,0,No user reviews,0,0,0
744650,True,7,Positive,16,0,16
744660,True,0,No user reviews,0,0,0
744670,True,5,Mixed,68,35,103
744680,True,0,6 user reviews,4,2,6
744700,True,0,No user reviews,0,0,0
744710,True,0,1 user reviews,0,1,1
744720,True,0,4 user reviews,0,4,4
744740,True,0,3 user reviews,3,0,3
744750,True,5,Mixed,7,5,12
744760,True,0,4 user reviews,2,2,4
744800,True,0,3 user reviews,3,0,3
744810,True,0,3 user reviews,3,0,3
744840,True,8,Very Positive,530,74,604
744870,True,0,No user reviews,0,0,0
744871,True,0,2 user reviews,0,2,2
744880,True,0,1 user reviews,1,0,1
744890,True,0,1 user reviews,0,1,1
744900,True,0,No user reviews,0,0,0
744910,True,0,No user reviews,0,0,0
744920,True,0,2 user reviews,2,0,2
744930,True,0,No user reviews,0,0,0
744940,True,5,Mixed,7,8,15
744950,True,5,Mixed,104,112,216
744980,True,0,No user reviews,0,0,0
744990,True,0,1 user reviews,1,0,1
745000,True,6,Mostly Positive,58,19,77
745010,True,5,Mixed,60,36,96
745030,True,7,Positive,14,0,14
745060,True,0,2 user reviews,1,1,2
745090,True,7,Positive,20,3,23
745120,True,0,3 user reviews,1,2,3
745130,True,5,Mixed,8,7,15
745160,True,0,4 user reviews,4,0,4
745170,True,0,No user reviews,0,0,0
745180,True,6,Mostly Positive,8,3,11
745220,True,6,Mostly Positive,158,45,203
745230,True,0,No user reviews,0,0,0
745250,True,0,5 user reviews,4,1,5
745270,True,0,No user reviews,0,0,0
745280,True,0,No user reviews,0,0,0
745310,True,0,No user reviews,0,0,0
745330,True,6,Mostly Positive,20,8,28
745340,True,4,Mostly Negative,4,7,11
745360,True,0,No user reviews,0,0,0
745370,True,5,Mixed,6,6,12
745380,True,5,Mixed,5,6,11
745400,True,7,Positive,9,1,10
745420,True,0,4 user reviews,3,1,4
745430,True,0,3 user reviews,3,0,3
745440,True,0,No user reviews,0,0,0
745450,True,0,No user reviews,0,0,0
745500,True,0,4 user reviews,2,2,4
745510,True,7,Positive,27,5,32
745520,True,0,5 user reviews,5,0,5
745530,True,5,Mixed,6,5,11
745550,True,0,No user reviews,0,0,0
745560,True,0,No user reviews,0,0,0
745580,True,0,5 user reviews,4,1,5
745620,True,0,2 user reviews,1,1,2
745630,True,0,1 user reviews,1,0,1
745640,True,0,7 user reviews,0,7,7
745650,True,0,3 user reviews,3,0,3
745660,True,0,6 user reviews,6,0,6
745670,True,5,Mixed,5,6,11
745680,True,0,No user reviews,0,0,0
745710,True,0,2 user reviews,2,0,2
745720,True,0,No user reviews,0,0,0
745730,True,0,No user reviews,0,0,0
745740,True,8,Very Positive,103,17,120
745750,True,0,1 user reviews,1,0,1
745760,True,0,No user reviews,0,0,0
745770,True,0,No user reviews,0,0,0
745780,True,0,No user reviews,0,0,0
745790,True,7,Positive,13,1,14
745800,True,0,No user reviews,0,0,0
745802,True,0,No user reviews,0,0,0
745810,True,6,Mostly Positive,45,18,63
745820,True,0,No user reviews,0,0,0
745830,True,0,6 user reviews,5,1,6
745840,True,0,5 user reviews,5,0,5
745850,True,8,Very Positive,60,5,65
745870,True,0,2 user reviews,2,0,2
745880,True,9,Overwhelmingly Positive,893,10,903
745890,True,0,3 user reviews,3,0,3
745900,True,0,3 user reviews,2,1,3
745910,True,0,No user reviews,0,0,0
745911,True,0,1 user reviews,1,0,1
745912,True,0,1 user reviews,1,0,1
745920,True,8,Very Positive,11055,1192,12247
745930,True,0,2 user reviews,0,2,2
745940,True,5,Mixed,6,6,12
745950,True,7,Positive,20,5,25
745960,True,8,Very Positive,186,11,197
745970,True,6,Mostly Positive,18,5,23
745980,True,0,No user reviews,0,0,0
746000,True,0,6 user reviews,5,1,6
746010,True,0,No user reviews,0,0,0
746020,True,0,8 user reviews,2,6,8
746030,True,0,3 user reviews,2,1,3
746040,True,0,No user reviews,0,0,0
746070,True,0,No user reviews,0,0,0
746080,True,0,No user reviews,0,0,0
746110,True,0,3 user reviews,3,0,3
746140,True,6,Mostly Positive,82,22,104
746150,True,0,No user reviews,0,0,0
746160,True,0,No user reviews,0,0,0
746170,True,0,No user reviews,0,0,0
746180,True,0,No user reviews,0,0,0
746200,True,0,No user reviews,0,0,0
746220,True,0,2 user reviews,2,0,2
746230,True,0,No user reviews,0,0,0
746240,True,0,6 user reviews,2,4,6
746250,True,0,No user reviews,0,0,0
746260,True,0,No user reviews,0,0,0
746270,True,0,No user reviews,0,0,0
746280,True,0,No user reviews,0,0,0
746300,True,0,No user reviews,0,0,0
746340,True,0,1 user reviews,0,1,1
746350,True,5,Mixed,9,5,14
746360,True,0,1 user reviews,1,0,1
746390,True,5,Mixed,13,6,19
746400,True,8,Very Positive,126,5,131
746410,True,6,Mostly Positive,16,6,22
746420,True,0,4 user reviews,4,0,4
746430,True,0,9 user reviews,4,5,9
746450,True,0,No user reviews,0,0,0
746460,True,0,No user reviews,0,0,0
746470,True,7,Positive,17,2,19
746500,True,0,5 user reviews,5,0,5
746510,True,8,Very Positive,242,24,266
746530,True,0,No user reviews,0,0,0
746540,True,5,Mixed,10,6,16
746560,True,8,Very Positive,57,1,58
746570,True,7,Positive,17,2,19
746580,True,8,Very Positive,319,31,350
746590,True,0,No user reviews,0,0,0
746610,True,0,4 user reviews,3,1,4
746620,True,0,4 user reviews,2,2,4
746650,True,8,Very Positive,92,3,95
746660,True,0,8 user reviews,6,2,8
746680,True,0,1 user reviews,1,0,1
746700,True,0,No user reviews,0,0,0
746710,True,8,Very Positive,183,16,199
746730,True,8,Very Positive,98,7,105
746731,True,0,4 user reviews,4,0,4
746750,True,0,8 user reviews,6,2,8
746760,True,4,Mostly Negative,5,8,13
746770,True,0,1 user reviews,1,0,1
746820,True,0,4 user reviews,4,0,4
746840,True,6,Mostly Positive,13,5,18
746850,True,8,Very Positive,1888,264,2152
746860,True,0,No user reviews,0,0,0
746870,True,0,No user reviews,0,0,0
746880,True,5,Mixed,12,7,19
746890,True,0,1 user reviews,1,0,1
746900,True,0,1 user reviews,0,1,1
746910,True,0,No user reviews,0,0,0
746920,True,0,No user reviews,0,0,0
746930,True,6,Mostly Positive,592,168,760
746940,True,8,Very Positive,85,5,90
746960,True,7,Positive,22,0,22
746970,True,0,No user reviews,0,0,0
746980,True,0,No user reviews,0,0,0
746990,True,0,6 user reviews,1,5,6
747020,True,0,1 user reviews,1,0,1
747030,True,0,9 user reviews,4,5,9
747040,True,0,5 user reviews,2,3,5
747050,True,6,Mostly Positive,8,3,11
747060,True,5,Mixed,23,12,35
747090,True,0,3 user reviews,2,1,3
747110,True,0,No user reviews,0,0,0
747120,True,0,No user reviews,0,0,0
747130,True,0,No user reviews,0,0,0
747140,True,0,1 user reviews,1,0,1
747160,True,0,6 user reviews,6,0,6
747180,True,0,3 user reviews,3,0,3
747190,True,5,Mixed,26,12,38
747200,True,8,Very Positive,178,29,207
747210,True,0,No user reviews,0,0,0
747220,True,0,No user reviews,0,0,0
747230,True,0,No user reviews,0,0,0
747240,True,0,No user reviews,0,0,0
747250,True,0,No user reviews,0,0,0
747260,True,5,Mixed,7,9,16
747280,True,0,No user reviews,0,0,0
747290,True,0,3 user reviews,3,0,3
747300,True,0,No user reviews,0,0,0
747310,True,5,Mixed,12,17,29
747320,True,6,Mostly Positive,13,4,17
747330,True,0,No user reviews,0,0,0
747340,True,8,Very Positive,284,63,347
747350,True,8,Very Positive,418,56,474
747360,True,8,Very Positive,150,32,182
747410,True,0,1 user reviews,1,0,1
747420,True,0,No user reviews,0,0,0
747430,True,0,No user reviews,0,0,0
747470,True,7,Positive,15,2,17
747480,True,0,No user reviews,0,0,0
747520,True,0,5 user reviews,5,0,5
747530,True,0,No user reviews,0,0,0
747540,True,0,No user reviews,0,0,0
747560,True,0,No user reviews,0,0,0
747590,True,6,Mostly Positive,21,7,28
747600,True,0,1 user reviews,0,1,1
747610,True,0,No user reviews,0,0,0
747620,True,7,Positive,17,1,18
747630,True,0,No user reviews,0,0,0
747640,True,0,6 user reviews,5,1,6
747650,True,7,Positive,10,0,10
747670,True,0,No user reviews,0,0,0
747680,True,0,No user reviews,0,0,0
747690,True,7,Positive,17,3,20
747700,True,0,3 user reviews,0,3,3
747720,True,0,No user reviews,0,0,0
747721,True,0,No user reviews,0,0,0
747730,True,0,3 user reviews,2,1,3
747740,True,0,No user reviews,0,0,0
747741,True,0,No user reviews,0,0,0
747742,True,0,No user reviews,0,0,0
747750,True,0,2 user reviews,2,0,2
747770,True,0,No user reviews,0,0,0
747790,True,0,1 user reviews,1,0,1
747800,True,0,1 user reviews,0,1,1
747810,True,0,1 user reviews,1,0,1
747820,True,0,No user reviews,0,0,0
747850,True,0,4 user reviews,3,1,4
747890,True,0,No user reviews,0,0,0
747900,True,0,1 user reviews,1,0,1
747910,True,6,Mostly Positive,85,27,112
747920,True,0,No user reviews,0,0,0
747930,True,0,No user reviews,0,0,0
747970,True,0,No user reviews,0,0,0
747980,True,0,3 user reviews,3,0,3
747990,True,0,9 user reviews,5,4,9
748000,True,0,No user reviews,0,0,0
748010,True,0,1 user reviews,1,0,1
748030,True,0,No user reviews,0,0,0
748040,True,8,Very Positive,50,3,53
748050,True,0,No user reviews,0,0,0
748060,True,0,4 user reviews,1,3,4
748070,True,0,3 user reviews,3,0,3
748080,True,0,No user reviews,0,0,0
748090,True,0,No user reviews,0,0,0
748110,True,0,5 user reviews,4,1,5
748120,True,0,No user reviews,0,0,0
748130,True,0,4 user reviews,1,3,4
748140,True,0,No user reviews,0,0,0
748150,True,6,Mostly Positive,9,3,12
748170,True,0,No user reviews,0,0,0
748190,True,0,No user reviews,0,0,0
748210,True,0,No user reviews,0,0,0
748260,True,0,1 user reviews,1,0,1
748270,True,0,8 user reviews,6,2,8
748280,True,0,No user reviews,0,0,0
748290,True,0,1 user reviews,1,0,1
748291,True,0,No user reviews,0,0,0
748300,True,5,Mixed,129,59,188
748310,True,0,4 user reviews,4,0,4
748320,True,0,No user reviews,0,0,0
748330,True,7,Positive,11,0,11
748340,True,5,Mixed,11,11,22
748341,True,7,Positive,38,6,44
748350,True,0,No user reviews,0,0,0
748360,True,8,Very Positive,508,123,631
748370,True,6,Mostly Positive,562,204,766
748420,True,0,No user reviews,0,0,0
748430,True,0,2 user reviews,1,1,2
748460,True,8,Very Positive,42,8,50
748470,True,0,No user reviews,0,0,0
748471,True,0,No user reviews,0,0,0
748472,True,0,No user reviews,0,0,0
748473,True,0,No user reviews,0,0,0
748480,True,5,Mixed,17,8,25
748490,True,9,Overwhelmingly Positive,964,33,997
748500,True,0,1 user reviews,1,0,1
748520,True,0,2 user reviews,0,2,2
748540,True,0,9 user reviews,6,3,9
748580,True,0,2 user reviews,2,0,2
748600,True,7,Positive,14,3,17
748610,True,6,Mostly Positive,48,14,62
748650,True,0,3 user reviews,2,1,3
748660,True,0,No user reviews,0,0,0
748670,True,0,4 user reviews,0,4,4
748680,True,0,2 user reviews,2,0,2
748700,True,0,No user reviews,0,0,0
748710,True,0,No user reviews,0,0,0
748720,True,0,2 user reviews,1,1,2
748730,True,0,No user reviews,0,0,0
748740,True,0,No user reviews,0,0,0
748780,True,0,No user reviews,0,0,0
748790,True,0,1 user reviews,1,0,1
748800,True,0,2 user reviews,2,0,2
748820,True,0,4 user reviews,2,2,4
748830,True,0,No user reviews,0,0,0
748850,True,0,1 user reviews,1,0,1
748870,True,0,No user reviews,0,0,0
748880,True,0,7 user reviews,5,2,7
748890,True,8,Very Positive,84,7,91
748900,True,0,No user reviews,0,0,0
748910,True,0,No user reviews,0,0,0
748930,True,0,6 user reviews,3,3,6
748940,True,0,No user reviews,0,0,0
748950,True,0,No user reviews,0,0,0
748970,True,8,Very Positive,56,10,66
748980,True,0,3 user reviews,3,0,3
748990,True,0,No user reviews,0,0,0
749000,True,0,No user reviews,0,0,0
749010,True,0,9 user reviews,7,2,9
749020,True,0,No user reviews,0,0,0
749040,True,0,2 user reviews,1,1,2
749050,True,5,Mixed,58,26,84
749060,True,0,No user reviews,0,0,0
749070,True,0,No user reviews,0,0,0
749080,True,0,7 user reviews,4,3,7
749090,True,0,No user reviews,0,0,0
749110,True,0,4 user reviews,2,2,4
749130,True,0,2 user reviews,2,0,2
749140,True,7,Positive,12,0,12
749150,True,0,1 user reviews,0,1,1
749160,True,0,No user reviews,0,0,0
749170,True,0,No user reviews,0,0,0
749180,True,0,No user reviews,0,0,0
749190,True,0,No user reviews,0,0,0
749200,True,0,No user reviews,0,0,0
749230,True,0,No user reviews,0,0,0
749240,True,0,2 user reviews,1,1,2
749241,True,0,1 user reviews,1,0,1
749242,True,0,1 user reviews,1,0,1
749250,True,6,Mostly Positive,85,35,120
749270,True,4,Mostly Negative,7,16,23
749280,True,0,No user reviews,0,0,0
749290,True,0,1 user reviews,1,0,1
749320,True,0,3 user reviews,3,0,3
749340,True,6,Mostly Positive,24,9,33
749370,True,5,Mixed,6,7,13
749410,True,7,Positive,12,1,13
749420,True,0,No user reviews,0,0,0
749430,True,0,No user reviews,0,0,0
749450,True,0,No user reviews,0,0,0
749470,True,0,1 user reviews,1,0,1
749480,True,0,8 user reviews,3,5,8
749490,True,0,No user reviews,0,0,0
749520,True,0,4 user reviews,4,0,4
749530,True,0,No user reviews,0,0,0
749540,True,4,Mostly Negative,17,30,47
749550,True,6,Mostly Positive,9,3,12
749560,True,7,Positive,20,4,24
749580,True,0,3 user reviews,0,3,3
749590,True,0,1 user reviews,1,0,1
749610,True,0,No user reviews,0,0,0
749620,True,0,No user reviews,0,0,0
749630,True,0,No user reviews,0,0,0
749640,True,0,No user reviews,0,0,0
749650,True,0,1 user reviews,0,1,1
749660,True,0,No user reviews,0,0,0
749670,True,0,8 user reviews,5,3,8
749700,True,0,7 user reviews,7,0,7
749710,True,0,6 user reviews,4,2,6
749720,True,0,No user reviews,0,0,0
749730,True,7,Positive,11,1,12
749750,True,0,No user reviews,0,0,0
749780,True,5,Mixed,57,73,130
749790,True,0,No user reviews,0,0,0
749800,True,5,Mixed,70,43,113
749810,True,0,No user reviews,0,0,0
749820,True,0,No user reviews,0,0,0
749830,True,0,5 user reviews,3,2,5
749840,True,6,Mostly Positive,35,9,44
749850,True,0,9 user reviews,9,0,9
749860,True,0,5 user reviews,3,2,5
749870,True,0,No user reviews,0,0,0
749880,True,0,4 user reviews,1,3,4
749890,True,7,Positive,40,4,44
749900,True,0,1 user reviews,0,1,1
749920,True,7,Positive,15,2,17
749950,True,0,No user reviews,0,0,0
749960,True,5,Mixed,72,39,111
749980,True,0,7 user reviews,4,3,7
749990,True,0,7 user reviews,6,1,7
750000,True,0,No user reviews,0,0,0
750010,True,5,Mixed,30,16,46
750020,True,0,2 user reviews,2,0,2
750030,True,8,Very Positive,94,18,112
750031,True,5,Mixed,134,78,212
750050,True,5,Mixed,280,177,457
750060,True,0,9 user reviews,9,0,9
750070,True,4,Mostly Negative,6,14,20
750080,True,0,3 user reviews,2,1,3
750120,True,0,No user reviews,0,0,0
750150,True,0,No user reviews,0,0,0
750151,True,0,No user reviews,0,0,0
750170,True,8,Very Positive,129,5,134
750200,True,0,No user reviews,0,0,0
750210,True,6,Mostly Positive,41,17,58
750230,True,5,Mixed,6,6,12
750240,True,0,No user reviews,0,0,0
750250,True,0,No user reviews,0,0,0
750270,True,0,No user reviews,0,0,0
750280,True,0,No user reviews,0,0,0
750300,True,0,No user reviews,0,0,0
750310,True,6,Mostly Positive,39,11,50
750320,True,0,9 user reviews,8,1,9
750330,True,5,Mixed,8,7,15
750340,True,0,7 user reviews,7,0,7
750341,True,0,8 user reviews,8,0,8
750342,True,0,7 user reviews,7,0,7
750350,True,0,No user reviews,0,0,0
750360,True,0,No user reviews,0,0,0
750380,True,0,No user reviews,0,0,0
750381,True,8,Very Positive,364,83,447
750400,True,0,No user reviews,0,0,0
750420,True,0,No user reviews,0,0,0
750430,True,0,4 user reviews,3,1,4
750440,True,0,5 user reviews,2,3,5
750450,True,7,Positive,25,0,25
750460,True,7,Positive,16,4,20
750470,True,8,Very Positive,102,8,110
750480,True,0,No user reviews,0,0,0
750490,True,0,2 user reviews,2,0,2
750491,True,0,2 user reviews,1,1,2
750492,True,0,5 user reviews,4,1,5
750500,True,7,Positive,9,2,11
750510,True,0,No user reviews,0,0,0
750520,True,6,Mostly Positive,65,18,83
750530,True,0,No user reviews,0,0,0
750540,True,0,No user reviews,0,0,0
750541,True,0,No user reviews,0,0,0
750542,True,0,No user reviews,0,0,0
750543,True,0,No user reviews,0,0,0
750544,True,0,No user reviews,0,0,0
750545,True,0,No user reviews,0,0,0
750546,True,0,No user reviews,0,0,0
750547,True,0,No user reviews,0,0,0
750610,True,0,No user reviews,0,0,0
750620,True,0,2 user reviews,1,1,2
750630,True,0,No user reviews,0,0,0
750640,True,0,1 user reviews,1,0,1
750660,True,5,Mixed,6,5,11
750670,True,0,No user reviews,0,0,0
750710,True,0,2 user reviews,1,1,2
750740,True,0,No user reviews,0,0,0
750750,True,0,No user reviews,0,0,0
750770,True,5,Mixed,9,4,13
750780,True,0,2 user reviews,2,0,2
750790,True,0,3 user reviews,2,1,3
750800,True,5,Mixed,28,14,42
750820,True,0,1 user reviews,1,0,1
750840,True,0,2 user reviews,0,2,2
750850,True,7,Positive,21,5,26
750870,True,0,3 user reviews,2,1,3
750900,True,0,No user reviews,0,0,0
750910,True,0,3 user reviews,3,0,3
750911,True,0,No user reviews,0,0,0
750912,True,0,No user reviews,0,0,0
750920,True,8,Very Positive,8280,1586,9866
750960,True,0,7 user reviews,7,0,7
750970,True,0,7 user reviews,4,3,7
750980,True,0,No user reviews,0,0,0
750990,True,7,Positive,25,2,27
751030,True,0,No user reviews,0,0,0
751040,True,0,No user reviews,0,0,0
751060,True,6,Mostly Positive,12,5,17
751070,True,0,No user reviews,0,0,0
751090,True,0,No user reviews,0,0,0
751100,True,0,No user reviews,0,0,0
751110,True,6,Mostly Positive,37,13,50
751140,True,0,No user reviews,0,0,0
751160,True,0,2 user reviews,0,2,2
751170,True,0,4 user reviews,3,1,4
751180,True,0,1 user reviews,0,1,1
751190,True,0,No user reviews,0,0,0
751191,True,0,No user reviews,0,0,0
751200,True,7,Positive,8,2,10
751220,True,7,Positive,27,1,28
751230,True,0,No user reviews,0,0,0
751240,True,5,Mixed,65,48,113
751250,True,7,Positive,26,5,31
751260,True,0,5 user reviews,5,0,5
751270,True,0,1 user reviews,1,0,1
751280,True,8,Very Positive,68,1,69
751300,True,8,Very Positive,56,6,62
751310,True,0,No user reviews,0,0,0
751320,True,0,No user reviews,0,0,0
751330,True,0,5 user reviews,3,2,5
751340,True,6,Mostly Positive,19,7,26
751350,True,0,No user reviews,0,0,0
751380,True,0,6 user reviews,5,1,6
751390,True,0,8 user reviews,5,3,8
751400,True,0,3 user reviews,3,0,3
751430,True,0,2 user reviews,1,1,2
751440,True,6,Mostly Positive,303,91,394
751450,True,8,Very Positive,69,1,70
751470,True,0,7 user reviews,7,0,7
751480,True,0,4 user reviews,3,1,4
751490,True,0,No user reviews,0,0,0
751500,True,5,Mixed,80,39,119
751520,True,0,No user reviews,0,0,0
751530,True,0,1 user reviews,0,1,1
751540,True,0,5 user reviews,2,3,5
751550,True,0,No user reviews,0,0,0
751580,True,0,1 user reviews,1,0,1
751590,True,0,No user reviews,0,0,0
751600,True,0,No user reviews,0,0,0
751610,True,0,No user reviews,0,0,0
751630,True,0,No user reviews,0,0,0
751640,True,7,Positive,25,1,26
751660,True,0,2 user reviews,1,1,2
751670,True,0,2 user reviews,2,0,2
751680,True,0,2 user reviews,2,0,2
751690,True,0,No user reviews,0,0,0
751700,True,0,1 user reviews,1,0,1
751701,True,0,No user reviews,0,0,0
751702,True,0,No user reviews,0,0,0
751720,True,0,5 user reviews,5,0,5
751730,True,7,Positive,14,2,16
751740,True,0,3 user reviews,0,3,3
751770,True,0,No user reviews,0,0,0
751780,True,8,Very Positive,6367,420,6787
751820,True,8,Very Positive,86,19,105
751830,True,0,No user reviews,0,0,0
751831,True,0,No user reviews,0,0,0
751832,True,0,No user reviews,0,0,0
751840,True,0,No user reviews,0,0,0
751850,True,0,No user reviews,0,0,0
751860,True,0,No user reviews,0,0,0
751870,True,0,2 user reviews,0,2,2
751880,True,0,5 user reviews,5,0,5
751890,True,0,No user reviews,0,0,0
751910,True,0,No user reviews,0,0,0
751920,True,0,No user reviews,0,0,0
751930,True,0,No user reviews,0,0,0
751940,True,0,No user reviews,0,0,0
751950,True,0,8 user reviews,7,1,8
751970,True,0,6 user reviews,6,0,6
752000,True,0,1 user reviews,0,1,1
752020,True,5,Mixed,5,7,12
752030,True,0,7 user reviews,4,3,7
752040,True,0,No user reviews,0,0,0
752050,True,5,Mixed,11,11,22
752060,True,0,No user reviews,0,0,0
752070,True,0,No user reviews,0,0,0
752080,True,0,2 user reviews,2,0,2
752110,True,0,No user reviews,0,0,0
752170,True,0,7 user reviews,7,0,7
752180,True,0,No user reviews,0,0,0
752200,True,0,1 user reviews,0,1,1
752220,True,0,No user reviews,0,0,0
752230,True,0,No user reviews,0,0,0
752240,True,0,No user reviews,0,0,0
752260,True,0,No user reviews,0,0,0
752300,True,4,Mostly Negative,5,10,15
752310,True,0,4 user reviews,2,2,4
752330,True,7,Positive,24,5,29
752350,True,0,No user reviews,0,0,0
752360,True,0,No user reviews,0,0,0
752380,True,6,Mostly Positive,19,5,24
752400,True,0,1 user reviews,0,1,1
752430,True,0,3 user reviews,3,0,3
752440,True,0,7 user reviews,7,0,7
752450,True,5,Mixed,12,6,18
752470,True,7,Positive,35,7,42
752490,True,0,No user reviews,0,0,0
752500,True,7,Positive,26,6,32
752510,True,0,No user reviews,0,0,0
752520,True,5,Mixed,10,6,16
752530,True,0,No user reviews,0,0,0
752540,True,0,No user reviews,0,0,0
752550,True,7,Positive,13,0,13
752560,True,0,1 user reviews,1,0,1
752570,True,5,Mixed,5,5,10
752590,True,8,Very Positive,8483,588,9071
752600,True,0,7 user reviews,7,0,7
752630,True,0,No user reviews,0,0,0
752640,True,6,Mostly Positive,15,5,20
752650,True,0,No user reviews,0,0,0
752690,True,0,3 user reviews,2,1,3
752700,True,0,3 user reviews,0,3,3
752710,True,0,1 user reviews,1,0,1
752720,True,2,Very Negative,14,97,111
752730,True,4,Mostly Negative,4,13,17
752750,True,4,Mostly Negative,6,11,17
752760,True,0,No user reviews,0,0,0
752770,True,0,No user reviews,0,0,0
752780,True,0,4 user reviews,0,4,4
752790,True,0,2 user reviews,1,1,2
752800,True,7,Positive,17,0,17
752810,True,0,6 user reviews,2,4,6
752820,True,0,No user reviews,0,0,0
752830,True,0,5 user reviews,3,2,5
752840,True,0,No user reviews,0,0,0
752850,True,6,Mostly Positive,8,3,11
752860,True,0,No user reviews,0,0,0
752870,True,0,No user reviews,0,0,0
752880,True,0,No user reviews,0,0,0
752900,True,0,No user reviews,0,0,0
752910,True,8,Very Positive,84,13,97
752920,True,0,2 user reviews,2,0,2
752921,True,0,No user reviews,0,0,0
752922,True,0,No user reviews,0,0,0
752923,True,0,No user reviews,0,0,0
752924,True,0,No user reviews,0,0,0
752925,True,0,No user reviews,0,0,0
752926,True,0,No user reviews,0,0,0
752927,True,0,No user reviews,0,0,0
752928,True,0,No user reviews,0,0,0
752929,True,0,No user reviews,0,0,0
752930,True,0,No user reviews,0,0,0
752931,True,0,No user reviews,0,0,0
752932,True,0,No user reviews,0,0,0
752940,True,0,No user reviews,0,0,0
752941,True,0,No user reviews,0,0,0
752942,True,0,No user reviews,0,0,0
752943,True,0,No user reviews,0,0,0
752944,True,0,No user reviews,0,0,0
752945,True,0,No user reviews,0,0,0
752946,True,0,No user reviews,0,0,0
752947,True,0,No user reviews,0,0,0
752948,True,0,No user reviews,0,0,0
752949,True,0,No user reviews,0,0,0
752950,True,0,No user reviews,0,0,0
752951,True,0,No user reviews,0,0,0
752952,True,0,No user reviews,0,0,0
752960,True,0,No user reviews,0,0,0
752990,True,0,No user reviews,0,0,0
753000,True,0,2 user reviews,1,1,2
753001,True,0,No user reviews,0,0,0
753003,True,0,No user reviews,0,0,0
753004,True,0,No user reviews,0,0,0
753020,True,0,No user reviews,0,0,0
753030,True,0,No user reviews,0,0,0
753060,True,0,No user reviews,0,0,0
753080,True,0,No user reviews,0,0,0
753090,True,0,No user reviews,0,0,0
753100,True,0,2 user reviews,0,2,2
753110,True,4,Mostly Negative,12,25,37
753120,True,0,1 user reviews,1,0,1
753170,True,0,1 user reviews,0,1,1
753200,True,0,6 user reviews,6,0,6
753210,True,4,Mostly Negative,3,7,10
753220,True,8,Very Positive,91,0,91
753230,True,6,Mostly Positive,54,21,75
753240,True,0,3 user reviews,1,2,3
753250,True,0,No user reviews,0,0,0
753270,True,0,9 user reviews,6,3,9
753281,True,0,No user reviews,0,0,0
753282,True,0,No user reviews,0,0,0
753283,True,0,No user reviews,0,0,0
753285,True,0,No user reviews,0,0,0
753286,True,0,No user reviews,0,0,0
753290,True,0,No user reviews,0,0,0
753291,True,0,1 user reviews,1,0,1
753292,True,0,No user reviews,0,0,0
753293,True,0,No user reviews,0,0,0
753360,True,5,Mixed,17,8,25
753370,True,0,7 user reviews,2,5,7
753380,True,0,5 user reviews,4,1,5
753390,True,0,2 user reviews,1,1,2
753400,True,0,3 user reviews,3,0,3
753410,True,0,No user reviews,0,0,0
753420,True,8,Very Positive,958,95,1053
753430,True,0,No user reviews,0,0,0
753440,True,7,Positive,12,2,14
753450,True,0,2 user reviews,2,0,2
753460,True,0,2 user reviews,1,1,2
753470,True,0,1 user reviews,1,0,1
753480,True,0,No user reviews,0,0,0
753490,True,0,5 user reviews,2,3,5
753500,True,0,2 user reviews,1,1,2
753510,True,0,No user reviews,0,0,0
753520,True,0,No user reviews,0,0,0
753530,True,0,No user reviews,0,0,0
753560,True,0,3 user reviews,3,0,3
753570,True,0,1 user reviews,0,1,1
753580,True,0,No user reviews,0,0,0
753590,True,5,Mixed,125,55,180
753610,True,0,No user reviews,0,0,0
753630,True,0,No user reviews,0,0,0
753640,True,8,Very Positive,5745,339,6084
753650,True,8,Very Positive,568,54,622
753660,True,8,Very Positive,44,10,54
753670,True,0,4 user reviews,2,2,4
753680,True,0,No user reviews,0,0,0
753700,True,0,No user reviews,0,0,0
753710,True,0,No user reviews,0,0,0
753730,True,0,No user reviews,0,0,0
753740,True,0,No user reviews,0,0,0
753741,True,0,No user reviews,0,0,0
753742,True,0,1 user reviews,0,1,1
753743,True,0,No user reviews,0,0,0
753744,True,0,No user reviews,0,0,0
753745,True,0,No user reviews,0,0,0
753746,True,0,No user reviews,0,0,0
753747,True,0,No user reviews,0,0,0
753748,True,0,No user reviews,0,0,0
753749,True,0,No user reviews,0,0,0
753750,True,0,No user reviews,0,0,0
753751,True,0,No user reviews,0,0,0
753752,True,0,No user reviews,0,0,0
753753,True,0,No user reviews,0,0,0
753754,True,0,No user reviews,0,0,0
753756,True,0,No user reviews,0,0,0
753757,True,0,No user reviews,0,0,0
753758,True,0,No user reviews,0,0,0
753759,True,0,No user reviews,0,0,0
753760,True,0,No user reviews,0,0,0
753761,True,0,No user reviews,0,0,0
753762,True,0,No user reviews,0,0,0
753763,True,0,No user reviews,0,0,0
753764,True,0,No user reviews,0,0,0
753765,True,0,No user reviews,0,0,0
753766,True,0,No user reviews,0,0,0
753767,True,0,No user reviews,0,0,0
753768,True,0,No user reviews,0,0,0
753769,True,0,No user reviews,0,0,0
753770,True,0,No user reviews,0,0,0
753771,True,0,1 user reviews,1,0,1
753772,True,0,No user reviews,0,0,0
753773,True,0,No user reviews,0,0,0
753774,True,0,No user reviews,0,0,0
753775,True,0,No user reviews,0,0,0
753776,True,0,No user reviews,0,0,0
753777,True,0,No user reviews,0,0,0
753778,True,0,No user reviews,0,0,0
753779,True,0,No user reviews,0,0,0
753780,True,0,1 user reviews,1,0,1
753781,True,0,No user reviews,0,0,0
753782,True,0,No user reviews,0,0,0
753783,True,0,No user reviews,0,0,0
753784,True,0,No user reviews,0,0,0
753785,True,0,No user reviews,0,0,0
753786,True,0,2 user reviews,1,1,2
753787,True,0,No user reviews,0,0,0
753788,True,0,No user reviews,0,0,0
753789,True,0,2 user reviews,2,0,2
753790,True,0,No user reviews,0,0,0
753791,True,0,No user reviews,0,0,0
753792,True,0,No user reviews,0,0,0
753793,True,0,No user reviews,0,0,0
753794,True,0,1 user reviews,1,0,1
753795,True,0,No user reviews,0,0,0
753796,True,0,1 user reviews,1,0,1
753797,True,0,3 user reviews,3,0,3
753798,True,0,No user reviews,0,0,0
753799,True,0,No user reviews,0,0,0
753800,True,0,No user reviews,0,0,0
753801,True,0,No user reviews,0,0,0
753802,True,0,No user reviews,0,0,0
753803,True,0,No user reviews,0,0,0
753804,True,0,No user reviews,0,0,0
753805,True,0,No user reviews,0,0,0
753806,True,0,No user reviews,0,0,0
753807,True,0,No user reviews,0,0,0
753808,True,0,No user reviews,0,0,0
753809,True,0,No user reviews,0,0,0
753810,True,0,No user reviews,0,0,0
753811,True,0,No user reviews,0,0,0
753812,True,0,No user reviews,0,0,0
753813,True,0,No user reviews,0,0,0
753814,True,0,4 user reviews,0,4,4
753815,True,0,No user reviews,0,0,0
753816,True,0,No user reviews,0,0,0
753817,True,0,No user reviews,0,0,0
753818,True,0,No user reviews,0,0,0
753819,True,0,No user reviews,0,0,0
753820,True,0,No user reviews,0,0,0
753821,True,0,No user reviews,0,0,0
753822,True,0,No user reviews,0,0,0
753823,True,0,No user reviews,0,0,0
753824,True,0,No user reviews,0,0,0
753825,True,0,No user reviews,0,0,0
753826,True,0,No user reviews,0,0,0
753827,True,0,No user reviews,0,0,0
753828,True,0,No user reviews,0,0,0
753829,True,0,1 user reviews,1,0,1
753830,True,0,No user reviews,0,0,0
753831,True,0,No user reviews,0,0,0
753832,True,0,No user reviews,0,0,0
753833,True,0,No user reviews,0,0,0
753834,True,0,No user reviews,0,0,0
753835,True,0,No user reviews,0,0,0
753836,True,0,2 user reviews,0,2,2
753842,True,0,1 user reviews,1,0,1
753843,True,0,No user reviews,0,0,0
753844,True,0,No user reviews,0,0,0
753845,True,0,1 user reviews,1,0,1
753846,True,0,No user reviews,0,0,0
753847,True,0,No user reviews,0,0,0
753848,True,0,No user reviews,0,0,0
753849,True,0,No user reviews,0,0,0
753850,True,0,No user reviews,0,0,0
753851,True,0,No user reviews,0,0,0
753852,True,0,No user reviews,0,0,0
753853,True,0,No user reviews,0,0,0
753854,True,0,No user reviews,0,0,0
753855,True,0,No user reviews,0,0,0
753856,True,0,No user reviews,0,0,0
753857,True,0,No user reviews,0,0,0
753858,True,0,No user reviews,0,0,0
753859,True,0,1 user reviews,1,0,1
753860,True,0,No user reviews,0,0,0
753861,True,0,No user reviews,0,0,0
753862,True,0,No user reviews,0,0,0
753863,True,0,1 user reviews,1,0,1
753864,True,0,No user reviews,0,0,0
753865,True,0,No user reviews,0,0,0
753866,True,0,No user reviews,0,0,0
753867,True,0,No user reviews,0,0,0
753868,True,0,No user reviews,0,0,0
753869,True,0,No user reviews,0,0,0
753870,True,0,No user reviews,0,0,0
753871,True,0,No user reviews,0,0,0
753872,True,0,No user reviews,0,0,0
753873,True,0,1 user reviews,1,0,1
753874,True,0,1 user reviews,1,0,1
753875,True,0,1 user reviews,1,0,1
753876,True,0,1 user reviews,0,1,1
753877,True,0,1 user reviews,1,0,1
753878,True,0,No user reviews,0,0,0
753879,True,0,No user reviews,0,0,0
753880,True,0,No user reviews,0,0,0
753881,True,0,No user reviews,0,0,0
753882,True,0,No user reviews,0,0,0
753883,True,0,No user reviews,0,0,0
753884,True,0,No user reviews,0,0,0
753885,True,0,No user reviews,0,0,0
753886,True,0,No user reviews,0,0,0
753887,True,0,No user reviews,0,0,0
753888,True,0,No user reviews,0,0,0
753889,True,0,No user reviews,0,0,0
753890,True,0,No user reviews,0,0,0
753891,True,0,No user reviews,0,0,0
753892,True,0,7 user reviews,7,0,7
753893,True,0,No user reviews,0,0,0
753894,True,0,1 user reviews,1,0,1
753895,True,0,No user reviews,0,0,0
753896,True,0,No user reviews,0,0,0
753900,True,5,Mixed,24,15,39
753920,True,0,8 user reviews,3,5,8
753930,True,5,Mixed,176,85,261
753950,True,0,No user reviews,0,0,0
753960,True,0,5 user reviews,2,3,5
753980,True,0,No user reviews,0,0,0
753990,True,0,9 user reviews,4,5,9
754000,True,0,No user reviews,0,0,0
754010,True,0,No user reviews,0,0,0
754020,True,0,4 user reviews,3,1,4
754030,True,0,No user reviews,0,0,0
754040,True,8,Very Positive,48,3,51
754050,True,0,No user reviews,0,0,0
754070,True,0,No user reviews,0,0,0
754100,True,0,No user reviews,0,0,0
754110,True,0,9 user reviews,6,3,9
754120,True,5,Mixed,16,9,25
754150,True,8,Very Positive,548,30,578
754160,True,0,No user reviews,0,0,0
754190,True,0,5 user reviews,5,0,5
754200,True,0,1 user reviews,0,1,1
754230,True,0,5 user reviews,4,1,5
754260,True,0,No user reviews,0,0,0
754270,True,0,4 user reviews,4,0,4
754280,True,0,No user reviews,0,0,0
754290,True,0,1 user reviews,0,1,1
754300,True,0,6 user reviews,6,0,6
754310,True,0,5 user reviews,5,0,5
754320,True,0,5 user reviews,4,1,5
754330,True,0,4 user reviews,2,2,4
754340,True,6,Mostly Positive,18,6,24
754350,True,0,No user reviews,0,0,0
754360,True,0,No user reviews,0,0,0
754370,True,0,No user reviews,0,0,0
754380,True,0,2 user reviews,0,2,2
754400,True,0,2 user reviews,2,0,2
754410,True,0,No user reviews,0,0,0
754420,True,0,No user reviews,0,0,0
754460,True,0,6 user reviews,5,1,6
754470,True,0,1 user reviews,0,1,1
754480,True,0,No user reviews,0,0,0
754500,True,6,Mostly Positive,217,73,290
754510,True,0,4 user reviews,3,1,4
754520,True,7,Positive,12,2,14
754530,True,5,Mixed,231,126,357
754540,True,7,Positive,14,2,16
754550,True,0,No user reviews,0,0,0
754570,True,0,No user reviews,0,0,0
754571,True,0,No user reviews,0,0,0
754572,True,0,No user reviews,0,0,0
754573,True,0,No user reviews,0,0,0
754574,True,0,No user reviews,0,0,0
754575,True,0,No user reviews,0,0,0
754576,True,0,No user reviews,0,0,0
754577,True,0,No user reviews,0,0,0
754590,True,0,No user reviews,0,0,0
754610,True,4,Mostly Negative,3,7,10
754620,True,0,No user reviews,0,0,0
754630,True,0,2 user reviews,1,1,2
754640,True,0,No user reviews,0,0,0
754650,True,0,No user reviews,0,0,0
754660,True,0,No user reviews,0,0,0
754670,True,0,No user reviews,0,0,0
754680,True,6,Mostly Positive,19,5,24
754700,True,0,No user reviews,0,0,0
754730,True,0,No user reviews,0,0,0
754740,True,0,No user reviews,0,0,0
754760,True,0,No user reviews,0,0,0
754770,True,7,Positive,33,3,36
754790,True,0,6 user reviews,6,0,6
754800,True,0,1 user reviews,0,1,1
754810,True,0,1 user reviews,1,0,1
754820,True,0,No user reviews,0,0,0
754830,True,0,3 user reviews,3,0,3
754840,True,8,Very Positive,47,4,51
754850,True,5,Mixed,31,20,51
754860,True,0,No user reviews,0,0,0
754870,True,0,No user reviews,0,0,0
754880,True,0,No user reviews,0,0,0
754900,True,0,No user reviews,0,0,0
754920,True,6,Mostly Positive,17,5,22
754921,True,5,Mixed,16,14,30
754922,True,5,Mixed,9,5,14
754923,True,0,9 user reviews,4,5,9
754930,True,0,7 user reviews,5,2,7
754940,True,0,No user reviews,0,0,0
754941,True,0,No user reviews,0,0,0
754950,True,0,No user reviews,0,0,0
754951,True,0,No user reviews,0,0,0
754952,True,0,No user reviews,0,0,0
754953,True,0,No user reviews,0,0,0
754954,True,0,No user reviews,0,0,0
754955,True,0,No user reviews,0,0,0
754960,True,0,No user reviews,0,0,0
754970,True,0,No user reviews,0,0,0
754980,True,0,No user reviews,0,0,0
754981,True,0,No user reviews,0,0,0
754982,True,0,No user reviews,0,0,0
754990,True,0,No user reviews,0,0,0
755000,True,0,No user reviews,0,0,0
755010,True,0,No user reviews,0,0,0
755030,True,0,No user reviews,0,0,0
755031,True,0,No user reviews,0,0,0
755032,True,0,No user reviews,0,0,0
755033,True,0,No user reviews,0,0,0
755035,True,0,No user reviews,0,0,0
755036,True,0,No user reviews,0,0,0
755040,True,0,No user reviews,0,0,0
755070,True,0,1 user reviews,1,0,1
755071,True,0,No user reviews,0,0,0
755072,True,0,No user reviews,0,0,0
755073,True,0,No user reviews,0,0,0
755080,True,0,No user reviews,0,0,0
755100,True,0,No user reviews,0,0,0
755120,True,0,No user reviews,0,0,0
755130,True,0,3 user reviews,2,1,3
755140,True,0,2 user reviews,0,2,2
755150,True,0,No user reviews,0,0,0
755160,True,0,No user reviews,0,0,0
755180,True,0,No user reviews,0,0,0
755190,True,0,No user reviews,0,0,0
755200,True,0,No user reviews,0,0,0
755220,True,0,No user reviews,0,0,0
755230,True,0,1 user reviews,1,0,1
755240,True,0,1 user reviews,0,1,1
755250,True,0,4 user reviews,4,0,4
755260,True,0,No user reviews,0,0,0
755270,True,0,No user reviews,0,0,0
755290,True,0,2 user reviews,0,2,2
755340,True,0,2 user reviews,2,0,2
755350,True,5,Mixed,10,15,25
755360,True,0,No user reviews,0,0,0
755370,True,0,1 user reviews,1,0,1
755390,True,0,No user reviews,0,0,0
755400,True,0,No user reviews,0,0,0
755410,True,8,Very Positive,95,4,99
755420,True,0,No user reviews,0,0,0
755430,True,0,No user reviews,0,0,0
755440,True,0,No user reviews,0,0,0
755450,True,0,No user reviews,0,0,0
755470,True,8,Very Positive,86,19,105
755480,True,0,No user reviews,0,0,0
755490,True,0,7 user reviews,7,0,7
755500,True,6,Mostly Positive,241,78,319
755520,True,0,9 user reviews,8,1,9
755530,True,0,1 user reviews,1,0,1
755540,True,0,No user reviews,0,0,0
755550,True,0,No user reviews,0,0,0
755560,True,0,5 user reviews,4,1,5
755570,True,5,Mixed,20,17,37
755580,True,0,1 user reviews,0,1,1
755590,True,7,Positive,9,1,10
755600,True,6,Mostly Positive,9,3,12
755610,True,0,2 user reviews,2,0,2
755630,True,5,Mixed,23,15,38
755640,True,0,No user reviews,0,0,0
755650,True,0,No user reviews,0,0,0
755670,True,7,Positive,13,3,16
755700,True,0,No user reviews,0,0,0
755710,True,0,No user reviews,0,0,0
755720,True,0,No user reviews,0,0,0
755730,True,0,No user reviews,0,0,0
755740,True,0,No user reviews,0,0,0
755741,True,0,No user reviews,0,0,0
755742,True,0,No user reviews,0,0,0
755743,True,0,1 user reviews,0,1,1
755744,True,0,1 user reviews,0,1,1
755750,True,0,No user reviews,0,0,0
755751,True,0,No user reviews,0,0,0
755752,True,0,1 user reviews,0,1,1
755753,True,0,No user reviews,0,0,0
755754,True,0,No user reviews,0,0,0
755755,True,0,No user reviews,0,0,0
755756,True,0,3 user reviews,3,0,3
755757,True,0,4 user reviews,2,2,4
755760,True,0,1 user reviews,1,0,1
755770,True,0,No user reviews,0,0,0
755790,True,6,Mostly Positive,161,64,225
755800,True,0,No user reviews,0,0,0
755820,True,0,No user reviews,0,0,0
755830,True,0,8 user reviews,7,1,8
755840,True,0,No user reviews,0,0,0
755850,True,0,4 user reviews,2,2,4
755860,True,0,1 user reviews,1,0,1
755890,True,6,Mostly Positive,29,12,41
755920,True,0,7 user reviews,7,0,7
755950,True,7,Positive,24,3,27
755980,True,8,Very Positive,64,12,76
755990,True,0,No user reviews,0,0,0
756010,True,5,Mixed,116,103,219
756020,True,7,Positive,9,1,10
756040,True,6,Mostly Positive,12,5,17
756060,True,0,8 user reviews,7,1,8
756070,True,0,6 user reviews,5,1,6
756071,True,6,Mostly Positive,102,39,141
756080,True,0,4 user reviews,3,1,4
756090,True,4,Mostly Negative,5,10,15
756100,True,0,1 user reviews,1,0,1
756120,True,0,No user reviews,0,0,0
756121,True,0,No user reviews,0,0,0
756130,True,0,No user reviews,0,0,0
756140,True,0,No user reviews,0,0,0
756150,True,0,1 user reviews,1,0,1
756170,True,0,No user reviews,0,0,0
756180,True,0,No user reviews,0,0,0
756181,True,0,No user reviews,0,0,0
756190,True,0,1 user reviews,0,1,1
756200,True,0,No user reviews,0,0,0
756210,True,0,3 user reviews,3,0,3
756220,True,0,No user reviews,0,0,0
756230,True,0,7 user reviews,3,4,7
756240,True,6,Mostly Positive,22,7,29
756260,True,4,Mostly Negative,4,8,12
756280,True,0,7 user reviews,6,1,7
756290,True,0,2 user reviews,0,2,2
756300,True,0,No user reviews,0,0,0
756320,True,7,Positive,23,0,23
756330,True,0,No user reviews,0,0,0
756340,True,0,2 user reviews,1,1,2
756350,True,0,4 user reviews,1,3,4
756360,True,5,Mixed,25,18,43
756380,True,0,No user reviews,0,0,0
756410,True,0,No user reviews,0,0,0
756420,True,0,4 user reviews,0,4,4
756440,True,0,6 user reviews,6,0,6
756490,True,0,6 user reviews,3,3,6
756500,True,4,Mostly Negative,7,12,19
756520,True,0,3 user reviews,0,3,3
756530,True,6,Mostly Positive,96,38,134
756540,True,0,No user reviews,0,0,0
756550,True,0,No user reviews,0,0,0
756560,True,0,3 user reviews,3,0,3
756590,True,8,Very Positive,79,9,88
756600,True,7,Positive,13,2,15
756610,True,0,No user reviews,0,0,0
756611,True,0,No user reviews,0,0,0
756620,True,0,No user reviews,0,0,0
756630,True,0,4 user reviews,4,0,4
756640,True,0,No user reviews,0,0,0
756650,True,0,No user reviews,0,0,0
756660,True,8,Very Positive,420,25,445
756680,True,0,2 user reviews,2,0,2
756690,True,0,No user reviews,0,0,0
756700,True,7,Positive,13,3,16
756720,True,0,1 user reviews,0,1,1
756721,True,0,1 user reviews,1,0,1
756722,True,0,No user reviews,0,0,0
756723,True,0,No user reviews,0,0,0
756724,True,0,No user reviews,0,0,0
756725,True,0,No user reviews,0,0,0
756726,True,0,No user reviews,0,0,0
756727,True,0,No user reviews,0,0,0
756728,True,0,1 user reviews,0,1,1
756729,True,0,No user reviews,0,0,0
756730,True,0,No user reviews,0,0,0
756731,True,0,No user reviews,0,0,0
756740,True,0,1 user reviews,1,0,1
756760,True,0,No user reviews,0,0,0
756790,True,0,5 user reviews,5,0,5
756800,True,0,No user reviews,0,0,0
756810,True,0,3 user reviews,1,2,3
756840,True,0,4 user reviews,4,0,4
756860,True,0,3 user reviews,2,1,3
756880,True,5,Mixed,17,22,39
756890,True,0,1 user reviews,1,0,1
756900,True,0,No user reviews,0,0,0
756910,True,0,No user reviews,0,0,0
756920,True,0,No user reviews,0,0,0
756950,True,0,No user reviews,0,0,0
756951,True,0,2 user reviews,0,2,2
756952,True,0,No user reviews,0,0,0
756953,True,0,No user reviews,0,0,0
756954,True,0,No user reviews,0,0,0
756955,True,0,4 user reviews,3,1,4
756980,True,0,1 user reviews,1,0,1
757020,True,0,No user reviews,0,0,0
757030,True,7,Positive,12,0,12
757040,True,7,Positive,47,2,49
757050,True,0,No user reviews,0,0,0
757060,True,6,Mostly Positive,7,3,10
757070,True,0,1 user reviews,0,1,1
757080,True,7,Positive,9,2,11
757090,True,0,No user reviews,0,0,0
757100,True,0,8 user reviews,7,1,8
757120,True,0,No user reviews,0,0,0
757130,True,0,No user reviews,0,0,0
757150,True,0,No user reviews,0,0,0
757160,True,4,Mostly Negative,5,9,14
757170,True,0,2 user reviews,2,0,2
757180,True,7,Positive,42,6,48
757190,True,0,1 user reviews,1,0,1
757200,True,6,Mostly Positive,22,9,31
757210,True,8,Very Positive,154,15,169
757220,True,0,No user reviews,0,0,0
757230,True,0,2 user reviews,0,2,2
757240,True,0,1 user reviews,1,0,1
757280,True,0,2 user reviews,2,0,2
757290,True,0,No user reviews,0,0,0
757300,True,8,Very Positive,88,18,106
757310,True,0,No user reviews,0,0,0
757320,True,8,Very Positive,180,19,199
757330,True,8,Very Positive,67,7,74
757350,True,5,Mixed,6,8,14
757380,True,0,No user reviews,0,0,0
757400,True,0,1 user reviews,1,0,1
757410,True,0,No user reviews,0,0,0
757420,True,0,7 user reviews,2,5,7
757430,True,0,4 user reviews,4,0,4
757440,True,0,No user reviews,0,0,0
757450,True,6,Mostly Positive,17,5,22
757460,True,0,No user reviews,0,0,0
757480,True,8,Very Positive,442,15,457
757490,True,0,No user reviews,0,0,0
757500,True,0,2 user reviews,0,2,2
757510,True,0,8 user reviews,7,1,8
757530,True,0,No user reviews,0,0,0
757540,True,0,4 user reviews,2,2,4
757550,True,0,No user reviews,0,0,0
757560,True,0,No user reviews,0,0,0
757570,True,0,No user reviews,0,0,0
757580,True,6,Mostly Positive,12,5,17
757590,True,5,Mixed,9,8,17
757600,True,0,3 user reviews,1,2,3
757630,True,4,Mostly Negative,4,8,12
757670,True,0,No user reviews,0,0,0
757690,True,0,No user reviews,0,0,0
757700,True,0,3 user reviews,3,0,3
757730,True,7,Positive,12,1,13
757750,True,0,No user reviews,0,0,0
757760,True,0,1 user reviews,1,0,1
757770,True,0,5 user reviews,4,1,5
757780,True,0,No user reviews,0,0,0
757790,True,0,No user reviews,0,0,0
757800,True,0,No user reviews,0,0,0
757820,True,0,No user reviews,0,0,0
757860,True,5,Mixed,5,7,12
757870,True,0,4 user reviews,3,1,4
757890,True,0,No user reviews,0,0,0
757900,True,0,No user reviews,0,0,0
757910,True,0,No user reviews,0,0,0
757920,True,0,No user reviews,0,0,0
757930,True,0,No user reviews,0,0,0
757940,True,0,No user reviews,0,0,0
757960,True,0,No user reviews,0,0,0
757970,True,0,No user reviews,0,0,0
757980,True,0,No user reviews,0,0,0
757990,True,0,2 user reviews,1,1,2
758020,True,0,1 user reviews,1,0,1
758030,True,0,No user reviews,0,0,0
758040,True,0,No user reviews,0,0,0
758050,True,4,Mostly Negative,4,7,11
758070,True,7,Positive,9,1,10
758080,True,6,Mostly Positive,43,14,57
758090,True,7,Positive,17,0,17
758100,True,5,Mixed,29,22,51
758110,True,0,No user reviews,0,0,0
758120,True,5,Mixed,8,6,14
758130,True,0,No user reviews,0,0,0
758140,True,0,1 user reviews,0,1,1
758150,True,0,5 user reviews,4,1,5
758160,True,8,Very Positive,60,0,60
758170,True,0,6 user reviews,5,1,6
758180,True,0,No user reviews,0,0,0
758190,True,8,Very Positive,589,92,681
758210,True,0,No user reviews,0,0,0
758220,True,0,5 user reviews,4,1,5
758230,True,8,Very Positive,170,6,176
758250,True,5,Mixed,12,6,18
758270,True,0,No user reviews,0,0,0
758280,True,0,No user reviews,0,0,0
758290,True,0,5 user reviews,5,0,5
758320,True,6,Mostly Positive,48,14,62
758330,True,8,Very Positive,627,76,703
758350,True,0,No user reviews,0,0,0
758360,True,0,No user reviews,0,0,0
758370,True,8,Very Positive,455,51,506
758380,True,0,No user reviews,0,0,0
758390,True,0,4 user reviews,1,3,4
758400,True,0,3 user reviews,2,1,3
758410,True,6,Mostly Positive,89,25,114
758420,True,5,Mixed,268,128,396
758440,True,0,7 user reviews,5,2,7
758450,True,0,No user reviews,0,0,0
758470,True,0,7 user reviews,4,3,7
758480,True,8,Very Positive,211,9,220
758500,True,8,Very Positive,277,15,292
758520,True,0,No user reviews,0,0,0
758530,True,0,No user reviews,0,0,0
758540,True,0,No user reviews,0,0,0
758560,True,7,Positive,15,0,15
758570,True,8,Very Positive,58,12,70
758580,True,0,3 user reviews,3,0,3
758590,True,0,3 user reviews,3,0,3
758600,True,0,3 user reviews,2,1,3
758610,True,0,1 user reviews,0,1,1
758620,True,0,No user reviews,0,0,0
758630,True,0,5 user reviews,5,0,5
758640,True,0,1 user reviews,1,0,1
758650,True,0,No user reviews,0,0,0
758660,True,7,Positive,24,1,25
758680,True,0,No user reviews,0,0,0
758690,True,0,No user reviews,0,0,0
758720,True,0,No user reviews,0,0,0
758730,True,8,Very Positive,43,10,53
758770,True,4,Mostly Negative,13,20,33
758771,True,4,Mostly Negative,6,12,18
758790,True,0,1 user reviews,0,1,1
758840,True,0,No user reviews,0,0,0
758870,True,8,Very Positive,455,51,506
758880,True,0,8 user reviews,5,3,8
758910,True,0,1 user reviews,1,0,1
758920,True,0,No user reviews,0,0,0
758930,True,7,Positive,33,6,39
758980,True,0,No user reviews,0,0,0
758990,True,8,Very Positive,612,57,669
759000,True,7,Positive,41,5,46
759010,True,0,6 user reviews,3,3,6
759020,True,0,No user reviews,0,0,0
759030,True,0,No user reviews,0,0,0
759040,True,0,No user reviews,0,0,0
759060,True,6,Mostly Positive,17,6,23
759070,True,0,No user reviews,0,0,0
759071,True,0,No user reviews,0,0,0
759072,True,0,No user reviews,0,0,0
759080,True,0,No user reviews,0,0,0
759130,True,6,Mostly Positive,54,14,68
759140,True,0,No user reviews,0,0,0
759150,True,0,No user reviews,0,0,0
759151,True,0,No user reviews,0,0,0
759152,True,0,No user reviews,0,0,0
759153,True,0,No user reviews,0,0,0
759154,True,0,No user reviews,0,0,0
759155,True,0,No user reviews,0,0,0
759156,True,0,No user reviews,0,0,0
759157,True,0,No user reviews,0,0,0
759160,True,5,Mixed,6,6,12
759170,True,0,1 user reviews,1,0,1
759180,True,0,No user reviews,0,0,0
759220,True,7,Positive,15,1,16
759230,True,0,No user reviews,0,0,0
759240,True,0,4 user reviews,4,0,4
759250,True,0,3 user reviews,3,0,3
759260,True,0,8 user reviews,6,2,8
759280,True,0,1 user reviews,0,1,1
759300,True,0,No user reviews,0,0,0
759320,True,0,No user reviews,0,0,0
759330,True,0,1 user reviews,1,0,1
759350,True,0,No user reviews,0,0,0
759380,True,0,No user reviews,0,0,0
759390,True,0,No user reviews,0,0,0
759410,True,0,No user reviews,0,0,0
759411,True,0,No user reviews,0,0,0
759412,True,0,No user reviews,0,0,0
759413,True,0,No user reviews,0,0,0
759414,True,0,No user reviews,0,0,0
759415,True,0,No user reviews,0,0,0
759416,True,0,No user reviews,0,0,0
759417,True,0,No user reviews,0,0,0
759418,True,0,No user reviews,0,0,0
759420,True,0,No user reviews,0,0,0
759440,True,8,Very Positive,105,11,116
759454,True,0,2 user reviews,2,0,2
759455,True,0,2 user reviews,2,0,2
759490,True,0,No user reviews,0,0,0
759500,True,0,6 user reviews,5,1,6
759510,True,0,No user reviews,0,0,0
759530,True,0,No user reviews,0,0,0
759540,True,6,Mostly Positive,55,14,69
759560,True,0,No user reviews,0,0,0
759570,True,5,Mixed,22,26,48
759580,True,0,5 user reviews,4,1,5
759581,True,0,2 user reviews,2,0,2
759590,True,0,3 user reviews,3,0,3
759610,True,0,3 user reviews,2,1,3
759640,True,7,Positive,17,1,18
759650,True,0,1 user reviews,1,0,1
759670,True,0,No user reviews,0,0,0
759680,True,0,1 user reviews,1,0,1
759681,True,0,2 user reviews,2,0,2
759740,True,6,Mostly Positive,540,141,681
759750,True,5,Mixed,9,10,19
759760,True,0,2 user reviews,2,0,2
759770,True,0,4 user reviews,3,1,4
759810,True,0,No user reviews,0,0,0
759820,True,0,No user reviews,0,0,0
759830,True,0,7 user reviews,4,3,7
759840,True,0,No user reviews,0,0,0
759850,True,0,1 user reviews,1,0,1
759870,True,3,Negative,3,16,19
759900,True,0,No user reviews,0,0,0
759910,True,0,No user reviews,0,0,0
759920,True,0,No user reviews,0,0,0
759940,True,0,8 user reviews,8,0,8
759950,True,0,8 user reviews,4,4,8
759970,True,0,No user reviews,0,0,0
759980,True,0,No user reviews,0,0,0
760000,True,0,2 user reviews,2,0,2
760010,True,0,No user reviews,0,0,0
760020,True,0,4 user reviews,3,1,4
760030,True,0,2 user reviews,2,0,2
760050,True,7,Positive,29,6,35
760060,True,8,Very Positive,4265,496,4761
760070,True,6,Mostly Positive,86,32,118
760080,True,6,Mostly Positive,25,10,35
760120,True,0,1 user reviews,0,1,1
760130,True,0,No user reviews,0,0,0
760180,True,0,3 user reviews,2,1,3
760190,True,0,No user reviews,0,0,0
760200,True,7,Positive,36,3,39
760220,True,0,2 user reviews,2,0,2
760240,True,0,No user reviews,0,0,0
760250,True,0,No user reviews,0,0,0
760260,True,0,No user reviews,0,0,0
760300,True,0,7 user reviews,7,0,7
760320,True,6,Mostly Positive,7,3,10
760330,True,8,Very Positive,175,8,183
760340,True,0,No user reviews,0,0,0
760350,True,5,Mixed,8,5,13
760360,True,0,2 user reviews,0,2,2
760390,True,0,1 user reviews,1,0,1
760400,True,5,Mixed,12,6,18
760410,True,0,No user reviews,0,0,0
760420,True,0,1 user reviews,0,1,1
760460,True,5,Mixed,30,22,52
760490,True,0,No user reviews,0,0,0
760510,True,0,7 user reviews,7,0,7
760520,True,0,2 user reviews,1,1,2
760530,True,0,1 user reviews,0,1,1
760550,True,0,No user reviews,0,0,0
760560,True,5,Mixed,6,6,12
760570,True,0,No user reviews,0,0,0
760571,True,0,No user reviews,0,0,0
760572,True,0,No user reviews,0,0,0
760573,True,0,No user reviews,0,0,0
760580,True,0,2 user reviews,1,1,2
760590,True,0,No user reviews,0,0,0
760610,True,0,7 user reviews,7,0,7
760620,True,6,Mostly Positive,165,58,223
760630,True,7,Positive,40,4,44
760650,True,8,Very Positive,63,12,75
760660,True,0,6 user reviews,1,5,6
760680,True,0,4 user reviews,2,2,4
760710,True,0,2 user reviews,1,1,2
760720,True,0,5 user reviews,5,0,5
760730,True,6,Mostly Positive,47,18,65
760760,True,0,No user reviews,0,0,0
760800,True,6,Mostly Positive,35,15,50
760810,True,7,Positive,40,1,41
760830,True,0,No user reviews,0,0,0
760840,True,4,Mostly Negative,4,8,12
760841,True,4,Mostly Negative,4,7,11
760842,True,3,Negative,2,13,15
760843,True,4,Mostly Negative,17,38,55
760844,True,0,7 user reviews,1,6,7
760860,True,5,Mixed,7,7,14
760890,True,8,Very Positive,154,3,157
760900,True,0,No user reviews,0,0,0
760910,True,0,No user reviews,0,0,0
760920,True,7,Positive,19,1,20
760930,True,5,Mixed,16,14,30
760940,True,0,No user reviews,0,0,0
760950,True,0,No user reviews,0,0,0
760960,True,0,4 user reviews,3,1,4
760970,True,0,2 user reviews,2,0,2
760980,True,0,No user reviews,0,0,0
761000,True,0,No user reviews,0,0,0
761010,True,0,No user reviews,0,0,0
761020,True,0,No user reviews,0,0,0
761030,True,8,Very Positive,120,27,147
761040,True,0,5 user reviews,5,0,5
761070,True,0,No user reviews,0,0,0
761080,True,0,No user reviews,0,0,0
761090,True,0,No user reviews,0,0,0
761100,True,0,1 user reviews,1,0,1
761110,True,0,4 user reviews,1,3,4
761130,True,0,No user reviews,0,0,0
761140,True,0,No user reviews,0,0,0
761150,True,0,No user reviews,0,0,0
761160,True,0,4 user reviews,4,0,4
761170,True,7,Positive,33,2,35
761190,True,0,5 user reviews,4,1,5
761210,True,0,No user reviews,0,0,0
761220,True,0,4 user reviews,2,2,4
761230,True,0,No user reviews,0,0,0
761231,True,0,No user reviews,0,0,0
761240,True,0,No user reviews,0,0,0
761250,True,0,7 user reviews,1,6,7
761270,True,0,No user reviews,0,0,0
761280,True,0,No user reviews,0,0,0
761290,True,0,3 user reviews,3,0,3
761300,True,0,1 user reviews,1,0,1
761320,True,7,Positive,25,5,30
761350,True,8,Very Positive,53,5,58
761400,True,0,No user reviews,0,0,0
761440,True,0,2 user reviews,2,0,2
761450,True,0,No user reviews,0,0,0
761460,True,8,Very Positive,214,22,236
761480,True,7,Positive,21,0,21
761530,True,0,No user reviews,0,0,0
761560,True,0,No user reviews,0,0,0
761570,True,0,No user reviews,0,0,0
761590,True,0,6 user reviews,6,0,6
761591,True,0,4 user reviews,4,0,4
761592,True,0,3 user reviews,3,0,3
761593,True,0,3 user reviews,3,0,3
761594,True,0,4 user reviews,4,0,4
761595,True,0,2 user reviews,2,0,2
761596,True,7,Positive,10,0,10
761597,True,0,1 user reviews,1,0,1
761600,True,8,Very Positive,407,23,430
761620,True,8,Very Positive,367,77,444
761630,True,3,Negative,1,9,10
761640,True,0,9 user reviews,1,8,9
761660,True,0,3 user reviews,0,3,3
761670,True,7,Positive,16,0,16
761680,True,0,No user reviews,0,0,0
761700,True,5,Mixed,6,4,10
761720,True,0,No user reviews,0,0,0
761760,True,5,Mixed,10,6,16
761770,True,0,No user reviews,0,0,0
761790,True,5,Mixed,8,7,15
761830,True,0,No user reviews,0,0,0
761880,True,0,1 user reviews,1,0,1
761890,True,5,Mixed,539,235,774
761900,True,0,No user reviews,0,0,0
761910,True,8,Very Positive,134,18,152
761920,True,0,2 user reviews,2,0,2
761930,True,0,1 user reviews,0,1,1
761970,True,0,No user reviews,0,0,0
761980,True,0,No user reviews,0,0,0
761990,True,0,No user reviews,0,0,0
762000,True,0,No user reviews,0,0,0
762030,True,7,Positive,16,1,17
762060,True,0,No user reviews,0,0,0
762070,True,0,1 user reviews,1,0,1
762080,True,6,Mostly Positive,28,11,39
762090,True,0,No user reviews,0,0,0
762100,True,0,No user reviews,0,0,0
762110,True,0,3 user reviews,3,0,3
762120,True,0,2 user reviews,0,2,2
762130,True,0,2 user reviews,1,1,2
762140,True,0,1 user reviews,0,1,1
762150,True,0,No user reviews,0,0,0
762174,True,7,Positive,30,0,30
762176,True,0,1 user reviews,1,0,1
762177,True,0,4 user reviews,4,0,4
762178,True,0,3 user reviews,3,0,3
762179,True,0,5 user reviews,4,1,5
762180,True,7,Positive,17,0,17
762190,True,0,6 user reviews,6,0,6
762220,True,6,Mostly Positive,34,10,44
762240,True,0,5 user reviews,5,0,5
762250,True,0,No user reviews,0,0,0
762270,True,0,8 user reviews,8,0,8
762290,True,0,1 user reviews,1,0,1
762300,True,0,1 user reviews,1,0,1
762310,True,0,1 user reviews,1,0,1
762320,True,0,1 user reviews,1,0,1
762330,True,0,1 user reviews,1,0,1
762340,True,0,1 user reviews,1,0,1
762350,True,0,1 user reviews,1,0,1
762360,True,0,1 user reviews,1,0,1
762380,True,5,Mixed,5,5,10
762390,True,0,2 user reviews,2,0,2
762420,True,0,No user reviews,0,0,0
762440,True,0,No user reviews,0,0,0
762450,True,0,No user reviews,0,0,0
762480,True,0,No user reviews,0,0,0
762490,True,6,Mostly Positive,22,9,31
762500,True,7,Positive,11,2,13
762520,True,5,Mixed,12,10,22
762530,True,0,No user reviews,0,0,0
762540,True,0,No user reviews,0,0,0
762550,True,0,No user reviews,0,0,0
762560,True,0,No user reviews,0,0,0
762590,True,7,Positive,12,3,15
762600,True,0,7 user reviews,6,1,7
762610,True,8,Very Positive,89,2,91
762630,True,0,4 user reviews,2,2,4
762640,True,0,1 user reviews,1,0,1
762650,True,5,Mixed,283,125,408
762660,True,0,No user reviews,0,0,0
762670,True,0,2 user reviews,1,1,2
762680,True,0,3 user reviews,1,2,3
762770,True,7,Positive,12,1,13
762780,True,0,No user reviews,0,0,0
762800,True,0,No user reviews,0,0,0
762830,True,5,Mixed,227,112,339
762840,True,0,No user reviews,0,0,0
762850,True,0,No user reviews,0,0,0
762860,True,0,1 user reviews,1,0,1
762870,True,0,No user reviews,0,0,0
762880,True,0,No user reviews,0,0,0
762900,True,0,6 user reviews,2,4,6
762912,True,7,Positive,12,0,12
762913,True,7,Positive,21,1,22
762914,True,0,3 user reviews,3,0,3
762915,True,0,9 user reviews,9,0,9
762916,True,0,4 user reviews,4,0,4
762918,True,0,3 user reviews,3,0,3
762919,True,0,4 user reviews,4,0,4
762920,True,4,Mostly Negative,10,18,28
762930,True,7,Positive,18,0,18
762940,True,0,No user reviews,0,0,0
762950,True,0,4 user reviews,3,1,4
762970,True,0,1 user reviews,0,1,1
762980,True,0,1 user reviews,1,0,1
763000,True,0,No user reviews,0,0,0
763010,True,0,5 user reviews,4,1,5
763030,True,8,Very Positive,49,4,53
763050,True,0,9 user reviews,5,4,9
763070,True,5,Mixed,8,4,12
763090,True,5,Mixed,4,6,10
763100,True,5,Mixed,24,13,37
763170,True,0,No user reviews,0,0,0
763180,True,0,No user reviews,0,0,0
763200,True,0,No user reviews,0,0,0
763210,True,0,7 user reviews,3,4,7
763220,True,0,No user reviews,0,0,0
763230,True,0,No user reviews,0,0,0
763250,True,6,Mostly Positive,69,22,91
763260,True,0,No user reviews,0,0,0
763270,True,6,Mostly Positive,8,3,11
763280,True,0,2 user reviews,2,0,2
763290,True,5,Mixed,15,10,25
763300,True,0,5 user reviews,1,4,5
763320,True,0,3 user reviews,3,0,3
763340,True,0,No user reviews,0,0,0
763350,True,0,3 user reviews,3,0,3
763360,True,0,5 user reviews,3,2,5
763370,True,0,6 user reviews,4,2,6
763380,True,0,2 user reviews,2,0,2
763390,True,0,No user reviews,0,0,0
763400,True,0,2 user reviews,0,2,2
763410,True,0,No user reviews,0,0,0
763420,True,0,No user reviews,0,0,0
763430,True,6,Mostly Positive,47,15,62
763470,True,0,No user reviews,0,0,0
763490,True,0,1 user reviews,1,0,1
763520,True,0,4 user reviews,2,2,4
763560,True,0,No user reviews,0,0,0
763570,True,0,No user reviews,0,0,0
763580,True,0,No user reviews,0,0,0
763590,True,0,1 user reviews,1,0,1
763600,True,0,No user reviews,0,0,0
763610,True,0,No user reviews,0,0,0
763630,True,0,5 user reviews,3,2,5
763650,True,0,No user reviews,0,0,0
763680,True,0,1 user reviews,0,1,1
763691,True,0,4 user reviews,4,0,4
763692,True,0,4 user reviews,4,0,4
763693,True,7,Positive,12,0,12
763695,True,0,No user reviews,0,0,0
763696,True,0,No user reviews,0,0,0
763697,True,0,No user reviews,0,0,0
763698,True,0,No user reviews,0,0,0
763699,True,8,Very Positive,51,3,54
763710,True,0,7 user reviews,5,2,7
763720,True,0,No user reviews,0,0,0
763730,True,0,8 user reviews,5,3,8
763740,True,0,3 user reviews,1,2,3
763750,True,0,5 user reviews,3,2,5
763760,True,7,Positive,16,1,17
763770,True,5,Mixed,13,6,19
763780,True,8,Very Positive,288,27,315
763790,True,7,Positive,29,2,31
763810,True,0,6 user reviews,4,2,6
763820,True,5,Mixed,123,120,243
763860,True,0,No user reviews,0,0,0
763870,True,0,No user reviews,0,0,0
763880,True,0,No user reviews,0,0,0
763890,True,9,Overwhelmingly Positive,1418,44,1462
763910,True,7,Positive,18,4,22
763920,True,0,No user reviews,0,0,0
763930,True,8,Very Positive,49,1,50
763940,True,0,No user reviews,0,0,0
763950,True,0,6 user reviews,2,4,6
763960,True,0,No user reviews,0,0,0
763970,True,7,Positive,26,6,32
763990,True,5,Mixed,12,7,19
764010,True,5,Mixed,16,15,31
764030,True,0,No user reviews,0,0,0
764040,True,0,No user reviews,0,0,0
764050,True,8,Very Positive,443,103,546
764080,True,0,No user reviews,0,0,0
764090,True,0,3 user reviews,3,0,3
764110,True,7,Positive,8,2,10
764180,True,0,6 user reviews,5,1,6
764230,True,8,Very Positive,52,5,57
764240,True,7,Positive,8,2,10
764250,True,0,No user reviews,0,0,0
764270,True,0,No user reviews,0,0,0
764280,True,0,7 user reviews,7,0,7
764300,True,8,Very Positive,142,10,152
764320,True,0,2 user reviews,1,1,2
764330,True,0,1 user reviews,1,0,1
764331,True,0,No user reviews,0,0,0
764340,True,0,1 user reviews,1,0,1
764350,True,0,No user reviews,0,0,0
764370,True,0,7 user reviews,7,0,7
764390,True,0,1 user reviews,1,0,1
764410,True,0,1 user reviews,0,1,1
764430,True,5,Mixed,8,5,13
764460,True,0,No user reviews,0,0,0
764470,True,0,6 user reviews,4,2,6
764490,True,0,4 user reviews,1,3,4
764500,True,7,Positive,27,6,33
764510,True,8,Very Positive,63,11,74
764530,True,0,No user reviews,0,0,0
764550,True,0,1 user reviews,0,1,1
764560,True,5,Mixed,10,5,15
764570,True,0,No user reviews,0,0,0
764590,True,6,Mostly Positive,15,4,19
764600,True,0,No user reviews,0,0,0
764620,True,0,No user reviews,0,0,0
764630,True,0,No user reviews,0,0,0
764660,True,0,1 user reviews,1,0,1
764661,True,0,2 user reviews,2,0,2
764670,True,5,Mixed,10,9,19
764690,True,0,No user reviews,0,0,0
764720,True,0,2 user reviews,2,0,2
764740,True,0,No user reviews,0,0,0
764750,True,0,No user reviews,0,0,0
764780,True,0,1 user reviews,0,1,1
764790,True,8,Very Positive,1996,132,2128
764830,True,0,4 user reviews,2,2,4
764860,True,0,No user reviews,0,0,0
764870,True,0,No user reviews,0,0,0
764880,True,0,1 user reviews,1,0,1
764890,True,0,4 user reviews,4,0,4
764900,True,0,No user reviews,0,0,0
764920,True,5,Mixed,151,113,264
764940,True,0,No user reviews,0,0,0
764950,True,0,No user reviews,0,0,0
764970,True,0,8 user reviews,7,1,8
764990,True,7,Positive,21,1,22
765010,True,0,1 user reviews,1,0,1
765020,True,0,No user reviews,0,0,0
765030,True,0,1 user reviews,1,0,1
765040,True,0,1 user reviews,1,0,1
765050,True,0,1 user reviews,0,1,1
765060,True,7,Positive,11,1,12
765080,True,0,No user reviews,0,0,0
765090,True,0,No user reviews,0,0,0
765100,True,7,Positive,10,0,10
765140,True,0,2 user reviews,1,1,2
765160,True,0,8 user reviews,4,4,8
765170,True,0,No user reviews,0,0,0
765180,True,4,Mostly Negative,6,14,20
765190,True,0,No user reviews,0,0,0
765210,True,6,Mostly Positive,48,16,64
765230,True,0,9 user reviews,8,1,9
765240,True,0,No user reviews,0,0,0
765250,True,5,Mixed,25,20,45
765260,True,0,3 user reviews,1,2,3
765290,True,0,No user reviews,0,0,0
765320,True,0,3 user reviews,1,2,3
765340,True,0,1 user reviews,0,1,1
765350,True,0,3 user reviews,3,0,3
765360,True,0,3 user reviews,3,0,3
765370,True,0,3 user reviews,0,3,3
765380,True,5,Mixed,8,4,12
765390,True,0,8 user reviews,1,7,8
765400,True,0,5 user reviews,1,4,5
765410,True,9,Overwhelmingly Positive,2103,92,2195
765420,True,0,No user reviews,0,0,0
765430,True,0,5 user reviews,5,0,5
765440,True,0,No user reviews,0,0,0
765450,True,0,No user reviews,0,0,0
765460,True,0,6 user reviews,4,2,6
765470,True,0,4 user reviews,2,2,4
765490,True,0,7 user reviews,6,1,7
765510,True,0,No user reviews,0,0,0
765520,True,0,2 user reviews,2,0,2
765530,True,0,3 user reviews,0,3,3
765560,True,0,7 user reviews,4,3,7
765570,True,0,3 user reviews,1,2,3
765590,True,7,Positive,16,2,18
765600,True,0,No user reviews,0,0,0
765610,True,7,Positive,16,2,18
765620,True,0,1 user reviews,0,1,1
765630,True,0,No user reviews,0,0,0
765640,True,0,4 user reviews,4,0,4
765650,True,0,No user reviews,0,0,0
765660,True,0,No user reviews,0,0,0
765670,True,0,No user reviews,0,0,0
765690,True,7,Positive,14,0,14
765700,True,0,No user reviews,0,0,0
765710,True,0,1 user reviews,1,0,1
765730,True,0,3 user reviews,0,3,3
765750,True,0,4 user reviews,4,0,4
765760,True,0,No user reviews,0,0,0
765770,True,0,8 user reviews,7,1,8
765780,True,0,No user reviews,0,0,0
765790,True,0,3 user reviews,1,2,3
765800,True,0,No user reviews,0,0,0
765810,True,0,No user reviews,0,0,0
765820,True,0,No user reviews,0,0,0
765830,True,0,4 user reviews,4,0,4
765840,True,0,9 user reviews,8,1,9
765850,True,0,6 user reviews,6,0,6
765860,True,0,5 user reviews,4,1,5
765870,True,8,Very Positive,238,50,288
765880,True,6,Mostly Positive,46,14,60
765890,True,7,Positive,25,1,26
765900,True,6,Mostly Positive,59,19,78
765910,True,0,7 user reviews,7,0,7
765930,True,0,3 user reviews,0,3,3
765940,True,7,Positive,18,1,19
765950,True,0,5 user reviews,2,3,5
765960,True,7,Positive,32,3,35
765970,True,0,No user reviews,0,0,0
766000,True,7,Positive,10,2,12
766010,True,0,1 user reviews,1,0,1
766030,True,7,Positive,10,0,10
766040,True,5,Mixed,31,30,61
766060,True,0,No user reviews,0,0,0
766070,True,0,1 user reviews,0,1,1
766090,True,0,No user reviews,0,0,0
766100,True,0,No user reviews,0,0,0
766101,True,0,No user reviews,0,0,0
766102,True,0,No user reviews,0,0,0
766110,True,0,No user reviews,0,0,0
766130,True,0,No user reviews,0,0,0
766150,True,0,1 user reviews,1,0,1
766170,True,0,No user reviews,0,0,0
766171,True,0,No user reviews,0,0,0
766172,True,0,No user reviews,0,0,0
766173,True,0,No user reviews,0,0,0
766180,True,0,No user reviews,0,0,0
766200,True,0,No user reviews,0,0,0
766210,True,0,No user reviews,0,0,0
766250,True,0,No user reviews,0,0,0
766280,True,8,Very Positive,124,10,134
766300,True,0,3 user reviews,3,0,3
766310,True,0,No user reviews,0,0,0
766320,True,6,Mostly Positive,58,17,75
766350,True,0,No user reviews,0,0,0
766360,True,0,No user reviews,0,0,0
766370,True,5,Mixed,262,165,427
766400,True,0,No user reviews,0,0,0
766401,True,0,No user reviews,0,0,0
766402,True,0,No user reviews,0,0,0
766403,True,0,No user reviews,0,0,0
766404,True,0,No user reviews,0,0,0
766405,True,0,No user reviews,0,0,0
766406,True,0,No user reviews,0,0,0
766407,True,0,No user reviews,0,0,0
766408,True,0,No user reviews,0,0,0
766409,True,0,No user reviews,0,0,0
766410,True,0,No user reviews,0,0,0
766411,True,0,No user reviews,0,0,0
766412,True,0,No user reviews,0,0,0
766420,True,0,2 user reviews,1,1,2
766430,True,0,No user reviews,0,0,0
766440,True,0,No user reviews,0,0,0
766441,True,0,No user reviews,0,0,0
766442,True,0,No user reviews,0,0,0
766443,True,0,No user reviews,0,0,0
766444,True,0,No user reviews,0,0,0
766445,True,0,No user reviews,0,0,0
766446,True,0,No user reviews,0,0,0
766447,True,0,No user reviews,0,0,0
766448,True,0,No user reviews,0,0,0
766449,True,0,1 user reviews,1,0,1
766450,True,0,3 user reviews,3,0,3
766460,True,0,2 user reviews,0,2,2
766470,True,0,No user reviews,0,0,0
766471,True,0,1 user reviews,1,0,1
766472,True,0,1 user reviews,1,0,1
766490,True,0,No user reviews,0,0,0
766491,True,0,No user reviews,0,0,0
766500,True,0,1 user reviews,1,0,1
766520,True,0,No user reviews,0,0,0
766521,True,0,2 user reviews,2,0,2
766550,True,6,Mostly Positive,7,3,10
766560,True,7,Positive,9,1,10
766570,True,0,No user reviews,0,0,0
766580,True,0,2 user reviews,0,2,2
766600,True,4,Mostly Negative,3,7,10
766610,True,0,No user reviews,0,0,0
766611,True,0,No user reviews,0,0,0
766620,True,0,1 user reviews,0,1,1
766630,True,7,Positive,39,8,47
766650,True,0,No user reviews,0,0,0
766680,True,5,Mixed,12,9,21
766700,True,0,7 user reviews,3,4,7
766710,True,0,1 user reviews,1,0,1
766711,True,0,No user reviews,0,0,0
766712,True,0,3 user reviews,2,1,3
766730,True,8,Very Positive,83,6,89
766740,True,0,9 user reviews,8,1,9
766770,True,0,No user reviews,0,0,0
766780,True,0,6 user reviews,6,0,6
766850,True,5,Mixed,28,27,55
766870,True,8,Very Positive,50,10,60
766880,True,0,No user reviews,0,0,0
766900,True,0,No user reviews,0,0,0
766910,True,0,1 user reviews,1,0,1
766930,True,0,No user reviews,0,0,0
766940,True,7,Positive,25,1,26
766990,True,0,No user reviews,0,0,0
767000,True,0,No user reviews,0,0,0
767010,True,0,1 user reviews,1,0,1
767020,True,0,2 user reviews,2,0,2
767030,True,5,Mixed,5,6,11
767050,True,4,Mostly Negative,4,7,11
767080,True,0,No user reviews,0,0,0
767100,True,0,5 user reviews,2,3,5
767110,True,5,Mixed,4,6,10
767120,True,0,No user reviews,0,0,0
767130,True,0,4 user reviews,1,3,4
767140,True,0,No user reviews,0,0,0
767150,True,0,No user reviews,0,0,0
767170,True,0,1 user reviews,0,1,1
767180,True,0,No user reviews,0,0,0
767190,True,0,4 user reviews,4,0,4
767200,True,0,2 user reviews,2,0,2
767220,True,0,No user reviews,0,0,0
767230,True,0,No user reviews,0,0,0
767240,True,7,Positive,12,3,15
767260,True,0,1 user reviews,1,0,1
767300,True,0,No user reviews,0,0,0
767310,True,0,7 user reviews,1,6,7
767330,True,0,4 user reviews,0,4,4
767340,True,0,7 user reviews,3,4,7
767360,True,7,Positive,17,1,18
767380,True,0,No user reviews,0,0,0
767390,True,5,Mixed,97,46,143
767400,True,0,1 user reviews,1,0,1
767410,True,0,No user reviews,0,0,0
767420,True,0,No user reviews,0,0,0
767460,True,7,Positive,19,4,23
767470,True,0,No user reviews,0,0,0
767490,True,6,Mostly Positive,33,9,42
767500,True,0,5 user reviews,5,0,5
767510,True,0,No user reviews,0,0,0
767530,True,0,No user reviews,0,0,0
767550,True,0,No user reviews,0,0,0
767560,True,0,No user reviews,0,0,0
767570,True,7,Positive,13,0,13
767580,True,0,2 user reviews,1,1,2
767590,True,0,No user reviews,0,0,0
767650,True,7,Positive,11,0,11
767660,True,0,No user reviews,0,0,0
767680,True,0,No user reviews,0,0,0
767690,True,0,No user reviews,0,0,0
767810,True,0,1 user reviews,1,0,1
767840,True,0,2 user reviews,1,1,2
767860,True,0,No user reviews,0,0,0
767870,True,0,No user reviews,0,0,0
767880,True,0,No user reviews,0,0,0
767890,True,5,Mixed,8,5,13
767910,True,0,3 user reviews,0,3,3
767930,True,8,Very Positive,138,15,153
767960,True,0,3 user reviews,1,2,3
767970,True,6,Mostly Positive,11,3,14
767980,True,0,4 user reviews,3,1,4
767990,True,0,No user reviews,0,0,0
768010,True,0,No user reviews,0,0,0
768020,True,0,2 user reviews,1,1,2
768050,True,0,7 user reviews,4,3,7
768060,True,7,Positive,15,2,17
768090,True,0,7 user reviews,5,2,7
768100,True,0,No user reviews,0,0,0
768110,True,0,1 user reviews,1,0,1
768120,True,0,No user reviews,0,0,0
768130,True,0,2 user reviews,1,1,2
768160,True,0,No user reviews,0,0,0
768170,True,0,4 user reviews,1,3,4
768180,True,0,No user reviews,0,0,0
768200,True,0,No user reviews,0,0,0
768210,True,0,No user reviews,0,0,0
768220,True,0,No user reviews,0,0,0
768240,True,0,3 user reviews,3,0,3
768270,True,0,9 user reviews,9,0,9
768290,True,7,Positive,13,1,14
768300,True,0,2 user reviews,1,1,2
768310,True,0,1 user reviews,1,0,1
768340,True,0,3 user reviews,3,0,3
768370,True,5,Mixed,30,32,62
768450,True,0,No user reviews,0,0,0
768460,True,6,Mostly Positive,12,4,16
768480,True,0,2 user reviews,2,0,2
768500,True,0,No user reviews,0,0,0
768520,True,0,No user reviews,0,0,0
768530,True,5,Mixed,42,19,61
768540,True,5,Mixed,17,11,28
768550,True,0,9 user reviews,6,3,9
768560,True,0,No user reviews,0,0,0
768561,True,0,2 user reviews,0,2,2
768562,True,0,2 user reviews,2,0,2
768570,True,0,3 user reviews,0,3,3
768580,True,0,7 user reviews,6,1,7
768590,True,7,Positive,10,1,11
768600,True,0,No user reviews,0,0,0
768620,True,0,No user reviews,0,0,0
768630,True,0,No user reviews,0,0,0
768640,True,0,2 user reviews,2,0,2
768680,True,0,No user reviews,0,0,0
768690,True,0,No user reviews,0,0,0
768700,True,0,No user reviews,0,0,0
768701,True,0,No user reviews,0,0,0
768702,True,0,1 user reviews,1,0,1
768703,True,0,1 user reviews,0,1,1
768710,True,0,No user reviews,0,0,0
768730,True,0,2 user reviews,1,1,2
768750,True,5,Mixed,54,68,122
768770,True,0,2 user reviews,2,0,2
768790,True,0,No user reviews,0,0,0
768800,True,6,Mostly Positive,26,9,35
768820,True,0,No user reviews,0,0,0
768830,True,8,Very Positive,55,8,63
768840,True,0,No user reviews,0,0,0
768850,True,0,No user reviews,0,0,0
768851,True,0,No user reviews,0,0,0
768852,True,0,No user reviews,0,0,0
768853,True,0,No user reviews,0,0,0
768854,True,0,No user reviews,0,0,0
768855,True,0,No user reviews,0,0,0
768856,True,0,No user reviews,0,0,0
768880,True,0,4 user reviews,3,1,4
768910,True,0,No user reviews,0,0,0
768920,True,0,No user reviews,0,0,0
768930,True,0,No user reviews,0,0,0
768950,True,0,No user reviews,0,0,0
768970,True,0,No user reviews,0,0,0
768990,True,0,8 user reviews,4,4,8
769000,True,0,No user reviews,0,0,0
769010,True,0,No user reviews,0,0,0
769020,True,0,2 user reviews,2,0,2
769030,True,0,No user reviews,0,0,0
769060,True,0,8 user reviews,6,2,8
769080,True,0,5 user reviews,2,3,5
769090,True,0,No user reviews,0,0,0
769100,True,0,No user reviews,0,0,0
769110,True,4,Mostly Negative,5,9,14
769120,True,0,No user reviews,0,0,0
769130,True,0,6 user reviews,6,0,6
769140,True,0,1 user reviews,1,0,1
769150,True,0,6 user reviews,2,4,6
769160,True,0,1 user reviews,1,0,1
769170,True,0,No user reviews,0,0,0
769180,True,7,Positive,22,0,22
769190,True,0,No user reviews,0,0,0
769200,True,0,6 user reviews,4,2,6
769220,True,7,Positive,10,2,12
769230,True,0,No user reviews,0,0,0
769320,True,7,Positive,10,0,10
769340,True,0,8 user reviews,6,2,8
769360,True,4,Mostly Negative,5,11,16
769370,True,0,1 user reviews,0,1,1
769390,True,0,3 user reviews,0,3,3
769410,True,7,Positive,18,3,21
769420,True,0,5 user reviews,4,1,5
769440,True,7,Positive,9,2,11
769480,True,0,No user reviews,0,0,0
769500,True,0,No user reviews,0,0,0
769501,True,0,No user reviews,0,0,0
769502,True,0,No user reviews,0,0,0
769503,True,0,No user reviews,0,0,0
769504,True,0,No user reviews,0,0,0
769505,True,0,No user reviews,0,0,0
769520,True,0,1 user reviews,1,0,1
769540,True,0,1 user reviews,1,0,1
769550,True,0,5 user reviews,3,2,5
769560,True,0,9 user reviews,9,0,9
769570,True,0,No user reviews,0,0,0
769580,True,0,1 user reviews,1,0,1
769590,True,0,4 user reviews,4,0,4
769600,True,0,No user reviews,0,0,0
769610,True,0,No user reviews,0,0,0
769620,True,0,8 user reviews,4,4,8
769630,True,0,No user reviews,0,0,0
769640,True,0,2 user reviews,1,1,2
769670,True,5,Mixed,43,23,66
769680,True,0,2 user reviews,2,0,2
769690,True,5,Mixed,13,7,20
769710,True,0,3 user reviews,2,1,3
769720,True,0,3 user reviews,1,2,3
769730,True,5,Mixed,8,6,14
769740,True,0,2 user reviews,1,1,2
769750,True,0,4 user reviews,3,1,4
769760,True,0,No user reviews,0,0,0
769770,True,0,No user reviews,0,0,0
769780,True,0,2 user reviews,1,1,2
769790,True,0,No user reviews,0,0,0
769800,True,0,No user reviews,0,0,0
769810,True,0,No user reviews,0,0,0
769820,True,0,No user reviews,0,0,0
769830,True,0,No user reviews,0,0,0
769840,True,7,Positive,19,2,21
769850,True,0,No user reviews,0,0,0
769860,True,0,No user reviews,0,0,0
769910,True,0,8 user reviews,8,0,8
769920,True,7,Positive,14,0,14
769930,True,0,1 user reviews,1,0,1
769940,True,0,5 user reviews,5,0,5
769950,True,5,Mixed,131,85,216
769970,True,6,Mostly Positive,119,35,154
769980,True,6,Mostly Positive,9,3,12
769990,True,0,No user reviews,0,0,0
770000,True,0,No user reviews,0,0,0
770010,True,0,1 user reviews,1,0,1
770020,True,0,6 user reviews,5,1,6
770030,True,0,No user reviews,0,0,0
770050,True,0,6 user reviews,4,2,6
770060,True,0,No user reviews,0,0,0
770061,True,0,No user reviews,0,0,0
770070,True,5,Mixed,40,31,71
770080,True,0,No user reviews,0,0,0
770090,True,0,No user reviews,0,0,0
770100,True,8,Very Positive,221,52,273
770110,True,6,Mostly Positive,57,16,73
770120,True,0,1 user reviews,1,0,1
770130,True,0,No user reviews,0,0,0
770160,True,0,5 user reviews,3,2,5
770190,True,0,1 user reviews,1,0,1
770200,True,5,Mixed,19,9,28
770240,True,5,Mixed,337,354,691
770270,True,0,3 user reviews,0,3,3
770280,True,0,No user reviews,0,0,0
770281,True,0,No user reviews,0,0,0
770282,True,0,No user reviews,0,0,0
770300,True,0,No user reviews,0,0,0
770310,True,0,No user reviews,0,0,0
770320,True,0,4 user reviews,1,3,4
770330,True,0,No user reviews,0,0,0
770350,True,0,No user reviews,0,0,0
770360,True,0,No user reviews,0,0,0
770370,True,0,7 user reviews,4,3,7
770380,True,0,1 user reviews,1,0,1
770390,True,6,Mostly Positive,440,139,579
770400,True,4,Mostly Negative,7,13,20
770410,True,6,Mostly Positive,18,7,25
770420,True,0,No user reviews,0,0,0
770440,True,5,Mixed,10,11,21
770460,True,0,No user reviews,0,0,0
770480,True,0,7 user reviews,7,0,7
770490,True,5,Mixed,11,7,18
770500,True,0,No user reviews,0,0,0
770520,True,0,No user reviews,0,0,0
770560,True,0,2 user reviews,0,2,2
770580,True,0,No user reviews,0,0,0
770581,True,0,No user reviews,0,0,0
770590,True,0,No user reviews,0,0,0
770600,True,7,Positive,15,1,16
770610,True,0,3 user reviews,1,2,3
770620,True,6,Mostly Positive,11,3,14
770630,True,0,6 user reviews,6,0,6
770660,True,0,4 user reviews,4,0,4
770690,True,0,6 user reviews,0,6,6
770720,True,0,No user reviews,0,0,0
770730,True,0,No user reviews,0,0,0
770770,True,0,No user reviews,0,0,0
770780,True,7,Positive,27,1,28
770790,True,0,No user reviews,0,0,0
770810,True,8,Very Positive,55,10,65
770820,True,0,6 user reviews,6,0,6
770830,True,0,No user reviews,0,0,0
770850,True,0,7 user reviews,6,1,7
770860,True,0,9 user reviews,8,1,9
770870,True,0,3 user reviews,3,0,3
770880,True,0,1 user reviews,1,0,1
770890,True,0,No user reviews,0,0,0
770900,True,0,3 user reviews,3,0,3
770920,True,0,2 user reviews,1,1,2
770950,True,0,2 user reviews,2,0,2
770951,True,0,No user reviews,0,0,0
770970,True,0,8 user reviews,8,0,8
770972,True,7,Positive,9,2,11
770973,True,6,Mostly Positive,70,19,89
770974,True,8,Very Positive,74,0,74
770975,True,7,Positive,11,1,12
770976,True,7,Positive,31,1,32
770977,True,0,No user reviews,0,0,0
770990,True,0,No user reviews,0,0,0
771010,True,7,Positive,34,4,38
771020,True,0,No user reviews,0,0,0
771040,True,0,No user reviews,0,0,0
771060,True,0,No user reviews,0,0,0
771070,True,7,Positive,20,0,20
771100,True,0,6 user reviews,4,2,6
771110,True,0,No user reviews,0,0,0
771120,True,0,No user reviews,0,0,0
771130,True,0,8 user reviews,2,6,8
771170,True,0,No user reviews,0,0,0
771180,True,0,No user reviews,0,0,0
771190,True,0,No user reviews,0,0,0
771200,True,0,No user reviews,0,0,0
771210,True,0,No user reviews,0,0,0
771240,True,7,Positive,26,3,29
771250,True,0,No user reviews,0,0,0
771270,True,0,No user reviews,0,0,0
771290,True,0,No user reviews,0,0,0
771300,True,5,Mixed,421,274,695
771310,True,0,No user reviews,0,0,0
771320,True,5,Mixed,6,6,12
771340,True,0,4 user reviews,3,1,4
771350,True,8,Very Positive,101,25,126
771370,True,0,3 user reviews,0,3,3
771380,True,0,3 user reviews,3,0,3
771390,True,0,No user reviews,0,0,0
771400,True,0,5 user reviews,0,5,5
771410,True,7,Positive,38,4,42
771420,True,8,Very Positive,51,2,53
771430,True,0,7 user reviews,5,2,7
771450,True,0,No user reviews,0,0,0
771470,True,0,9 user reviews,3,6,9
771480,True,0,No user reviews,0,0,0
771490,True,0,1 user reviews,1,0,1
771500,True,0,6 user reviews,1,5,6
771530,True,7,Positive,20,4,24
771540,True,0,No user reviews,0,0,0
771560,True,0,No user reviews,0,0,0
771570,True,0,6 user reviews,2,4,6
771600,True,0,No user reviews,0,0,0
771601,True,0,No user reviews,0,0,0
771602,True,0,No user reviews,0,0,0
771610,True,0,8 user reviews,7,1,8
771640,True,0,1 user reviews,1,0,1
771670,True,0,4 user reviews,2,2,4
771680,True,7,Positive,17,4,21
771690,True,0,7 user reviews,2,5,7
771700,True,0,No user reviews,0,0,0
771710,True,6,Mostly Positive,26,9,35
771720,True,5,Mixed,33,21,54
771730,True,0,No user reviews,0,0,0
771740,True,0,No user reviews,0,0,0
771750,True,0,4 user reviews,1,3,4
771760,True,0,No user reviews,0,0,0
771770,True,0,No user reviews,0,0,0
771780,True,0,3 user reviews,2,1,3
771790,True,0,No user reviews,0,0,0
771800,True,0,No user reviews,0,0,0
771810,True,6,Mostly Positive,56,16,72
771820,True,0,2 user reviews,0,2,2
771830,True,0,4 user reviews,4,0,4
771840,True,6,Mostly Positive,22,6,28
771860,True,0,No user reviews,0,0,0
771880,True,0,No user reviews,0,0,0
771890,True,0,8 user reviews,5,3,8
771900,True,0,No user reviews,0,0,0
771920,True,5,Mixed,68,42,110
771950,True,6,Mostly Positive,12,4,16
771960,True,0,No user reviews,0,0,0
771970,True,0,No user reviews,0,0,0
772010,True,0,No user reviews,0,0,0
772030,True,0,No user reviews,0,0,0
772040,True,0,No user reviews,0,0,0
772060,True,0,5 user reviews,3,2,5
772070,True,0,No user reviews,0,0,0
772080,True,0,4 user reviews,2,2,4
772090,True,7,Positive,10,0,10
772100,True,0,1 user reviews,0,1,1
772110,True,0,No user reviews,0,0,0
772140,True,0,No user reviews,0,0,0
772150,True,6,Mostly Positive,106,29,135
772160,True,0,No user reviews,0,0,0
772180,True,8,Very Positive,79,8,87
772200,True,6,Mostly Positive,11,4,15
772210,True,0,No user reviews,0,0,0
772220,True,0,5 user reviews,3,2,5
772230,True,0,No user reviews,0,0,0
772240,True,0,3 user reviews,2,1,3
772250,True,0,No user reviews,0,0,0
772260,True,0,No user reviews,0,0,0
772270,True,8,Very Positive,57,6,63
772280,True,0,No user reviews,0,0,0
772290,True,8,Very Positive,80,10,90
772300,True,0,2 user reviews,0,2,2
772310,True,0,No user reviews,0,0,0
772320,True,0,5 user reviews,3,2,5
772330,True,0,No user reviews,0,0,0
772340,True,0,5 user reviews,5,0,5
772350,True,0,No user reviews,0,0,0
772360,True,0,5 user reviews,3,2,5
772370,True,0,No user reviews,0,0,0
772400,True,0,No user reviews,0,0,0
772410,True,0,No user reviews,0,0,0
772420,True,0,1 user reviews,0,1,1
772430,True,8,Very Positive,256,63,319
772440,True,0,1 user reviews,0,1,1
772450,True,0,No user reviews,0,0,0
772460,True,0,No user reviews,0,0,0
772470,True,7,Positive,12,2,14
772480,True,6,Mostly Positive,31,8,39
772500,True,5,Mixed,16,16,32
772520,True,0,No user reviews,0,0,0
772530,True,7,Positive,12,1,13
772540,True,6,Mostly Positive,163,69,232
772570,True,7,Positive,12,0,12
772590,True,0,No user reviews,0,0,0
772600,True,0,3 user reviews,1,2,3
772610,True,7,Positive,46,1,47
772630,True,0,No user reviews,0,0,0
772650,True,0,No user reviews,0,0,0
772660,True,0,No user reviews,0,0,0
772670,True,0,5 user reviews,2,3,5
772680,True,0,No user reviews,0,0,0
772700,True,0,No user reviews,0,0,0
772730,True,7,Positive,9,2,11
772750,True,0,8 user reviews,8,0,8
772770,True,0,No user reviews,0,0,0
772771,True,0,No user reviews,0,0,0
772772,True,0,No user reviews,0,0,0
772773,True,0,No user reviews,0,0,0
772774,True,0,No user reviews,0,0,0
772775,True,0,No user reviews,0,0,0
772776,True,0,No user reviews,0,0,0
772777,True,0,No user reviews,0,0,0
772780,True,0,No user reviews,0,0,0
772781,True,0,No user reviews,0,0,0
772782,True,0,No user reviews,0,0,0
772810,True,0,No user reviews,0,0,0
772811,True,0,No user reviews,0,0,0
772812,True,0,No user reviews,0,0,0
772813,True,0,No user reviews,0,0,0
772814,True,0,No user reviews,0,0,0
772830,True,0,No user reviews,0,0,0
772840,True,0,No user reviews,0,0,0
772860,True,0,No user reviews,0,0,0
772870,True,0,No user reviews,0,0,0
772880,True,0,No user reviews,0,0,0
772890,True,0,No user reviews,0,0,0
772900,True,0,No user reviews,0,0,0
772910,True,0,No user reviews,0,0,0
772930,True,0,No user reviews,0,0,0
772940,True,0,No user reviews,0,0,0
772970,True,0,No user reviews,0,0,0
772980,True,0,No user reviews,0,0,0
772990,True,5,Mixed,8,9,17
773000,True,0,No user reviews,0,0,0
773010,True,0,4 user reviews,1,3,4
773040,True,0,No user reviews,0,0,0
773090,True,6,Mostly Positive,42,16,58
773100,True,0,No user reviews,0,0,0
773110,True,0,5 user reviews,3,2,5
773120,True,0,3 user reviews,0,3,3
773130,True,0,2 user reviews,2,0,2
773150,True,0,No user reviews,0,0,0
773160,True,0,No user reviews,0,0,0
773170,True,0,4 user reviews,3,1,4
773190,True,0,No user reviews,0,0,0
773210,True,0,7 user reviews,7,0,7
773230,True,0,3 user reviews,2,1,3
773240,True,4,Mostly Negative,3,7,10
773280,True,0,1 user reviews,0,1,1
773300,True,0,No user reviews,0,0,0
773310,True,0,No user reviews,0,0,0
773320,True,0,1 user reviews,0,1,1
773330,True,5,Mixed,7,5,12
773340,True,0,No user reviews,0,0,0
773350,True,0,No user reviews,0,0,0
773360,True,0,1 user reviews,1,0,1
773370,True,0,No user reviews,0,0,0
773380,True,0,No user reviews,0,0,0
773390,True,5,Mixed,35,18,53
773420,True,0,5 user reviews,3,2,5
773430,True,7,Positive,37,3,40
773440,True,0,4 user reviews,1,3,4
773460,True,5,Mixed,14,8,22
773470,True,0,1 user reviews,0,1,1
773471,True,0,8 user reviews,4,4,8
773472,True,0,7 user reviews,6,1,7
773490,True,0,No user reviews,0,0,0
773500,True,6,Mostly Positive,36,11,47
773510,True,0,8 user reviews,5,3,8
773520,True,0,No user reviews,0,0,0
773530,True,0,2 user reviews,2,0,2
773540,True,6,Mostly Positive,18,6,24
773570,True,0,2 user reviews,1,1,2
773580,True,8,Very Positive,204,25,229
773590,True,5,Mixed,23,10,33
773600,True,0,6 user reviews,3,3,6
773610,True,0,1 user reviews,1,0,1
773620,True,0,2 user reviews,2,0,2
773630,True,0,No user reviews,0,0,0
773640,True,0,5 user reviews,1,4,5
773650,True,0,2 user reviews,0,2,2
773660,True,0,No user reviews,0,0,0
773670,True,8,Very Positive,348,11,359
773680,True,0,No user reviews,0,0,0
773690,True,0,No user reviews,0,0,0
773710,True,0,5 user reviews,5,0,5
773740,True,8,Very Positive,54,2,56
773760,True,0,No user reviews,0,0,0
773761,True,0,No user reviews,0,0,0
773762,True,0,No user reviews,0,0,0
773763,True,0,1 user reviews,1,0,1
773765,True,0,1 user reviews,1,0,1
773770,True,5,Mixed,18,13,31
773790,True,8,Very Positive,637,85,722
773800,True,0,No user reviews,0,0,0
773801,True,0,No user reviews,0,0,0
773802,True,0,No user reviews,0,0,0
773803,True,0,No user reviews,0,0,0
773804,True,0,No user reviews,0,0,0
773805,True,0,No user reviews,0,0,0
773806,True,0,No user reviews,0,0,0
773810,True,0,1 user reviews,1,0,1
773830,True,6,Mostly Positive,14,4,18
773840,True,8,Very Positive,55,6,61
773850,True,0,No user reviews,0,0,0
773860,True,0,No user reviews,0,0,0
773870,True,0,No user reviews,0,0,0
773900,True,7,Positive,43,1,44
773910,True,0,1 user reviews,0,1,1
773920,True,0,3 user reviews,1,2,3
773930,True,7,Positive,10,2,12
773951,True,6,Mostly Positive,3209,848,4057
773971,True,0,No user reviews,0,0,0
773991,True,5,Mixed,56,70,126
774011,True,4,Mostly Negative,41,124,165
774041,True,8,Very Positive,43,9,52
774051,True,0,1 user reviews,0,1,1
774061,True,0,No user reviews,0,0,0
774071,True,0,6 user reviews,4,2,6
774081,True,0,5 user reviews,4,1,5
774091,True,8,Very Positive,144,14,158
774111,True,0,No user reviews,0,0,0
774121,True,0,1 user reviews,1,0,1
774131,True,0,1 user reviews,0,1,1
774141,True,7,Positive,9,2,11
774151,True,7,Positive,12,2,14
774161,True,0,7 user reviews,5,2,7
774171,True,9,Overwhelmingly Positive,7473,160,7633
774181,True,0,No user reviews,0,0,0
774191,True,7,Positive,10,2,12
774201,True,8,Very Positive,705,49,754
774211,True,0,No user reviews,0,0,0
774221,True,7,Positive,15,1,16
774231,True,0,7 user reviews,5,2,7
774241,True,5,Mixed,466,419,885
774251,True,0,No user reviews,0,0,0
774261,True,7,Positive,22,3,25
774271,True,0,No user reviews,0,0,0
774272,True,0,No user reviews,0,0,0
774273,True,0,No user reviews,0,0,0
774274,True,0,No user reviews,0,0,0
774275,True,0,No user reviews,0,0,0
774276,True,0,No user reviews,0,0,0
774277,True,0,No user reviews,0,0,0
774278,True,0,No user reviews,0,0,0
774279,True,0,No user reviews,0,0,0
774281,True,5,Mixed,12,7,19
774291,True,0,No user reviews,0,0,0
774301,True,0,No user reviews,0,0,0
774321,True,5,Mixed,30,24,54
774331,True,0,9 user reviews,2,7,9
774341,True,0,No user reviews,0,0,0
774342,True,0,No user reviews,0,0,0
774351,True,6,Mostly Positive,343,138,481
774361,True,8,Very Positive,2704,311,3015
774401,True,6,Mostly Positive,11,3,14
774411,True,0,6 user reviews,4,2,6
774421,True,0,No user reviews,0,0,0
774431,True,0,No user reviews,0,0,0
774441,True,5,Mixed,17,9,26
774451,True,0,No user reviews,0,0,0
774461,True,8,Very Positive,672,68,740
774471,True,0,No user reviews,0,0,0
774501,True,0,1 user reviews,1,0,1
774511,True,5,Mixed,121,72,193
774521,True,0,4 user reviews,2,2,4
774531,True,7,Positive,22,0,22
774541,True,6,Mostly Positive,332,102,434
774551,True,5,Mixed,9,5,14
774561,True,7,Positive,25,5,30
774611,True,0,1 user reviews,1,0,1
774621,True,0,1 user reviews,1,0,1
774631,True,0,No user reviews,0,0,0
774641,True,0,1 user reviews,1,0,1
774651,True,7,Positive,33,2,35
774661,True,0,4 user reviews,2,2,4
774711,True,0,8 user reviews,7,1,8
774721,True,0,No user reviews,0,0,0
774741,True,0,No user reviews,0,0,0
774751,True,0,No user reviews,0,0,0
774752,True,0,No user reviews,0,0,0
774753,True,0,No user reviews,0,0,0
774754,True,0,6 user reviews,5,1,6
774755,True,0,No user reviews,0,0,0
774756,True,0,1 user reviews,1,0,1
774757,True,0,2 user reviews,2,0,2
774758,True,7,Positive,15,0,15
774759,True,5,Mixed,10,9,19
774760,True,0,2 user reviews,1,1,2
774761,True,0,No user reviews,0,0,0
774771,True,0,No user reviews,0,0,0
774781,True,6,Mostly Positive,7,3,10
774801,True,0,No user reviews,0,0,0
774811,True,5,Mixed,285,126,411
774821,True,0,No user reviews,0,0,0
774822,True,0,No user reviews,0,0,0
774823,True,0,No user reviews,0,0,0
774841,True,0,2 user reviews,2,0,2
774861,True,8,Very Positive,2434,298,2732
774871,True,0,4 user reviews,4,0,4
774891,True,0,4 user reviews,3,1,4
774901,True,5,Mixed,9,6,15
774911,True,5,Mixed,22,18,40
774931,True,0,1 user reviews,1,0,1
774941,True,0,No user reviews,0,0,0
774961,True,0,No user reviews,0,0,0
774971,True,0,No user reviews,0,0,0
774981,True,0,No user reviews,0,0,0
774991,True,0,No user reviews,0,0,0
775031,True,0,1 user reviews,1,0,1
775050,True,0,No user reviews,0,0,0
775200,True,0,1 user reviews,1,0,1
775210,True,0,No user reviews,0,0,0
775220,True,0,No user reviews,0,0,0
775240,True,0,No user reviews,0,0,0
775250,True,0,No user reviews,0,0,0
775260,True,0,1 user reviews,1,0,1
775270,True,0,2 user reviews,2,0,2
775300,True,0,No user reviews,0,0,0
775310,True,7,Positive,12,0,12
775360,True,0,No user reviews,0,0,0
775370,True,0,No user reviews,0,0,0
775380,True,0,No user reviews,0,0,0
775390,True,0,No user reviews,0,0,0
775410,True,7,Positive,24,0,24
775460,True,0,7 user reviews,5,2,7
775470,True,0,No user reviews,0,0,0
775480,True,0,No user reviews,0,0,0
775490,True,7,Positive,13,0,13
775510,True,0,No user reviews,0,0,0
775520,True,6,Mostly Positive,8,3,11
775530,True,8,Very Positive,55,10,65
775550,True,0,No user reviews,0,0,0
775570,True,0,1 user reviews,0,1,1
775580,True,8,Very Positive,103,6,109
775590,True,0,No user reviews,0,0,0
775600,True,0,No user reviews,0,0,0
775620,True,0,1 user reviews,0,1,1
775630,True,5,Mixed,34,27,61
775640,True,0,No user reviews,0,0,0
775650,True,0,No user reviews,0,0,0
775651,True,0,No user reviews,0,0,0
775652,True,0,No user reviews,0,0,0
775660,True,0,No user reviews,0,0,0
775670,True,0,No user reviews,0,0,0
775680,True,0,No user reviews,0,0,0
775681,True,0,No user reviews,0,0,0
775682,True,0,No user reviews,0,0,0
775683,True,0,No user reviews,0,0,0
775690,True,0,3 user reviews,3,0,3
775700,True,0,No user reviews,0,0,0
775720,True,0,3 user reviews,2,1,3
775730,True,0,1 user reviews,1,0,1
775760,True,5,Mixed,7,5,12
775790,True,0,3 user reviews,1,2,3
775800,True,0,5 user reviews,3,2,5
775820,True,5,Mixed,5,6,11
775830,True,0,No user reviews,0,0,0
775850,True,0,No user reviews,0,0,0
775860,True,0,9 user reviews,5,4,9
775880,True,0,No user reviews,0,0,0
775881,True,0,1 user reviews,0,1,1
775900,True,6,Mostly Positive,108,43,151
775910,True,6,Mostly Positive,9,3,12
775920,True,0,1 user reviews,0,1,1
775940,True,8,Very Positive,800,109,909
775960,True,7,Positive,18,4,22
775990,True,0,No user reviews,0,0,0
776000,True,5,Mixed,8,8,16
776010,True,0,No user reviews,0,0,0
776020,True,0,5 user reviews,4,1,5
776030,True,0,No user reviews,0,0,0
776040,True,0,8 user reviews,6,2,8
776070,True,0,No user reviews,0,0,0
776090,True,0,No user reviews,0,0,0
776100,True,0,1 user reviews,0,1,1
776110,True,0,No user reviews,0,0,0
776120,True,0,No user reviews,0,0,0
776140,True,0,4 user reviews,2,2,4
776160,True,0,3 user reviews,3,0,3
776170,True,0,No user reviews,0,0,0
776180,True,0,8 user reviews,8,0,8
776190,True,0,5 user reviews,1,4,5
776210,True,0,No user reviews,0,0,0
776280,True,0,No user reviews,0,0,0
776290,True,0,3 user reviews,0,3,3
776300,True,0,No user reviews,0,0,0
776320,True,0,4 user reviews,2,2,4
776340,True,8,Very Positive,89,17,106
776360,True,0,2 user reviews,2,0,2
776370,True,5,Mixed,13,7,20
776380,True,0,No user reviews,0,0,0
776390,True,0,No user reviews,0,0,0
776410,True,0,No user reviews,0,0,0
776420,True,0,No user reviews,0,0,0
776430,True,0,2 user reviews,1,1,2
776440,True,0,No user reviews,0,0,0
776450,True,0,No user reviews,0,0,0
776480,True,0,7 user reviews,6,1,7
776490,True,8,Very Positive,353,53,406
776510,True,0,No user reviews,0,0,0
776520,True,5,Mixed,6,5,11
776530,True,0,7 user reviews,5,2,7
776540,True,5,Mixed,11,9,20
776550,True,5,Mixed,6,6,12
776560,True,0,9 user reviews,8,1,9
776570,True,0,No user reviews,0,0,0
776580,True,5,Mixed,12,17,29
776590,True,0,No user reviews,0,0,0
776600,True,0,5 user reviews,4,1,5
776610,True,0,3 user reviews,1,2,3
776650,True,0,4 user reviews,4,0,4
776670,True,0,3 user reviews,1,2,3
776720,True,0,3 user reviews,3,0,3
776740,True,0,No user reviews,0,0,0
776780,True,0,5 user reviews,5,0,5
776790,True,7,Positive,10,1,11
776800,True,0,No user reviews,0,0,0
776820,True,0,8 user reviews,4,4,8
776830,True,0,7 user reviews,7,0,7
776840,True,0,No user reviews,0,0,0
776850,True,0,2 user reviews,2,0,2
776890,True,4,Mostly Negative,13,21,34
776900,True,0,No user reviews,0,0,0
776920,True,0,8 user reviews,6,2,8
776930,True,0,4 user reviews,1,3,4
776950,True,5,Mixed,7,10,17
776960,True,5,Mixed,52,24,76
776970,True,0,No user reviews,0,0,0
776990,True,0,1 user reviews,1,0,1
777000,True,0,4 user reviews,1,3,4
777020,True,7,Positive,9,1,10
777030,True,0,No user reviews,0,0,0
777040,True,0,6 user reviews,2,4,6
777050,True,5,Mixed,11,6,17
777080,True,0,1 user reviews,1,0,1
777090,True,0,7 user reviews,4,3,7
777110,True,0,3 user reviews,3,0,3
777120,True,0,1 user reviews,1,0,1
777130,True,7,Positive,13,1,14
777140,True,0,No user reviews,0,0,0
777150,True,8,Very Positive,59,10,69
777160,True,7,Positive,21,5,26
777170,True,0,No user reviews,0,0,0
777180,True,0,8 user reviews,4,4,8
777200,True,0,3 user reviews,3,0,3
777210,True,0,No user reviews,0,0,0
777220,True,0,No user reviews,0,0,0
777230,True,0,No user reviews,0,0,0
777240,True,0,1 user reviews,0,1,1
777250,True,0,No user reviews,0,0,0
777270,True,0,1 user reviews,1,0,1
777290,True,0,No user reviews,0,0,0
777300,True,0,No user reviews,0,0,0
777310,True,0,2 user reviews,1,1,2
777320,True,3,Negative,5,36,41
777340,True,0,6 user reviews,4,2,6
777350,True,0,5 user reviews,2,3,5
777360,True,0,No user reviews,0,0,0
777380,True,0,1 user reviews,1,0,1
777400,True,4,Mostly Negative,8,17,25
777410,True,0,9 user reviews,9,0,9
777420,True,0,8 user reviews,5,3,8
777430,True,5,Mixed,14,10,24
777450,True,0,No user reviews,0,0,0
777460,True,0,No user reviews,0,0,0
777490,True,0,No user reviews,0,0,0
777530,True,0,1 user reviews,0,1,1
777540,True,0,1 user reviews,1,0,1
777550,True,0,1 user reviews,1,0,1
777560,True,0,No user reviews,0,0,0
777580,True,0,No user reviews,0,0,0
777590,True,0,2 user reviews,1,1,2
777610,True,0,3 user reviews,3,0,3
777620,True,0,No user reviews,0,0,0
777640,True,0,2 user reviews,0,2,2
777650,True,7,Positive,22,5,27
777660,True,0,1 user reviews,0,1,1
777680,True,0,No user reviews,0,0,0
777700,True,0,4 user reviews,4,0,4
777730,True,0,No user reviews,0,0,0
777760,True,0,3 user reviews,3,0,3
777770,True,5,Mixed,135,60,195
777790,True,8,Very Positive,67,7,74
777820,True,0,7 user reviews,5,2,7
777850,True,0,1 user reviews,0,1,1
777860,True,0,No user reviews,0,0,0
777870,True,0,5 user reviews,5,0,5
777880,True,6,Mostly Positive,41,11,52
777890,True,0,No user reviews,0,0,0
777910,True,0,No user reviews,0,0,0
777920,True,0,No user reviews,0,0,0
777930,True,0,No user reviews,0,0,0
777940,True,0,No user reviews,0,0,0
777950,True,0,No user reviews,0,0,0
777960,True,0,No user reviews,0,0,0
777970,True,0,No user reviews,0,0,0
777971,True,0,No user reviews,0,0,0
777972,True,0,No user reviews,0,0,0
777973,True,0,No user reviews,0,0,0
778000,True,0,1 user reviews,1,0,1
778010,True,0,No user reviews,0,0,0
778020,True,0,1 user reviews,1,0,1
778030,True,0,No user reviews,0,0,0
778040,True,0,No user reviews,0,0,0
778041,True,0,No user reviews,0,0,0
778050,True,0,4 user reviews,2,2,4
778060,True,0,No user reviews,0,0,0
778070,True,0,No user reviews,0,0,0
778080,True,0,7 user reviews,2,5,7
778090,True,0,No user reviews,0,0,0
778110,True,0,8 user reviews,1,7,8
778120,True,0,1 user reviews,0,1,1
778140,True,0,1 user reviews,1,0,1
778150,True,6,Mostly Positive,35,11,46
778160,True,0,5 user reviews,4,1,5
778190,True,0,2 user reviews,1,1,2
778210,True,0,1 user reviews,1,0,1
778230,True,0,2 user reviews,2,0,2
778240,True,0,1 user reviews,0,1,1
778250,True,6,Mostly Positive,17,6,23
778260,True,0,No user reviews,0,0,0
778270,True,0,1 user reviews,0,1,1
778330,True,8,Very Positive,113,3,116
778340,True,0,9 user reviews,6,3,9
778350,True,0,No user reviews,0,0,0
778360,True,0,2 user reviews,1,1,2
778370,True,0,No user reviews,0,0,0
778380,True,0,No user reviews,0,0,0
778390,True,8,Very Positive,104,14,118
778400,True,8,Very Positive,47,4,51
778410,True,5,Mixed,13,9,22
778460,True,0,8 user reviews,6,2,8
778470,True,0,5 user reviews,5,0,5
778480,True,0,No user reviews,0,0,0
778490,True,0,No user reviews,0,0,0
778500,True,0,No user reviews,0,0,0
778530,True,7,Positive,20,1,21
778540,True,0,No user reviews,0,0,0
778550,True,0,5 user reviews,0,5,5
778560,True,0,No user reviews,0,0,0
778570,True,5,Mixed,7,6,13
778580,True,0,1 user reviews,1,0,1
778590,True,0,5 user reviews,2,3,5
778600,True,0,No user reviews,0,0,0
778610,True,8,Very Positive,182,11,193
778630,True,0,No user reviews,0,0,0
778640,True,0,6 user reviews,6,0,6
778650,True,0,6 user reviews,6,0,6
778660,True,0,No user reviews,0,0,0
778700,True,0,No user reviews,0,0,0
778710,True,0,1 user reviews,0,1,1
778720,True,0,No user reviews,0,0,0
778740,True,0,No user reviews,0,0,0
778741,True,0,No user reviews,0,0,0
778760,True,0,7 user reviews,3,4,7
778770,True,0,No user reviews,0,0,0
778780,True,0,2 user reviews,2,0,2
778790,True,0,No user reviews,0,0,0
778800,True,7,Positive,24,0,24
778810,True,0,1 user reviews,0,1,1
778830,True,0,1 user reviews,0,1,1
778840,True,7,Positive,25,1,26
778850,True,0,2 user reviews,1,1,2
778860,True,0,9 user reviews,7,2,9
778870,True,0,2 user reviews,1,1,2
778880,True,0,No user reviews,0,0,0
778881,True,0,No user reviews,0,0,0
778890,True,0,No user reviews,0,0,0
778900,True,0,No user reviews,0,0,0
778920,True,0,No user reviews,0,0,0
778930,True,6,Mostly Positive,26,7,33
778960,True,0,No user reviews,0,0,0
778970,True,0,No user reviews,0,0,0
778980,True,0,No user reviews,0,0,0
779000,True,0,No user reviews,0,0,0
779010,True,0,1 user reviews,0,1,1
779050,True,0,No user reviews,0,0,0
779060,True,0,4 user reviews,1,3,4
779070,True,0,1 user reviews,1,0,1
779080,True,0,No user reviews,0,0,0
779090,True,7,Positive,39,5,44
779100,True,6,Mostly Positive,25,10,35
779110,True,0,4 user reviews,3,1,4
779120,True,0,4 user reviews,4,0,4
779130,True,5,Mixed,41,18,59
779140,True,0,5 user reviews,4,1,5
779150,True,0,2 user reviews,0,2,2
779160,True,0,2 user reviews,1,1,2
779170,True,0,No user reviews,0,0,0
779180,True,0,No user reviews,0,0,0
779210,True,0,No user reviews,0,0,0
779220,True,0,No user reviews,0,0,0
779240,True,0,9 user reviews,6,3,9
779250,True,7,Positive,8,2,10
779260,True,0,No user reviews,0,0,0
779280,True,7,Positive,16,0,16
779290,True,6,Mostly Positive,247,104,351
779300,True,0,9 user reviews,5,4,9
779320,True,0,2 user reviews,1,1,2
779330,True,5,Mixed,79,39,118
779340,True,8,Very Positive,9728,1576,11304
779350,True,0,No user reviews,0,0,0
779360,True,6,Mostly Positive,17,6,23
779370,True,0,No user reviews,0,0,0
779380,True,5,Mixed,7,4,11
779390,True,0,3 user reviews,1,2,3
779400,True,0,4 user reviews,4,0,4
779401,True,0,8 user reviews,7,1,8
779410,True,0,No user reviews,0,0,0
779430,True,8,Very Positive,47,9,56
779450,True,5,Mixed,6,5,11
779500,True,0,No user reviews,0,0,0
779520,True,0,No user reviews,0,0,0
779530,True,0,No user reviews,0,0,0
779550,True,0,1 user reviews,1,0,1
779560,True,0,No user reviews,0,0,0
779570,True,5,Mixed,8,8,16
779580,True,0,4 user reviews,4,0,4
779590,True,8,Very Positive,181,27,208
779610,True,4,Mostly Negative,8,22,30
779620,True,0,2 user reviews,2,0,2
779630,True,0,No user reviews,0,0,0
779640,True,6,Mostly Positive,8,3,11
779650,True,0,No user reviews,0,0,0
779660,True,0,No user reviews,0,0,0
779700,True,0,3 user reviews,2,1,3
779720,True,0,No user reviews,0,0,0
779730,True,0,5 user reviews,5,0,5
779750,True,0,No user reviews,0,0,0
779760,True,0,1 user reviews,1,0,1
779780,True,0,No user reviews,0,0,0
779790,True,0,2 user reviews,0,2,2
779800,True,0,3 user reviews,1,2,3
779810,True,0,4 user reviews,2,2,4
779840,True,0,1 user reviews,0,1,1
779870,True,0,No user reviews,0,0,0
779880,True,6,Mostly Positive,157,57,214
779890,True,0,No user reviews,0,0,0
779892,True,0,6 user reviews,4,2,6
779893,True,0,No user reviews,0,0,0
779894,True,7,Positive,23,1,24
779895,True,0,No user reviews,0,0,0
779896,True,0,3 user reviews,2,1,3
779897,True,0,No user reviews,0,0,0
779898,True,0,6 user reviews,5,1,6
779899,True,0,No user reviews,0,0,0
779900,True,0,No user reviews,0,0,0
779920,True,0,2 user reviews,2,0,2
779930,True,4,Mostly Negative,10,26,36
779931,True,0,4 user reviews,3,1,4
779932,True,8,Very Positive,67,4,71
779933,True,8,Very Positive,71,5,76
779934,True,7,Positive,40,0,40
779935,True,7,Positive,46,3,49
779936,True,7,Positive,37,5,42
779937,True,7,Positive,30,5,35
779938,True,7,Positive,23,5,28
779939,True,7,Positive,31,3,34
779950,True,0,3 user reviews,2,1,3
779960,True,5,Mixed,13,7,20
779990,True,0,No user reviews,0,0,0
780000,True,0,3 user reviews,3,0,3
780020,True,6,Mostly Positive,37,12,49
780080,True,0,7 user reviews,5,2,7
780100,True,6,Mostly Positive,29,12,41
780110,True,0,No user reviews,0,0,0
780120,True,0,No user reviews,0,0,0
780140,True,0,7 user reviews,3,4,7
780150,True,0,No user reviews,0,0,0
780160,True,0,7 user reviews,2,5,7
780170,True,0,No user reviews,0,0,0
780180,True,0,No user reviews,0,0,0
780210,True,6,Mostly Positive,147,37,184
780230,True,0,1 user reviews,1,0,1
780240,True,0,No user reviews,0,0,0
780250,True,0,No user reviews,0,0,0
780260,True,0,1 user reviews,1,0,1
780270,True,0,6 user reviews,6,0,6
780280,True,8,Very Positive,78,7,85
780290,True,8,Very Positive,1536,279,1815
780310,True,0,No user reviews,0,0,0
780320,True,0,7 user reviews,4,3,7
780340,True,7,Positive,35,3,38
780350,True,6,Mostly Positive,66,26,92
780370,True,0,No user reviews,0,0,0
780390,True,8,Very Positive,56,6,62
780400,True,0,No user reviews,0,0,0
780430,True,0,No user reviews,0,0,0
780460,True,0,No user reviews,0,0,0
780470,True,0,No user reviews,0,0,0
780490,True,0,No user reviews,0,0,0
780500,True,8,Very Positive,84,10,94
780520,True,0,3 user reviews,3,0,3
780550,True,0,5 user reviews,5,0,5
780560,True,7,Positive,13,2,15
780561,True,0,6 user reviews,5,1,6
780570,True,0,2 user reviews,2,0,2
780580,True,5,Mixed,12,14,26
780590,True,0,3 user reviews,1,2,3
780630,True,0,1 user reviews,1,0,1
780650,True,0,No user reviews,0,0,0
780670,True,7,Positive,24,2,26
780690,True,3,Negative,0,11,11
780710,True,0,2 user reviews,1,1,2
780730,True,0,No user reviews,0,0,0
780740,True,0,1 user reviews,1,0,1
780750,True,5,Mixed,24,15,39
780760,True,0,5 user reviews,4,1,5
780770,True,0,No user reviews,0,0,0
780800,True,0,4 user reviews,3,1,4
780820,True,0,No user reviews,0,0,0
780830,True,0,No user reviews,0,0,0
780840,True,7,Positive,14,2,16
780850,True,0,4 user reviews,4,0,4
780930,True,0,No user reviews,0,0,0
780960,True,0,No user reviews,0,0,0
780970,True,0,No user reviews,0,0,0
780980,True,0,No user reviews,0,0,0
780990,True,7,Positive,16,0,16
781000,True,0,1 user reviews,1,0,1
781010,True,7,Positive,13,0,13
781030,True,0,No user reviews,0,0,0
781040,True,0,No user reviews,0,0,0
781050,True,5,Mixed,14,15,29
781060,True,0,No user reviews,0,0,0
781100,True,0,9 user reviews,3,6,9
781110,True,7,Positive,16,0,16
781120,True,0,2 user reviews,2,0,2
781130,True,6,Mostly Positive,20,6,26
781190,True,0,No user reviews,0,0,0
781200,True,0,No user reviews,0,0,0
781220,True,0,9 user reviews,7,2,9
781230,True,0,1 user reviews,1,0,1
781240,True,0,No user reviews,0,0,0
781250,True,0,2 user reviews,2,0,2
781260,True,0,3 user reviews,2,1,3
781270,True,0,1 user reviews,1,0,1
781280,True,0,5 user reviews,4,1,5
781290,True,0,3 user reviews,1,2,3
781320,True,0,9 user reviews,7,2,9
781340,True,0,No user reviews,0,0,0
781350,True,0,No user reviews,0,0,0
781351,True,0,No user reviews,0,0,0
781352,True,0,No user reviews,0,0,0
781353,True,0,No user reviews,0,0,0
781354,True,0,No user reviews,0,0,0
781355,True,0,No user reviews,0,0,0
781356,True,0,No user reviews,0,0,0
781357,True,0,No user reviews,0,0,0
781358,True,0,No user reviews,0,0,0
781359,True,0,No user reviews,0,0,0
781360,True,0,No user reviews,0,0,0
781361,True,0,No user reviews,0,0,0
781362,True,0,No user reviews,0,0,0
781370,True,0,No user reviews,0,0,0
781390,True,0,No user reviews,0,0,0
781400,True,0,No user reviews,0,0,0
781410,True,0,No user reviews,0,0,0
781440,True,0,No user reviews,0,0,0
781470,True,0,No user reviews,0,0,0
781480,True,6,Mostly Positive,119,41,160
781490,True,0,No user reviews,0,0,0
781500,True,0,No user reviews,0,0,0
781510,True,0,1 user reviews,1,0,1
781520,True,0,6 user reviews,3,3,6
781530,True,0,No user reviews,0,0,0
781531,True,0,1 user reviews,1,0,1
781532,True,0,1 user reviews,0,1,1
781540,True,0,No user reviews,0,0,0
781541,True,0,No user reviews,0,0,0
781590,True,0,No user reviews,0,0,0
781610,True,0,2 user reviews,1,1,2
781630,True,0,No user reviews,0,0,0
781640,True,7,Positive,9,2,11
781650,True,0,1 user reviews,1,0,1
781660,True,5,Mixed,9,5,14
781670,True,0,3 user reviews,2,1,3
781680,True,0,3 user reviews,2,1,3
781730,True,0,No user reviews,0,0,0
781760,True,0,8 user reviews,4,4,8
781780,True,0,No user reviews,0,0,0
781790,True,0,No user reviews,0,0,0
781800,True,0,2 user reviews,1,1,2
781810,True,8,Very Positive,47,8,55
781820,True,7,Positive,21,4,25
781830,True,0,No user reviews,0,0,0
781840,True,0,1 user reviews,1,0,1
781850,True,0,2 user reviews,2,0,2
781860,True,0,2 user reviews,2,0,2
781870,True,0,No user reviews,0,0,0
781880,True,0,4 user reviews,2,2,4
781890,True,0,7 user reviews,7,0,7
781920,True,0,8 user reviews,8,0,8
781930,True,0,3 user reviews,2,1,3
781950,True,0,1 user reviews,1,0,1
781970,True,0,No user reviews,0,0,0
781990,True,0,No user reviews,0,0,0
782020,True,0,3 user reviews,1,2,3
782050,True,0,7 user reviews,5,2,7
782060,True,0,No user reviews,0,0,0
782070,True,5,Mixed,14,15,29
782090,True,0,4 user reviews,3,1,4
782100,True,0,8 user reviews,5,3,8
782110,True,5,Mixed,7,6,13
782120,True,7,Positive,11,0,11
782130,True,0,No user reviews,0,0,0
782140,True,5,Mixed,63,39,102
782160,True,0,3 user reviews,1,2,3
782180,True,0,1 user reviews,1,0,1
782190,True,0,3 user reviews,2,1,3
782210,True,0,4 user reviews,4,0,4
782230,True,7,Positive,41,8,49
782250,True,0,No user reviews,0,0,0
782270,True,7,Positive,11,1,12
782280,True,0,3 user reviews,3,0,3
782290,True,0,No user reviews,0,0,0
782300,True,7,Positive,9,2,11
782310,True,0,4 user reviews,4,0,4
782330,True,8,Very Positive,44566,6756,51322
782340,True,0,No user reviews,0,0,0
782380,True,6,Mostly Positive,7,3,10
782410,True,0,3 user reviews,0,3,3
782420,True,0,No user reviews,0,0,0
782430,True,0,No user reviews,0,0,0
782450,True,0,1 user reviews,0,1,1
782460,True,0,No user reviews,0,0,0
782470,True,0,No user reviews,0,0,0
782510,True,0,9 user reviews,3,6,9
782550,True,0,No user reviews,0,0,0
782560,True,0,No user reviews,0,0,0
782570,True,0,7 user reviews,3,4,7
782580,True,0,No user reviews,0,0,0
782600,True,0,No user reviews,0,0,0
782610,True,0,2 user reviews,2,0,2
782620,True,0,No user reviews,0,0,0
782630,True,0,No user reviews,0,0,0
782640,True,0,No user reviews,0,0,0
782650,True,0,1 user reviews,1,0,1
782660,True,0,No user reviews,0,0,0
782670,True,0,No user reviews,0,0,0
782680,True,0,No user reviews,0,0,0
782690,True,5,Mixed,26,16,42
782700,True,0,5 user reviews,2,3,5
782770,True,0,No user reviews,0,0,0
782940,True,0,No user reviews,0,0,0
783030,True,0,No user reviews,0,0,0
783040,True,0,No user reviews,0,0,0
783050,True,7,Positive,29,0,29
783060,True,0,2 user reviews,0,2,2
783070,True,0,1 user reviews,1,0,1
783090,True,0,No user reviews,0,0,0
783120,True,0,5 user reviews,5,0,5
783130,True,0,No user reviews,0,0,0
783150,True,7,Positive,20,2,22
783170,True,5,Mixed,149,101,250
783180,True,0,8 user reviews,7,1,8
783190,True,5,Mixed,52,40,92
783200,True,6,Mostly Positive,18,6,24
783210,True,6,Mostly Positive,91,28,119
783220,True,0,6 user reviews,1,5,6
783230,True,0,No user reviews,0,0,0
783240,True,0,No user reviews,0,0,0
783250,True,0,No user reviews,0,0,0
783260,True,0,6 user reviews,4,2,6
783270,True,0,1 user reviews,0,1,1
783280,True,0,1 user reviews,1,0,1
783310,True,4,Mostly Negative,4,11,15
783320,True,0,No user reviews,0,0,0
783330,True,0,4 user reviews,3,1,4
783340,True,6,Mostly Positive,10,3,13
783370,True,0,No user reviews,0,0,0
783380,True,0,1 user reviews,0,1,1
783390,True,0,2 user reviews,2,0,2
783391,True,0,No user reviews,0,0,0
783392,True,0,No user reviews,0,0,0
783400,True,0,No user reviews,0,0,0
783410,True,0,No user reviews,0,0,0
783420,True,0,5 user reviews,2,3,5
783430,True,0,4 user reviews,4,0,4
783440,True,6,Mostly Positive,12,5,17
783450,True,4,Mostly Negative,8,15,23
783490,True,0,No user reviews,0,0,0
783500,True,0,No user reviews,0,0,0
783501,True,0,No user reviews,0,0,0
783502,True,0,No user reviews,0,0,0
783503,True,0,No user reviews,0,0,0
783504,True,0,No user reviews,0,0,0
783505,True,0,No user reviews,0,0,0
783506,True,0,No user reviews,0,0,0
783507,True,0,1 user reviews,0,1,1
783508,True,0,No user reviews,0,0,0
783530,True,0,No user reviews,0,0,0
783540,True,0,No user reviews,0,0,0
783541,True,0,No user reviews,0,0,0
783542,True,0,2 user reviews,0,2,2
783543,True,0,No user reviews,0,0,0
783544,True,0,2 user reviews,1,1,2
783545,True,0,5 user reviews,4,1,5
783546,True,0,3 user reviews,3,0,3
783560,True,0,No user reviews,0,0,0
783570,True,0,No user reviews,0,0,0
783580,True,0,No user reviews,0,0,0
783590,True,5,Mixed,95,43,138
783610,True,0,No user reviews,0,0,0
783620,True,0,No user reviews,0,0,0
783630,True,0,No user reviews,0,0,0
783631,True,0,No user reviews,0,0,0
783632,True,0,No user reviews,0,0,0
783640,True,0,2 user reviews,1,1,2
783650,True,0,No user reviews,0,0,0
783660,True,0,No user reviews,0,0,0
783670,True,0,No user reviews,0,0,0
783680,True,0,No user reviews,0,0,0
783690,True,0,No user reviews,0,0,0
783710,True,5,Mixed,13,16,29
783720,True,0,No user reviews,0,0,0
783750,True,0,No user reviews,0,0,0
783770,True,0,No user reviews,0,0,0
783780,True,0,No user reviews,0,0,0
783790,True,0,5 user reviews,5,0,5
783800,True,0,No user reviews,0,0,0
783810,True,0,4 user reviews,3,1,4
783840,True,8,Very Positive,170,34,204
783850,True,0,2 user reviews,0,2,2
783860,True,5,Mixed,9,5,14
783870,True,0,1 user reviews,1,0,1
783880,True,0,No user reviews,0,0,0
783890,True,0,2 user reviews,0,2,2
783910,True,0,9 user reviews,5,4,9
783940,True,7,Positive,29,2,31
783960,True,0,No user reviews,0,0,0
783990,True,7,Positive,43,5,48
784010,True,0,6 user reviews,6,0,6
784040,True,0,1 user reviews,1,0,1
784050,True,6,Mostly Positive,27,7,34
784060,True,0,No user reviews,0,0,0
784070,True,6,Mostly Positive,11,4,15
784100,True,0,5 user reviews,5,0,5
784110,True,0,No user reviews,0,0,0
784120,True,0,No user reviews,0,0,0
784130,True,0,7 user reviews,7,0,7
784150,True,8,Very Positive,1780,229,2009
784160,True,0,8 user reviews,4,4,8
784180,True,0,1 user reviews,1,0,1
784330,True,0,No user reviews,0,0,0
784710,True,0,No user reviews,0,0,0
784730,True,0,No user reviews,0,0,0
784750,True,0,No user reviews,0,0,0
784760,True,0,No user reviews,0,0,0
784770,True,0,No user reviews,0,0,0
784780,True,0,No user reviews,0,0,0
784790,True,0,No user reviews,0,0,0
784800,True,0,No user reviews,0,0,0
784810,True,0,No user reviews,0,0,0
784820,True,0,No user reviews,0,0,0
784840,True,0,No user reviews,0,0,0
784841,True,0,No user reviews,0,0,0
784842,True,0,No user reviews,0,0,0
784843,True,0,No user reviews,0,0,0
784844,True,0,No user reviews,0,0,0
784845,True,0,No user reviews,0,0,0
784846,True,0,No user reviews,0,0,0
784847,True,0,No user reviews,0,0,0
784850,True,0,No user reviews,0,0,0
784851,True,0,No user reviews,0,0,0
784852,True,0,No user reviews,0,0,0
784853,True,0,No user reviews,0,0,0
784854,True,0,No user reviews,0,0,0
784856,True,0,No user reviews,0,0,0
784857,True,0,No user reviews,0,0,0
784858,True,0,No user reviews,0,0,0
784860,True,0,No user reviews,0,0,0
784870,True,0,No user reviews,0,0,0
784880,True,0,No user reviews,0,0,0
784890,True,0,No user reviews,0,0,0
784900,True,0,No user reviews,0,0,0
784930,True,0,6 user reviews,6,0,6
784940,True,5,Mixed,19,9,28
784950,True,0,1 user reviews,1,0,1
784980,True,0,No user reviews,0,0,0
784990,True,0,No user reviews,0,0,0
785010,True,0,No user reviews,0,0,0
785030,True,0,No user reviews,0,0,0
785050,True,0,No user reviews,0,0,0
785060,True,0,No user reviews,0,0,0
785070,True,0,No user reviews,0,0,0
785080,True,0,2 user reviews,2,0,2
785100,True,7,Positive,10,1,11
785110,True,7,Positive,36,8,44
785130,True,0,No user reviews,0,0,0
785150,True,0,1 user reviews,1,0,1
785200,True,0,No user reviews,0,0,0
785260,True,5,Mixed,518,252,770
785300,True,6,Mostly Positive,86,25,111
785320,True,0,No user reviews,0,0,0
785330,True,0,No user reviews,0,0,0
785340,True,0,No user reviews,0,0,0
785350,True,0,No user reviews,0,0,0
785360,True,0,No user reviews,0,0,0
785370,True,0,No user reviews,0,0,0
785380,True,0,No user reviews,0,0,0
785390,True,0,No user reviews,0,0,0
785400,True,0,No user reviews,0,0,0
785410,True,0,No user reviews,0,0,0
785420,True,0,No user reviews,0,0,0
785430,True,0,2 user reviews,0,2,2
785440,True,0,1 user reviews,1,0,1
785460,True,0,No user reviews,0,0,0
785480,True,8,Very Positive,110,18,128
785500,True,0,No user reviews,0,0,0
785510,True,0,No user reviews,0,0,0
785511,True,0,No user reviews,0,0,0
785512,True,0,No user reviews,0,0,0
785513,True,0,No user reviews,0,0,0
785514,True,0,No user reviews,0,0,0
785540,True,0,No user reviews,0,0,0
785560,True,0,2 user reviews,2,0,2
785590,True,0,6 user reviews,5,1,6
785620,True,0,No user reviews,0,0,0
785630,True,0,No user reviews,0,0,0
785640,True,5,Mixed,15,10,25
785660,True,5,Mixed,28,23,51
785670,True,5,Mixed,5,7,12
785680,True,3,Negative,0,10,10
785690,True,0,1 user reviews,1,0,1
785740,True,5,Mixed,537,318,855
785750,True,0,8 user reviews,8,0,8
785760,True,7,Positive,16,2,18
785770,True,0,No user reviews,0,0,0
785780,True,7,Positive,18,3,21
785790,True,8,Very Positive,131,6,137
785810,True,0,No user reviews,0,0,0
785820,True,0,No user reviews,0,0,0
785830,True,0,No user reviews,0,0,0
785840,True,8,Very Positive,59,3,62
785850,True,5,Mixed,46,33,79
785860,True,5,Mixed,10,14,24
785870,True,0,2 user reviews,2,0,2
785880,True,8,Very Positive,87,20,107
785890,True,8,Very Positive,161,9,170
785900,True,0,1 user reviews,0,1,1
785910,True,5,Mixed,10,10,20
785920,True,0,6 user reviews,1,5,6
785930,True,5,Mixed,5,6,11
785940,True,0,2 user reviews,1,1,2
785950,True,0,No user reviews,0,0,0
785980,True,0,No user reviews,0,0,0
785990,True,0,No user reviews,0,0,0
786010,True,0,2 user reviews,2,0,2
786020,True,0,No user reviews,0,0,0
786040,True,0,1 user reviews,1,0,1
786050,True,0,No user reviews,0,0,0
786060,True,0,No user reviews,0,0,0
786070,True,0,1 user reviews,1,0,1
786080,True,0,No user reviews,0,0,0
786090,True,0,2 user reviews,2,0,2
786100,True,0,2 user reviews,2,0,2
786110,True,0,No user reviews,0,0,0
786120,True,0,1 user reviews,1,0,1
786130,True,0,1 user reviews,0,1,1
786140,True,0,No user reviews,0,0,0
786160,True,0,No user reviews,0,0,0
786170,True,0,2 user reviews,2,0,2
786180,True,0,3 user reviews,1,2,3
786280,True,0,2 user reviews,1,1,2
786290,True,5,Mixed,6,4,10
786300,True,0,No user reviews,0,0,0
786320,True,0,No user reviews,0,0,0
786330,True,0,No user reviews,0,0,0
786340,True,0,4 user reviews,3,1,4
786350,True,0,1 user reviews,1,0,1
786370,True,0,No user reviews,0,0,0
786380,True,0,No user reviews,0,0,0
786390,True,7,Positive,9,2,11
786410,True,0,No user reviews,0,0,0
786420,True,0,2 user reviews,1,1,2
786430,True,0,No user reviews,0,0,0
786450,True,6,Mostly Positive,61,18,79
786460,True,0,No user reviews,0,0,0
786470,True,0,No user reviews,0,0,0
786490,True,0,No user reviews,0,0,0
786510,True,6,Mostly Positive,10,4,14
786520,True,8,Very Positive,122,19,141
786530,True,0,No user reviews,0,0,0
786540,True,0,1 user reviews,1,0,1
786550,True,0,No user reviews,0,0,0
786560,True,0,6 user reviews,4,2,6
786570,True,0,No user reviews,0,0,0
786580,True,5,Mixed,126,57,183
786590,True,0,No user reviews,0,0,0
786600,True,0,No user reviews,0,0,0
786620,True,0,1 user reviews,1,0,1
786630,True,7,Positive,26,4,30
786640,True,0,No user reviews,0,0,0
786650,True,0,2 user reviews,2,0,2
786670,True,0,9 user reviews,6,3,9
786680,True,0,No user reviews,0,0,0
786710,True,0,8 user reviews,8,0,8
786720,True,4,Mostly Negative,3,8,11
786730,True,0,No user reviews,0,0,0
786740,True,0,5 user reviews,1,4,5
786750,True,0,6 user reviews,3,3,6
786760,True,0,No user reviews,0,0,0
786770,True,0,3 user reviews,3,0,3
786780,True,0,No user reviews,0,0,0
786800,True,0,3 user reviews,3,0,3
786810,True,0,No user reviews,0,0,0
786820,True,0,9 user reviews,9,0,9
786840,True,0,2 user reviews,1,1,2
786850,True,0,No user reviews,0,0,0
786860,True,0,No user reviews,0,0,0
786870,True,0,No user reviews,0,0,0
786890,True,0,2 user reviews,2,0,2
786910,True,5,Mixed,14,12,26
786920,True,0,No user reviews,0,0,0
786940,True,0,No user reviews,0,0,0
786950,True,0,2 user reviews,2,0,2
786960,True,0,No user reviews,0,0,0
786980,True,0,5 user reviews,1,4,5
786990,True,7,Positive,12,1,13
787000,True,0,No user reviews,0,0,0
787040,True,5,Mixed,12,13,25
787050,True,0,2 user reviews,2,0,2
787070,True,8,Very Positive,234,5,239
787100,True,0,No user reviews,0,0,0
787110,True,0,1 user reviews,1,0,1
787120,True,0,3 user reviews,1,2,3
787130,True,0,No user reviews,0,0,0
787140,True,0,2 user reviews,0,2,2
787150,True,0,No user reviews,0,0,0
787160,True,0,No user reviews,0,0,0
787170,True,0,4 user reviews,4,0,4
787180,True,0,No user reviews,0,0,0
787200,True,0,7 user reviews,6,1,7
787220,True,0,No user reviews,0,0,0
787250,True,5,Mixed,6,5,11
787260,True,0,No user reviews,0,0,0
787280,True,0,No user reviews,0,0,0
787290,True,0,No user reviews,0,0,0
787291,True,0,No user reviews,0,0,0
787292,True,0,No user reviews,0,0,0
787300,True,4,Mostly Negative,3,7,10
787320,True,0,No user reviews,0,0,0
787321,True,0,No user reviews,0,0,0
787322,True,0,No user reviews,0,0,0
787323,True,0,No user reviews,0,0,0
787324,True,0,No user reviews,0,0,0
787340,True,5,Mixed,362,179,541
787350,True,0,No user reviews,0,0,0
787370,True,4,Mostly Negative,4,7,11
787380,True,0,No user reviews,0,0,0
787400,True,7,Positive,35,7,42
787410,True,0,1 user reviews,0,1,1
787420,True,0,5 user reviews,1,4,5
787430,True,0,1 user reviews,0,1,1
787440,True,0,7 user reviews,4,3,7
787450,True,0,No user reviews,0,0,0
787460,True,0,4 user reviews,1,3,4
787480,True,9,Overwhelmingly Positive,1968,33,2001
787500,True,0,No user reviews,0,0,0
787530,True,0,4 user reviews,3,1,4
787550,True,0,7 user reviews,3,4,7
787560,True,0,No user reviews,0,0,0
787620,True,0,5 user reviews,5,0,5
787630,True,0,No user reviews,0,0,0
787640,True,0,No user reviews,0,0,0
787650,True,0,4 user reviews,4,0,4
787660,True,0,No user reviews,0,0,0
787680,True,0,1 user reviews,0,1,1
787681,True,0,1 user reviews,0,1,1
787682,True,0,2 user reviews,0,2,2
787690,True,0,5 user reviews,3,2,5
787710,True,7,Positive,15,3,18
787720,True,4,Mostly Negative,3,7,10
787730,True,0,2 user reviews,1,1,2
787740,True,5,Mixed,72,38,110
787750,True,0,No user reviews,0,0,0
787770,True,0,No user reviews,0,0,0
787780,True,5,Mixed,6,4,10
787790,True,0,6 user reviews,4,2,6
787810,True,0,No user reviews,0,0,0
787820,True,0,No user reviews,0,0,0
787830,True,0,No user reviews,0,0,0
787840,True,6,Mostly Positive,18,5,23
787850,True,7,Positive,17,3,20
787860,True,8,Very Positive,9624,1021,10645
787890,True,0,1 user reviews,1,0,1
787910,True,7,Positive,14,0,14
787930,True,7,Positive,35,8,43
787940,True,0,1 user reviews,0,1,1
787950,True,0,No user reviews,0,0,0
787960,True,0,3 user reviews,2,1,3
787970,True,7,Positive,24,5,29
787980,True,0,2 user reviews,1,1,2
787990,True,0,No user reviews,0,0,0
788000,True,0,1 user reviews,1,0,1
788010,True,0,No user reviews,0,0,0
788020,True,0,1 user reviews,0,1,1
788040,True,0,No user reviews,0,0,0
788050,True,7,Positive,16,4,20
788060,True,0,3 user reviews,3,0,3
788100,True,6,Mostly Positive,748,188,936
788120,True,0,2 user reviews,2,0,2
788130,True,5,Mixed,28,13,41
788150,True,0,4 user reviews,4,0,4
788160,True,0,No user reviews,0,0,0
788170,True,0,No user reviews,0,0,0
788180,True,0,1 user reviews,1,0,1
788190,True,0,4 user reviews,1,3,4
788200,True,0,2 user reviews,0,2,2
788210,True,5,Mixed,29,19,48
788230,True,0,No user reviews,0,0,0
788231,True,0,No user reviews,0,0,0
788240,True,0,No user reviews,0,0,0
788250,True,0,3 user reviews,2,1,3
788260,True,5,Mixed,1242,822,2064
788270,True,8,Very Positive,201,50,251
788290,True,0,No user reviews,0,0,0
788310,True,0,No user reviews,0,0,0
788320,True,0,8 user reviews,6,2,8
788330,True,0,4 user reviews,4,0,4
788350,True,0,No user reviews,0,0,0
788380,True,7,Positive,17,4,21
788390,True,7,Positive,11,1,12
788400,True,0,1 user reviews,1,0,1
788410,True,7,Positive,30,5,35
788420,True,7,Positive,22,4,26
788430,True,5,Mixed,9,5,14
788440,True,0,No user reviews,0,0,0
788460,True,0,No user reviews,0,0,0
788470,True,0,No user reviews,0,0,0
788480,True,0,9 user reviews,5,4,9
788490,True,4,Mostly Negative,5,8,13
788500,True,0,2 user reviews,0,2,2
788510,True,0,5 user reviews,2,3,5
788520,True,0,3 user reviews,2,1,3
788540,True,0,No user reviews,0,0,0
788580,True,0,No user reviews,0,0,0
788590,True,0,No user reviews,0,0,0
788610,True,6,Mostly Positive,8,3,11
788620,True,0,No user reviews,0,0,0
788630,True,6,Mostly Positive,71,30,101
788640,True,0,8 user reviews,6,2,8
788670,True,0,4 user reviews,4,0,4
788680,True,0,No user reviews,0,0,0
788690,True,8,Very Positive,164,21,185
788700,True,6,Mostly Positive,67,23,90
788720,True,0,2 user reviews,2,0,2
788730,True,0,1 user reviews,1,0,1
788740,True,5,Mixed,16,15,31
788750,True,0,No user reviews,0,0,0
788760,True,0,6 user reviews,5,1,6
788770,True,0,No user reviews,0,0,0
788800,True,0,No user reviews,0,0,0
788810,True,5,Mixed,6,6,12
788820,True,0,No user reviews,0,0,0
788840,True,0,No user reviews,0,0,0
788860,True,0,No user reviews,0,0,0
788870,True,4,Mostly Negative,5,9,14
788890,True,0,5 user reviews,4,1,5
788900,True,0,3 user reviews,2,1,3
788910,True,5,Mixed,15,13,28
788930,True,7,Positive,45,2,47
788950,True,0,No user reviews,0,0,0
788960,True,0,3 user reviews,1,2,3
788970,True,5,Mixed,18,10,28
788980,True,0,1 user reviews,1,0,1
788981,True,0,No user reviews,0,0,0
788982,True,0,No user reviews,0,0,0
788983,True,0,No user reviews,0,0,0
789010,True,0,3 user reviews,2,1,3
789040,True,0,No user reviews,0,0,0
789041,True,0,No user reviews,0,0,0
789050,True,0,No user reviews,0,0,0
789070,True,0,4 user reviews,4,0,4
789080,True,0,No user reviews,0,0,0
789090,True,7,Positive,38,3,41
789100,True,0,No user reviews,0,0,0
789140,True,0,No user reviews,0,0,0
789150,True,0,No user reviews,0,0,0
789160,True,0,5 user reviews,3,2,5
789170,True,0,4 user reviews,2,2,4
789200,True,0,5 user reviews,5,0,5
789210,True,0,No user reviews,0,0,0
789220,True,0,6 user reviews,1,5,6
789230,True,0,No user reviews,0,0,0
789240,True,0,7 user reviews,5,2,7
789260,True,6,Mostly Positive,33,10,43
789280,True,0,1 user reviews,1,0,1
789290,True,5,Mixed,6,4,10
789380,True,7,Positive,23,2,25
789391,True,0,No user reviews,0,0,0
789393,True,0,9 user reviews,5,4,9
789460,True,0,8 user reviews,6,2,8
789480,True,7,Positive,10,0,10
789490,True,0,2 user reviews,1,1,2
789500,True,0,No user reviews,0,0,0
789510,True,0,1 user reviews,0,1,1
789520,True,0,6 user reviews,2,4,6
789530,True,0,1 user reviews,0,1,1
789540,True,0,No user reviews,0,0,0
789550,True,0,1 user reviews,1,0,1
789570,True,8,Very Positive,50,4,54
789580,True,0,No user reviews,0,0,0
789600,True,0,No user reviews,0,0,0
789610,True,0,No user reviews,0,0,0
789620,True,0,No user reviews,0,0,0
789640,True,0,2 user reviews,1,1,2
789650,True,0,No user reviews,0,0,0
789660,True,0,No user reviews,0,0,0
789670,True,0,3 user reviews,1,2,3
789680,True,0,2 user reviews,1,1,2
789700,True,0,1 user reviews,0,1,1
789710,True,0,No user reviews,0,0,0
789720,True,0,No user reviews,0,0,0
789730,True,7,Positive,35,4,39
789740,True,7,Positive,15,3,18
789750,True,6,Mostly Positive,10,3,13
789760,True,8,Very Positive,231,20,251
789770,True,0,3 user reviews,3,0,3
789780,True,0,No user reviews,0,0,0
789790,True,0,No user reviews,0,0,0
789800,True,0,1 user reviews,1,0,1
789801,True,0,No user reviews,0,0,0
789810,True,0,No user reviews,0,0,0
789811,True,0,No user reviews,0,0,0
789820,True,0,No user reviews,0,0,0
789840,True,0,No user reviews,0,0,0
789870,True,0,No user reviews,0,0,0
789880,True,0,9 user reviews,2,7,9
789890,True,0,4 user reviews,0,4,4
789900,True,0,8 user reviews,5,3,8
789910,True,5,Mixed,19,12,31
789920,True,0,No user reviews,0,0,0
789930,True,0,4 user reviews,3,1,4
789950,True,8,Very Positive,54,11,65
789960,True,4,Mostly Negative,5,10,15
789970,True,0,No user reviews,0,0,0
789980,True,0,1 user reviews,0,1,1
790010,True,0,No user reviews,0,0,0
790020,True,7,Positive,16,3,19
790050,True,0,No user reviews,0,0,0
790060,True,8,Very Positive,127,0,127
790070,True,0,No user reviews,0,0,0
790080,True,7,Positive,12,2,14
790090,True,0,8 user reviews,6,2,8
790100,True,0,No user reviews,0,0,0
790120,True,7,Positive,14,2,16
790130,True,7,Positive,8,2,10
790150,True,0,No user reviews,0,0,0
790160,True,0,1 user reviews,0,1,1
790170,True,0,4 user reviews,4,0,4
790180,True,0,4 user reviews,3,1,4
790210,True,0,4 user reviews,2,2,4
790230,True,0,9 user reviews,1,8,9
790250,True,0,1 user reviews,1,0,1
790260,True,0,4 user reviews,4,0,4
790280,True,0,No user reviews,0,0,0
790290,True,7,Positive,10,2,12
790300,True,0,6 user reviews,2,4,6
790350,True,7,Positive,16,3,19
790360,True,7,Positive,28,0,28
790390,True,0,1 user reviews,1,0,1
790410,True,0,No user reviews,0,0,0
790450,True,0,No user reviews,0,0,0
790460,True,0,1 user reviews,1,0,1
790480,True,0,No user reviews,0,0,0
790490,True,0,No user reviews,0,0,0
790500,True,0,No user reviews,0,0,0
790510,True,0,No user reviews,0,0,0
790520,True,0,2 user reviews,2,0,2
790530,True,0,No user reviews,0,0,0
790540,True,4,Mostly Negative,50,109,159
790550,True,0,No user reviews,0,0,0
790560,True,0,No user reviews,0,0,0
790570,True,0,5 user reviews,2,3,5
790600,True,0,No user reviews,0,0,0
790610,True,0,No user reviews,0,0,0
790630,True,0,5 user reviews,4,1,5
790650,True,0,No user reviews,0,0,0
790680,True,0,No user reviews,0,0,0
790700,True,5,Mixed,7,9,16
790710,True,0,2 user reviews,2,0,2
790730,True,0,3 user reviews,0,3,3
790740,True,8,Very Positive,1155,83,1238
790750,True,7,Positive,8,2,10
790760,True,0,4 user reviews,2,2,4
790780,True,0,1 user reviews,1,0,1
790790,True,0,No user reviews,0,0,0
790800,True,0,2 user reviews,0,2,2
790810,True,0,5 user reviews,1,4,5
790820,True,8,Very Positive,1304,153,1457
790830,True,0,5 user reviews,4,1,5
790831,True,7,Positive,15,2,17
790832,True,7,Positive,8,2,10
790840,True,0,1 user reviews,0,1,1
790850,True,8,Very Positive,334,39,373
790860,True,7,Positive,9,1,10
790870,True,0,No user reviews,0,0,0
790890,True,0,No user reviews,0,0,0
790900,True,0,1 user reviews,0,1,1
790923,True,0,1 user reviews,1,0,1
790924,True,0,2 user reviews,2,0,2
790930,True,0,4 user reviews,3,1,4
790950,True,0,4 user reviews,1,3,4
790960,True,0,1 user reviews,1,0,1
790970,True,0,No user reviews,0,0,0
791000,True,0,1 user reviews,1,0,1
791020,True,7,Positive,21,1,22
791040,True,0,No user reviews,0,0,0
791050,True,0,5 user reviews,2,3,5
791070,True,0,No user reviews,0,0,0
791090,True,0,No user reviews,0,0,0
791110,True,0,No user reviews,0,0,0
791120,True,0,No user reviews,0,0,0
791130,True,0,No user reviews,0,0,0
791140,True,0,3 user reviews,3,0,3
791150,True,0,No user reviews,0,0,0
791160,True,0,1 user reviews,1,0,1
791180,True,8,Very Positive,114,17,131
791190,True,0,No user reviews,0,0,0
791220,True,0,No user reviews,0,0,0
791230,True,0,No user reviews,0,0,0
791240,True,7,Positive,24,0,24
791250,True,0,No user reviews,0,0,0
791260,True,0,3 user reviews,1,2,3
791290,True,0,2 user reviews,2,0,2
791300,True,0,No user reviews,0,0,0
791310,True,0,No user reviews,0,0,0
791320,True,0,7 user reviews,3,4,7
791330,True,8,Very Positive,150,17,167
791370,True,0,1 user reviews,1,0,1
791380,True,0,1 user reviews,0,1,1
791390,True,0,No user reviews,0,0,0
791400,True,6,Mostly Positive,15,4,19
791420,True,0,1 user reviews,1,0,1
791430,True,0,8 user reviews,4,4,8
791460,True,0,No user reviews,0,0,0
791470,True,7,Positive,15,0,15
791490,True,0,1 user reviews,1,0,1
791500,True,7,Positive,15,3,18
791510,True,0,No user reviews,0,0,0
791520,True,0,No user reviews,0,0,0
791560,True,0,No user reviews,0,0,0
791570,True,5,Mixed,7,9,16
791580,True,0,1 user reviews,0,1,1
791590,True,5,Mixed,5,7,12
791600,True,0,4 user reviews,3,1,4
791620,True,0,No user reviews,0,0,0
791630,True,0,No user reviews,0,0,0
791650,True,0,No user reviews,0,0,0
791660,True,0,No user reviews,0,0,0
791670,True,0,No user reviews,0,0,0
791700,True,7,Positive,29,4,33
791720,True,0,No user reviews,0,0,0
791740,True,0,1 user reviews,1,0,1
791750,True,8,Very Positive,49,9,58
791760,True,0,7 user reviews,4,3,7
791770,True,8,Very Positive,56,5,61
791790,True,0,No user reviews,0,0,0
791800,True,0,6 user reviews,6,0,6
791830,True,0,No user reviews,0,0,0
791831,True,0,No user reviews,0,0,0
791870,True,0,2 user reviews,2,0,2
791871,True,0,3 user reviews,3,0,3
791872,True,0,2 user reviews,1,1,2
791880,True,0,4 user reviews,3,1,4
791890,True,0,5 user reviews,5,0,5
791930,True,0,1 user reviews,1,0,1
791950,True,4,Mostly Negative,4,7,11
791960,True,0,5 user reviews,5,0,5
791980,True,0,No user reviews,0,0,0
791990,True,4,Mostly Negative,3,7,10
792000,True,0,3 user reviews,2,1,3
792010,True,0,No user reviews,0,0,0
792030,True,0,1 user reviews,1,0,1
792040,True,8,Very Positive,102,9,111
792050,True,0,No user reviews,0,0,0
792060,True,0,2 user reviews,1,1,2
792070,True,0,2 user reviews,1,1,2
792080,True,0,No user reviews,0,0,0
792100,True,8,Very Positive,399,21,420
792110,True,0,4 user reviews,4,0,4
792120,True,0,No user reviews,0,0,0
792140,True,0,No user reviews,0,0,0
792150,True,0,No user reviews,0,0,0
792160,True,0,5 user reviews,4,1,5
792190,True,0,No user reviews,0,0,0
792220,True,0,No user reviews,0,0,0
792230,True,0,No user reviews,0,0,0
792280,True,0,No user reviews,0,0,0
792290,True,0,No user reviews,0,0,0
792300,True,8,Very Positive,431,94,525
792320,True,0,5 user reviews,4,1,5
792330,True,7,Positive,18,3,21
792331,True,7,Positive,32,2,34
792340,True,0,2 user reviews,1,1,2
792350,True,0,3 user reviews,2,1,3
792360,True,0,No user reviews,0,0,0
792370,True,0,7 user reviews,6,1,7
792380,True,0,No user reviews,0,0,0
792390,True,0,No user reviews,0,0,0
792400,True,0,1 user reviews,0,1,1
792410,True,7,Positive,15,2,17
792420,True,7,Positive,16,2,18
792440,True,0,No user reviews,0,0,0
792470,True,0,No user reviews,0,0,0
792480,True,0,No user reviews,0,0,0
792490,True,0,1 user reviews,1,0,1
792500,True,0,4 user reviews,2,2,4
792510,True,0,No user reviews,0,0,0
792520,True,5,Mixed,76,35,111
792530,True,0,No user reviews,0,0,0
792550,True,0,3 user reviews,1,2,3
792560,True,7,Positive,9,1,10
792570,True,0,No user reviews,0,0,0
792610,True,0,No user reviews,0,0,0
792620,True,0,No user reviews,0,0,0
792630,True,0,No user reviews,0,0,0
792640,True,0,5 user reviews,4,1,5
792650,True,7,Positive,26,4,30
792660,True,6,Mostly Positive,40,13,53
792670,True,0,5 user reviews,1,4,5
792680,True,0,6 user reviews,5,1,6
792710,True,8,Very Positive,395,11,406
792720,True,0,4 user reviews,3,1,4
792750,True,0,No user reviews,0,0,0
792760,True,0,1 user reviews,1,0,1
792770,True,0,No user reviews,0,0,0
792800,True,0,2 user reviews,2,0,2
792810,True,0,1 user reviews,1,0,1
792820,True,0,No user reviews,0,0,0
792840,True,0,3 user reviews,1,2,3
792850,True,0,8 user reviews,7,1,8
792860,True,0,7 user reviews,7,0,7
792870,True,0,1 user reviews,1,0,1
792880,True,5,Mixed,13,10,23
792900,True,0,2 user reviews,0,2,2
792910,True,0,No user reviews,0,0,0
792920,True,0,No user reviews,0,0,0
792930,True,6,Mostly Positive,17,6,23
792940,True,0,8 user reviews,2,6,8
792970,True,6,Mostly Positive,8,3,11
792980,True,0,7 user reviews,3,4,7
792990,True,4,Mostly Negative,54,190,244
793000,True,0,2 user reviews,2,0,2
793010,True,0,5 user reviews,5,0,5
793020,True,0,No user reviews,0,0,0
793030,True,0,1 user reviews,1,0,1
793040,True,0,No user reviews,0,0,0
793050,True,0,No user reviews,0,0,0
793070,True,0,No user reviews,0,0,0
793080,True,0,No user reviews,0,0,0
793090,True,0,No user reviews,0,0,0
793091,True,0,No user reviews,0,0,0
793100,True,0,No user reviews,0,0,0
793120,True,0,No user reviews,0,0,0
793130,True,0,No user reviews,0,0,0
793150,True,0,No user reviews,0,0,0
793170,True,0,No user reviews,0,0,0
793180,True,0,No user reviews,0,0,0
793190,True,5,Mixed,20,12,32
793200,True,0,3 user reviews,3,0,3
793210,True,0,7 user reviews,5,2,7
793220,True,6,Mostly Positive,10,3,13
793240,True,6,Mostly Positive,7,3,10
793250,True,0,No user reviews,0,0,0
793260,True,0,3 user reviews,2,1,3
793270,True,0,1 user reviews,1,0,1
793280,True,0,No user reviews,0,0,0
793310,True,0,No user reviews,0,0,0
793320,True,0,1 user reviews,1,0,1
793330,True,0,No user reviews,0,0,0
793340,True,0,No user reviews,0,0,0
793350,True,9,Overwhelmingly Positive,614,18,632
793360,True,0,3 user reviews,3,0,3
793370,True,8,Very Positive,427,78,505
793390,True,0,1 user reviews,1,0,1
793400,True,0,No user reviews,0,0,0
793410,True,0,No user reviews,0,0,0
793450,True,7,Positive,32,1,33
793460,True,8,Very Positive,437,73,510
793470,True,0,No user reviews,0,0,0
793480,True,0,No user reviews,0,0,0
793490,True,0,No user reviews,0,0,0
793510,True,0,8 user reviews,1,7,8
793530,True,0,No user reviews,0,0,0
793531,True,0,1 user reviews,1,0,1
793532,True,0,1 user reviews,1,0,1
793533,True,0,1 user reviews,1,0,1
793534,True,0,1 user reviews,1,0,1
793535,True,0,2 user reviews,2,0,2
793536,True,0,4 user reviews,4,0,4
793537,True,0,3 user reviews,3,0,3
793538,True,0,No user reviews,0,0,0
793539,True,0,No user reviews,0,0,0
793540,True,0,No user reviews,0,0,0
793541,True,0,No user reviews,0,0,0
793542,True,0,No user reviews,0,0,0
793543,True,0,No user reviews,0,0,0
793544,True,0,1 user reviews,1,0,1
793545,True,0,2 user reviews,2,0,2
793546,True,0,5 user reviews,5,0,5
793547,True,0,1 user reviews,1,0,1
793548,True,0,1 user reviews,1,0,1
793549,True,0,1 user reviews,1,0,1
793550,True,0,No user reviews,0,0,0
793551,True,7,Positive,14,2,16
793552,True,0,No user reviews,0,0,0
793553,True,0,1 user reviews,1,0,1
793554,True,0,No user reviews,0,0,0
793560,True,7,Positive,39,7,46
793570,True,0,No user reviews,0,0,0
793580,True,0,No user reviews,0,0,0
793600,True,7,Positive,12,2,14
793610,True,3,Negative,2,14,16
793620,True,6,Mostly Positive,9,3,12
793630,True,7,Positive,8,2,10
793640,True,0,5 user reviews,4,1,5
793650,True,0,1 user reviews,0,1,1
793670,True,5,Mixed,11,5,16
793680,True,8,Very Positive,67,7,74
793690,True,8,Very Positive,184,16,200
793730,True,0,2 user reviews,2,0,2
793740,True,8,Very Positive,123,7,130
793750,True,0,1 user reviews,0,1,1
793751,True,0,2 user reviews,1,1,2
793760,True,5,Mixed,11,10,21
793770,True,0,1 user reviews,0,1,1
793771,True,0,1 user reviews,0,1,1
793790,True,0,No user reviews,0,0,0
793820,True,0,6 user reviews,6,0,6
793830,True,7,Positive,10,0,10
793860,True,0,No user reviews,0,0,0
793861,True,0,No user reviews,0,0,0
793880,True,0,8 user reviews,8,0,8
793900,True,0,No user reviews,0,0,0
793910,True,0,No user reviews,0,0,0
793940,True,5,Mixed,7,4,11
793950,True,0,No user reviews,0,0,0
793970,True,0,9 user reviews,1,8,9
793980,True,0,No user reviews,0,0,0
793990,True,0,4 user reviews,3,1,4
794000,True,0,No user reviews,0,0,0
794010,True,0,No user reviews,0,0,0
794020,True,0,No user reviews,0,0,0
794030,True,7,Positive,12,0,12
794040,True,0,1 user reviews,0,1,1
794050,True,0,6 user reviews,1,5,6
794060,True,5,Mixed,9,5,14
794101,True,0,2 user reviews,2,0,2
794102,True,0,3 user reviews,1,2,3
794103,True,0,3 user reviews,2,1,3
794104,True,0,4 user reviews,1,3,4
794105,True,0,9 user reviews,3,6,9
794106,True,0,1 user reviews,0,1,1
794107,True,0,2 user reviews,2,0,2
794108,True,0,1 user reviews,1,0,1
794109,True,0,6 user reviews,5,1,6
794110,True,0,No user reviews,0,0,0
794111,True,0,No user reviews,0,0,0
794140,True,0,4 user reviews,3,1,4
794141,True,0,2 user reviews,1,1,2
794143,True,0,2 user reviews,2,0,2
794150,True,5,Mixed,25,13,38
794170,True,0,1 user reviews,1,0,1
794180,True,0,5 user reviews,1,4,5
794190,True,5,Mixed,10,5,15
794210,True,0,No user reviews,0,0,0
794220,True,7,Positive,16,3,19
794230,True,0,No user reviews,0,0,0
794240,True,7,Positive,32,6,38
794260,True,6,Mostly Positive,5606,1851,7457
794270,True,5,Mixed,88,65,153
794280,True,0,No user reviews,0,0,0
794300,True,0,5 user reviews,2,3,5
794310,True,7,Positive,27,0,27
794320,True,0,1 user reviews,1,0,1
794340,True,0,3 user reviews,3,0,3
794341,True,0,4 user reviews,3,1,4
794342,True,0,3 user reviews,3,0,3
794343,True,7,Positive,43,1,44
794344,True,0,2 user reviews,2,0,2
794345,True,7,Positive,25,2,27
794350,True,0,1 user reviews,1,0,1
794390,True,7,Positive,26,1,27
794400,True,0,No user reviews,0,0,0
794401,True,0,2 user reviews,1,1,2
794410,True,6,Mostly Positive,17,6,23
794420,True,0,No user reviews,0,0,0
794430,True,0,No user reviews,0,0,0
794440,True,0,No user reviews,0,0,0
794441,True,0,No user reviews,0,0,0
794442,True,0,No user reviews,0,0,0
794443,True,0,No user reviews,0,0,0
794444,True,0,No user reviews,0,0,0
794445,True,0,No user reviews,0,0,0
794446,True,0,No user reviews,0,0,0
794447,True,0,No user reviews,0,0,0
794448,True,0,No user reviews,0,0,0
794449,True,0,No user reviews,0,0,0
794450,True,0,No user reviews,0,0,0
794451,True,0,No user reviews,0,0,0
794480,True,0,2 user reviews,2,0,2
794490,True,6,Mostly Positive,192,75,267
794530,True,0,No user reviews,0,0,0
794540,True,8,Very Positive,295,38,333
794550,True,8,Very Positive,64,5,69
794560,True,0,2 user reviews,2,0,2
794570,True,0,2 user reviews,2,0,2
794580,True,8,Very Positive,58,14,72
794590,True,0,No user reviews,0,0,0
794600,True,0,2 user reviews,2,0,2
794610,True,0,No user reviews,0,0,0
794630,True,0,No user reviews,0,0,0
794640,True,0,3 user reviews,2,1,3
794650,True,4,Mostly Negative,5,13,18
794690,True,0,No user reviews,0,0,0
794700,True,0,No user reviews,0,0,0
794710,True,0,No user reviews,0,0,0
794720,True,0,No user reviews,0,0,0
794730,True,0,1 user reviews,1,0,1
794740,True,0,9 user reviews,5,4,9
794750,True,0,No user reviews,0,0,0
794760,True,7,Positive,12,3,15
794780,True,0,2 user reviews,2,0,2
794800,True,8,Very Positive,494,87,581
794820,True,0,No user reviews,0,0,0
794830,True,0,3 user reviews,3,0,3
794850,True,0,No user reviews,0,0,0
794860,True,8,Very Positive,147,7,154
794880,True,0,No user reviews,0,0,0
794890,True,0,No user reviews,0,0,0
794930,True,0,5 user reviews,2,3,5
794940,True,7,Positive,30,3,33
794950,True,0,1 user reviews,1,0,1
794960,True,7,Positive,9,2,11
794990,True,0,4 user reviews,1,3,4
795000,True,0,No user reviews,0,0,0
795020,True,0,No user reviews,0,0,0
795040,True,7,Positive,45,2,47
795050,True,0,4 user reviews,4,0,4
795100,True,7,Positive,18,2,20
795110,True,7,Positive,8,2,10
795120,True,0,1 user reviews,1,0,1
795160,True,5,Mixed,12,8,20
795170,True,0,No user reviews,0,0,0
795210,True,0,No user reviews,0,0,0
795220,True,7,Positive,10,1,11
795230,True,0,5 user reviews,2,3,5
795250,True,0,No user reviews,0,0,0
795260,True,0,No user reviews,0,0,0
795290,True,0,No user reviews,0,0,0
795310,True,5,Mixed,9,7,16
795320,True,0,2 user reviews,1,1,2
795330,True,0,No user reviews,0,0,0
795340,True,0,No user reviews,0,0,0
795350,True,0,No user reviews,0,0,0
795360,True,0,No user reviews,0,0,0
795380,True,0,No user reviews,0,0,0
795390,True,0,No user reviews,0,0,0
795400,True,0,No user reviews,0,0,0
795410,True,0,No user reviews,0,0,0
795420,True,0,No user reviews,0,0,0
795440,True,0,2 user reviews,2,0,2
795460,True,0,No user reviews,0,0,0
795461,True,0,No user reviews,0,0,0
795462,True,0,No user reviews,0,0,0
795470,True,0,No user reviews,0,0,0
795480,True,0,No user reviews,0,0,0
795490,True,0,5 user reviews,2,3,5
795510,True,7,Positive,24,2,26
795530,True,0,1 user reviews,0,1,1
795550,True,0,No user reviews,0,0,0
795570,True,7,Positive,19,2,21
795580,True,0,No user reviews,0,0,0
795600,True,0,No user reviews,0,0,0
795610,True,0,9 user reviews,5,4,9
795620,True,0,No user reviews,0,0,0
795621,True,7,Positive,17,1,18
795630,True,6,Mostly Positive,239,79,318
795640,True,0,No user reviews,0,0,0
795650,True,0,1 user reviews,1,0,1
795680,True,6,Mostly Positive,18,5,23
795720,True,0,2 user reviews,1,1,2
795731,True,7,Positive,11,2,13
795732,True,0,5 user reviews,4,1,5
795760,True,6,Mostly Positive,10,3,13
795910,True,0,3 user reviews,2,1,3
795920,True,0,2 user reviews,2,0,2
795940,True,0,3 user reviews,3,0,3
795950,True,0,No user reviews,0,0,0
795960,True,0,1 user reviews,0,1,1
795990,True,0,8 user reviews,5,3,8
796030,True,0,5 user reviews,3,2,5
796050,True,0,5 user reviews,4,1,5
796060,True,0,3 user reviews,3,0,3
796070,True,0,2 user reviews,2,0,2
796080,True,0,No user reviews,0,0,0
796090,True,0,1 user reviews,1,0,1
796100,True,0,2 user reviews,2,0,2
796110,True,0,No user reviews,0,0,0
796120,True,0,No user reviews,0,0,0
796130,True,0,2 user reviews,1,1,2
796140,True,0,No user reviews,0,0,0
796160,True,0,No user reviews,0,0,0
796170,True,0,No user reviews,0,0,0
796190,True,0,No user reviews,0,0,0
796200,True,0,No user reviews,0,0,0
796210,True,0,No user reviews,0,0,0
796240,True,0,No user reviews,0,0,0
796241,True,0,No user reviews,0,0,0
796242,True,0,No user reviews,0,0,0
796260,True,0,No user reviews,0,0,0
796290,True,0,No user reviews,0,0,0
796300,True,0,No user reviews,0,0,0
796310,True,0,No user reviews,0,0,0
796320,True,0,2 user reviews,1,1,2
796330,True,3,Negative,0,11,11
796340,True,0,5 user reviews,3,2,5
796350,True,0,4 user reviews,3,1,4
796360,True,5,Mixed,11,9,20
796370,True,0,8 user reviews,7,1,8
796380,True,7,Positive,15,1,16
796400,True,0,No user reviews,0,0,0
796410,True,0,No user reviews,0,0,0
796430,True,6,Mostly Positive,17,5,22
796440,True,0,7 user reviews,1,6,7
796460,True,5,Mixed,7,9,16
796480,True,5,Mixed,8,5,13
796490,True,0,3 user reviews,3,0,3
796500,True,0,No user reviews,0,0,0
796510,True,5,Mixed,16,9,25
796520,True,0,No user reviews,0,0,0
796530,True,0,No user reviews,0,0,0
796560,True,0,No user reviews,0,0,0
796580,True,0,No user reviews,0,0,0
796590,True,5,Mixed,9,6,15
796600,True,5,Mixed,9,5,14
796620,True,5,Mixed,23,12,35
796640,True,0,4 user reviews,4,0,4
796650,True,7,Positive,8,2,10
796660,True,0,No user reviews,0,0,0
796710,True,0,1 user reviews,0,1,1
796760,True,0,1 user reviews,1,0,1
796770,True,6,Mostly Positive,7,3,10
796780,True,7,Positive,13,1,14
796790,True,0,8 user reviews,6,2,8
796800,True,0,No user reviews,0,0,0
796820,True,0,No user reviews,0,0,0
796840,True,0,8 user reviews,7,1,8
796850,True,0,No user reviews,0,0,0
796860,True,4,Mostly Negative,47,104,151
796900,True,0,9 user reviews,6,3,9
796910,True,0,No user reviews,0,0,0
796920,True,0,1 user reviews,0,1,1
796930,True,0,No user reviews,0,0,0
796940,True,8,Very Positive,61,3,64
796950,True,0,No user reviews,0,0,0
796970,True,0,No user reviews,0,0,0
796980,True,0,2 user reviews,1,1,2
797010,True,0,No user reviews,0,0,0
797020,True,0,No user reviews,0,0,0
797040,True,5,Mixed,7,10,17
797050,True,0,No user reviews,0,0,0
797060,True,0,No user reviews,0,0,0
797070,True,0,8 user reviews,6,2,8
797090,True,5,Mixed,4,6,10
797110,True,0,No user reviews,0,0,0
797150,True,0,5 user reviews,4,1,5
797180,True,0,No user reviews,0,0,0
797190,True,0,2 user reviews,1,1,2
797200,True,0,No user reviews,0,0,0
797210,True,0,No user reviews,0,0,0
797220,True,5,Mixed,9,5,14
797230,True,0,No user reviews,0,0,0
797240,True,0,1 user reviews,1,0,1
797260,True,0,No user reviews,0,0,0
797280,True,7,Positive,19,1,20
797300,True,0,4 user reviews,3,1,4
797310,True,0,1 user reviews,1,0,1
797330,True,0,3 user reviews,3,0,3
797340,True,0,3 user reviews,3,0,3
797350,True,0,1 user reviews,1,0,1
797360,True,0,No user reviews,0,0,0
797370,True,0,No user reviews,0,0,0
797390,True,0,No user reviews,0,0,0
797400,True,5,Mixed,196,93,289
797410,True,7,Positive,22,4,26
797420,True,0,2 user reviews,2,0,2
797430,True,0,No user reviews,0,0,0
797440,True,0,2 user reviews,2,0,2
797450,True,0,1 user reviews,1,0,1
797460,True,0,No user reviews,0,0,0
797470,True,0,No user reviews,0,0,0
797500,True,0,1 user reviews,1,0,1
797510,True,0,No user reviews,0,0,0
797520,True,0,No user reviews,0,0,0
797540,True,0,No user reviews,0,0,0
797550,True,0,1 user reviews,0,1,1
797560,True,0,No user reviews,0,0,0
797570,True,0,9 user reviews,9,0,9
797580,True,0,No user reviews,0,0,0
797610,True,0,9 user reviews,9,0,9
797620,True,7,Positive,22,2,24
797630,True,0,1 user reviews,1,0,1
797631,True,0,No user reviews,0,0,0
797632,True,0,No user reviews,0,0,0
797660,True,0,1 user reviews,0,1,1
797670,True,0,1 user reviews,1,0,1
797671,True,0,1 user reviews,1,0,1
797672,True,0,No user reviews,0,0,0
797710,True,5,Mixed,9,4,13
797730,True,0,No user reviews,0,0,0
797740,True,0,No user reviews,0,0,0
797750,True,0,No user reviews,0,0,0
797760,True,0,1 user reviews,0,1,1
797770,True,0,2 user reviews,1,1,2
797780,True,0,1 user reviews,0,1,1
797790,True,0,1 user reviews,0,1,1
797800,True,0,1 user reviews,0,1,1
797810,True,0,No user reviews,0,0,0
797820,True,0,No user reviews,0,0,0
797830,True,0,No user reviews,0,0,0
797840,True,0,1 user reviews,1,0,1
797850,True,0,No user reviews,0,0,0
797860,True,0,1 user reviews,1,0,1
797870,True,0,No user reviews,0,0,0
797880,True,0,No user reviews,0,0,0
797890,True,0,No user reviews,0,0,0
797900,True,0,No user reviews,0,0,0
797910,True,0,No user reviews,0,0,0
797920,True,0,No user reviews,0,0,0
797930,True,0,No user reviews,0,0,0
797940,True,0,No user reviews,0,0,0
797950,True,0,No user reviews,0,0,0
797960,True,0,No user reviews,0,0,0
797970,True,0,No user reviews,0,0,0
797980,True,0,No user reviews,0,0,0
797990,True,0,No user reviews,0,0,0
798000,True,0,No user reviews,0,0,0
798010,True,0,No user reviews,0,0,0
798020,True,0,No user reviews,0,0,0
798030,True,0,1 user reviews,1,0,1
798050,True,0,No user reviews,0,0,0
798060,True,0,No user reviews,0,0,0
798070,True,0,No user reviews,0,0,0
798080,True,0,1 user reviews,0,1,1
798090,True,0,No user reviews,0,0,0
798100,True,0,No user reviews,0,0,0
798110,True,0,No user reviews,0,0,0
798140,True,0,5 user reviews,5,0,5
798150,True,0,No user reviews,0,0,0
798170,True,0,7 user reviews,7,0,7
798180,True,0,No user reviews,0,0,0
798190,True,0,No user reviews,0,0,0
798200,True,0,1 user reviews,1,0,1
798210,True,0,4 user reviews,3,1,4
798230,True,0,5 user reviews,2,3,5
798240,True,0,3 user reviews,3,0,3
798250,True,0,No user reviews,0,0,0
798252,True,0,1 user reviews,1,0,1
798280,True,0,No user reviews,0,0,0
798290,True,5,Mixed,110,50,160
798300,True,0,No user reviews,0,0,0
798310,True,0,No user reviews,0,0,0
798320,True,0,1 user reviews,1,0,1
798330,True,0,2 user reviews,2,0,2
798350,True,0,No user reviews,0,0,0
798360,True,0,No user reviews,0,0,0
798380,True,0,3 user reviews,1,2,3
798390,True,8,Very Positive,104,22,126
798400,True,0,No user reviews,0,0,0
798410,True,0,No user reviews,0,0,0
798420,True,0,3 user reviews,1,2,3
798430,True,0,7 user reviews,7,0,7
798440,True,0,No user reviews,0,0,0
798450,True,0,No user reviews,0,0,0
798460,True,8,Very Positive,546,74,620
798480,True,0,No user reviews,0,0,0
798490,True,8,Very Positive,536,103,639
798510,True,8,Very Positive,316,38,354
798520,True,0,1 user reviews,0,1,1
798540,True,0,No user reviews,0,0,0
798541,True,0,No user reviews,0,0,0
798542,True,0,No user reviews,0,0,0
798543,True,0,No user reviews,0,0,0
798560,True,0,9 user reviews,3,6,9
798580,True,0,No user reviews,0,0,0
798590,True,5,Mixed,25,32,57
798610,True,0,No user reviews,0,0,0
798620,True,0,No user reviews,0,0,0
798630,True,0,No user reviews,0,0,0
798650,True,7,Positive,16,0,16
798660,True,0,No user reviews,0,0,0
798670,True,0,No user reviews,0,0,0
798680,True,0,5 user reviews,4,1,5
798710,True,0,7 user reviews,2,5,7
798720,True,0,No user reviews,0,0,0
798740,True,0,7 user reviews,7,0,7
798750,True,7,Positive,9,1,10
798780,True,0,No user reviews,0,0,0
798790,True,0,7 user reviews,6,1,7
798800,True,0,No user reviews,0,0,0
798810,True,8,Very Positive,274,33,307
798820,True,0,No user reviews,0,0,0
798830,True,5,Mixed,12,18,30
798840,True,6,Mostly Positive,37,13,50
798850,True,5,Mixed,9,6,15
798860,True,0,1 user reviews,1,0,1
798870,True,0,6 user reviews,5,1,6
798880,True,0,3 user reviews,3,0,3
798892,True,0,No user reviews,0,0,0
798893,True,0,No user reviews,0,0,0
798894,True,0,No user reviews,0,0,0
798895,True,0,No user reviews,0,0,0
798896,True,0,No user reviews,0,0,0
798901,True,0,1 user reviews,1,0,1
798902,True,0,1 user reviews,1,0,1
798930,True,0,No user reviews,0,0,0
798940,True,0,No user reviews,0,0,0
798950,True,0,No user reviews,0,0,0
798960,True,0,9 user reviews,7,2,9
798970,True,0,No user reviews,0,0,0
798980,True,0,No user reviews,0,0,0
798990,True,0,No user reviews,0,0,0
799010,True,0,No user reviews,0,0,0
799030,True,0,No user reviews,0,0,0
799060,True,0,No user reviews,0,0,0
799070,True,8,Very Positive,390,15,405
799080,True,0,4 user reviews,2,2,4
799090,True,0,No user reviews,0,0,0
799110,True,7,Positive,22,3,25
799120,True,0,3 user reviews,1,2,3
799130,True,0,No user reviews,0,0,0
799140,True,0,No user reviews,0,0,0
799160,True,0,No user reviews,0,0,0
799180,True,0,2 user reviews,1,1,2
799200,True,8,Very Positive,154,35,189
799210,True,0,1 user reviews,0,1,1
799240,True,0,No user reviews,0,0,0
799260,True,6,Mostly Positive,12,4,16
799270,True,0,2 user reviews,1,1,2
799280,True,0,No user reviews,0,0,0
799300,True,0,No user reviews,0,0,0
799310,True,0,1 user reviews,1,0,1
799330,True,0,2 user reviews,2,0,2
799331,True,0,5 user reviews,5,0,5
799340,True,0,No user reviews,0,0,0
799350,True,5,Mixed,71,56,127
799360,True,0,No user reviews,0,0,0
799420,True,0,4 user reviews,1,3,4
799430,True,0,No user reviews,0,0,0
799460,True,0,No user reviews,0,0,0
799470,True,0,No user reviews,0,0,0
799480,True,0,No user reviews,0,0,0
799481,True,0,No user reviews,0,0,0
799482,True,0,2 user reviews,2,0,2
799500,True,5,Mixed,26,15,41
799510,True,8,Very Positive,185,6,191
799520,True,8,Very Positive,81,13,94
799521,True,0,No user reviews,0,0,0
799522,True,0,No user reviews,0,0,0
799524,True,0,No user reviews,0,0,0
799530,True,5,Mixed,9,5,14
799540,True,0,No user reviews,0,0,0
799560,True,0,2 user reviews,1,1,2
799570,True,0,No user reviews,0,0,0
799580,True,0,No user reviews,0,0,0
799590,True,0,4 user reviews,4,0,4
799600,True,0,No user reviews,0,0,0
799610,True,0,1 user reviews,0,1,1
799620,True,0,6 user reviews,5,1,6
799640,True,8,Very Positive,232,9,241
799660,True,0,No user reviews,0,0,0
799670,True,5,Mixed,6,4,10
799680,True,0,No user reviews,0,0,0
799690,True,0,No user reviews,0,0,0
799700,True,0,No user reviews,0,0,0
799710,True,0,No user reviews,0,0,0
799730,True,7,Positive,8,2,10
799750,True,5,Mixed,16,10,26
799751,True,4,Mostly Negative,11,20,31
799770,True,0,2 user reviews,2,0,2
799790,True,7,Positive,24,4,28
799800,True,7,Positive,14,3,17
799810,True,5,Mixed,14,7,21
799820,True,0,3 user reviews,2,1,3
799840,True,5,Mixed,10,8,18
799860,True,0,No user reviews,0,0,0
799870,True,0,1 user reviews,1,0,1
799890,True,0,4 user reviews,1,3,4
799910,True,0,9 user reviews,6,3,9
799920,True,0,No user reviews,0,0,0
799950,True,0,No user reviews,0,0,0
799960,True,0,No user reviews,0,0,0
799980,True,0,No user reviews,0,0,0
799990,True,0,No user reviews,0,0,0
800010,True,0,No user reviews,0,0,0
800020,True,0,1 user reviews,1,0,1
800030,True,0,8 user reviews,3,5,8
800040,True,0,No user reviews,0,0,0
800050,True,7,Positive,14,2,16
800060,True,0,No user reviews,0,0,0
800090,True,0,No user reviews,0,0,0
800100,True,0,No user reviews,0,0,0
800120,True,7,Positive,29,5,34
800130,True,0,2 user reviews,1,1,2
800140,True,0,No user reviews,0,0,0
800150,True,0,No user reviews,0,0,0
800170,True,0,No user reviews,0,0,0
800180,True,7,Positive,26,0,26
800190,True,7,Positive,15,1,16
800200,True,6,Mostly Positive,48,16,64
800210,True,0,No user reviews,0,0,0
800220,True,0,1 user reviews,0,1,1
800221,True,0,2 user reviews,1,1,2
800222,True,0,1 user reviews,1,0,1
800230,True,7,Positive,15,0,15
800240,True,6,Mostly Positive,10,4,14
800250,True,0,No user reviews,0,0,0
800260,True,0,No user reviews,0,0,0
800261,True,0,No user reviews,0,0,0
800270,True,6,Mostly Positive,944,338,1282
800280,True,0,No user reviews,0,0,0
800290,True,0,9 user reviews,8,1,9
800300,True,0,No user reviews,0,0,0
800310,True,0,5 user reviews,0,5,5
800320,True,0,1 user reviews,1,0,1
800330,True,0,1 user reviews,1,0,1
800340,True,5,Mixed,7,4,11
800341,True,0,2 user reviews,2,0,2
800342,True,0,7 user reviews,7,0,7
800350,True,0,3 user reviews,3,0,3
800370,True,8,Very Positive,302,20,322
800380,True,5,Mixed,9,7,16
800390,True,7,Positive,21,0,21
800450,True,5,Mixed,25,11,36
800460,True,0,No user reviews,0,0,0
800490,True,7,Positive,9,2,11
800510,True,0,6 user reviews,4,2,6
800520,True,0,1 user reviews,1,0,1
800530,True,0,1 user reviews,0,1,1
800540,True,0,No user reviews,0,0,0
800550,True,0,4 user reviews,3,1,4
800560,True,5,Mixed,6,5,11
800570,True,0,No user reviews,0,0,0
800580,True,5,Mixed,6,4,10
800590,True,0,No user reviews,0,0,0
800600,True,8,Very Positive,177,9,186
800610,True,0,No user reviews,0,0,0
800620,True,8,Very Positive,181,5,186
800630,True,0,No user reviews,0,0,0
800640,True,0,7 user reviews,6,1,7
800650,True,5,Mixed,8,6,14
800660,True,0,2 user reviews,2,0,2
800670,True,5,Mixed,9,5,14
800680,True,0,No user reviews,0,0,0
800690,True,7,Positive,16,0,16
800700,True,0,8 user reviews,7,1,8
800710,True,0,No user reviews,0,0,0
800720,True,0,No user reviews,0,0,0
800740,True,0,1 user reviews,1,0,1
800810,True,0,No user reviews,0,0,0
800820,True,0,9 user reviews,9,0,9
800830,True,0,No user reviews,0,0,0
800840,True,0,1 user reviews,0,1,1
800860,True,0,3 user reviews,3,0,3
800910,True,0,2 user reviews,2,0,2
800930,True,7,Positive,12,1,13
800950,True,0,No user reviews,0,0,0
800980,True,0,2 user reviews,0,2,2
801010,True,5,Mixed,4,6,10
801020,True,0,2 user reviews,0,2,2
801040,True,8,Very Positive,50,8,58
801060,True,0,2 user reviews,0,2,2
801070,True,0,No user reviews,0,0,0
801080,True,0,No user reviews,0,0,0
801120,True,0,No user reviews,0,0,0
801140,True,0,No user reviews,0,0,0
801150,True,0,2 user reviews,1,1,2
801180,True,0,4 user reviews,1,3,4
801210,True,5,Mixed,20,12,32
801220,True,0,No user reviews,0,0,0
801230,True,0,No user reviews,0,0,0
801250,True,0,1 user reviews,1,0,1
801260,True,0,5 user reviews,4,1,5
801280,True,0,2 user reviews,1,1,2
801290,True,8,Very Positive,50,3,53
801300,True,0,7 user reviews,7,0,7
801310,True,0,No user reviews,0,0,0
801320,True,0,8 user reviews,4,4,8
801330,True,0,2 user reviews,1,1,2
801340,True,0,7 user reviews,1,6,7
801370,True,0,No user reviews,0,0,0
801380,True,0,1 user reviews,1,0,1
801390,True,0,No user reviews,0,0,0
801400,True,0,No user reviews,0,0,0
801410,True,0,2 user reviews,2,0,2
801420,True,0,No user reviews,0,0,0
801440,True,0,9 user reviews,4,5,9
801450,True,0,No user reviews,0,0,0
801460,True,0,No user reviews,0,0,0
801461,True,0,No user reviews,0,0,0
801462,True,0,No user reviews,0,0,0
801480,True,8,Very Positive,351,11,362
801490,True,0,3 user reviews,0,3,3
801500,True,0,2 user reviews,2,0,2
801550,True,0,No user reviews,0,0,0
801560,True,0,2 user reviews,2,0,2
801561,True,0,1 user reviews,1,0,1
801570,True,0,No user reviews,0,0,0
801571,True,0,No user reviews,0,0,0
801580,True,0,1 user reviews,1,0,1
801590,True,0,No user reviews,0,0,0
801591,True,0,No user reviews,0,0,0
801592,True,0,No user reviews,0,0,0
801593,True,0,No user reviews,0,0,0
801594,True,0,No user reviews,0,0,0
801595,True,0,No user reviews,0,0,0
801596,True,0,No user reviews,0,0,0
801600,True,0,No user reviews,0,0,0
801610,True,0,No user reviews,0,0,0
801630,True,9,Overwhelmingly Positive,1037,45,1082
801640,True,0,No user reviews,0,0,0
801660,True,0,1 user reviews,1,0,1
801670,True,6,Mostly Positive,26,8,34
801690,True,0,3 user reviews,3,0,3
801700,True,0,2 user reviews,1,1,2
801710,True,7,Positive,22,3,25
801740,True,0,No user reviews,0,0,0
801750,True,7,Positive,20,0,20
801760,True,0,3 user reviews,3,0,3
801770,True,0,4 user reviews,1,3,4
801780,True,0,3 user reviews,0,3,3
801790,True,0,No user reviews,0,0,0
801830,True,0,1 user reviews,0,1,1
801840,True,0,No user reviews,0,0,0
801860,True,8,Very Positive,284,5,289
801870,True,0,No user reviews,0,0,0
801880,True,5,Mixed,41,40,81
801890,True,0,2 user reviews,2,0,2
801900,True,0,9 user reviews,7,2,9
801910,True,0,No user reviews,0,0,0
801920,True,0,6 user reviews,6,0,6
801930,True,0,No user reviews,0,0,0
801940,True,0,3 user reviews,1,2,3
801970,True,0,No user reviews,0,0,0
801980,True,7,Positive,16,0,16
801990,True,0,No user reviews,0,0,0
802000,True,0,2 user reviews,2,0,2
802020,True,0,No user reviews,0,0,0
802040,True,7,Positive,35,4,39
802050,True,0,No user reviews,0,0,0
802060,True,0,1 user reviews,1,0,1
802070,True,7,Positive,8,2,10
802080,True,0,9 user reviews,7,2,9
802090,True,0,2 user reviews,2,0,2
802100,True,0,No user reviews,0,0,0
802120,True,0,2 user reviews,0,2,2
802130,True,0,3 user reviews,3,0,3
802150,True,0,No user reviews,0,0,0
802170,True,0,No user reviews,0,0,0
802180,True,0,1 user reviews,1,0,1
802190,True,0,6 user reviews,3,3,6
802200,True,0,No user reviews,0,0,0
802210,True,0,7 user reviews,6,1,7
802240,True,0,No user reviews,0,0,0
802260,True,0,2 user reviews,2,0,2
802270,True,0,No user reviews,0,0,0
802280,True,0,1 user reviews,1,0,1
802290,True,0,1 user reviews,0,1,1
802300,True,0,2 user reviews,1,1,2
802310,True,0,4 user reviews,3,1,4
802320,True,0,3 user reviews,1,2,3
802330,True,4,Mostly Negative,5,8,13
802340,True,0,4 user reviews,3,1,4
802350,True,0,No user reviews,0,0,0
802360,True,0,8 user reviews,3,5,8
802370,True,0,No user reviews,0,0,0
802390,True,0,No user reviews,0,0,0
802400,True,7,Positive,30,2,32
802410,True,0,No user reviews,0,0,0
802420,True,0,No user reviews,0,0,0
802440,True,0,No user reviews,0,0,0
802450,True,7,Positive,37,7,44
802460,True,0,1 user reviews,1,0,1
802470,True,0,No user reviews,0,0,0
802480,True,0,1 user reviews,0,1,1
802490,True,5,Mixed,8,4,12
802500,True,0,No user reviews,0,0,0
802510,True,0,No user reviews,0,0,0
802530,True,0,2 user reviews,0,2,2
802540,True,0,No user reviews,0,0,0
802550,True,0,No user reviews,0,0,0
802580,True,0,No user reviews,0,0,0
802590,True,0,No user reviews,0,0,0
802600,True,0,No user reviews,0,0,0
802610,True,0,No user reviews,0,0,0
802620,True,0,No user reviews,0,0,0
802630,True,0,No user reviews,0,0,0
802640,True,8,Very Positive,53,2,55
802650,True,0,5 user reviews,5,0,5
802660,True,0,2 user reviews,1,1,2
802690,True,5,Mixed,7,7,14
802700,True,5,Mixed,24,14,38
802720,True,0,2 user reviews,2,0,2
802730,True,8,Very Positive,83,14,97
802740,True,7,Positive,12,1,13
802770,True,0,No user reviews,0,0,0
802780,True,0,5 user reviews,4,1,5
802810,True,5,Mixed,7,6,13
802820,True,0,9 user reviews,7,2,9
802850,True,5,Mixed,13,8,21
802860,True,0,6 user reviews,6,0,6
802870,True,8,Very Positive,189,5,194
802880,True,8,Very Positive,121,5,126
802890,True,8,Very Positive,238,13,251
802900,True,0,8 user reviews,5,3,8
802910,True,7,Positive,18,1,19
802920,True,0,9 user reviews,5,4,9
802930,True,0,6 user reviews,6,0,6
802960,True,0,No user reviews,0,0,0
802980,True,0,2 user reviews,2,0,2
803030,True,0,No user reviews,0,0,0
803040,True,5,Mixed,37,23,60
803050,True,0,No user reviews,0,0,0
803060,True,0,No user reviews,0,0,0
803080,True,0,4 user reviews,3,1,4
803090,True,0,No user reviews,0,0,0
803100,True,0,No user reviews,0,0,0
803110,True,0,4 user reviews,1,3,4
803130,True,5,Mixed,6,5,11
803140,True,0,No user reviews,0,0,0
803150,True,7,Positive,32,4,36
803170,True,0,1 user reviews,1,0,1
803210,True,0,No user reviews,0,0,0
803220,True,0,No user reviews,0,0,0
803240,True,0,1 user reviews,0,1,1
803260,True,5,Mixed,8,4,12
803270,True,0,6 user reviews,6,0,6
803280,True,0,5 user reviews,5,0,5
803290,True,0,1 user reviews,1,0,1
803310,True,0,9 user reviews,1,8,9
803320,True,0,1 user reviews,0,1,1
803330,True,9,Overwhelmingly Positive,2845,137,2982
803340,True,0,No user reviews,0,0,0
803350,True,0,No user reviews,0,0,0
803360,True,0,5 user reviews,4,1,5
803380,True,7,Positive,16,1,17
803381,True,7,Positive,18,3,21
803390,True,0,3 user reviews,2,1,3
803450,True,0,No user reviews,0,0,0
803500,True,0,No user reviews,0,0,0
803510,True,0,8 user reviews,7,1,8
803520,True,0,No user reviews,0,0,0
803570,True,0,5 user reviews,1,4,5
803580,True,0,1 user reviews,1,0,1
803590,True,0,6 user reviews,6,0,6
803600,True,8,Very Positive,828,113,941
803610,True,0,2 user reviews,2,0,2
803660,True,0,No user reviews,0,0,0
803670,True,0,No user reviews,0,0,0
803680,True,0,1 user reviews,0,1,1
803690,True,0,No user reviews,0,0,0
803700,True,0,No user reviews,0,0,0
803710,True,0,No user reviews,0,0,0
803711,True,0,No user reviews,0,0,0
803712,True,0,No user reviews,0,0,0
803720,True,0,4 user reviews,2,2,4
803750,True,0,7 user reviews,6,1,7
803760,True,0,1 user reviews,1,0,1
803780,True,0,1 user reviews,1,0,1
803800,True,0,7 user reviews,3,4,7
803810,True,0,No user reviews,0,0,0
803830,True,6,Mostly Positive,97,26,123
803840,True,0,1 user reviews,1,0,1
803850,True,6,Mostly Positive,17,7,24
803860,True,0,No user reviews,0,0,0
803870,True,0,1 user reviews,1,0,1
803890,True,4,Mostly Negative,3,7,10
803910,True,0,No user reviews,0,0,0
803920,True,0,6 user reviews,5,1,6
803930,True,0,3 user reviews,3,0,3
803960,True,0,No user reviews,0,0,0
803970,True,0,No user reviews,0,0,0
803980,True,5,Mixed,389,170,559
804000,True,6,Mostly Positive,8,3,11
804010,True,8,Very Positive,435,52,487
804030,True,0,3 user reviews,3,0,3
804070,True,0,No user reviews,0,0,0
804120,True,0,5 user reviews,4,1,5
804130,True,6,Mostly Positive,9,3,12
804190,True,0,No user reviews,0,0,0
804200,True,0,No user reviews,0,0,0
804210,True,5,Mixed,9,7,16
804230,True,0,No user reviews,0,0,0
804270,True,0,No user reviews,0,0,0
804290,True,5,Mixed,6,5,11
804310,True,0,2 user reviews,2,0,2
804320,True,0,No user reviews,0,0,0
804330,True,0,No user reviews,0,0,0
804340,True,0,No user reviews,0,0,0
804350,True,6,Mostly Positive,21,6,27
804390,True,0,No user reviews,0,0,0
804400,True,0,5 user reviews,5,0,5
804410,True,0,No user reviews,0,0,0
804430,True,0,7 user reviews,2,5,7
804440,True,0,6 user reviews,5,1,6
804450,True,0,No user reviews,0,0,0
804460,True,0,6 user reviews,3,3,6
804490,True,6,Mostly Positive,446,112,558
804500,True,0,No user reviews,0,0,0
804530,True,0,5 user reviews,5,0,5
804540,True,0,No user reviews,0,0,0
804560,True,0,No user reviews,0,0,0
804580,True,0,No user reviews,0,0,0
804590,True,0,No user reviews,0,0,0
804600,True,0,6 user reviews,4,2,6
804610,True,5,Mixed,7,4,11
804620,True,0,No user reviews,0,0,0
804630,True,0,No user reviews,0,0,0
804640,True,7,Positive,15,2,17
804641,True,7,Positive,13,1,14
804642,True,7,Positive,9,1,10
804643,True,0,7 user reviews,6,1,7
804644,True,7,Positive,9,1,10
804645,True,0,8 user reviews,7,1,8
804646,True,7,Positive,10,2,12
804647,True,0,9 user reviews,7,2,9
804680,True,0,1 user reviews,0,1,1
804690,True,0,No user reviews,0,0,0
804700,True,8,Very Positive,92,4,96
804730,True,5,Mixed,31,44,75
804740,True,0,No user reviews,0,0,0
804741,True,0,No user reviews,0,0,0
804742,True,0,No user reviews,0,0,0
804750,True,0,No user reviews,0,0,0
804760,True,7,Positive,32,5,37
804780,True,0,4 user reviews,3,1,4
804790,True,0,No user reviews,0,0,0
804820,True,0,No user reviews,0,0,0
804830,True,0,9 user reviews,3,6,9
804850,True,5,Mixed,90,66,156
804860,True,0,No user reviews,0,0,0
804870,True,6,Mostly Positive,61,24,85
804900,True,0,5 user reviews,3,2,5
804910,True,0,No user reviews,0,0,0
804920,True,0,No user reviews,0,0,0
804930,True,0,No user reviews,0,0,0
804950,True,0,2 user reviews,2,0,2
804970,True,0,No user reviews,0,0,0
804980,True,0,No user reviews,0,0,0
804990,True,0,No user reviews,0,0,0
805000,True,0,1 user reviews,1,0,1
805010,True,0,4 user reviews,3,1,4
805020,True,0,2 user reviews,2,0,2
805030,True,0,2 user reviews,2,0,2
805040,True,0,2 user reviews,2,0,2
805060,True,0,1 user reviews,1,0,1
805070,True,0,1 user reviews,1,0,1
805080,True,0,No user reviews,0,0,0
805090,True,5,Mixed,5,6,11
805100,True,0,No user reviews,0,0,0
805110,True,0,No user reviews,0,0,0
805120,True,0,7 user reviews,3,4,7
805130,True,0,No user reviews,0,0,0
805140,True,0,No user reviews,0,0,0
805150,True,4,Mostly Negative,4,7,11
805180,True,0,No user reviews,0,0,0
805200,True,0,No user reviews,0,0,0
805210,True,0,No user reviews,0,0,0
805220,True,0,No user reviews,0,0,0
805250,True,0,No user reviews,0,0,0
805260,True,0,No user reviews,0,0,0
805270,True,0,No user reviews,0,0,0
805320,True,7,Positive,19,0,19
805330,True,0,No user reviews,0,0,0
805340,True,0,1 user reviews,1,0,1
805350,True,0,1 user reviews,1,0,1
805360,True,0,8 user reviews,6,2,8
805370,True,0,6 user reviews,6,0,6
805380,True,0,No user reviews,0,0,0
805400,True,6,Mostly Positive,10,4,14
805420,True,0,3 user reviews,3,0,3
805440,True,0,6 user reviews,4,2,6
805470,True,0,1 user reviews,1,0,1
805480,True,0,No user reviews,0,0,0
805500,True,6,Mostly Positive,9,3,12
805510,True,0,No user reviews,0,0,0
805520,True,0,3 user reviews,3,0,3
805540,True,0,No user reviews,0,0,0
805550,True,8,Very Positive,3045,447,3492
805560,True,0,No user reviews,0,0,0
805590,True,8,Very Positive,70,0,70
805610,True,0,8 user reviews,6,2,8
805620,True,0,No user reviews,0,0,0
805660,True,6,Mostly Positive,18,6,24
805690,True,0,1 user reviews,0,1,1
805710,True,0,6 user reviews,3,3,6
805720,True,0,2 user reviews,1,1,2
805730,True,0,No user reviews,0,0,0
805760,True,5,Mixed,5,5,10
805770,True,0,No user reviews,0,0,0
805790,True,0,1 user reviews,1,0,1
805800,True,0,No user reviews,0,0,0
805820,True,8,Very Positive,97,3,100
805840,True,0,3 user reviews,3,0,3
805850,True,0,No user reviews,0,0,0
805870,True,6,Mostly Positive,22,8,30
805880,True,0,7 user reviews,4,3,7
805890,True,0,No user reviews,0,0,0
805900,True,0,3 user reviews,3,0,3
805920,True,6,Mostly Positive,21,6,27
805930,True,0,No user reviews,0,0,0
805940,True,8,Very Positive,525,125,650
805950,True,0,No user reviews,0,0,0
805970,True,0,3 user reviews,3,0,3
805980,True,0,6 user reviews,3,3,6
805990,True,0,No user reviews,0,0,0
806000,True,0,No user reviews,0,0,0
806010,True,0,2 user reviews,1,1,2
806020,True,0,9 user reviews,7,2,9
806050,True,0,No user reviews,0,0,0
806100,True,6,Mostly Positive,9,3,12
806120,True,0,3 user reviews,3,0,3
806140,True,8,Very Positive,107,17,124
806150,True,0,No user reviews,0,0,0
806160,True,3,Negative,2,9,11
806180,True,0,No user reviews,0,0,0
806200,True,0,No user reviews,0,0,0
806220,True,5,Mixed,5,5,10
806230,True,0,7 user reviews,3,4,7
806240,True,0,1 user reviews,1,0,1
806280,True,0,No user reviews,0,0,0
806300,True,0,No user reviews,0,0,0
806320,True,0,No user reviews,0,0,0
806330,True,0,No user reviews,0,0,0
806350,True,0,4 user reviews,4,0,4
806360,True,0,No user reviews,0,0,0
806370,True,0,1 user reviews,1,0,1
806390,True,0,No user reviews,0,0,0
806410,True,0,No user reviews,0,0,0
806420,True,0,No user reviews,0,0,0
806430,True,0,No user reviews,0,0,0
806440,True,0,No user reviews,0,0,0
806450,True,0,No user reviews,0,0,0
806460,True,0,No user reviews,0,0,0
806470,True,0,8 user reviews,4,4,8
806480,True,0,No user reviews,0,0,0
806490,True,7,Positive,9,1,10
806500,True,0,No user reviews,0,0,0
806501,True,0,3 user reviews,0,3,3
806510,True,0,1 user reviews,1,0,1
806521,True,0,No user reviews,0,0,0
806530,True,6,Mostly Positive,20,8,28
806540,True,0,No user reviews,0,0,0
806550,True,0,1 user reviews,1,0,1
806560,True,0,No user reviews,0,0,0
806570,True,0,No user reviews,0,0,0
806580,True,7,Positive,10,0,10
806600,True,0,No user reviews,0,0,0
806610,True,0,7 user reviews,6,1,7
806630,True,0,5 user reviews,5,0,5
806650,True,0,No user reviews,0,0,0
806670,True,0,4 user reviews,4,0,4
806710,True,0,No user reviews,0,0,0
806711,True,0,No user reviews,0,0,0
806712,True,0,No user reviews,0,0,0
806713,True,0,No user reviews,0,0,0
806714,True,0,No user reviews,0,0,0
806715,True,0,No user reviews,0,0,0
806716,True,0,No user reviews,0,0,0
806720,True,0,6 user reviews,6,0,6
806740,True,0,4 user reviews,2,2,4
806750,True,0,No user reviews,0,0,0
806760,True,0,No user reviews,0,0,0
806770,True,6,Mostly Positive,22,7,29
806780,True,5,Mixed,70,38,108
806790,True,0,No user reviews,0,0,0
806800,True,0,No user reviews,0,0,0
806830,True,0,5 user reviews,1,4,5
806840,True,0,4 user reviews,4,0,4
806850,True,5,Mixed,8,6,14
806860,True,5,Mixed,56,46,102
806880,True,0,No user reviews,0,0,0
806900,True,0,3 user reviews,3,0,3
806910,True,0,9 user reviews,6,3,9
806920,True,0,No user reviews,0,0,0
806930,True,0,1 user reviews,0,1,1
806940,True,0,1 user reviews,0,1,1
806950,True,5,Mixed,166,97,263
806960,True,5,Mixed,8,6,14
806970,True,0,2 user reviews,1,1,2
806980,True,0,No user reviews,0,0,0
806990,True,0,2 user reviews,2,0,2
807020,True,0,2 user reviews,2,0,2
807040,True,0,No user reviews,0,0,0
807050,True,0,No user reviews,0,0,0
807060,True,6,Mostly Positive,24,9,33
807070,True,0,2 user reviews,2,0,2
807080,True,4,Mostly Negative,4,8,12
807100,True,0,No user reviews,0,0,0
807120,True,8,Very Positive,1278,206,1484
807140,True,0,2 user reviews,2,0,2
807150,True,0,No user reviews,0,0,0
807210,True,0,No user reviews,0,0,0
807230,True,5,Mixed,22,10,32
807250,True,0,No user reviews,0,0,0
807260,True,0,No user reviews,0,0,0
807261,True,0,No user reviews,0,0,0
807290,True,0,2 user reviews,2,0,2
807300,True,0,No user reviews,0,0,0
807310,True,0,No user reviews,0,0,0
807320,True,7,Positive,10,1,11
807340,True,0,2 user reviews,1,1,2
807420,True,0,No user reviews,0,0,0
807430,True,0,4 user reviews,2,2,4
807450,True,0,No user reviews,0,0,0
807460,True,0,No user reviews,0,0,0
807470,True,0,No user reviews,0,0,0
807480,True,0,No user reviews,0,0,0
807490,True,0,No user reviews,0,0,0
807500,True,0,No user reviews,0,0,0
807510,True,0,No user reviews,0,0,0
807520,True,0,3 user reviews,3,0,3
807530,True,0,2 user reviews,2,0,2
807540,True,0,1 user reviews,1,0,1
807550,True,0,No user reviews,0,0,0
807560,True,0,2 user reviews,2,0,2
807570,True,0,No user reviews,0,0,0
807620,True,0,2 user reviews,2,0,2
807630,True,0,2 user reviews,2,0,2
807640,True,0,1 user reviews,1,0,1
807650,True,0,No user reviews,0,0,0
807660,True,0,No user reviews,0,0,0
807661,True,0,No user reviews,0,0,0
807662,True,0,No user reviews,0,0,0
807663,True,0,No user reviews,0,0,0
807670,True,0,No user reviews,0,0,0
807671,True,0,No user reviews,0,0,0
807680,True,0,No user reviews,0,0,0
807681,True,0,No user reviews,0,0,0
807682,True,0,No user reviews,0,0,0
807683,True,0,No user reviews,0,0,0
807684,True,0,No user reviews,0,0,0
807685,True,0,No user reviews,0,0,0
807686,True,0,No user reviews,0,0,0
807687,True,0,No user reviews,0,0,0
807688,True,0,No user reviews,0,0,0
807689,True,0,No user reviews,0,0,0
807690,True,0,No user reviews,0,0,0
807710,True,0,No user reviews,0,0,0
807711,True,0,No user reviews,0,0,0
807712,True,0,No user reviews,0,0,0
807713,True,0,No user reviews,0,0,0
807714,True,0,No user reviews,0,0,0
807715,True,0,No user reviews,0,0,0
807716,True,0,No user reviews,0,0,0
807717,True,0,No user reviews,0,0,0
807718,True,0,No user reviews,0,0,0
807719,True,0,No user reviews,0,0,0
807720,True,0,No user reviews,0,0,0
807730,True,5,Mixed,8,4,12
807750,True,0,No user reviews,0,0,0
807751,True,0,No user reviews,0,0,0
807752,True,0,No user reviews,0,0,0
807753,True,0,No user reviews,0,0,0
807754,True,0,No user reviews,0,0,0
807755,True,0,No user reviews,0,0,0
807756,True,0,No user reviews,0,0,0
807757,True,0,No user reviews,0,0,0
807758,True,0,No user reviews,0,0,0
807759,True,0,No user reviews,0,0,0
807760,True,0,No user reviews,0,0,0
807761,True,0,No user reviews,0,0,0
807762,True,0,No user reviews,0,0,0
807763,True,0,No user reviews,0,0,0
807764,True,0,No user reviews,0,0,0
807765,True,0,No user reviews,0,0,0
807766,True,0,No user reviews,0,0,0
807770,True,0,6 user reviews,5,1,6
807780,True,0,3 user reviews,1,2,3
807790,True,5,Mixed,4,6,10
807800,True,0,1 user reviews,1,0,1
807810,True,0,No user reviews,0,0,0
807820,True,0,1 user reviews,0,1,1
807830,True,0,5 user reviews,0,5,5
807840,True,0,No user reviews,0,0,0
807850,True,0,1 user reviews,0,1,1
807860,True,0,2 user reviews,0,2,2
807870,True,0,1 user reviews,0,1,1
807880,True,0,5 user reviews,2,3,5
807890,True,0,2 user reviews,0,2,2
807900,True,0,No user reviews,0,0,0
807910,True,0,No user reviews,0,0,0
807920,True,5,Mixed,53,40,93
807930,True,0,1 user reviews,0,1,1
807940,True,0,3 user reviews,1,2,3
807950,True,0,2 user reviews,0,2,2
807960,True,0,1 user reviews,1,0,1
807990,True,0,No user reviews,0,0,0
808020,True,0,1 user reviews,0,1,1
808080,True,8,Very Positive,131,16,147
808090,True,5,Mixed,8,5,13
808100,True,8,Very Positive,152,23,175
808110,True,0,No user reviews,0,0,0
808120,True,0,2 user reviews,1,1,2
808130,True,0,8 user reviews,4,4,8
808140,True,0,No user reviews,0,0,0
808150,True,0,No user reviews,0,0,0
808160,True,6,Mostly Positive,7,3,10
808190,True,0,1 user reviews,1,0,1
808210,True,0,7 user reviews,5,2,7
808220,True,0,9 user reviews,8,1,9
808230,True,0,No user reviews,0,0,0
808270,True,0,2 user reviews,0,2,2
808290,True,0,2 user reviews,1,1,2
808360,True,0,5 user reviews,5,0,5
808390,True,0,No user reviews,0,0,0
808400,True,0,1 user reviews,1,0,1
808410,True,0,2 user reviews,2,0,2
808420,True,0,4 user reviews,1,3,4
808430,True,0,No user reviews,0,0,0
808440,True,0,1 user reviews,1,0,1
808450,True,0,6 user reviews,5,1,6
808470,True,0,No user reviews,0,0,0
808540,True,0,9 user reviews,5,4,9
808580,True,0,3 user reviews,3,0,3
808590,True,0,No user reviews,0,0,0
808600,True,0,No user reviews,0,0,0
808610,True,0,No user reviews,0,0,0
808620,True,0,No user reviews,0,0,0
808630,True,0,No user reviews,0,0,0
808640,True,0,No user reviews,0,0,0
808650,True,0,No user reviews,0,0,0
808660,True,0,No user reviews,0,0,0
808670,True,0,No user reviews,0,0,0
808680,True,0,No user reviews,0,0,0
808690,True,0,No user reviews,0,0,0
808700,True,0,No user reviews,0,0,0
808710,True,0,No user reviews,0,0,0
808720,True,0,1 user reviews,0,1,1
808730,True,0,No user reviews,0,0,0
808740,True,0,No user reviews,0,0,0
808750,True,0,1 user reviews,0,1,1
808760,True,0,No user reviews,0,0,0
808770,True,5,Mixed,9,4,13
808790,True,0,No user reviews,0,0,0
808800,True,7,Positive,30,5,35
808810,True,0,No user reviews,0,0,0
808870,True,0,No user reviews,0,0,0
808880,True,0,No user reviews,0,0,0
808890,True,0,No user reviews,0,0,0
808900,True,0,No user reviews,0,0,0
808901,True,0,No user reviews,0,0,0
808902,True,0,No user reviews,0,0,0
808903,True,0,No user reviews,0,0,0
808910,True,8,Very Positive,596,95,691
808931,True,0,1 user reviews,1,0,1
808932,True,0,4 user reviews,3,1,4
808934,True,0,3 user reviews,3,0,3
808935,True,0,1 user reviews,1,0,1
808936,True,0,No user reviews,0,0,0
808937,True,0,No user reviews,0,0,0
808938,True,0,No user reviews,0,0,0
808939,True,0,No user reviews,0,0,0
808940,True,0,No user reviews,0,0,0
808941,True,0,No user reviews,0,0,0
808950,True,0,5 user reviews,4,1,5
808960,True,0,No user reviews,0,0,0
808980,True,0,7 user reviews,7,0,7
808990,True,0,4 user reviews,3,1,4
809000,True,5,Mixed,18,16,34
809010,True,0,No user reviews,0,0,0
809020,True,9,Overwhelmingly Positive,477,23,500
809040,True,0,No user reviews,0,0,0
809050,True,5,Mixed,12,7,19
809060,True,0,No user reviews,0,0,0
809070,True,0,No user reviews,0,0,0
809080,True,0,6 user reviews,1,5,6
809100,True,0,No user reviews,0,0,0
809140,True,8,Very Positive,999,182,1181
809150,True,0,No user reviews,0,0,0
809180,True,0,4 user reviews,4,0,4
809190,True,0,No user reviews,0,0,0
809200,True,0,4 user reviews,3,1,4
809210,True,6,Mostly Positive,45,12,57
809220,True,0,1 user reviews,0,1,1
809230,True,8,Very Positive,374,83,457
809240,True,6,Mostly Positive,10,4,14
809250,True,0,No user reviews,0,0,0
809260,True,0,1 user reviews,1,0,1
809270,True,0,4 user reviews,2,2,4
809280,True,5,Mixed,57,44,101
809290,True,0,No user reviews,0,0,0
809300,True,0,No user reviews,0,0,0
809310,True,7,Positive,29,5,34
809320,True,0,3 user reviews,3,0,3
809330,True,0,1 user reviews,1,0,1
809340,True,5,Mixed,8,4,12
809350,True,0,No user reviews,0,0,0
809360,True,0,7 user reviews,6,1,7
809380,True,0,No user reviews,0,0,0
809410,True,7,Positive,9,2,11
809430,True,0,No user reviews,0,0,0
809440,True,8,Very Positive,183,28,211
809450,True,0,2 user reviews,0,2,2
809460,True,0,2 user reviews,2,0,2
809470,True,0,3 user reviews,1,2,3
809480,True,0,2 user reviews,1,1,2
809490,True,0,5 user reviews,2,3,5
809500,True,0,5 user reviews,2,3,5
809530,True,7,Positive,20,3,23
809540,True,8,Very Positive,109,13,122
809550,True,0,No user reviews,0,0,0
809570,True,0,1 user reviews,1,0,1
809580,True,5,Mixed,19,10,29
809600,True,0,No user reviews,0,0,0
809610,True,0,No user reviews,0,0,0
809630,True,0,No user reviews,0,0,0
809631,True,0,No user reviews,0,0,0
809632,True,0,No user reviews,0,0,0
809640,True,0,No user reviews,0,0,0
809650,True,0,No user reviews,0,0,0
809670,True,0,No user reviews,0,0,0
809680,True,7,Positive,17,0,17
809690,True,0,No user reviews,0,0,0
809700,True,0,1 user reviews,1,0,1
809720,True,6,Mostly Positive,148,38,186
809730,True,6,Mostly Positive,55,16,71
809740,True,0,No user reviews,0,0,0
809760,True,0,1 user reviews,0,1,1
809770,True,0,8 user reviews,2,6,8
809780,True,0,No user reviews,0,0,0
809790,True,0,8 user reviews,3,5,8
809800,True,0,1 user reviews,0,1,1
809820,True,0,No user reviews,0,0,0
809830,True,0,No user reviews,0,0,0
809840,True,5,Mixed,7,5,12
809850,True,7,Positive,35,5,40
809860,True,0,No user reviews,0,0,0
809870,True,8,Very Positive,74,1,75
809880,True,8,Very Positive,144,16,160
809890,True,6,Mostly Positive,181,63,244
809900,True,0,6 user reviews,5,1,6
809910,True,0,No user reviews,0,0,0
809930,True,0,No user reviews,0,0,0
809950,True,0,8 user reviews,7,1,8
809960,True,8,Very Positive,47,7,54
809970,True,0,No user reviews,0,0,0
809980,True,0,No user reviews,0,0,0
809990,True,0,No user reviews,0,0,0
810000,True,0,5 user reviews,5,0,5
810010,True,0,No user reviews,0,0,0
810020,True,0,No user reviews,0,0,0
810040,True,8,Very Positive,184,16,200
810050,True,0,4 user reviews,2,2,4
810060,True,0,6 user reviews,4,2,6
810070,True,0,No user reviews,0,0,0
810080,True,0,1 user reviews,0,1,1
810090,True,0,No user reviews,0,0,0
810100,True,0,No user reviews,0,0,0
810110,True,0,No user reviews,0,0,0
810140,True,0,No user reviews,0,0,0
810150,True,0,No user reviews,0,0,0
810190,True,0,No user reviews,0,0,0
810200,True,0,No user reviews,0,0,0
810220,True,0,No user reviews,0,0,0
810230,True,0,No user reviews,0,0,0
810240,True,0,No user reviews,0,0,0
810250,True,0,3 user reviews,2,1,3
810260,True,0,No user reviews,0,0,0
810280,True,0,No user reviews,0,0,0
810290,True,0,No user reviews,0,0,0
810300,True,0,No user reviews,0,0,0
810310,True,0,No user reviews,0,0,0
810320,True,0,No user reviews,0,0,0
810330,True,0,5 user reviews,4,1,5
810340,True,0,6 user reviews,4,2,6
810360,True,0,7 user reviews,5,2,7
810370,True,0,No user reviews,0,0,0
810380,True,7,Positive,10,0,10
810390,True,0,1 user reviews,1,0,1
810420,True,0,3 user reviews,3,0,3
810450,True,0,4 user reviews,4,0,4
810460,True,5,Mixed,17,14,31
810470,True,7,Positive,12,2,14
810480,True,0,No user reviews,0,0,0
810490,True,0,No user reviews,0,0,0
810500,True,8,Very Positive,60,8,68
810510,True,0,7 user reviews,4,3,7
810520,True,0,No user reviews,0,0,0
810530,True,0,2 user reviews,2,0,2
810540,True,0,3 user reviews,1,2,3
810570,True,0,3 user reviews,3,0,3
810580,True,0,2 user reviews,2,0,2
810590,True,7,Positive,9,2,11
810600,True,0,3 user reviews,3,0,3
810610,True,0,1 user reviews,1,0,1
810630,True,0,7 user reviews,6,1,7
810640,True,7,Positive,26,3,29
810650,True,0,3 user reviews,0,3,3
810660,True,8,Very Positive,53,6,59
810670,True,6,Mostly Positive,75,29,104
810680,True,0,4 user reviews,3,1,4
810690,True,0,No user reviews,0,0,0
810700,True,0,2 user reviews,1,1,2
810720,True,0,2 user reviews,2,0,2
810740,True,0,No user reviews,0,0,0
810760,True,0,No user reviews,0,0,0
810770,True,5,Mixed,9,7,16
810780,True,6,Mostly Positive,25,8,33
810800,True,0,9 user reviews,6,3,9
810820,True,0,No user reviews,0,0,0
810830,True,0,No user reviews,0,0,0
810840,True,0,No user reviews,0,0,0
810850,True,0,2 user reviews,2,0,2
810860,True,0,No user reviews,0,0,0
810870,True,0,No user reviews,0,0,0
810880,True,0,No user reviews,0,0,0
810890,True,0,1 user reviews,1,0,1
810900,True,0,1 user reviews,1,0,1
810910,True,0,No user reviews,0,0,0
810920,True,0,2 user reviews,2,0,2
810930,True,0,No user reviews,0,0,0
810940,True,0,No user reviews,0,0,0
810950,True,0,No user reviews,0,0,0
810960,True,0,No user reviews,0,0,0
810970,True,0,2 user reviews,2,0,2
810980,True,0,No user reviews,0,0,0
810990,True,0,No user reviews,0,0,0
811000,True,0,No user reviews,0,0,0
811010,True,0,No user reviews,0,0,0
811020,True,0,1 user reviews,1,0,1
811030,True,0,No user reviews,0,0,0
811040,True,0,3 user reviews,3,0,3
811050,True,0,No user reviews,0,0,0
811070,True,0,5 user reviews,5,0,5
811080,True,0,4 user reviews,1,3,4
811090,True,0,No user reviews,0,0,0
811100,True,0,No user reviews,0,0,0
811110,True,7,Positive,10,0,10
811130,True,0,No user reviews,0,0,0
811160,True,0,1 user reviews,1,0,1
811170,True,5,Mixed,16,14,30
811180,True,0,3 user reviews,1,2,3
811190,True,0,4 user reviews,1,3,4
811200,True,0,No user reviews,0,0,0
811210,True,4,Mostly Negative,5,15,20
811220,True,0,No user reviews,0,0,0
811230,True,0,1 user reviews,1,0,1
811240,True,6,Mostly Positive,7,3,10
811250,True,0,6 user reviews,1,5,6
811270,True,7,Positive,39,4,43
811290,True,7,Positive,10,1,11
811300,True,0,3 user reviews,2,1,3
811310,True,5,Mixed,15,19,34
811320,True,8,Very Positive,169,20,189
811360,True,0,No user reviews,0,0,0
811430,True,0,No user reviews,0,0,0
811431,True,0,No user reviews,0,0,0
811440,True,0,2 user reviews,2,0,2
811450,True,0,2 user reviews,1,1,2
811460,True,7,Positive,10,0,10
811470,True,0,No user reviews,0,0,0
811480,True,0,8 user reviews,5,3,8
811500,True,0,No user reviews,0,0,0
811540,True,0,No user reviews,0,0,0
811550,True,0,No user reviews,0,0,0
811620,True,7,Positive,8,2,10
811630,True,0,5 user reviews,2,3,5
811640,True,0,3 user reviews,3,0,3
811650,True,0,No user reviews,0,0,0
811660,True,0,No user reviews,0,0,0
811670,True,0,No user reviews,0,0,0
811690,True,0,1 user reviews,0,1,1
811710,True,0,2 user reviews,2,0,2
811720,True,6,Mostly Positive,28,11,39
811750,True,0,No user reviews,0,0,0
811770,True,0,No user reviews,0,0,0
811790,True,0,No user reviews,0,0,0
811800,True,0,No user reviews,0,0,0
811840,True,7,Positive,43,1,44
811850,True,0,No user reviews,0,0,0
811860,True,0,No user reviews,0,0,0
811870,True,8,Very Positive,129,7,136
811880,True,5,Mixed,82,92,174
811890,True,8,Very Positive,118,13,131
811900,True,0,7 user reviews,4,3,7
811910,True,7,Positive,12,0,12
811940,True,0,No user reviews,0,0,0
811950,True,0,4 user reviews,2,2,4
812000,True,0,No user reviews,0,0,0
812020,True,6,Mostly Positive,31,13,44
812030,True,0,No user reviews,0,0,0
812040,True,6,Mostly Positive,527,173,700
812050,True,0,No user reviews,0,0,0
812060,True,0,No user reviews,0,0,0
812070,True,6,Mostly Positive,17,5,22
812090,True,0,6 user reviews,6,0,6
812100,True,0,4 user reviews,3,1,4
812110,True,5,Mixed,11,5,16
812120,True,0,No user reviews,0,0,0
812130,True,0,3 user reviews,3,0,3
812140,True,8,Very Positive,24074,2674,26748
812160,True,6,Mostly Positive,19,6,25
812170,True,0,2 user reviews,2,0,2
812180,True,0,4 user reviews,1,3,4
812190,True,0,7 user reviews,7,0,7
812200,True,0,No user reviews,0,0,0
812210,True,0,No user reviews,0,0,0
812220,True,0,No user reviews,0,0,0
812230,True,0,No user reviews,0,0,0
812240,True,0,No user reviews,0,0,0
812250,True,0,No user reviews,0,0,0
812260,True,0,No user reviews,0,0,0
812270,True,0,No user reviews,0,0,0
812280,True,0,No user reviews,0,0,0
812320,True,0,No user reviews,0,0,0
812360,True,0,3 user reviews,3,0,3
812380,True,0,No user reviews,0,0,0
812390,True,0,1 user reviews,0,1,1
812400,True,0,No user reviews,0,0,0
812410,True,8,Very Positive,74,9,83
812430,True,0,No user reviews,0,0,0
812440,True,0,No user reviews,0,0,0
812450,True,0,3 user reviews,2,1,3
812460,True,0,No user reviews,0,0,0
812470,True,0,1 user reviews,0,1,1
812480,True,0,No user reviews,0,0,0
812490,True,0,No user reviews,0,0,0
812500,True,0,No user reviews,0,0,0
812501,True,0,No user reviews,0,0,0
812502,True,0,No user reviews,0,0,0
812503,True,0,No user reviews,0,0,0
812510,True,0,No user reviews,0,0,0
812530,True,0,No user reviews,0,0,0
812550,True,6,Mostly Positive,67,23,90
812560,True,5,Mixed,15,10,25
812580,True,0,8 user reviews,7,1,8
812590,True,0,No user reviews,0,0,0
812610,True,0,No user reviews,0,0,0
812650,True,7,Positive,14,2,16
812690,True,0,2 user reviews,2,0,2
812700,True,0,No user reviews,0,0,0
812710,True,0,No user reviews,0,0,0
812711,True,0,No user reviews,0,0,0
812712,True,0,No user reviews,0,0,0
812713,True,0,No user reviews,0,0,0
812714,True,0,No user reviews,0,0,0
812715,True,0,No user reviews,0,0,0
812718,True,0,No user reviews,0,0,0
812720,True,0,No user reviews,0,0,0
812723,True,0,No user reviews,0,0,0
812724,True,0,No user reviews,0,0,0
812725,True,0,No user reviews,0,0,0
812727,True,0,No user reviews,0,0,0
812740,True,0,No user reviews,0,0,0
812750,True,0,1 user reviews,1,0,1
812760,True,0,1 user reviews,0,1,1
812770,True,0,9 user reviews,6,3,9
812780,True,0,No user reviews,0,0,0
812800,True,7,Positive,15,0,15
812810,True,0,6 user reviews,6,0,6
812820,True,0,No user reviews,0,0,0
812830,True,0,No user reviews,0,0,0
812840,True,8,Very Positive,99,3,102
812850,True,0,5 user reviews,2,3,5
812860,True,7,Positive,9,2,11
812870,True,6,Mostly Positive,83,32,115
812890,True,0,1 user reviews,1,0,1
812900,True,0,1 user reviews,1,0,1
812930,True,0,8 user reviews,6,2,8
812940,True,0,1 user reviews,0,1,1
812960,True,6,Mostly Positive,19,6,25
812970,True,0,1 user reviews,1,0,1
812980,True,0,9 user reviews,7,2,9
813020,True,0,1 user reviews,1,0,1
813030,True,6,Mostly Positive,7,3,10
813080,True,0,No user reviews,0,0,0
813090,True,0,No user reviews,0,0,0
813091,True,0,No user reviews,0,0,0
813100,True,0,No user reviews,0,0,0
813110,True,0,1 user reviews,0,1,1
813120,True,0,No user reviews,0,0,0
813150,True,0,7 user reviews,4,3,7
813170,True,5,Mixed,7,10,17
813200,True,0,No user reviews,0,0,0
813210,True,0,No user reviews,0,0,0
813240,True,0,3 user reviews,1,2,3
813250,True,0,7 user reviews,7,0,7
813260,True,0,1 user reviews,1,0,1
813280,True,0,1 user reviews,0,1,1
813290,True,0,No user reviews,0,0,0
813300,True,0,1 user reviews,1,0,1
813310,True,0,No user reviews,0,0,0
813320,True,0,No user reviews,0,0,0
813330,True,0,No user reviews,0,0,0
813350,True,0,No user reviews,0,0,0
813360,True,0,No user reviews,0,0,0
813370,True,0,1 user reviews,1,0,1
813380,True,0,No user reviews,0,0,0
813390,True,0,7 user reviews,6,1,7
813400,True,0,No user reviews,0,0,0
813410,True,7,Positive,17,0,17
813420,True,7,Positive,36,1,37
813440,True,0,No user reviews,0,0,0
813450,True,7,Positive,16,3,19
813460,True,7,Positive,16,2,18
813480,True,7,Positive,11,1,12
813490,True,0,No user reviews,0,0,0
813491,True,0,No user reviews,0,0,0
813500,True,0,No user reviews,0,0,0
813510,True,0,No user reviews,0,0,0
813520,True,0,No user reviews,0,0,0
813530,True,7,Positive,22,2,24
813540,True,8,Very Positive,78,15,93
813560,True,0,No user reviews,0,0,0
813590,True,7,Positive,11,1,12
813610,True,0,No user reviews,0,0,0
813611,True,0,No user reviews,0,0,0
813612,True,0,No user reviews,0,0,0
813613,True,0,No user reviews,0,0,0
813614,True,0,No user reviews,0,0,0
813615,True,0,No user reviews,0,0,0
813616,True,0,No user reviews,0,0,0
813620,True,0,No user reviews,0,0,0
813621,True,0,No user reviews,0,0,0
813622,True,0,No user reviews,0,0,0
813623,True,0,No user reviews,0,0,0
813624,True,0,No user reviews,0,0,0
813625,True,0,No user reviews,0,0,0
813626,True,0,No user reviews,0,0,0
813627,True,0,No user reviews,0,0,0
813630,True,9,Overwhelmingly Positive,2817,90,2907
813650,True,7,Positive,35,3,38
813700,True,8,Very Positive,100,13,113
813730,True,0,2 user reviews,2,0,2
813740,True,0,No user reviews,0,0,0
813750,True,0,No user reviews,0,0,0
813751,True,0,No user reviews,0,0,0
813752,True,0,No user reviews,0,0,0
813753,True,0,No user reviews,0,0,0
813754,True,0,No user reviews,0,0,0
813755,True,0,No user reviews,0,0,0
813756,True,0,No user reviews,0,0,0
813757,True,0,No user reviews,0,0,0
813758,True,0,No user reviews,0,0,0
813759,True,0,No user reviews,0,0,0
813760,True,0,No user reviews,0,0,0
813761,True,0,No user reviews,0,0,0
813762,True,0,No user reviews,0,0,0
813763,True,0,No user reviews,0,0,0
813764,True,0,No user reviews,0,0,0
813765,True,0,No user reviews,0,0,0
813766,True,0,No user reviews,0,0,0
813767,True,0,No user reviews,0,0,0
813768,True,0,No user reviews,0,0,0
813769,True,0,No user reviews,0,0,0
813770,True,0,No user reviews,0,0,0
813771,True,0,No user reviews,0,0,0
813780,True,8,Very Positive,19367,1393,20760
813790,True,0,No user reviews,0,0,0
813791,True,0,No user reviews,0,0,0
813792,True,0,No user reviews,0,0,0
813793,True,0,No user reviews,0,0,0
813794,True,0,No user reviews,0,0,0
813795,True,0,No user reviews,0,0,0
813796,True,0,No user reviews,0,0,0
813797,True,0,No user reviews,0,0,0
813798,True,0,No user reviews,0,0,0
813799,True,0,No user reviews,0,0,0
813800,True,0,No user reviews,0,0,0
813801,True,0,No user reviews,0,0,0
813802,True,0,No user reviews,0,0,0
813803,True,0,No user reviews,0,0,0
813804,True,0,No user reviews,0,0,0
813805,True,0,No user reviews,0,0,0
813806,True,0,No user reviews,0,0,0
813807,True,0,No user reviews,0,0,0
813808,True,0,No user reviews,0,0,0
813809,True,0,No user reviews,0,0,0
813810,True,0,No user reviews,0,0,0
813820,True,7,Positive,12,1,13
813840,True,0,3 user reviews,2,1,3
813850,True,0,No user reviews,0,0,0
813860,True,0,No user reviews,0,0,0
813870,True,0,No user reviews,0,0,0
813900,True,0,2 user reviews,0,2,2
813920,True,0,No user reviews,0,0,0
813930,True,5,Mixed,10,5,15
813950,True,0,No user reviews,0,0,0
813970,True,0,4 user reviews,3,1,4
814010,True,0,No user reviews,0,0,0
814020,True,0,2 user reviews,2,0,2
814030,True,6,Mostly Positive,11,3,14
814060,True,0,1 user reviews,1,0,1
814070,True,0,1 user reviews,1,0,1
814100,True,0,1 user reviews,1,0,1
814110,True,5,Mixed,14,8,22
814140,True,0,4 user reviews,2,2,4
814190,True,0,2 user reviews,1,1,2
814200,True,5,Mixed,10,6,16
814210,True,0,2 user reviews,1,1,2
814230,True,0,1 user reviews,1,0,1
814251,True,0,4 user reviews,1,3,4
814300,True,7,Positive,24,1,25
814310,True,0,7 user reviews,3,4,7
814320,True,0,1 user reviews,1,0,1
814330,True,0,No user reviews,0,0,0
814340,True,4,Mostly Negative,4,8,12
814360,True,7,Positive,40,1,41
814370,True,9,Overwhelmingly Positive,876,34,910
814380,True,8,Very Positive,22355,1937,24292
814390,True,0,No user reviews,0,0,0
814400,True,5,Mixed,26,13,39
814420,True,7,Positive,10,0,10
814440,True,0,No user reviews,0,0,0
814480,True,6,Mostly Positive,84,32,116
814510,True,0,1 user reviews,1,0,1
814520,True,0,No user reviews,0,0,0
814530,True,8,Very Positive,76,12,88
814540,True,8,Very Positive,1202,95,1297
814550,True,0,No user reviews,0,0,0
814560,True,0,1 user reviews,1,0,1
814570,True,0,2 user reviews,1,1,2
814580,True,0,1 user reviews,1,0,1
814590,True,0,4 user reviews,2,2,4
814600,True,0,4 user reviews,3,1,4
814610,True,6,Mostly Positive,9,3,12
814620,True,0,1 user reviews,1,0,1
814630,True,0,No user reviews,0,0,0
814640,True,0,No user reviews,0,0,0
814650,True,0,6 user reviews,5,1,6
814660,True,0,6 user reviews,3,3,6
814680,True,0,No user reviews,0,0,0
814700,True,0,No user reviews,0,0,0
814710,True,0,1 user reviews,1,0,1
814720,True,0,No user reviews,0,0,0
814730,True,0,No user reviews,0,0,0
814740,True,8,Very Positive,142,35,177
814750,True,0,No user reviews,0,0,0
814760,True,0,No user reviews,0,0,0
814770,True,0,9 user reviews,3,6,9
814780,True,0,No user reviews,0,0,0
814790,True,0,No user reviews,0,0,0
814800,True,0,No user reviews,0,0,0
814870,True,0,3 user reviews,2,1,3
814890,True,0,2 user reviews,2,0,2
814900,True,5,Mixed,11,11,22
814930,True,0,No user reviews,0,0,0
814940,True,0,No user reviews,0,0,0
814960,True,0,No user reviews,0,0,0
814990,True,0,1 user reviews,1,0,1
815000,True,7,Positive,30,7,37
815010,True,0,9 user reviews,8,1,9
815020,True,0,No user reviews,0,0,0
815030,True,0,No user reviews,0,0,0
815040,True,0,No user reviews,0,0,0
815060,True,0,No user reviews,0,0,0
815070,True,0,3 user reviews,2,1,3
815080,True,5,Mixed,11,11,22
815090,True,0,No user reviews,0,0,0
815100,True,0,No user reviews,0,0,0
815110,True,0,No user reviews,0,0,0
815120,True,0,No user reviews,0,0,0
815150,True,8,Very Positive,55,1,56
815160,True,0,2 user reviews,2,0,2
815170,True,0,3 user reviews,0,3,3
815210,True,5,Mixed,20,14,34
815240,True,0,3 user reviews,0,3,3
815250,True,0,5 user reviews,1,4,5
815260,True,0,No user reviews,0,0,0
815280,True,0,5 user reviews,4,1,5
815290,True,5,Mixed,13,7,20
815300,True,0,1 user reviews,1,0,1
815320,True,5,Mixed,11,5,16
815330,True,0,No user reviews,0,0,0
815340,True,0,No user reviews,0,0,0
815350,True,0,No user reviews,0,0,0
815351,True,0,2 user reviews,1,1,2
815352,True,0,1 user reviews,1,0,1
815353,True,0,No user reviews,0,0,0
815354,True,0,3 user reviews,3,0,3
815355,True,0,1 user reviews,1,0,1
815356,True,0,2 user reviews,2,0,2
815357,True,0,No user reviews,0,0,0
815358,True,0,No user reviews,0,0,0
815359,True,0,No user reviews,0,0,0
815360,True,0,8 user reviews,3,5,8
815370,True,8,Very Positive,6174,1010,7184
815380,True,7,Positive,36,6,42
815390,True,0,8 user reviews,5,3,8
815410,True,0,7 user reviews,7,0,7
815420,True,0,2 user reviews,1,1,2
815440,True,6,Mostly Positive,17,7,24
815450,True,8,Very Positive,119,7,126
815460,True,5,Mixed,406,351,757
815480,True,0,1 user reviews,0,1,1
815490,True,0,No user reviews,0,0,0
815540,True,0,3 user reviews,3,0,3
815550,True,0,3 user reviews,3,0,3
815560,True,0,3 user reviews,2,1,3
815570,True,0,4 user reviews,3,1,4
815580,True,7,Positive,14,1,15
815600,True,0,No user reviews,0,0,0
815610,True,0,No user reviews,0,0,0
815620,True,0,1 user reviews,0,1,1
815630,True,0,2 user reviews,2,0,2
815640,True,0,No user reviews,0,0,0
815660,True,7,Positive,9,1,10
815680,True,0,No user reviews,0,0,0
815690,True,0,1 user reviews,1,0,1
815700,True,0,No user reviews,0,0,0
815710,True,0,No user reviews,0,0,0
815720,True,0,No user reviews,0,0,0
815730,True,0,3 user reviews,2,1,3
815740,True,0,No user reviews,0,0,0
815750,True,0,No user reviews,0,0,0
815760,True,0,6 user reviews,6,0,6
815770,True,0,7 user reviews,6,1,7
815780,True,8,Very Positive,959,138,1097
815790,True,0,No user reviews,0,0,0
815800,True,0,No user reviews,0,0,0
815810,True,0,1 user reviews,1,0,1
815820,True,0,No user reviews,0,0,0
815830,True,7,Positive,10,1,11
815840,True,0,2 user reviews,1,1,2
815860,True,0,7 user reviews,4,3,7
815940,True,0,No user reviews,0,0,0
815950,True,7,Positive,9,1,10
815980,True,0,1 user reviews,1,0,1
816000,True,0,No user reviews,0,0,0
816020,True,5,Mixed,1896,894,2790
816030,True,0,1 user reviews,1,0,1
816050,True,0,No user reviews,0,0,0
816060,True,5,Mixed,5,5,10
816070,True,0,No user reviews,0,0,0
816080,True,0,No user reviews,0,0,0
816090,True,6,Mostly Positive,2150,754,2904
816110,True,0,No user reviews,0,0,0
816140,True,0,No user reviews,0,0,0
816150,True,0,No user reviews,0,0,0
816160,True,0,8 user reviews,5,3,8
816170,True,0,No user reviews,0,0,0
816180,True,0,5 user reviews,4,1,5
816190,True,0,7 user reviews,6,1,7
816200,True,0,No user reviews,0,0,0
816210,True,0,4 user reviews,3,1,4
816220,True,0,7 user reviews,3,4,7
816240,True,0,1 user reviews,1,0,1
816250,True,7,Positive,13,1,14
816270,True,8,Very Positive,52,10,62
816280,True,0,2 user reviews,2,0,2
816290,True,0,No user reviews,0,0,0
816300,True,0,No user reviews,0,0,0
816310,True,0,No user reviews,0,0,0
816320,True,0,No user reviews,0,0,0
816330,True,5,Mixed,13,9,22
816340,True,8,Very Positive,680,42,722
816350,True,0,No user reviews,0,0,0
816360,True,0,2 user reviews,1,1,2
816370,True,0,No user reviews,0,0,0
816380,True,0,2 user reviews,1,1,2
816390,True,0,1 user reviews,1,0,1
816400,True,0,No user reviews,0,0,0
816410,True,0,1 user reviews,1,0,1
816430,True,6,Mostly Positive,23,8,31
816440,True,0,No user reviews,0,0,0
816470,True,0,No user reviews,0,0,0
816490,True,8,Very Positive,138,15,153
816500,True,7,Positive,9,1,10
816510,True,0,No user reviews,0,0,0
816540,True,0,No user reviews,0,0,0
816550,True,0,2 user reviews,1,1,2
816560,True,5,Mixed,8,5,13
816570,True,0,1 user reviews,0,1,1
816580,True,0,6 user reviews,3,3,6
816590,True,0,No user reviews,0,0,0
816600,True,0,No user reviews,0,0,0
816610,True,0,2 user reviews,2,0,2
816620,True,0,No user reviews,0,0,0
816630,True,0,4 user reviews,3,1,4
816650,True,0,7 user reviews,5,2,7
816660,True,0,2 user reviews,1,1,2
816670,True,0,6 user reviews,2,4,6
816710,True,5,Mixed,12,6,18
816720,True,7,Positive,8,2,10
816730,True,0,No user reviews,0,0,0
816760,True,0,8 user reviews,7,1,8
816770,True,0,9 user reviews,8,1,9
816780,True,7,Positive,10,1,11
816790,True,0,4 user reviews,3,1,4
816810,True,0,No user reviews,0,0,0
816830,True,7,Positive,11,1,12
816840,True,0,1 user reviews,0,1,1
816850,True,0,No user reviews,0,0,0
816870,True,0,8 user reviews,7,1,8
816880,True,0,No user reviews,0,0,0
816890,True,0,1 user reviews,1,0,1
816920,True,0,5 user reviews,1,4,5
816930,True,0,No user reviews,0,0,0
816940,True,0,No user reviews,0,0,0
816950,True,0,No user reviews,0,0,0
816970,True,0,No user reviews,0,0,0
816980,True,0,No user reviews,0,0,0
816981,True,0,1 user reviews,1,0,1
816982,True,0,1 user reviews,1,0,1
816990,True,0,6 user reviews,3,3,6
817020,True,0,No user reviews,0,0,0
817050,True,0,No user reviews,0,0,0
817060,True,0,No user reviews,0,0,0
817070,True,0,No user reviews,0,0,0
817080,True,0,No user reviews,0,0,0
817090,True,0,No user reviews,0,0,0
817100,True,0,No user reviews,0,0,0
817110,True,0,1 user reviews,0,1,1
817120,True,0,No user reviews,0,0,0
817130,True,5,Mixed,613,311,924
817150,True,0,2 user reviews,1,1,2
817160,True,0,1 user reviews,1,0,1
817170,True,0,No user reviews,0,0,0
817190,True,7,Positive,27,4,31
817200,True,0,7 user reviews,2,5,7
817220,True,0,5 user reviews,5,0,5
817230,True,8,Very Positive,71,8,79
817240,True,0,No user reviews,0,0,0
817250,True,0,1 user reviews,1,0,1
817260,True,0,1 user reviews,1,0,1
817270,True,0,1 user reviews,0,1,1
817300,True,0,No user reviews,0,0,0
817310,True,0,5 user reviews,0,5,5
817320,True,0,No user reviews,0,0,0
817360,True,0,No user reviews,0,0,0
817370,True,0,No user reviews,0,0,0
817390,True,0,6 user reviews,3,3,6
817410,True,0,No user reviews,0,0,0
817440,True,0,No user reviews,0,0,0
817450,True,0,No user reviews,0,0,0
817460,True,5,Mixed,9,5,14
817470,True,0,2 user reviews,2,0,2
817480,True,0,No user reviews,0,0,0
817490,True,7,Positive,12,0,12
817510,True,5,Mixed,149,85,234
817530,True,0,5 user reviews,4,1,5
817540,True,8,Very Positive,437,74,511
817550,True,6,Mostly Positive,126,37,163
817560,True,0,3 user reviews,2,1,3
817570,True,0,No user reviews,0,0,0
817600,True,0,No user reviews,0,0,0
817610,True,0,2 user reviews,1,1,2
817620,True,0,No user reviews,0,0,0
817630,True,0,2 user reviews,1,1,2
817640,True,0,4 user reviews,1,3,4
817660,True,0,7 user reviews,5,2,7
817670,True,0,No user reviews,0,0,0
817680,True,4,Mostly Negative,5,11,16
817710,True,0,2 user reviews,2,0,2
817720,True,5,Mixed,36,22,58
817730,True,0,No user reviews,0,0,0
817750,True,0,No user reviews,0,0,0
817760,True,0,2 user reviews,2,0,2
817770,True,5,Mixed,11,6,17
817800,True,0,No user reviews,0,0,0
817810,True,0,No user reviews,0,0,0
817820,True,0,3 user reviews,3,0,3
817840,True,8,Very Positive,459,41,500
817850,True,0,No user reviews,0,0,0
817860,True,7,Positive,40,0,40
817880,True,0,No user reviews,0,0,0
817890,True,0,No user reviews,0,0,0
817900,True,0,No user reviews,0,0,0
817901,True,0,No user reviews,0,0,0
817902,True,0,No user reviews,0,0,0
817910,True,0,No user reviews,0,0,0
817920,True,0,1 user reviews,1,0,1
817950,True,0,3 user reviews,1,2,3
817970,True,0,No user reviews,0,0,0
817980,True,0,3 user reviews,3,0,3
818000,True,0,No user reviews,0,0,0
818030,True,0,4 user reviews,1,3,4
818040,True,0,No user reviews,0,0,0
818050,True,7,Positive,19,0,19
818060,True,6,Mostly Positive,8,3,11
818070,True,0,No user reviews,0,0,0
818090,True,0,No user reviews,0,0,0
818110,True,0,No user reviews,0,0,0
818130,True,0,No user reviews,0,0,0
818140,True,0,5 user reviews,5,0,5
818150,True,7,Positive,13,2,15
818180,True,0,No user reviews,0,0,0
818190,True,0,No user reviews,0,0,0
818200,True,0,No user reviews,0,0,0
818210,True,8,Very Positive,118,25,143
818220,True,0,7 user reviews,3,4,7
818240,True,0,No user reviews,0,0,0
818270,True,0,2 user reviews,1,1,2
818280,True,0,No user reviews,0,0,0
818300,True,0,No user reviews,0,0,0
818320,True,8,Very Positive,147,30,177
818330,True,0,9 user reviews,3,6,9
818340,True,0,No user reviews,0,0,0
818350,True,0,2 user reviews,2,0,2
818360,True,0,1 user reviews,1,0,1
818370,True,0,No user reviews,0,0,0
818380,True,0,No user reviews,0,0,0
818390,True,0,7 user reviews,3,4,7
818400,True,0,8 user reviews,5,3,8
818410,True,7,Positive,13,0,13
818420,True,0,No user reviews,0,0,0
818430,True,0,2 user reviews,0,2,2
818440,True,5,Mixed,6,6,12
818480,True,0,7 user reviews,3,4,7
818500,True,7,Positive,34,2,36
818520,True,0,No user reviews,0,0,0
818530,True,7,Positive,12,3,15
818570,True,7,Positive,19,4,23
818580,True,0,No user reviews,0,0,0
818590,True,0,4 user reviews,1,3,4
818610,True,7,Positive,34,5,39
818620,True,0,2 user reviews,1,1,2
818640,True,0,1 user reviews,0,1,1
818650,True,0,5 user reviews,3,2,5
818670,True,0,3 user reviews,3,0,3
818690,True,0,No user reviews,0,0,0
818700,True,0,7 user reviews,6,1,7
818710,True,0,No user reviews,0,0,0
818720,True,0,No user reviews,0,0,0
818730,True,6,Mostly Positive,16,5,21
818760,True,7,Positive,11,0,11
818780,True,0,1 user reviews,0,1,1
818790,True,0,1 user reviews,1,0,1
818800,True,7,Positive,8,2,10
818810,True,0,No user reviews,0,0,0
818820,True,0,No user reviews,0,0,0
818830,True,0,2 user reviews,2,0,2
818860,True,0,6 user reviews,6,0,6
818870,True,0,No user reviews,0,0,0
818880,True,0,No user reviews,0,0,0
818890,True,0,No user reviews,0,0,0
818900,True,0,No user reviews,0,0,0
818920,True,0,No user reviews,0,0,0
818940,True,7,Positive,22,4,26
818950,True,0,7 user reviews,6,1,7
818960,True,7,Positive,13,2,15
818980,True,0,No user reviews,0,0,0
818981,True,0,1 user reviews,1,0,1
818982,True,0,No user reviews,0,0,0
818990,True,0,2 user reviews,1,1,2
819000,True,0,No user reviews,0,0,0
819020,True,6,Mostly Positive,172,48,220
819030,True,8,Very Positive,228,19,247
819040,True,7,Positive,19,0,19
819060,True,7,Positive,10,2,12
819070,True,0,3 user reviews,1,2,3
819080,True,0,2 user reviews,0,2,2
819090,True,0,No user reviews,0,0,0
819100,True,0,1 user reviews,1,0,1
819101,True,0,No user reviews,0,0,0
819102,True,0,No user reviews,0,0,0
819103,True,0,No user reviews,0,0,0
819104,True,0,No user reviews,0,0,0
819105,True,0,No user reviews,0,0,0
819110,True,0,No user reviews,0,0,0
819111,True,0,No user reviews,0,0,0
819112,True,0,No user reviews,0,0,0
819150,True,0,No user reviews,0,0,0
819160,True,0,2 user reviews,2,0,2
819170,True,0,No user reviews,0,0,0
819180,True,0,1 user reviews,0,1,1
819190,True,0,No user reviews,0,0,0
819200,True,0,No user reviews,0,0,0
819210,True,0,2 user reviews,0,2,2
819220,True,0,3 user reviews,3,0,3
819230,True,8,Very Positive,67,6,73
819240,True,0,1 user reviews,1,0,1
819260,True,0,No user reviews,0,0,0
819270,True,0,No user reviews,0,0,0
819280,True,0,5 user reviews,4,1,5
819290,True,0,No user reviews,0,0,0
819300,True,0,No user reviews,0,0,0
819310,True,0,No user reviews,0,0,0
819320,True,0,5 user reviews,4,1,5
819330,True,0,7 user reviews,7,0,7
819340,True,0,No user reviews,0,0,0
819350,True,0,No user reviews,0,0,0
819360,True,0,No user reviews,0,0,0
819370,True,0,No user reviews,0,0,0
819390,True,0,No user reviews,0,0,0
819400,True,5,Mixed,7,7,14
819410,True,0,9 user reviews,2,7,9
819420,True,0,No user reviews,0,0,0
819430,True,0,No user reviews,0,0,0
819440,True,0,No user reviews,0,0,0
819450,True,0,No user reviews,0,0,0
819460,True,0,No user reviews,0,0,0
819470,True,0,No user reviews,0,0,0
819480,True,7,Positive,22,2,24
819490,True,0,No user reviews,0,0,0
819500,True,5,Mixed,267,200,467
819510,True,7,Positive,10,1,11
819520,True,0,7 user reviews,6,1,7
819550,True,0,No user reviews,0,0,0
819560,True,0,6 user reviews,5,1,6
819580,True,0,No user reviews,0,0,0
819590,True,0,No user reviews,0,0,0
819610,True,0,No user reviews,0,0,0
819630,True,8,Very Positive,77,2,79
819640,True,0,2 user reviews,1,1,2
819650,True,5,Mixed,14,16,30
819660,True,0,1 user reviews,0,1,1
819670,True,0,2 user reviews,2,0,2
819730,True,0,No user reviews,0,0,0
819740,True,5,Mixed,10,5,15
819750,True,0,No user reviews,0,0,0
819760,True,0,No user reviews,0,0,0
819780,True,7,Positive,10,0,10
819790,True,0,No user reviews,0,0,0
819800,True,0,1 user reviews,1,0,1
819810,True,0,No user reviews,0,0,0
819820,True,0,No user reviews,0,0,0
819830,True,0,No user reviews,0,0,0
819840,True,0,No user reviews,0,0,0
819850,True,0,No user reviews,0,0,0
819860,True,0,1 user reviews,1,0,1
819870,True,0,1 user reviews,1,0,1
819880,True,0,1 user reviews,1,0,1
819940,True,0,1 user reviews,1,0,1
819950,True,0,No user reviews,0,0,0
819960,True,0,8 user reviews,7,1,8
819970,True,0,No user reviews,0,0,0
819980,True,0,3 user reviews,3,0,3
820010,True,0,No user reviews,0,0,0
820020,True,5,Mixed,46,29,75
820030,True,5,Mixed,37,16,53
820040,True,5,Mixed,10,6,16
820060,True,0,No user reviews,0,0,0
820070,True,0,4 user reviews,4,0,4
820090,True,0,No user reviews,0,0,0
820140,True,8,Very Positive,55,1,56
820150,True,0,1 user reviews,1,0,1
820151,True,0,2 user reviews,2,0,2
820152,True,0,No user reviews,0,0,0
820153,True,0,No user reviews,0,0,0
820170,True,0,2 user reviews,2,0,2
820180,True,0,2 user reviews,2,0,2
820190,True,0,No user reviews,0,0,0
820200,True,0,4 user reviews,2,2,4
820201,True,0,4 user reviews,4,0,4
820203,True,6,Mostly Positive,57,24,81
820210,True,0,8 user reviews,8,0,8
820220,True,0,No user reviews,0,0,0
820230,True,0,No user reviews,0,0,0
820231,True,0,1 user reviews,1,0,1
820232,True,0,1 user reviews,1,0,1
820240,True,5,Mixed,19,10,29
820250,True,0,8 user reviews,4,4,8
820270,True,0,No user reviews,0,0,0
820300,True,0,3 user reviews,3,0,3
820310,True,0,4 user reviews,1,3,4
820320,True,5,Mixed,9,6,15
820370,True,0,No user reviews,0,0,0
820380,True,5,Mixed,11,8,19
820400,True,0,No user reviews,0,0,0
820430,True,0,No user reviews,0,0,0
820440,True,0,No user reviews,0,0,0
820441,True,0,No user reviews,0,0,0
820442,True,7,Positive,32,4,36
820460,True,0,7 user reviews,5,2,7
820480,True,0,2 user reviews,2,0,2
820490,True,0,No user reviews,0,0,0
820500,True,0,No user reviews,0,0,0
820510,True,7,Positive,12,1,13
820520,True,0,No user reviews,0,0,0
820530,True,0,1 user reviews,1,0,1
820540,True,0,No user reviews,0,0,0
820570,True,0,No user reviews,0,0,0
820580,True,5,Mixed,7,8,15
820590,True,0,No user reviews,0,0,0
820600,True,7,Positive,17,0,17
820610,True,6,Mostly Positive,27,7,34
820620,True,6,Mostly Positive,16,6,22
820630,True,8,Very Positive,209,24,233
820640,True,0,5 user reviews,5,0,5
820660,True,0,2 user reviews,0,2,2
820680,True,0,2 user reviews,1,1,2
820690,True,0,No user reviews,0,0,0
820700,True,0,7 user reviews,5,2,7
820710,True,0,3 user reviews,2,1,3
820720,True,0,No user reviews,0,0,0
820730,True,8,Very Positive,77,4,81
820760,True,0,5 user reviews,3,2,5
820780,True,0,1 user reviews,1,0,1
820790,True,0,No user reviews,0,0,0
820820,True,0,No user reviews,0,0,0
820821,True,0,No user reviews,0,0,0
820830,True,0,2 user reviews,2,0,2
820840,True,0,7 user reviews,5,2,7
820860,True,0,No user reviews,0,0,0
820870,True,0,1 user reviews,1,0,1
820880,True,5,Mixed,11,7,18
820890,True,0,1 user reviews,1,0,1
820900,True,8,Very Positive,73,7,80
820910,True,7,Positive,39,3,42
820930,True,7,Positive,28,7,35
820940,True,0,1 user reviews,0,1,1
820950,True,0,9 user reviews,9,0,9
820980,True,0,No user reviews,0,0,0
820990,True,0,No user reviews,0,0,0
821020,True,0,No user reviews,0,0,0
821030,True,0,2 user reviews,1,1,2
821060,True,5,Mixed,58,33,91
821090,True,8,Very Positive,50,7,57
821100,True,0,4 user reviews,2,2,4
821120,True,0,8 user reviews,6,2,8
821170,True,0,5 user reviews,5,0,5
821180,True,0,3 user reviews,0,3,3
821190,True,0,4 user reviews,3,1,4
821210,True,0,No user reviews,0,0,0
821230,True,7,Positive,17,1,18
821250,True,6,Mostly Positive,442,119,561
821260,True,0,1 user reviews,0,1,1
821280,True,0,No user reviews,0,0,0
821290,True,0,No user reviews,0,0,0
821310,True,0,No user reviews,0,0,0
821320,True,8,Very Positive,70,6,76
821330,True,0,4 user reviews,2,2,4
821350,True,5,Mixed,79,57,136
821360,True,0,1 user reviews,1,0,1
821370,True,5,Mixed,8,5,13
821380,True,0,No user reviews,0,0,0
821390,True,5,Mixed,11,6,17
821400,True,0,2 user reviews,2,0,2
821410,True,0,5 user reviews,4,1,5
821430,True,0,No user reviews,0,0,0
821440,True,0,No user reviews,0,0,0
821450,True,0,2 user reviews,2,0,2
821470,True,0,No user reviews,0,0,0
821480,True,0,1 user reviews,0,1,1
821490,True,0,5 user reviews,5,0,5
821500,True,0,9 user reviews,8,1,9
821520,True,0,6 user reviews,4,2,6
821550,True,0,6 user reviews,4,2,6
821560,True,0,6 user reviews,6,0,6
821570,True,0,5 user reviews,5,0,5
821590,True,0,No user reviews,0,0,0
821600,True,0,No user reviews,0,0,0
821601,True,0,No user reviews,0,0,0
821610,True,0,No user reviews,0,0,0
821620,True,0,No user reviews,0,0,0
821630,True,0,1 user reviews,1,0,1
821640,True,7,Positive,30,2,32
821670,True,0,No user reviews,0,0,0
821680,True,0,No user reviews,0,0,0
821710,True,0,1 user reviews,1,0,1
821720,True,0,6 user reviews,5,1,6
821740,True,0,No user reviews,0,0,0
821750,True,0,No user reviews,0,0,0
821760,True,0,No user reviews,0,0,0
821770,True,0,No user reviews,0,0,0
821780,True,7,Positive,11,2,13
821790,True,6,Mostly Positive,26,7,33
821800,True,0,No user reviews,0,0,0
821820,True,0,No user reviews,0,0,0
821850,True,0,6 user reviews,1,5,6
821860,True,0,3 user reviews,1,2,3
821880,True,0,No user reviews,0,0,0
821890,True,8,Very Positive,296,37,333
821910,True,0,5 user reviews,0,5,5
821920,True,0,No user reviews,0,0,0
821940,True,6,Mostly Positive,58,23,81
821950,True,7,Positive,40,7,47
821970,True,0,No user reviews,0,0,0
821980,True,0,No user reviews,0,0,0
821990,True,0,No user reviews,0,0,0
822000,True,0,No user reviews,0,0,0
822010,True,0,5 user reviews,5,0,5
822030,True,0,No user reviews,0,0,0
822040,True,7,Positive,24,2,26
822060,True,0,No user reviews,0,0,0
822061,True,0,No user reviews,0,0,0
822070,True,0,1 user reviews,0,1,1
822080,True,0,9 user reviews,9,0,9
822090,True,0,No user reviews,0,0,0
822091,True,0,1 user reviews,0,1,1
822093,True,0,No user reviews,0,0,0
822094,True,7,Positive,16,1,17
822110,True,0,No user reviews,0,0,0
822130,True,0,6 user reviews,1,5,6
822140,True,0,2 user reviews,1,1,2
822150,True,0,3 user reviews,1,2,3
822170,True,0,No user reviews,0,0,0
822180,True,0,1 user reviews,1,0,1
822190,True,7,Positive,21,0,21
822210,True,0,No user reviews,0,0,0
822230,True,0,No user reviews,0,0,0
822240,True,0,No user reviews,0,0,0
822250,True,0,2 user reviews,1,1,2
822260,True,0,No user reviews,0,0,0
822270,True,0,No user reviews,0,0,0
822300,True,0,No user reviews,0,0,0
822310,True,0,No user reviews,0,0,0
822330,True,0,2 user reviews,1,1,2
822340,True,0,1 user reviews,1,0,1
822350,True,0,No user reviews,0,0,0
822380,True,0,4 user reviews,0,4,4
822400,True,0,1 user reviews,1,0,1
822410,True,0,No user reviews,0,0,0
822420,True,0,No user reviews,0,0,0
822421,True,0,No user reviews,0,0,0
822422,True,0,No user reviews,0,0,0
822440,True,0,3 user reviews,1,2,3
822450,True,0,5 user reviews,5,0,5
822460,True,0,5 user reviews,4,1,5
822470,True,0,No user reviews,0,0,0
822480,True,0,No user reviews,0,0,0
822510,True,0,7 user reviews,4,3,7
822530,True,0,5 user reviews,2,3,5
822540,True,6,Mostly Positive,37,13,50
822550,True,0,1 user reviews,1,0,1
822570,True,0,No user reviews,0,0,0
822610,True,0,No user reviews,0,0,0
822640,True,0,2 user reviews,2,0,2
822650,True,5,Mixed,15,16,31
822660,True,0,6 user reviews,6,0,6
822670,True,0,No user reviews,0,0,0
822680,True,0,6 user reviews,1,5,6
822690,True,0,No user reviews,0,0,0
822700,True,0,2 user reviews,2,0,2
822710,True,0,No user reviews,0,0,0
822720,True,0,4 user reviews,3,1,4
822730,True,0,No user reviews,0,0,0
822740,True,0,1 user reviews,1,0,1
822750,True,0,4 user reviews,3,1,4
822760,True,8,Very Positive,101,2,103
822770,True,0,6 user reviews,1,5,6
822780,True,0,No user reviews,0,0,0
822800,True,6,Mostly Positive,23,6,29
822810,True,0,2 user reviews,2,0,2
822820,True,0,No user reviews,0,0,0
822830,True,8,Very Positive,69,0,69
822840,True,0,1 user reviews,0,1,1
822860,True,0,1 user reviews,1,0,1
822870,True,0,No user reviews,0,0,0
822900,True,0,8 user reviews,6,2,8
822910,True,0,2 user reviews,1,1,2
822920,True,7,Positive,9,2,11
822930,True,8,Very Positive,417,14,431
822940,True,0,9 user reviews,9,0,9
822970,True,0,1 user reviews,1,0,1
822980,True,0,No user reviews,0,0,0
822990,True,6,Mostly Positive,147,40,187
823000,True,0,No user reviews,0,0,0
823010,True,0,No user reviews,0,0,0
823020,True,0,3 user reviews,3,0,3
823030,True,0,1 user reviews,1,0,1
823040,True,6,Mostly Positive,10,3,13
823080,True,0,No user reviews,0,0,0
823100,True,0,5 user reviews,3,2,5
823110,True,0,No user reviews,0,0,0
823120,True,0,No user reviews,0,0,0
823130,True,8,Very Positive,3258,729,3987
823140,True,0,No user reviews,0,0,0
823150,True,0,No user reviews,0,0,0
823160,True,0,No user reviews,0,0,0
823170,True,0,No user reviews,0,0,0
823180,True,0,1 user reviews,1,0,1
823190,True,0,No user reviews,0,0,0
823200,True,0,No user reviews,0,0,0
823210,True,0,No user reviews,0,0,0
823240,True,0,No user reviews,0,0,0
823250,True,0,No user reviews,0,0,0
823260,True,0,2 user reviews,2,0,2
823261,True,0,2 user reviews,2,0,2
823262,True,0,2 user reviews,2,0,2
823280,True,5,Mixed,6,5,11
823290,True,0,No user reviews,0,0,0
823300,True,0,No user reviews,0,0,0
823301,True,0,No user reviews,0,0,0
823310,True,0,2 user reviews,1,1,2
823320,True,0,No user reviews,0,0,0
823330,True,0,2 user reviews,1,1,2
823340,True,0,4 user reviews,3,1,4
823360,True,0,4 user reviews,3,1,4
823370,True,0,3 user reviews,3,0,3
823400,True,0,No user reviews,0,0,0
823420,True,0,No user reviews,0,0,0
823430,True,0,No user reviews,0,0,0
823460,True,0,No user reviews,0,0,0
823470,True,0,No user reviews,0,0,0
823500,True,8,Very Positive,11295,1247,12542
823510,True,0,1 user reviews,1,0,1
823520,True,0,No user reviews,0,0,0
823530,True,7,Positive,29,5,34
823550,True,0,No user reviews,0,0,0
823580,True,7,Positive,16,1,17
823590,True,0,No user reviews,0,0,0
823600,True,0,No user reviews,0,0,0
823610,True,6,Mostly Positive,54,19,73
823640,True,4,Mostly Negative,9,14,23
823650,True,0,2 user reviews,2,0,2
823660,True,0,No user reviews,0,0,0
823670,True,0,1 user reviews,0,1,1
823680,True,0,No user reviews,0,0,0
823690,True,0,2 user reviews,2,0,2
823700,True,5,Mixed,11,6,17
823710,True,0,8 user reviews,3,5,8
823720,True,0,No user reviews,0,0,0
823730,True,0,7 user reviews,5,2,7
823740,True,0,4 user reviews,1,3,4
823770,True,0,6 user reviews,1,5,6
823780,True,0,No user reviews,0,0,0
823800,True,0,4 user reviews,2,2,4
823810,True,0,6 user reviews,4,2,6
823820,True,0,No user reviews,0,0,0
823830,True,0,No user reviews,0,0,0
823840,True,7,Positive,40,1,41
823850,True,0,No user reviews,0,0,0
823860,True,0,No user reviews,0,0,0
823870,True,0,No user reviews,0,0,0
823900,True,0,No user reviews,0,0,0
823910,True,8,Very Positive,509,42,551
823920,True,0,5 user reviews,3,2,5
823930,True,0,1 user reviews,1,0,1
823940,True,6,Mostly Positive,197,76,273
823950,True,5,Mixed,394,244,638
823960,True,0,No user reviews,0,0,0
823970,True,0,No user reviews,0,0,0
823980,True,0,No user reviews,0,0,0
823981,True,0,No user reviews,0,0,0
823990,True,5,Mixed,43,37,80
824000,True,0,No user reviews,0,0,0
824010,True,0,No user reviews,0,0,0
824011,True,0,No user reviews,0,0,0
824020,True,0,No user reviews,0,0,0
824030,True,0,No user reviews,0,0,0
824040,True,0,No user reviews,0,0,0
824041,True,0,No user reviews,0,0,0
824050,True,0,No user reviews,0,0,0
824070,True,5,Mixed,211,175,386
824080,True,0,No user reviews,0,0,0
824090,True,0,No user reviews,0,0,0
824110,True,0,No user reviews,0,0,0
824140,True,0,No user reviews,0,0,0
824141,True,0,No user reviews,0,0,0
824142,True,0,No user reviews,0,0,0
824143,True,0,No user reviews,0,0,0
824144,True,0,No user reviews,0,0,0
824145,True,0,No user reviews,0,0,0
824146,True,0,No user reviews,0,0,0
824147,True,0,No user reviews,0,0,0
824148,True,0,No user reviews,0,0,0
824149,True,0,No user reviews,0,0,0
824150,True,0,No user reviews,0,0,0
824151,True,0,No user reviews,0,0,0
824160,True,0,No user reviews,0,0,0
824170,True,0,No user reviews,0,0,0
824180,True,0,No user reviews,0,0,0
824190,True,8,Very Positive,133,24,157
824200,True,7,Positive,8,2,10
824220,True,0,No user reviews,0,0,0
824230,True,0,3 user reviews,2,1,3
824240,True,0,No user reviews,0,0,0
824250,True,0,3 user reviews,3,0,3
824260,True,0,No user reviews,0,0,0
824270,True,8,Very Positive,7450,678,8128
824280,True,6,Mostly Positive,86,36,122
824300,True,0,No user reviews,0,0,0
824320,True,0,No user reviews,0,0,0
824330,True,0,No user reviews,0,0,0
824350,True,0,No user reviews,0,0,0
824360,True,0,No user reviews,0,0,0
824380,True,0,2 user reviews,2,0,2
824381,True,0,2 user reviews,2,0,2
824382,True,0,2 user reviews,2,0,2
824400,True,0,No user reviews,0,0,0
824420,True,0,No user reviews,0,0,0
824430,True,0,No user reviews,0,0,0
824440,True,0,No user reviews,0,0,0
824450,True,5,Mixed,10,5,15
824460,True,7,Positive,15,0,15
824470,True,0,6 user reviews,4,2,6
824480,True,0,No user reviews,0,0,0
824500,True,0,No user reviews,0,0,0
824520,True,0,No user reviews,0,0,0
824540,True,0,No user reviews,0,0,0
824570,True,7,Positive,13,0,13
824580,True,0,4 user reviews,2,2,4
824590,True,0,No user reviews,0,0,0
824600,True,0,No user reviews,0,0,0
824610,True,7,Positive,18,3,21
824620,True,0,9 user reviews,9,0,9
824640,True,0,2 user reviews,2,0,2
824720,True,8,Very Positive,424,59,483
824760,True,7,Positive,12,2,14
824770,True,0,1 user reviews,1,0,1
824810,True,0,No user reviews,0,0,0
824820,True,0,No user reviews,0,0,0
824830,True,8,Very Positive,72,11,83
824840,True,0,No user reviews,0,0,0
824850,True,7,Positive,44,4,48
824860,True,0,No user reviews,0,0,0
824880,True,0,No user reviews,0,0,0
824890,True,0,No user reviews,0,0,0
824900,True,0,No user reviews,0,0,0
824910,True,0,No user reviews,0,0,0
824920,True,0,No user reviews,0,0,0
824940,True,0,No user reviews,0,0,0
824950,True,0,No user reviews,0,0,0
824960,True,0,No user reviews,0,0,0
824970,True,0,No user reviews,0,0,0
824980,True,0,No user reviews,0,0,0
824990,True,0,No user reviews,0,0,0
825000,True,0,3 user reviews,1,2,3
825010,True,0,No user reviews,0,0,0
825020,True,0,1 user reviews,1,0,1
825030,True,0,No user reviews,0,0,0
825040,True,0,1 user reviews,1,0,1
825060,True,0,No user reviews,0,0,0
825090,True,0,2 user reviews,1,1,2
825100,True,0,No user reviews,0,0,0
825110,True,0,No user reviews,0,0,0
825170,True,0,No user reviews,0,0,0
825180,True,0,No user reviews,0,0,0
825210,True,0,No user reviews,0,0,0
825220,True,0,No user reviews,0,0,0
825221,True,0,No user reviews,0,0,0
825240,True,0,7 user reviews,7,0,7
825260,True,0,No user reviews,0,0,0
825270,True,0,No user reviews,0,0,0
825271,True,0,No user reviews,0,0,0
825272,True,0,No user reviews,0,0,0
825273,True,0,No user reviews,0,0,0
825274,True,0,No user reviews,0,0,0
825275,True,0,No user reviews,0,0,0
825276,True,0,No user reviews,0,0,0
825277,True,0,No user reviews,0,0,0
825278,True,0,No user reviews,0,0,0
825279,True,0,No user reviews,0,0,0
825280,True,0,No user reviews,0,0,0
825300,True,8,Very Positive,59,10,69
825310,True,5,Mixed,132,183,315
825320,True,0,4 user reviews,4,0,4
825350,True,0,2 user reviews,1,1,2
825370,True,6,Mostly Positive,8,3,11
825380,True,0,No user reviews,0,0,0
825400,True,0,5 user reviews,5,0,5
825420,True,0,No user reviews,0,0,0
825430,True,0,No user reviews,0,0,0
825450,True,0,No user reviews,0,0,0
825470,True,0,2 user reviews,2,0,2
825480,True,0,3 user reviews,3,0,3
825490,True,0,1 user reviews,0,1,1
825500,True,5,Mixed,5,5,10
825550,True,5,Mixed,20,15,35
825570,True,8,Very Positive,134,9,143
825580,True,0,No user reviews,0,0,0
825590,True,0,1 user reviews,1,0,1
825610,True,0,No user reviews,0,0,0
825620,True,0,2 user reviews,1,1,2
825630,True,9,Overwhelmingly Positive,641,29,670
825640,True,0,No user reviews,0,0,0
825650,True,0,1 user reviews,0,1,1
825660,True,0,1 user reviews,0,1,1
825670,True,0,No user reviews,0,0,0
825680,True,0,2 user reviews,0,2,2
825690,True,0,No user reviews,0,0,0
825700,True,0,1 user reviews,1,0,1
825710,True,0,2 user reviews,1,1,2
825730,True,8,Very Positive,66,7,73
825930,True,6,Mostly Positive,10,4,14
825970,True,0,7 user reviews,4,3,7
826000,True,5,Mixed,13,11,24
826010,True,6,Mostly Positive,14,6,20
826020,True,0,No user reviews,0,0,0
826030,True,0,5 user reviews,3,2,5
826040,True,0,4 user reviews,3,1,4
826050,True,0,1 user reviews,1,0,1
826080,True,0,6 user reviews,5,1,6
826081,True,0,No user reviews,0,0,0
826082,True,0,No user reviews,0,0,0
826083,True,0,3 user reviews,2,1,3
826084,True,0,1 user reviews,0,1,1
826085,True,0,1 user reviews,1,0,1
826086,True,0,1 user reviews,1,0,1
826087,True,0,2 user reviews,1,1,2
826088,True,0,No user reviews,0,0,0
826090,True,0,No user reviews,0,0,0
826100,True,0,No user reviews,0,0,0
826110,True,0,No user reviews,0,0,0
826111,True,0,No user reviews,0,0,0
826112,True,0,No user reviews,0,0,0
826113,True,0,No user reviews,0,0,0
826114,True,0,No user reviews,0,0,0
826115,True,0,No user reviews,0,0,0
826116,True,0,No user reviews,0,0,0
826117,True,0,No user reviews,0,0,0
826118,True,0,No user reviews,0,0,0
826119,True,0,No user reviews,0,0,0
826120,True,0,No user reviews,0,0,0
826121,True,0,No user reviews,0,0,0
826140,True,0,No user reviews,0,0,0
826141,True,0,No user reviews,0,0,0
826142,True,0,No user reviews,0,0,0
826143,True,0,No user reviews,0,0,0
826144,True,0,No user reviews,0,0,0
826145,True,0,No user reviews,0,0,0
826146,True,0,No user reviews,0,0,0
826147,True,0,No user reviews,0,0,0
826148,True,0,No user reviews,0,0,0
826149,True,0,No user reviews,0,0,0
826150,True,0,No user reviews,0,0,0
826151,True,0,No user reviews,0,0,0
826160,True,5,Mixed,11,9,20
826170,True,0,2 user reviews,2,0,2
826180,True,6,Mostly Positive,13,4,17
826190,True,0,No user reviews,0,0,0
826200,True,0,No user reviews,0,0,0
826210,True,0,No user reviews,0,0,0
826220,True,0,No user reviews,0,0,0
826230,True,0,No user reviews,0,0,0
826240,True,0,No user reviews,0,0,0
826241,True,0,No user reviews,0,0,0
826242,True,0,No user reviews,0,0,0
826243,True,0,No user reviews,0,0,0
826244,True,0,No user reviews,0,0,0
826245,True,0,No user reviews,0,0,0
826246,True,0,No user reviews,0,0,0
826247,True,0,No user reviews,0,0,0
826248,True,0,No user reviews,0,0,0
826249,True,0,No user reviews,0,0,0
826250,True,0,No user reviews,0,0,0
826251,True,0,No user reviews,0,0,0
826260,True,0,No user reviews,0,0,0
826290,True,0,6 user reviews,6,0,6
826300,True,0,No user reviews,0,0,0
826330,True,0,No user reviews,0,0,0
826331,True,0,No user reviews,0,0,0
826332,True,0,No user reviews,0,0,0
826333,True,0,No user reviews,0,0,0
826334,True,0,No user reviews,0,0,0
826335,True,0,No user reviews,0,0,0
826336,True,0,No user reviews,0,0,0
826337,True,0,No user reviews,0,0,0
826338,True,0,No user reviews,0,0,0
826339,True,0,No user reviews,0,0,0
826340,True,0,No user reviews,0,0,0
826341,True,0,No user reviews,0,0,0
826360,True,0,No user reviews,0,0,0
826370,True,0,1 user reviews,1,0,1
826380,True,0,1 user reviews,1,0,1
826390,True,0,1 user reviews,1,0,1
826420,True,0,8 user reviews,7,1,8
826430,True,0,2 user reviews,1,1,2
826440,True,0,1 user reviews,1,0,1
826450,True,0,5 user reviews,4,1,5
826460,True,5,Mixed,5,7,12
826470,True,0,No user reviews,0,0,0
826480,True,0,No user reviews,0,0,0
826490,True,0,1 user reviews,1,0,1
826491,True,0,1 user reviews,1,0,1
826492,True,0,1 user reviews,1,0,1
826493,True,0,1 user reviews,1,0,1
826494,True,0,1 user reviews,1,0,1
826495,True,0,1 user reviews,1,0,1
826496,True,0,1 user reviews,1,0,1
826497,True,0,1 user reviews,1,0,1
826498,True,0,1 user reviews,1,0,1
826499,True,0,1 user reviews,1,0,1
826500,True,0,1 user reviews,1,0,1
826501,True,0,1 user reviews,1,0,1
826502,True,0,1 user reviews,1,0,1
826503,True,0,1 user reviews,1,0,1
826504,True,0,1 user reviews,1,0,1
826505,True,0,1 user reviews,1,0,1
826506,True,0,1 user reviews,1,0,1
826507,True,0,1 user reviews,1,0,1
826510,True,0,No user reviews,0,0,0
826520,True,0,No user reviews,0,0,0
826530,True,0,No user reviews,0,0,0
826540,True,8,Very Positive,67,7,74
826550,True,0,No user reviews,0,0,0
826580,True,0,1 user reviews,0,1,1
826590,True,0,No user reviews,0,0,0
826600,True,6,Mostly Positive,85,28,113
826610,True,0,No user reviews,0,0,0
826620,True,0,1 user reviews,1,0,1
826630,True,6,Mostly Positive,920,347,1267
826640,True,0,No user reviews,0,0,0
826650,True,7,Positive,13,1,14
826660,True,0,7 user reviews,5,2,7
826740,True,7,Positive,30,6,36
826810,True,0,No user reviews,0,0,0
826930,True,0,4 user reviews,3,1,4
826940,True,8,Very Positive,101,24,125
827000,True,7,Positive,17,4,21
827050,True,6,Mostly Positive,26,7,33
827100,True,0,8 user reviews,4,4,8
827110,True,0,6 user reviews,2,4,6
827120,True,0,7 user reviews,3,4,7
827130,True,0,4 user reviews,2,2,4
827170,True,0,No user reviews,0,0,0
827200,True,0,No user reviews,0,0,0
827210,True,0,No user reviews,0,0,0
827220,True,0,No user reviews,0,0,0
827240,True,4,Mostly Negative,120,188,308
827250,True,7,Positive,8,2,10
827270,True,0,1 user reviews,1,0,1
827280,True,0,3 user reviews,2,1,3
827290,True,8,Very Positive,158,4,162
827320,True,0,No user reviews,0,0,0
827340,True,0,No user reviews,0,0,0
827350,True,0,No user reviews,0,0,0
827360,True,0,No user reviews,0,0,0
827380,True,6,Mostly Positive,10,3,13
827390,True,0,No user reviews,0,0,0
827391,True,0,No user reviews,0,0,0
827392,True,0,No user reviews,0,0,0
827393,True,0,No user reviews,0,0,0
827394,True,0,No user reviews,0,0,0
827395,True,0,No user reviews,0,0,0
827396,True,0,No user reviews,0,0,0
827397,True,0,No user reviews,0,0,0
827398,True,0,No user reviews,0,0,0
827399,True,0,No user reviews,0,0,0
827400,True,0,No user reviews,0,0,0
827401,True,0,No user reviews,0,0,0
827410,True,0,1 user reviews,0,1,1
827420,True,5,Mixed,9,6,15
827430,True,0,No user reviews,0,0,0
827431,True,0,No user reviews,0,0,0
827432,True,0,No user reviews,0,0,0
827433,True,0,No user reviews,0,0,0
827434,True,0,No user reviews,0,0,0
827435,True,0,No user reviews,0,0,0
827436,True,0,No user reviews,0,0,0
827437,True,0,No user reviews,0,0,0
827438,True,0,No user reviews,0,0,0
827439,True,0,No user reviews,0,0,0
827440,True,0,No user reviews,0,0,0
827450,True,0,2 user reviews,1,1,2
827460,True,0,7 user reviews,7,0,7
827490,True,0,No user reviews,0,0,0
827491,True,0,No user reviews,0,0,0
827492,True,0,No user reviews,0,0,0
827493,True,0,No user reviews,0,0,0
827494,True,0,No user reviews,0,0,0
827495,True,0,No user reviews,0,0,0
827496,True,0,No user reviews,0,0,0
827497,True,0,No user reviews,0,0,0
827498,True,0,No user reviews,0,0,0
827499,True,0,No user reviews,0,0,0
827500,True,0,No user reviews,0,0,0
827501,True,0,No user reviews,0,0,0
827502,True,0,No user reviews,0,0,0
827520,True,0,3 user reviews,3,0,3
827530,True,0,7 user reviews,4,3,7
827540,True,0,No user reviews,0,0,0
827560,True,0,No user reviews,0,0,0
827580,True,0,No user reviews,0,0,0
827590,True,0,3 user reviews,3,0,3
827600,True,0,No user reviews,0,0,0
827610,True,0,7 user reviews,6,1,7
827640,True,6,Mostly Positive,32,10,42
827690,True,0,No user reviews,0,0,0
827700,True,0,1 user reviews,0,1,1
827710,True,0,1 user reviews,1,0,1
827720,True,0,2 user reviews,0,2,2
827730,True,0,7 user reviews,7,0,7
827770,True,0,2 user reviews,0,2,2
827780,True,0,1 user reviews,0,1,1
827810,True,0,1 user reviews,1,0,1
827820,True,0,1 user reviews,1,0,1
827830,True,0,9 user reviews,8,1,9
827860,True,0,No user reviews,0,0,0
827880,True,0,4 user reviews,4,0,4
827900,True,0,No user reviews,0,0,0
827920,True,0,5 user reviews,4,1,5
827930,True,0,No user reviews,0,0,0
827940,True,7,Positive,9,2,11
827950,True,0,1 user reviews,1,0,1
827960,True,0,No user reviews,0,0,0
827961,True,0,No user reviews,0,0,0
827962,True,0,No user reviews,0,0,0
827963,True,0,No user reviews,0,0,0
827964,True,0,No user reviews,0,0,0
827965,True,0,No user reviews,0,0,0
827966,True,0,No user reviews,0,0,0
827967,True,0,No user reviews,0,0,0
827968,True,0,No user reviews,0,0,0
827969,True,0,No user reviews,0,0,0
827970,True,0,No user reviews,0,0,0
827971,True,0,No user reviews,0,0,0
827990,True,0,No user reviews,0,0,0
828020,True,0,No user reviews,0,0,0
828030,True,0,No user reviews,0,0,0
828040,True,0,No user reviews,0,0,0
828050,True,0,No user reviews,0,0,0
828070,True,8,Very Positive,147,17,164
828080,True,0,No user reviews,0,0,0
828090,True,0,2 user reviews,1,1,2
828100,True,0,No user reviews,0,0,0
828130,True,0,No user reviews,0,0,0
828150,True,6,Mostly Positive,21,7,28
828160,True,0,4 user reviews,2,2,4
828170,True,0,No user reviews,0,0,0
828180,True,0,No user reviews,0,0,0
828200,True,0,No user reviews,0,0,0
828220,True,0,No user reviews,0,0,0
828230,True,0,No user reviews,0,0,0
828240,True,7,Positive,15,1,16
828250,True,0,No user reviews,0,0,0
828260,True,0,No user reviews,0,0,0
828270,True,0,2 user reviews,2,0,2
828300,True,0,1 user reviews,1,0,1
828310,True,0,No user reviews,0,0,0
828320,True,7,Positive,8,2,10
828350,True,0,3 user reviews,3,0,3
828360,True,0,3 user reviews,2,1,3
828370,True,0,No user reviews,0,0,0
828380,True,0,No user reviews,0,0,0
828390,True,0,No user reviews,0,0,0
828410,True,0,4 user reviews,2,2,4
828420,True,0,1 user reviews,1,0,1
828430,True,0,No user reviews,0,0,0
828440,True,0,3 user reviews,1,2,3
828450,True,0,No user reviews,0,0,0
828460,True,0,2 user reviews,1,1,2
828470,True,0,No user reviews,0,0,0
828480,True,0,4 user reviews,2,2,4
828490,True,0,1 user reviews,1,0,1
828500,True,0,2 user reviews,2,0,2
828520,True,0,2 user reviews,2,0,2
828540,True,0,1 user reviews,1,0,1
828550,True,5,Mixed,8,4,12
828560,True,0,No user reviews,0,0,0
828580,True,7,Positive,42,5,47
828590,True,7,Positive,11,1,12
828600,True,0,1 user reviews,1,0,1
828610,True,0,No user reviews,0,0,0
828611,True,0,No user reviews,0,0,0
828612,True,0,No user reviews,0,0,0
828613,True,0,No user reviews,0,0,0
828614,True,0,No user reviews,0,0,0
828615,True,0,No user reviews,0,0,0
828616,True,0,No user reviews,0,0,0
828620,True,0,No user reviews,0,0,0
828621,True,0,No user reviews,0,0,0
828622,True,0,No user reviews,0,0,0
828623,True,0,No user reviews,0,0,0
828624,True,0,No user reviews,0,0,0
828625,True,0,No user reviews,0,0,0
828626,True,0,1 user reviews,1,0,1
828630,True,0,No user reviews,0,0,0
828631,True,0,No user reviews,0,0,0
828632,True,0,No user reviews,0,0,0
828640,True,7,Positive,19,4,23
828660,True,6,Mostly Positive,26,7,33
828680,True,7,Positive,11,0,11
828690,True,0,No user reviews,0,0,0
828710,True,0,No user reviews,0,0,0
828730,True,0,2 user reviews,0,2,2
828740,True,6,Mostly Positive,107,27,134
828760,True,0,No user reviews,0,0,0
828770,True,0,3 user reviews,2,1,3
828790,True,5,Mixed,200,206,406
828800,True,0,9 user reviews,6,3,9
828830,True,0,1 user reviews,0,1,1
828860,True,0,3 user reviews,3,0,3
828880,True,0,No user reviews,0,0,0
828890,True,5,Mixed,13,8,21
828900,True,6,Mostly Positive,123,43,166
828910,True,5,Mixed,6,5,11
828920,True,0,No user reviews,0,0,0
828940,True,0,No user reviews,0,0,0
828950,True,6,Mostly Positive,12,4,16
828960,True,5,Mixed,14,14,28
828970,True,0,2 user reviews,0,2,2
829000,True,0,No user reviews,0,0,0
829020,True,0,No user reviews,0,0,0
829021,True,0,No user reviews,0,0,0
829022,True,0,No user reviews,0,0,0
829023,True,0,No user reviews,0,0,0
829024,True,0,No user reviews,0,0,0
829025,True,0,No user reviews,0,0,0
829026,True,0,No user reviews,0,0,0
829027,True,0,No user reviews,0,0,0
829028,True,0,No user reviews,0,0,0
829029,True,0,No user reviews,0,0,0
829030,True,0,No user reviews,0,0,0
829031,True,0,No user reviews,0,0,0
829032,True,0,No user reviews,0,0,0
829033,True,0,No user reviews,0,0,0
829034,True,0,No user reviews,0,0,0
829035,True,0,No user reviews,0,0,0
829036,True,0,No user reviews,0,0,0
829037,True,0,No user reviews,0,0,0
829038,True,0,No user reviews,0,0,0
829039,True,0,No user reviews,0,0,0
829040,True,0,3 user reviews,3,0,3
829060,True,0,No user reviews,0,0,0
829070,True,0,No user reviews,0,0,0
829071,True,0,No user reviews,0,0,0
829072,True,0,No user reviews,0,0,0
829073,True,0,No user reviews,0,0,0
829074,True,0,No user reviews,0,0,0
829075,True,0,No user reviews,0,0,0
829076,True,0,No user reviews,0,0,0
829077,True,0,No user reviews,0,0,0
829078,True,0,No user reviews,0,0,0
829079,True,0,No user reviews,0,0,0
829080,True,0,8 user reviews,7,1,8
829090,True,0,No user reviews,0,0,0
829100,True,0,No user reviews,0,0,0
829101,True,0,No user reviews,0,0,0
829102,True,0,No user reviews,0,0,0
829103,True,0,No user reviews,0,0,0
829110,True,8,Very Positive,484,66,550
829120,True,0,No user reviews,0,0,0
829130,True,0,No user reviews,0,0,0
829200,True,0,2 user reviews,2,0,2
829210,True,7,Positive,9,2,11
829230,True,0,No user reviews,0,0,0
829250,True,4,Mostly Negative,7,11,18
829260,True,7,Positive,15,2,17
829270,True,0,No user reviews,0,0,0
829280,True,0,No user reviews,0,0,0
829300,True,0,5 user reviews,4,1,5
829350,True,0,1 user reviews,1,0,1
829351,True,0,No user reviews,0,0,0
829352,True,0,No user reviews,0,0,0
829353,True,0,No user reviews,0,0,0
829354,True,0,No user reviews,0,0,0
829355,True,0,No user reviews,0,0,0
829356,True,0,No user reviews,0,0,0
829357,True,0,No user reviews,0,0,0
829358,True,0,No user reviews,0,0,0
829359,True,0,No user reviews,0,0,0
829360,True,0,No user reviews,0,0,0
829370,True,0,5 user reviews,4,1,5
829390,True,5,Mixed,7,4,11
829410,True,0,4 user reviews,2,2,4
829420,True,0,No user reviews,0,0,0
829430,True,0,No user reviews,0,0,0
829440,True,0,No user reviews,0,0,0
829441,True,0,No user reviews,0,0,0
829442,True,0,No user reviews,0,0,0
829443,True,0,No user reviews,0,0,0
829444,True,0,No user reviews,0,0,0
829445,True,0,No user reviews,0,0,0
829446,True,0,No user reviews,0,0,0
829447,True,0,No user reviews,0,0,0
829448,True,0,No user reviews,0,0,0
829449,True,0,No user reviews,0,0,0
829450,True,0,No user reviews,0,0,0
829460,True,0,No user reviews,0,0,0
829490,True,0,2 user reviews,2,0,2
829500,True,0,No user reviews,0,0,0
829501,True,0,No user reviews,0,0,0
829502,True,0,No user reviews,0,0,0
829503,True,0,No user reviews,0,0,0
829504,True,0,No user reviews,0,0,0
829510,True,0,No user reviews,0,0,0
829540,True,7,Positive,14,0,14
829550,True,0,1 user reviews,1,0,1
829560,True,7,Positive,15,2,17
829580,True,0,No user reviews,0,0,0
829581,True,0,No user reviews,0,0,0
829590,True,6,Mostly Positive,401,119,520
829610,True,0,2 user reviews,1,1,2
829620,True,0,No user reviews,0,0,0
829630,True,0,3 user reviews,1,2,3
829660,True,8,Very Positive,202,15,217
829690,True,0,No user reviews,0,0,0
829700,True,0,No user reviews,0,0,0
829710,True,0,No user reviews,0,0,0
829720,True,0,4 user reviews,3,1,4
829730,True,0,No user reviews,0,0,0
829731,True,0,1 user reviews,0,1,1
829732,True,0,No user reviews,0,0,0
829733,True,0,No user reviews,0,0,0
829734,True,0,No user reviews,0,0,0
829735,True,0,No user reviews,0,0,0
829736,True,0,1 user reviews,1,0,1
829737,True,0,No user reviews,0,0,0
829750,True,0,1 user reviews,1,0,1
829760,True,0,1 user reviews,1,0,1
829780,True,5,Mixed,6,6,12
829940,True,0,9 user reviews,9,0,9
829960,True,7,Positive,13,3,16
829990,True,0,No user reviews,0,0,0
829991,True,0,No user reviews,0,0,0
829992,True,0,No user reviews,0,0,0
829993,True,0,No user reviews,0,0,0
829994,True,0,No user reviews,0,0,0
829995,True,0,No user reviews,0,0,0
829996,True,0,No user reviews,0,0,0
829997,True,0,No user reviews,0,0,0
829998,True,0,No user reviews,0,0,0
829999,True,0,No user reviews,0,0,0
830000,True,0,No user reviews,0,0,0
830001,True,0,No user reviews,0,0,0
830002,True,0,No user reviews,0,0,0
830003,True,0,No user reviews,0,0,0
830004,True,0,No user reviews,0,0,0
830005,True,0,No user reviews,0,0,0
830010,True,0,No user reviews,0,0,0
830360,True,0,2 user reviews,1,1,2
830370,True,8,Very Positive,147,18,165
830380,True,0,4 user reviews,1,3,4
830390,True,0,No user reviews,0,0,0
830400,True,6,Mostly Positive,12,5,17
830410,True,0,1 user reviews,1,0,1
830420,True,0,No user reviews,0,0,0
830430,True,0,2 user reviews,0,2,2
830440,True,0,No user reviews,0,0,0
830450,True,8,Very Positive,68,7,75
830451,True,6,Mostly Positive,19,7,26
830460,True,7,Positive,28,5,33
830461,True,6,Mostly Positive,31,10,41
830470,True,0,No user reviews,0,0,0
830480,True,0,No user reviews,0,0,0
830481,True,0,No user reviews,0,0,0
830482,True,0,No user reviews,0,0,0
830483,True,0,No user reviews,0,0,0
830484,True,0,No user reviews,0,0,0
830485,True,0,No user reviews,0,0,0
830486,True,0,No user reviews,0,0,0
830487,True,0,No user reviews,0,0,0
830488,True,0,No user reviews,0,0,0
830490,True,5,Mixed,5,5,10
830500,True,0,1 user reviews,1,0,1
830510,True,0,No user reviews,0,0,0
830520,True,0,3 user reviews,3,0,3
830530,True,0,4 user reviews,3,1,4
830540,True,0,No user reviews,0,0,0
830550,True,0,No user reviews,0,0,0
830560,True,0,No user reviews,0,0,0
830570,True,0,No user reviews,0,0,0
830580,True,0,No user reviews,0,0,0
830590,True,6,Mostly Positive,29,10,39
830620,True,0,3 user reviews,3,0,3
830630,True,5,Mixed,9,6,15
830640,True,6,Mostly Positive,27,8,35
830650,True,0,No user reviews,0,0,0
830660,True,0,No user reviews,0,0,0
830710,True,7,Positive,18,4,22
830720,True,0,3 user reviews,3,0,3
830740,True,0,No user reviews,0,0,0
830750,True,0,3 user reviews,2,1,3
830810,True,0,1 user reviews,0,1,1
830820,True,8,Very Positive,367,17,384
830840,True,0,No user reviews,0,0,0
830850,True,0,6 user reviews,6,0,6
830890,True,0,1 user reviews,0,1,1
830910,True,0,No user reviews,0,0,0
830920,True,0,No user reviews,0,0,0
830930,True,0,No user reviews,0,0,0
830940,True,0,No user reviews,0,0,0
830950,True,0,No user reviews,0,0,0
830980,True,5,Mixed,88,41,129
830990,True,0,No user reviews,0,0,0
830991,True,0,No user reviews,0,0,0
830992,True,0,No user reviews,0,0,0
830993,True,0,No user reviews,0,0,0
830994,True,0,No user reviews,0,0,0
830995,True,0,No user reviews,0,0,0
830996,True,0,No user reviews,0,0,0
830997,True,0,No user reviews,0,0,0
830998,True,0,No user reviews,0,0,0
830999,True,0,No user reviews,0,0,0
831000,True,0,No user reviews,0,0,0
831001,True,0,No user reviews,0,0,0
831002,True,0,No user reviews,0,0,0
831040,True,0,No user reviews,0,0,0
831050,True,0,No user reviews,0,0,0
831060,True,0,4 user reviews,1,3,4
831070,True,7,Positive,20,2,22
831090,True,7,Positive,18,2,20
831100,True,0,No user reviews,0,0,0
831110,True,0,No user reviews,0,0,0
831120,True,7,Positive,23,2,25
831150,True,0,2 user reviews,2,0,2
831160,True,0,5 user reviews,5,0,5
831161,True,0,4 user reviews,2,2,4
831162,True,0,5 user reviews,5,0,5
831170,True,0,No user reviews,0,0,0
831210,True,0,No user reviews,0,0,0
831211,True,0,No user reviews,0,0,0
831212,True,0,No user reviews,0,0,0
831213,True,0,No user reviews,0,0,0
831214,True,0,No user reviews,0,0,0
831215,True,0,No user reviews,0,0,0
831216,True,0,No user reviews,0,0,0
831217,True,0,No user reviews,0,0,0
831218,True,0,No user reviews,0,0,0
831219,True,0,No user reviews,0,0,0
831220,True,0,No user reviews,0,0,0
831221,True,0,No user reviews,0,0,0
831222,True,0,No user reviews,0,0,0
831223,True,0,No user reviews,0,0,0
831224,True,0,No user reviews,0,0,0
831225,True,0,No user reviews,0,0,0
831226,True,0,No user reviews,0,0,0
831227,True,0,No user reviews,0,0,0
831228,True,0,No user reviews,0,0,0
831230,True,0,No user reviews,0,0,0
831250,True,0,4 user reviews,2,2,4
831260,True,0,3 user reviews,3,0,3
831310,True,0,No user reviews,0,0,0
831311,True,0,No user reviews,0,0,0
831312,True,0,3 user reviews,3,0,3
831350,True,0,1 user reviews,0,1,1
831390,True,0,No user reviews,0,0,0
831450,True,0,No user reviews,0,0,0
831460,True,0,1 user reviews,1,0,1
831470,True,5,Mixed,8,5,13
831490,True,0,No user reviews,0,0,0
831510,True,0,2 user reviews,1,1,2
831520,True,0,8 user reviews,2,6,8
831530,True,7,Positive,28,3,31
831540,True,0,1 user reviews,0,1,1
831550,True,0,No user reviews,0,0,0
831560,True,8,Very Positive,404,72,476
831570,True,7,Positive,21,0,21
831590,True,0,No user reviews,0,0,0
831640,True,0,No user reviews,0,0,0
831650,True,0,1 user reviews,1,0,1
831660,True,0,2 user reviews,2,0,2
831670,True,0,8 user reviews,5,3,8
831680,True,0,3 user reviews,3,0,3
831690,True,0,2 user reviews,0,2,2
831700,True,0,6 user reviews,1,5,6
831710,True,5,Mixed,5,6,11
831720,True,7,Positive,19,1,20
831740,True,0,No user reviews,0,0,0
831760,True,0,No user reviews,0,0,0
831770,True,5,Mixed,7,4,11
831790,True,0,2 user reviews,1,1,2
831810,True,0,No user reviews,0,0,0
831830,True,0,No user reviews,0,0,0
831840,True,8,Very Positive,54,5,59
831890,True,0,No user reviews,0,0,0
831900,True,0,No user reviews,0,0,0
831910,True,0,1 user reviews,0,1,1
831920,True,0,No user reviews,0,0,0
831950,True,0,6 user reviews,3,3,6
831960,True,0,No user reviews,0,0,0
831961,True,0,No user reviews,0,0,0
831962,True,0,No user reviews,0,0,0
831963,True,0,No user reviews,0,0,0
831964,True,0,No user reviews,0,0,0
831965,True,0,No user reviews,0,0,0
831966,True,0,No user reviews,0,0,0
831967,True,0,No user reviews,0,0,0
831968,True,0,No user reviews,0,0,0
831969,True,0,No user reviews,0,0,0
831970,True,0,No user reviews,0,0,0
831971,True,0,No user reviews,0,0,0
831972,True,0,No user reviews,0,0,0
831973,True,0,No user reviews,0,0,0
831974,True,0,No user reviews,0,0,0
831980,True,8,Very Positive,745,55,800
832010,True,0,No user reviews,0,0,0
832020,True,0,No user reviews,0,0,0
832060,True,0,No user reviews,0,0,0
832080,True,0,No user reviews,0,0,0
832090,True,0,No user reviews,0,0,0
832100,True,0,No user reviews,0,0,0
832130,True,0,6 user reviews,5,1,6
832140,True,0,5 user reviews,5,0,5
832220,True,0,No user reviews,0,0,0
832221,True,0,No user reviews,0,0,0
832222,True,0,No user reviews,0,0,0
832310,True,0,No user reviews,0,0,0
832311,True,0,No user reviews,0,0,0
832312,True,0,No user reviews,0,0,0
832313,True,0,No user reviews,0,0,0
832314,True,0,No user reviews,0,0,0
832320,True,7,Positive,15,1,16
832350,True,5,Mixed,13,16,29
832360,True,0,No user reviews,0,0,0
832370,True,0,No user reviews,0,0,0
832380,True,0,2 user reviews,2,0,2
832400,True,0,No user reviews,0,0,0
832410,True,0,No user reviews,0,0,0
832411,True,0,No user reviews,0,0,0
832412,True,0,No user reviews,0,0,0
832420,True,0,6 user reviews,3,3,6
832430,True,0,No user reviews,0,0,0
832440,True,0,No user reviews,0,0,0
832450,True,0,No user reviews,0,0,0
832451,True,0,No user reviews,0,0,0
832452,True,0,No user reviews,0,0,0
832453,True,0,No user reviews,0,0,0
832460,True,0,No user reviews,0,0,0
832470,True,0,5 user reviews,4,1,5
832480,True,0,No user reviews,0,0,0
832481,True,0,No user reviews,0,0,0
832482,True,0,No user reviews,0,0,0
832483,True,0,No user reviews,0,0,0
832484,True,0,No user reviews,0,0,0
832485,True,0,No user reviews,0,0,0
832486,True,0,No user reviews,0,0,0
832487,True,0,No user reviews,0,0,0
832500,True,0,No user reviews,0,0,0
832510,True,0,No user reviews,0,0,0
832520,True,0,No user reviews,0,0,0
832530,True,0,No user reviews,0,0,0
832540,True,5,Mixed,16,7,23
832550,True,0,5 user reviews,1,4,5
832580,True,0,1 user reviews,1,0,1
832610,True,0,9 user reviews,1,8,9
832620,True,0,No user reviews,0,0,0
832640,True,0,No user reviews,0,0,0
832650,True,0,7 user reviews,5,2,7
832680,True,5,Mixed,8,4,12
832690,True,0,6 user reviews,4,2,6
832700,True,5,Mixed,35,28,63
832710,True,7,Positive,18,3,21
832720,True,5,Mixed,26,12,38
832730,True,0,No user reviews,0,0,0
832770,True,7,Positive,29,0,29
832780,True,0,No user reviews,0,0,0
832950,True,0,No user reviews,0,0,0
832990,True,0,6 user reviews,1,5,6
833010,True,0,4 user reviews,2,2,4
833020,True,0,No user reviews,0,0,0
833030,True,7,Positive,23,4,27
833040,True,8,Very Positive,780,51,831
833050,True,0,No user reviews,0,0,0
833051,True,0,No user reviews,0,0,0
833052,True,0,No user reviews,0,0,0
833053,True,0,No user reviews,0,0,0
833054,True,0,No user reviews,0,0,0
833055,True,0,No user reviews,0,0,0
833056,True,0,No user reviews,0,0,0
833060,True,0,No user reviews,0,0,0
833070,True,0,5 user reviews,5,0,5
833080,True,0,No user reviews,0,0,0
833081,True,0,No user reviews,0,0,0
833082,True,0,No user reviews,0,0,0
833083,True,0,No user reviews,0,0,0
833084,True,0,No user reviews,0,0,0
833085,True,0,No user reviews,0,0,0
833086,True,0,No user reviews,0,0,0
833087,True,0,No user reviews,0,0,0
833088,True,0,No user reviews,0,0,0
833089,True,0,No user reviews,0,0,0
833090,True,8,Very Positive,266,34,300
833110,True,0,4 user reviews,2,2,4
833130,True,0,No user reviews,0,0,0
833131,True,0,No user reviews,0,0,0
833140,True,7,Positive,40,3,43
833150,True,0,4 user reviews,2,2,4
833170,True,6,Mostly Positive,23,6,29
833180,True,0,7 user reviews,3,4,7
833240,True,0,No user reviews,0,0,0
833260,True,7,Positive,8,2,10
833270,True,7,Positive,11,1,12
833300,True,0,No user reviews,0,0,0
833310,True,0,No user reviews,0,0,0
833330,True,0,No user reviews,0,0,0
833340,True,0,No user reviews,0,0,0
833360,True,8,Very Positive,236,22,258
833370,True,5,Mixed,5,5,10
833380,True,0,2 user reviews,0,2,2
833390,True,0,2 user reviews,2,0,2
833400,True,5,Mixed,13,8,21
833420,True,0,No user reviews,0,0,0
833440,True,0,No user reviews,0,0,0
833450,True,0,No user reviews,0,0,0
833470,True,0,5 user reviews,4,1,5
833500,True,7,Positive,12,0,12
833510,True,0,1 user reviews,0,1,1
833530,True,0,No user reviews,0,0,0
833540,True,0,2 user reviews,1,1,2
833570,True,0,No user reviews,0,0,0
833580,True,0,No user reviews,0,0,0
833590,True,0,6 user reviews,6,0,6
833600,True,0,No user reviews,0,0,0
833610,True,0,No user reviews,0,0,0
833620,True,0,No user reviews,0,0,0
833640,True,0,4 user reviews,2,2,4
833650,True,0,1 user reviews,0,1,1
833660,True,0,9 user reviews,5,4,9
833670,True,0,2 user reviews,1,1,2
833690,True,0,6 user reviews,6,0,6
833700,True,0,7 user reviews,1,6,7
833730,True,0,No user reviews,0,0,0
833740,True,0,No user reviews,0,0,0
833750,True,0,1 user reviews,1,0,1
833760,True,0,No user reviews,0,0,0
833770,True,0,3 user reviews,2,1,3
833780,True,0,No user reviews,0,0,0
833800,True,0,1 user reviews,0,1,1
833810,True,0,4 user reviews,1,3,4
833820,True,0,7 user reviews,1,6,7
833830,True,0,No user reviews,0,0,0
833840,True,0,No user reviews,0,0,0
833850,True,0,No user reviews,0,0,0
833860,True,0,2 user reviews,1,1,2
833870,True,0,No user reviews,0,0,0
833880,True,0,No user reviews,0,0,0
833890,True,0,6 user reviews,5,1,6
833910,True,7,Positive,33,5,38
833920,True,0,5 user reviews,1,4,5
833940,True,0,1 user reviews,1,0,1
833950,True,7,Positive,19,0,19
833960,True,0,No user reviews,0,0,0
833980,True,0,4 user reviews,4,0,4
833990,True,7,Positive,23,1,24
834000,True,0,3 user reviews,1,2,3
834020,True,0,2 user reviews,0,2,2
834030,True,0,No user reviews,0,0,0
834040,True,0,No user reviews,0,0,0
834050,True,0,No user reviews,0,0,0
834060,True,5,Mixed,34,37,71
834070,True,5,Mixed,6,7,13
834100,True,0,1 user reviews,0,1,1
834110,True,0,No user reviews,0,0,0
834120,True,0,No user reviews,0,0,0
834130,True,0,2 user reviews,1,1,2
834131,True,0,2 user reviews,1,1,2
834140,True,5,Mixed,6,6,12
834150,True,6,Mostly Positive,10,4,14
834170,True,0,7 user reviews,4,3,7
834180,True,0,6 user reviews,5,1,6
834210,True,0,1 user reviews,0,1,1
834280,True,5,Mixed,168,75,243
834290,True,0,No user reviews,0,0,0
834320,True,0,No user reviews,0,0,0
834340,True,6,Mostly Positive,12,4,16
834350,True,0,1 user reviews,1,0,1
834360,True,0,2 user reviews,1,1,2
834380,True,0,5 user reviews,5,0,5
834390,True,5,Mixed,12,6,18
834400,True,0,1 user reviews,0,1,1
834401,True,0,8 user reviews,8,0,8
834402,True,0,No user reviews,0,0,0
834403,True,5,Mixed,9,5,14
834404,True,0,4 user reviews,4,0,4
834405,True,0,2 user reviews,2,0,2
834406,True,0,2 user reviews,0,2,2
834407,True,5,Mixed,9,13,22
834408,True,0,3 user reviews,2,1,3
834410,True,0,No user reviews,0,0,0
834420,True,0,2 user reviews,1,1,2
834430,True,0,No user reviews,0,0,0
834440,True,0,No user reviews,0,0,0
834450,True,5,Mixed,5,6,11
834470,True,0,No user reviews,0,0,0
834490,True,0,No user reviews,0,0,0
834500,True,0,No user reviews,0,0,0
834510,True,0,No user reviews,0,0,0
834520,True,0,No user reviews,0,0,0
834530,True,8,Very Positive,2454,138,2592
834550,True,0,No user reviews,0,0,0
834560,True,0,No user reviews,0,0,0
834580,True,7,Positive,16,0,16
834590,True,0,No user reviews,0,0,0
834730,True,0,No user reviews,0,0,0
834740,True,8,Very Positive,704,103,807
834750,True,5,Mixed,16,12,28
834760,True,8,Very Positive,49,1,50
834800,True,5,Mixed,26,19,45
834880,True,0,No user reviews,0,0,0
834910,True,5,Mixed,7748,8876,16624
834920,True,0,No user reviews,0,0,0
834930,True,0,3 user reviews,3,0,3
835040,True,0,7 user reviews,5,2,7
835110,True,7,Positive,34,3,37
835130,True,0,4 user reviews,2,2,4
835140,True,0,No user reviews,0,0,0
835280,True,0,No user reviews,0,0,0
835430,True,8,Very Positive,235,36,271
835440,True,0,1 user reviews,0,1,1
835450,True,0,1 user reviews,0,1,1
835460,True,0,1 user reviews,1,0,1
835470,True,0,No user reviews,0,0,0
835471,True,0,1 user reviews,0,1,1
835480,True,0,No user reviews,0,0,0
835490,True,0,2 user reviews,1,1,2
835500,True,0,No user reviews,0,0,0
835510,True,0,9 user reviews,4,5,9
835520,True,0,2 user reviews,2,0,2
835530,True,0,No user reviews,0,0,0
835560,True,0,3 user reviews,3,0,3
835570,True,6,Mostly Positive,145,47,192
835590,True,0,No user reviews,0,0,0
835600,True,0,3 user reviews,2,1,3
835620,True,0,No user reviews,0,0,0
835630,True,0,7 user reviews,7,0,7
835640,True,0,4 user reviews,4,0,4
835650,True,8,Very Positive,60,7,67
835660,True,0,1 user reviews,0,1,1
835670,True,8,Very Positive,466,108,574
835671,True,0,No user reviews,0,0,0
835680,True,0,2 user reviews,2,0,2
835690,True,0,3 user reviews,3,0,3
835700,True,7,Positive,21,4,25
835710,True,0,8 user reviews,8,0,8
835720,True,0,No user reviews,0,0,0
835730,True,0,3 user reviews,3,0,3
835740,True,0,1 user reviews,1,0,1
835750,True,0,No user reviews,0,0,0
835770,True,0,No user reviews,0,0,0
835780,True,0,No user reviews,0,0,0
835790,True,0,No user reviews,0,0,0
835800,True,0,No user reviews,0,0,0
835830,True,0,No user reviews,0,0,0
835860,True,0,1 user reviews,0,1,1
835910,True,5,Mixed,6,5,11
835950,True,7,Positive,38,1,39
836010,True,0,No user reviews,0,0,0
836040,True,0,No user reviews,0,0,0
836080,True,6,Mostly Positive,10,4,14
836090,True,0,No user reviews,0,0,0
836110,True,5,Mixed,11,9,20
836120,True,0,No user reviews,0,0,0
836230,True,0,1 user reviews,1,0,1
836260,True,0,4 user reviews,4,0,4
836270,True,0,No user reviews,0,0,0
836280,True,0,3 user reviews,2,1,3
836290,True,0,4 user reviews,3,1,4
836300,True,0,4 user reviews,4,0,4
836310,True,0,No user reviews,0,0,0
836320,True,0,No user reviews,0,0,0
836321,True,0,No user reviews,0,0,0
836330,True,0,8 user reviews,3,5,8
836340,True,0,No user reviews,0,0,0
836350,True,7,Positive,15,2,17
836370,True,0,No user reviews,0,0,0
836380,True,0,No user reviews,0,0,0
836400,True,0,1 user reviews,1,0,1
836420,True,0,1 user reviews,0,1,1
836440,True,0,No user reviews,0,0,0
836450,True,8,Very Positive,213,14,227
836460,True,0,6 user reviews,5,1,6
836470,True,0,3 user reviews,1,2,3
836480,True,0,8 user reviews,5,3,8
836490,True,7,Positive,37,5,42
836510,True,0,No user reviews,0,0,0
836520,True,0,No user reviews,0,0,0
836530,True,0,No user reviews,0,0,0
836540,True,0,6 user reviews,6,0,6
836550,True,0,4 user reviews,4,0,4
836560,True,0,6 user reviews,5,1,6
836570,True,0,No user reviews,0,0,0
836580,True,4,Mostly Negative,5,11,16
836590,True,0,7 user reviews,4,3,7
836600,True,0,6 user reviews,5,1,6
836610,True,0,7 user reviews,7,0,7
836620,True,6,Mostly Positive,13342,5203,18545
836630,True,0,4 user reviews,3,1,4
836631,True,0,1 user reviews,1,0,1
836632,True,0,1 user reviews,0,1,1
836640,True,7,Positive,9,1,10
836680,True,0,No user reviews,0,0,0
836690,True,0,2 user reviews,2,0,2
836700,True,0,5 user reviews,3,2,5
836710,True,0,No user reviews,0,0,0
836730,True,0,No user reviews,0,0,0
836750,True,5,Mixed,12,14,26
836760,True,6,Mostly Positive,39,13,52
836770,True,5,Mixed,12,8,20
836781,True,7,Positive,12,2,14
836783,True,0,3 user reviews,3,0,3
836785,True,0,7 user reviews,6,1,7
836790,True,0,7 user reviews,5,2,7
836810,True,5,Mixed,19,24,43
836811,True,5,Mixed,20,10,30
836812,True,7,Positive,12,1,13
836820,True,0,6 user reviews,5,1,6
836830,True,0,No user reviews,0,0,0
836840,True,0,No user reviews,0,0,0
836841,True,0,No user reviews,0,0,0
836842,True,0,No user reviews,0,0,0
836843,True,0,No user reviews,0,0,0
836844,True,0,No user reviews,0,0,0
836845,True,0,No user reviews,0,0,0
836846,True,0,No user reviews,0,0,0
836850,True,5,Mixed,44,24,68
836860,True,3,Negative,2,13,15
836870,True,4,Mostly Negative,3,12,15
836880,True,0,No user reviews,0,0,0
836890,True,0,No user reviews,0,0,0
836900,True,7,Positive,11,1,12
836910,True,0,No user reviews,0,0,0
836920,True,0,No user reviews,0,0,0
836930,True,0,No user reviews,0,0,0
836940,True,0,No user reviews,0,0,0
837040,True,7,Positive,9,1,10
837060,True,0,No user reviews,0,0,0
837090,True,0,9 user reviews,8,1,9
837100,True,5,Mixed,4,6,10
837110,True,3,Negative,1,10,11
837140,True,0,No user reviews,0,0,0
837150,True,0,No user reviews,0,0,0
837160,True,0,No user reviews,0,0,0
837170,True,0,No user reviews,0,0,0
837180,True,0,3 user reviews,3,0,3
837190,True,7,Positive,26,3,29
837200,True,6,Mostly Positive,14,6,20
837210,True,0,2 user reviews,1,1,2
837220,True,0,1 user reviews,0,1,1
837240,True,0,9 user reviews,5,4,9
837260,True,0,2 user reviews,1,1,2
837270,True,0,4 user reviews,3,1,4
837280,True,0,No user reviews,0,0,0
837290,True,0,1 user reviews,0,1,1
837310,True,0,No user reviews,0,0,0
837330,True,0,5 user reviews,5,0,5
837340,True,0,No user reviews,0,0,0
837350,True,0,No user reviews,0,0,0
837360,True,0,2 user reviews,1,1,2
837380,True,0,No user reviews,0,0,0
837390,True,0,No user reviews,0,0,0
837400,True,8,Very Positive,82,13,95
837430,True,5,Mixed,8,7,15
837440,True,6,Mostly Positive,13,4,17
837450,True,0,2 user reviews,2,0,2
837460,True,7,Positive,33,1,34
837470,True,8,Very Positive,766,52,818
837500,True,0,No user reviews,0,0,0
837510,True,6,Mostly Positive,59,24,83
837530,True,0,8 user reviews,1,7,8
837550,True,0,2 user reviews,1,1,2
837570,True,0,No user reviews,0,0,0
837590,True,5,Mixed,38,22,60
837600,True,5,Mixed,15,13,28
837610,True,8,Very Positive,198,30,228
837640,True,0,No user reviews,0,0,0
837720,True,0,No user reviews,0,0,0
837780,True,0,9 user reviews,4,5,9
837790,True,5,Mixed,9,5,14
837800,True,6,Mostly Positive,13,4,17
837810,True,0,3 user reviews,0,3,3
837830,True,7,Positive,13,0,13
837840,True,0,7 user reviews,7,0,7
837841,True,0,7 user reviews,5,2,7
837850,True,7,Positive,13,1,14
837860,True,0,4 user reviews,4,0,4
837861,True,0,5 user reviews,5,0,5
837880,True,0,No user reviews,0,0,0
837900,True,0,7 user reviews,3,4,7
837910,True,0,No user reviews,0,0,0
837920,True,0,No user reviews,0,0,0
837930,True,6,Mostly Positive,9,3,12
837940,True,7,Positive,17,1,18
837950,True,0,No user reviews,0,0,0
837970,True,0,No user reviews,0,0,0
837990,True,0,No user reviews,0,0,0
838000,True,0,No user reviews,0,0,0
838010,True,7,Positive,26,4,30
838020,True,0,1 user reviews,1,0,1
838030,True,0,No user reviews,0,0,0
838050,True,5,Mixed,8,11,19
838060,True,0,No user reviews,0,0,0
838080,True,0,No user reviews,0,0,0
838090,True,0,No user reviews,0,0,0
838100,True,0,6 user reviews,6,0,6
838110,True,7,Positive,39,6,45
838120,True,0,6 user reviews,6,0,6
838130,True,0,2 user reviews,2,0,2
838140,True,0,2 user reviews,2,0,2
838150,True,0,1 user reviews,0,1,1
838160,True,0,6 user reviews,3,3,6
838170,True,0,No user reviews,0,0,0
838180,True,7,Positive,35,7,42
838190,True,0,No user reviews,0,0,0
838210,True,0,No user reviews,0,0,0
838220,True,0,No user reviews,0,0,0
838230,True,0,No user reviews,0,0,0
838240,True,0,No user reviews,0,0,0
838250,True,0,No user reviews,0,0,0
838251,True,0,No user reviews,0,0,0
838270,True,5,Mixed,7,10,17
838300,True,0,No user reviews,0,0,0
838310,True,8,Very Positive,1202,86,1288
838330,True,5,Mixed,85,48,133
838340,True,0,8 user reviews,6,2,8
838350,True,8,Very Positive,339,38,377
838360,True,0,No user reviews,0,0,0
838370,True,0,No user reviews,0,0,0
838380,True,5,Mixed,590,271,861
838390,True,7,Positive,28,3,31
838400,True,0,No user reviews,0,0,0
838410,True,7,Positive,18,2,20
838420,True,0,6 user reviews,1,5,6
838430,True,0,No user reviews,0,0,0
838440,True,0,No user reviews,0,0,0
838450,True,0,No user reviews,0,0,0
838490,True,0,8 user reviews,8,0,8
838510,True,0,No user reviews,0,0,0
838530,True,0,2 user reviews,2,0,2
838540,True,0,1 user reviews,1,0,1
838610,True,0,No user reviews,0,0,0
838620,True,8,Very Positive,67,5,72
838630,True,5,Mixed,197,147,344
838680,True,0,No user reviews,0,0,0
838690,True,0,No user reviews,0,0,0
838700,True,0,3 user reviews,3,0,3
838710,True,0,2 user reviews,2,0,2
838720,True,0,3 user reviews,3,0,3
838730,True,0,3 user reviews,2,1,3
838740,True,0,No user reviews,0,0,0
838750,True,0,1 user reviews,1,0,1
838760,True,0,2 user reviews,1,1,2
838770,True,8,Very Positive,141,20,161
838790,True,0,3 user reviews,2,1,3
838800,True,0,No user reviews,0,0,0
838810,True,0,1 user reviews,1,0,1
838820,True,4,Mostly Negative,7,11,18
838840,True,0,3 user reviews,0,3,3
838850,True,0,No user reviews,0,0,0
838860,True,7,Positive,29,0,29
838870,True,0,No user reviews,0,0,0
838900,True,0,No user reviews,0,0,0
838920,True,0,No user reviews,0,0,0
838930,True,0,No user reviews,0,0,0
838940,True,0,5 user reviews,3,2,5
838970,True,0,No user reviews,0,0,0
838980,True,0,1 user reviews,0,1,1
838990,True,8,Very Positive,67,13,80
839000,True,0,No user reviews,0,0,0
839010,True,0,2 user reviews,2,0,2
839020,True,7,Positive,19,4,23
839030,True,0,1 user reviews,0,1,1
839040,True,0,4 user reviews,2,2,4
839080,True,0,2 user reviews,1,1,2
839090,True,0,6 user reviews,5,1,6
839110,True,0,1 user reviews,1,0,1
839130,True,0,3 user reviews,3,0,3
839170,True,0,8 user reviews,5,3,8
839180,True,0,No user reviews,0,0,0
839190,True,0,No user reviews,0,0,0
839200,True,0,No user reviews,0,0,0
839210,True,0,3 user reviews,3,0,3
839230,True,0,4 user reviews,4,0,4
839240,True,0,No user reviews,0,0,0
839250,True,0,1 user reviews,0,1,1
839260,True,5,Mixed,6,7,13
839270,True,0,No user reviews,0,0,0
839280,True,7,Positive,20,3,23
839290,True,0,No user reviews,0,0,0
839300,True,5,Mixed,6,5,11
839310,True,8,Very Positive,380,69,449
839320,True,0,No user reviews,0,0,0
839330,True,0,No user reviews,0,0,0
839340,True,7,Positive,14,1,15
839350,True,0,No user reviews,0,0,0
839360,True,0,No user reviews,0,0,0
839370,True,0,No user reviews,0,0,0
839400,True,0,No user reviews,0,0,0
839410,True,0,No user reviews,0,0,0
839420,True,7,Positive,15,1,16
839430,True,0,No user reviews,0,0,0
839450,True,8,Very Positive,66,10,76
839460,True,0,No user reviews,0,0,0
839470,True,0,No user reviews,0,0,0
839500,True,0,No user reviews,0,0,0
839510,True,0,No user reviews,0,0,0
839520,True,0,1 user reviews,0,1,1
839530,True,0,1 user reviews,1,0,1
839540,True,0,2 user reviews,0,2,2
839550,True,0,No user reviews,0,0,0
839560,True,0,No user reviews,0,0,0
839570,True,6,Mostly Positive,11,3,14
839580,True,0,3 user reviews,1,2,3
839590,True,0,2 user reviews,0,2,2
839610,True,0,No user reviews,0,0,0
839620,True,0,1 user reviews,0,1,1
839630,True,5,Mixed,90,70,160
839660,True,0,No user reviews,0,0,0
839670,True,6,Mostly Positive,10,4,14
839680,True,0,No user reviews,0,0,0
839690,True,0,No user reviews,0,0,0
839710,True,0,No user reviews,0,0,0
839730,True,0,4 user reviews,2,2,4
839750,True,0,No user reviews,0,0,0
839760,True,0,No user reviews,0,0,0
839770,True,0,No user reviews,0,0,0
839810,True,0,No user reviews,0,0,0
839820,True,0,2 user reviews,1,1,2
839850,True,7,Positive,20,0,20
839860,True,0,No user reviews,0,0,0
839870,True,8,Very Positive,163,9,172
839890,True,0,7 user reviews,3,4,7
839910,True,0,No user reviews,0,0,0
839920,True,0,2 user reviews,1,1,2
839930,True,5,Mixed,82,39,121
839940,True,7,Positive,16,0,16
839950,True,0,No user reviews,0,0,0
839960,True,7,Positive,18,1,19
839970,True,0,1 user reviews,1,0,1
839990,True,0,No user reviews,0,0,0
840010,True,8,Very Positive,804,96,900
840020,True,0,3 user reviews,3,0,3
840030,True,0,No user reviews,0,0,0
840040,True,0,No user reviews,0,0,0
840050,True,0,No user reviews,0,0,0
840060,True,0,2 user reviews,2,0,2
840070,True,0,No user reviews,0,0,0
840090,True,0,2 user reviews,0,2,2
840100,True,6,Mostly Positive,8,3,11
840110,True,0,No user reviews,0,0,0
840130,True,0,3 user reviews,1,2,3
840140,True,4,Mostly Negative,56,97,153
840160,True,0,7 user reviews,7,0,7
840170,True,0,2 user reviews,0,2,2
840180,True,0,No user reviews,0,0,0
840190,True,0,8 user reviews,4,4,8
840210,True,0,No user reviews,0,0,0
840220,True,0,No user reviews,0,0,0
840230,True,0,3 user reviews,3,0,3
840240,True,0,9 user reviews,7,2,9
840260,True,0,4 user reviews,3,1,4
840280,True,0,No user reviews,0,0,0
840300,True,0,3 user reviews,3,0,3
840310,True,7,Positive,13,1,14
840370,True,6,Mostly Positive,84,29,113
840380,True,0,3 user reviews,3,0,3
840390,True,0,No user reviews,0,0,0
840410,True,0,No user reviews,0,0,0
840430,True,7,Positive,22,2,24
840440,True,0,4 user reviews,4,0,4
840460,True,0,No user reviews,0,0,0
840490,True,0,No user reviews,0,0,0
840500,True,0,3 user reviews,1,2,3
840510,True,0,No user reviews,0,0,0
840520,True,0,No user reviews,0,0,0
840540,True,0,No user reviews,0,0,0
840580,True,0,2 user reviews,1,1,2
840590,True,0,6 user reviews,3,3,6
840610,True,7,Positive,25,0,25
840620,True,0,No user reviews,0,0,0
840630,True,0,No user reviews,0,0,0
840640,True,0,No user reviews,0,0,0
840670,True,0,No user reviews,0,0,0
840680,True,0,No user reviews,0,0,0
840690,True,0,6 user reviews,6,0,6
840700,True,0,8 user reviews,8,0,8
840710,True,0,7 user reviews,4,3,7
840720,True,6,Mostly Positive,198,50,248
840730,True,0,5 user reviews,4,1,5
840750,True,0,8 user reviews,7,1,8
840760,True,0,5 user reviews,5,0,5
840770,True,0,3 user reviews,3,0,3
840790,True,0,2 user reviews,1,1,2
840800,True,5,Mixed,1615,747,2362
840810,True,0,No user reviews,0,0,0
840820,True,0,No user reviews,0,0,0
840830,True,0,No user reviews,0,0,0
840840,True,0,No user reviews,0,0,0
840850,True,0,No user reviews,0,0,0
840860,True,0,1 user reviews,1,0,1
840880,True,0,No user reviews,0,0,0
840890,True,0,No user reviews,0,0,0
840910,True,0,2 user reviews,2,0,2
840920,True,0,1 user reviews,0,1,1
840930,True,8,Very Positive,72,9,81
840940,True,0,1 user reviews,1,0,1
840980,True,0,5 user reviews,4,1,5
840991,True,0,2 user reviews,2,0,2
841000,True,0,No user reviews,0,0,0
841010,True,0,2 user reviews,2,0,2
841020,True,0,No user reviews,0,0,0
841030,True,0,6 user reviews,3,3,6
841070,True,0,No user reviews,0,0,0
841080,True,0,No user reviews,0,0,0
841110,True,0,No user reviews,0,0,0
841120,True,7,Positive,9,2,11
841140,True,4,Mostly Negative,4,7,11
841150,True,5,Mixed,8,5,13
841160,True,0,3 user reviews,2,1,3
841161,True,0,No user reviews,0,0,0
841162,True,0,4 user reviews,2,2,4
841163,True,0,No user reviews,0,0,0
841164,True,0,No user reviews,0,0,0
841165,True,0,No user reviews,0,0,0
841166,True,0,No user reviews,0,0,0
841167,True,0,No user reviews,0,0,0
841168,True,0,1 user reviews,1,0,1
841170,True,0,No user reviews,0,0,0
841190,True,0,No user reviews,0,0,0
841200,True,0,6 user reviews,5,1,6
841210,True,0,2 user reviews,2,0,2
841220,True,0,No user reviews,0,0,0
841240,True,0,No user reviews,0,0,0
841250,True,6,Mostly Positive,22,8,30
841260,True,0,6 user reviews,2,4,6
841270,True,0,No user reviews,0,0,0
841280,True,0,1 user reviews,1,0,1
841290,True,0,No user reviews,0,0,0
841300,True,0,No user reviews,0,0,0
841310,True,0,No user reviews,0,0,0
841320,True,6,Mostly Positive,8,3,11
841330,True,0,No user reviews,0,0,0
841340,True,0,9 user reviews,6,3,9
841350,True,5,Mixed,14,11,25
841370,True,5,Mixed,1675,1640,3315
841440,True,0,2 user reviews,2,0,2
841460,True,8,Very Positive,110,13,123
841470,True,0,1 user reviews,1,0,1
841500,True,0,No user reviews,0,0,0
841570,True,0,2 user reviews,1,1,2
841580,True,0,1 user reviews,1,0,1
841600,True,8,Very Positive,54,2,56
841640,True,0,No user reviews,0,0,0
841650,True,0,No user reviews,0,0,0
841660,True,7,Positive,39,7,46
841670,True,0,No user reviews,0,0,0
841680,True,0,3 user reviews,3,0,3
841690,True,0,1 user reviews,1,0,1
841700,True,0,No user reviews,0,0,0
841710,True,0,No user reviews,0,0,0
841720,True,0,No user reviews,0,0,0
841730,True,0,No user reviews,0,0,0
841740,True,0,1 user reviews,1,0,1
841750,True,0,No user reviews,0,0,0
841770,True,9,Overwhelmingly Positive,685,34,719
841790,True,0,1 user reviews,0,1,1
841800,True,0,3 user reviews,1,2,3
841820,True,0,3 user reviews,3,0,3
841821,True,0,1 user reviews,0,1,1
841830,True,0,No user reviews,0,0,0
841840,True,0,9 user reviews,5,4,9
841850,True,0,No user reviews,0,0,0
841870,True,0,No user reviews,0,0,0
841900,True,0,No user reviews,0,0,0
841910,True,0,1 user reviews,1,0,1
841940,True,0,No user reviews,0,0,0
841950,True,0,7 user reviews,5,2,7
841970,True,0,No user reviews,0,0,0
841980,True,6,Mostly Positive,9,3,12
841990,True,0,1 user reviews,0,1,1
842000,True,0,2 user reviews,2,0,2
842020,True,0,6 user reviews,5,1,6
842030,True,0,2 user reviews,1,1,2
842050,True,0,6 user reviews,2,4,6
842070,True,0,1 user reviews,0,1,1
842080,True,0,No user reviews,0,0,0
842090,True,0,No user reviews,0,0,0
842100,True,6,Mostly Positive,397,158,555
842120,True,0,8 user reviews,7,1,8
842130,True,0,No user reviews,0,0,0
842140,True,7,Positive,26,4,30
842150,True,0,No user reviews,0,0,0
842160,True,0,No user reviews,0,0,0
842170,True,7,Positive,30,3,33
842180,True,0,No user reviews,0,0,0
842190,True,0,No user reviews,0,0,0
842210,True,0,No user reviews,0,0,0
842211,True,0,No user reviews,0,0,0
842212,True,0,No user reviews,0,0,0
842213,True,0,No user reviews,0,0,0
842214,True,0,No user reviews,0,0,0
842215,True,0,No user reviews,0,0,0
842240,True,0,No user reviews,0,0,0
842250,True,4,Mostly Negative,16,27,43
842270,True,0,No user reviews,0,0,0
842290,True,0,1 user reviews,0,1,1
842300,True,0,No user reviews,0,0,0
842310,True,0,2 user reviews,1,1,2
842330,True,0,4 user reviews,3,1,4
842331,True,0,No user reviews,0,0,0
842340,True,0,No user reviews,0,0,0
842350,True,0,1 user reviews,0,1,1
842360,True,0,No user reviews,0,0,0
842361,True,0,1 user reviews,1,0,1
842362,True,0,No user reviews,0,0,0
842363,True,0,1 user reviews,1,0,1
842364,True,0,2 user reviews,2,0,2
842365,True,0,No user reviews,0,0,0
842366,True,0,1 user reviews,0,1,1
842367,True,0,No user reviews,0,0,0
842368,True,0,No user reviews,0,0,0
842369,True,0,1 user reviews,0,1,1
842370,True,0,No user reviews,0,0,0
842381,True,0,No user reviews,0,0,0
842382,True,0,2 user reviews,2,0,2
842383,True,0,No user reviews,0,0,0
842384,True,0,No user reviews,0,0,0
842390,True,0,No user reviews,0,0,0
842420,True,0,No user reviews,0,0,0
842430,True,0,5 user reviews,5,0,5
842450,True,0,No user reviews,0,0,0
842451,True,0,No user reviews,0,0,0
842452,True,0,No user reviews,0,0,0
842453,True,0,No user reviews,0,0,0
842470,True,0,3 user reviews,3,0,3
842480,True,0,No user reviews,0,0,0
842490,True,0,2 user reviews,1,1,2
842500,True,0,No user reviews,0,0,0
842510,True,0,1 user reviews,0,1,1
842520,True,0,No user reviews,0,0,0
842530,True,0,6 user reviews,2,4,6
842540,True,0,No user reviews,0,0,0
842541,True,0,No user reviews,0,0,0
842542,True,0,No user reviews,0,0,0
842543,True,0,No user reviews,0,0,0
842550,True,0,No user reviews,0,0,0
842560,True,0,5 user reviews,0,5,5
842570,True,0,No user reviews,0,0,0
842590,True,0,1 user reviews,1,0,1
842620,True,0,No user reviews,0,0,0
842640,True,0,8 user reviews,3,5,8
842650,True,0,No user reviews,0,0,0
842651,True,0,No user reviews,0,0,0
842660,True,0,No user reviews,0,0,0
842670,True,0,No user reviews,0,0,0
842680,True,7,Positive,31,6,37
842690,True,0,No user reviews,0,0,0
842700,True,0,No user reviews,0,0,0
842710,True,0,No user reviews,0,0,0
842711,True,0,No user reviews,0,0,0
842720,True,0,No user reviews,0,0,0
842750,True,7,Positive,23,2,25
842760,True,0,3 user reviews,3,0,3
842770,True,0,7 user reviews,7,0,7
842780,True,8,Very Positive,64,16,80
842810,True,8,Very Positive,55,7,62
842820,True,0,1 user reviews,1,0,1
842840,True,0,No user reviews,0,0,0
842841,True,0,No user reviews,0,0,0
842850,True,7,Positive,9,2,11
842870,True,0,2 user reviews,1,1,2
842880,True,0,No user reviews,0,0,0
842910,True,8,Very Positive,308,27,335
842940,True,0,No user reviews,0,0,0
842950,True,0,4 user reviews,4,0,4
842951,True,0,2 user reviews,2,0,2
842952,True,0,No user reviews,0,0,0
842960,True,0,2 user reviews,2,0,2
842990,True,0,4 user reviews,4,0,4
843000,True,0,1 user reviews,0,1,1
843010,True,6,Mostly Positive,13,5,18
843020,True,0,No user reviews,0,0,0
843040,True,5,Mixed,4,6,10
843050,True,0,No user reviews,0,0,0
843070,True,0,No user reviews,0,0,0
843080,True,0,1 user reviews,1,0,1
843100,True,0,No user reviews,0,0,0
843101,True,0,No user reviews,0,0,0
843102,True,0,No user reviews,0,0,0
843103,True,0,No user reviews,0,0,0
843120,True,0,6 user reviews,6,0,6
843130,True,0,No user reviews,0,0,0
843160,True,0,7 user reviews,4,3,7
843170,True,7,Positive,27,0,27
843180,True,0,No user reviews,0,0,0
843190,True,0,3 user reviews,0,3,3
843200,True,0,No user reviews,0,0,0
843240,True,0,No user reviews,0,0,0
843250,True,5,Mixed,8,4,12
843260,True,9,Overwhelmingly Positive,509,19,528
843270,True,0,7 user reviews,4,3,7
843280,True,0,No user reviews,0,0,0
843290,True,0,No user reviews,0,0,0
843330,True,0,No user reviews,0,0,0
843340,True,0,3 user reviews,2,1,3
843360,True,5,Mixed,4,6,10
843370,True,0,8 user reviews,8,0,8
843380,True,9,Overwhelmingly Positive,2521,72,2593
843390,True,0,No user reviews,0,0,0
843400,True,0,1 user reviews,0,1,1
843420,True,0,3 user reviews,1,2,3
843430,True,8,Very Positive,57,4,61
843440,True,8,Very Positive,64,4,68
843500,True,0,No user reviews,0,0,0
843510,True,7,Positive,14,3,17
843520,True,6,Mostly Positive,11,4,15
843580,True,0,1 user reviews,0,1,1
843590,True,0,3 user reviews,3,0,3
843600,True,0,No user reviews,0,0,0
843620,True,0,No user reviews,0,0,0
843630,True,0,No user reviews,0,0,0
843640,True,7,Positive,16,3,19
843650,True,0,1 user reviews,1,0,1
843660,True,0,No user reviews,0,0,0
843671,True,0,No user reviews,0,0,0
843700,True,0,No user reviews,0,0,0
843710,True,0,1 user reviews,1,0,1
843720,True,0,7 user reviews,5,2,7
843730,True,5,Mixed,16,7,23
843740,True,6,Mostly Positive,8,3,11
843760,True,0,2 user reviews,1,1,2
843770,True,0,No user reviews,0,0,0
843780,True,0,4 user reviews,3,1,4
843790,True,0,No user reviews,0,0,0
843800,True,0,No user reviews,0,0,0
843810,True,0,No user reviews,0,0,0
843820,True,0,5 user reviews,2,3,5
843830,True,0,No user reviews,0,0,0
843840,True,7,Positive,9,1,10
843850,True,0,No user reviews,0,0,0
843860,True,4,Mostly Negative,10,19,29
843870,True,5,Mixed,9,6,15
843890,True,5,Mixed,18,9,27
843900,True,8,Very Positive,43,9,52
843910,True,0,No user reviews,0,0,0
843920,True,0,No user reviews,0,0,0
843930,True,0,3 user reviews,3,0,3
843980,True,0,1 user reviews,1,0,1
843990,True,0,3 user reviews,3,0,3
844020,True,0,No user reviews,0,0,0
844030,True,0,No user reviews,0,0,0
844040,True,8,Very Positive,67,14,81
844050,True,7,Positive,26,6,32
844060,True,0,No user reviews,0,0,0
844070,True,0,No user reviews,0,0,0
844090,True,0,6 user reviews,0,6,6
844120,True,0,No user reviews,0,0,0
844130,True,7,Positive,21,0,21
844140,True,6,Mostly Positive,7,3,10
844160,True,0,8 user reviews,8,0,8
844180,True,6,Mostly Positive,22,6,28
844190,True,7,Positive,21,1,22
844210,True,5,Mixed,23,10,33
844220,True,0,No user reviews,0,0,0
844240,True,0,1 user reviews,1,0,1
844250,True,0,4 user reviews,0,4,4
844260,True,0,No user reviews,0,0,0
844290,True,0,5 user reviews,1,4,5
844300,True,0,8 user reviews,3,5,8
844310,True,0,9 user reviews,3,6,9
844320,True,0,No user reviews,0,0,0
844330,True,5,Mixed,73,40,113
844340,True,0,3 user reviews,2,1,3
844350,True,0,1 user reviews,1,0,1
844370,True,0,No user reviews,0,0,0
844380,True,7,Positive,11,1,12
844410,True,0,No user reviews,0,0,0
844420,True,8,Very Positive,70,14,84
844440,True,0,7 user reviews,7,0,7
844460,True,0,No user reviews,0,0,0
844470,True,0,No user reviews,0,0,0
844480,True,0,No user reviews,0,0,0
844490,True,0,No user reviews,0,0,0
844500,True,6,Mostly Positive,21,9,30
844510,True,0,4 user reviews,4,0,4
844520,True,0,No user reviews,0,0,0
844530,True,0,No user reviews,0,0,0
844540,True,0,No user reviews,0,0,0
844550,True,0,4 user reviews,4,0,4
844580,True,0,No user reviews,0,0,0
844590,True,9,Overwhelmingly Positive,1245,27,1272
844610,True,0,5 user reviews,1,4,5
844620,True,0,1 user reviews,1,0,1
844650,True,0,No user reviews,0,0,0
844660,True,8,Very Positive,277,4,281
844670,True,0,No user reviews,0,0,0
844680,True,0,No user reviews,0,0,0
844690,True,0,No user reviews,0,0,0
844710,True,0,No user reviews,0,0,0
844740,True,0,No user reviews,0,0,0
844750,True,5,Mixed,15,16,31
844760,True,0,4 user reviews,3,1,4
844810,True,6,Mostly Positive,159,58,217
844820,True,0,2 user reviews,1,1,2
844830,True,0,5 user reviews,3,2,5
844840,True,0,No user reviews,0,0,0
844850,True,5,Mixed,78,51,129
844860,True,7,Positive,26,3,29
844870,True,5,Mixed,22,17,39
844880,True,0,No user reviews,0,0,0
844890,True,6,Mostly Positive,135,49,184
844900,True,0,5 user reviews,3,2,5
844920,True,0,6 user reviews,3,3,6
844930,True,8,Very Positive,395,26,421
844940,True,0,No user reviews,0,0,0
844950,True,0,1 user reviews,1,0,1
844960,True,0,No user reviews,0,0,0
844970,True,0,6 user reviews,6,0,6
844980,True,0,No user reviews,0,0,0
844990,True,0,1 user reviews,0,1,1
845000,True,7,Positive,16,3,19
845010,True,6,Mostly Positive,29,8,37
845020,True,0,6 user reviews,4,2,6
845030,True,7,Positive,16,0,16
845040,True,7,Positive,18,4,22
845050,True,7,Positive,32,3,35
845070,True,0,No user reviews,0,0,0
845090,True,0,No user reviews,0,0,0
845110,True,0,No user reviews,0,0,0
845120,True,0,1 user reviews,1,0,1
845130,True,0,No user reviews,0,0,0
845140,True,0,3 user reviews,1,2,3
845142,True,0,1 user reviews,1,0,1
845143,True,0,3 user reviews,2,1,3
845144,True,0,1 user reviews,1,0,1
845147,True,0,1 user reviews,0,1,1
845148,True,0,1 user reviews,1,0,1
845149,True,0,5 user reviews,5,0,5
845150,True,0,9 user reviews,8,1,9
845170,True,0,No user reviews,0,0,0
845190,True,0,1 user reviews,1,0,1
845200,True,0,3 user reviews,0,3,3
845210,True,0,2 user reviews,1,1,2
845250,True,0,No user reviews,0,0,0
845270,True,7,Positive,45,1,46
845290,True,0,2 user reviews,1,1,2
845330,True,0,9 user reviews,3,6,9
845340,True,0,1 user reviews,1,0,1
845350,True,0,3 user reviews,2,1,3
845370,True,0,No user reviews,0,0,0
845380,True,5,Mixed,13,9,22
845390,True,0,5 user reviews,3,2,5
845400,True,0,9 user reviews,2,7,9
845410,True,0,3 user reviews,1,2,3
845420,True,0,9 user reviews,5,4,9
845440,True,0,7 user reviews,0,7,7
845450,True,0,No user reviews,0,0,0
845460,True,0,3 user reviews,1,2,3
845470,True,0,No user reviews,0,0,0
845480,True,0,3 user reviews,0,3,3
845490,True,5,Mixed,22,12,34
845500,True,0,3 user reviews,0,3,3
845510,True,0,No user reviews,0,0,0
845520,True,0,9 user reviews,3,6,9
845530,True,4,Mostly Negative,9,17,26
845570,True,0,2 user reviews,0,2,2
845580,True,0,1 user reviews,1,0,1
845581,True,0,No user reviews,0,0,0
845582,True,0,1 user reviews,1,0,1
845590,True,0,9 user reviews,4,5,9
845600,True,0,4 user reviews,3,1,4
845630,True,0,8 user reviews,5,3,8
845640,True,8,Very Positive,246,29,275
845650,True,0,1 user reviews,1,0,1
845660,True,0,No user reviews,0,0,0
845690,True,7,Positive,30,1,31
845700,True,0,3 user reviews,3,0,3
845710,True,0,No user reviews,0,0,0
845730,True,0,8 user reviews,7,1,8
845750,True,0,7 user reviews,7,0,7
845800,True,0,1 user reviews,1,0,1
845820,True,0,3 user reviews,2,1,3
845830,True,0,No user reviews,0,0,0
845840,True,7,Positive,13,0,13
845860,True,0,5 user reviews,4,1,5
845870,True,0,1 user reviews,0,1,1
845880,True,8,Very Positive,108,7,115
845900,True,6,Mostly Positive,25,8,33
845910,True,0,3 user reviews,3,0,3
845920,True,0,No user reviews,0,0,0
845930,True,0,No user reviews,0,0,0
845940,True,0,8 user reviews,7,1,8
845950,True,0,No user reviews,0,0,0
845960,True,0,9 user reviews,4,5,9
845970,True,0,7 user reviews,4,3,7
845980,True,0,2 user reviews,1,1,2
845990,True,0,No user reviews,0,0,0
846000,True,0,No user reviews,0,0,0
846010,True,5,Mixed,8,4,12
846020,True,0,5 user reviews,3,2,5
846030,True,8,Very Positive,68,9,77
846040,True,0,No user reviews,0,0,0
846050,True,5,Mixed,11,15,26
846080,True,7,Positive,16,2,18
846100,True,0,1 user reviews,1,0,1
846110,True,8,Very Positive,199,19,218
846120,True,0,1 user reviews,0,1,1
846130,True,0,4 user reviews,4,0,4
846140,True,0,No user reviews,0,0,0
846200,True,5,Mixed,15,14,29
846210,True,0,No user reviews,0,0,0
846220,True,0,1 user reviews,1,0,1
846230,True,0,No user reviews,0,0,0
846250,True,0,4 user reviews,2,2,4
846260,True,0,No user reviews,0,0,0
846280,True,0,No user reviews,0,0,0
846290,True,0,No user reviews,0,0,0
846310,True,0,3 user reviews,2,1,3
846320,True,0,No user reviews,0,0,0
846330,True,0,1 user reviews,1,0,1
846340,True,0,No user reviews,0,0,0
846350,True,0,No user reviews,0,0,0
846360,True,0,1 user reviews,1,0,1
846370,True,0,No user reviews,0,0,0
846400,True,0,1 user reviews,0,1,1
846410,True,0,No user reviews,0,0,0
846420,True,0,No user reviews,0,0,0
846421,True,0,1 user reviews,0,1,1
846450,True,0,No user reviews,0,0,0
846470,True,8,Very Positive,846,59,905
846480,True,0,No user reviews,0,0,0
846490,True,0,2 user reviews,2,0,2
846500,True,0,No user reviews,0,0,0
846520,True,0,No user reviews,0,0,0
846530,True,0,1 user reviews,0,1,1
846560,True,0,No user reviews,0,0,0
846570,True,0,No user reviews,0,0,0
846580,True,0,1 user reviews,1,0,1
846590,True,0,1 user reviews,1,0,1
846610,True,0,No user reviews,0,0,0
846620,True,0,No user reviews,0,0,0
846621,True,0,No user reviews,0,0,0
846630,True,0,No user reviews,0,0,0
846650,True,0,1 user reviews,1,0,1
846660,True,0,No user reviews,0,0,0
846670,True,0,3 user reviews,3,0,3
846680,True,0,No user reviews,0,0,0
846690,True,7,Positive,16,4,20
846700,True,7,Positive,12,1,13
846710,True,7,Positive,15,3,18
846720,True,0,3 user reviews,3,0,3
846730,True,5,Mixed,34,17,51
846740,True,0,No user reviews,0,0,0
846750,True,0,No user reviews,0,0,0
846760,True,0,No user reviews,0,0,0
846770,True,0,No user reviews,0,0,0
846780,True,0,No user reviews,0,0,0
846790,True,6,Mostly Positive,7,3,10
846800,True,8,Very Positive,191,25,216
846820,True,5,Mixed,11,6,17
846830,True,5,Mixed,8,6,14
846840,True,0,No user reviews,0,0,0
846850,True,0,5 user reviews,1,4,5
846860,True,0,No user reviews,0,0,0
846870,True,8,Very Positive,210,20,230
846880,True,8,Very Positive,155,9,164
846900,True,0,No user reviews,0,0,0
846910,True,0,No user reviews,0,0,0
846920,True,0,No user reviews,0,0,0
846930,True,0,No user reviews,0,0,0
846940,True,0,No user reviews,0,0,0
846950,True,0,No user reviews,0,0,0
846960,True,0,No user reviews,0,0,0
846970,True,0,No user reviews,0,0,0
846980,True,0,No user reviews,0,0,0
846990,True,0,No user reviews,0,0,0
847000,True,0,No user reviews,0,0,0
847010,True,0,1 user reviews,1,0,1
847020,True,0,No user reviews,0,0,0
847030,True,0,No user reviews,0,0,0
847040,True,0,No user reviews,0,0,0
847041,True,0,No user reviews,0,0,0
847042,True,0,No user reviews,0,0,0
847043,True,0,No user reviews,0,0,0
847044,True,0,No user reviews,0,0,0
847045,True,0,No user reviews,0,0,0
847046,True,0,No user reviews,0,0,0
847047,True,0,No user reviews,0,0,0
847048,True,0,No user reviews,0,0,0
847049,True,0,No user reviews,0,0,0
847050,True,0,No user reviews,0,0,0
847060,True,0,No user reviews,0,0,0
847061,True,0,No user reviews,0,0,0
847062,True,0,No user reviews,0,0,0
847063,True,0,No user reviews,0,0,0
847064,True,0,No user reviews,0,0,0
847065,True,0,No user reviews,0,0,0
847066,True,0,No user reviews,0,0,0
847067,True,0,No user reviews,0,0,0
847068,True,0,No user reviews,0,0,0
847069,True,0,No user reviews,0,0,0
847070,True,0,No user reviews,0,0,0
847071,True,0,No user reviews,0,0,0
847072,True,0,No user reviews,0,0,0
847073,True,0,No user reviews,0,0,0
847074,True,0,No user reviews,0,0,0
847075,True,0,No user reviews,0,0,0
847076,True,0,No user reviews,0,0,0
847077,True,0,No user reviews,0,0,0
847078,True,0,No user reviews,0,0,0
847079,True,0,No user reviews,0,0,0
847080,True,0,No user reviews,0,0,0
847081,True,0,No user reviews,0,0,0
847090,True,0,No user reviews,0,0,0
847100,True,0,No user reviews,0,0,0
847110,True,0,No user reviews,0,0,0
847120,True,0,No user reviews,0,0,0
847121,True,0,No user reviews,0,0,0
847122,True,0,No user reviews,0,0,0
847123,True,0,No user reviews,0,0,0
847124,True,0,No user reviews,0,0,0
847125,True,0,No user reviews,0,0,0
847126,True,0,No user reviews,0,0,0
847127,True,0,No user reviews,0,0,0
847128,True,0,No user reviews,0,0,0
847129,True,0,No user reviews,0,0,0
847130,True,0,No user reviews,0,0,0
847131,True,0,No user reviews,0,0,0
847132,True,0,No user reviews,0,0,0
847133,True,0,No user reviews,0,0,0
847134,True,0,No user reviews,0,0,0
847135,True,0,No user reviews,0,0,0
847136,True,0,No user reviews,0,0,0
847137,True,0,No user reviews,0,0,0
847138,True,0,No user reviews,0,0,0
847139,True,0,No user reviews,0,0,0
847140,True,0,No user reviews,0,0,0
847141,True,0,No user reviews,0,0,0
847180,True,0,No user reviews,0,0,0
847181,True,0,No user reviews,0,0,0
847182,True,0,No user reviews,0,0,0
847183,True,0,No user reviews,0,0,0
847184,True,0,No user reviews,0,0,0
847185,True,0,No user reviews,0,0,0
847186,True,0,No user reviews,0,0,0
847187,True,0,No user reviews,0,0,0
847188,True,0,No user reviews,0,0,0
847189,True,0,No user reviews,0,0,0
847190,True,0,No user reviews,0,0,0
847191,True,0,No user reviews,0,0,0
847192,True,0,No user reviews,0,0,0
847193,True,0,No user reviews,0,0,0
847194,True,0,No user reviews,0,0,0
847195,True,0,No user reviews,0,0,0
847196,True,0,No user reviews,0,0,0
847197,True,0,No user reviews,0,0,0
847198,True,0,No user reviews,0,0,0
847199,True,0,No user reviews,0,0,0
847200,True,0,No user reviews,0,0,0
847201,True,0,No user reviews,0,0,0
847210,True,7,Positive,10,0,10
847230,True,0,4 user reviews,3,1,4
847240,True,0,9 user reviews,7,2,9
847260,True,4,Mostly Negative,4,7,11
847270,True,0,No user reviews,0,0,0
847271,True,0,No user reviews,0,0,0
847272,True,0,No user reviews,0,0,0
847273,True,0,No user reviews,0,0,0
847274,True,0,No user reviews,0,0,0
847275,True,0,No user reviews,0,0,0
847276,True,0,No user reviews,0,0,0
847277,True,0,No user reviews,0,0,0
847278,True,0,No user reviews,0,0,0
847279,True,0,No user reviews,0,0,0
847280,True,0,No user reviews,0,0,0
847281,True,0,No user reviews,0,0,0
847282,True,0,No user reviews,0,0,0
847290,True,7,Positive,20,2,22
847300,True,0,5 user reviews,2,3,5
847310,True,0,6 user reviews,2,4,6
847320,True,0,No user reviews,0,0,0
847321,True,0,No user reviews,0,0,0
847322,True,0,No user reviews,0,0,0
847323,True,0,No user reviews,0,0,0
847324,True,0,No user reviews,0,0,0
847325,True,0,No user reviews,0,0,0
847326,True,0,No user reviews,0,0,0
847327,True,0,No user reviews,0,0,0
847328,True,0,No user reviews,0,0,0
847329,True,0,No user reviews,0,0,0
847330,True,0,No user reviews,0,0,0
847331,True,0,No user reviews,0,0,0
847332,True,0,No user reviews,0,0,0
847333,True,0,No user reviews,0,0,0
847334,True,0,No user reviews,0,0,0
847335,True,0,No user reviews,0,0,0
847340,True,0,No user reviews,0,0,0
847341,True,0,No user reviews,0,0,0
847342,True,0,No user reviews,0,0,0
847343,True,0,No user reviews,0,0,0
847344,True,0,No user reviews,0,0,0
847345,True,0,No user reviews,0,0,0
847346,True,0,No user reviews,0,0,0
847347,True,0,No user reviews,0,0,0
847348,True,0,No user reviews,0,0,0
847349,True,0,No user reviews,0,0,0
847350,True,0,No user reviews,0,0,0
847351,True,0,No user reviews,0,0,0
847352,True,0,No user reviews,0,0,0
847353,True,0,No user reviews,0,0,0
847354,True,0,No user reviews,0,0,0
847355,True,0,No user reviews,0,0,0
847360,True,8,Very Positive,143,20,163
847370,True,8,Very Positive,2320,225,2545
847390,True,0,5 user reviews,4,1,5
847400,True,0,No user reviews,0,0,0
847410,True,0,No user reviews,0,0,0
847411,True,0,No user reviews,0,0,0
847412,True,0,No user reviews,0,0,0
847413,True,0,No user reviews,0,0,0
847414,True,0,No user reviews,0,0,0
847415,True,0,No user reviews,0,0,0
847416,True,0,No user reviews,0,0,0
847417,True,0,No user reviews,0,0,0
847418,True,0,No user reviews,0,0,0
847420,True,0,1 user reviews,0,1,1
847421,True,0,1 user reviews,0,1,1
847422,True,0,1 user reviews,1,0,1
847423,True,0,6 user reviews,5,1,6
847440,True,0,No user reviews,0,0,0
847450,True,0,3 user reviews,2,1,3
847460,True,0,No user reviews,0,0,0
847470,True,0,No user reviews,0,0,0
847480,True,0,1 user reviews,1,0,1
847490,True,0,No user reviews,0,0,0
847510,True,0,No user reviews,0,0,0
847530,True,7,Positive,18,0,18
847540,True,0,2 user reviews,2,0,2
847550,True,0,No user reviews,0,0,0
847560,True,0,6 user reviews,6,0,6
847570,True,0,3 user reviews,1,2,3
847580,True,0,6 user reviews,1,5,6
847590,True,0,7 user reviews,6,1,7
847600,True,0,No user reviews,0,0,0
847640,True,0,No user reviews,0,0,0
847650,True,0,No user reviews,0,0,0
847660,True,0,7 user reviews,2,5,7
847670,True,0,No user reviews,0,0,0
847700,True,0,No user reviews,0,0,0
847750,True,0,3 user reviews,3,0,3
847760,True,0,No user reviews,0,0,0
847770,True,0,No user reviews,0,0,0
847780,True,0,No user reviews,0,0,0
847790,True,0,No user reviews,0,0,0
847800,True,0,No user reviews,0,0,0
847810,True,0,1 user reviews,1,0,1
847820,True,0,1 user reviews,1,0,1
847850,True,0,No user reviews,0,0,0
847860,True,0,2 user reviews,1,1,2
847890,True,0,No user reviews,0,0,0
847900,True,0,2 user reviews,2,0,2
847940,True,0,2 user reviews,2,0,2
847950,True,7,Positive,23,5,28
847990,True,0,No user reviews,0,0,0
848000,True,0,No user reviews,0,0,0
848010,True,6,Mostly Positive,60,22,82
848020,True,7,Positive,43,2,45
848030,True,8,Very Positive,88,20,108
848040,True,0,No user reviews,0,0,0
848041,True,0,No user reviews,0,0,0
848042,True,0,No user reviews,0,0,0
848043,True,0,No user reviews,0,0,0
848060,True,7,Positive,23,2,25
848070,True,0,No user reviews,0,0,0
848080,True,0,No user reviews,0,0,0
848090,True,0,No user reviews,0,0,0
848100,True,0,1 user reviews,1,0,1
848110,True,0,4 user reviews,2,2,4
848120,True,0,No user reviews,0,0,0
848130,True,0,No user reviews,0,0,0
848140,True,0,No user reviews,0,0,0
848150,True,0,2 user reviews,0,2,2
848160,True,0,No user reviews,0,0,0
848180,True,0,No user reviews,0,0,0
848190,True,0,No user reviews,0,0,0
848200,True,7,Positive,10,2,12
848210,True,0,No user reviews,0,0,0
848230,True,0,3 user reviews,2,1,3
848260,True,0,7 user reviews,3,4,7
848270,True,0,3 user reviews,2,1,3
848280,True,7,Positive,23,0,23
848300,True,5,Mixed,10,8,18
848310,True,5,Mixed,26,28,54
848320,True,0,8 user reviews,8,0,8
848330,True,0,5 user reviews,5,0,5
848340,True,0,No user reviews,0,0,0
848350,True,8,Very Positive,1342,116,1458
848370,True,0,No user reviews,0,0,0
848400,True,0,No user reviews,0,0,0
848410,True,6,Mostly Positive,11,3,14
848420,True,0,No user reviews,0,0,0
848430,True,0,2 user reviews,1,1,2
848440,True,0,No user reviews,0,0,0
848450,True,8,Very Positive,11774,835,12609
848460,True,0,No user reviews,0,0,0
848470,True,0,1 user reviews,1,0,1
848480,True,0,No user reviews,0,0,0
848490,True,0,No user reviews,0,0,0
848500,True,0,No user reviews,0,0,0
848520,True,7,Positive,13,1,14
848530,True,7,Positive,9,2,11
848550,True,0,4 user reviews,3,1,4
848590,True,0,No user reviews,0,0,0
848610,True,0,2 user reviews,0,2,2
848630,True,0,3 user reviews,2,1,3
848660,True,0,3 user reviews,3,0,3
848700,True,0,No user reviews,0,0,0
848710,True,0,5 user reviews,3,2,5
848720,True,0,No user reviews,0,0,0
848730,True,0,4 user reviews,0,4,4
848740,True,0,1 user reviews,1,0,1
848750,True,0,No user reviews,0,0,0
848760,True,0,1 user reviews,1,0,1
848770,True,0,8 user reviews,8,0,8
848780,True,0,No user reviews,0,0,0
848790,True,0,7 user reviews,4,3,7
848810,True,0,1 user reviews,1,0,1
848840,True,0,No user reviews,0,0,0
848850,True,0,No user reviews,0,0,0
848890,True,0,5 user reviews,1,4,5
848920,True,0,1 user reviews,1,0,1
848930,True,7,Positive,23,1,24
848960,True,0,2 user reviews,1,1,2
848970,True,0,2 user reviews,2,0,2
848980,True,0,No user reviews,0,0,0
848990,True,0,4 user reviews,4,0,4
848991,True,0,1 user reviews,1,0,1
849000,True,0,5 user reviews,5,0,5
849010,True,0,No user reviews,0,0,0
849030,True,0,No user reviews,0,0,0
849040,True,0,No user reviews,0,0,0
849050,True,0,No user reviews,0,0,0
849070,True,0,5 user reviews,1,4,5
849090,True,0,No user reviews,0,0,0
849100,True,0,No user reviews,0,0,0
849130,True,0,No user reviews,0,0,0
849140,True,0,1 user reviews,1,0,1
849160,True,0,No user reviews,0,0,0
849161,True,0,No user reviews,0,0,0
849162,True,0,No user reviews,0,0,0
849163,True,0,No user reviews,0,0,0
849164,True,0,No user reviews,0,0,0
849165,True,0,No user reviews,0,0,0
849166,True,0,No user reviews,0,0,0
849167,True,0,No user reviews,0,0,0
849168,True,0,No user reviews,0,0,0
849170,True,0,No user reviews,0,0,0
849176,True,0,No user reviews,0,0,0
849177,True,0,No user reviews,0,0,0
849178,True,0,No user reviews,0,0,0
849179,True,0,No user reviews,0,0,0
849180,True,0,No user reviews,0,0,0
849186,True,0,No user reviews,0,0,0
849187,True,0,No user reviews,0,0,0
849200,True,0,No user reviews,0,0,0
849210,True,7,Positive,12,1,13
849230,True,0,3 user reviews,2,1,3
849240,True,0,No user reviews,0,0,0
849260,True,5,Mixed,14,11,25
849261,True,5,Mixed,15,11,26
849262,True,5,Mixed,34,28,62
849270,True,0,5 user reviews,5,0,5
849280,True,0,No user reviews,0,0,0
849290,True,0,No user reviews,0,0,0
849300,True,5,Mixed,11,8,19
849301,True,5,Mixed,5,6,11
849302,True,5,Mixed,7,6,13
849303,True,5,Mixed,10,6,16
849304,True,4,Mostly Negative,5,8,13
849305,True,4,Mostly Negative,5,9,14
849306,True,4,Mostly Negative,19,29,48
849307,True,5,Mixed,24,13,37
849308,True,5,Mixed,19,9,28
849309,True,6,Mostly Positive,19,5,24
849310,True,5,Mixed,9,8,17
849311,True,6,Mostly Positive,15,5,20
849320,True,0,No user reviews,0,0,0
849330,True,0,No user reviews,0,0,0
849350,True,0,No user reviews,0,0,0
849360,True,0,No user reviews,0,0,0
849370,True,0,No user reviews,0,0,0
849390,True,0,2 user reviews,1,1,2
849410,True,0,No user reviews,0,0,0
849420,True,0,2 user reviews,0,2,2
849520,True,0,7 user reviews,6,1,7
849530,True,0,No user reviews,0,0,0
849540,True,0,3 user reviews,3,0,3
849560,True,6,Mostly Positive,8,3,11
849570,True,0,No user reviews,0,0,0
849600,True,0,6 user reviews,3,3,6
849620,True,0,6 user reviews,4,2,6
849630,True,0,5 user reviews,5,0,5
849670,True,7,Positive,14,3,17
849680,True,7,Positive,15,0,15
849690,True,0,4 user reviews,2,2,4
849700,True,0,No user reviews,0,0,0
849740,True,8,Very Positive,309,20,329
849750,True,0,No user reviews,0,0,0
849760,True,0,No user reviews,0,0,0
849790,True,6,Mostly Positive,13,4,17
849800,True,0,4 user reviews,4,0,4
849840,True,0,2 user reviews,1,1,2
849860,True,0,5 user reviews,0,5,5
849870,True,0,1 user reviews,0,1,1
849880,True,0,No user reviews,0,0,0
849890,True,0,No user reviews,0,0,0
849920,True,0,4 user reviews,4,0,4
849930,True,0,5 user reviews,5,0,5
849931,True,0,4 user reviews,4,0,4
849940,True,5,Mixed,13,9,22
849950,True,0,No user reviews,0,0,0
849970,True,0,1 user reviews,0,1,1
849980,True,0,1 user reviews,1,0,1
850000,True,8,Very Positive,67,10,77
850010,True,5,Mixed,186,135,321
850020,True,0,No user reviews,0,0,0
850030,True,0,No user reviews,0,0,0
850040,True,7,Positive,12,0,12
850050,True,6,Mostly Positive,34,13,47
850060,True,5,Mixed,16,7,23
850110,True,0,No user reviews,0,0,0
850130,True,0,No user reviews,0,0,0
850150,True,0,No user reviews,0,0,0
850160,True,0,No user reviews,0,0,0
850200,True,0,No user reviews,0,0,0
850210,True,6,Mostly Positive,76,26,102
850220,True,0,No user reviews,0,0,0
850230,True,0,No user reviews,0,0,0
850240,True,0,No user reviews,0,0,0
850250,True,0,5 user reviews,1,4,5
850260,True,7,Positive,9,2,11
850270,True,0,No user reviews,0,0,0
850280,True,0,1 user reviews,1,0,1
850281,True,0,1 user reviews,1,0,1
850290,True,0,No user reviews,0,0,0
850310,True,0,No user reviews,0,0,0
850320,True,0,No user reviews,0,0,0
850330,True,0,No user reviews,0,0,0
850340,True,0,1 user reviews,1,0,1
850350,True,0,No user reviews,0,0,0
850360,True,0,No user reviews,0,0,0
850370,True,0,No user reviews,0,0,0
850380,True,0,No user reviews,0,0,0
850390,True,0,No user reviews,0,0,0
850400,True,0,No user reviews,0,0,0
850410,True,0,No user reviews,0,0,0
850420,True,0,No user reviews,0,0,0
850430,True,0,No user reviews,0,0,0
850440,True,0,No user reviews,0,0,0
850450,True,5,Mixed,67,49,116
850470,True,0,No user reviews,0,0,0
850480,True,0,No user reviews,0,0,0
850481,True,0,No user reviews,0,0,0
850482,True,0,No user reviews,0,0,0
850483,True,0,No user reviews,0,0,0
850484,True,0,No user reviews,0,0,0
850485,True,0,No user reviews,0,0,0
850486,True,0,No user reviews,0,0,0
850487,True,0,No user reviews,0,0,0
850488,True,0,No user reviews,0,0,0
850489,True,0,No user reviews,0,0,0
850490,True,0,No user reviews,0,0,0
850491,True,0,No user reviews,0,0,0
850492,True,0,No user reviews,0,0,0
850493,True,0,No user reviews,0,0,0
850494,True,0,No user reviews,0,0,0
850495,True,0,No user reviews,0,0,0
850496,True,0,No user reviews,0,0,0
850497,True,0,No user reviews,0,0,0
850498,True,0,No user reviews,0,0,0
850500,True,0,No user reviews,0,0,0
850530,True,0,No user reviews,0,0,0
850540,True,0,No user reviews,0,0,0
850550,True,0,No user reviews,0,0,0
850560,True,0,No user reviews,0,0,0
850570,True,0,No user reviews,0,0,0
850580,True,0,No user reviews,0,0,0
850600,True,0,No user reviews,0,0,0
850610,True,0,No user reviews,0,0,0
850620,True,0,No user reviews,0,0,0
850630,True,6,Mostly Positive,50,15,65
850640,True,0,No user reviews,0,0,0
850650,True,0,No user reviews,0,0,0
850660,True,0,No user reviews,0,0,0
850670,True,0,No user reviews,0,0,0
850680,True,0,No user reviews,0,0,0
850690,True,5,Mixed,35,23,58
850700,True,0,No user reviews,0,0,0
850710,True,0,No user reviews,0,0,0
850740,True,0,2 user reviews,1,1,2
850750,True,0,No user reviews,0,0,0
850760,True,0,No user reviews,0,0,0
850780,True,5,Mixed,9,4,13
850800,True,0,No user reviews,0,0,0
850810,True,0,2 user reviews,2,0,2
850820,True,0,No user reviews,0,0,0
850830,True,0,4 user reviews,0,4,4
850840,True,0,4 user reviews,3,1,4
850850,True,0,8 user reviews,8,0,8
850880,True,0,2 user reviews,2,0,2
850920,True,0,5 user reviews,5,0,5
850930,True,0,1 user reviews,1,0,1
850940,True,0,8 user reviews,3,5,8
850950,True,0,3 user reviews,1,2,3
850960,True,0,4 user reviews,1,3,4
850970,True,0,No user reviews,0,0,0
850980,True,7,Positive,38,5,43
850990,True,0,No user reviews,0,0,0
851000,True,7,Positive,35,4,39
851010,True,0,3 user reviews,0,3,3
851040,True,0,2 user reviews,1,1,2
851050,True,4,Mostly Negative,4,7,11
851100,True,9,Overwhelmingly Positive,2302,51,2353
851110,True,0,No user reviews,0,0,0
851150,True,7,Positive,28,5,33
851180,True,7,Positive,25,5,30
851200,True,6,Mostly Positive,7,3,10
851210,True,0,No user reviews,0,0,0
851220,True,0,No user reviews,0,0,0
851240,True,0,No user reviews,0,0,0
851250,True,0,5 user reviews,2,3,5
851270,True,0,1 user reviews,1,0,1
851271,True,0,1 user reviews,1,0,1
851272,True,0,1 user reviews,1,0,1
851273,True,0,1 user reviews,1,0,1
851274,True,0,No user reviews,0,0,0
851275,True,0,No user reviews,0,0,0
851278,True,0,No user reviews,0,0,0
851279,True,0,1 user reviews,1,0,1
851280,True,5,Mixed,39,17,56
851290,True,0,No user reviews,0,0,0
851310,True,0,No user reviews,0,0,0
851312,True,0,No user reviews,0,0,0
851313,True,0,No user reviews,0,0,0
851318,True,0,No user reviews,0,0,0
851320,True,0,No user reviews,0,0,0
851350,True,0,9 user reviews,4,5,9
851360,True,0,No user reviews,0,0,0
851370,True,0,8 user reviews,4,4,8
851396,True,0,No user reviews,0,0,0
851397,True,0,No user reviews,0,0,0
851398,True,0,No user reviews,0,0,0
851470,True,0,No user reviews,0,0,0
851490,True,0,No user reviews,0,0,0
851500,True,0,No user reviews,0,0,0
851510,True,0,No user reviews,0,0,0
851520,True,0,5 user reviews,2,3,5
851530,True,0,No user reviews,0,0,0
851570,True,0,3 user reviews,0,3,3
851580,True,0,3 user reviews,2,1,3
851590,True,0,No user reviews,0,0,0
851600,True,0,No user reviews,0,0,0
851601,True,0,1 user reviews,0,1,1
851610,True,0,No user reviews,0,0,0
851620,True,0,No user reviews,0,0,0
851640,True,7,Positive,30,4,34
851650,True,0,No user reviews,0,0,0
851670,True,8,Very Positive,144,6,150
851690,True,0,No user reviews,0,0,0
851710,True,0,4 user reviews,2,2,4
851730,True,7,Positive,39,3,42
851750,True,0,No user reviews,0,0,0
851770,True,0,1 user reviews,1,0,1
851780,True,0,No user reviews,0,0,0
851790,True,6,Mostly Positive,12,4,16
851800,True,7,Positive,40,6,46
851810,True,0,No user reviews,0,0,0
851820,True,5,Mixed,15,7,22
851840,True,0,7 user reviews,7,0,7
851850,True,8,Very Positive,4955,485,5440
851860,True,0,5 user reviews,5,0,5
851870,True,0,5 user reviews,5,0,5
851880,True,0,9 user reviews,6,3,9
851890,True,8,Very Positive,199,23,222
851900,True,0,No user reviews,0,0,0
851910,True,0,No user reviews,0,0,0
851920,True,0,4 user reviews,1,3,4
851930,True,6,Mostly Positive,151,58,209
851940,True,0,8 user reviews,3,5,8
851950,True,7,Positive,21,3,24
851960,True,0,No user reviews,0,0,0
851970,True,0,No user reviews,0,0,0
851980,True,5,Mixed,5,5,10
852000,True,0,3 user reviews,2,1,3
852020,True,0,No user reviews,0,0,0
852030,True,0,No user reviews,0,0,0
852090,True,7,Positive,31,0,31
852100,True,0,No user reviews,0,0,0
852110,True,8,Very Positive,214,8,222
852130,True,0,No user reviews,0,0,0
852160,True,5,Mixed,6,6,12
852180,True,5,Mixed,4,6,10
852190,True,0,4 user reviews,4,0,4
852200,True,0,No user reviews,0,0,0
852220,True,8,Very Positive,59,12,71
852240,True,0,No user reviews,0,0,0
852250,True,0,No user reviews,0,0,0
852270,True,0,No user reviews,0,0,0
852290,True,0,No user reviews,0,0,0
852300,True,6,Mostly Positive,87,27,114
852310,True,0,No user reviews,0,0,0
852320,True,0,1 user reviews,1,0,1
852340,True,0,No user reviews,0,0,0
852370,True,0,No user reviews,0,0,0
852390,True,0,9 user reviews,9,0,9
852420,True,0,No user reviews,0,0,0
852440,True,0,No user reviews,0,0,0
852450,True,0,No user reviews,0,0,0
852470,True,0,No user reviews,0,0,0
852480,True,8,Very Positive,471,28,499
852500,True,0,No user reviews,0,0,0
852530,True,0,1 user reviews,1,0,1
852560,True,0,No user reviews,0,0,0
852570,True,0,2 user reviews,1,1,2
852580,True,0,1 user reviews,1,0,1
852590,True,0,2 user reviews,1,1,2
852610,True,0,No user reviews,0,0,0
852620,True,0,No user reviews,0,0,0
852630,True,0,4 user reviews,3,1,4
852640,True,0,No user reviews,0,0,0
852650,True,0,1 user reviews,0,1,1
852660,True,0,6 user reviews,4,2,6
852710,True,0,No user reviews,0,0,0
852720,True,5,Mixed,7,4,11
852750,True,0,No user reviews,0,0,0
852760,True,0,1 user reviews,1,0,1
852790,True,7,Positive,17,4,21
852800,True,0,No user reviews,0,0,0
852830,True,0,No user reviews,0,0,0
852840,True,0,No user reviews,0,0,0
852850,True,0,No user reviews,0,0,0
852860,True,0,No user reviews,0,0,0
852870,True,0,No user reviews,0,0,0
852880,True,0,No user reviews,0,0,0
852890,True,0,No user reviews,0,0,0
852900,True,7,Positive,18,1,19
852910,True,8,Very Positive,53,9,62
852920,True,0,1 user reviews,1,0,1
852930,True,0,No user reviews,0,0,0
852940,True,0,No user reviews,0,0,0
852970,True,0,No user reviews,0,0,0
852980,True,0,No user reviews,0,0,0
852991,True,0,2 user reviews,1,1,2
852992,True,0,3 user reviews,2,1,3
852993,True,0,1 user reviews,1,0,1
852994,True,0,1 user reviews,1,0,1
852995,True,0,5 user reviews,4,1,5
852996,True,0,No user reviews,0,0,0
853000,True,0,No user reviews,0,0,0
853011,True,0,No user reviews,0,0,0
853012,True,0,No user reviews,0,0,0
853013,True,0,No user reviews,0,0,0
853014,True,0,1 user reviews,0,1,1
853015,True,0,No user reviews,0,0,0
853020,True,0,4 user reviews,1,3,4
853040,True,0,5 user reviews,3,2,5
853050,True,0,No user reviews,0,0,0
853110,True,7,Positive,14,1,15
853120,True,0,4 user reviews,2,2,4
853140,True,6,Mostly Positive,159,42,201
853150,True,0,No user reviews,0,0,0
853170,True,0,1 user reviews,1,0,1
853180,True,0,1 user reviews,0,1,1
853190,True,0,No user reviews,0,0,0
853200,True,7,Positive,39,5,44
853210,True,0,9 user reviews,4,5,9
853220,True,0,1 user reviews,0,1,1
853230,True,0,No user reviews,0,0,0
853240,True,5,Mixed,56,33,89
853250,True,0,No user reviews,0,0,0
853260,True,0,3 user reviews,3,0,3
853270,True,0,No user reviews,0,0,0
853280,True,0,3 user reviews,2,1,3
853281,True,0,No user reviews,0,0,0
853282,True,0,No user reviews,0,0,0
853290,True,0,1 user reviews,1,0,1
853300,True,0,8 user reviews,7,1,8
853310,True,7,Positive,12,1,13
853320,True,0,No user reviews,0,0,0
853330,True,0,1 user reviews,1,0,1
853360,True,8,Very Positive,126,26,152
853370,True,0,No user reviews,0,0,0
853380,True,5,Mixed,9,4,13
853390,True,0,No user reviews,0,0,0
853410,True,0,3 user reviews,3,0,3
853440,True,0,No user reviews,0,0,0
853450,True,0,No user reviews,0,0,0
853460,True,0,No user reviews,0,0,0
853480,True,7,Positive,15,2,17
853500,True,8,Very Positive,266,35,301
853530,True,0,No user reviews,0,0,0
853531,True,0,No user reviews,0,0,0
853532,True,0,No user reviews,0,0,0
853533,True,0,No user reviews,0,0,0
853534,True,0,No user reviews,0,0,0
853535,True,0,No user reviews,0,0,0
853536,True,0,No user reviews,0,0,0
853537,True,0,No user reviews,0,0,0
853538,True,0,No user reviews,0,0,0
853539,True,0,No user reviews,0,0,0
853540,True,0,No user reviews,0,0,0
853541,True,0,No user reviews,0,0,0
853542,True,0,No user reviews,0,0,0
853543,True,0,No user reviews,0,0,0
853550,True,8,Very Positive,1432,98,1530
853580,True,0,3 user reviews,0,3,3
853590,True,0,5 user reviews,5,0,5
853600,True,0,No user reviews,0,0,0
853610,True,0,2 user reviews,2,0,2
853620,True,0,6 user reviews,3,3,6
853630,True,0,No user reviews,0,0,0
853631,True,0,No user reviews,0,0,0
853632,True,0,No user reviews,0,0,0
853633,True,0,No user reviews,0,0,0
853634,True,0,No user reviews,0,0,0
853635,True,0,No user reviews,0,0,0
853636,True,0,No user reviews,0,0,0
853637,True,0,No user reviews,0,0,0
853638,True,0,No user reviews,0,0,0
853639,True,0,No user reviews,0,0,0
853640,True,0,No user reviews,0,0,0
853641,True,0,No user reviews,0,0,0
853650,True,0,No user reviews,0,0,0
853700,True,0,1 user reviews,1,0,1
853730,True,0,No user reviews,0,0,0
853760,True,0,2 user reviews,0,2,2
853770,True,8,Very Positive,1542,169,1711
853780,True,0,No user reviews,0,0,0
853830,True,0,1 user reviews,1,0,1
853850,True,0,3 user reviews,2,1,3
853860,True,7,Positive,27,5,32
853870,True,0,No user reviews,0,0,0
853871,True,0,No user reviews,0,0,0
853872,True,0,No user reviews,0,0,0
853873,True,0,No user reviews,0,0,0
853874,True,0,No user reviews,0,0,0
853875,True,0,No user reviews,0,0,0
853876,True,0,No user reviews,0,0,0
853877,True,0,No user reviews,0,0,0
853881,True,0,No user reviews,0,0,0
853882,True,0,No user reviews,0,0,0
853883,True,0,No user reviews,0,0,0
853884,True,0,No user reviews,0,0,0
853885,True,0,No user reviews,0,0,0
853886,True,0,No user reviews,0,0,0
853887,True,0,No user reviews,0,0,0
853890,True,0,No user reviews,0,0,0
853940,True,0,6 user reviews,2,4,6
853980,True,0,No user reviews,0,0,0
854030,True,0,7 user reviews,2,5,7
854050,True,0,1 user reviews,0,1,1
854060,True,0,1 user reviews,1,0,1
854070,True,6,Mostly Positive,48,18,66
854110,True,0,No user reviews,0,0,0
854120,True,0,4 user reviews,4,0,4
854130,True,0,No user reviews,0,0,0
854150,True,0,1 user reviews,1,0,1
854160,True,0,6 user reviews,0,6,6
854180,True,0,No user reviews,0,0,0
854190,True,5,Mixed,10,5,15
854210,True,0,No user reviews,0,0,0
854220,True,0,6 user reviews,6,0,6
854230,True,0,1 user reviews,1,0,1
854240,True,0,2 user reviews,2,0,2
854250,True,7,Positive,29,5,34
854270,True,0,No user reviews,0,0,0
854290,True,7,Positive,10,0,10
854310,True,0,No user reviews,0,0,0
854320,True,0,No user reviews,0,0,0
854321,True,0,No user reviews,0,0,0
854330,True,0,No user reviews,0,0,0
854340,True,0,No user reviews,0,0,0
854370,True,0,No user reviews,0,0,0
854390,True,0,2 user reviews,2,0,2
854400,True,5,Mixed,6,4,10
854410,True,0,No user reviews,0,0,0
854420,True,0,No user reviews,0,0,0
854430,True,0,No user reviews,0,0,0
854450,True,7,Positive,11,0,11
854490,True,0,No user reviews,0,0,0
854500,True,0,2 user reviews,2,0,2
854510,True,0,1 user reviews,0,1,1
854520,True,0,No user reviews,0,0,0
854530,True,0,No user reviews,0,0,0
854540,True,0,No user reviews,0,0,0
854550,True,5,Mixed,5,7,12
854570,True,8,Very Positive,220,28,248
854600,True,0,No user reviews,0,0,0
854640,True,0,No user reviews,0,0,0
854650,True,0,1 user reviews,0,1,1
854660,True,0,No user reviews,0,0,0
854670,True,0,1 user reviews,1,0,1
854680,True,0,2 user reviews,1,1,2
854690,True,5,Mixed,5,6,11
854710,True,0,2 user reviews,0,2,2
854740,True,0,4 user reviews,2,2,4
854750,True,6,Mostly Positive,39,10,49
854770,True,5,Mixed,28,28,56
854780,True,0,1 user reviews,0,1,1
854800,True,0,No user reviews,0,0,0
854810,True,0,7 user reviews,1,6,7
854820,True,0,No user reviews,0,0,0
854830,True,0,7 user reviews,7,0,7
854860,True,8,Very Positive,258,17,275
854870,True,7,Positive,9,1,10
854880,True,0,No user reviews,0,0,0
854890,True,5,Mixed,18,14,32
854900,True,0,No user reviews,0,0,0
854910,True,0,No user reviews,0,0,0
854940,True,8,Very Positive,117,6,123
854950,True,0,2 user reviews,2,0,2
854960,True,7,Positive,28,5,33
854961,True,0,2 user reviews,2,0,2
854980,True,0,No user reviews,0,0,0
854990,True,0,No user reviews,0,0,0
855010,True,0,No user reviews,0,0,0
855020,True,0,No user reviews,0,0,0
855030,True,0,4 user reviews,2,2,4
855040,True,0,No user reviews,0,0,0
855050,True,0,5 user reviews,3,2,5
855060,True,0,No user reviews,0,0,0
855100,True,0,5 user reviews,3,2,5
855120,True,0,No user reviews,0,0,0
855130,True,0,No user reviews,0,0,0
855150,True,0,No user reviews,0,0,0
855151,True,0,No user reviews,0,0,0
855152,True,0,No user reviews,0,0,0
855160,True,0,2 user reviews,0,2,2
855170,True,4,Mostly Negative,7,11,18
855180,True,0,No user reviews,0,0,0
855190,True,6,Mostly Positive,17,7,24
855220,True,0,2 user reviews,2,0,2
855230,True,0,1 user reviews,1,0,1
855240,True,0,No user reviews,0,0,0
855250,True,0,2 user reviews,2,0,2
855260,True,0,1 user reviews,1,0,1
855270,True,0,1 user reviews,1,0,1
855280,True,0,1 user reviews,1,0,1
855290,True,0,1 user reviews,1,0,1
855300,True,0,1 user reviews,1,0,1
855310,True,0,1 user reviews,1,0,1
855320,True,5,Mixed,6,8,14
855330,True,0,1 user reviews,1,0,1
855340,True,0,1 user reviews,1,0,1
855350,True,0,1 user reviews,1,0,1
855360,True,0,2 user reviews,2,0,2
855380,True,0,No user reviews,0,0,0
855390,True,0,No user reviews,0,0,0
855400,True,0,1 user reviews,1,0,1
855410,True,0,1 user reviews,1,0,1
855420,True,0,1 user reviews,1,0,1
855430,True,0,1 user reviews,1,0,1
855440,True,0,1 user reviews,1,0,1
855450,True,0,1 user reviews,1,0,1
855460,True,0,1 user reviews,1,0,1
855470,True,0,1 user reviews,1,0,1
855480,True,0,No user reviews,0,0,0
855490,True,0,4 user reviews,2,2,4
855510,True,0,1 user reviews,1,0,1
855530,True,0,6 user reviews,5,1,6
855550,True,0,No user reviews,0,0,0
855580,True,0,No user reviews,0,0,0
855610,True,0,No user reviews,0,0,0
855620,True,0,1 user reviews,1,0,1
855630,True,7,Positive,33,6,39
855640,True,8,Very Positive,208,8,216
855650,True,0,2 user reviews,2,0,2
855660,True,0,No user reviews,0,0,0
855670,True,0,No user reviews,0,0,0
855680,True,0,No user reviews,0,0,0
855700,True,0,3 user reviews,3,0,3
855710,True,0,No user reviews,0,0,0
855730,True,0,1 user reviews,1,0,1
855740,True,0,No user reviews,0,0,0
855760,True,0,1 user reviews,1,0,1
855770,True,0,1 user reviews,1,0,1
855780,True,0,No user reviews,0,0,0
855781,True,0,No user reviews,0,0,0
855782,True,0,No user reviews,0,0,0
855783,True,0,No user reviews,0,0,0
855784,True,0,No user reviews,0,0,0
855785,True,0,No user reviews,0,0,0
855786,True,0,No user reviews,0,0,0
855787,True,0,No user reviews,0,0,0
855788,True,0,No user reviews,0,0,0
855789,True,0,No user reviews,0,0,0
855790,True,0,No user reviews,0,0,0
855791,True,0,No user reviews,0,0,0
855792,True,0,No user reviews,0,0,0
855793,True,0,No user reviews,0,0,0
855800,True,0,1 user reviews,1,0,1
855810,True,0,No user reviews,0,0,0
855830,True,0,No user reviews,0,0,0
855850,True,8,Very Positive,46,8,54
855860,True,8,Very Positive,381,48,429
855880,True,0,No user reviews,0,0,0
855890,True,0,No user reviews,0,0,0
855900,True,0,No user reviews,0,0,0
855910,True,0,No user reviews,0,0,0
855920,True,0,No user reviews,0,0,0
855930,True,0,No user reviews,0,0,0
855940,True,0,9 user reviews,3,6,9
855970,True,5,Mixed,7,6,13
855980,True,0,No user reviews,0,0,0
855990,True,0,No user reviews,0,0,0
856000,True,0,No user reviews,0,0,0
856001,True,0,No user reviews,0,0,0
856010,True,5,Mixed,11,8,19
856020,True,0,No user reviews,0,0,0
856030,True,0,No user reviews,0,0,0
856040,True,0,1 user reviews,1,0,1
856050,True,0,No user reviews,0,0,0
856060,True,0,No user reviews,0,0,0
856070,True,0,No user reviews,0,0,0
856080,True,0,7 user reviews,4,3,7
856090,True,0,No user reviews,0,0,0
856100,True,0,2 user reviews,2,0,2
856110,True,0,8 user reviews,7,1,8
856120,True,7,Positive,28,3,31
856130,True,5,Mixed,24,21,45
856140,True,0,No user reviews,0,0,0
856141,True,0,No user reviews,0,0,0
856142,True,0,1 user reviews,1,0,1
856143,True,0,No user reviews,0,0,0
856144,True,0,No user reviews,0,0,0
856145,True,0,No user reviews,0,0,0
856146,True,0,No user reviews,0,0,0
856147,True,0,No user reviews,0,0,0
856148,True,0,No user reviews,0,0,0
856149,True,0,No user reviews,0,0,0
856150,True,0,No user reviews,0,0,0
856160,True,0,1 user reviews,1,0,1
856170,True,0,4 user reviews,3,1,4
856180,True,0,No user reviews,0,0,0
856190,True,0,No user reviews,0,0,0
856200,True,0,No user reviews,0,0,0
856210,True,6,Mostly Positive,47,18,65
856220,True,0,7 user reviews,5,2,7
856240,True,0,1 user reviews,1,0,1
856260,True,0,4 user reviews,0,4,4
856270,True,0,4 user reviews,4,0,4
856300,True,0,No user reviews,0,0,0
856310,True,0,No user reviews,0,0,0
856320,True,5,Mixed,14,10,24
856350,True,0,1 user reviews,0,1,1
856370,True,0,1 user reviews,1,0,1
856380,True,0,1 user reviews,1,0,1
856390,True,0,1 user reviews,1,0,1
856400,True,0,5 user reviews,3,2,5
856410,True,0,4 user reviews,0,4,4
856420,True,0,No user reviews,0,0,0
856430,True,0,9 user reviews,3,6,9
856440,True,0,5 user reviews,2,3,5
856450,True,7,Positive,12,1,13
856490,True,5,Mixed,6,5,11
856530,True,0,No user reviews,0,0,0
856540,True,7,Positive,41,1,42
856550,True,0,1 user reviews,1,0,1
856560,True,0,1 user reviews,1,0,1
856570,True,7,Positive,11,0,11
856600,True,0,No user reviews,0,0,0
856610,True,7,Positive,18,3,21
856620,True,0,No user reviews,0,0,0
856630,True,0,No user reviews,0,0,0
856640,True,0,No user reviews,0,0,0
856650,True,0,5 user reviews,5,0,5
856660,True,0,No user reviews,0,0,0
856670,True,0,1 user reviews,1,0,1
856680,True,0,No user reviews,0,0,0
856700,True,0,No user reviews,0,0,0
856710,True,0,No user reviews,0,0,0
856730,True,0,No user reviews,0,0,0
856750,True,0,5 user reviews,4,1,5
856760,True,0,3 user reviews,1,2,3
856770,True,0,No user reviews,0,0,0
856780,True,0,No user reviews,0,0,0
856790,True,0,5 user reviews,1,4,5
856820,True,0,No user reviews,0,0,0
856840,True,0,1 user reviews,0,1,1
856850,True,7,Positive,38,9,47
856880,True,0,9 user reviews,7,2,9
856890,True,0,No user reviews,0,0,0
856900,True,0,3 user reviews,3,0,3
856910,True,0,1 user reviews,1,0,1
856920,True,0,3 user reviews,3,0,3
856930,True,0,1 user reviews,1,0,1
856940,True,0,1 user reviews,1,0,1
856950,True,0,1 user reviews,1,0,1
856960,True,0,3 user reviews,3,0,3
856970,True,0,No user reviews,0,0,0
856971,True,0,No user reviews,0,0,0
856972,True,0,No user reviews,0,0,0
856980,True,0,7 user reviews,2,5,7
856990,True,5,Mixed,14,12,26
857010,True,5,Mixed,10,5,15
857020,True,0,5 user reviews,3,2,5
857050,True,5,Mixed,8,6,14
857060,True,5,Mixed,22,24,46
857080,True,7,Positive,36,6,42
857110,True,0,1 user reviews,0,1,1
857130,True,0,No user reviews,0,0,0
857140,True,0,5 user reviews,3,2,5
857150,True,0,No user reviews,0,0,0
857151,True,0,No user reviews,0,0,0
857152,True,0,No user reviews,0,0,0
857153,True,0,No user reviews,0,0,0
857180,True,5,Mixed,16,9,25
857200,True,7,Positive,19,2,21
857210,True,0,No user reviews,0,0,0
857230,True,0,No user reviews,0,0,0
857240,True,0,4 user reviews,0,4,4
857250,True,0,No user reviews,0,0,0
857260,True,0,No user reviews,0,0,0
857280,True,7,Positive,11,0,11
857300,True,0,7 user reviews,6,1,7
857320,True,7,Positive,40,7,47
857350,True,0,No user reviews,0,0,0
857370,True,0,9 user reviews,5,4,9
857380,True,0,1 user reviews,1,0,1
857381,True,0,1 user reviews,1,0,1
857390,True,0,3 user reviews,0,3,3
857410,True,0,No user reviews,0,0,0
857420,True,0,9 user reviews,7,2,9
857450,True,8,Very Positive,106,3,109
857460,True,0,6 user reviews,6,0,6
857470,True,7,Positive,12,3,15
857480,True,0,7 user reviews,7,0,7
857500,True,7,Positive,28,1,29
857510,True,0,2 user reviews,1,1,2
857520,True,0,5 user reviews,2,3,5
857540,True,0,7 user reviews,6,1,7
857570,True,0,3 user reviews,0,3,3
857590,True,0,No user reviews,0,0,0
857600,True,0,3 user reviews,2,1,3
857620,True,0,No user reviews,0,0,0
857630,True,0,3 user reviews,1,2,3
857640,True,0,No user reviews,0,0,0
857680,True,6,Mostly Positive,37,10,47
857690,True,8,Very Positive,47,4,51
857700,True,0,4 user reviews,1,3,4
857710,True,0,1 user reviews,1,0,1
857720,True,0,No user reviews,0,0,0
857740,True,0,2 user reviews,2,0,2
857760,True,0,No user reviews,0,0,0
857770,True,0,2 user reviews,2,0,2
857830,True,0,No user reviews,0,0,0
857850,True,0,5 user reviews,3,2,5
857860,True,0,5 user reviews,5,0,5
857880,True,0,1 user reviews,1,0,1
857890,True,0,No user reviews,0,0,0
857900,True,0,6 user reviews,4,2,6
857910,True,0,No user reviews,0,0,0
857940,True,0,9 user reviews,7,2,9
857950,True,0,5 user reviews,3,2,5
857960,True,0,No user reviews,0,0,0
857970,True,0,2 user reviews,2,0,2
857980,True,8,Very Positive,1523,202,1725
858010,True,0,1 user reviews,0,1,1
858020,True,0,No user reviews,0,0,0
858030,True,0,No user reviews,0,0,0
858040,True,7,Positive,18,4,22
858050,True,7,Positive,31,0,31
858060,True,0,No user reviews,0,0,0
858070,True,0,No user reviews,0,0,0
858080,True,0,2 user reviews,1,1,2
858090,True,0,No user reviews,0,0,0
858100,True,7,Positive,16,4,20
858110,True,0,No user reviews,0,0,0
858130,True,0,No user reviews,0,0,0
858170,True,0,3 user reviews,3,0,3
858180,True,0,6 user reviews,1,5,6
858210,True,9,Overwhelmingly Positive,1544,23,1567
858230,True,0,2 user reviews,2,0,2
858240,True,7,Positive,16,3,19
858250,True,6,Mostly Positive,9,3,12
858260,True,9,Overwhelmingly Positive,1047,45,1092
858270,True,0,1 user reviews,1,0,1
858290,True,0,No user reviews,0,0,0
858300,True,0,2 user reviews,1,1,2
858320,True,0,1 user reviews,1,0,1
858350,True,0,No user reviews,0,0,0
858360,True,7,Positive,41,5,46
858380,True,0,No user reviews,0,0,0
858420,True,0,5 user reviews,2,3,5
858440,True,0,2 user reviews,1,1,2
858450,True,0,No user reviews,0,0,0
858460,True,0,No user reviews,0,0,0
858480,True,0,No user reviews,0,0,0
858500,True,0,No user reviews,0,0,0
858560,True,0,No user reviews,0,0,0
858590,True,5,Mixed,254,139,393
858600,True,0,No user reviews,0,0,0
858610,True,0,No user reviews,0,0,0
858620,True,0,No user reviews,0,0,0
858630,True,7,Positive,34,5,39
858640,True,0,No user reviews,0,0,0
858660,True,0,No user reviews,0,0,0
858680,True,6,Mostly Positive,28,9,37
858690,True,0,8 user reviews,3,5,8
858700,True,0,No user reviews,0,0,0
858710,True,0,No user reviews,0,0,0
858720,True,0,No user reviews,0,0,0
858730,True,0,No user reviews,0,0,0
858740,True,0,No user reviews,0,0,0
858760,True,8,Very Positive,274,5,279
858770,True,0,No user reviews,0,0,0
858780,True,5,Mixed,8,7,15
858790,True,0,No user reviews,0,0,0
858800,True,0,No user reviews,0,0,0
858810,True,8,Very Positive,4964,807,5771
858820,True,0,No user reviews,0,0,0
858830,True,0,9 user reviews,9,0,9
858840,True,0,2 user reviews,1,1,2
858860,True,7,Positive,26,1,27
858870,True,7,Positive,9,2,11
858880,True,7,Positive,19,0,19
858900,True,0,No user reviews,0,0,0
858930,True,0,7 user reviews,2,5,7
858940,True,7,Positive,49,0,49
858950,True,0,No user reviews,0,0,0
858960,True,0,6 user reviews,5,1,6
858970,True,0,1 user reviews,1,0,1
858980,True,0,1 user reviews,1,0,1
858990,True,0,No user reviews,0,0,0
859010,True,0,No user reviews,0,0,0
859040,True,6,Mostly Positive,25,7,32
859041,True,0,No user reviews,0,0,0
859050,True,0,1 user reviews,1,0,1
859060,True,0,No user reviews,0,0,0
859090,True,0,No user reviews,0,0,0
859100,True,0,No user reviews,0,0,0
859110,True,0,No user reviews,0,0,0
859120,True,0,No user reviews,0,0,0
859130,True,7,Positive,34,0,34
859150,True,0,4 user reviews,3,1,4
859160,True,0,No user reviews,0,0,0
859170,True,0,No user reviews,0,0,0
859180,True,0,No user reviews,0,0,0
859200,True,0,3 user reviews,3,0,3
859220,True,0,No user reviews,0,0,0
859240,True,0,No user reviews,0,0,0
859250,True,0,No user reviews,0,0,0
859270,True,0,No user reviews,0,0,0
859280,True,0,No user reviews,0,0,0
859290,True,0,No user reviews,0,0,0
859300,True,0,3 user reviews,3,0,3
859310,True,0,1 user reviews,0,1,1
859320,True,0,No user reviews,0,0,0
859340,True,5,Mixed,162,96,258
859350,True,7,Positive,11,1,12
859370,True,7,Positive,12,0,12
859380,True,0,3 user reviews,2,1,3
859400,True,0,No user reviews,0,0,0
859420,True,0,1 user reviews,1,0,1
859430,True,0,1 user reviews,1,0,1
859440,True,5,Mixed,6,7,13
859460,True,0,1 user reviews,0,1,1
859470,True,0,No user reviews,0,0,0
859490,True,0,No user reviews,0,0,0
859500,True,0,4 user reviews,1,3,4
859510,True,0,No user reviews,0,0,0
859530,True,0,1 user reviews,1,0,1
859540,True,0,No user reviews,0,0,0
859550,True,0,No user reviews,0,0,0
859560,True,0,4 user reviews,2,2,4
859570,True,8,Very Positive,1904,299,2203
859580,True,5,Mixed,4394,3878,8272
859600,True,0,1 user reviews,1,0,1
859610,True,0,1 user reviews,1,0,1
859640,True,7,Positive,21,3,24
859660,True,0,2 user reviews,2,0,2
859670,True,0,No user reviews,0,0,0
859680,True,9,Overwhelmingly Positive,499,16,515
859700,True,7,Positive,35,5,40
859720,True,0,No user reviews,0,0,0
859740,True,7,Positive,17,4,21
859770,True,0,No user reviews,0,0,0
859790,True,0,No user reviews,0,0,0
859820,True,0,3 user reviews,3,0,3
859870,True,0,2 user reviews,1,1,2
859900,True,0,4 user reviews,1,3,4
859910,True,0,No user reviews,0,0,0
859920,True,0,1 user reviews,0,1,1
859930,True,0,No user reviews,0,0,0
859940,True,0,No user reviews,0,0,0
859950,True,0,1 user reviews,1,0,1
859960,True,0,8 user reviews,8,0,8
859970,True,0,1 user reviews,1,0,1
859990,True,7,Positive,24,1,25
860000,True,0,No user reviews,0,0,0
860010,True,0,No user reviews,0,0,0
860020,True,0,No user reviews,0,0,0
860030,True,0,2 user reviews,2,0,2
860050,True,0,No user reviews,0,0,0
860060,True,0,No user reviews,0,0,0
860070,True,0,9 user reviews,6,3,9
860080,True,0,6 user reviews,6,0,6
860090,True,6,Mostly Positive,11,3,14
860100,True,0,No user reviews,0,0,0
860110,True,0,No user reviews,0,0,0
860120,True,0,No user reviews,0,0,0
860130,True,0,No user reviews,0,0,0
860140,True,0,No user reviews,0,0,0
860150,True,0,No user reviews,0,0,0
860190,True,3,Negative,2,9,11
860210,True,0,No user reviews,0,0,0
860230,True,0,No user reviews,0,0,0
860231,True,0,No user reviews,0,0,0
860232,True,0,No user reviews,0,0,0
860233,True,0,No user reviews,0,0,0
860260,True,0,4 user reviews,1,3,4
860270,True,0,No user reviews,0,0,0
860290,True,0,No user reviews,0,0,0
860320,True,0,3 user reviews,2,1,3
860330,True,0,No user reviews,0,0,0
860340,True,0,6 user reviews,3,3,6
860350,True,0,4 user reviews,1,3,4
860400,True,0,2 user reviews,1,1,2
860430,True,0,1 user reviews,0,1,1
860440,True,5,Mixed,13,7,20
860450,True,5,Mixed,11,6,17
860470,True,0,No user reviews,0,0,0
860480,True,0,3 user reviews,1,2,3
860490,True,0,1 user reviews,1,0,1
860500,True,5,Mixed,5,5,10
860530,True,0,8 user reviews,6,2,8
860540,True,0,No user reviews,0,0,0
860550,True,0,4 user reviews,4,0,4
860570,True,0,4 user reviews,0,4,4
860580,True,0,1 user reviews,0,1,1
860590,True,0,3 user reviews,3,0,3
860600,True,0,4 user reviews,3,1,4
860610,True,0,No user reviews,0,0,0
860620,True,4,Mostly Negative,20,45,65
860630,True,0,1 user reviews,1,0,1
860640,True,5,Mixed,12,12,24
860650,True,6,Mostly Positive,38,12,50
860660,True,0,8 user reviews,5,3,8
860670,True,0,No user reviews,0,0,0
860680,True,0,3 user reviews,2,1,3
860690,True,0,No user reviews,0,0,0
860700,True,0,No user reviews,0,0,0
860710,True,0,No user reviews,0,0,0
860720,True,0,3 user reviews,3,0,3
860730,True,0,No user reviews,0,0,0
860750,True,0,No user reviews,0,0,0
860770,True,0,8 user reviews,4,4,8
860790,True,0,5 user reviews,4,1,5
860820,True,0,6 user reviews,2,4,6
860840,True,0,No user reviews,0,0,0
860850,True,0,No user reviews,0,0,0
860860,True,5,Mixed,30,14,44
860870,True,0,1 user reviews,1,0,1
860880,True,0,6 user reviews,6,0,6
860890,True,8,Very Positive,961,91,1052
860900,True,3,Negative,3,13,16
860910,True,6,Mostly Positive,101,40,141
860930,True,0,No user reviews,0,0,0
860950,True,9,Overwhelmingly Positive,982,30,1012
860980,True,0,3 user reviews,2,1,3
860981,True,0,1 user reviews,0,1,1
860990,True,5,Mixed,9,5,14
861000,True,0,No user reviews,0,0,0
861010,True,0,5 user reviews,5,0,5
861020,True,0,No user reviews,0,0,0
861030,True,5,Mixed,6,5,11
861050,True,0,No user reviews,0,0,0
861080,True,0,4 user reviews,2,2,4
861090,True,0,8 user reviews,7,1,8
861100,True,0,5 user reviews,4,1,5
861110,True,0,1 user reviews,1,0,1
861120,True,0,No user reviews,0,0,0
861130,True,0,No user reviews,0,0,0
861150,True,0,No user reviews,0,0,0
861160,True,0,4 user reviews,2,2,4
861180,True,3,Negative,1,9,10
861190,True,4,Mostly Negative,4,9,13
861200,True,0,1 user reviews,1,0,1
861210,True,0,No user reviews,0,0,0
861230,True,0,2 user reviews,1,1,2
861240,True,0,4 user reviews,4,0,4
861250,True,0,No user reviews,0,0,0
861260,True,0,No user reviews,0,0,0
861270,True,7,Positive,15,2,17
861280,True,0,1 user reviews,1,0,1
861290,True,0,4 user reviews,2,2,4
861300,True,7,Positive,19,0,19
861320,True,0,4 user reviews,2,2,4
861330,True,7,Positive,16,0,16
861350,True,5,Mixed,30,23,53
861380,True,0,No user reviews,0,0,0
861390,True,0,No user reviews,0,0,0
861400,True,0,No user reviews,0,0,0
861440,True,0,No user reviews,0,0,0
861510,True,0,No user reviews,0,0,0
861530,True,0,No user reviews,0,0,0
861540,True,8,Very Positive,2292,228,2520
861550,True,0,7 user reviews,6,1,7
861580,True,0,No user reviews,0,0,0
861600,True,0,No user reviews,0,0,0
861640,True,0,3 user reviews,2,1,3
861641,True,0,5 user reviews,2,3,5
861642,True,0,2 user reviews,2,0,2
861650,True,8,Very Positive,3353,543,3896
861670,True,0,5 user reviews,4,1,5
861710,True,7,Positive,11,1,12
861720,True,5,Mixed,4,6,10
861730,True,0,1 user reviews,0,1,1
861731,True,0,2 user reviews,2,0,2
861732,True,5,Mixed,6,6,12
861740,True,0,3 user reviews,1,2,3
861750,True,0,1 user reviews,1,0,1
861751,True,0,No user reviews,0,0,0
861752,True,0,No user reviews,0,0,0
861753,True,0,No user reviews,0,0,0
861760,True,5,Mixed,25,17,42
861770,True,0,No user reviews,0,0,0
861790,True,0,No user reviews,0,0,0
861800,True,0,No user reviews,0,0,0
861810,True,0,No user reviews,0,0,0
861860,True,0,2 user reviews,2,0,2
861870,True,6,Mostly Positive,7,3,10
861871,True,0,3 user reviews,2,1,3
861872,True,0,4 user reviews,3,1,4
861880,True,0,6 user reviews,6,0,6
861881,True,7,Positive,13,3,16
861882,True,0,2 user reviews,2,0,2
861883,True,0,2 user reviews,2,0,2
861884,True,0,2 user reviews,2,0,2
861885,True,0,5 user reviews,5,0,5
861887,True,0,6 user reviews,4,2,6
861888,True,7,Positive,8,2,10
861889,True,5,Mixed,12,9,21
861910,True,0,No user reviews,0,0,0
861920,True,0,No user reviews,0,0,0
861930,True,0,No user reviews,0,0,0
861940,True,0,No user reviews,0,0,0
861960,True,0,2 user reviews,2,0,2
861990,True,0,No user reviews,0,0,0
862000,True,0,No user reviews,0,0,0
862070,True,0,No user reviews,0,0,0
862090,True,0,No user reviews,0,0,0
862100,True,0,No user reviews,0,0,0
862110,True,7,Positive,19,0,19
862120,True,0,5 user reviews,1,4,5
862130,True,7,Positive,11,0,11
862140,True,0,No user reviews,0,0,0
862141,True,0,No user reviews,0,0,0
862142,True,0,No user reviews,0,0,0
862143,True,0,No user reviews,0,0,0
862150,True,0,5 user reviews,3,2,5
862160,True,0,No user reviews,0,0,0
862170,True,0,No user reviews,0,0,0
862190,True,0,2 user reviews,0,2,2
862200,True,0,No user reviews,0,0,0
862210,True,4,Mostly Negative,4,10,14
862220,True,0,No user reviews,0,0,0
862230,True,0,No user reviews,0,0,0
862240,True,0,No user reviews,0,0,0
862250,True,0,1 user reviews,1,0,1
862260,True,5,Mixed,9,5,14
862280,True,0,6 user reviews,2,4,6
862300,True,0,7 user reviews,5,2,7
862370,True,0,1 user reviews,0,1,1
862390,True,5,Mixed,52,25,77
862400,True,0,No user reviews,0,0,0
862401,True,0,No user reviews,0,0,0
862430,True,0,No user reviews,0,0,0
862440,True,0,No user reviews,0,0,0
862450,True,0,8 user reviews,6,2,8
862460,True,7,Positive,11,0,11
862480,True,8,Very Positive,239,21,260
862490,True,0,1 user reviews,1,0,1
862500,True,0,2 user reviews,0,2,2
862510,True,0,No user reviews,0,0,0
862520,True,3,Negative,0,13,13
862550,True,0,No user reviews,0,0,0
862560,True,0,No user reviews,0,0,0
862570,True,8,Very Positive,226,6,232
862580,True,6,Mostly Positive,191,52,243
862590,True,0,5 user reviews,0,5,5
862610,True,0,No user reviews,0,0,0
862630,True,0,No user reviews,0,0,0
862640,True,0,1 user reviews,1,0,1
862650,True,0,4 user reviews,0,4,4
862660,True,0,8 user reviews,3,5,8
862670,True,0,No user reviews,0,0,0
862690,True,0,1 user reviews,1,0,1
862700,True,0,1 user reviews,1,0,1
862710,True,0,No user reviews,0,0,0
862730,True,0,No user reviews,0,0,0
862740,True,0,7 user reviews,6,1,7
862760,True,0,1 user reviews,1,0,1
862770,True,7,Positive,13,3,16
862790,True,0,2 user reviews,2,0,2
862800,True,8,Very Positive,514,52,566
862810,True,0,9 user reviews,7,2,9
862820,True,0,No user reviews,0,0,0
862840,True,0,No user reviews,0,0,0
862850,True,0,3 user reviews,1,2,3
862880,True,0,5 user reviews,2,3,5
862890,True,0,No user reviews,0,0,0
862900,True,0,No user reviews,0,0,0
862910,True,0,No user reviews,0,0,0
862911,True,0,No user reviews,0,0,0
862912,True,0,No user reviews,0,0,0
862913,True,0,No user reviews,0,0,0
862914,True,0,No user reviews,0,0,0
862915,True,0,No user reviews,0,0,0
862920,True,7,Positive,16,1,17
862930,True,0,No user reviews,0,0,0
862931,True,0,No user reviews,0,0,0
862940,True,3,Negative,2,9,11
862970,True,0,No user reviews,0,0,0
862990,True,0,3 user reviews,0,3,3
863110,True,0,No user reviews,0,0,0
863120,True,0,No user reviews,0,0,0
863140,True,0,No user reviews,0,0,0
863150,True,0,5 user reviews,3,2,5
863160,True,0,No user reviews,0,0,0
863170,True,0,No user reviews,0,0,0
863180,True,0,3 user reviews,3,0,3
863181,True,0,1 user reviews,1,0,1
863182,True,0,No user reviews,0,0,0
863190,True,0,1 user reviews,1,0,1
863210,True,0,5 user reviews,5,0,5
863220,True,0,No user reviews,0,0,0
863270,True,0,1 user reviews,1,0,1
863280,True,0,3 user reviews,2,1,3
863290,True,0,1 user reviews,1,0,1
863300,True,0,No user reviews,0,0,0
863310,True,0,2 user reviews,2,0,2
863320,True,0,No user reviews,0,0,0
863330,True,0,No user reviews,0,0,0
863360,True,0,No user reviews,0,0,0
863370,True,0,No user reviews,0,0,0
863380,True,5,Mixed,6,5,11
863400,True,0,No user reviews,0,0,0
863410,True,0,No user reviews,0,0,0
863420,True,4,Mostly Negative,8,13,21
863430,True,0,4 user reviews,4,0,4
863460,True,5,Mixed,17,15,32
863470,True,7,Positive,12,0,12
863490,True,5,Mixed,18,11,29
863520,True,0,6 user reviews,6,0,6
863550,True,8,Very Positive,7746,750,8496
863560,True,0,No user reviews,0,0,0
863570,True,8,Very Positive,215,42,257
863580,True,0,9 user reviews,3,6,9
863590,True,8,Very Positive,780,57,837
863600,True,0,No user reviews,0,0,0
863610,True,0,No user reviews,0,0,0
863620,True,0,1 user reviews,1,0,1
863640,True,0,No user reviews,0,0,0
863650,True,0,No user reviews,0,0,0
863660,True,0,2 user reviews,1,1,2
863670,True,0,No user reviews,0,0,0
863680,True,0,No user reviews,0,0,0
863681,True,0,No user reviews,0,0,0
863690,True,0,1 user reviews,0,1,1
863700,True,0,No user reviews,0,0,0
863720,True,0,No user reviews,0,0,0
863730,True,0,1 user reviews,1,0,1
863740,True,0,No user reviews,0,0,0
863760,True,0,1 user reviews,1,0,1
863780,True,0,No user reviews,0,0,0
863790,True,0,No user reviews,0,0,0
863810,True,0,7 user reviews,5,2,7
863820,True,0,No user reviews,0,0,0
863840,True,0,1 user reviews,0,1,1
863870,True,0,2 user reviews,1,1,2
863880,True,0,No user reviews,0,0,0
863900,True,0,6 user reviews,6,0,6
863910,True,0,No user reviews,0,0,0
863920,True,0,No user reviews,0,0,0
863930,True,0,No user reviews,0,0,0
863960,True,0,No user reviews,0,0,0
863980,True,5,Mixed,9,8,17
864010,True,0,6 user reviews,4,2,6
864020,True,0,3 user reviews,2,1,3
864030,True,0,No user reviews,0,0,0
864050,True,0,No user reviews,0,0,0
864060,True,8,Very Positive,312,17,329
864080,True,0,1 user reviews,1,0,1
864100,True,8,Very Positive,88,6,94
864110,True,0,3 user reviews,2,1,3
864130,True,6,Mostly Positive,20,6,26
864150,True,0,9 user reviews,5,4,9
864160,True,6,Mostly Positive,108,31,139
864180,True,0,No user reviews,0,0,0
864181,True,0,No user reviews,0,0,0
864182,True,0,No user reviews,0,0,0
864183,True,0,No user reviews,0,0,0
864184,True,0,No user reviews,0,0,0
864185,True,0,No user reviews,0,0,0
864186,True,0,No user reviews,0,0,0
864187,True,0,No user reviews,0,0,0
864188,True,0,No user reviews,0,0,0
864189,True,0,No user reviews,0,0,0
864190,True,0,1 user reviews,1,0,1
864200,True,0,1 user reviews,0,1,1
864210,True,0,No user reviews,0,0,0
864220,True,0,3 user reviews,3,0,3
864230,True,0,No user reviews,0,0,0
864240,True,0,No user reviews,0,0,0
864250,True,0,No user reviews,0,0,0
864270,True,0,No user reviews,0,0,0
864290,True,0,No user reviews,0,0,0
864300,True,8,Very Positive,64,5,69
864310,True,0,1 user reviews,1,0,1
864320,True,0,No user reviews,0,0,0
864330,True,0,No user reviews,0,0,0
864360,True,0,1 user reviews,1,0,1
864370,True,0,2 user reviews,2,0,2
864420,True,0,No user reviews,0,0,0
864430,True,0,4 user reviews,3,1,4
864450,True,0,8 user reviews,6,2,8
864480,True,0,No user reviews,0,0,0
864500,True,0,2 user reviews,2,0,2
864510,True,6,Mostly Positive,12,4,16
864530,True,0,5 user reviews,3,2,5
864540,True,7,Positive,40,8,48
864550,True,6,Mostly Positive,36,11,47
864560,True,0,No user reviews,0,0,0
864570,True,0,9 user reviews,7,2,9
864590,True,0,No user reviews,0,0,0
864600,True,0,2 user reviews,2,0,2
864610,True,6,Mostly Positive,16,5,21
864660,True,0,2 user reviews,1,1,2
864670,True,0,No user reviews,0,0,0
864680,True,8,Very Positive,67,5,72
864700,True,0,No user reviews,0,0,0
864710,True,0,No user reviews,0,0,0
864720,True,0,No user reviews,0,0,0
864730,True,6,Mostly Positive,29,10,39
864740,True,0,6 user reviews,6,0,6
864750,True,0,No user reviews,0,0,0
864760,True,0,3 user reviews,1,2,3
864780,True,0,No user reviews,0,0,0
864790,True,5,Mixed,6,4,10
864810,True,0,6 user reviews,3,3,6
864820,True,0,No user reviews,0,0,0
864850,True,0,3 user reviews,2,1,3
864860,True,7,Positive,12,1,13
864880,True,0,5 user reviews,3,2,5
864890,True,0,No user reviews,0,0,0
864900,True,0,No user reviews,0,0,0
864930,True,0,No user reviews,0,0,0
864940,True,4,Mostly Negative,3,9,12
864960,True,0,2 user reviews,2,0,2
864970,True,7,Positive,32,7,39
864980,True,7,Positive,23,2,25
865010,True,0,No user reviews,0,0,0
865011,True,0,No user reviews,0,0,0
865012,True,0,No user reviews,0,0,0
865013,True,0,No user reviews,0,0,0
865014,True,0,No user reviews,0,0,0
865040,True,8,Very Positive,101,6,107
865060,True,0,6 user reviews,6,0,6
865070,True,0,2 user reviews,0,2,2
865090,True,8,Very Positive,279,29,308
865100,True,0,No user reviews,0,0,0
865120,True,0,1 user reviews,0,1,1
865130,True,0,No user reviews,0,0,0
865140,True,0,No user reviews,0,0,0
865150,True,0,No user reviews,0,0,0
865160,True,5,Mixed,10,9,19
865170,True,0,3 user reviews,3,0,3
865180,True,0,3 user reviews,1,2,3
865190,True,5,Mixed,7,4,11
865200,True,0,No user reviews,0,0,0
865210,True,0,1 user reviews,1,0,1
865220,True,7,Positive,17,1,18
865250,True,6,Mostly Positive,62,21,83
865260,True,0,2 user reviews,2,0,2
865270,True,8,Very Positive,75,5,80
865290,True,0,1 user reviews,1,0,1
865310,True,5,Mixed,4,6,10
865320,True,0,9 user reviews,6,3,9
865330,True,0,2 user reviews,1,1,2
865351,True,0,No user reviews,0,0,0
865360,True,8,Very Positive,1264,135,1399
865370,True,0,No user reviews,0,0,0
865380,True,0,No user reviews,0,0,0
865390,True,4,Mostly Negative,11,19,30
865400,True,0,No user reviews,0,0,0
865420,True,0,No user reviews,0,0,0
865430,True,0,No user reviews,0,0,0
865540,True,8,Very Positive,455,13,468
865570,True,0,No user reviews,0,0,0
865590,True,0,No user reviews,0,0,0
865610,True,0,No user reviews,0,0,0
865620,True,0,No user reviews,0,0,0
865630,True,0,3 user reviews,3,0,3
865640,True,0,No user reviews,0,0,0
865650,True,0,No user reviews,0,0,0
865670,True,6,Mostly Positive,521,157,678
865700,True,0,No user reviews,0,0,0
865701,True,0,No user reviews,0,0,0
865720,True,0,1 user reviews,0,1,1
865740,True,0,No user reviews,0,0,0
865750,True,0,1 user reviews,1,0,1
865760,True,0,1 user reviews,1,0,1
865770,True,0,No user reviews,0,0,0
865780,True,0,No user reviews,0,0,0
865800,True,0,2 user reviews,2,0,2
865810,True,0,No user reviews,0,0,0
865820,True,8,Very Positive,74,10,84
865830,True,7,Positive,38,4,42
865840,True,0,No user reviews,0,0,0
865850,True,5,Mixed,8,6,14
865860,True,0,2 user reviews,0,2,2
865870,True,0,4 user reviews,2,2,4
865880,True,0,No user reviews,0,0,0
865890,True,0,No user reviews,0,0,0
865920,True,0,No user reviews,0,0,0
865930,True,0,8 user reviews,7,1,8
865940,True,7,Positive,24,5,29
865960,True,0,No user reviews,0,0,0
865970,True,0,1 user reviews,1,0,1
865980,True,6,Mostly Positive,52,15,67
865990,True,0,3 user reviews,2,1,3
866010,True,7,Positive,31,7,38
866040,True,0,No user reviews,0,0,0
866060,True,0,No user reviews,0,0,0
866080,True,0,No user reviews,0,0,0
866100,True,0,3 user reviews,1,2,3
866120,True,0,No user reviews,0,0,0
866130,True,0,No user reviews,0,0,0
866140,True,0,No user reviews,0,0,0
866150,True,0,3 user reviews,2,1,3
866180,True,0,4 user reviews,0,4,4
866190,True,8,Very Positive,89,10,99
866200,True,0,No user reviews,0,0,0
866210,True,0,No user reviews,0,0,0
866211,True,0,1 user reviews,0,1,1
866212,True,0,3 user reviews,3,0,3
866260,True,5,Mixed,6,8,14
866270,True,0,No user reviews,0,0,0
866280,True,0,2 user reviews,0,2,2
866290,True,0,No user reviews,0,0,0
866300,True,0,No user reviews,0,0,0
866310,True,6,Mostly Positive,11,4,15
866320,True,0,2 user reviews,2,0,2
866330,True,0,No user reviews,0,0,0
866340,True,0,1 user reviews,0,1,1
866350,True,0,No user reviews,0,0,0
866360,True,0,No user reviews,0,0,0
866400,True,7,Positive,28,7,35
866410,True,0,No user reviews,0,0,0
866420,True,7,Positive,15,1,16
866430,True,0,No user reviews,0,0,0
866440,True,0,No user reviews,0,0,0
866450,True,0,2 user reviews,2,0,2
866480,True,0,No user reviews,0,0,0
866500,True,0,3 user reviews,3,0,3
866510,True,5,Mixed,20,17,37
866520,True,6,Mostly Positive,7,3,10
866530,True,0,No user reviews,0,0,0
866540,True,0,3 user reviews,3,0,3
866560,True,0,No user reviews,0,0,0
866590,True,0,No user reviews,0,0,0
866600,True,0,2 user reviews,2,0,2
866610,True,0,No user reviews,0,0,0
866620,True,0,No user reviews,0,0,0
866630,True,0,1 user reviews,0,1,1
866640,True,0,No user reviews,0,0,0
866650,True,0,No user reviews,0,0,0
866660,True,0,No user reviews,0,0,0
866670,True,0,1 user reviews,0,1,1
866700,True,0,3 user reviews,2,1,3
866710,True,0,3 user reviews,2,1,3
866720,True,0,2 user reviews,2,0,2
866730,True,0,2 user reviews,2,0,2
866740,True,0,No user reviews,0,0,0
866750,True,0,2 user reviews,2,0,2
866770,True,0,7 user reviews,3,4,7
866780,True,0,No user reviews,0,0,0
866790,True,0,1 user reviews,1,0,1
866800,True,8,Very Positive,3146,318,3464
866810,True,0,No user reviews,0,0,0
866820,True,0,No user reviews,0,0,0
866840,True,0,No user reviews,0,0,0
866850,True,0,No user reviews,0,0,0
866880,True,0,No user reviews,0,0,0
866900,True,0,No user reviews,0,0,0
866950,True,0,No user reviews,0,0,0
866960,True,0,No user reviews,0,0,0
866980,True,0,No user reviews,0,0,0
866990,True,0,No user reviews,0,0,0
867010,True,0,2 user reviews,2,0,2
867020,True,0,1 user reviews,1,0,1
867030,True,0,No user reviews,0,0,0
867050,True,5,Mixed,17,9,26
867070,True,0,1 user reviews,1,0,1
867080,True,0,No user reviews,0,0,0
867090,True,0,No user reviews,0,0,0
867100,True,0,No user reviews,0,0,0
867110,True,0,3 user reviews,3,0,3
867120,True,5,Mixed,8,5,13
867130,True,0,No user reviews,0,0,0
867140,True,5,Mixed,11,5,16
867150,True,0,No user reviews,0,0,0
867180,True,7,Positive,26,3,29
867200,True,0,1 user reviews,1,0,1
867220,True,0,1 user reviews,0,1,1
867230,True,0,No user reviews,0,0,0
867240,True,7,Positive,22,3,25
867250,True,0,9 user reviews,9,0,9
867290,True,5,Mixed,801,516,1317
867380,True,8,Very Positive,109,9,118
867390,True,0,1 user reviews,1,0,1
867400,True,8,Very Positive,52,8,60
867420,True,5,Mixed,8,5,13
867460,True,0,No user reviews,0,0,0
867470,True,0,1 user reviews,0,1,1
867480,True,5,Mixed,7,6,13
867490,True,7,Positive,33,7,40
867510,True,0,2 user reviews,2,0,2
867530,True,0,1 user reviews,1,0,1
867540,True,0,4 user reviews,2,2,4
867550,True,0,2 user reviews,1,1,2
867570,True,0,1 user reviews,0,1,1
867580,True,0,4 user reviews,1,3,4
867590,True,0,3 user reviews,2,1,3
867600,True,0,1 user reviews,1,0,1
867610,True,5,Mixed,10,9,19
867620,True,0,7 user reviews,0,7,7
867630,True,0,No user reviews,0,0,0
867640,True,0,5 user reviews,3,2,5
867660,True,0,No user reviews,0,0,0
867680,True,0,No user reviews,0,0,0
867690,True,0,No user reviews,0,0,0
867700,True,7,Positive,30,6,36
867710,True,0,1 user reviews,1,0,1
867720,True,0,No user reviews,0,0,0
867730,True,0,8 user reviews,3,5,8
867740,True,0,No user reviews,0,0,0
867750,True,0,No user reviews,0,0,0
867760,True,0,No user reviews,0,0,0
867770,True,0,No user reviews,0,0,0
867780,True,0,No user reviews,0,0,0
867790,True,0,2 user reviews,2,0,2
867800,True,0,5 user reviews,3,2,5
867810,True,0,No user reviews,0,0,0
867850,True,0,3 user reviews,1,2,3
867860,True,0,6 user reviews,6,0,6
867870,True,0,No user reviews,0,0,0
867880,True,0,No user reviews,0,0,0
867890,True,0,No user reviews,0,0,0
867900,True,0,No user reviews,0,0,0
867910,True,0,No user reviews,0,0,0
867920,True,0,1 user reviews,1,0,1
867930,True,0,No user reviews,0,0,0
867940,True,0,1 user reviews,0,1,1
867941,True,0,No user reviews,0,0,0
867942,True,0,No user reviews,0,0,0
867943,True,0,No user reviews,0,0,0
867944,True,0,No user reviews,0,0,0
867945,True,0,No user reviews,0,0,0
867946,True,0,No user reviews,0,0,0
867947,True,0,No user reviews,0,0,0
867948,True,0,No user reviews,0,0,0
867949,True,0,No user reviews,0,0,0
867950,True,0,No user reviews,0,0,0
867951,True,0,No user reviews,0,0,0
867960,True,0,No user reviews,0,0,0
867980,True,7,Positive,24,1,25
867990,True,0,No user reviews,0,0,0
868000,True,0,3 user reviews,0,3,3
868010,True,0,3 user reviews,3,0,3
868020,True,0,No user reviews,0,0,0
868030,True,0,No user reviews,0,0,0
868040,True,0,1 user reviews,1,0,1
868060,True,7,Positive,26,5,31
868070,True,0,No user reviews,0,0,0
868080,True,7,Positive,26,5,31
868090,True,0,No user reviews,0,0,0
868100,True,0,No user reviews,0,0,0
868110,True,0,No user reviews,0,0,0
868111,True,0,1 user reviews,1,0,1
868112,True,0,No user reviews,0,0,0
868120,True,0,No user reviews,0,0,0
868130,True,0,1 user reviews,1,0,1
868140,True,0,No user reviews,0,0,0
868150,True,8,Very Positive,96,10,106
868170,True,0,No user reviews,0,0,0
868180,True,0,No user reviews,0,0,0
868190,True,0,No user reviews,0,0,0
868200,True,0,No user reviews,0,0,0
868210,True,0,1 user reviews,1,0,1
868220,True,0,No user reviews,0,0,0
868221,True,0,No user reviews,0,0,0
868230,True,6,Mostly Positive,18,6,24
868240,True,0,1 user reviews,1,0,1
868250,True,0,No user reviews,0,0,0
868260,True,5,Mixed,8,6,14
868270,True,0,No user reviews,0,0,0
868280,True,7,Positive,41,3,44
868310,True,7,Positive,31,6,37
868311,True,7,Positive,16,2,18
868312,True,6,Mostly Positive,21,7,28
868320,True,0,No user reviews,0,0,0
868330,True,0,No user reviews,0,0,0
868340,True,7,Positive,10,1,11
868350,True,0,3 user reviews,0,3,3
868360,True,8,Very Positive,1075,215,1290
868370,True,0,No user reviews,0,0,0
868380,True,5,Mixed,44,32,76
868390,True,0,1 user reviews,0,1,1
868400,True,0,3 user reviews,1,2,3
868410,True,4,Mostly Negative,10,16,26
868422,True,6,Mostly Positive,28,11,39
868423,True,6,Mostly Positive,12,4,16
868424,True,5,Mixed,26,18,44
868430,True,0,3 user reviews,3,0,3
868440,True,0,3 user reviews,3,0,3
868450,True,0,No user reviews,0,0,0
868460,True,0,1 user reviews,0,1,1
868470,True,0,2 user reviews,0,2,2
868480,True,0,3 user reviews,2,1,3
868490,True,0,No user reviews,0,0,0
868500,True,7,Positive,11,0,11
868510,True,0,1 user reviews,1,0,1
868520,True,9,Overwhelmingly Positive,734,25,759
868530,True,0,No user reviews,0,0,0
868540,True,0,No user reviews,0,0,0
868550,True,5,Mixed,9,4,13
868560,True,0,4 user reviews,3,1,4
868570,True,5,Mixed,12,6,18
868580,True,7,Positive,23,5,28
868600,True,0,1 user reviews,1,0,1
868610,True,0,No user reviews,0,0,0
868620,True,0,No user reviews,0,0,0
868621,True,0,No user reviews,0,0,0
868622,True,0,No user reviews,0,0,0
868623,True,0,No user reviews,0,0,0
868624,True,0,No user reviews,0,0,0
868625,True,0,No user reviews,0,0,0
868626,True,0,No user reviews,0,0,0
868627,True,0,No user reviews,0,0,0
868628,True,0,No user reviews,0,0,0
868629,True,0,No user reviews,0,0,0
868630,True,0,No user reviews,0,0,0
868631,True,0,No user reviews,0,0,0
868650,True,0,No user reviews,0,0,0
868660,True,0,6 user reviews,5,1,6
868670,True,0,No user reviews,0,0,0
868680,True,0,No user reviews,0,0,0
868710,True,3,Negative,1,9,10
868720,True,0,No user reviews,0,0,0
868730,True,0,1 user reviews,1,0,1
868750,True,0,No user reviews,0,0,0
868760,True,0,No user reviews,0,0,0
868770,True,0,1 user reviews,1,0,1
868780,True,7,Positive,22,2,24
868790,True,0,No user reviews,0,0,0
868810,True,0,No user reviews,0,0,0
868820,True,0,4 user reviews,4,0,4
868830,True,0,No user reviews,0,0,0
868870,True,0,6 user reviews,6,0,6
868880,True,0,4 user reviews,3,1,4
868890,True,5,Mixed,7,4,11
868900,True,0,No user reviews,0,0,0
868910,True,0,1 user reviews,1,0,1
868920,True,0,4 user reviews,2,2,4
868930,True,0,7 user reviews,7,0,7
868940,True,0,No user reviews,0,0,0
868950,True,0,No user reviews,0,0,0
868960,True,0,1 user reviews,0,1,1
868970,True,0,4 user reviews,1,3,4
868980,True,8,Very Positive,412,10,422
868990,True,0,No user reviews,0,0,0
869010,True,0,No user reviews,0,0,0
869030,True,0,2 user reviews,2,0,2
869060,True,5,Mixed,33,44,77
869080,True,0,1 user reviews,1,0,1
869090,True,0,No user reviews,0,0,0
869100,True,0,6 user reviews,5,1,6
869120,True,0,4 user reviews,4,0,4
869130,True,0,3 user reviews,1,2,3
869140,True,0,No user reviews,0,0,0
869160,True,0,2 user reviews,2,0,2
869170,True,7,Positive,23,4,27
869210,True,0,No user reviews,0,0,0
869230,True,0,No user reviews,0,0,0
869240,True,0,No user reviews,0,0,0
869241,True,0,1 user reviews,0,1,1
869270,True,0,No user reviews,0,0,0
869280,True,0,7 user reviews,1,6,7
869290,True,0,8 user reviews,8,0,8
869300,True,7,Positive,9,1,10
869330,True,0,No user reviews,0,0,0
869340,True,0,4 user reviews,0,4,4
869350,True,8,Very Positive,51,3,54
869360,True,0,No user reviews,0,0,0
869370,True,0,2 user reviews,2,0,2
869390,True,7,Positive,13,0,13
869410,True,0,No user reviews,0,0,0
869420,True,0,2 user reviews,0,2,2
869430,True,0,No user reviews,0,0,0
869440,True,0,3 user reviews,3,0,3
869450,True,0,No user reviews,0,0,0
869460,True,0,No user reviews,0,0,0
869470,True,0,5 user reviews,5,0,5
869480,True,0,No user reviews,0,0,0
869500,True,0,1 user reviews,1,0,1
869530,True,0,2 user reviews,2,0,2
869540,True,0,3 user reviews,2,1,3
869550,True,7,Positive,10,1,11
869560,True,0,4 user reviews,2,2,4
869580,True,0,No user reviews,0,0,0
869600,True,0,No user reviews,0,0,0
869620,True,7,Positive,10,2,12
869630,True,0,No user reviews,0,0,0
869640,True,0,No user reviews,0,0,0
869650,True,0,No user reviews,0,0,0
869660,True,0,1 user reviews,0,1,1
869670,True,7,Positive,15,1,16
869680,True,0,5 user reviews,0,5,5
869690,True,7,Positive,21,0,21
869700,True,0,No user reviews,0,0,0
869710,True,0,No user reviews,0,0,0
869730,True,0,No user reviews,0,0,0
869740,True,0,No user reviews,0,0,0
869750,True,0,3 user reviews,2,1,3
869760,True,0,No user reviews,0,0,0
869780,True,6,Mostly Positive,8,3,11
869790,True,0,No user reviews,0,0,0
869830,True,7,Positive,24,3,27
869840,True,0,5 user reviews,4,1,5
869850,True,0,7 user reviews,7,0,7
869860,True,0,No user reviews,0,0,0
869870,True,0,4 user reviews,4,0,4
869880,True,0,No user reviews,0,0,0
869910,True,0,4 user reviews,4,0,4
869930,True,0,1 user reviews,0,1,1
870000,True,0,No user reviews,0,0,0
870010,True,0,2 user reviews,0,2,2
870020,True,0,3 user reviews,3,0,3
870030,True,0,1 user reviews,1,0,1
870080,True,6,Mostly Positive,20,6,26
870090,True,0,3 user reviews,3,0,3
870100,True,0,1 user reviews,0,1,1
870110,True,0,5 user reviews,2,3,5
870120,True,0,6 user reviews,2,4,6
870140,True,0,7 user reviews,6,1,7
870150,True,0,No user reviews,0,0,0
870160,True,0,3 user reviews,2,1,3
870180,True,0,7 user reviews,4,3,7
870190,True,0,3 user reviews,3,0,3
870200,True,8,Very Positive,529,53,582
870240,True,0,2 user reviews,2,0,2
870260,True,0,7 user reviews,7,0,7
870270,True,5,Mixed,16,7,23
870271,True,0,3 user reviews,3,0,3
870272,True,0,5 user reviews,5,0,5
870273,True,0,3 user reviews,3,0,3
870274,True,0,No user reviews,0,0,0
870275,True,0,No user reviews,0,0,0
870276,True,0,1 user reviews,1,0,1
870277,True,0,4 user reviews,3,1,4
870279,True,0,No user reviews,0,0,0
870280,True,0,7 user reviews,6,1,7
870290,True,6,Mostly Positive,195,62,257
870300,True,0,No user reviews,0,0,0
870310,True,0,No user reviews,0,0,0
870320,True,0,No user reviews,0,0,0
870321,True,0,No user reviews,0,0,0
870322,True,0,No user reviews,0,0,0
870323,True,0,No user reviews,0,0,0
870324,True,0,No user reviews,0,0,0
870325,True,0,No user reviews,0,0,0
870326,True,0,No user reviews,0,0,0
870327,True,0,No user reviews,0,0,0
870328,True,0,No user reviews,0,0,0
870329,True,0,No user reviews,0,0,0
870330,True,0,No user reviews,0,0,0
870331,True,0,No user reviews,0,0,0
870340,True,0,No user reviews,0,0,0
870341,True,0,No user reviews,0,0,0
870342,True,0,No user reviews,0,0,0
870343,True,0,No user reviews,0,0,0
870344,True,0,No user reviews,0,0,0
870345,True,0,1 user reviews,1,0,1
870346,True,0,No user reviews,0,0,0
870347,True,0,No user reviews,0,0,0
870348,True,0,No user reviews,0,0,0
870349,True,0,No user reviews,0,0,0
870350,True,0,No user reviews,0,0,0
870351,True,0,No user reviews,0,0,0
870390,True,0,4 user reviews,3,1,4
870400,True,0,4 user reviews,2,2,4
870420,True,8,Very Positive,213,31,244
870430,True,0,2 user reviews,0,2,2
870450,True,0,1 user reviews,0,1,1
870460,True,0,1 user reviews,0,1,1
870461,True,0,1 user reviews,0,1,1
870462,True,0,1 user reviews,0,1,1
870470,True,0,1 user reviews,1,0,1
870490,True,0,No user reviews,0,0,0
870500,True,0,No user reviews,0,0,0
870510,True,0,2 user reviews,2,0,2
870520,True,0,1 user reviews,0,1,1
870570,True,0,No user reviews,0,0,0
870580,True,0,4 user reviews,3,1,4
870590,True,0,3 user reviews,3,0,3
870600,True,0,8 user reviews,8,0,8
870620,True,0,1 user reviews,0,1,1
870621,True,0,No user reviews,0,0,0
870630,True,0,No user reviews,0,0,0
870640,True,0,No user reviews,0,0,0
870650,True,0,1 user reviews,0,1,1
870670,True,0,5 user reviews,5,0,5
870680,True,0,2 user reviews,1,1,2
870690,True,8,Very Positive,65,4,69
870710,True,0,No user reviews,0,0,0
870720,True,0,No user reviews,0,0,0
870730,True,7,Positive,30,3,33
870740,True,0,No user reviews,0,0,0
870750,True,0,2 user reviews,2,0,2
870760,True,0,No user reviews,0,0,0
870780,True,8,Very Positive,2862,284,3146
870800,True,0,5 user reviews,5,0,5
870810,True,0,No user reviews,0,0,0
870820,True,0,No user reviews,0,0,0
870830,True,0,No user reviews,0,0,0
870890,True,0,No user reviews,0,0,0
870900,True,0,No user reviews,0,0,0
870920,True,0,2 user reviews,2,0,2
870940,True,0,No user reviews,0,0,0
870950,True,0,No user reviews,0,0,0
870960,True,0,No user reviews,0,0,0
870990,True,0,3 user reviews,1,2,3
871030,True,0,No user reviews,0,0,0
871031,True,0,No user reviews,0,0,0
871040,True,0,No user reviews,0,0,0
871041,True,0,No user reviews,0,0,0
871050,True,0,No user reviews,0,0,0
871051,True,0,No user reviews,0,0,0
871060,True,0,No user reviews,0,0,0
871070,True,0,No user reviews,0,0,0
871080,True,0,No user reviews,0,0,0
871081,True,0,No user reviews,0,0,0
871082,True,0,No user reviews,0,0,0
871100,True,0,6 user reviews,6,0,6
871140,True,0,1 user reviews,0,1,1
871150,True,0,3 user reviews,2,1,3
871160,True,0,No user reviews,0,0,0
871170,True,0,No user reviews,0,0,0
871190,True,7,Positive,17,1,18
871200,True,8,Very Positive,208,25,233
871220,True,0,No user reviews,0,0,0
871230,True,0,8 user reviews,5,3,8
871240,True,0,No user reviews,0,0,0
871241,True,0,No user reviews,0,0,0
871250,True,0,No user reviews,0,0,0
871260,True,0,3 user reviews,2,1,3
871270,True,0,No user reviews,0,0,0
871280,True,7,Positive,15,0,15
871290,True,0,4 user reviews,3,1,4
871300,True,0,1 user reviews,0,1,1
871310,True,6,Mostly Positive,9,3,12
871320,True,0,No user reviews,0,0,0
871330,True,0,4 user reviews,4,0,4
871340,True,0,No user reviews,0,0,0
871380,True,0,No user reviews,0,0,0
871390,True,0,4 user reviews,3,1,4
871400,True,0,No user reviews,0,0,0
871410,True,0,No user reviews,0,0,0
871420,True,8,Very Positive,165,34,199
871490,True,0,No user reviews,0,0,0
871510,True,0,4 user reviews,3,1,4
871530,True,6,Mostly Positive,329,86,415
871550,True,0,No user reviews,0,0,0
871570,True,0,1 user reviews,1,0,1
871580,True,0,2 user reviews,2,0,2
871590,True,0,6 user reviews,4,2,6
871600,True,0,No user reviews,0,0,0
871620,True,0,No user reviews,0,0,0
871630,True,0,No user reviews,0,0,0
871640,True,0,No user reviews,0,0,0
871650,True,7,Positive,27,1,28
871651,True,0,9 user reviews,3,6,9
871670,True,0,No user reviews,0,0,0
871710,True,0,7 user reviews,3,4,7
871720,True,0,3 user reviews,3,0,3
871810,True,0,8 user reviews,4,4,8
871830,True,0,No user reviews,0,0,0
871850,True,0,5 user reviews,4,1,5
871860,True,0,1 user reviews,0,1,1
871870,True,5,Mixed,6,4,10
871900,True,0,9 user reviews,9,0,9
871920,True,0,2 user reviews,2,0,2
871930,True,8,Very Positive,369,27,396
871940,True,0,No user reviews,0,0,0
871950,True,8,Very Positive,100,16,116
871970,True,0,No user reviews,0,0,0
871990,True,5,Mixed,86,59,145
872000,True,0,No user reviews,0,0,0
872040,True,0,6 user reviews,6,0,6
872050,True,0,No user reviews,0,0,0
872060,True,6,Mostly Positive,7,3,10
872070,True,0,3 user reviews,3,0,3
872090,True,5,Mixed,7,6,13
872100,True,0,No user reviews,0,0,0
872110,True,7,Positive,13,1,14
872120,True,0,No user reviews,0,0,0
872130,True,8,Very Positive,237,20,257
872140,True,0,No user reviews,0,0,0
872170,True,0,No user reviews,0,0,0
872180,True,0,3 user reviews,2,1,3
872190,True,0,No user reviews,0,0,0
872210,True,0,No user reviews,0,0,0
872220,True,0,1 user reviews,1,0,1
872230,True,0,No user reviews,0,0,0
872240,True,0,1 user reviews,1,0,1
872250,True,0,No user reviews,0,0,0
872260,True,0,No user reviews,0,0,0
872270,True,0,No user reviews,0,0,0
872280,True,4,Mostly Negative,36,60,96
872300,True,0,No user reviews,0,0,0
872310,True,0,1 user reviews,1,0,1
872330,True,0,1 user reviews,0,1,1
872340,True,0,No user reviews,0,0,0
872350,True,5,Mixed,17,15,32
872360,True,0,3 user reviews,2,1,3
872370,True,0,1 user reviews,1,0,1
872380,True,0,9 user reviews,8,1,9
872390,True,0,No user reviews,0,0,0
872400,True,0,5 user reviews,1,4,5
872410,True,5,Mixed,190,131,321
872420,True,0,No user reviews,0,0,0
872430,True,0,No user reviews,0,0,0
872440,True,0,No user reviews,0,0,0
872450,True,0,No user reviews,0,0,0
872460,True,0,No user reviews,0,0,0
872470,True,7,Positive,14,1,15
872490,True,0,6 user reviews,3,3,6
872500,True,0,No user reviews,0,0,0
872520,True,0,No user reviews,0,0,0
872530,True,0,2 user reviews,1,1,2
872540,True,0,No user reviews,0,0,0
872550,True,0,4 user reviews,2,2,4
872560,True,0,No user reviews,0,0,0
872580,True,0,9 user reviews,9,0,9
872590,True,0,No user reviews,0,0,0
872600,True,0,No user reviews,0,0,0
872610,True,0,No user reviews,0,0,0
872630,True,0,8 user reviews,1,7,8
872640,True,0,No user reviews,0,0,0
872650,True,0,No user reviews,0,0,0
872670,True,0,No user reviews,0,0,0
872680,True,5,Mixed,50,26,76
872690,True,0,4 user reviews,2,2,4
872700,True,0,1 user reviews,1,0,1
872720,True,0,No user reviews,0,0,0
872730,True,0,7 user reviews,6,1,7
872750,True,8,Very Positive,88,8,96
872770,True,0,7 user reviews,5,2,7
872790,True,8,Very Positive,2094,321,2415
872810,True,7,Positive,17,2,19
872820,True,8,Very Positive,65,13,78
872860,True,0,No user reviews,0,0,0
872870,True,0,No user reviews,0,0,0
872970,True,0,No user reviews,0,0,0
872990,True,0,4 user reviews,2,2,4
873030,True,7,Positive,20,5,25
873040,True,0,No user reviews,0,0,0
873050,True,0,1 user reviews,0,1,1
873070,True,7,Positive,16,1,17
873090,True,0,No user reviews,0,0,0
873100,True,0,No user reviews,0,0,0
873120,True,0,6 user reviews,4,2,6
873130,True,0,No user reviews,0,0,0
873140,True,0,1 user reviews,0,1,1
873160,True,0,1 user reviews,0,1,1
873180,True,0,1 user reviews,0,1,1
873190,True,7,Positive,26,2,28
873200,True,8,Very Positive,99,4,103
873210,True,0,1 user reviews,0,1,1
873220,True,5,Mixed,37,24,61
873230,True,0,No user reviews,0,0,0
873240,True,8,Very Positive,252,32,284
873250,True,0,No user reviews,0,0,0
873280,True,0,No user reviews,0,0,0
873290,True,0,5 user reviews,5,0,5
873300,True,0,No user reviews,0,0,0
873310,True,0,No user reviews,0,0,0
873320,True,0,1 user reviews,0,1,1
873330,True,0,No user reviews,0,0,0
873340,True,0,No user reviews,0,0,0
873370,True,0,No user reviews,0,0,0
873380,True,0,No user reviews,0,0,0
873390,True,7,Positive,15,1,16
873400,True,0,No user reviews,0,0,0
873410,True,6,Mostly Positive,11,3,14
873470,True,0,2 user reviews,2,0,2
873480,True,0,No user reviews,0,0,0
873490,True,0,1 user reviews,1,0,1
873500,True,0,3 user reviews,2,1,3
873530,True,0,No user reviews,0,0,0
873540,True,0,No user reviews,0,0,0
873541,True,0,No user reviews,0,0,0
873560,True,7,Positive,14,1,15
873570,True,0,No user reviews,0,0,0
873580,True,0,No user reviews,0,0,0
873590,True,0,2 user reviews,1,1,2
873600,True,0,No user reviews,0,0,0
873610,True,6,Mostly Positive,22,6,28
873630,True,0,No user reviews,0,0,0
873640,True,0,No user reviews,0,0,0
873650,True,0,No user reviews,0,0,0
873660,True,0,No user reviews,0,0,0
873670,True,0,No user reviews,0,0,0
873680,True,0,No user reviews,0,0,0
873690,True,0,No user reviews,0,0,0
873710,True,0,2 user reviews,0,2,2
873720,True,0,No user reviews,0,0,0
873730,True,0,No user reviews,0,0,0
873740,True,0,1 user reviews,0,1,1
873780,True,0,3 user reviews,3,0,3
873790,True,0,9 user reviews,7,2,9
873810,True,0,No user reviews,0,0,0
873820,True,0,No user reviews,0,0,0
873830,True,0,1 user reviews,1,0,1
873840,True,5,Mixed,99,45,144
873850,True,0,4 user reviews,0,4,4
873860,True,0,1 user reviews,0,1,1
873870,True,7,Positive,10,2,12
873871,True,6,Mostly Positive,7,3,10
873880,True,7,Positive,28,6,34
873890,True,8,Very Positive,76,5,81
873900,True,0,9 user reviews,7,2,9
873910,True,0,No user reviews,0,0,0
873920,True,0,No user reviews,0,0,0
873930,True,7,Positive,11,2,13
873940,True,8,Very Positive,897,144,1041
873960,True,0,No user reviews,0,0,0
873970,True,5,Mixed,7,5,12
873980,True,5,Mixed,30,17,47
874010,True,6,Mostly Positive,12,4,16
874020,True,0,5 user reviews,2,3,5
874030,True,0,No user reviews,0,0,0
874040,True,6,Mostly Positive,44,13,57
874060,True,0,3 user reviews,3,0,3
874070,True,0,No user reviews,0,0,0
874080,True,0,1 user reviews,1,0,1
874090,True,0,2 user reviews,2,0,2
874110,True,0,No user reviews,0,0,0
874121,True,0,No user reviews,0,0,0
874130,True,0,1 user reviews,1,0,1
874140,True,0,3 user reviews,1,2,3
874150,True,0,No user reviews,0,0,0
874151,True,0,No user reviews,0,0,0
874152,True,0,No user reviews,0,0,0
874153,True,0,No user reviews,0,0,0
874160,True,0,No user reviews,0,0,0
874180,True,0,No user reviews,0,0,0
874200,True,0,2 user reviews,2,0,2
874230,True,5,Mixed,11,5,16
874240,True,0,4 user reviews,1,3,4
874250,True,0,2 user reviews,2,0,2
874260,True,0,No user reviews,0,0,0
874270,True,5,Mixed,7,4,11
874300,True,0,No user reviews,0,0,0
874310,True,4,Mostly Negative,222,468,690
874320,True,0,No user reviews,0,0,0
874330,True,0,2 user reviews,0,2,2
874340,True,5,Mixed,20,10,30
874341,True,5,Mixed,17,25,42
874342,True,7,Positive,26,2,28
874343,True,4,Mostly Negative,7,18,25
874344,True,8,Very Positive,82,12,94
874345,True,5,Mixed,21,26,47
874360,True,5,Mixed,46,47,93
874370,True,0,8 user reviews,5,3,8
874380,True,4,Mostly Negative,4,8,12
874390,True,8,Very Positive,479,16,495
874400,True,0,No user reviews,0,0,0
874410,True,0,No user reviews,0,0,0
874420,True,0,No user reviews,0,0,0
874421,True,0,No user reviews,0,0,0
874430,True,0,No user reviews,0,0,0
874431,True,0,No user reviews,0,0,0
874440,True,0,No user reviews,0,0,0
874450,True,0,No user reviews,0,0,0
874460,True,6,Mostly Positive,32,13,45
874470,True,0,No user reviews,0,0,0
874480,True,0,No user reviews,0,0,0
874520,True,0,No user reviews,0,0,0
874580,True,0,No user reviews,0,0,0
874620,True,0,No user reviews,0,0,0
874630,True,0,No user reviews,0,0,0
874640,True,0,5 user reviews,1,4,5
874650,True,0,No user reviews,0,0,0
874661,True,7,Positive,39,8,47
874680,True,0,No user reviews,0,0,0
874690,True,0,2 user reviews,2,0,2
874700,True,0,3 user reviews,3,0,3
874710,True,0,2 user reviews,2,0,2
874720,True,0,3 user reviews,2,1,3
874730,True,0,1 user reviews,1,0,1
874740,True,0,5 user reviews,5,0,5
874750,True,0,2 user reviews,1,1,2
874760,True,0,No user reviews,0,0,0
874770,True,0,5 user reviews,5,0,5
874780,True,0,2 user reviews,1,1,2
874800,True,0,6 user reviews,5,1,6
874810,True,0,1 user reviews,1,0,1
874830,True,0,7 user reviews,0,7,7
874840,True,0,No user reviews,0,0,0
874850,True,0,No user reviews,0,0,0
874860,True,0,No user reviews,0,0,0
874880,True,0,No user reviews,0,0,0
874890,True,0,2 user reviews,2,0,2
874891,True,0,No user reviews,0,0,0
874892,True,0,No user reviews,0,0,0
874893,True,0,3 user reviews,3,0,3
874920,True,0,No user reviews,0,0,0
874930,True,0,No user reviews,0,0,0
874940,True,0,2 user reviews,1,1,2
874960,True,0,1 user reviews,1,0,1
874970,True,0,1 user reviews,0,1,1
874980,True,0,No user reviews,0,0,0
875000,True,0,No user reviews,0,0,0
875010,True,0,1 user reviews,0,1,1
875030,True,0,No user reviews,0,0,0
875040,True,0,No user reviews,0,0,0
875050,True,0,No user reviews,0,0,0
875060,True,0,No user reviews,0,0,0
875070,True,0,1 user reviews,1,0,1
875080,True,0,5 user reviews,5,0,5
875090,True,0,1 user reviews,1,0,1
875100,True,0,No user reviews,0,0,0
875110,True,7,Positive,12,2,14
875120,True,0,No user reviews,0,0,0
875150,True,0,3 user reviews,2,1,3
875151,True,0,2 user reviews,2,0,2
875152,True,0,2 user reviews,2,0,2
875153,True,0,No user reviews,0,0,0
875160,True,0,6 user reviews,5,1,6
875190,True,0,No user reviews,0,0,0
875200,True,0,No user reviews,0,0,0
875210,True,0,No user reviews,0,0,0
875220,True,0,No user reviews,0,0,0
875230,True,0,No user reviews,0,0,0
875240,True,6,Mostly Positive,44,13,57
875250,True,0,1 user reviews,1,0,1
875260,True,0,9 user reviews,1,8,9
875270,True,0,4 user reviews,3,1,4
875290,True,0,No user reviews,0,0,0
875300,True,0,No user reviews,0,0,0
875310,True,5,Mixed,22,12,34
875320,True,0,No user reviews,0,0,0
875330,True,0,No user reviews,0,0,0
875340,True,0,No user reviews,0,0,0
875360,True,0,2 user reviews,0,2,2
875370,True,0,No user reviews,0,0,0
875371,True,0,1 user reviews,1,0,1
875400,True,0,No user reviews,0,0,0
875410,True,0,No user reviews,0,0,0
875430,True,5,Mixed,11,7,18
875440,True,0,5 user reviews,2,3,5
875460,True,7,Positive,11,2,13
875480,True,0,No user reviews,0,0,0
875500,True,0,1 user reviews,0,1,1
875510,True,0,4 user reviews,3,1,4
875520,True,0,No user reviews,0,0,0
875530,True,0,No user reviews,0,0,0
875540,True,0,9 user reviews,5,4,9
875550,True,0,3 user reviews,0,3,3
875560,True,0,No user reviews,0,0,0
875610,True,0,No user reviews,0,0,0
875620,True,0,4 user reviews,4,0,4
875621,True,0,1 user reviews,1,0,1
875630,True,0,No user reviews,0,0,0
875640,True,0,No user reviews,0,0,0
875650,True,0,No user reviews,0,0,0
875660,True,0,3 user reviews,3,0,3
875670,True,0,1 user reviews,0,1,1
875680,True,0,No user reviews,0,0,0
875710,True,0,No user reviews,0,0,0
875740,True,0,No user reviews,0,0,0
875750,True,0,No user reviews,0,0,0
875760,True,6,Mostly Positive,70,22,92
875780,True,0,2 user reviews,1,1,2
875790,True,0,No user reviews,0,0,0
875800,True,6,Mostly Positive,49,14,63
875810,True,0,1 user reviews,1,0,1
875830,True,7,Positive,18,3,21
875840,True,0,No user reviews,0,0,0
875850,True,0,1 user reviews,1,0,1
875860,True,0,No user reviews,0,0,0
875890,True,0,7 user reviews,6,1,7
875930,True,0,6 user reviews,5,1,6
875950,True,2,Very Negative,7,81,88
875960,True,2,Very Negative,5,62,67
875980,True,0,No user reviews,0,0,0
875990,True,0,No user reviews,0,0,0
876000,True,0,No user reviews,0,0,0
876100,True,0,No user reviews,0,0,0
876110,True,0,No user reviews,0,0,0
876130,True,0,2 user reviews,2,0,2
876140,True,0,4 user reviews,1,3,4
876150,True,0,No user reviews,0,0,0
876160,True,0,No user reviews,0,0,0
876170,True,0,No user reviews,0,0,0
876180,True,0,3 user reviews,3,0,3
876190,True,5,Mixed,15,7,22
876200,True,0,4 user reviews,3,1,4
876210,True,0,2 user reviews,1,1,2
876220,True,0,8 user reviews,7,1,8
876240,True,0,No user reviews,0,0,0
876260,True,0,2 user reviews,2,0,2
876270,True,0,1 user reviews,1,0,1
876290,True,0,2 user reviews,1,1,2
876300,True,0,4 user reviews,4,0,4
876310,True,0,5 user reviews,5,0,5
876320,True,7,Positive,23,2,25
876330,True,0,No user reviews,0,0,0
876340,True,0,No user reviews,0,0,0
876360,True,7,Positive,11,0,11
876380,True,0,2 user reviews,2,0,2
876400,True,0,No user reviews,0,0,0
876401,True,0,No user reviews,0,0,0
876410,True,0,1 user reviews,0,1,1
876420,True,0,No user reviews,0,0,0
876430,True,0,No user reviews,0,0,0
876440,True,0,No user reviews,0,0,0
876450,True,0,5 user reviews,3,2,5
876470,True,0,No user reviews,0,0,0
876480,True,0,3 user reviews,3,0,3
876490,True,0,No user reviews,0,0,0
876500,True,0,9 user reviews,8,1,9
876510,True,0,No user reviews,0,0,0
876520,True,0,No user reviews,0,0,0
876540,True,0,2 user reviews,1,1,2
876550,True,0,1 user reviews,1,0,1
876570,True,0,No user reviews,0,0,0
876580,True,0,No user reviews,0,0,0
876590,True,0,No user reviews,0,0,0
876610,True,0,No user reviews,0,0,0
876640,True,0,No user reviews,0,0,0
876650,True,8,Very Positive,393,27,420
876660,True,0,No user reviews,0,0,0
876680,True,0,No user reviews,0,0,0
876681,True,0,No user reviews,0,0,0
876682,True,0,No user reviews,0,0,0
876683,True,0,No user reviews,0,0,0
876690,True,0,No user reviews,0,0,0
876691,True,0,No user reviews,0,0,0
876692,True,0,No user reviews,0,0,0
876693,True,0,No user reviews,0,0,0
876694,True,0,No user reviews,0,0,0
876700,True,0,No user reviews,0,0,0
876701,True,0,No user reviews,0,0,0
876710,True,0,No user reviews,0,0,0
876720,True,0,No user reviews,0,0,0
876721,True,0,No user reviews,0,0,0
876722,True,0,No user reviews,0,0,0
876723,True,0,No user reviews,0,0,0
876730,True,0,No user reviews,0,0,0
876731,True,0,No user reviews,0,0,0
876732,True,0,No user reviews,0,0,0
876733,True,0,No user reviews,0,0,0
876734,True,0,No user reviews,0,0,0
876735,True,0,No user reviews,0,0,0
876740,True,0,No user reviews,0,0,0
876760,True,0,No user reviews,0,0,0
876780,True,0,4 user reviews,3,1,4
876810,True,0,No user reviews,0,0,0
876840,True,0,2 user reviews,1,1,2
876850,True,0,4 user reviews,4,0,4
876860,True,0,1 user reviews,0,1,1
876870,True,0,2 user reviews,1,1,2
876880,True,0,7 user reviews,3,4,7
876890,True,0,No user reviews,0,0,0
876900,True,0,No user reviews,0,0,0
876910,True,0,2 user reviews,1,1,2
876920,True,0,No user reviews,0,0,0
876930,True,0,5 user reviews,3,2,5
876960,True,0,No user reviews,0,0,0
876970,True,0,No user reviews,0,0,0
876971,True,0,No user reviews,0,0,0
876980,True,7,Positive,16,0,16
877040,True,0,2 user reviews,1,1,2
877060,True,0,2 user reviews,2,0,2
877070,True,0,No user reviews,0,0,0
877080,True,5,Mixed,39,19,58
877090,True,0,No user reviews,0,0,0
877100,True,0,No user reviews,0,0,0
877110,True,0,No user reviews,0,0,0
877120,True,0,No user reviews,0,0,0
877130,True,0,No user reviews,0,0,0
877150,True,0,2 user reviews,1,1,2
877160,True,0,No user reviews,0,0,0
877180,True,0,No user reviews,0,0,0
877190,True,0,7 user reviews,3,4,7
877200,True,8,Very Positive,1310,269,1579
877210,True,0,No user reviews,0,0,0
877230,True,0,9 user reviews,5,4,9
877240,True,0,No user reviews,0,0,0
877250,True,0,3 user reviews,2,1,3
877260,True,0,7 user reviews,3,4,7
877270,True,0,3 user reviews,2,1,3
877300,True,0,No user reviews,0,0,0
877310,True,0,1 user reviews,1,0,1
877330,True,0,4 user reviews,3,1,4
877340,True,0,No user reviews,0,0,0
877360,True,5,Mixed,39,17,56
877380,True,0,5 user reviews,4,1,5
877400,True,0,No user reviews,0,0,0
877420,True,0,No user reviews,0,0,0
877440,True,0,7 user reviews,7,0,7
877450,True,0,No user reviews,0,0,0
877460,True,0,No user reviews,0,0,0
877470,True,0,2 user reviews,1,1,2
877480,True,0,5 user reviews,5,0,5
877490,True,0,No user reviews,0,0,0
877500,True,0,No user reviews,0,0,0
877510,True,0,7 user reviews,4,3,7
877520,True,0,No user reviews,0,0,0
877530,True,0,No user reviews,0,0,0
877550,True,7,Positive,9,1,10
877570,True,0,2 user reviews,2,0,2
877580,True,0,No user reviews,0,0,0
877590,True,0,2 user reviews,0,2,2
877600,True,0,No user reviews,0,0,0
877610,True,0,No user reviews,0,0,0
877620,True,0,6 user reviews,6,0,6
877680,True,0,4 user reviews,2,2,4
877700,True,0,No user reviews,0,0,0
877710,True,0,1 user reviews,1,0,1
877730,True,0,6 user reviews,3,3,6
877740,True,0,No user reviews,0,0,0
877750,True,0,No user reviews,0,0,0
877770,True,0,No user reviews,0,0,0
877780,True,0,7 user reviews,5,2,7
877800,True,0,2 user reviews,2,0,2
877810,True,8,Very Positive,242,18,260
877840,True,7,Positive,23,5,28
877850,True,7,Positive,38,4,42
877870,True,0,1 user reviews,1,0,1
877910,True,0,No user reviews,0,0,0
877940,True,0,6 user reviews,6,0,6
877950,True,0,No user reviews,0,0,0
877960,True,0,1 user reviews,0,1,1
877980,True,0,1 user reviews,0,1,1
878020,True,7,Positive,26,4,30
878030,True,0,1 user reviews,1,0,1
878040,True,0,No user reviews,0,0,0
878060,True,0,No user reviews,0,0,0
878070,True,0,No user reviews,0,0,0
878080,True,5,Mixed,6,4,10
878090,True,7,Positive,12,1,13
878100,True,0,No user reviews,0,0,0
878110,True,0,No user reviews,0,0,0
878120,True,0,2 user reviews,1,1,2
878130,True,0,No user reviews,0,0,0
878140,True,0,1 user reviews,0,1,1
878150,True,0,5 user reviews,5,0,5
878160,True,0,8 user reviews,1,7,8
878170,True,6,Mostly Positive,10,4,14
878180,True,6,Mostly Positive,7,3,10
878200,True,0,No user reviews,0,0,0
878220,True,0,No user reviews,0,0,0
878230,True,0,No user reviews,0,0,0
878240,True,0,No user reviews,0,0,0
878250,True,7,Positive,14,0,14
878260,True,0,No user reviews,0,0,0
878270,True,0,5 user reviews,2,3,5
878280,True,0,No user reviews,0,0,0
878290,True,7,Positive,13,2,15
878300,True,0,2 user reviews,1,1,2
878310,True,0,No user reviews,0,0,0
878320,True,0,No user reviews,0,0,0
878330,True,0,7 user reviews,6,1,7
878340,True,0,1 user reviews,1,0,1
878350,True,5,Mixed,9,4,13
878380,True,8,Very Positive,46,8,54
878400,True,0,1 user reviews,0,1,1
878410,True,0,No user reviews,0,0,0
878420,True,7,Positive,35,8,43
878440,True,0,No user reviews,0,0,0
878460,True,7,Positive,19,2,21
878461,True,7,Positive,29,5,34
878462,True,7,Positive,16,3,19
878463,True,7,Positive,37,1,38
878464,True,7,Positive,17,2,19
878465,True,8,Very Positive,49,4,53
878467,True,8,Very Positive,88,12,100
878470,True,0,1 user reviews,0,1,1
878500,True,0,No user reviews,0,0,0
878510,True,0,1 user reviews,1,0,1
878520,True,5,Mixed,12,9,21
878530,True,0,No user reviews,0,0,0
878540,True,0,1 user reviews,0,1,1
878570,True,0,2 user reviews,0,2,2
878580,True,6,Mostly Positive,49,14,63
878590,True,0,No user reviews,0,0,0
878600,True,0,No user reviews,0,0,0
878610,True,0,No user reviews,0,0,0
878620,True,0,1 user reviews,1,0,1
878630,True,0,1 user reviews,0,1,1
878640,True,0,7 user reviews,5,2,7
878660,True,0,4 user reviews,2,2,4
878670,True,0,No user reviews,0,0,0
878680,True,7,Positive,22,2,24
878690,True,0,No user reviews,0,0,0
878710,True,0,8 user reviews,4,4,8
878750,True,8,Very Positive,1530,124,1654
878760,True,0,No user reviews,0,0,0
878770,True,0,4 user reviews,3,1,4
878780,True,0,9 user reviews,8,1,9
878810,True,0,3 user reviews,0,3,3
878820,True,0,1 user reviews,0,1,1
878830,True,0,No user reviews,0,0,0
878840,True,0,No user reviews,0,0,0
878880,True,0,No user reviews,0,0,0
878890,True,0,2 user reviews,1,1,2
878910,True,0,1 user reviews,1,0,1
878920,True,7,Positive,25,0,25
878940,True,0,No user reviews,0,0,0
878950,True,7,Positive,13,2,15
878960,True,0,No user reviews,0,0,0
878970,True,0,No user reviews,0,0,0
878980,True,0,2 user reviews,2,0,2
878990,True,0,No user reviews,0,0,0
879000,True,6,Mostly Positive,60,24,84
879030,True,0,No user reviews,0,0,0
879050,True,0,No user reviews,0,0,0
879060,True,0,5 user reviews,3,2,5
879080,True,0,No user reviews,0,0,0
879090,True,0,2 user reviews,1,1,2
879100,True,0,1 user reviews,1,0,1
879110,True,0,1 user reviews,1,0,1
879120,True,0,4 user reviews,2,2,4
879160,True,5,Mixed,974,498,1472
879180,True,0,No user reviews,0,0,0
879190,True,0,No user reviews,0,0,0
879200,True,0,3 user reviews,2,1,3
879240,True,5,Mixed,17,18,35
879250,True,0,No user reviews,0,0,0
879260,True,0,2 user reviews,2,0,2
879270,True,0,3 user reviews,3,0,3
879280,True,0,2 user reviews,1,1,2
879290,True,7,Positive,11,0,11
879300,True,0,No user reviews,0,0,0
879310,True,0,8 user reviews,4,4,8
879320,True,0,No user reviews,0,0,0
879330,True,0,No user reviews,0,0,0
879380,True,0,No user reviews,0,0,0
879390,True,0,No user reviews,0,0,0
879410,True,0,No user reviews,0,0,0
879420,True,5,Mixed,613,288,901
879430,True,0,3 user reviews,3,0,3
879450,True,0,No user reviews,0,0,0
879460,True,0,No user reviews,0,0,0
879470,True,5,Mixed,23,12,35
879480,True,0,No user reviews,0,0,0
879490,True,0,No user reviews,0,0,0
879500,True,0,No user reviews,0,0,0
879510,True,8,Very Positive,174,9,183
879520,True,0,4 user reviews,4,0,4
879530,True,0,No user reviews,0,0,0
879550,True,0,No user reviews,0,0,0
879580,True,0,No user reviews,0,0,0
879600,True,0,5 user reviews,5,0,5
879610,True,5,Mixed,5,5,10
879620,True,0,7 user reviews,2,5,7
879650,True,0,No user reviews,0,0,0
879660,True,0,2 user reviews,2,0,2
879670,True,5,Mixed,18,27,45
879720,True,0,No user reviews,0,0,0
879730,True,0,No user reviews,0,0,0
879731,True,0,No user reviews,0,0,0
879732,True,0,1 user reviews,1,0,1
879733,True,0,2 user reviews,2,0,2
879740,True,0,9 user reviews,8,1,9
879760,True,0,No user reviews,0,0,0
879780,True,0,No user reviews,0,0,0
879790,True,0,No user reviews,0,0,0
879800,True,0,No user reviews,0,0,0
879810,True,0,No user reviews,0,0,0
879811,True,0,No user reviews,0,0,0
879812,True,0,No user reviews,0,0,0
879813,True,0,No user reviews,0,0,0
879814,True,0,No user reviews,0,0,0
879815,True,0,No user reviews,0,0,0
879816,True,0,No user reviews,0,0,0
879817,True,0,No user reviews,0,0,0
879818,True,0,No user reviews,0,0,0
879819,True,0,No user reviews,0,0,0
879820,True,0,No user reviews,0,0,0
879821,True,0,No user reviews,0,0,0
879830,True,0,No user reviews,0,0,0
879831,True,0,No user reviews,0,0,0
879832,True,0,No user reviews,0,0,0
879833,True,0,No user reviews,0,0,0
879834,True,0,No user reviews,0,0,0
879835,True,0,No user reviews,0,0,0
879836,True,0,No user reviews,0,0,0
879837,True,0,No user reviews,0,0,0
879838,True,0,No user reviews,0,0,0
879839,True,0,No user reviews,0,0,0
879840,True,0,No user reviews,0,0,0
879841,True,0,No user reviews,0,0,0
879850,True,0,No user reviews,0,0,0
879860,True,0,No user reviews,0,0,0
879870,True,0,No user reviews,0,0,0
879920,True,0,No user reviews,0,0,0
879930,True,0,No user reviews,0,0,0
880130,True,7,Positive,36,1,37
880170,True,0,No user reviews,0,0,0
880180,True,0,No user reviews,0,0,0
880200,True,0,6 user reviews,2,4,6
880210,True,0,No user reviews,0,0,0
880220,True,0,2 user reviews,1,1,2
880240,True,0,1 user reviews,1,0,1
880250,True,0,3 user reviews,3,0,3
880270,True,0,No user reviews,0,0,0
880281,True,7,Positive,29,0,29
880282,True,0,6 user reviews,6,0,6
880283,True,0,No user reviews,0,0,0
880290,True,0,No user reviews,0,0,0
880300,True,6,Mostly Positive,14,6,20
880310,True,0,6 user reviews,3,3,6
880320,True,0,1 user reviews,1,0,1
880330,True,0,No user reviews,0,0,0
880340,True,0,2 user reviews,2,0,2
880350,True,0,No user reviews,0,0,0
880351,True,0,No user reviews,0,0,0
880370,True,0,4 user reviews,3,1,4
880380,True,5,Mixed,60,51,111
880400,True,7,Positive,33,2,35
880460,True,0,No user reviews,0,0,0
880470,True,5,Mixed,8,8,16
880480,True,0,No user reviews,0,0,0
880490,True,7,Positive,34,3,37
880510,True,8,Very Positive,246,35,281
880520,True,7,Positive,10,2,12
880521,True,6,Mostly Positive,16,5,21
880540,True,0,No user reviews,0,0,0
880550,True,0,5 user reviews,4,1,5
880570,True,0,3 user reviews,3,0,3
880580,True,8,Very Positive,58,9,67
880590,True,0,No user reviews,0,0,0
880610,True,7,Positive,26,1,27
880620,True,0,3 user reviews,0,3,3
880630,True,0,No user reviews,0,0,0
880640,True,6,Mostly Positive,206,71,277
880670,True,0,No user reviews,0,0,0
880680,True,0,No user reviews,0,0,0
880700,True,0,No user reviews,0,0,0
880710,True,0,No user reviews,0,0,0
880720,True,0,5 user reviews,5,0,5
880730,True,0,No user reviews,0,0,0
880740,True,0,2 user reviews,2,0,2
880750,True,5,Mixed,10,12,22
880760,True,0,No user reviews,0,0,0
880770,True,0,No user reviews,0,0,0
880780,True,0,6 user reviews,5,1,6
880790,True,0,No user reviews,0,0,0
880800,True,0,5 user reviews,3,2,5
880830,True,7,Positive,12,1,13
880840,True,0,No user reviews,0,0,0
880850,True,0,No user reviews,0,0,0
880860,True,0,9 user reviews,6,3,9
880880,True,0,No user reviews,0,0,0
880910,True,0,No user reviews,0,0,0
880923,True,0,1 user reviews,0,1,1
880924,True,0,1 user reviews,1,0,1
880940,True,8,Very Positive,5406,559,5965
880950,True,7,Positive,20,1,21
880990,True,0,5 user reviews,0,5,5
881000,True,0,No user reviews,0,0,0
881030,True,0,No user reviews,0,0,0
881040,True,7,Positive,15,0,15
881050,True,0,1 user reviews,0,1,1
881060,True,0,2 user reviews,2,0,2
881070,True,0,No user reviews,0,0,0
881080,True,0,3 user reviews,1,2,3
881090,True,0,1 user reviews,1,0,1
881100,True,9,Overwhelmingly Positive,10346,441,10787
881110,True,0,5 user reviews,4,1,5
881130,True,7,Positive,24,0,24
881150,True,0,No user reviews,0,0,0
881170,True,0,4 user reviews,2,2,4
881190,True,0,1 user reviews,1,0,1
881210,True,0,No user reviews,0,0,0
881220,True,0,No user reviews,0,0,0
881230,True,0,No user reviews,0,0,0
881260,True,0,3 user reviews,3,0,3
881290,True,0,No user reviews,0,0,0
881300,True,0,No user reviews,0,0,0
881310,True,0,3 user reviews,2,1,3
881320,True,5,Mixed,86,42,128
881330,True,0,2 user reviews,2,0,2
881340,True,0,No user reviews,0,0,0
881390,True,0,4 user reviews,3,1,4
881420,True,8,Very Positive,179,35,214
881430,True,0,No user reviews,0,0,0
881470,True,0,2 user reviews,2,0,2
881480,True,7,Positive,11,1,12
881490,True,0,No user reviews,0,0,0
881500,True,5,Mixed,7,4,11
881510,True,0,4 user reviews,2,2,4
881520,True,0,7 user reviews,4,3,7
881530,True,0,No user reviews,0,0,0
881550,True,0,No user reviews,0,0,0
881560,True,8,Very Positive,181,29,210
881590,True,0,No user reviews,0,0,0
881591,True,0,No user reviews,0,0,0
881600,True,0,No user reviews,0,0,0
881610,True,0,7 user reviews,1,6,7
881620,True,0,1 user reviews,1,0,1
881660,True,0,1 user reviews,1,0,1
881670,True,0,3 user reviews,2,1,3
881680,True,6,Mostly Positive,30,10,40
881690,True,6,Mostly Positive,118,45,163
881710,True,0,No user reviews,0,0,0
881730,True,0,3 user reviews,2,1,3
881750,True,5,Mixed,9,4,13
881800,True,0,No user reviews,0,0,0
881810,True,0,No user reviews,0,0,0
881820,True,0,No user reviews,0,0,0
881830,True,0,No user reviews,0,0,0
881840,True,0,No user reviews,0,0,0
881841,True,0,No user reviews,0,0,0
881880,True,0,8 user reviews,3,5,8
881900,True,0,No user reviews,0,0,0
881910,True,0,1 user reviews,0,1,1
881920,True,5,Mixed,65,28,93
881930,True,0,5 user reviews,1,4,5
881950,True,0,No user reviews,0,0,0
881960,True,0,1 user reviews,1,0,1
881970,True,0,No user reviews,0,0,0
881980,True,0,No user reviews,0,0,0
881990,True,0,No user reviews,0,0,0
882020,True,6,Mostly Positive,167,45,212
882030,True,0,No user reviews,0,0,0
882040,True,7,Positive,17,3,20
882070,True,0,6 user reviews,4,2,6
882080,True,0,3 user reviews,2,1,3
882100,True,6,Mostly Positive,6855,2151,9006
882110,True,0,No user reviews,0,0,0
882140,True,8,Very Positive,185,7,192
882150,True,7,Positive,34,1,35
882180,True,0,No user reviews,0,0,0
882200,True,5,Mixed,5,6,11
882210,True,7,Positive,19,3,22
882220,True,0,No user reviews,0,0,0
882230,True,0,1 user reviews,1,0,1
882250,True,8,Very Positive,60,11,71
882260,True,0,No user reviews,0,0,0
882270,True,0,2 user reviews,2,0,2
882280,True,0,No user reviews,0,0,0
882290,True,0,3 user reviews,2,1,3
882300,True,0,No user reviews,0,0,0
882330,True,0,3 user reviews,1,2,3
882340,True,0,No user reviews,0,0,0
882350,True,0,No user reviews,0,0,0
882380,True,0,No user reviews,0,0,0
882390,True,0,1 user reviews,1,0,1
882400,True,0,No user reviews,0,0,0
882410,True,0,No user reviews,0,0,0
882430,True,0,No user reviews,0,0,0
882440,True,0,No user reviews,0,0,0
882450,True,0,No user reviews,0,0,0
882460,True,0,4 user reviews,1,3,4
882540,True,0,No user reviews,0,0,0
882550,True,0,No user reviews,0,0,0
882560,True,5,Mixed,28,23,51
882590,True,0,No user reviews,0,0,0
882600,True,0,1 user reviews,1,0,1
882620,True,0,4 user reviews,4,0,4
882630,True,0,1 user reviews,1,0,1
882640,True,7,Positive,17,2,19
882650,True,0,No user reviews,0,0,0
882660,True,0,No user reviews,0,0,0
882670,True,0,2 user reviews,2,0,2
882680,True,7,Positive,10,1,11
882700,True,0,1 user reviews,1,0,1
882710,True,8,Very Positive,142,10,152
882720,True,0,No user reviews,0,0,0
882740,True,0,No user reviews,0,0,0
882750,True,0,1 user reviews,1,0,1
882760,True,0,2 user reviews,1,1,2
882790,True,8,Very Positive,123,5,128
882800,True,0,1 user reviews,0,1,1
882830,True,0,No user reviews,0,0,0
882840,True,0,2 user reviews,1,1,2
882860,True,0,No user reviews,0,0,0
882870,True,0,No user reviews,0,0,0
882890,True,0,No user reviews,0,0,0
882900,True,0,9 user reviews,8,1,9
882910,True,0,6 user reviews,0,6,6
882940,True,6,Mostly Positive,8,3,11
882960,True,5,Mixed,10,6,16
882990,True,0,No user reviews,0,0,0
883000,True,0,5 user reviews,2,3,5
883020,True,7,Positive,10,1,11
883060,True,0,No user reviews,0,0,0
883061,True,0,No user reviews,0,0,0
883062,True,0,No user reviews,0,0,0
883070,True,7,Positive,40,9,49
883080,True,7,Positive,36,9,45
883100,True,8,Very Positive,210,22,232
883110,True,0,No user reviews,0,0,0
883120,True,0,No user reviews,0,0,0
883130,True,8,Very Positive,111,17,128
883140,True,5,Mixed,41,20,61
883150,True,5,Mixed,224,149,373
883160,True,0,No user reviews,0,0,0
883170,True,0,6 user reviews,2,4,6
883180,True,0,No user reviews,0,0,0
883181,True,0,No user reviews,0,0,0
883182,True,0,No user reviews,0,0,0
883190,True,0,3 user reviews,3,0,3
883200,True,0,1 user reviews,1,0,1
883210,True,0,No user reviews,0,0,0
883220,True,5,Mixed,49,25,74
883240,True,0,No user reviews,0,0,0
883250,True,0,No user reviews,0,0,0
883270,True,0,No user reviews,0,0,0
883280,True,0,No user reviews,0,0,0
883290,True,0,No user reviews,0,0,0
883300,True,0,6 user reviews,4,2,6
883310,True,0,4 user reviews,3,1,4
883320,True,0,No user reviews,0,0,0
883330,True,0,5 user reviews,3,2,5
883340,True,0,No user reviews,0,0,0
883360,True,8,Very Positive,175,38,213
883390,True,0,3 user reviews,2,1,3
883400,True,0,No user reviews,0,0,0
883430,True,0,No user reviews,0,0,0
883440,True,0,No user reviews,0,0,0
883450,True,0,No user reviews,0,0,0
883460,True,0,No user reviews,0,0,0
883470,True,0,No user reviews,0,0,0
883480,True,0,No user reviews,0,0,0
883490,True,0,No user reviews,0,0,0
883510,True,0,No user reviews,0,0,0
883520,True,0,No user reviews,0,0,0
883530,True,0,No user reviews,0,0,0
883540,True,0,No user reviews,0,0,0
883550,True,0,No user reviews,0,0,0
883560,True,0,4 user reviews,4,0,4
883570,True,0,No user reviews,0,0,0
883590,True,0,No user reviews,0,0,0
883620,True,0,No user reviews,0,0,0
883630,True,0,2 user reviews,2,0,2
883640,True,0,No user reviews,0,0,0
883670,True,5,Mixed,14,10,24
883680,True,0,1 user reviews,1,0,1
883700,True,0,No user reviews,0,0,0
883710,True,9,Overwhelmingly Positive,19091,514,19605
883750,True,0,No user reviews,0,0,0
883780,True,0,No user reviews,0,0,0
883790,True,0,3 user reviews,2,1,3
883800,True,0,1 user reviews,1,0,1
883810,True,0,1 user reviews,1,0,1
883820,True,0,No user reviews,0,0,0
883830,True,0,4 user reviews,3,1,4
883840,True,0,No user reviews,0,0,0
883850,True,0,No user reviews,0,0,0
883860,True,0,No user reviews,0,0,0
883870,True,0,No user reviews,0,0,0
883880,True,0,No user reviews,0,0,0
883900,True,0,No user reviews,0,0,0
883930,True,0,2 user reviews,1,1,2
883960,True,0,1 user reviews,0,1,1
883970,True,0,6 user reviews,0,6,6
884000,True,0,8 user reviews,2,6,8
884010,True,0,No user reviews,0,0,0
884020,True,0,No user reviews,0,0,0
884030,True,0,1 user reviews,1,0,1
884031,True,0,No user reviews,0,0,0
884070,True,0,No user reviews,0,0,0
884080,True,0,1 user reviews,1,0,1
884090,True,0,No user reviews,0,0,0
884110,True,0,No user reviews,0,0,0
884140,True,7,Positive,16,1,17
884141,True,6,Mostly Positive,33,11,44
884142,True,7,Positive,11,1,12
884143,True,6,Mostly Positive,16,5,21
884160,True,0,No user reviews,0,0,0
884180,True,0,No user reviews,0,0,0
884200,True,5,Mixed,26,15,41
884240,True,0,No user reviews,0,0,0
884260,True,9,Overwhelmingly Positive,644,23,667
884270,True,0,2 user reviews,2,0,2
884290,True,0,4 user reviews,2,2,4
884320,True,5,Mixed,63,51,114
884340,True,5,Mixed,15,11,26
884350,True,0,No user reviews,0,0,0
884370,True,0,4 user reviews,3,1,4
884390,True,0,5 user reviews,1,4,5
884400,True,7,Positive,10,0,10
884410,True,5,Mixed,6,4,10
884420,True,7,Positive,14,1,15
884430,True,5,Mixed,5,6,11
884440,True,0,3 user reviews,1,2,3
884460,True,0,3 user reviews,2,1,3
884470,True,0,3 user reviews,3,0,3
884490,True,0,No user reviews,0,0,0
884500,True,0,2 user reviews,0,2,2
884510,True,0,No user reviews,0,0,0
884530,True,0,6 user reviews,0,6,6
884540,True,0,No user reviews,0,0,0
884550,True,0,No user reviews,0,0,0
884560,True,0,No user reviews,0,0,0
884580,True,0,No user reviews,0,0,0
884590,True,0,3 user reviews,0,3,3
884610,True,0,No user reviews,0,0,0
884620,True,5,Mixed,47,53,100
884630,True,0,2 user reviews,2,0,2
884640,True,5,Mixed,11,11,22
884650,True,0,No user reviews,0,0,0
884660,True,0,2 user reviews,2,0,2
884700,True,0,No user reviews,0,0,0
884710,True,0,1 user reviews,1,0,1
884730,True,0,No user reviews,0,0,0
884760,True,0,3 user reviews,3,0,3
884761,True,0,2 user reviews,2,0,2
884762,True,0,2 user reviews,2,0,2
884770,True,0,4 user reviews,2,2,4
884780,True,0,No user reviews,0,0,0
884790,True,0,1 user reviews,1,0,1
884791,True,0,No user reviews,0,0,0
884830,True,0,No user reviews,0,0,0
884860,True,0,2 user reviews,2,0,2
884870,True,0,3 user reviews,2,1,3
884880,True,0,6 user reviews,5,1,6
884890,True,0,No user reviews,0,0,0
884900,True,0,1 user reviews,0,1,1
884910,True,0,No user reviews,0,0,0
884920,True,0,No user reviews,0,0,0
884960,True,7,Positive,20,2,22
884970,True,0,No user reviews,0,0,0
884980,True,7,Positive,16,0,16
884990,True,6,Mostly Positive,38,10,48
885000,True,8,Very Positive,267,19,286
885030,True,0,No user reviews,0,0,0
885070,True,0,No user reviews,0,0,0
885071,True,0,No user reviews,0,0,0
885080,True,0,No user reviews,0,0,0
885090,True,0,9 user reviews,1,8,9
885100,True,4,Mostly Negative,7,14,21
885110,True,4,Mostly Negative,4,7,11
885120,True,7,Positive,41,5,46
885130,True,0,No user reviews,0,0,0
885140,True,0,3 user reviews,1,2,3
885150,True,8,Very Positive,140,19,159
885170,True,0,2 user reviews,0,2,2
885180,True,0,4 user reviews,1,3,4
885190,True,5,Mixed,9,6,15
885210,True,0,No user reviews,0,0,0
885220,True,0,1 user reviews,1,0,1
885240,True,0,3 user reviews,2,1,3
885250,True,0,1 user reviews,1,0,1
885260,True,0,2 user reviews,2,0,2
885270,True,5,Mixed,25,14,39
885290,True,0,4 user reviews,3,1,4
885300,True,0,No user reviews,0,0,0
885320,True,0,5 user reviews,1,4,5
885380,True,5,Mixed,7,7,14
885390,True,4,Mostly Negative,6,12,18
885410,True,0,No user reviews,0,0,0
885430,True,0,1 user reviews,1,0,1
885440,True,6,Mostly Positive,31,10,41
885450,True,0,No user reviews,0,0,0
885460,True,0,No user reviews,0,0,0
885470,True,0,No user reviews,0,0,0
885480,True,0,No user reviews,0,0,0
885490,True,0,No user reviews,0,0,0
885520,True,0,No user reviews,0,0,0
885540,True,0,No user reviews,0,0,0
885550,True,7,Positive,29,4,33
885570,True,0,3 user reviews,2,1,3
885590,True,0,No user reviews,0,0,0
885630,True,6,Mostly Positive,7,3,10
885640,True,0,No user reviews,0,0,0
885650,True,0,No user reviews,0,0,0
885660,True,0,2 user reviews,1,1,2
885690,True,0,No user reviews,0,0,0
885700,True,0,No user reviews,0,0,0
885701,True,0,No user reviews,0,0,0
885720,True,0,No user reviews,0,0,0
885730,True,0,No user reviews,0,0,0
885780,True,7,Positive,21,5,26
885790,True,0,4 user reviews,3,1,4
885810,True,8,Very Positive,201,5,206
885850,True,0,No user reviews,0,0,0
885851,True,0,No user reviews,0,0,0
885860,True,0,No user reviews,0,0,0
885890,True,0,No user reviews,0,0,0
885910,True,7,Positive,11,0,11
885920,True,0,2 user reviews,2,0,2
885940,True,8,Very Positive,66,5,71
885950,True,8,Very Positive,64,2,66
885960,True,7,Positive,15,1,16
885980,True,0,No user reviews,0,0,0
886010,True,0,4 user reviews,2,2,4
886020,True,0,3 user reviews,0,3,3
886030,True,0,No user reviews,0,0,0
886040,True,6,Mostly Positive,90,25,115
886050,True,0,No user reviews,0,0,0
886060,True,0,No user reviews,0,0,0
886070,True,7,Positive,35,4,39
886110,True,7,Positive,11,1,12
886120,True,0,7 user reviews,3,4,7
886130,True,0,No user reviews,0,0,0
886140,True,0,1 user reviews,1,0,1
886150,True,0,No user reviews,0,0,0
886160,True,0,No user reviews,0,0,0
886170,True,0,No user reviews,0,0,0
886180,True,6,Mostly Positive,9,3,12
886190,True,0,No user reviews,0,0,0
886200,True,7,Positive,32,0,32
886210,True,0,No user reviews,0,0,0
886220,True,0,No user reviews,0,0,0
886230,True,0,3 user reviews,0,3,3
886250,True,0,No user reviews,0,0,0
886270,True,5,Mixed,7,5,12
886280,True,5,Mixed,5,5,10
886290,True,0,1 user reviews,1,0,1
886300,True,0,3 user reviews,3,0,3
886310,True,0,2 user reviews,0,2,2
886330,True,0,2 user reviews,1,1,2
886340,True,0,No user reviews,0,0,0
886341,True,0,No user reviews,0,0,0
886342,True,0,No user reviews,0,0,0
886343,True,0,No user reviews,0,0,0
886344,True,0,No user reviews,0,0,0
886345,True,0,No user reviews,0,0,0
886346,True,0,No user reviews,0,0,0
886350,True,0,4 user reviews,3,1,4
886360,True,7,Positive,9,1,10
886370,True,5,Mixed,14,12,26
886380,True,0,4 user reviews,4,0,4
886390,True,0,1 user reviews,1,0,1
886400,True,0,No user reviews,0,0,0
886420,True,0,1 user reviews,0,1,1
886430,True,0,No user reviews,0,0,0
886440,True,0,No user reviews,0,0,0
886450,True,0,1 user reviews,0,1,1
886460,True,0,No user reviews,0,0,0
886470,True,0,7 user reviews,7,0,7
886480,True,0,1 user reviews,1,0,1
886490,True,0,5 user reviews,2,3,5
886520,True,4,Mostly Negative,14,23,37
886530,True,0,No user reviews,0,0,0
886540,True,0,No user reviews,0,0,0
886590,True,0,4 user reviews,3,1,4
886600,True,0,4 user reviews,3,1,4
886610,True,0,2 user reviews,0,2,2
886620,True,0,No user reviews,0,0,0
886630,True,7,Positive,11,1,12
886650,True,0,No user reviews,0,0,0
886660,True,0,No user reviews,0,0,0
886661,True,0,No user reviews,0,0,0
886670,True,0,3 user reviews,3,0,3
886710,True,5,Mixed,13,18,31
886720,True,0,No user reviews,0,0,0
886730,True,5,Mixed,7,7,14
886750,True,0,No user reviews,0,0,0
886780,True,0,2 user reviews,1,1,2
886820,True,6,Mostly Positive,30,10,40
886830,True,0,1 user reviews,1,0,1
886840,True,0,No user reviews,0,0,0
886860,True,0,No user reviews,0,0,0
886890,True,0,No user reviews,0,0,0
886900,True,6,Mostly Positive,316,101,417
886910,True,0,No user reviews,0,0,0
886920,True,5,Mixed,12,7,19
886930,True,7,Positive,22,0,22
886950,True,0,6 user reviews,5,1,6
886960,True,8,Very Positive,105,25,130
886970,True,7,Positive,16,4,20
887030,True,0,3 user reviews,2,1,3
887040,True,0,No user reviews,0,0,0
887050,True,0,6 user reviews,5,1,6
887060,True,6,Mostly Positive,75,22,97
887070,True,0,No user reviews,0,0,0
887090,True,5,Mixed,18,9,27
887120,True,5,Mixed,34,15,49
887130,True,0,No user reviews,0,0,0
887160,True,0,1 user reviews,1,0,1
887170,True,0,No user reviews,0,0,0
887180,True,0,No user reviews,0,0,0
887190,True,0,No user reviews,0,0,0
887230,True,0,No user reviews,0,0,0
887280,True,0,No user reviews,0,0,0
887300,True,0,3 user reviews,3,0,3
887340,True,6,Mostly Positive,40,14,54
887350,True,0,No user reviews,0,0,0
887370,True,5,Mixed,72,32,104
887380,True,5,Mixed,467,369,836
887390,True,0,No user reviews,0,0,0
887400,True,7,Positive,14,0,14
887420,True,7,Positive,13,1,14
887430,True,0,No user reviews,0,0,0
887440,True,0,No user reviews,0,0,0
887450,True,0,No user reviews,0,0,0
887490,True,0,No user reviews,0,0,0
887510,True,7,Positive,16,0,16
887520,True,0,5 user reviews,3,2,5
887530,True,8,Very Positive,51,12,63
887550,True,7,Positive,11,1,12
887570,True,0,No user reviews,0,0,0
887580,True,0,No user reviews,0,0,0
887590,True,0,No user reviews,0,0,0
887630,True,0,No user reviews,0,0,0
887660,True,0,3 user reviews,2,1,3
887680,True,0,No user reviews,0,0,0
887690,True,0,5 user reviews,2,3,5
887700,True,0,No user reviews,0,0,0
887710,True,0,3 user reviews,2,1,3
887720,True,5,Mixed,57,44,101
887730,True,6,Mostly Positive,15,5,20
887740,True,0,No user reviews,0,0,0
887750,True,0,1 user reviews,1,0,1
887760,True,0,No user reviews,0,0,0
887780,True,6,Mostly Positive,10,4,14
887790,True,0,No user reviews,0,0,0
887800,True,5,Mixed,123,76,199
887820,True,6,Mostly Positive,14,6,20
887850,True,0,8 user reviews,7,1,8
887870,True,0,No user reviews,0,0,0
887880,True,0,No user reviews,0,0,0
887890,True,0,6 user reviews,6,0,6
887900,True,7,Positive,12,1,13
887910,True,0,2 user reviews,1,1,2
887920,True,0,No user reviews,0,0,0
887930,True,0,2 user reviews,2,0,2
887940,True,0,1 user reviews,1,0,1
887950,True,0,1 user reviews,1,0,1
887960,True,0,9 user reviews,4,5,9
887970,True,6,Mostly Positive,7,3,10
887980,True,0,No user reviews,0,0,0
888000,True,7,Positive,16,0,16
888010,True,6,Mostly Positive,15,4,19
888020,True,0,No user reviews,0,0,0
888040,True,8,Very Positive,116,11,127
888060,True,0,No user reviews,0,0,0
888070,True,0,No user reviews,0,0,0
888090,True,0,No user reviews,0,0,0
888110,True,0,No user reviews,0,0,0
888130,True,6,Mostly Positive,27,8,35
888150,True,0,No user reviews,0,0,0
888200,True,0,No user reviews,0,0,0
888210,True,0,2 user reviews,2,0,2
888220,True,0,4 user reviews,4,0,4
888240,True,0,4 user reviews,3,1,4
888250,True,0,1 user reviews,0,1,1
888260,True,8,Very Positive,95,10,105
888310,True,0,2 user reviews,2,0,2
888330,True,0,No user reviews,0,0,0
888350,True,0,No user reviews,0,0,0
888360,True,0,5 user reviews,5,0,5
888370,True,0,9 user reviews,7,2,9
888380,True,0,2 user reviews,1,1,2
888390,True,0,No user reviews,0,0,0
888400,True,0,3 user reviews,0,3,3
888430,True,0,No user reviews,0,0,0
888440,True,0,No user reviews,0,0,0
888450,True,0,No user reviews,0,0,0
888451,True,0,No user reviews,0,0,0
888452,True,0,No user reviews,0,0,0
888480,True,0,No user reviews,0,0,0
888490,True,0,No user reviews,0,0,0
888491,True,0,No user reviews,0,0,0
888492,True,0,No user reviews,0,0,0
888493,True,0,No user reviews,0,0,0
888494,True,0,No user reviews,0,0,0
888495,True,0,No user reviews,0,0,0
888496,True,0,No user reviews,0,0,0
888497,True,0,No user reviews,0,0,0
888498,True,0,No user reviews,0,0,0
888499,True,0,No user reviews,0,0,0
888510,True,0,No user reviews,0,0,0
888511,True,0,No user reviews,0,0,0
888512,True,0,No user reviews,0,0,0
888513,True,0,No user reviews,0,0,0
888514,True,0,1 user reviews,1,0,1
888515,True,0,1 user reviews,0,1,1
888516,True,0,No user reviews,0,0,0
888517,True,0,No user reviews,0,0,0
888520,True,0,No user reviews,0,0,0
888530,True,0,No user reviews,0,0,0
888540,True,0,No user reviews,0,0,0
888560,True,0,1 user reviews,0,1,1
888570,True,0,1 user reviews,1,0,1
888590,True,0,No user reviews,0,0,0
888600,True,0,No user reviews,0,0,0
888601,True,0,No user reviews,0,0,0
888602,True,0,No user reviews,0,0,0
888603,True,0,No user reviews,0,0,0
888604,True,0,No user reviews,0,0,0
888605,True,0,No user reviews,0,0,0
888610,True,0,8 user reviews,4,4,8
888620,True,0,1 user reviews,0,1,1
888630,True,7,Positive,41,3,44
888640,True,0,1 user reviews,1,0,1
888650,True,6,Mostly Positive,53,16,69
888670,True,0,No user reviews,0,0,0
888680,True,0,No user reviews,0,0,0
888690,True,5,Mixed,6,6,12
888700,True,0,No user reviews,0,0,0
888701,True,7,Positive,10,2,12
888710,True,0,3 user reviews,2,1,3
888720,True,0,No user reviews,0,0,0
888740,True,0,1 user reviews,0,1,1
888750,True,0,1 user reviews,1,0,1
888760,True,0,No user reviews,0,0,0
888770,True,5,Mixed,327,472,799
888780,True,0,No user reviews,0,0,0
888790,True,8,Very Positive,237,8,245
888800,True,0,No user reviews,0,0,0
888810,True,0,5 user reviews,1,4,5
888820,True,0,5 user reviews,4,1,5
888830,True,0,No user reviews,0,0,0
888850,True,0,3 user reviews,3,0,3
888851,True,0,5 user reviews,4,1,5
888852,True,0,8 user reviews,5,3,8
888853,True,0,3 user reviews,3,0,3
888854,True,0,6 user reviews,4,2,6
888855,True,5,Mixed,9,5,14
888856,True,0,2 user reviews,2,0,2
888857,True,0,3 user reviews,3,0,3
888858,True,0,5 user reviews,4,1,5
888859,True,0,1 user reviews,0,1,1
888870,True,0,8 user reviews,2,6,8
888871,True,0,No user reviews,0,0,0
888872,True,5,Mixed,12,6,18
888880,True,0,1 user reviews,0,1,1
888900,True,0,4 user reviews,4,0,4
888910,True,0,No user reviews,0,0,0
888950,True,0,No user reviews,0,0,0
888960,True,0,No user reviews,0,0,0
888970,True,0,7 user reviews,2,5,7
888990,True,7,Positive,11,0,11
889000,True,0,No user reviews,0,0,0
889010,True,0,No user reviews,0,0,0
889030,True,0,3 user reviews,3,0,3
889040,True,6,Mostly Positive,74,25,99
889060,True,0,No user reviews,0,0,0
889070,True,0,1 user reviews,1,0,1
889071,True,0,No user reviews,0,0,0
889072,True,0,No user reviews,0,0,0
889073,True,0,No user reviews,0,0,0
889080,True,8,Very Positive,162,13,175
889100,True,0,1 user reviews,1,0,1
889110,True,0,No user reviews,0,0,0
889120,True,0,1 user reviews,1,0,1
889130,True,0,No user reviews,0,0,0
889150,True,0,1 user reviews,1,0,1
889160,True,0,No user reviews,0,0,0
889170,True,7,Positive,20,5,25
889180,True,0,No user reviews,0,0,0
889200,True,0,No user reviews,0,0,0
889210,True,0,No user reviews,0,0,0
889220,True,0,No user reviews,0,0,0
889240,True,0,No user reviews,0,0,0
889260,True,0,9 user reviews,9,0,9
889280,True,7,Positive,9,1,10
889290,True,0,1 user reviews,1,0,1
889300,True,0,No user reviews,0,0,0
889320,True,0,No user reviews,0,0,0
889330,True,0,2 user reviews,1,1,2
889340,True,5,Mixed,6,5,11
889350,True,0,No user reviews,0,0,0
889360,True,0,No user reviews,0,0,0
889380,True,0,2 user reviews,1,1,2
889400,True,7,Positive,11,0,11
889420,True,0,No user reviews,0,0,0
889430,True,0,No user reviews,0,0,0
889440,True,0,1 user reviews,1,0,1
889450,True,0,3 user reviews,3,0,3
889460,True,0,8 user reviews,5,3,8
889470,True,0,3 user reviews,1,2,3
889480,True,8,Very Positive,333,22,355
889510,True,8,Very Positive,330,23,353
889520,True,7,Positive,22,3,25
889530,True,0,No user reviews,0,0,0
889580,True,0,No user reviews,0,0,0
889590,True,0,No user reviews,0,0,0
889600,True,6,Mostly Positive,73,22,95
889610,True,0,No user reviews,0,0,0
889611,True,0,No user reviews,0,0,0
889612,True,0,No user reviews,0,0,0
889613,True,0,No user reviews,0,0,0
889614,True,0,No user reviews,0,0,0
889620,True,0,No user reviews,0,0,0
889630,True,0,2 user reviews,1,1,2
889640,True,0,1 user reviews,1,0,1
889650,True,0,No user reviews,0,0,0
889670,True,0,No user reviews,0,0,0
889680,True,0,No user reviews,0,0,0
889700,True,7,Positive,29,2,31
889710,True,7,Positive,30,5,35
889720,True,5,Mixed,7,5,12
889730,True,0,No user reviews,0,0,0
889740,True,0,No user reviews,0,0,0
889760,True,0,1 user reviews,0,1,1
889770,True,8,Very Positive,47,9,56
889790,True,0,3 user reviews,2,1,3
889800,True,0,5 user reviews,5,0,5
889820,True,7,Positive,33,1,34
889830,True,0,No user reviews,0,0,0
889840,True,0,No user reviews,0,0,0
889850,True,0,No user reviews,0,0,0
889870,True,0,No user reviews,0,0,0
889871,True,0,No user reviews,0,0,0
889872,True,0,No user reviews,0,0,0
889890,True,6,Mostly Positive,29,10,39
889902,True,5,Mixed,20,18,38
889903,True,5,Mixed,27,16,43
889910,True,0,No user reviews,0,0,0
889920,True,8,Very Positive,345,67,412
889921,True,6,Mostly Positive,204,64,268
889940,True,0,No user reviews,0,0,0
889970,True,0,3 user reviews,0,3,3
889990,True,0,2 user reviews,0,2,2
890010,True,0,No user reviews,0,0,0
890020,True,0,No user reviews,0,0,0
890030,True,0,No user reviews,0,0,0
890031,True,0,No user reviews,0,0,0
890032,True,0,No user reviews,0,0,0
890050,True,0,No user reviews,0,0,0
890070,True,0,No user reviews,0,0,0
890080,True,0,No user reviews,0,0,0
890100,True,0,No user reviews,0,0,0
890110,True,0,No user reviews,0,0,0
890130,True,0,3 user reviews,3,0,3
890180,True,5,Mixed,13,12,25
890200,True,0,No user reviews,0,0,0
890210,True,0,1 user reviews,0,1,1
890220,True,7,Positive,22,4,26
890230,True,0,No user reviews,0,0,0
890240,True,0,No user reviews,0,0,0
890250,True,0,6 user reviews,4,2,6
890280,True,7,Positive,14,3,17
890290,True,0,8 user reviews,5,3,8
890300,True,0,No user reviews,0,0,0
890310,True,7,Positive,18,0,18
890320,True,0,No user reviews,0,0,0
890330,True,0,No user reviews,0,0,0
890340,True,0,7 user reviews,7,0,7
890350,True,0,No user reviews,0,0,0
890370,True,0,No user reviews,0,0,0
890371,True,0,No user reviews,0,0,0
890372,True,0,No user reviews,0,0,0
890373,True,0,No user reviews,0,0,0
890374,True,0,No user reviews,0,0,0
890375,True,0,No user reviews,0,0,0
890376,True,0,No user reviews,0,0,0
890377,True,0,No user reviews,0,0,0
890378,True,0,No user reviews,0,0,0
890379,True,0,No user reviews,0,0,0
890380,True,0,No user reviews,0,0,0
890381,True,0,No user reviews,0,0,0
890382,True,0,No user reviews,0,0,0
890383,True,0,No user reviews,0,0,0
890384,True,0,No user reviews,0,0,0
890385,True,0,No user reviews,0,0,0
890386,True,0,No user reviews,0,0,0
890387,True,0,No user reviews,0,0,0
890388,True,0,No user reviews,0,0,0
890389,True,0,No user reviews,0,0,0
890390,True,0,No user reviews,0,0,0
890391,True,0,No user reviews,0,0,0
890392,True,0,No user reviews,0,0,0
890393,True,0,No user reviews,0,0,0
890394,True,0,No user reviews,0,0,0
890400,True,0,No user reviews,0,0,0
890410,True,0,No user reviews,0,0,0
890420,True,0,1 user reviews,1,0,1
890430,True,0,No user reviews,0,0,0
890460,True,0,No user reviews,0,0,0
890470,True,0,No user reviews,0,0,0
890480,True,0,6 user reviews,4,2,6
890490,True,0,No user reviews,0,0,0
890500,True,5,Mixed,16,8,24
890520,True,7,Positive,21,3,24
890530,True,0,No user reviews,0,0,0
890540,True,0,No user reviews,0,0,0
890550,True,0,No user reviews,0,0,0
890570,True,5,Mixed,80,38,118
890590,True,0,6 user reviews,6,0,6
890600,True,0,No user reviews,0,0,0
890610,True,0,No user reviews,0,0,0
890630,True,0,1 user reviews,1,0,1
890640,True,0,5 user reviews,3,2,5
890650,True,0,No user reviews,0,0,0
890651,True,0,No user reviews,0,0,0
890652,True,0,No user reviews,0,0,0
890653,True,0,No user reviews,0,0,0
890680,True,0,1 user reviews,0,1,1
890690,True,0,No user reviews,0,0,0
890700,True,7,Positive,12,1,13
890710,True,6,Mostly Positive,12,4,16
890720,True,8,Very Positive,238,13,251
890740,True,0,5 user reviews,4,1,5
890750,True,8,Very Positive,52,0,52
890770,True,0,No user reviews,0,0,0
890800,True,0,1 user reviews,1,0,1
890820,True,0,No user reviews,0,0,0
890840,True,0,No user reviews,0,0,0
890850,True,0,No user reviews,0,0,0
890860,True,0,No user reviews,0,0,0
890880,True,0,No user reviews,0,0,0
890900,True,0,1 user reviews,1,0,1
890910,True,0,1 user reviews,1,0,1
890920,True,0,No user reviews,0,0,0
890930,True,0,No user reviews,0,0,0
890940,True,5,Mixed,9,4,13
890960,True,0,No user reviews,0,0,0
890970,True,8,Very Positive,83,17,100
890980,True,0,No user reviews,0,0,0
890990,True,0,No user reviews,0,0,0
891010,True,0,No user reviews,0,0,0
891020,True,0,No user reviews,0,0,0
891030,True,0,No user reviews,0,0,0
891031,True,0,No user reviews,0,0,0
891033,True,0,No user reviews,0,0,0
891035,True,0,No user reviews,0,0,0
891040,True,0,No user reviews,0,0,0
891050,True,0,3 user reviews,2,1,3
891060,True,0,No user reviews,0,0,0
891090,True,0,4 user reviews,1,3,4
891100,True,0,7 user reviews,3,4,7
891110,True,0,4 user reviews,4,0,4
891120,True,0,5 user reviews,2,3,5
891130,True,0,No user reviews,0,0,0
891140,True,0,No user reviews,0,0,0
891170,True,0,No user reviews,0,0,0
891180,True,0,No user reviews,0,0,0
891190,True,0,No user reviews,0,0,0
891200,True,0,No user reviews,0,0,0
891220,True,0,1 user reviews,1,0,1
891230,True,6,Mostly Positive,23,7,30
891240,True,5,Mixed,6,4,10
891250,True,0,No user reviews,0,0,0
891260,True,0,1 user reviews,1,0,1
891270,True,0,6 user reviews,2,4,6
891280,True,0,No user reviews,0,0,0
891290,True,0,1 user reviews,1,0,1
891300,True,5,Mixed,10,5,15
891301,True,5,Mixed,18,14,32
891302,True,5,Mixed,7,10,17
891310,True,0,8 user reviews,3,5,8
891320,True,0,6 user reviews,4,2,6
891330,True,0,1 user reviews,0,1,1
891340,True,0,2 user reviews,2,0,2
891350,True,0,6 user reviews,5,1,6
891370,True,8,Very Positive,86,13,99
891380,True,0,2 user reviews,1,1,2
891420,True,5,Mixed,15,7,22
891430,True,0,No user reviews,0,0,0
891440,True,0,No user reviews,0,0,0
891460,True,0,No user reviews,0,0,0
891470,True,0,1 user reviews,0,1,1
891480,True,0,1 user reviews,1,0,1
891490,True,0,8 user reviews,6,2,8
891510,True,8,Very Positive,51,4,55
891520,True,0,No user reviews,0,0,0
891530,True,0,No user reviews,0,0,0
891540,True,0,No user reviews,0,0,0
891550,True,0,No user reviews,0,0,0
891630,True,0,No user reviews,0,0,0
891660,True,0,No user reviews,0,0,0
891700,True,0,5 user reviews,2,3,5
891710,True,0,3 user reviews,3,0,3
891720,True,0,8 user reviews,6,2,8
891730,True,5,Mixed,54,34,88
891770,True,0,No user reviews,0,0,0
891780,True,0,No user reviews,0,0,0
891790,True,6,Mostly Positive,37,13,50
891810,True,5,Mixed,52,26,78
891830,True,0,No user reviews,0,0,0
891840,True,0,No user reviews,0,0,0
891850,True,0,2 user reviews,2,0,2
891860,True,0,No user reviews,0,0,0
891870,True,6,Mostly Positive,7,3,10
891880,True,0,No user reviews,0,0,0
891881,True,0,No user reviews,0,0,0
891882,True,0,No user reviews,0,0,0
891883,True,0,No user reviews,0,0,0
891900,True,0,No user reviews,0,0,0
891910,True,0,No user reviews,0,0,0
891930,True,0,No user reviews,0,0,0
891950,True,0,No user reviews,0,0,0
891960,True,0,No user reviews,0,0,0
891970,True,0,No user reviews,0,0,0
891990,True,0,1 user reviews,1,0,1
892020,True,0,3 user reviews,2,1,3
892030,True,0,7 user reviews,5,2,7
892040,True,0,7 user reviews,5,2,7
892050,True,0,1 user reviews,1,0,1
892130,True,0,3 user reviews,1,2,3
892140,True,0,No user reviews,0,0,0
892160,True,0,3 user reviews,3,0,3
892170,True,0,No user reviews,0,0,0
892180,True,0,2 user reviews,2,0,2
892200,True,0,No user reviews,0,0,0
892210,True,0,3 user reviews,2,1,3
892220,True,0,No user reviews,0,0,0
892240,True,0,No user reviews,0,0,0
892250,True,0,2 user reviews,2,0,2
892260,True,0,No user reviews,0,0,0
892270,True,0,No user reviews,0,0,0
892280,True,0,No user reviews,0,0,0
892281,True,0,No user reviews,0,0,0
892282,True,0,No user reviews,0,0,0
892283,True,0,No user reviews,0,0,0
892284,True,0,No user reviews,0,0,0
892285,True,0,No user reviews,0,0,0
892286,True,0,No user reviews,0,0,0
892287,True,0,No user reviews,0,0,0
892288,True,0,No user reviews,0,0,0
892289,True,0,No user reviews,0,0,0
892290,True,0,No user reviews,0,0,0
892291,True,0,1 user reviews,1,0,1
892292,True,0,No user reviews,0,0,0
892293,True,0,No user reviews,0,0,0
892294,True,0,No user reviews,0,0,0
892295,True,0,No user reviews,0,0,0
892300,True,0,No user reviews,0,0,0
892310,True,0,3 user reviews,2,1,3
892350,True,0,No user reviews,0,0,0
892351,True,0,No user reviews,0,0,0
892352,True,0,No user reviews,0,0,0
892353,True,0,No user reviews,0,0,0
892354,True,0,No user reviews,0,0,0
892380,True,6,Mostly Positive,20,6,26
892390,True,0,No user reviews,0,0,0
892391,True,0,No user reviews,0,0,0
892392,True,0,No user reviews,0,0,0
892393,True,0,No user reviews,0,0,0
892394,True,0,No user reviews,0,0,0
892395,True,0,No user reviews,0,0,0
892396,True,0,No user reviews,0,0,0
892397,True,0,1 user reviews,1,0,1
892398,True,0,1 user reviews,1,0,1
892399,True,0,No user reviews,0,0,0
892400,True,7,Positive,21,0,21
892410,True,0,No user reviews,0,0,0
892420,True,0,8 user reviews,6,2,8
892430,True,0,No user reviews,0,0,0
892440,True,0,8 user reviews,5,3,8
892450,True,0,No user reviews,0,0,0
892460,True,0,No user reviews,0,0,0
892470,True,0,8 user reviews,8,0,8
892480,True,0,No user reviews,0,0,0
892490,True,0,2 user reviews,2,0,2
892500,True,0,No user reviews,0,0,0
892510,True,0,5 user reviews,3,2,5
892530,True,0,No user reviews,0,0,0
892550,True,7,Positive,12,3,15
892560,True,0,No user reviews,0,0,0
892570,True,0,No user reviews,0,0,0
892580,True,0,4 user reviews,4,0,4
892600,True,0,No user reviews,0,0,0
892610,True,0,No user reviews,0,0,0
892620,True,0,No user reviews,0,0,0
892630,True,0,1 user reviews,0,1,1
892640,True,0,2 user reviews,2,0,2
892650,True,5,Mixed,9,5,14
892660,True,0,No user reviews,0,0,0
892690,True,7,Positive,36,5,41
892700,True,0,No user reviews,0,0,0
892710,True,0,No user reviews,0,0,0
892720,True,0,No user reviews,0,0,0
892740,True,0,No user reviews,0,0,0
892750,True,0,No user reviews,0,0,0
892760,True,7,Positive,23,2,25
892780,True,7,Positive,15,3,18
892810,True,0,9 user reviews,7,2,9
892830,True,0,4 user reviews,4,0,4
892860,True,0,No user reviews,0,0,0
892870,True,0,No user reviews,0,0,0
892880,True,0,6 user reviews,6,0,6
892900,True,0,No user reviews,0,0,0
892910,True,0,3 user reviews,2,1,3
892920,True,0,No user reviews,0,0,0
892921,True,0,No user reviews,0,0,0
892922,True,0,No user reviews,0,0,0
892923,True,0,No user reviews,0,0,0
892924,True,0,No user reviews,0,0,0
892925,True,0,No user reviews,0,0,0
892926,True,0,No user reviews,0,0,0
892930,True,0,5 user reviews,3,2,5
892940,True,0,No user reviews,0,0,0
892941,True,0,No user reviews,0,0,0
892942,True,0,1 user reviews,1,0,1
892960,True,0,No user reviews,0,0,0
892970,True,0,No user reviews,0,0,0
892980,True,7,Positive,9,1,10
892990,True,7,Positive,20,0,20
893000,True,0,No user reviews,0,0,0
893001,True,0,3 user reviews,1,2,3
893010,True,6,Mostly Positive,41,15,56
893020,True,5,Mixed,23,10,33
893030,True,8,Very Positive,508,121,629
893040,True,4,Mostly Negative,5,9,14
893050,True,7,Positive,29,3,32
893060,True,0,8 user reviews,2,6,8
893070,True,5,Mixed,5,7,12
893090,True,0,4 user reviews,2,2,4
893120,True,0,No user reviews,0,0,0
893130,True,0,No user reviews,0,0,0
893140,True,0,2 user reviews,1,1,2
893150,True,0,No user reviews,0,0,0
893160,True,0,No user reviews,0,0,0
893170,True,0,No user reviews,0,0,0
893180,True,8,Very Positive,1759,149,1908
893190,True,0,No user reviews,0,0,0
893210,True,0,No user reviews,0,0,0
893220,True,0,No user reviews,0,0,0
893230,True,0,No user reviews,0,0,0
893240,True,0,No user reviews,0,0,0
893250,True,0,No user reviews,0,0,0
893260,True,0,No user reviews,0,0,0
893270,True,0,No user reviews,0,0,0
893280,True,0,No user reviews,0,0,0
893320,True,0,1 user reviews,0,1,1
893321,True,0,2 user reviews,2,0,2
893330,True,5,Mixed,13,10,23
893340,True,0,No user reviews,0,0,0
893350,True,0,No user reviews,0,0,0
893360,True,0,No user reviews,0,0,0
893370,True,0,No user reviews,0,0,0
893380,True,0,No user reviews,0,0,0
893390,True,0,No user reviews,0,0,0
893400,True,0,No user reviews,0,0,0
893410,True,0,No user reviews,0,0,0
893420,True,7,Positive,10,0,10
893450,True,0,3 user reviews,2,1,3
893460,True,0,4 user reviews,1,3,4
893470,True,7,Positive,12,0,12
893480,True,0,No user reviews,0,0,0
893490,True,0,No user reviews,0,0,0
893500,True,5,Mixed,7,5,12
893510,True,0,8 user reviews,3,5,8
893520,True,5,Mixed,152,72,224
893550,True,0,No user reviews,0,0,0
893560,True,0,No user reviews,0,0,0
893570,True,0,No user reviews,0,0,0
893590,True,0,2 user reviews,0,2,2
893610,True,7,Positive,34,4,38
893620,True,7,Positive,11,1,12
893630,True,0,2 user reviews,2,0,2
893640,True,0,No user reviews,0,0,0
893650,True,0,4 user reviews,1,3,4
893670,True,0,No user reviews,0,0,0
893680,True,8,Very Positive,942,95,1037
893690,True,8,Very Positive,52,3,55
893700,True,0,No user reviews,0,0,0
893710,True,0,2 user reviews,2,0,2
893720,True,0,No user reviews,0,0,0
893730,True,0,No user reviews,0,0,0
893740,True,0,5 user reviews,5,0,5
893750,True,0,No user reviews,0,0,0
893760,True,0,8 user reviews,8,0,8
893770,True,7,Positive,34,1,35
893780,True,0,No user reviews,0,0,0
893790,True,8,Very Positive,150,6,156
893800,True,0,2 user reviews,2,0,2
893810,True,0,No user reviews,0,0,0
893820,True,0,No user reviews,0,0,0
893830,True,0,No user reviews,0,0,0
893840,True,7,Positive,29,1,30
893850,True,8,Very Positive,799,73,872
893860,True,0,No user reviews,0,0,0
893870,True,5,Mixed,19,14,33
893880,True,0,No user reviews,0,0,0
893881,True,0,No user reviews,0,0,0
893882,True,0,No user reviews,0,0,0
893900,True,0,3 user reviews,3,0,3
893940,True,0,1 user reviews,1,0,1
893950,True,7,Positive,15,2,17
893960,True,0,4 user reviews,1,3,4
893980,True,0,1 user reviews,0,1,1
893981,True,0,1 user reviews,0,1,1
893982,True,0,No user reviews,0,0,0
893983,True,0,No user reviews,0,0,0
893984,True,0,No user reviews,0,0,0
894000,True,7,Positive,15,1,16
894010,True,0,3 user reviews,2,1,3
894070,True,0,4 user reviews,3,1,4
894080,True,0,1 user reviews,1,0,1
894090,True,0,No user reviews,0,0,0
894110,True,0,No user reviews,0,0,0
894120,True,0,2 user reviews,2,0,2
894130,True,0,No user reviews,0,0,0
894150,True,0,No user reviews,0,0,0
894160,True,0,2 user reviews,2,0,2
894200,True,0,No user reviews,0,0,0
894230,True,0,No user reviews,0,0,0
894270,True,6,Mostly Positive,21,7,28
894280,True,0,No user reviews,0,0,0
894310,True,0,6 user reviews,6,0,6
894320,True,0,No user reviews,0,0,0
894330,True,0,7 user reviews,5,2,7
894340,True,0,3 user reviews,3,0,3
894350,True,0,No user reviews,0,0,0
894360,True,0,No user reviews,0,0,0
894380,True,0,No user reviews,0,0,0
894390,True,5,Mixed,13,6,19
894400,True,0,No user reviews,0,0,0
894420,True,7,Positive,15,0,15
894430,True,0,7 user reviews,7,0,7
894440,True,0,No user reviews,0,0,0
894460,True,8,Very Positive,56,3,59
894500,True,0,1 user reviews,1,0,1
894540,True,6,Mostly Positive,12,5,17
894550,True,0,No user reviews,0,0,0
894570,True,0,3 user reviews,3,0,3
894580,True,0,No user reviews,0,0,0
894581,True,0,No user reviews,0,0,0
894582,True,0,No user reviews,0,0,0
894583,True,0,No user reviews,0,0,0
894584,True,0,No user reviews,0,0,0
894585,True,0,No user reviews,0,0,0
894600,True,5,Mixed,124,101,225
894610,True,0,2 user reviews,1,1,2
894620,True,0,No user reviews,0,0,0
894630,True,8,Very Positive,139,30,169
894640,True,0,No user reviews,0,0,0
894650,True,0,No user reviews,0,0,0
894660,True,0,No user reviews,0,0,0
894670,True,0,5 user reviews,5,0,5
894690,True,0,5 user reviews,5,0,5
894700,True,0,8 user reviews,8,0,8
894710,True,0,9 user reviews,9,0,9
894720,True,0,2 user reviews,2,0,2
894730,True,0,6 user reviews,3,3,6
894740,True,0,4 user reviews,3,1,4
894750,True,0,4 user reviews,2,2,4
894780,True,0,No user reviews,0,0,0
894790,True,0,1 user reviews,1,0,1
894820,True,0,No user reviews,0,0,0
894830,True,0,No user reviews,0,0,0
894840,True,0,No user reviews,0,0,0
894850,True,0,No user reviews,0,0,0
894860,True,0,No user reviews,0,0,0
894870,True,0,No user reviews,0,0,0
894890,True,0,No user reviews,0,0,0
894900,True,0,6 user reviews,2,4,6
894930,True,0,2 user reviews,0,2,2
894940,True,9,Overwhelmingly Positive,1835,87,1922
894950,True,0,3 user reviews,2,1,3
894970,True,0,4 user reviews,3,1,4
894980,True,0,1 user reviews,1,0,1
895000,True,0,4 user reviews,4,0,4
895040,True,5,Mixed,50,26,76
895060,True,4,Mostly Negative,13,21,34
895070,True,0,1 user reviews,1,0,1
895120,True,0,4 user reviews,2,2,4
895130,True,0,No user reviews,0,0,0
895140,True,7,Positive,8,2,10
895150,True,0,No user reviews,0,0,0
895160,True,0,No user reviews,0,0,0
895170,True,0,3 user reviews,3,0,3
895180,True,0,2 user reviews,2,0,2
895190,True,0,No user reviews,0,0,0
895200,True,5,Mixed,43,37,80
895210,True,0,No user reviews,0,0,0
895220,True,0,5 user reviews,4,1,5
895240,True,0,No user reviews,0,0,0
895250,True,0,No user reviews,0,0,0
895260,True,0,1 user reviews,1,0,1
895270,True,0,1 user reviews,1,0,1
895280,True,0,1 user reviews,1,0,1
895290,True,0,No user reviews,0,0,0
895300,True,0,1 user reviews,1,0,1
895330,True,0,6 user reviews,6,0,6
895370,True,0,3 user reviews,2,1,3
895390,True,0,No user reviews,0,0,0
895391,True,0,No user reviews,0,0,0
895392,True,0,No user reviews,0,0,0
895393,True,0,No user reviews,0,0,0
895394,True,0,No user reviews,0,0,0
895400,True,6,Mostly Positive,5192,1341,6533
895420,True,7,Positive,28,2,30
895430,True,0,No user reviews,0,0,0
895440,True,0,4 user reviews,3,1,4
895450,True,0,1 user reviews,1,0,1
895470,True,6,Mostly Positive,14,5,19
895480,True,8,Very Positive,53,5,58
895490,True,5,Mixed,50,28,78
895491,True,6,Mostly Positive,47,17,64
895492,True,5,Mixed,48,67,115
895493,True,5,Mixed,41,23,64
895510,True,0,No user reviews,0,0,0
895520,True,0,No user reviews,0,0,0
895530,True,0,No user reviews,0,0,0
895540,True,0,No user reviews,0,0,0
895550,True,0,No user reviews,0,0,0
895570,True,0,1 user reviews,0,1,1
895580,True,0,5 user reviews,0,5,5
895600,True,7,Positive,24,3,27
895610,True,0,5 user reviews,5,0,5
895620,True,6,Mostly Positive,110,36,146
895650,True,0,No user reviews,0,0,0
895670,True,0,No user reviews,0,0,0
895690,True,7,Positive,28,6,34
895710,True,0,2 user reviews,1,1,2
895720,True,0,7 user reviews,7,0,7
895740,True,0,3 user reviews,2,1,3
895750,True,6,Mostly Positive,7,3,10
895760,True,0,No user reviews,0,0,0
895790,True,0,No user reviews,0,0,0
895800,True,0,3 user reviews,3,0,3
895810,True,0,No user reviews,0,0,0
895820,True,0,4 user reviews,3,1,4
895840,True,0,No user reviews,0,0,0
895850,True,0,2 user reviews,2,0,2
895860,True,0,2 user reviews,2,0,2
895870,True,0,No user reviews,0,0,0
895880,True,0,No user reviews,0,0,0
895890,True,0,4 user reviews,3,1,4
895900,True,0,No user reviews,0,0,0
895930,True,0,1 user reviews,1,0,1
895940,True,0,2 user reviews,1,1,2
895950,True,0,7 user reviews,4,3,7
895960,True,0,1 user reviews,0,1,1
895970,True,0,No user reviews,0,0,0
895980,True,0,No user reviews,0,0,0
895990,True,0,No user reviews,0,0,0
896000,True,0,4 user reviews,4,0,4
896010,True,0,No user reviews,0,0,0
896020,True,0,No user reviews,0,0,0
896030,True,5,Mixed,6,6,12
896040,True,0,No user reviews,0,0,0
896050,True,0,No user reviews,0,0,0
896070,True,0,6 user reviews,4,2,6
896100,True,0,No user reviews,0,0,0
896101,True,0,No user reviews,0,0,0
896102,True,0,No user reviews,0,0,0
896110,True,0,2 user reviews,2,0,2
896160,True,6,Mostly Positive,331,122,453
896170,True,0,No user reviews,0,0,0
896180,True,0,5 user reviews,3,2,5
896190,True,0,1 user reviews,1,0,1
896220,True,0,No user reviews,0,0,0
896230,True,0,2 user reviews,0,2,2
896240,True,0,2 user reviews,0,2,2
896250,True,0,No user reviews,0,0,0
896260,True,0,No user reviews,0,0,0
896270,True,0,No user reviews,0,0,0
896290,True,0,No user reviews,0,0,0
896340,True,7,Positive,21,5,26
896350,True,0,1 user reviews,1,0,1
896370,True,0,3 user reviews,3,0,3
896380,True,0,6 user reviews,3,3,6
896400,True,0,6 user reviews,6,0,6
896410,True,0,No user reviews,0,0,0
896420,True,0,2 user reviews,1,1,2
896440,True,5,Mixed,25,17,42
896460,True,8,Very Positive,160,6,166
896500,True,0,2 user reviews,2,0,2
896510,True,5,Mixed,9,6,15
896520,True,0,No user reviews,0,0,0
896530,True,0,No user reviews,0,0,0
896540,True,0,No user reviews,0,0,0
896541,True,0,No user reviews,0,0,0
896542,True,0,No user reviews,0,0,0
896543,True,0,No user reviews,0,0,0
896544,True,0,No user reviews,0,0,0
896546,True,0,No user reviews,0,0,0
896548,True,0,No user reviews,0,0,0
896550,True,7,Positive,14,0,14
896570,True,0,6 user reviews,4,2,6
896580,True,0,No user reviews,0,0,0
896590,True,0,No user reviews,0,0,0
896620,True,0,No user reviews,0,0,0
896630,True,0,No user reviews,0,0,0
896640,True,7,Positive,10,0,10
896650,True,0,3 user reviews,2,1,3
896670,True,0,1 user reviews,1,0,1
896680,True,5,Mixed,10,11,21
896700,True,0,3 user reviews,2,1,3
896712,True,0,2 user reviews,2,0,2
896713,True,6,Mostly Positive,10,4,14
896715,True,7,Positive,19,4,23
896716,True,0,1 user reviews,0,1,1
896717,True,5,Mixed,12,10,22
896718,True,0,9 user reviews,4,5,9
896719,True,7,Positive,18,2,20
896730,True,0,1 user reviews,1,0,1
896741,True,0,5 user reviews,3,2,5
896742,True,0,4 user reviews,3,1,4
896743,True,0,4 user reviews,4,0,4
896744,True,0,8 user reviews,7,1,8
896745,True,0,6 user reviews,4,2,6
896746,True,0,5 user reviews,3,2,5
896747,True,0,6 user reviews,3,3,6
896748,True,5,Mixed,6,5,11
896749,True,0,2 user reviews,0,2,2
896750,True,8,Very Positive,58,12,70
896761,True,0,1 user reviews,1,0,1
896762,True,0,No user reviews,0,0,0
896764,True,0,2 user reviews,2,0,2
896765,True,0,2 user reviews,2,0,2
896766,True,0,1 user reviews,1,0,1
896767,True,0,2 user reviews,1,1,2
896780,True,0,2 user reviews,2,0,2
896790,True,0,No user reviews,0,0,0
896800,True,0,No user reviews,0,0,0
896830,True,0,1 user reviews,1,0,1
896840,True,0,No user reviews,0,0,0
896850,True,0,3 user reviews,1,2,3
896860,True,0,2 user reviews,0,2,2
896870,True,0,No user reviews,0,0,0
896880,True,5,Mixed,6,4,10
896890,True,8,Very Positive,238,24,262
896910,True,0,No user reviews,0,0,0
896940,True,0,No user reviews,0,0,0
896950,True,0,7 user reviews,4,3,7
896960,True,6,Mostly Positive,20,7,27
896970,True,0,4 user reviews,3,1,4
896980,True,0,No user reviews,0,0,0
896990,True,0,4 user reviews,1,3,4
897000,True,0,1 user reviews,1,0,1
897010,True,0,1 user reviews,1,0,1
897020,True,0,5 user reviews,4,1,5
897030,True,8,Very Positive,401,81,482
897040,True,5,Mixed,23,14,37
897060,True,0,No user reviews,0,0,0
897061,True,0,No user reviews,0,0,0
897062,True,0,No user reviews,0,0,0
897063,True,0,No user reviews,0,0,0
897064,True,0,No user reviews,0,0,0
897065,True,0,No user reviews,0,0,0
897066,True,0,No user reviews,0,0,0
897067,True,0,No user reviews,0,0,0
897068,True,0,No user reviews,0,0,0
897069,True,0,No user reviews,0,0,0
897070,True,0,No user reviews,0,0,0
897071,True,0,No user reviews,0,0,0
897072,True,0,No user reviews,0,0,0
897073,True,0,No user reviews,0,0,0
897074,True,0,No user reviews,0,0,0
897075,True,0,No user reviews,0,0,0
897080,True,0,No user reviews,0,0,0
897090,True,0,No user reviews,0,0,0
897100,True,0,4 user reviews,3,1,4
897110,True,0,No user reviews,0,0,0
897120,True,0,No user reviews,0,0,0
897130,True,0,No user reviews,0,0,0
897150,True,0,No user reviews,0,0,0
897180,True,0,2 user reviews,2,0,2
897190,True,0,1 user reviews,1,0,1
897210,True,0,No user reviews,0,0,0
897220,True,8,Very Positive,232,5,237
897230,True,0,1 user reviews,1,0,1
897240,True,0,1 user reviews,1,0,1
897250,True,0,1 user reviews,1,0,1
897270,True,0,No user reviews,0,0,0
897280,True,0,2 user reviews,1,1,2
897290,True,0,No user reviews,0,0,0
897300,True,5,Mixed,12,8,20
897310,True,0,No user reviews,0,0,0
897330,True,7,Positive,14,0,14
897340,True,0,No user reviews,0,0,0
897350,True,0,No user reviews,0,0,0
897360,True,0,1 user reviews,1,0,1
897380,True,0,No user reviews,0,0,0
897390,True,0,2 user reviews,1,1,2
897400,True,0,4 user reviews,1,3,4
897410,True,5,Mixed,103,76,179
897420,True,0,3 user reviews,2,1,3
897440,True,5,Mixed,23,13,36
897450,True,5,Mixed,192,137,329
897510,True,0,No user reviews,0,0,0
897530,True,0,No user reviews,0,0,0
897550,True,0,6 user reviews,1,5,6
897560,True,0,1 user reviews,1,0,1
897580,True,0,No user reviews,0,0,0
897590,True,0,No user reviews,0,0,0
897630,True,5,Mixed,11,7,18
897640,True,6,Mostly Positive,15,4,19
897650,True,0,No user reviews,0,0,0
897670,True,8,Very Positive,350,50,400
897690,True,7,Positive,38,0,38
897700,True,0,7 user reviews,4,3,7
897730,True,0,No user reviews,0,0,0
897760,True,7,Positive,10,0,10
897770,True,0,2 user reviews,1,1,2
897800,True,7,Positive,22,2,24
897820,True,6,Mostly Positive,151,61,212
897830,True,7,Positive,12,3,15
897840,True,0,1 user reviews,0,1,1
897870,True,0,No user reviews,0,0,0
897880,True,0,2 user reviews,1,1,2
897890,True,0,No user reviews,0,0,0
897900,True,0,3 user reviews,3,0,3
897910,True,0,2 user reviews,1,1,2
897920,True,0,1 user reviews,1,0,1
897930,True,8,Very Positive,81,16,97
897940,True,0,No user reviews,0,0,0
897950,True,0,2 user reviews,0,2,2
897970,True,0,No user reviews,0,0,0
898000,True,5,Mixed,12,16,28
898010,True,0,No user reviews,0,0,0
898030,True,0,No user reviews,0,0,0
898040,True,0,No user reviews,0,0,0
898050,True,0,No user reviews,0,0,0
898060,True,0,No user reviews,0,0,0
898080,True,0,No user reviews,0,0,0
898090,True,0,1 user reviews,1,0,1
898100,True,0,No user reviews,0,0,0
898110,True,0,1 user reviews,1,0,1
898120,True,0,4 user reviews,2,2,4
898130,True,0,No user reviews,0,0,0
898160,True,0,No user reviews,0,0,0
898170,True,0,1 user reviews,0,1,1
898190,True,0,3 user reviews,3,0,3
898200,True,0,No user reviews,0,0,0
898230,True,0,No user reviews,0,0,0
898240,True,0,5 user reviews,5,0,5
898250,True,0,1 user reviews,1,0,1
898260,True,7,Positive,11,0,11
898290,True,0,No user reviews,0,0,0
898310,True,0,5 user reviews,5,0,5
898320,True,0,1 user reviews,0,1,1
898330,True,0,No user reviews,0,0,0
898340,True,0,7 user reviews,2,5,7
898380,True,0,4 user reviews,3,1,4
898390,True,5,Mixed,22,11,33
898400,True,0,No user reviews,0,0,0
898420,True,0,No user reviews,0,0,0
898430,True,0,1 user reviews,0,1,1
898440,True,0,4 user reviews,3,1,4
898450,True,8,Very Positive,69,2,71
898460,True,6,Mostly Positive,13,4,17
898490,True,0,No user reviews,0,0,0
898500,True,0,3 user reviews,2,1,3
898520,True,0,No user reviews,0,0,0
898530,True,0,5 user reviews,1,4,5
898540,True,0,3 user reviews,0,3,3
898550,True,0,No user reviews,0,0,0
898551,True,0,No user reviews,0,0,0
898552,True,0,No user reviews,0,0,0
898553,True,0,No user reviews,0,0,0
898554,True,0,No user reviews,0,0,0
898555,True,0,No user reviews,0,0,0
898560,True,0,No user reviews,0,0,0
898570,True,0,No user reviews,0,0,0
898580,True,8,Very Positive,116,6,122
898590,True,0,No user reviews,0,0,0
898600,True,0,1 user reviews,0,1,1
898640,True,0,No user reviews,0,0,0
898650,True,8,Very Positive,185,37,222
898660,True,0,No user reviews,0,0,0
898670,True,0,No user reviews,0,0,0
898680,True,0,No user reviews,0,0,0
898690,True,0,2 user reviews,1,1,2
898700,True,5,Mixed,9,6,15
898710,True,0,No user reviews,0,0,0
898720,True,6,Mostly Positive,105,27,132
898730,True,0,No user reviews,0,0,0
898760,True,0,1 user reviews,1,0,1
898770,True,0,No user reviews,0,0,0
898780,True,7,Positive,38,6,44
898790,True,7,Positive,18,0,18
898800,True,8,Very Positive,71,7,78
898810,True,0,No user reviews,0,0,0
898820,True,0,No user reviews,0,0,0
898830,True,0,4 user reviews,4,0,4
898880,True,0,No user reviews,0,0,0
898890,True,0,No user reviews,0,0,0
898910,True,7,Positive,11,0,11
898920,True,6,Mostly Positive,1225,404,1629
898930,True,0,3 user reviews,3,0,3
898940,True,0,5 user reviews,3,2,5
898950,True,0,No user reviews,0,0,0
898960,True,6,Mostly Positive,16,5,21
898961,True,0,7 user reviews,6,1,7
898962,True,0,9 user reviews,3,6,9
898980,True,0,No user reviews,0,0,0
898990,True,0,No user reviews,0,0,0
899000,True,0,2 user reviews,2,0,2
899020,True,0,3 user reviews,2,1,3
899030,True,0,2 user reviews,2,0,2
899060,True,0,No user reviews,0,0,0
899061,True,0,No user reviews,0,0,0
899070,True,0,No user reviews,0,0,0
899090,True,0,No user reviews,0,0,0
899100,True,7,Positive,8,2,10
899130,True,0,5 user reviews,4,1,5
899140,True,0,No user reviews,0,0,0
899150,True,0,2 user reviews,1,1,2
899160,True,0,No user reviews,0,0,0
899180,True,7,Positive,20,3,23
899190,True,0,No user reviews,0,0,0
899200,True,6,Mostly Positive,10,3,13
899210,True,0,No user reviews,0,0,0
899211,True,0,No user reviews,0,0,0
899212,True,0,No user reviews,0,0,0
899213,True,0,No user reviews,0,0,0
899214,True,0,No user reviews,0,0,0
899220,True,0,No user reviews,0,0,0
899230,True,0,No user reviews,0,0,0
899240,True,0,1 user reviews,1,0,1
899250,True,0,No user reviews,0,0,0
899270,True,7,Positive,18,0,18
899280,True,0,2 user reviews,2,0,2
899290,True,0,No user reviews,0,0,0
899310,True,8,Very Positive,91,19,110
899330,True,0,No user reviews,0,0,0
899340,True,7,Positive,10,0,10
899350,True,0,2 user reviews,1,1,2
899360,True,0,No user reviews,0,0,0
899380,True,0,No user reviews,0,0,0
899390,True,5,Mixed,98,47,145
899410,True,0,1 user reviews,0,1,1
899411,True,0,2 user reviews,1,1,2
899440,True,8,Very Positive,1280,153,1433
899450,True,0,No user reviews,0,0,0
899460,True,0,No user reviews,0,0,0
899470,True,7,Positive,46,3,49
899480,True,6,Mostly Positive,13,5,18
899490,True,0,No user reviews,0,0,0
899510,True,0,No user reviews,0,0,0
899530,True,0,No user reviews,0,0,0
899540,True,5,Mixed,12,10,22
899550,True,0,No user reviews,0,0,0
899551,True,0,No user reviews,0,0,0
899570,True,0,4 user reviews,0,4,4
899580,True,0,No user reviews,0,0,0
899590,True,0,8 user reviews,8,0,8
899610,True,0,No user reviews,0,0,0
899630,True,5,Mixed,6,9,15
899640,True,0,No user reviews,0,0,0
899650,True,0,No user reviews,0,0,0
899660,True,0,No user reviews,0,0,0
899760,True,0,3 user reviews,3,0,3
899770,True,8,Very Positive,1403,241,1644
899781,True,0,No user reviews,0,0,0
899782,True,0,No user reviews,0,0,0
899783,True,0,No user reviews,0,0,0
899784,True,0,No user reviews,0,0,0
899785,True,0,No user reviews,0,0,0
899786,True,0,No user reviews,0,0,0
899787,True,0,No user reviews,0,0,0
899788,True,0,No user reviews,0,0,0
899789,True,0,No user reviews,0,0,0
899790,True,0,No user reviews,0,0,0
899791,True,0,No user reviews,0,0,0
899792,True,0,No user reviews,0,0,0
899793,True,0,No user reviews,0,0,0
899794,True,0,No user reviews,0,0,0
899795,True,0,1 user reviews,1,0,1
899796,True,0,1 user reviews,1,0,1
899797,True,0,No user reviews,0,0,0
899798,True,0,No user reviews,0,0,0
899799,True,0,No user reviews,0,0,0
899800,True,0,No user reviews,0,0,0
899801,True,0,No user reviews,0,0,0
899802,True,0,No user reviews,0,0,0
899803,True,0,No user reviews,0,0,0
899804,True,0,1 user reviews,1,0,1
899805,True,0,No user reviews,0,0,0
899806,True,0,2 user reviews,0,2,2
899807,True,0,No user reviews,0,0,0
899808,True,0,1 user reviews,1,0,1
899809,True,0,No user reviews,0,0,0
899810,True,0,1 user reviews,1,0,1
899811,True,0,No user reviews,0,0,0
899812,True,0,No user reviews,0,0,0
899813,True,0,No user reviews,0,0,0
899814,True,0,No user reviews,0,0,0
899815,True,0,No user reviews,0,0,0
899816,True,0,No user reviews,0,0,0
899817,True,0,No user reviews,0,0,0
899818,True,0,No user reviews,0,0,0
899819,True,0,No user reviews,0,0,0
899820,True,0,No user reviews,0,0,0
899821,True,0,1 user reviews,1,0,1
899822,True,0,No user reviews,0,0,0
899823,True,0,1 user reviews,1,0,1
899824,True,0,No user reviews,0,0,0
899825,True,0,No user reviews,0,0,0
899826,True,0,1 user reviews,1,0,1
899827,True,0,No user reviews,0,0,0
899828,True,0,No user reviews,0,0,0
899829,True,0,No user reviews,0,0,0
899830,True,0,No user reviews,0,0,0
899831,True,0,No user reviews,0,0,0
899832,True,0,No user reviews,0,0,0
899833,True,0,2 user reviews,1,1,2
899834,True,0,4 user reviews,3,1,4
899835,True,0,No user reviews,0,0,0
899836,True,0,No user reviews,0,0,0
899837,True,0,No user reviews,0,0,0
899838,True,0,No user reviews,0,0,0
899839,True,0,No user reviews,0,0,0
899840,True,0,No user reviews,0,0,0
899841,True,0,No user reviews,0,0,0
899842,True,0,No user reviews,0,0,0
899843,True,0,1 user reviews,1,0,1
899844,True,0,No user reviews,0,0,0
899845,True,0,No user reviews,0,0,0
899846,True,0,No user reviews,0,0,0
899847,True,0,No user reviews,0,0,0
899848,True,0,No user reviews,0,0,0
899849,True,0,No user reviews,0,0,0
899850,True,0,No user reviews,0,0,0
899851,True,0,No user reviews,0,0,0
899852,True,0,No user reviews,0,0,0
899853,True,0,No user reviews,0,0,0
899854,True,0,No user reviews,0,0,0
899855,True,0,No user reviews,0,0,0
899856,True,0,No user reviews,0,0,0
899857,True,0,No user reviews,0,0,0
899858,True,0,2 user reviews,2,0,2
899859,True,0,1 user reviews,1,0,1
899860,True,0,No user reviews,0,0,0
899861,True,0,No user reviews,0,0,0
899862,True,0,No user reviews,0,0,0
899863,True,0,No user reviews,0,0,0
899864,True,0,1 user reviews,0,1,1
899865,True,0,No user reviews,0,0,0
899866,True,0,No user reviews,0,0,0
899867,True,0,No user reviews,0,0,0
899868,True,0,No user reviews,0,0,0
899869,True,0,No user reviews,0,0,0
899870,True,0,No user reviews,0,0,0
899871,True,0,No user reviews,0,0,0
899872,True,0,1 user reviews,1,0,1
899873,True,0,No user reviews,0,0,0
899874,True,0,No user reviews,0,0,0
899875,True,0,No user reviews,0,0,0
899876,True,0,No user reviews,0,0,0
899877,True,0,No user reviews,0,0,0
899878,True,0,No user reviews,0,0,0
899879,True,0,No user reviews,0,0,0
899880,True,0,No user reviews,0,0,0
899881,True,0,No user reviews,0,0,0
899882,True,0,No user reviews,0,0,0
899883,True,0,No user reviews,0,0,0
899884,True,0,No user reviews,0,0,0
899885,True,0,No user reviews,0,0,0
899886,True,0,No user reviews,0,0,0
899887,True,0,No user reviews,0,0,0
899888,True,0,No user reviews,0,0,0
899889,True,0,No user reviews,0,0,0
899890,True,0,No user reviews,0,0,0
899891,True,0,No user reviews,0,0,0
899892,True,0,1 user reviews,1,0,1
899893,True,0,No user reviews,0,0,0
899894,True,0,No user reviews,0,0,0
899895,True,0,No user reviews,0,0,0
899896,True,0,No user reviews,0,0,0
899897,True,0,No user reviews,0,0,0
899898,True,0,No user reviews,0,0,0
899899,True,0,No user reviews,0,0,0
899900,True,0,7 user reviews,5,2,7
899901,True,0,No user reviews,0,0,0
899902,True,0,No user reviews,0,0,0
899903,True,0,No user reviews,0,0,0
899904,True,0,No user reviews,0,0,0
899905,True,0,No user reviews,0,0,0
899906,True,0,No user reviews,0,0,0
899907,True,0,No user reviews,0,0,0
899908,True,0,No user reviews,0,0,0
899909,True,0,No user reviews,0,0,0
899910,True,0,No user reviews,0,0,0
899920,True,0,No user reviews,0,0,0
899930,True,0,No user reviews,0,0,0
899940,True,0,7 user reviews,6,1,7
899960,True,7,Positive,16,1,17
899970,True,9,Overwhelmingly Positive,488,17,505
899990,True,0,6 user reviews,0,6,6
900010,True,5,Mixed,171,95,266
900030,True,0,1 user reviews,1,0,1
900050,True,7,Positive,19,4,23
900060,True,0,No user reviews,0,0,0
900070,True,0,No user reviews,0,0,0
900090,True,7,Positive,19,1,20
900100,True,0,No user reviews,0,0,0
900101,True,0,No user reviews,0,0,0
900102,True,0,No user reviews,0,0,0
900103,True,0,No user reviews,0,0,0
900110,True,0,No user reviews,0,0,0
900130,True,0,No user reviews,0,0,0
900150,True,0,No user reviews,0,0,0
900170,True,0,No user reviews,0,0,0
900180,True,0,No user reviews,0,0,0
900190,True,0,No user reviews,0,0,0
900210,True,0,No user reviews,0,0,0
900230,True,0,No user reviews,0,0,0
900231,True,0,1 user reviews,1,0,1
900240,True,0,No user reviews,0,0,0
900241,True,0,No user reviews,0,0,0
900242,True,0,No user reviews,0,0,0
900250,True,0,No user reviews,0,0,0
900260,True,0,No user reviews,0,0,0
900270,True,8,Very Positive,1284,85,1369
900280,True,0,No user reviews,0,0,0
900290,True,6,Mostly Positive,16,5,21
900310,True,0,No user reviews,0,0,0
900330,True,0,No user reviews,0,0,0
900340,True,0,6 user reviews,4,2,6
900350,True,0,No user reviews,0,0,0
900370,True,0,9 user reviews,6,3,9
900380,True,0,3 user reviews,3,0,3
900390,True,0,1 user reviews,1,0,1
900400,True,0,No user reviews,0,0,0
900447,True,6,Mostly Positive,44,13,57
900448,True,5,Mixed,32,39,71
900449,True,6,Mostly Positive,37,15,52
900450,True,0,No user reviews,0,0,0
900460,True,0,No user reviews,0,0,0
900470,True,0,No user reviews,0,0,0
900480,True,0,No user reviews,0,0,0
900490,True,7,Positive,19,0,19
900510,True,0,No user reviews,0,0,0
900530,True,0,1 user reviews,1,0,1
900540,True,0,1 user reviews,1,0,1
900550,True,0,2 user reviews,2,0,2
900560,True,0,1 user reviews,1,0,1
900570,True,0,No user reviews,0,0,0
900580,True,0,No user reviews,0,0,0
900610,True,0,1 user reviews,1,0,1
900700,True,0,No user reviews,0,0,0
900710,True,0,No user reviews,0,0,0
900790,True,7,Positive,16,2,18
900820,True,0,No user reviews,0,0,0
900883,True,9,Overwhelmingly Positive,14817,669,15486
901000,True,0,2 user reviews,2,0,2
901020,True,0,2 user reviews,2,0,2
903040,True,6,Mostly Positive,38,12,50
903090,True,0,No user reviews,0,0,0
903110,True,0,1 user reviews,1,0,1
903130,True,0,No user reviews,0,0,0
903140,True,0,No user reviews,0,0,0
903150,True,0,1 user reviews,1,0,1
903160,True,0,1 user reviews,1,0,1
903180,True,0,4 user reviews,3,1,4
903240,True,0,1 user reviews,0,1,1
903241,True,0,No user reviews,0,0,0
903242,True,0,No user reviews,0,0,0
903243,True,0,1 user reviews,1,0,1
903244,True,0,No user reviews,0,0,0
903245,True,0,No user reviews,0,0,0
903246,True,0,No user reviews,0,0,0
903247,True,0,No user reviews,0,0,0
903248,True,0,No user reviews,0,0,0
903249,True,0,No user reviews,0,0,0
903250,True,0,No user reviews,0,0,0
903251,True,0,No user reviews,0,0,0
903252,True,0,No user reviews,0,0,0
903253,True,0,No user reviews,0,0,0
903260,True,0,No user reviews,0,0,0
903261,True,0,No user reviews,0,0,0
903262,True,0,No user reviews,0,0,0
903263,True,0,No user reviews,0,0,0
903410,True,0,No user reviews,0,0,0
903460,True,0,3 user reviews,3,0,3
903560,True,0,No user reviews,0,0,0
903570,True,0,No user reviews,0,0,0
903580,True,0,6 user reviews,6,0,6
903590,True,0,No user reviews,0,0,0
903610,True,0,1 user reviews,1,0,1
903620,True,0,7 user reviews,3,4,7
903630,True,0,No user reviews,0,0,0
903640,True,0,No user reviews,0,0,0
903660,True,0,No user reviews,0,0,0
903670,True,0,6 user reviews,1,5,6
903680,True,0,1 user reviews,1,0,1
903690,True,0,No user reviews,0,0,0
903700,True,0,No user reviews,0,0,0
903710,True,5,Mixed,12,8,20
903730,True,0,No user reviews,0,0,0
903740,True,0,9 user reviews,3,6,9
903750,True,0,No user reviews,0,0,0
903760,True,0,No user reviews,0,0,0
903770,True,0,1 user reviews,1,0,1
903771,True,0,2 user reviews,2,0,2
903772,True,0,2 user reviews,0,2,2
903780,True,0,6 user reviews,5,1,6
903790,True,0,No user reviews,0,0,0
903820,True,0,No user reviews,0,0,0
903830,True,5,Mixed,13,7,20
903840,True,0,No user reviews,0,0,0
903850,True,0,5 user reviews,5,0,5
903860,True,0,2 user reviews,2,0,2
903870,True,0,No user reviews,0,0,0
903880,True,0,6 user reviews,2,4,6
903910,True,0,5 user reviews,5,0,5
903930,True,0,No user reviews,0,0,0
903940,True,0,No user reviews,0,0,0
903950,True,6,Mostly Positive,6930,2045,8975
903970,True,0,No user reviews,0,0,0
903980,True,0,No user reviews,0,0,0
903990,True,0,No user reviews,0,0,0
904010,True,0,No user reviews,0,0,0
904020,True,0,No user reviews,0,0,0
904050,True,0,5 user reviews,2,3,5
904110,True,0,No user reviews,0,0,0
904120,True,0,2 user reviews,1,1,2
904121,True,0,No user reviews,0,0,0
904122,True,0,1 user reviews,1,0,1
904123,True,0,1 user reviews,1,0,1
904124,True,0,No user reviews,0,0,0
904125,True,0,No user reviews,0,0,0
904126,True,0,1 user reviews,1,0,1
904127,True,0,No user reviews,0,0,0
904130,True,7,Positive,22,3,25
904150,True,0,No user reviews,0,0,0
904160,True,0,7 user reviews,5,2,7
904170,True,0,4 user reviews,2,2,4
904190,True,0,No user reviews,0,0,0
904200,True,0,No user reviews,0,0,0
904210,True,0,No user reviews,0,0,0
904220,True,0,No user reviews,0,0,0
904230,True,0,No user reviews,0,0,0
904260,True,0,5 user reviews,5,0,5
904270,True,0,No user reviews,0,0,0
904300,True,0,No user reviews,0,0,0
904310,True,6,Mostly Positive,25,9,34
904320,True,0,1 user reviews,1,0,1
904340,True,0,2 user reviews,1,1,2
904360,True,8,Very Positive,102,25,127
904370,True,7,Positive,11,0,11
904380,True,6,Mostly Positive,80,32,112
904390,True,0,No user reviews,0,0,0
904400,True,7,Positive,22,0,22
904410,True,0,No user reviews,0,0,0
904430,True,0,2 user reviews,2,0,2
904440,True,5,Mixed,22,11,33
904450,True,0,No user reviews,0,0,0
904460,True,0,No user reviews,0,0,0
904490,True,0,No user reviews,0,0,0
904500,True,0,No user reviews,0,0,0
904510,True,0,No user reviews,0,0,0
904520,True,6,Mostly Positive,88,26,114
904530,True,0,4 user reviews,4,0,4
904540,True,8,Very Positive,70,9,79
904550,True,0,1 user reviews,1,0,1
904560,True,0,No user reviews,0,0,0
904570,True,8,Very Positive,56,5,61
904580,True,7,Positive,24,0,24
904590,True,0,No user reviews,0,0,0
904600,True,5,Mixed,5,6,11
904610,True,0,No user reviews,0,0,0
904620,True,0,No user reviews,0,0,0
904640,True,0,No user reviews,0,0,0
904650,True,0,No user reviews,0,0,0
904680,True,0,2 user reviews,1,1,2
904700,True,0,No user reviews,0,0,0
904710,True,0,No user reviews,0,0,0
904730,True,0,No user reviews,0,0,0
904740,True,0,No user reviews,0,0,0
904750,True,0,No user reviews,0,0,0
904770,True,0,2 user reviews,2,0,2
904780,True,5,Mixed,7,4,11
904800,True,0,No user reviews,0,0,0
904810,True,0,2 user reviews,2,0,2
904820,True,0,No user reviews,0,0,0
904840,True,0,No user reviews,0,0,0
904850,True,0,No user reviews,0,0,0
904860,True,0,5 user reviews,2,3,5
904870,True,0,No user reviews,0,0,0
904890,True,5,Mixed,6,6,12
904900,True,5,Mixed,24,12,36
904920,True,0,No user reviews,0,0,0
904930,True,0,2 user reviews,1,1,2
904950,True,0,2 user reviews,0,2,2
904960,True,6,Mostly Positive,95,33,128
904970,True,0,No user reviews,0,0,0
904990,True,5,Mixed,7,5,12
905010,True,0,No user reviews,0,0,0
905020,True,0,2 user reviews,1,1,2
905040,True,0,No user reviews,0,0,0
905050,True,7,Positive,10,2,12
905060,True,0,8 user reviews,2,6,8
905070,True,0,4 user reviews,4,0,4
905090,True,5,Mixed,7,9,16
905100,True,0,No user reviews,0,0,0
905120,True,0,1 user reviews,1,0,1
905130,True,0,2 user reviews,2,0,2
905150,True,0,8 user reviews,4,4,8
905170,True,0,No user reviews,0,0,0
905180,True,0,No user reviews,0,0,0
905190,True,0,No user reviews,0,0,0
905210,True,0,1 user reviews,1,0,1
905220,True,0,4 user reviews,4,0,4
905240,True,0,No user reviews,0,0,0
905250,True,0,No user reviews,0,0,0
905260,True,0,No user reviews,0,0,0
905270,True,0,1 user reviews,0,1,1
905280,True,0,No user reviews,0,0,0
905300,True,0,5 user reviews,1,4,5
905320,True,0,No user reviews,0,0,0
905330,True,0,2 user reviews,2,0,2
905340,True,8,Very Positive,473,17,490
905350,True,0,4 user reviews,4,0,4
905360,True,0,No user reviews,0,0,0
905370,True,5,Mixed,317,179,496
905380,True,0,1 user reviews,1,0,1
905390,True,0,No user reviews,0,0,0
905400,True,0,No user reviews,0,0,0
905420,True,0,No user reviews,0,0,0
905440,True,0,No user reviews,0,0,0
905450,True,5,Mixed,151,67,218
905460,True,0,No user reviews,0,0,0
905470,True,0,No user reviews,0,0,0
905490,True,6,Mostly Positive,69,26,95
905510,True,0,4 user reviews,4,0,4
905520,True,0,2 user reviews,0,2,2
905530,True,0,No user reviews,0,0,0
905540,True,0,No user reviews,0,0,0
905560,True,0,No user reviews,0,0,0
905590,True,0,No user reviews,0,0,0
905630,True,0,1 user reviews,0,1,1
905640,True,0,No user reviews,0,0,0
905650,True,0,No user reviews,0,0,0
905660,True,7,Positive,13,1,14
905670,True,0,No user reviews,0,0,0
905680,True,0,No user reviews,0,0,0
905681,True,0,No user reviews,0,0,0
905682,True,0,5 user reviews,5,0,5
905683,True,0,No user reviews,0,0,0
905684,True,0,No user reviews,0,0,0
905685,True,0,No user reviews,0,0,0
905686,True,0,No user reviews,0,0,0
905687,True,0,No user reviews,0,0,0
905688,True,0,No user reviews,0,0,0
905689,True,0,No user reviews,0,0,0
905690,True,0,2 user reviews,2,0,2
905700,True,0,No user reviews,0,0,0
905701,True,0,No user reviews,0,0,0
905702,True,0,No user reviews,0,0,0
905703,True,0,No user reviews,0,0,0
905704,True,0,2 user reviews,2,0,2
905705,True,0,1 user reviews,1,0,1
905706,True,0,No user reviews,0,0,0
905707,True,0,No user reviews,0,0,0
905708,True,0,No user reviews,0,0,0
905730,True,0,No user reviews,0,0,0
905740,True,0,No user reviews,0,0,0
905750,True,0,No user reviews,0,0,0
905760,True,0,No user reviews,0,0,0
905770,True,0,No user reviews,0,0,0
905780,True,0,No user reviews,0,0,0
905790,True,0,2 user reviews,2,0,2
905800,True,0,7 user reviews,4,3,7
905820,True,0,No user reviews,0,0,0
905840,True,0,No user reviews,0,0,0
905860,True,0,1 user reviews,0,1,1
905870,True,0,3 user reviews,3,0,3
905880,True,0,6 user reviews,5,1,6
905890,True,0,1 user reviews,1,0,1
905960,True,0,1 user reviews,1,0,1
905970,True,0,No user reviews,0,0,0
905980,True,0,No user reviews,0,0,0
905990,True,0,No user reviews,0,0,0
906000,True,5,Mixed,8,7,15
906010,True,0,5 user reviews,4,1,5
906020,True,0,2 user reviews,1,1,2
906030,True,0,No user reviews,0,0,0
906040,True,0,No user reviews,0,0,0
906050,True,6,Mostly Positive,74,27,101
906060,True,0,No user reviews,0,0,0
906100,True,6,Mostly Positive,841,222,1063
906110,True,7,Positive,35,0,35
906120,True,8,Very Positive,102,8,110
906130,True,0,2 user reviews,1,1,2
906160,True,0,2 user reviews,1,1,2
906170,True,0,2 user reviews,1,1,2
906190,True,0,2 user reviews,2,0,2
906200,True,0,No user reviews,0,0,0
906240,True,0,1 user reviews,0,1,1
906250,True,0,2 user reviews,0,2,2
906260,True,0,No user reviews,0,0,0
906280,True,0,5 user reviews,5,0,5
906290,True,0,6 user reviews,6,0,6
906300,True,7,Positive,44,4,48
906310,True,0,2 user reviews,2,0,2
906320,True,0,No user reviews,0,0,0
906360,True,0,3 user reviews,2,1,3
906370,True,0,5 user reviews,5,0,5
906390,True,7,Positive,15,1,16
906430,True,0,No user reviews,0,0,0
906440,True,0,1 user reviews,1,0,1
906460,True,0,No user reviews,0,0,0
906470,True,0,No user reviews,0,0,0
906480,True,0,1 user reviews,1,0,1
906490,True,0,No user reviews,0,0,0
906500,True,0,No user reviews,0,0,0
906510,True,7,Positive,26,4,30
906520,True,0,No user reviews,0,0,0
906530,True,0,No user reviews,0,0,0
906531,True,0,No user reviews,0,0,0
906560,True,0,1 user reviews,0,1,1
906590,True,7,Positive,27,4,31
906600,True,7,Positive,30,0,30
906610,True,0,No user reviews,0,0,0
906630,True,0,1 user reviews,0,1,1
906631,True,0,1 user reviews,1,0,1
906632,True,0,No user reviews,0,0,0
906633,True,0,No user reviews,0,0,0
906634,True,0,No user reviews,0,0,0
906635,True,0,No user reviews,0,0,0
906636,True,0,1 user reviews,0,1,1
906637,True,0,No user reviews,0,0,0
906638,True,0,1 user reviews,1,0,1
906650,True,0,3 user reviews,3,0,3
906660,True,0,7 user reviews,4,3,7
906680,True,0,7 user reviews,5,2,7
906700,True,0,No user reviews,0,0,0
906720,True,0,No user reviews,0,0,0
906730,True,7,Positive,17,2,19
906740,True,5,Mixed,46,20,66
906750,True,0,1 user reviews,0,1,1
906770,True,5,Mixed,8,6,14
906780,True,0,No user reviews,0,0,0
906790,True,5,Mixed,23,16,39
906800,True,0,No user reviews,0,0,0
906810,True,5,Mixed,7,8,15
906820,True,0,No user reviews,0,0,0
906840,True,0,No user reviews,0,0,0
906850,True,0,2 user reviews,2,0,2
906870,True,0,No user reviews,0,0,0
906880,True,0,3 user reviews,3,0,3
906910,True,0,No user reviews,0,0,0
906920,True,5,Mixed,5,6,11
906950,True,0,1 user reviews,1,0,1
907000,True,0,No user reviews,0,0,0
907020,True,0,5 user reviews,3,2,5
907030,True,0,No user reviews,0,0,0
907040,True,0,7 user reviews,5,2,7
907050,True,0,No user reviews,0,0,0
907080,True,0,5 user reviews,4,1,5
907120,True,0,No user reviews,0,0,0
907140,True,0,No user reviews,0,0,0
907150,True,0,3 user reviews,3,0,3
907160,True,0,No user reviews,0,0,0
907170,True,0,No user reviews,0,0,0
907180,True,0,No user reviews,0,0,0
907190,True,0,3 user reviews,3,0,3
907210,True,5,Mixed,18,19,37
907220,True,0,1 user reviews,0,1,1
907230,True,0,1 user reviews,1,0,1
907240,True,0,1 user reviews,1,0,1
907250,True,0,2 user reviews,1,1,2
907270,True,8,Very Positive,67,16,83
907280,True,0,5 user reviews,4,1,5
907290,True,0,No user reviews,0,0,0
907310,True,0,No user reviews,0,0,0
907320,True,0,1 user reviews,1,0,1
907330,True,0,No user reviews,0,0,0
907350,True,0,3 user reviews,2,1,3
907360,True,0,No user reviews,0,0,0
907370,True,8,Very Positive,192,12,204
907380,True,6,Mostly Positive,17,7,24
907390,True,0,No user reviews,0,0,0
907410,True,0,6 user reviews,5,1,6
907420,True,0,1 user reviews,1,0,1
907421,True,0,No user reviews,0,0,0
907430,True,0,No user reviews,0,0,0
907440,True,5,Mixed,11,6,17
907460,True,0,5 user reviews,2,3,5
907470,True,8,Very Positive,153,26,179
907480,True,0,No user reviews,0,0,0
907490,True,0,No user reviews,0,0,0
907500,True,0,No user reviews,0,0,0
907510,True,7,Positive,11,2,13
907520,True,0,No user reviews,0,0,0
907540,True,0,2 user reviews,2,0,2
907560,True,0,3 user reviews,3,0,3
907570,True,0,No user reviews,0,0,0
907571,True,0,No user reviews,0,0,0
907572,True,0,No user reviews,0,0,0
907580,True,0,No user reviews,0,0,0
907590,True,0,5 user reviews,1,4,5
907600,True,0,5 user reviews,5,0,5
907610,True,0,No user reviews,0,0,0
907611,True,0,No user reviews,0,0,0
907613,True,0,No user reviews,0,0,0
907614,True,0,No user reviews,0,0,0
907620,True,0,8 user reviews,7,1,8
907630,True,0,No user reviews,0,0,0
907650,True,0,No user reviews,0,0,0
907670,True,7,Positive,35,0,35
907680,True,5,Mixed,13,8,21
907710,True,5,Mixed,4,6,10
907760,True,8,Very Positive,44,9,53
907770,True,6,Mostly Positive,27,11,38
907780,True,0,No user reviews,0,0,0
907790,True,0,No user reviews,0,0,0
907800,True,0,No user reviews,0,0,0
907820,True,7,Positive,42,5,47
907870,True,0,2 user reviews,1,1,2
907880,True,0,1 user reviews,1,0,1
907881,True,0,3 user reviews,3,0,3
907890,True,0,4 user reviews,3,1,4
907900,True,0,2 user reviews,2,0,2
907910,True,0,No user reviews,0,0,0
907920,True,0,No user reviews,0,0,0
907940,True,0,No user reviews,0,0,0
907950,True,0,7 user reviews,5,2,7
907970,True,0,4 user reviews,2,2,4
907980,True,0,No user reviews,0,0,0
908000,True,0,No user reviews,0,0,0
908010,True,0,1 user reviews,1,0,1
908020,True,0,2 user reviews,2,0,2
908030,True,0,1 user reviews,0,1,1
908040,True,0,No user reviews,0,0,0
908050,True,6,Mostly Positive,19,8,27
908070,True,8,Very Positive,131,16,147
908090,True,0,2 user reviews,0,2,2
908100,True,0,No user reviews,0,0,0
908120,True,0,1 user reviews,1,0,1
908130,True,0,6 user reviews,6,0,6
908150,True,0,1 user reviews,1,0,1
908180,True,7,Positive,8,2,10
908190,True,0,No user reviews,0,0,0
908210,True,5,Mixed,14,8,22
908211,True,0,6 user reviews,5,1,6
908212,True,0,3 user reviews,1,2,3
908213,True,0,7 user reviews,7,0,7
908220,True,0,No user reviews,0,0,0
908221,True,0,1 user reviews,1,0,1
908222,True,0,1 user reviews,1,0,1
908223,True,0,1 user reviews,1,0,1
908224,True,0,1 user reviews,1,0,1
908225,True,0,1 user reviews,1,0,1
908226,True,0,No user reviews,0,0,0
908227,True,0,No user reviews,0,0,0
908230,True,0,4 user reviews,1,3,4
908240,True,0,No user reviews,0,0,0
908250,True,0,No user reviews,0,0,0
908260,True,0,1 user reviews,1,0,1
908270,True,0,No user reviews,0,0,0
908290,True,0,1 user reviews,1,0,1
908310,True,0,4 user reviews,2,2,4
908320,True,0,No user reviews,0,0,0
908330,True,0,No user reviews,0,0,0
908340,True,0,No user reviews,0,0,0
908350,True,0,2 user reviews,2,0,2
908360,True,0,No user reviews,0,0,0
908380,True,0,No user reviews,0,0,0
908390,True,0,No user reviews,0,0,0
908400,True,0,1 user reviews,1,0,1
908420,True,0,No user reviews,0,0,0
908430,True,0,No user reviews,0,0,0
908450,True,0,No user reviews,0,0,0
908460,True,0,5 user reviews,4,1,5
908461,True,0,No user reviews,0,0,0
908470,True,0,No user reviews,0,0,0
908471,True,0,1 user reviews,1,0,1
908472,True,0,1 user reviews,1,0,1
908473,True,0,1 user reviews,1,0,1
908474,True,0,2 user reviews,1,1,2
908480,True,0,No user reviews,0,0,0
908500,True,0,No user reviews,0,0,0
908510,True,0,No user reviews,0,0,0
908520,True,9,Overwhelmingly Positive,530,8,538
908560,True,0,4 user reviews,4,0,4
908570,True,0,No user reviews,0,0,0
908580,True,0,No user reviews,0,0,0
908590,True,0,No user reviews,0,0,0
908620,True,0,1 user reviews,1,0,1
908640,True,0,No user reviews,0,0,0
908650,True,0,No user reviews,0,0,0
908660,True,0,No user reviews,0,0,0
908670,True,0,No user reviews,0,0,0
908680,True,0,No user reviews,0,0,0
908690,True,0,No user reviews,0,0,0
908710,True,0,3 user reviews,2,1,3
908730,True,0,No user reviews,0,0,0
908740,True,5,Mixed,19,18,37
908750,True,0,3 user reviews,3,0,3
908760,True,0,No user reviews,0,0,0
908770,True,0,No user reviews,0,0,0
908790,True,6,Mostly Positive,25,7,32
908810,True,0,No user reviews,0,0,0
908820,True,0,No user reviews,0,0,0
908830,True,0,1 user reviews,1,0,1
908840,True,0,1 user reviews,1,0,1
908860,True,0,No user reviews,0,0,0
908920,True,0,1 user reviews,0,1,1
908940,True,0,No user reviews,0,0,0
908950,True,0,2 user reviews,0,2,2
908960,True,0,No user reviews,0,0,0
908970,True,0,No user reviews,0,0,0
908990,True,7,Positive,13,1,14
909000,True,5,Mixed,21,20,41
909010,True,0,4 user reviews,4,0,4
909020,True,0,No user reviews,0,0,0
909050,True,0,6 user reviews,2,4,6
909080,True,8,Very Positive,83,2,85
909090,True,0,No user reviews,0,0,0
909100,True,0,No user reviews,0,0,0
909110,True,0,No user reviews,0,0,0
909140,True,0,No user reviews,0,0,0
909150,True,7,Positive,43,2,45
909170,True,0,No user reviews,0,0,0
909190,True,0,No user reviews,0,0,0
909200,True,0,1 user reviews,1,0,1
909220,True,7,Positive,9,1,10
909250,True,0,No user reviews,0,0,0
909270,True,0,3 user reviews,2,1,3
909320,True,8,Very Positive,192,37,229
909330,True,0,1 user reviews,1,0,1
909340,True,0,No user reviews,0,0,0
909350,True,0,No user reviews,0,0,0
909360,True,0,No user reviews,0,0,0
909370,True,0,No user reviews,0,0,0
909380,True,0,No user reviews,0,0,0
909390,True,0,No user reviews,0,0,0
909420,True,0,1 user reviews,0,1,1
909430,True,0,No user reviews,0,0,0
909450,True,0,No user reviews,0,0,0
909460,True,0,1 user reviews,1,0,1
909470,True,0,No user reviews,0,0,0
909480,True,0,5 user reviews,3,2,5
909490,True,0,1 user reviews,1,0,1
909500,True,0,No user reviews,0,0,0
909510,True,8,Very Positive,158,37,195
909530,True,0,No user reviews,0,0,0
909550,True,0,No user reviews,0,0,0
909570,True,6,Mostly Positive,17,5,22
909580,True,5,Mixed,4,6,10
909590,True,0,No user reviews,0,0,0
909600,True,0,No user reviews,0,0,0
909610,True,7,Positive,28,0,28
909630,True,5,Mixed,7,5,12
909640,True,7,Positive,16,0,16
909650,True,0,No user reviews,0,0,0
909660,True,8,Very Positive,86,13,99
909670,True,7,Positive,11,2,13
909690,True,0,No user reviews,0,0,0
909720,True,6,Mostly Positive,37,14,51
909730,True,0,No user reviews,0,0,0
909770,True,0,1 user reviews,1,0,1
909780,True,6,Mostly Positive,15,6,21
909790,True,0,No user reviews,0,0,0
909800,True,0,No user reviews,0,0,0
909801,True,0,No user reviews,0,0,0
909802,True,0,No user reviews,0,0,0
909803,True,0,No user reviews,0,0,0
909804,True,0,No user reviews,0,0,0
909805,True,0,No user reviews,0,0,0
909806,True,0,No user reviews,0,0,0
909807,True,0,No user reviews,0,0,0
909808,True,0,No user reviews,0,0,0
909809,True,0,No user reviews,0,0,0
909810,True,0,No user reviews,0,0,0
909820,True,8,Very Positive,87,5,92
909830,True,0,9 user reviews,5,4,9
909850,True,0,4 user reviews,0,4,4
909851,True,0,6 user reviews,6,0,6
909870,True,0,No user reviews,0,0,0
909890,True,0,No user reviews,0,0,0
909900,True,0,No user reviews,0,0,0
909910,True,0,No user reviews,0,0,0
909911,True,0,No user reviews,0,0,0
909912,True,0,No user reviews,0,0,0
909913,True,0,No user reviews,0,0,0
909914,True,0,No user reviews,0,0,0
909915,True,0,No user reviews,0,0,0
909916,True,0,No user reviews,0,0,0
909917,True,0,No user reviews,0,0,0
909918,True,0,No user reviews,0,0,0
909919,True,0,No user reviews,0,0,0
909920,True,0,No user reviews,0,0,0
909921,True,0,No user reviews,0,0,0
909930,True,0,No user reviews,0,0,0
909940,True,0,No user reviews,0,0,0
909941,True,0,No user reviews,0,0,0
909942,True,0,No user reviews,0,0,0
909943,True,0,No user reviews,0,0,0
909944,True,0,No user reviews,0,0,0
909945,True,0,No user reviews,0,0,0
909946,True,0,No user reviews,0,0,0
909947,True,0,No user reviews,0,0,0
909948,True,0,No user reviews,0,0,0
909949,True,0,No user reviews,0,0,0
909950,True,0,No user reviews,0,0,0
909951,True,0,No user reviews,0,0,0
909952,True,0,No user reviews,0,0,0
909953,True,0,No user reviews,0,0,0
909954,True,0,No user reviews,0,0,0
909955,True,0,No user reviews,0,0,0
909956,True,0,No user reviews,0,0,0
909957,True,0,No user reviews,0,0,0
909958,True,0,No user reviews,0,0,0
909959,True,0,No user reviews,0,0,0
909960,True,0,No user reviews,0,0,0
909961,True,0,No user reviews,0,0,0
909962,True,0,No user reviews,0,0,0
909963,True,0,No user reviews,0,0,0
909970,True,4,Mostly Negative,30,71,101
909980,True,0,No user reviews,0,0,0
909990,True,0,No user reviews,0,0,0
909991,True,0,No user reviews,0,0,0
909992,True,0,No user reviews,0,0,0
909993,True,0,No user reviews,0,0,0
909994,True,0,No user reviews,0,0,0
909995,True,0,No user reviews,0,0,0
909996,True,0,No user reviews,0,0,0
909997,True,0,No user reviews,0,0,0
909998,True,0,No user reviews,0,0,0
909999,True,0,No user reviews,0,0,0
910000,True,0,No user reviews,0,0,0
910001,True,0,No user reviews,0,0,0
910002,True,0,No user reviews,0,0,0
910040,True,0,No user reviews,0,0,0
910050,True,0,No user reviews,0,0,0
910150,True,0,6 user reviews,4,2,6
910160,True,0,No user reviews,0,0,0
910180,True,0,No user reviews,0,0,0
910190,True,0,No user reviews,0,0,0
910200,True,0,3 user reviews,1,2,3
910210,True,0,No user reviews,0,0,0
910220,True,0,3 user reviews,1,2,3
910230,True,0,No user reviews,0,0,0
910250,True,0,4 user reviews,2,2,4
910260,True,0,No user reviews,0,0,0
910280,True,0,1 user reviews,1,0,1
910290,True,0,1 user reviews,0,1,1
910320,True,0,No user reviews,0,0,0
910370,True,5,Mixed,5,7,12
910380,True,0,3 user reviews,3,0,3
910390,True,0,1 user reviews,1,0,1
910400,True,0,2 user reviews,1,1,2
910410,True,0,No user reviews,0,0,0
910420,True,0,No user reviews,0,0,0
910430,True,0,9 user reviews,3,6,9
910450,True,5,Mixed,45,41,86
910460,True,0,No user reviews,0,0,0
910470,True,0,7 user reviews,7,0,7
910490,True,5,Mixed,468,226,694
910500,True,0,No user reviews,0,0,0
910530,True,0,4 user reviews,2,2,4
910540,True,0,5 user reviews,4,1,5
910560,True,0,No user reviews,0,0,0
910590,True,0,3 user reviews,1,2,3
910600,True,0,No user reviews,0,0,0
910620,True,0,No user reviews,0,0,0
910630,True,8,Very Positive,195,2,197
910640,True,0,No user reviews,0,0,0
910650,True,0,No user reviews,0,0,0
910660,True,0,7 user reviews,6,1,7
910700,True,0,No user reviews,0,0,0
910710,True,0,No user reviews,0,0,0
910711,True,0,No user reviews,0,0,0
910730,True,0,6 user reviews,6,0,6
910740,True,0,No user reviews,0,0,0
910750,True,0,No user reviews,0,0,0
910760,True,0,No user reviews,0,0,0
910770,True,0,No user reviews,0,0,0
910800,True,0,No user reviews,0,0,0
910820,True,0,1 user reviews,1,0,1
910821,True,0,1 user reviews,1,0,1
910830,True,5,Mixed,105,53,158
910850,True,0,1 user reviews,0,1,1
910880,True,8,Very Positive,109,25,134
910930,True,0,5 user reviews,5,0,5
910931,True,0,No user reviews,0,0,0
910932,True,0,No user reviews,0,0,0
910940,True,5,Mixed,22,10,32
910980,True,0,No user reviews,0,0,0
910990,True,0,5 user reviews,4,1,5
911000,True,0,2 user reviews,2,0,2
911010,True,0,1 user reviews,1,0,1
911020,True,0,No user reviews,0,0,0
911040,True,5,Mixed,6,6,12
911050,True,0,No user reviews,0,0,0
911070,True,0,No user reviews,0,0,0
911080,True,0,No user reviews,0,0,0
911100,True,0,8 user reviews,8,0,8
911120,True,0,9 user reviews,9,0,9
911130,True,0,5 user reviews,1,4,5
911170,True,0,No user reviews,0,0,0
911180,True,0,4 user reviews,2,2,4
911200,True,0,3 user reviews,1,2,3
911210,True,0,4 user reviews,1,3,4
911220,True,8,Very Positive,56,4,60
911230,True,0,4 user reviews,4,0,4
911240,True,0,2 user reviews,2,0,2
911250,True,0,No user reviews,0,0,0
911260,True,0,No user reviews,0,0,0
911270,True,0,1 user reviews,1,0,1
911280,True,0,2 user reviews,0,2,2
911290,True,0,2 user reviews,2,0,2
911310,True,0,5 user reviews,5,0,5
911320,True,0,No user reviews,0,0,0
911380,True,0,No user reviews,0,0,0
911400,True,5,Mixed,556,483,1039
911410,True,0,No user reviews,0,0,0
911420,True,0,4 user reviews,3,1,4
911430,True,6,Mostly Positive,222,80,302
911440,True,0,2 user reviews,1,1,2
911450,True,0,No user reviews,0,0,0
911480,True,0,3 user reviews,3,0,3
911490,True,0,No user reviews,0,0,0
911500,True,0,No user reviews,0,0,0
911510,True,5,Mixed,6,8,14
911520,True,7,Positive,22,1,23
911540,True,0,No user reviews,0,0,0
911550,True,6,Mostly Positive,75,22,97
911580,True,0,2 user reviews,2,0,2
911590,True,0,5 user reviews,2,3,5
911610,True,0,4 user reviews,4,0,4
911630,True,0,No user reviews,0,0,0
911640,True,0,No user reviews,0,0,0
911660,True,0,No user reviews,0,0,0
911680,True,0,6 user reviews,5,1,6
911690,True,0,1 user reviews,1,0,1
911700,True,0,No user reviews,0,0,0
911720,True,0,No user reviews,0,0,0
911760,True,7,Positive,8,2,10
911780,True,0,No user reviews,0,0,0
911820,True,0,No user reviews,0,0,0
911840,True,0,5 user reviews,4,1,5
911850,True,0,No user reviews,0,0,0
911860,True,0,No user reviews,0,0,0
911880,True,0,2 user reviews,0,2,2
911920,True,0,2 user reviews,2,0,2
911930,True,5,Mixed,84,81,165
911950,True,0,2 user reviews,2,0,2
911970,True,0,No user reviews,0,0,0
911980,True,0,No user reviews,0,0,0
911990,True,0,No user reviews,0,0,0
912000,True,0,No user reviews,0,0,0
912010,True,0,No user reviews,0,0,0
912020,True,0,3 user reviews,2,1,3
912070,True,0,1 user reviews,1,0,1
912110,True,5,Mixed,18,11,29
912120,True,0,1 user reviews,0,1,1
912140,True,0,No user reviews,0,0,0
912170,True,7,Positive,10,1,11
912180,True,0,No user reviews,0,0,0
912190,True,6,Mostly Positive,12,5,17
912210,True,0,No user reviews,0,0,0
912240,True,0,No user reviews,0,0,0
912250,True,0,No user reviews,0,0,0
912260,True,0,No user reviews,0,0,0
912270,True,0,8 user reviews,8,0,8
912290,True,0,No user reviews,0,0,0
912310,True,0,No user reviews,0,0,0
912330,True,0,No user reviews,0,0,0
912340,True,0,No user reviews,0,0,0
912350,True,0,No user reviews,0,0,0
912360,True,0,No user reviews,0,0,0
912370,True,6,Mostly Positive,33,11,44
912390,True,0,7 user reviews,7,0,7
912410,True,0,No user reviews,0,0,0
912420,True,0,7 user reviews,3,4,7
912450,True,6,Mostly Positive,22,8,30
912460,True,7,Positive,29,3,32
912470,True,0,3 user reviews,3,0,3
912500,True,0,2 user reviews,2,0,2
912510,True,0,No user reviews,0,0,0
912520,True,0,No user reviews,0,0,0
912540,True,7,Positive,30,1,31
912550,True,7,Positive,18,2,20
912560,True,0,No user reviews,0,0,0
912570,True,8,Very Positive,91,22,113
912580,True,0,2 user reviews,2,0,2
912590,True,0,2 user reviews,1,1,2
912630,True,0,No user reviews,0,0,0
912650,True,0,1 user reviews,1,0,1
912660,True,0,9 user reviews,6,3,9
912690,True,0,No user reviews,0,0,0
912720,True,0,No user reviews,0,0,0
912730,True,0,No user reviews,0,0,0
912760,True,0,3 user reviews,2,1,3
912770,True,0,No user reviews,0,0,0
912780,True,0,No user reviews,0,0,0
912790,True,0,2 user reviews,1,1,2
912810,True,0,No user reviews,0,0,0
912820,True,0,5 user reviews,4,1,5
912830,True,0,No user reviews,0,0,0
912831,True,0,3 user reviews,3,0,3
912832,True,0,No user reviews,0,0,0
912833,True,0,No user reviews,0,0,0
912834,True,0,No user reviews,0,0,0
912835,True,0,No user reviews,0,0,0
912840,True,0,No user reviews,0,0,0
912850,True,0,2 user reviews,2,0,2
912870,True,0,No user reviews,0,0,0
912880,True,0,No user reviews,0,0,0
912900,True,0,3 user reviews,2,1,3
912910,True,0,No user reviews,0,0,0
912920,True,7,Positive,15,0,15
912930,True,7,Positive,19,0,19
912970,True,0,No user reviews,0,0,0
912980,True,0,No user reviews,0,0,0
912990,True,0,No user reviews,0,0,0
913000,True,0,1 user reviews,1,0,1
913010,True,0,No user reviews,0,0,0
913020,True,0,No user reviews,0,0,0
913050,True,0,No user reviews,0,0,0
913060,True,8,Very Positive,196,12,208
913090,True,7,Positive,29,1,30
913100,True,0,9 user reviews,8,1,9
913110,True,7,Positive,27,0,27
913120,True,0,3 user reviews,3,0,3
913130,True,0,4 user reviews,4,0,4
913140,True,0,No user reviews,0,0,0
913150,True,0,1 user reviews,1,0,1
913160,True,0,1 user reviews,1,0,1
913180,True,0,9 user reviews,4,5,9
913210,True,0,1 user reviews,1,0,1
913250,True,0,2 user reviews,0,2,2
913260,True,0,3 user reviews,2,1,3
913270,True,0,No user reviews,0,0,0
913280,True,0,7 user reviews,5,2,7
913320,True,0,No user reviews,0,0,0
913330,True,7,Positive,19,3,22
913340,True,5,Mixed,9,4,13
913350,True,0,1 user reviews,0,1,1
913370,True,0,No user reviews,0,0,0
913380,True,0,No user reviews,0,0,0
913400,True,0,No user reviews,0,0,0
913420,True,0,1 user reviews,1,0,1
913440,True,0,4 user reviews,3,1,4
913460,True,0,No user reviews,0,0,0
913480,True,0,No user reviews,0,0,0
913500,True,0,3 user reviews,3,0,3
913510,True,0,No user reviews,0,0,0
913550,True,0,2 user reviews,2,0,2
913570,True,0,No user reviews,0,0,0
913590,True,7,Positive,14,2,16
913600,True,0,No user reviews,0,0,0
913610,True,0,No user reviews,0,0,0
913611,True,0,No user reviews,0,0,0
913620,True,0,No user reviews,0,0,0
913630,True,0,No user reviews,0,0,0
913650,True,0,4 user reviews,3,1,4
913660,True,0,No user reviews,0,0,0
913670,True,0,3 user reviews,3,0,3
913680,True,0,1 user reviews,1,0,1
913690,True,0,No user reviews,0,0,0
913710,True,5,Mixed,17,8,25
913720,True,0,No user reviews,0,0,0
913730,True,0,No user reviews,0,0,0
913740,True,9,Overwhelmingly Positive,1842,43,1885
913750,True,0,8 user reviews,5,3,8
913770,True,0,1 user reviews,1,0,1
913780,True,2,Very Negative,10,43,53
913810,True,7,Positive,21,0,21
913820,True,5,Mixed,8,12,20
913830,True,0,6 user reviews,4,2,6
913840,True,0,4 user reviews,4,0,4
913850,True,6,Mostly Positive,27,11,38
913890,True,6,Mostly Positive,48,20,68
913900,True,0,No user reviews,0,0,0
913910,True,0,1 user reviews,0,1,1
913920,True,0,No user reviews,0,0,0
913930,True,0,1 user reviews,1,0,1
913970,True,0,3 user reviews,3,0,3
914000,True,7,Positive,16,4,20
914010,True,8,Very Positive,380,74,454
914020,True,8,Very Positive,331,41,372
914030,True,0,No user reviews,0,0,0
914050,True,0,No user reviews,0,0,0
914060,True,0,1 user reviews,1,0,1
914070,True,0,5 user reviews,1,4,5
914080,True,7,Positive,8,2,10
914090,True,0,5 user reviews,3,2,5
914110,True,5,Mixed,23,22,45
914120,True,0,No user reviews,0,0,0
914130,True,0,6 user reviews,1,5,6
914140,True,5,Mixed,24,18,42
914160,True,4,Mostly Negative,5,10,15
914170,True,6,Mostly Positive,54,14,68
914180,True,5,Mixed,12,14,26
914190,True,0,3 user reviews,3,0,3
914200,True,0,5 user reviews,2,3,5
914210,True,0,No user reviews,0,0,0
914220,True,0,4 user reviews,2,2,4
914230,True,0,2 user reviews,1,1,2
914250,True,0,No user reviews,0,0,0
914260,True,8,Very Positive,453,81,534
914270,True,0,No user reviews,0,0,0
914280,True,0,4 user reviews,4,0,4
914290,True,8,Very Positive,86,18,104
914310,True,0,2 user reviews,2,0,2
914320,True,0,No user reviews,0,0,0
914340,True,0,2 user reviews,1,1,2
914350,True,0,1 user reviews,1,0,1
914360,True,0,No user reviews,0,0,0
914390,True,0,No user reviews,0,0,0
914400,True,7,Positive,22,4,26
914410,True,0,No user reviews,0,0,0
914420,True,0,1 user reviews,1,0,1
914430,True,0,No user reviews,0,0,0
914440,True,0,1 user reviews,1,0,1
914450,True,0,No user reviews,0,0,0
914460,True,0,No user reviews,0,0,0
914480,True,0,1 user reviews,1,0,1
914490,True,0,No user reviews,0,0,0
914500,True,0,6 user reviews,3,3,6
914510,True,0,No user reviews,0,0,0
914520,True,0,No user reviews,0,0,0
914540,True,0,2 user reviews,2,0,2
914560,True,0,No user reviews,0,0,0
914570,True,0,No user reviews,0,0,0
914600,True,0,No user reviews,0,0,0
914620,True,6,Mostly Positive,2701,698,3399
914630,True,0,5 user reviews,3,2,5
914640,True,5,Mixed,7,4,11
914660,True,0,No user reviews,0,0,0
914661,True,0,No user reviews,0,0,0
914662,True,0,1 user reviews,1,0,1
914680,True,0,4 user reviews,1,3,4
914690,True,6,Mostly Positive,129,38,167
914700,True,0,1 user reviews,1,0,1
914710,True,9,Overwhelmingly Positive,492,13,505
914750,True,0,No user reviews,0,0,0
914770,True,0,No user reviews,0,0,0
914780,True,0,No user reviews,0,0,0
914790,True,0,No user reviews,0,0,0
914800,True,8,Very Positive,697,48,745
914810,True,0,No user reviews,0,0,0
914820,True,0,No user reviews,0,0,0
914830,True,0,No user reviews,0,0,0
914831,True,0,No user reviews,0,0,0
914840,True,0,1 user reviews,0,1,1
914850,True,8,Very Positive,46,6,52
914870,True,0,No user reviews,0,0,0
914890,True,0,No user reviews,0,0,0
914900,True,0,1 user reviews,1,0,1
914950,True,5,Mixed,9,5,14
914970,True,5,Mixed,20,16,36
914990,True,0,No user reviews,0,0,0
915000,True,0,No user reviews,0,0,0
915020,True,0,3 user reviews,3,0,3
915050,True,0,No user reviews,0,0,0
915060,True,0,No user reviews,0,0,0
915070,True,0,No user reviews,0,0,0
915080,True,0,8 user reviews,7,1,8
915090,True,0,3 user reviews,3,0,3
915100,True,0,No user reviews,0,0,0
915120,True,0,1 user reviews,1,0,1
915130,True,7,Positive,10,0,10
915140,True,7,Positive,40,4,44
915160,True,0,7 user reviews,6,1,7
915170,True,0,1 user reviews,0,1,1
915180,True,0,No user reviews,0,0,0
915190,True,0,No user reviews,0,0,0
915200,True,7,Positive,8,2,10
915210,True,0,No user reviews,0,0,0
915230,True,0,No user reviews,0,0,0
915250,True,0,No user reviews,0,0,0
915300,True,0,1 user reviews,1,0,1
915320,True,0,No user reviews,0,0,0
915330,True,7,Positive,17,3,20
915340,True,0,No user reviews,0,0,0
915350,True,0,No user reviews,0,0,0
915360,True,0,1 user reviews,1,0,1
915380,True,0,2 user reviews,2,0,2
915390,True,0,3 user reviews,2,1,3
915420,True,0,2 user reviews,2,0,2
915430,True,0,No user reviews,0,0,0
915440,True,5,Mixed,7,5,12
915460,True,8,Very Positive,680,49,729
915480,True,0,No user reviews,0,0,0
915490,True,5,Mixed,39,22,61
915520,True,0,No user reviews,0,0,0
915540,True,0,5 user reviews,3,2,5
915560,True,0,4 user reviews,3,1,4
915570,True,0,No user reviews,0,0,0
915580,True,0,No user reviews,0,0,0
915590,True,0,1 user reviews,1,0,1
915591,True,0,No user reviews,0,0,0
915600,True,8,Very Positive,96,14,110
915610,True,0,No user reviews,0,0,0
915630,True,5,Mixed,4,6,10
915631,True,0,2 user reviews,2,0,2
915650,True,0,3 user reviews,1,2,3
915652,True,5,Mixed,15,17,32
915653,True,4,Mostly Negative,5,8,13
915660,True,0,No user reviews,0,0,0
915661,True,0,No user reviews,0,0,0
915670,True,5,Mixed,47,46,93
915690,True,0,No user reviews,0,0,0
915710,True,5,Mixed,17,13,30
915720,True,0,No user reviews,0,0,0
915730,True,0,3 user reviews,3,0,3
915760,True,0,No user reviews,0,0,0
915770,True,0,No user reviews,0,0,0
915810,True,0,No user reviews,0,0,0
915820,True,0,5 user reviews,5,0,5
915850,True,0,4 user reviews,4,0,4
915860,True,0,1 user reviews,1,0,1
915870,True,0,No user reviews,0,0,0
915890,True,0,No user reviews,0,0,0
915930,True,0,2 user reviews,2,0,2
915960,True,0,No user reviews,0,0,0
915980,True,0,No user reviews,0,0,0
915990,True,0,No user reviews,0,0,0
916000,True,8,Very Positive,81,13,94
916010,True,0,2 user reviews,2,0,2
916030,True,0,7 user reviews,7,0,7
916040,True,7,Positive,32,1,33
916050,True,0,5 user reviews,4,1,5
916060,True,7,Positive,26,3,29
916070,True,0,1 user reviews,1,0,1
916071,True,0,1 user reviews,0,1,1
916100,True,6,Mostly Positive,20,8,28
916110,True,0,No user reviews,0,0,0
916120,True,0,No user reviews,0,0,0
916130,True,0,No user reviews,0,0,0
916150,True,0,No user reviews,0,0,0
916160,True,6,Mostly Positive,17,7,24
916170,True,0,No user reviews,0,0,0
916180,True,0,8 user reviews,6,2,8
916190,True,0,9 user reviews,8,1,9
916200,True,0,No user reviews,0,0,0
916220,True,0,2 user reviews,2,0,2
916240,True,0,5 user reviews,5,0,5
916260,True,0,3 user reviews,0,3,3
916280,True,0,2 user reviews,2,0,2
916290,True,0,3 user reviews,3,0,3
916300,True,0,No user reviews,0,0,0
916320,True,0,8 user reviews,8,0,8
916330,True,0,No user reviews,0,0,0
916340,True,0,1 user reviews,0,1,1
916360,True,0,No user reviews,0,0,0
916361,True,0,No user reviews,0,0,0
916370,True,0,1 user reviews,1,0,1
916380,True,0,5 user reviews,4,1,5
916390,True,0,No user reviews,0,0,0
916410,True,0,3 user reviews,2,1,3
916420,True,0,No user reviews,0,0,0
916430,True,4,Mostly Negative,44,79,123
916431,True,0,No user reviews,0,0,0
916440,True,8,Very Positive,932,168,1100
916451,True,0,No user reviews,0,0,0
916452,True,0,No user reviews,0,0,0
916470,True,0,1 user reviews,0,1,1
916500,True,0,No user reviews,0,0,0
916510,True,0,6 user reviews,4,2,6
916530,True,0,No user reviews,0,0,0
916540,True,0,4 user reviews,3,1,4
916570,True,0,No user reviews,0,0,0
916580,True,7,Positive,9,2,11
916590,True,0,No user reviews,0,0,0
916600,True,0,1 user reviews,1,0,1
916630,True,0,No user reviews,0,0,0
916640,True,0,4 user reviews,0,4,4
916650,True,0,No user reviews,0,0,0
916660,True,0,No user reviews,0,0,0
916661,True,0,No user reviews,0,0,0
916662,True,0,No user reviews,0,0,0
916663,True,0,No user reviews,0,0,0
916664,True,0,No user reviews,0,0,0
916665,True,0,No user reviews,0,0,0
916666,True,0,No user reviews,0,0,0
916667,True,0,No user reviews,0,0,0
916668,True,0,No user reviews,0,0,0
916669,True,0,No user reviews,0,0,0
916670,True,0,No user reviews,0,0,0
916671,True,0,No user reviews,0,0,0
916672,True,0,No user reviews,0,0,0
916673,True,0,No user reviews,0,0,0
916674,True,0,No user reviews,0,0,0
916675,True,0,No user reviews,0,0,0
916676,True,0,No user reviews,0,0,0
916677,True,0,No user reviews,0,0,0
916678,True,0,No user reviews,0,0,0
916679,True,0,No user reviews,0,0,0
916680,True,0,No user reviews,0,0,0
916681,True,0,No user reviews,0,0,0
916682,True,0,No user reviews,0,0,0
916683,True,0,No user reviews,0,0,0
916690,True,0,No user reviews,0,0,0
916720,True,0,No user reviews,0,0,0
916730,True,8,Very Positive,788,42,830
916760,True,0,No user reviews,0,0,0
916771,True,0,2 user reviews,1,1,2
916772,True,0,No user reviews,0,0,0
916780,True,0,3 user reviews,2,1,3
916820,True,0,No user reviews,0,0,0
916840,True,8,Very Positive,2270,285,2555
916850,True,0,No user reviews,0,0,0
916860,True,0,5 user reviews,1,4,5
916880,True,0,1 user reviews,0,1,1
916900,True,8,Very Positive,51,6,57
916910,True,0,No user reviews,0,0,0
916920,True,0,No user reviews,0,0,0
916930,True,5,Mixed,65,86,151
916950,True,7,Positive,13,1,14
916960,True,0,4 user reviews,4,0,4
916970,True,0,No user reviews,0,0,0
917000,True,5,Mixed,7,4,11
917010,True,0,No user reviews,0,0,0
917011,True,0,No user reviews,0,0,0
917012,True,0,No user reviews,0,0,0
917013,True,0,7 user reviews,7,0,7
917014,True,0,1 user reviews,1,0,1
917015,True,0,No user reviews,0,0,0
917016,True,0,No user reviews,0,0,0
917017,True,0,No user reviews,0,0,0
917018,True,0,No user reviews,0,0,0
917019,True,0,No user reviews,0,0,0
917020,True,0,No user reviews,0,0,0
917030,True,0,No user reviews,0,0,0
917031,True,0,No user reviews,0,0,0
917032,True,0,No user reviews,0,0,0
917033,True,0,No user reviews,0,0,0
917040,True,0,No user reviews,0,0,0
917050,True,0,1 user reviews,0,1,1
917080,True,0,2 user reviews,2,0,2
917090,True,0,3 user reviews,1,2,3
917110,True,0,No user reviews,0,0,0
917130,True,0,1 user reviews,1,0,1
917140,True,0,No user reviews,0,0,0
917150,True,6,Mostly Positive,311,116,427
917170,True,0,No user reviews,0,0,0
917190,True,0,4 user reviews,4,0,4
917200,True,0,5 user reviews,2,3,5
917210,True,0,No user reviews,0,0,0
917220,True,0,No user reviews,0,0,0
917240,True,0,No user reviews,0,0,0
917250,True,0,No user reviews,0,0,0
917260,True,0,No user reviews,0,0,0
917280,True,0,No user reviews,0,0,0
917290,True,8,Very Positive,73,1,74
917310,True,0,No user reviews,0,0,0
917330,True,0,No user reviews,0,0,0
917331,True,0,No user reviews,0,0,0
917332,True,0,No user reviews,0,0,0
917333,True,0,No user reviews,0,0,0
917334,True,0,No user reviews,0,0,0
917335,True,0,No user reviews,0,0,0
917336,True,0,No user reviews,0,0,0
917337,True,0,No user reviews,0,0,0
917338,True,0,No user reviews,0,0,0
917339,True,0,No user reviews,0,0,0
917340,True,0,No user reviews,0,0,0
917341,True,0,No user reviews,0,0,0
917342,True,0,No user reviews,0,0,0
917350,True,0,No user reviews,0,0,0
917360,True,0,No user reviews,0,0,0
917380,True,0,6 user reviews,6,0,6
917390,True,7,Positive,14,2,16
917400,True,0,No user reviews,0,0,0
917410,True,0,No user reviews,0,0,0
917411,True,0,No user reviews,0,0,0
917412,True,0,No user reviews,0,0,0
917413,True,0,No user reviews,0,0,0
917414,True,0,No user reviews,0,0,0
917415,True,0,No user reviews,0,0,0
917416,True,0,No user reviews,0,0,0
917417,True,0,No user reviews,0,0,0
917418,True,0,No user reviews,0,0,0
917419,True,0,No user reviews,0,0,0
917420,True,0,No user reviews,0,0,0
917421,True,0,No user reviews,0,0,0
917422,True,0,No user reviews,0,0,0
917423,True,0,No user reviews,0,0,0
917424,True,0,No user reviews,0,0,0
917425,True,0,No user reviews,0,0,0
917426,True,0,No user reviews,0,0,0
917427,True,0,No user reviews,0,0,0
917428,True,0,No user reviews,0,0,0
917429,True,0,No user reviews,0,0,0
917430,True,0,No user reviews,0,0,0
917431,True,0,No user reviews,0,0,0
917432,True,0,No user reviews,0,0,0
917440,True,0,No user reviews,0,0,0
917441,True,0,No user reviews,0,0,0
917442,True,0,No user reviews,0,0,0
917443,True,0,No user reviews,0,0,0
917444,True,0,No user reviews,0,0,0
917445,True,0,No user reviews,0,0,0
917446,True,0,No user reviews,0,0,0
917447,True,0,No user reviews,0,0,0
917448,True,0,No user reviews,0,0,0
917449,True,0,No user reviews,0,0,0
917450,True,0,No user reviews,0,0,0
917451,True,0,No user reviews,0,0,0
917452,True,0,No user reviews,0,0,0
917453,True,0,No user reviews,0,0,0
917454,True,0,No user reviews,0,0,0
917455,True,0,No user reviews,0,0,0
917456,True,0,No user reviews,0,0,0
917457,True,0,No user reviews,0,0,0
917458,True,0,No user reviews,0,0,0
917459,True,0,No user reviews,0,0,0
917460,True,0,No user reviews,0,0,0
917461,True,0,No user reviews,0,0,0
917462,True,0,No user reviews,0,0,0
917463,True,0,No user reviews,0,0,0
917470,True,0,No user reviews,0,0,0
917490,True,0,No user reviews,0,0,0
917500,True,0,1 user reviews,1,0,1
917510,True,0,No user reviews,0,0,0
917511,True,0,No user reviews,0,0,0
917512,True,0,No user reviews,0,0,0
917513,True,0,No user reviews,0,0,0
917514,True,0,No user reviews,0,0,0
917515,True,0,No user reviews,0,0,0
917516,True,0,No user reviews,0,0,0
917517,True,0,No user reviews,0,0,0
917518,True,0,No user reviews,0,0,0
917519,True,0,No user reviews,0,0,0
917520,True,0,No user reviews,0,0,0
917521,True,0,No user reviews,0,0,0
917530,True,0,No user reviews,0,0,0
917531,True,0,No user reviews,0,0,0
917532,True,0,No user reviews,0,0,0
917533,True,0,No user reviews,0,0,0
917534,True,0,No user reviews,0,0,0
917535,True,0,No user reviews,0,0,0
917536,True,0,No user reviews,0,0,0
917537,True,0,No user reviews,0,0,0
917538,True,0,No user reviews,0,0,0
917539,True,0,No user reviews,0,0,0
917540,True,0,No user reviews,0,0,0
917541,True,0,No user reviews,0,0,0
917550,True,0,No user reviews,0,0,0
917590,True,0,No user reviews,0,0,0
917600,True,0,4 user reviews,1,3,4
917610,True,0,No user reviews,0,0,0
917630,True,0,No user reviews,0,0,0
917640,True,0,No user reviews,0,0,0
917680,True,0,No user reviews,0,0,0
917690,True,7,Positive,12,0,12
917710,True,0,No user reviews,0,0,0
917720,True,0,No user reviews,0,0,0
917740,True,8,Very Positive,60,9,69
917760,True,0,No user reviews,0,0,0
917770,True,0,1 user reviews,1,0,1
917780,True,0,No user reviews,0,0,0
917800,True,0,1 user reviews,0,1,1
917810,True,0,1 user reviews,1,0,1
917820,True,0,No user reviews,0,0,0
917830,True,0,9 user reviews,7,2,9
917840,True,8,Very Positive,128,5,133
917850,True,6,Mostly Positive,7,3,10
917870,True,0,1 user reviews,1,0,1
917880,True,0,No user reviews,0,0,0
917890,True,0,1 user reviews,0,1,1
917900,True,0,1 user reviews,1,0,1
917910,True,0,5 user reviews,4,1,5
917920,True,8,Very Positive,42,9,51
917930,True,0,No user reviews,0,0,0
917940,True,0,No user reviews,0,0,0
917970,True,0,No user reviews,0,0,0
917990,True,0,No user reviews,0,0,0
918000,True,0,No user reviews,0,0,0
918060,True,0,6 user reviews,3,3,6
918070,True,6,Mostly Positive,19,7,26
918080,True,0,9 user reviews,5,4,9
918100,True,0,No user reviews,0,0,0
918110,True,0,5 user reviews,5,0,5
918150,True,0,No user reviews,0,0,0
918151,True,0,No user reviews,0,0,0
918160,True,0,No user reviews,0,0,0
918170,True,0,No user reviews,0,0,0
918180,True,0,8 user reviews,7,1,8
918190,True,0,No user reviews,0,0,0
918200,True,0,No user reviews,0,0,0
918210,True,0,No user reviews,0,0,0
918260,True,0,3 user reviews,2,1,3
918270,True,0,No user reviews,0,0,0
918290,True,0,No user reviews,0,0,0
918300,True,0,1 user reviews,1,0,1
918310,True,0,No user reviews,0,0,0
918320,True,0,4 user reviews,2,2,4
918330,True,0,No user reviews,0,0,0
918331,True,0,No user reviews,0,0,0
918332,True,0,No user reviews,0,0,0
918333,True,0,No user reviews,0,0,0
918334,True,0,No user reviews,0,0,0
918335,True,0,No user reviews,0,0,0
918336,True,0,No user reviews,0,0,0
918337,True,0,No user reviews,0,0,0
918338,True,0,No user reviews,0,0,0
918339,True,0,No user reviews,0,0,0
918340,True,0,No user reviews,0,0,0
918341,True,0,No user reviews,0,0,0
918342,True,0,No user reviews,0,0,0
918343,True,0,No user reviews,0,0,0
918344,True,0,No user reviews,0,0,0
918345,True,0,No user reviews,0,0,0
918346,True,0,No user reviews,0,0,0
918347,True,0,No user reviews,0,0,0
918348,True,0,No user reviews,0,0,0
918349,True,0,No user reviews,0,0,0
918360,True,0,No user reviews,0,0,0
918380,True,8,Very Positive,98,8,106
918390,True,0,No user reviews,0,0,0
918400,True,0,No user reviews,0,0,0
918410,True,0,No user reviews,0,0,0
918420,True,0,No user reviews,0,0,0
918430,True,6,Mostly Positive,15,5,20
918440,True,0,1 user reviews,0,1,1
918450,True,0,1 user reviews,1,0,1
918460,True,0,No user reviews,0,0,0
918470,True,0,No user reviews,0,0,0
918480,True,0,No user reviews,0,0,0
918490,True,0,6 user reviews,6,0,6
918500,True,0,8 user reviews,7,1,8
918520,True,0,No user reviews,0,0,0
918530,True,8,Very Positive,88,7,95
918540,True,0,No user reviews,0,0,0
918550,True,0,No user reviews,0,0,0
918590,True,4,Mostly Negative,3,7,10
918610,True,0,1 user reviews,0,1,1
918620,True,0,1 user reviews,1,0,1
918640,True,0,No user reviews,0,0,0
918650,True,0,No user reviews,0,0,0
918660,True,0,No user reviews,0,0,0
918670,True,7,Positive,29,0,29
918680,True,0,5 user reviews,2,3,5
918690,True,0,2 user reviews,2,0,2
918700,True,0,1 user reviews,1,0,1
918710,True,0,No user reviews,0,0,0
918720,True,0,2 user reviews,0,2,2
918740,True,0,2 user reviews,2,0,2
918760,True,0,No user reviews,0,0,0
918770,True,0,No user reviews,0,0,0
918792,True,0,1 user reviews,1,0,1
918793,True,0,2 user reviews,1,1,2
918794,True,0,1 user reviews,1,0,1
918795,True,0,No user reviews,0,0,0
918800,True,0,No user reviews,0,0,0
918810,True,0,No user reviews,0,0,0
918820,True,8,Very Positive,293,20,313
918830,True,0,No user reviews,0,0,0
918850,True,0,No user reviews,0,0,0
918870,True,0,1 user reviews,0,1,1
918900,True,5,Mixed,5,6,11
918950,True,7,Positive,11,2,13
918970,True,3,Negative,3,14,17
918980,True,0,No user reviews,0,0,0
918990,True,6,Mostly Positive,26,7,33
919000,True,0,7 user reviews,6,1,7
919020,True,0,No user reviews,0,0,0
919021,True,0,No user reviews,0,0,0
919022,True,0,No user reviews,0,0,0
919023,True,0,No user reviews,0,0,0
919024,True,0,No user reviews,0,0,0
919025,True,0,No user reviews,0,0,0
919026,True,0,No user reviews,0,0,0
919027,True,0,No user reviews,0,0,0
919028,True,0,No user reviews,0,0,0
919029,True,0,No user reviews,0,0,0
919030,True,0,No user reviews,0,0,0
919031,True,0,No user reviews,0,0,0
919032,True,0,No user reviews,0,0,0
919040,True,0,1 user reviews,0,1,1
919050,True,0,6 user reviews,5,1,6
919051,True,0,2 user reviews,2,0,2
919070,True,0,1 user reviews,1,0,1
919080,True,0,No user reviews,0,0,0
919081,True,0,No user reviews,0,0,0
919082,True,0,No user reviews,0,0,0
919083,True,0,No user reviews,0,0,0
919084,True,0,No user reviews,0,0,0
919085,True,0,No user reviews,0,0,0
919086,True,0,No user reviews,0,0,0
919087,True,0,No user reviews,0,0,0
919088,True,0,No user reviews,0,0,0
919089,True,0,No user reviews,0,0,0
919090,True,0,No user reviews,0,0,0
919091,True,0,No user reviews,0,0,0
919092,True,0,No user reviews,0,0,0
919140,True,0,2 user reviews,1,1,2
919150,True,0,4 user reviews,3,1,4
919160,True,6,Mostly Positive,13,4,17
919170,True,0,No user reviews,0,0,0
919180,True,0,1 user reviews,1,0,1
919190,True,0,No user reviews,0,0,0
919200,True,0,8 user reviews,5,3,8
919210,True,0,No user reviews,0,0,0
919220,True,5,Mixed,26,15,41
919230,True,0,No user reviews,0,0,0
919240,True,0,1 user reviews,0,1,1
919260,True,8,Very Positive,64,11,75
919280,True,5,Mixed,132,100,232
919300,True,0,7 user reviews,5,2,7
919310,True,0,No user reviews,0,0,0
919320,True,0,8 user reviews,8,0,8
919330,True,0,No user reviews,0,0,0
919340,True,0,3 user reviews,3,0,3
919360,True,0,No user reviews,0,0,0
919370,True,6,Mostly Positive,169,47,216
919390,True,6,Mostly Positive,28,9,37
919400,True,0,2 user reviews,2,0,2
919410,True,6,Mostly Positive,28,8,36
919420,True,0,No user reviews,0,0,0
919440,True,0,No user reviews,0,0,0
919450,True,0,4 user reviews,4,0,4
919520,True,0,No user reviews,0,0,0
919560,True,5,Mixed,10,5,15
919610,True,0,No user reviews,0,0,0
919640,True,6,Mostly Positive,1339,377,1716
919670,True,0,No user reviews,0,0,0
919680,True,8,Very Positive,223,20,243
919690,True,0,4 user reviews,1,3,4
919700,True,0,No user reviews,0,0,0
919720,True,5,Mixed,7,4,11
919730,True,0,No user reviews,0,0,0
919740,True,0,No user reviews,0,0,0
919770,True,7,Positive,10,0,10
919890,True,0,4 user reviews,4,0,4
919990,True,0,No user reviews,0,0,0
920000,True,0,No user reviews,0,0,0
920070,True,0,No user reviews,0,0,0
920080,True,0,No user reviews,0,0,0
920090,True,0,No user reviews,0,0,0
920100,True,0,No user reviews,0,0,0
920110,True,0,No user reviews,0,0,0
920111,True,0,No user reviews,0,0,0
920112,True,0,No user reviews,0,0,0
920113,True,0,No user reviews,0,0,0
920114,True,0,No user reviews,0,0,0
920115,True,0,No user reviews,0,0,0
920116,True,0,No user reviews,0,0,0
920117,True,0,No user reviews,0,0,0
920118,True,0,No user reviews,0,0,0
920119,True,0,No user reviews,0,0,0
920120,True,0,No user reviews,0,0,0
920121,True,0,No user reviews,0,0,0
920122,True,0,No user reviews,0,0,0
920140,True,0,No user reviews,0,0,0
920141,True,0,No user reviews,0,0,0
920142,True,0,No user reviews,0,0,0
920143,True,0,No user reviews,0,0,0
920144,True,0,No user reviews,0,0,0
920145,True,0,No user reviews,0,0,0
920146,True,0,No user reviews,0,0,0
920147,True,0,No user reviews,0,0,0
920148,True,0,No user reviews,0,0,0
920149,True,0,No user reviews,0,0,0
920150,True,0,No user reviews,0,0,0
920151,True,0,No user reviews,0,0,0
920152,True,0,No user reviews,0,0,0
920190,True,0,No user reviews,0,0,0
920200,True,7,Positive,15,0,15
920280,True,0,3 user reviews,3,0,3
920320,True,8,Very Positive,199,15,214
920330,True,0,No user reviews,0,0,0
920331,True,0,No user reviews,0,0,0
920332,True,0,No user reviews,0,0,0
920333,True,0,No user reviews,0,0,0
920334,True,0,No user reviews,0,0,0
920335,True,0,No user reviews,0,0,0
920336,True,0,No user reviews,0,0,0
920337,True,0,No user reviews,0,0,0
920338,True,0,No user reviews,0,0,0
920339,True,0,No user reviews,0,0,0
920340,True,0,No user reviews,0,0,0
920341,True,0,No user reviews,0,0,0
920342,True,0,No user reviews,0,0,0
920350,True,0,2 user reviews,2,0,2
920351,True,0,No user reviews,0,0,0
920352,True,0,4 user reviews,4,0,4
920353,True,0,2 user reviews,2,0,2
920370,True,0,No user reviews,0,0,0
920371,True,0,No user reviews,0,0,0
920372,True,0,No user reviews,0,0,0
920373,True,0,No user reviews,0,0,0
920374,True,0,No user reviews,0,0,0
920375,True,0,No user reviews,0,0,0
920376,True,0,No user reviews,0,0,0
920377,True,0,No user reviews,0,0,0
920378,True,0,No user reviews,0,0,0
920379,True,0,No user reviews,0,0,0
920380,True,0,No user reviews,0,0,0
920381,True,0,No user reviews,0,0,0
920382,True,0,No user reviews,0,0,0
920390,True,0,No user reviews,0,0,0
920391,True,0,No user reviews,0,0,0
920392,True,0,No user reviews,0,0,0
920393,True,0,No user reviews,0,0,0
920394,True,0,No user reviews,0,0,0
920395,True,0,No user reviews,0,0,0
920396,True,0,No user reviews,0,0,0
920397,True,0,No user reviews,0,0,0
920398,True,0,No user reviews,0,0,0
920399,True,0,No user reviews,0,0,0
920400,True,0,No user reviews,0,0,0
920401,True,0,No user reviews,0,0,0
920410,True,0,No user reviews,0,0,0
920411,True,0,No user reviews,0,0,0
920412,True,0,No user reviews,0,0,0
920413,True,0,No user reviews,0,0,0
920414,True,0,No user reviews,0,0,0
920415,True,0,No user reviews,0,0,0
920416,True,0,No user reviews,0,0,0
920417,True,0,No user reviews,0,0,0
920418,True,0,No user reviews,0,0,0
920419,True,0,No user reviews,0,0,0
920420,True,0,No user reviews,0,0,0
920421,True,0,No user reviews,0,0,0
920422,True,0,No user reviews,0,0,0
920430,True,0,No user reviews,0,0,0
920450,True,0,No user reviews,0,0,0
920460,True,7,Positive,33,7,40
920470,True,0,No user reviews,0,0,0
920490,True,7,Positive,15,1,16
920500,True,0,No user reviews,0,0,0
920510,True,0,5 user reviews,4,1,5
920520,True,7,Positive,24,5,29
920530,True,0,2 user reviews,1,1,2
920560,True,7,Positive,22,1,23
920561,True,7,Positive,25,3,28
920562,True,6,Mostly Positive,18,7,25
920563,True,7,Positive,19,2,21
920564,True,7,Positive,48,1,49
920565,True,0,No user reviews,0,0,0
920566,True,0,No user reviews,0,0,0
920567,True,8,Very Positive,102,16,118
920568,True,7,Positive,33,8,41
920571,True,8,Very Positive,126,8,134
920580,True,0,No user reviews,0,0,0
920590,True,0,No user reviews,0,0,0
920591,True,0,No user reviews,0,0,0
920592,True,0,No user reviews,0,0,0
920593,True,0,No user reviews,0,0,0
920594,True,0,No user reviews,0,0,0
920595,True,0,No user reviews,0,0,0
920596,True,0,No user reviews,0,0,0
920597,True,0,No user reviews,0,0,0
920598,True,0,No user reviews,0,0,0
920601,True,0,No user reviews,0,0,0
920620,True,0,4 user reviews,3,1,4
920630,True,5,Mixed,16,11,27
920640,True,0,No user reviews,0,0,0
920650,True,0,No user reviews,0,0,0
920680,True,8,Very Positive,211,52,263
920690,True,5,Mixed,392,273,665
920700,True,0,1 user reviews,1,0,1
920710,True,0,2 user reviews,0,2,2
920730,True,0,No user reviews,0,0,0
920770,True,0,8 user reviews,7,1,8
920780,True,0,2 user reviews,1,1,2
920800,True,0,1 user reviews,1,0,1
920820,True,0,1 user reviews,0,1,1
920840,True,5,Mixed,45,46,91
920870,True,0,2 user reviews,2,0,2
920880,True,0,1 user reviews,1,0,1
920890,True,0,1 user reviews,1,0,1
920891,True,0,No user reviews,0,0,0
920892,True,0,No user reviews,0,0,0
920893,True,0,No user reviews,0,0,0
920894,True,0,No user reviews,0,0,0
920895,True,0,No user reviews,0,0,0
920896,True,0,No user reviews,0,0,0
920897,True,0,No user reviews,0,0,0
920898,True,0,No user reviews,0,0,0
920899,True,0,No user reviews,0,0,0
920900,True,0,No user reviews,0,0,0
920901,True,0,No user reviews,0,0,0
920930,True,0,1 user reviews,1,0,1
920931,True,0,No user reviews,0,0,0
920932,True,0,No user reviews,0,0,0
920933,True,0,No user reviews,0,0,0
920934,True,0,No user reviews,0,0,0
920935,True,0,No user reviews,0,0,0
920936,True,0,No user reviews,0,0,0
920937,True,0,No user reviews,0,0,0
920938,True,0,No user reviews,0,0,0
920939,True,0,No user reviews,0,0,0
920940,True,0,No user reviews,0,0,0
920941,True,0,No user reviews,0,0,0
920960,True,0,7 user reviews,4,3,7
921010,True,0,No user reviews,0,0,0
921050,True,0,1 user reviews,0,1,1
921060,True,0,No user reviews,0,0,0
921070,True,0,No user reviews,0,0,0
921090,True,0,No user reviews,0,0,0
921120,True,0,No user reviews,0,0,0
921130,True,0,No user reviews,0,0,0
921140,True,0,No user reviews,0,0,0
921150,True,0,No user reviews,0,0,0
921160,True,0,No user reviews,0,0,0
921180,True,0,No user reviews,0,0,0
921190,True,0,No user reviews,0,0,0
921230,True,0,No user reviews,0,0,0
921240,True,0,No user reviews,0,0,0
921250,True,0,No user reviews,0,0,0
921260,True,0,No user reviews,0,0,0
921290,True,0,No user reviews,0,0,0
921300,True,0,No user reviews,0,0,0
921310,True,0,No user reviews,0,0,0
921330,True,0,No user reviews,0,0,0
921340,True,0,No user reviews,0,0,0
921360,True,0,No user reviews,0,0,0
921370,True,0,No user reviews,0,0,0
921390,True,6,Mostly Positive,30,12,42
921410,True,0,No user reviews,0,0,0
921420,True,0,2 user reviews,2,0,2
921430,True,7,Positive,33,1,34
921450,True,0,3 user reviews,2,1,3
921460,True,0,No user reviews,0,0,0
921480,True,0,No user reviews,0,0,0
921481,True,0,1 user reviews,1,0,1
921482,True,0,2 user reviews,2,0,2
921483,True,0,No user reviews,0,0,0
921484,True,0,No user reviews,0,0,0
921485,True,0,No user reviews,0,0,0
921486,True,0,No user reviews,0,0,0
921487,True,0,No user reviews,0,0,0
921488,True,0,No user reviews,0,0,0
921489,True,0,No user reviews,0,0,0
921500,True,5,Mixed,6,4,10
921520,True,0,4 user reviews,3,1,4
921530,True,5,Mixed,34,19,53
921540,True,0,7 user reviews,6,1,7
921541,True,0,No user reviews,0,0,0
921542,True,0,4 user reviews,4,0,4
921543,True,0,No user reviews,0,0,0
921550,True,0,No user reviews,0,0,0
921570,True,8,Very Positive,1272,190,1462
921590,True,5,Mixed,174,113,287
921610,True,0,No user reviews,0,0,0
921620,True,0,No user reviews,0,0,0
921630,True,8,Very Positive,209,36,245
921650,True,0,No user reviews,0,0,0
921660,True,0,1 user reviews,1,0,1
921670,True,0,No user reviews,0,0,0
921680,True,0,No user reviews,0,0,0
921690,True,0,No user reviews,0,0,0
921700,True,0,No user reviews,0,0,0
921710,True,6,Mostly Positive,149,41,190
921720,True,0,No user reviews,0,0,0
921730,True,0,4 user reviews,3,1,4
921740,True,0,2 user reviews,2,0,2
921760,True,0,No user reviews,0,0,0
921770,True,5,Mixed,6,4,10
921780,True,5,Mixed,142,78,220
921790,True,0,No user reviews,0,0,0
921800,True,6,Mostly Positive,275,81,356
921810,True,0,No user reviews,0,0,0
921830,True,0,No user reviews,0,0,0
921840,True,0,No user reviews,0,0,0
921850,True,0,No user reviews,0,0,0
921870,True,0,3 user reviews,2,1,3
921890,True,0,2 user reviews,2,0,2
921900,True,7,Positive,43,6,49
921920,True,0,No user reviews,0,0,0
921940,True,0,No user reviews,0,0,0
921950,True,5,Mixed,101,96,197
921960,True,0,1 user reviews,0,1,1
921970,True,4,Mostly Negative,9,30,39
922020,True,0,4 user reviews,4,0,4
922040,True,6,Mostly Positive,19,5,24
922060,True,0,No user reviews,0,0,0
922090,True,0,No user reviews,0,0,0
922100,True,8,Very Positive,138,5,143
922130,True,0,2 user reviews,1,1,2
922140,True,6,Mostly Positive,15,5,20
922150,True,6,Mostly Positive,16,5,21
922160,True,0,No user reviews,0,0,0
922170,True,0,1 user reviews,1,0,1
922200,True,0,No user reviews,0,0,0
922220,True,0,2 user reviews,1,1,2
922230,True,0,No user reviews,0,0,0
922250,True,7,Positive,11,1,12
922260,True,0,No user reviews,0,0,0
922280,True,0,No user reviews,0,0,0
922290,True,7,Positive,15,1,16
922300,True,0,No user reviews,0,0,0
922310,True,0,No user reviews,0,0,0
922311,True,0,No user reviews,0,0,0
922312,True,0,No user reviews,0,0,0
922313,True,0,No user reviews,0,0,0
922320,True,0,No user reviews,0,0,0
922400,True,8,Very Positive,145,4,149
922410,True,0,6 user reviews,4,2,6
922420,True,0,No user reviews,0,0,0
922430,True,7,Positive,16,0,16
922450,True,0,No user reviews,0,0,0
922460,True,0,No user reviews,0,0,0
922470,True,7,Positive,12,0,12
922480,True,0,No user reviews,0,0,0
922500,True,5,Mixed,139,64,203
922510,True,0,3 user reviews,3,0,3
922520,True,0,1 user reviews,1,0,1
922530,True,7,Positive,11,2,13
922540,True,0,No user reviews,0,0,0
922550,True,6,Mostly Positive,9,3,12
922560,True,0,No user reviews,0,0,0
922580,True,0,1 user reviews,1,0,1
922581,True,0,No user reviews,0,0,0
922590,True,0,1 user reviews,0,1,1
922600,True,0,No user reviews,0,0,0
922610,True,0,No user reviews,0,0,0
922620,True,0,No user reviews,0,0,0
922630,True,0,No user reviews,0,0,0
922640,True,0,No user reviews,0,0,0
922650,True,0,4 user reviews,4,0,4
922660,True,5,Mixed,17,8,25
922670,True,0,9 user reviews,5,4,9
922700,True,7,Positive,19,0,19
922710,True,7,Positive,41,6,47
922740,True,0,No user reviews,0,0,0
922741,True,0,No user reviews,0,0,0
922750,True,0,No user reviews,0,0,0
922800,True,4,Mostly Negative,5,14,19
922810,True,0,6 user reviews,4,2,6
922870,True,0,No user reviews,0,0,0
922880,True,0,No user reviews,0,0,0
922920,True,6,Mostly Positive,15,4,19
922940,True,0,No user reviews,0,0,0
922970,True,0,No user reviews,0,0,0
922971,True,0,No user reviews,0,0,0
922972,True,0,No user reviews,0,0,0
922973,True,0,No user reviews,0,0,0
923010,True,0,No user reviews,0,0,0
923030,True,0,No user reviews,0,0,0
923050,True,0,1 user reviews,1,0,1
923080,True,0,2 user reviews,2,0,2
923100,True,0,No user reviews,0,0,0
923110,True,0,No user reviews,0,0,0
923120,True,0,No user reviews,0,0,0
923130,True,0,No user reviews,0,0,0
923140,True,0,No user reviews,0,0,0
923151,True,0,No user reviews,0,0,0
923152,True,0,No user reviews,0,0,0
923180,True,0,No user reviews,0,0,0
923220,True,0,No user reviews,0,0,0
923230,True,0,6 user reviews,5,1,6
923240,True,0,1 user reviews,0,1,1
923250,True,0,No user reviews,0,0,0
923260,True,8,Very Positive,65,4,69
923270,True,0,3 user reviews,0,3,3
923280,True,0,No user reviews,0,0,0
923290,True,0,1 user reviews,1,0,1
923300,True,0,No user reviews,0,0,0
923310,True,0,1 user reviews,1,0,1
923340,True,0,No user reviews,0,0,0
923350,True,0,1 user reviews,0,1,1
923360,True,0,No user reviews,0,0,0
923370,True,0,8 user reviews,8,0,8
923380,True,0,3 user reviews,3,0,3
923390,True,0,No user reviews,0,0,0
923400,True,0,No user reviews,0,0,0
923420,True,7,Positive,14,2,16
923430,True,0,No user reviews,0,0,0
923460,True,0,No user reviews,0,0,0
923470,True,8,Very Positive,103,20,123
923480,True,0,3 user reviews,3,0,3
923500,True,0,No user reviews,0,0,0
923510,True,0,No user reviews,0,0,0
923530,True,0,6 user reviews,2,4,6
923540,True,0,No user reviews,0,0,0
923550,True,0,3 user reviews,3,0,3
923560,True,0,No user reviews,0,0,0
923570,True,8,Very Positive,59,3,62
923580,True,0,No user reviews,0,0,0
923590,True,5,Mixed,14,20,34
923600,True,0,No user reviews,0,0,0
923610,True,0,No user reviews,0,0,0
923620,True,0,No user reviews,0,0,0
923630,True,0,5 user reviews,4,1,5
923640,True,0,No user reviews,0,0,0
923650,True,0,3 user reviews,3,0,3
923670,True,0,7 user reviews,7,0,7
923690,True,4,Mostly Negative,3,8,11
923710,True,6,Mostly Positive,28,10,38
923720,True,0,1 user reviews,1,0,1
923730,True,0,4 user reviews,3,1,4
923750,True,0,No user reviews,0,0,0
923760,True,0,No user reviews,0,0,0
923780,True,0,No user reviews,0,0,0
923790,True,0,2 user reviews,1,1,2
923800,True,0,No user reviews,0,0,0
923810,True,8,Very Positive,75,8,83
923820,True,0,No user reviews,0,0,0
923830,True,0,No user reviews,0,0,0
923840,True,0,1 user reviews,1,0,1
923850,True,0,No user reviews,0,0,0
923851,True,0,No user reviews,0,0,0
923880,True,0,2 user reviews,1,1,2
923890,True,5,Mixed,20,15,35
923900,True,0,5 user reviews,5,0,5
923910,True,7,Positive,10,0,10
923920,True,0,No user reviews,0,0,0
923930,True,0,No user reviews,0,0,0
923970,True,4,Mostly Negative,24,41,65
924020,True,3,Negative,5,26,31
924040,True,0,5 user reviews,2,3,5
924050,True,0,No user reviews,0,0,0
924051,True,0,1 user reviews,1,0,1
924070,True,6,Mostly Positive,40,16,56
924080,True,0,No user reviews,0,0,0
924090,True,0,6 user reviews,3,3,6
924100,True,5,Mixed,6,7,13
924110,True,0,5 user reviews,1,4,5
924120,True,0,No user reviews,0,0,0
924130,True,0,No user reviews,0,0,0
924140,True,8,Very Positive,1030,170,1200
924150,True,0,5 user reviews,4,1,5
924151,True,0,4 user reviews,4,0,4
924160,True,0,No user reviews,0,0,0
924170,True,0,No user reviews,0,0,0
924180,True,0,No user reviews,0,0,0
924181,True,5,Mixed,7,8,15
924182,True,0,No user reviews,0,0,0
924183,True,0,4 user reviews,2,2,4
924184,True,0,No user reviews,0,0,0
924185,True,0,3 user reviews,2,1,3
924190,True,0,No user reviews,0,0,0
924200,True,0,No user reviews,0,0,0
924210,True,0,1 user reviews,1,0,1
924220,True,8,Very Positive,73,14,87
924230,True,0,No user reviews,0,0,0
924240,True,0,No user reviews,0,0,0
924250,True,6,Mostly Positive,27,11,38
924280,True,0,5 user reviews,5,0,5
924310,True,6,Mostly Positive,8,3,11
924330,True,0,4 user reviews,4,0,4
924331,True,0,2 user reviews,2,0,2
924332,True,0,1 user reviews,1,0,1
924340,True,0,No user reviews,0,0,0
924360,True,0,No user reviews,0,0,0
924370,True,0,8 user reviews,3,5,8
924380,True,0,No user reviews,0,0,0
924390,True,0,2 user reviews,0,2,2
924430,True,0,No user reviews,0,0,0
924450,True,0,No user reviews,0,0,0
924460,True,0,2 user reviews,1,1,2
924470,True,0,No user reviews,0,0,0
924471,True,0,No user reviews,0,0,0
924472,True,0,No user reviews,0,0,0
924473,True,0,No user reviews,0,0,0
924474,True,0,No user reviews,0,0,0
924475,True,0,No user reviews,0,0,0
924476,True,0,No user reviews,0,0,0
924477,True,0,No user reviews,0,0,0
924478,True,0,No user reviews,0,0,0
924479,True,0,No user reviews,0,0,0
924480,True,0,No user reviews,0,0,0
924481,True,0,No user reviews,0,0,0
924482,True,0,No user reviews,0,0,0
924483,True,0,No user reviews,0,0,0
924490,True,0,1 user reviews,1,0,1
924500,True,0,1 user reviews,0,1,1
924520,True,0,1 user reviews,1,0,1
924560,True,0,2 user reviews,2,0,2
924650,True,7,Positive,39,5,44
924660,True,0,No user reviews,0,0,0
924670,True,5,Mixed,6,8,14
924690,True,0,No user reviews,0,0,0
924730,True,0,No user reviews,0,0,0
924740,True,0,4 user reviews,1,3,4
924750,True,0,No user reviews,0,0,0
924770,True,0,2 user reviews,2,0,2
924780,True,7,Positive,10,0,10
924790,True,0,4 user reviews,4,0,4
924800,True,6,Mostly Positive,14,4,18
924810,True,0,No user reviews,0,0,0
924830,True,0,No user reviews,0,0,0
924840,True,0,No user reviews,0,0,0
924841,True,0,No user reviews,0,0,0
924870,True,0,6 user reviews,5,1,6
924900,True,7,Positive,19,1,20
924920,True,0,No user reviews,0,0,0
924930,True,0,No user reviews,0,0,0
924940,True,7,Positive,14,0,14
924950,True,0,No user reviews,0,0,0
924960,True,0,2 user reviews,1,1,2
924980,True,8,Very Positive,1100,60,1160
925000,True,0,No user reviews,0,0,0
925010,True,0,No user reviews,0,0,0
925020,True,0,No user reviews,0,0,0
925040,True,0,8 user reviews,6,2,8
925050,True,0,1 user reviews,1,0,1
925060,True,0,3 user reviews,3,0,3
925070,True,0,2 user reviews,1,1,2
925090,True,0,4 user reviews,3,1,4
925100,True,6,Mostly Positive,179,47,226
925102,True,0,No user reviews,0,0,0
925110,True,0,8 user reviews,5,3,8
925120,True,0,No user reviews,0,0,0
925160,True,0,No user reviews,0,0,0
925170,True,7,Positive,14,2,16
925180,True,0,1 user reviews,1,0,1
925190,True,0,4 user reviews,3,1,4
925191,True,0,2 user reviews,2,0,2
925280,True,0,1 user reviews,1,0,1
925290,True,0,No user reviews,0,0,0
925300,True,0,No user reviews,0,0,0
925310,True,0,No user reviews,0,0,0
925330,True,0,No user reviews,0,0,0
925340,True,7,Positive,19,0,19
925360,True,0,3 user reviews,2,1,3
925370,True,0,3 user reviews,3,0,3
925380,True,0,No user reviews,0,0,0
925390,True,0,No user reviews,0,0,0
925400,True,0,No user reviews,0,0,0
925410,True,0,No user reviews,0,0,0
925420,True,0,No user reviews,0,0,0
925440,True,7,Positive,32,3,35
925460,True,8,Very Positive,85,3,88
925470,True,5,Mixed,18,8,26
925490,True,0,9 user reviews,8,1,9
925520,True,8,Very Positive,50,7,57
925540,True,0,1 user reviews,0,1,1
925550,True,7,Positive,21,1,22
925560,True,0,No user reviews,0,0,0
925570,True,5,Mixed,40,32,72
925580,True,8,Very Positive,320,27,347
925590,True,0,No user reviews,0,0,0
925600,True,0,1 user reviews,0,1,1
925610,True,0,1 user reviews,0,1,1
925620,True,0,No user reviews,0,0,0
925621,True,0,No user reviews,0,0,0
925640,True,0,No user reviews,0,0,0
925650,True,7,Positive,23,0,23
925660,True,0,2 user reviews,2,0,2
925670,True,3,Negative,1,10,11
925680,True,0,No user reviews,0,0,0
925690,True,0,4 user reviews,3,1,4
925700,True,0,1 user reviews,0,1,1
925720,True,0,No user reviews,0,0,0
925740,True,0,No user reviews,0,0,0
925750,True,8,Very Positive,167,41,208
925760,True,0,2 user reviews,2,0,2
925810,True,0,No user reviews,0,0,0
925820,True,0,No user reviews,0,0,0
925821,True,0,No user reviews,0,0,0
925822,True,0,No user reviews,0,0,0
925823,True,0,No user reviews,0,0,0
925824,True,0,No user reviews,0,0,0
925825,True,0,1 user reviews,1,0,1
925826,True,0,4 user reviews,4,0,4
925827,True,0,6 user reviews,2,4,6
925828,True,0,No user reviews,0,0,0
925829,True,0,No user reviews,0,0,0
925830,True,0,No user reviews,0,0,0
925850,True,0,No user reviews,0,0,0
925851,True,0,No user reviews,0,0,0
925852,True,0,No user reviews,0,0,0
925853,True,0,No user reviews,0,0,0
925854,True,0,No user reviews,0,0,0
925855,True,0,No user reviews,0,0,0
925856,True,0,No user reviews,0,0,0
925858,True,0,No user reviews,0,0,0
925859,True,0,No user reviews,0,0,0
925860,True,0,No user reviews,0,0,0
925861,True,0,No user reviews,0,0,0
925862,True,0,No user reviews,0,0,0
925863,True,0,1 user reviews,1,0,1
925864,True,0,No user reviews,0,0,0
925865,True,0,No user reviews,0,0,0
925866,True,0,No user reviews,0,0,0
925867,True,0,No user reviews,0,0,0
925868,True,0,No user reviews,0,0,0
925869,True,0,No user reviews,0,0,0
925870,True,0,No user reviews,0,0,0
925871,True,0,No user reviews,0,0,0
925880,True,0,6 user reviews,3,3,6
925900,True,0,No user reviews,0,0,0
925910,True,5,Mixed,6,4,10
925930,True,8,Very Positive,74,3,77
925940,True,5,Mixed,37,18,55
925970,True,0,No user reviews,0,0,0
925980,True,0,No user reviews,0,0,0
926010,True,5,Mixed,10,10,20
926020,True,7,Positive,24,0,24
926050,True,0,No user reviews,0,0,0
926070,True,0,1 user reviews,1,0,1
926080,True,0,No user reviews,0,0,0
926090,True,0,4 user reviews,3,1,4
926100,True,0,3 user reviews,3,0,3
926110,True,0,2 user reviews,2,0,2
926120,True,0,3 user reviews,3,0,3
926130,True,0,2 user reviews,0,2,2
926140,True,8,Very Positive,628,52,680
926170,True,7,Positive,12,2,14
926180,True,5,Mixed,17,10,27
926210,True,0,7 user reviews,6,1,7
926220,True,0,No user reviews,0,0,0
926240,True,0,1 user reviews,1,0,1
926250,True,0,7 user reviews,7,0,7
926310,True,0,1 user reviews,1,0,1
926320,True,0,No user reviews,0,0,0
926340,True,7,Positive,33,1,34
926350,True,0,3 user reviews,3,0,3
926370,True,0,4 user reviews,2,2,4
926390,True,7,Positive,22,5,27
926400,True,0,5 user reviews,4,1,5
926410,True,0,6 user reviews,3,3,6
926420,True,0,No user reviews,0,0,0
926440,True,0,No user reviews,0,0,0
926450,True,0,5 user reviews,5,0,5
926460,True,0,No user reviews,0,0,0
926470,True,0,9 user reviews,7,2,9
926480,True,0,1 user reviews,0,1,1
926490,True,0,1 user reviews,1,0,1
926510,True,0,No user reviews,0,0,0
926520,True,7,Positive,40,4,44
926540,True,5,Mixed,46,28,74
926560,True,0,No user reviews,0,0,0
926561,True,0,No user reviews,0,0,0
926562,True,0,No user reviews,0,0,0
926580,True,6,Mostly Positive,177,46,223
926590,True,0,1 user reviews,1,0,1
926600,True,0,No user reviews,0,0,0
926610,True,0,3 user reviews,3,0,3
926650,True,0,7 user reviews,6,1,7
926660,True,0,No user reviews,0,0,0
926670,True,0,No user reviews,0,0,0
926720,True,0,No user reviews,0,0,0
926730,True,4,Mostly Negative,7,15,22
926800,True,0,6 user reviews,6,0,6
926810,True,4,Mostly Negative,6,11,17
926820,True,0,5 user reviews,5,0,5
926830,True,0,No user reviews,0,0,0
926850,True,0,No user reviews,0,0,0
926860,True,8,Very Positive,106,7,113
926870,True,0,No user reviews,0,0,0
926890,True,0,No user reviews,0,0,0
926920,True,0,No user reviews,0,0,0
926940,True,0,No user reviews,0,0,0
926960,True,0,No user reviews,0,0,0
926970,True,0,No user reviews,0,0,0
926980,True,0,No user reviews,0,0,0
926990,True,9,Overwhelmingly Positive,1033,50,1083
927020,True,0,No user reviews,0,0,0
927030,True,0,No user reviews,0,0,0
927040,True,0,No user reviews,0,0,0
927050,True,0,No user reviews,0,0,0
927070,True,0,No user reviews,0,0,0
927080,True,0,3 user reviews,3,0,3
927090,True,0,No user reviews,0,0,0
927100,True,0,No user reviews,0,0,0
927110,True,0,No user reviews,0,0,0
927120,True,0,No user reviews,0,0,0
927140,True,0,No user reviews,0,0,0
927150,True,0,No user reviews,0,0,0
927180,True,0,No user reviews,0,0,0
927190,True,0,7 user reviews,5,2,7
927210,True,0,No user reviews,0,0,0
927240,True,0,3 user reviews,2,1,3
927250,True,8,Very Positive,263,26,289
927270,True,8,Very Positive,362,89,451
927310,True,0,4 user reviews,3,1,4
927330,True,0,No user reviews,0,0,0
927340,True,0,1 user reviews,1,0,1
927350,True,0,No user reviews,0,0,0
927370,True,0,2 user reviews,2,0,2
927380,True,9,Overwhelmingly Positive,2248,61,2309
927460,True,0,No user reviews,0,0,0
927470,True,0,No user reviews,0,0,0
927480,True,0,No user reviews,0,0,0
927490,True,0,No user reviews,0,0,0
927580,True,0,2 user reviews,1,1,2
927590,True,0,No user reviews,0,0,0
927660,True,0,No user reviews,0,0,0
927670,True,0,No user reviews,0,0,0
927700,True,0,No user reviews,0,0,0
927720,True,0,No user reviews,0,0,0
927730,True,6,Mostly Positive,42,18,60
927740,True,0,No user reviews,0,0,0
927760,True,0,No user reviews,0,0,0
927780,True,0,No user reviews,0,0,0
927800,True,0,No user reviews,0,0,0
927820,True,0,No user reviews,0,0,0
927840,True,6,Mostly Positive,11,4,15
927850,True,0,No user reviews,0,0,0
927860,True,0,No user reviews,0,0,0
927870,True,0,No user reviews,0,0,0
927880,True,0,No user reviews,0,0,0
927890,True,8,Very Positive,519,39,558
927900,True,0,No user reviews,0,0,0
927920,True,0,No user reviews,0,0,0
927930,True,6,Mostly Positive,12,4,16
927940,True,0,No user reviews,0,0,0
927970,True,0,No user reviews,0,0,0
927990,True,0,No user reviews,0,0,0
928000,True,0,No user reviews,0,0,0
928020,True,0,No user reviews,0,0,0
928050,True,0,No user reviews,0,0,0
928060,True,4,Mostly Negative,8,16,24
928070,True,0,9 user reviews,1,8,9
928080,True,0,No user reviews,0,0,0
928090,True,0,No user reviews,0,0,0
928100,True,7,Positive,26,2,28
928110,True,0,No user reviews,0,0,0
928130,True,0,No user reviews,0,0,0
928140,True,0,3 user reviews,2,1,3
928160,True,0,4 user reviews,4,0,4
928170,True,5,Mixed,8,9,17
928180,True,6,Mostly Positive,11,4,15
928190,True,0,No user reviews,0,0,0
928210,True,0,2 user reviews,1,1,2
928220,True,0,No user reviews,0,0,0
928230,True,0,4 user reviews,3,1,4
928240,True,0,No user reviews,0,0,0
928290,True,0,1 user reviews,0,1,1
928300,True,7,Positive,31,2,33
928340,True,0,No user reviews,0,0,0
928350,True,0,3 user reviews,3,0,3
928370,True,0,5 user reviews,5,0,5
928380,True,0,No user reviews,0,0,0
928390,True,8,Very Positive,63,8,71
928410,True,0,3 user reviews,1,2,3
928420,True,0,No user reviews,0,0,0
928440,True,7,Positive,13,3,16
928460,True,4,Mostly Negative,3,7,10
928480,True,0,9 user reviews,9,0,9
928500,True,0,No user reviews,0,0,0
928520,True,6,Mostly Positive,39,11,50
928530,True,0,No user reviews,0,0,0
928540,True,0,No user reviews,0,0,0
928550,True,0,No user reviews,0,0,0
928560,True,0,No user reviews,0,0,0
928570,True,0,No user reviews,0,0,0
928580,True,0,No user reviews,0,0,0
928600,True,8,Very Positive,3926,389,4315
928610,True,4,Mostly Negative,5,9,14
928660,True,0,7 user reviews,7,0,7
928670,True,7,Positive,11,1,12
928680,True,0,9 user reviews,9,0,9
928690,True,0,No user reviews,0,0,0
928770,True,0,No user reviews,0,0,0
928771,True,0,No user reviews,0,0,0
928830,True,0,5 user reviews,4,1,5
928840,True,5,Mixed,16,8,24
928860,True,0,No user reviews,0,0,0
928870,True,0,No user reviews,0,0,0
928880,True,4,Mostly Negative,5,12,17
928920,True,0,No user reviews,0,0,0
928940,True,0,No user reviews,0,0,0
928950,True,0,No user reviews,0,0,0
928970,True,0,8 user reviews,8,0,8
928980,True,0,No user reviews,0,0,0
928990,True,0,No user reviews,0,0,0
929010,True,5,Mixed,349,415,764
929020,True,0,No user reviews,0,0,0
929030,True,0,7 user reviews,3,4,7
929060,True,5,Mixed,52,24,76
929070,True,0,No user reviews,0,0,0
929080,True,0,1 user reviews,0,1,1
929090,True,0,No user reviews,0,0,0
929100,True,8,Very Positive,62,9,71
929101,True,7,Positive,44,2,46
929102,True,7,Positive,47,2,49
929103,True,7,Positive,20,1,21
929104,True,0,No user reviews,0,0,0
929105,True,0,No user reviews,0,0,0
929106,True,8,Very Positive,49,11,60
929111,True,0,No user reviews,0,0,0
929120,True,0,6 user reviews,5,1,6
929130,True,0,No user reviews,0,0,0
929140,True,7,Positive,18,2,20
929150,True,0,1 user reviews,0,1,1
929160,True,0,2 user reviews,2,0,2
929170,True,0,6 user reviews,5,1,6
929180,True,0,1 user reviews,1,0,1
929190,True,0,No user reviews,0,0,0
929191,True,0,No user reviews,0,0,0
929192,True,0,1 user reviews,0,1,1
929193,True,0,No user reviews,0,0,0
929200,True,0,6 user reviews,1,5,6
929210,True,0,1 user reviews,0,1,1
929230,True,0,6 user reviews,5,1,6
929270,True,6,Mostly Positive,36,13,49
929280,True,0,No user reviews,0,0,0
929290,True,0,9 user reviews,4,5,9
929300,True,6,Mostly Positive,18,7,25
929310,True,0,9 user reviews,8,1,9
929320,True,7,Positive,12,0,12
929330,True,0,5 user reviews,3,2,5
929350,True,0,3 user reviews,3,0,3
929360,True,0,2 user reviews,2,0,2
929390,True,0,No user reviews,0,0,0
929400,True,0,1 user reviews,1,0,1
929410,True,0,1 user reviews,1,0,1
929420,True,0,2 user reviews,2,0,2
929430,True,0,8 user reviews,5,3,8
929440,True,0,2 user reviews,2,0,2
929450,True,0,No user reviews,0,0,0
929460,True,0,No user reviews,0,0,0
929470,True,0,1 user reviews,1,0,1
929480,True,0,6 user reviews,5,1,6
929490,True,0,No user reviews,0,0,0
929510,True,0,4 user reviews,2,2,4
929520,True,0,No user reviews,0,0,0
929530,True,0,1 user reviews,0,1,1
929540,True,0,No user reviews,0,0,0
929550,True,0,3 user reviews,2,1,3
929570,True,0,2 user reviews,1,1,2
929600,True,6,Mostly Positive,8,3,11
929610,True,0,1 user reviews,0,1,1
929630,True,0,No user reviews,0,0,0
929640,True,0,3 user reviews,3,0,3
929660,True,0,No user reviews,0,0,0
929670,True,6,Mostly Positive,12,4,16
929680,True,7,Positive,9,1,10
929690,True,0,No user reviews,0,0,0
929720,True,0,No user reviews,0,0,0
929740,True,0,No user reviews,0,0,0
929800,True,0,2 user reviews,1,1,2
929820,True,0,No user reviews,0,0,0
929830,True,0,No user reviews,0,0,0
929850,True,0,8 user reviews,8,0,8
929860,True,0,No user reviews,0,0,0
929880,True,0,1 user reviews,0,1,1
929910,True,7,Positive,10,0,10
930010,True,0,1 user reviews,1,0,1
930020,True,0,4 user reviews,3,1,4
930030,True,0,1 user reviews,0,1,1
930100,True,0,7 user reviews,7,0,7
930110,True,0,No user reviews,0,0,0
930130,True,0,No user reviews,0,0,0
930150,True,0,No user reviews,0,0,0
930180,True,0,No user reviews,0,0,0
930200,True,0,6 user reviews,6,0,6
930220,True,0,No user reviews,0,0,0
930230,True,0,No user reviews,0,0,0
930240,True,0,No user reviews,0,0,0
930250,True,0,No user reviews,0,0,0
930260,True,0,No user reviews,0,0,0
930280,True,0,No user reviews,0,0,0
930290,True,0,1 user reviews,1,0,1
930300,True,0,2 user reviews,1,1,2
930310,True,0,6 user reviews,6,0,6
930320,True,0,6 user reviews,6,0,6
930360,True,0,No user reviews,0,0,0
930370,True,0,No user reviews,0,0,0
930410,True,0,No user reviews,0,0,0
930430,True,0,2 user reviews,2,0,2
930440,True,0,No user reviews,0,0,0
930460,True,7,Positive,30,5,35
930470,True,0,No user reviews,0,0,0
930480,True,0,2 user reviews,2,0,2
930490,True,0,No user reviews,0,0,0
930500,True,0,4 user reviews,3,1,4
930570,True,0,No user reviews,0,0,0
930600,True,0,1 user reviews,1,0,1
930620,True,5,Mixed,40,34,74
930630,True,7,Positive,12,0,12
930640,True,0,7 user reviews,7,0,7
930650,True,0,1 user reviews,0,1,1
930690,True,0,3 user reviews,3,0,3
930700,True,0,No user reviews,0,0,0
930710,True,0,5 user reviews,4,1,5
930720,True,0,No user reviews,0,0,0
930780,True,8,Very Positive,142,33,175
930790,True,0,No user reviews,0,0,0
930840,True,0,No user reviews,0,0,0
930850,True,0,1 user reviews,0,1,1
930860,True,0,No user reviews,0,0,0
930870,True,0,No user reviews,0,0,0
930890,True,0,No user reviews,0,0,0
930910,True,8,Very Positive,110,1,111
930920,True,0,No user reviews,0,0,0
930940,True,0,2 user reviews,1,1,2
930970,True,0,1 user reviews,0,1,1
930980,True,0,4 user reviews,3,1,4
930981,True,0,No user reviews,0,0,0
930982,True,0,9 user reviews,9,0,9
930983,True,0,No user reviews,0,0,0
930984,True,0,5 user reviews,5,0,5
930985,True,0,No user reviews,0,0,0
930990,True,7,Positive,12,0,12
930991,True,0,No user reviews,0,0,0
931000,True,0,4 user reviews,3,1,4
931010,True,0,No user reviews,0,0,0
931020,True,0,No user reviews,0,0,0
931040,True,0,2 user reviews,2,0,2
931050,True,0,No user reviews,0,0,0
931060,True,0,No user reviews,0,0,0
931070,True,0,No user reviews,0,0,0
931090,True,0,6 user reviews,6,0,6
931120,True,0,4 user reviews,2,2,4
931140,True,0,No user reviews,0,0,0
931150,True,0,2 user reviews,2,0,2
931180,True,0,No user reviews,0,0,0
931191,True,0,No user reviews,0,0,0
931193,True,0,No user reviews,0,0,0
931200,True,0,3 user reviews,3,0,3
931210,True,0,2 user reviews,1,1,2
931220,True,0,No user reviews,0,0,0
931250,True,0,5 user reviews,1,4,5
931260,True,0,3 user reviews,2,1,3
931270,True,8,Very Positive,188,10,198
931280,True,8,Very Positive,198,43,241
931300,True,0,No user reviews,0,0,0
931310,True,5,Mixed,22,24,46
931320,True,7,Positive,11,0,11
931330,True,0,No user reviews,0,0,0
931360,True,0,3 user reviews,2,1,3
931370,True,0,3 user reviews,3,0,3
931420,True,0,No user reviews,0,0,0
931430,True,0,9 user reviews,4,5,9
931440,True,0,2 user reviews,0,2,2
931450,True,0,9 user reviews,8,1,9
931460,True,0,No user reviews,0,0,0
931470,True,0,6 user reviews,5,1,6
931480,True,0,2 user reviews,1,1,2
931500,True,8,Very Positive,107,6,113
931520,True,0,No user reviews,0,0,0
931530,True,0,2 user reviews,2,0,2
931540,True,0,4 user reviews,3,1,4
931560,True,7,Positive,18,0,18
931570,True,0,2 user reviews,2,0,2
931580,True,0,No user reviews,0,0,0
931590,True,0,No user reviews,0,0,0
931600,True,0,No user reviews,0,0,0
931610,True,0,No user reviews,0,0,0
931620,True,0,3 user reviews,3,0,3
931630,True,0,9 user reviews,7,2,9
931640,True,0,8 user reviews,4,4,8
931650,True,0,No user reviews,0,0,0
931670,True,0,8 user reviews,8,0,8
931690,True,0,No user reviews,0,0,0
931700,True,0,No user reviews,0,0,0
931720,True,0,No user reviews,0,0,0
931740,True,0,No user reviews,0,0,0
931760,True,0,No user reviews,0,0,0
931780,True,0,No user reviews,0,0,0
931790,True,0,No user reviews,0,0,0
931791,True,0,No user reviews,0,0,0
931800,True,0,1 user reviews,1,0,1
931810,True,0,No user reviews,0,0,0
931820,True,0,1 user reviews,1,0,1
931830,True,6,Mostly Positive,7,3,10
931860,True,7,Positive,26,4,30
931870,True,0,No user reviews,0,0,0
931880,True,0,No user reviews,0,0,0
931900,True,0,No user reviews,0,0,0
931920,True,7,Positive,18,0,18
931930,True,7,Positive,32,2,34
931940,True,0,No user reviews,0,0,0
931950,True,8,Very Positive,40,10,50
931960,True,0,1 user reviews,1,0,1
931970,True,0,No user reviews,0,0,0
931980,True,0,1 user reviews,1,0,1
932000,True,0,No user reviews,0,0,0
932010,True,0,No user reviews,0,0,0
932030,True,0,No user reviews,0,0,0
932050,True,0,No user reviews,0,0,0
932060,True,0,No user reviews,0,0,0
932070,True,0,No user reviews,0,0,0
932080,True,0,No user reviews,0,0,0
932090,True,0,No user reviews,0,0,0
932120,True,0,4 user reviews,3,1,4
932150,True,0,No user reviews,0,0,0
932160,True,5,Mixed,4,6,10
932170,True,0,No user reviews,0,0,0
932190,True,0,No user reviews,0,0,0
932200,True,0,No user reviews,0,0,0
932210,True,5,Mixed,9,5,14
932220,True,7,Positive,18,1,19
932230,True,0,No user reviews,0,0,0
932240,True,0,No user reviews,0,0,0
932270,True,0,3 user reviews,3,0,3
932290,True,0,2 user reviews,2,0,2
932300,True,0,1 user reviews,0,1,1
932310,True,0,8 user reviews,3,5,8
932330,True,7,Positive,14,2,16
932350,True,0,2 user reviews,1,1,2
932370,True,0,No user reviews,0,0,0
932380,True,0,No user reviews,0,0,0
932400,True,0,No user reviews,0,0,0
932420,True,0,7 user reviews,7,0,7
932450,True,0,6 user reviews,6,0,6
932460,True,0,No user reviews,0,0,0
932480,True,0,6 user reviews,5,1,6
932500,True,8,Very Positive,85,2,87
932510,True,0,No user reviews,0,0,0
932520,True,0,No user reviews,0,0,0
932540,True,0,No user reviews,0,0,0
932550,True,0,No user reviews,0,0,0
932560,True,0,1 user reviews,1,0,1
932570,True,0,No user reviews,0,0,0
932580,True,0,No user reviews,0,0,0
932600,True,0,No user reviews,0,0,0
932620,True,0,No user reviews,0,0,0
932621,True,0,No user reviews,0,0,0
932622,True,0,No user reviews,0,0,0
932640,True,0,No user reviews,0,0,0
932641,True,0,1 user reviews,0,1,1
932642,True,0,No user reviews,0,0,0
932643,True,0,1 user reviews,1,0,1
932644,True,0,5 user reviews,1,4,5
932660,True,6,Mostly Positive,8,3,11
932670,True,0,2 user reviews,0,2,2
932690,True,0,4 user reviews,0,4,4
932700,True,0,No user reviews,0,0,0
932730,True,0,5 user reviews,3,2,5
932740,True,0,1 user reviews,1,0,1
932741,True,0,No user reviews,0,0,0
932742,True,0,No user reviews,0,0,0
932743,True,0,No user reviews,0,0,0
932744,True,0,1 user reviews,1,0,1
932760,True,0,6 user reviews,5,1,6
932780,True,0,5 user reviews,5,0,5
932790,True,7,Positive,12,3,15
932800,True,0,No user reviews,0,0,0
932810,True,0,No user reviews,0,0,0
932820,True,0,4 user reviews,4,0,4
932830,True,0,No user reviews,0,0,0
932840,True,0,No user reviews,0,0,0
932850,True,8,Very Positive,330,45,375
932870,True,0,No user reviews,0,0,0
932920,True,0,1 user reviews,0,1,1
932930,True,0,5 user reviews,3,2,5
932940,True,5,Mixed,5,5,10
932950,True,0,1 user reviews,1,0,1
932970,True,0,4 user reviews,2,2,4
932980,True,5,Mixed,79,45,124
932990,True,0,3 user reviews,3,0,3
933000,True,0,No user reviews,0,0,0
933010,True,0,No user reviews,0,0,0
933020,True,0,1 user reviews,1,0,1
933030,True,0,5 user reviews,5,0,5
933050,True,0,2 user reviews,1,1,2
933060,True,6,Mostly Positive,12,4,16
933070,True,0,3 user reviews,1,2,3
933080,True,5,Mixed,11,8,19
933100,True,0,No user reviews,0,0,0
933110,True,5,Mixed,1614,1029,2643
933120,True,0,No user reviews,0,0,0
933130,True,7,Positive,11,2,13
933140,True,7,Positive,17,1,18
933160,True,0,2 user reviews,2,0,2
933170,True,0,No user reviews,0,0,0
933200,True,0,No user reviews,0,0,0
933210,True,0,4 user reviews,4,0,4
933230,True,5,Mixed,17,10,27
933250,True,0,No user reviews,0,0,0
933260,True,0,No user reviews,0,0,0
933261,True,0,No user reviews,0,0,0
933262,True,0,No user reviews,0,0,0
933290,True,0,No user reviews,0,0,0
933300,True,0,7 user reviews,5,2,7
933330,True,0,No user reviews,0,0,0
933340,True,0,No user reviews,0,0,0
933350,True,0,No user reviews,0,0,0
933360,True,0,No user reviews,0,0,0
933370,True,0,No user reviews,0,0,0
933380,True,0,No user reviews,0,0,0
933390,True,0,No user reviews,0,0,0
933400,True,0,1 user reviews,1,0,1
933430,True,0,1 user reviews,1,0,1
933440,True,0,No user reviews,0,0,0
933450,True,5,Mixed,26,12,38
933480,True,0,No user reviews,0,0,0
933490,True,0,No user reviews,0,0,0
933504,True,6,Mostly Positive,7,3,10
933505,True,0,No user reviews,0,0,0
933506,True,0,No user reviews,0,0,0
933509,True,0,No user reviews,0,0,0
933510,True,0,2 user reviews,1,1,2
933511,True,0,No user reviews,0,0,0
933512,True,0,1 user reviews,1,0,1
933520,True,0,No user reviews,0,0,0
933521,True,0,No user reviews,0,0,0
933522,True,0,No user reviews,0,0,0
933523,True,0,No user reviews,0,0,0
933524,True,0,1 user reviews,0,1,1
933525,True,0,1 user reviews,1,0,1
933526,True,0,1 user reviews,1,0,1
933527,True,0,No user reviews,0,0,0
933528,True,0,1 user reviews,1,0,1
933529,True,0,1 user reviews,1,0,1
933530,True,0,1 user reviews,0,1,1
933531,True,0,1 user reviews,0,1,1
933532,True,0,3 user reviews,2,1,3
933533,True,0,No user reviews,0,0,0
933534,True,0,No user reviews,0,0,0
933535,True,0,No user reviews,0,0,0
933536,True,0,No user reviews,0,0,0
933537,True,0,No user reviews,0,0,0
933538,True,0,No user reviews,0,0,0
933539,True,0,No user reviews,0,0,0
933540,True,0,No user reviews,0,0,0
933550,True,0,No user reviews,0,0,0
933551,True,0,No user reviews,0,0,0
933552,True,0,1 user reviews,1,0,1
933553,True,0,No user reviews,0,0,0
933554,True,0,No user reviews,0,0,0
933555,True,0,No user reviews,0,0,0
933556,True,0,1 user reviews,1,0,1
933557,True,0,1 user reviews,1,0,1
933558,True,0,2 user reviews,1,1,2
933560,True,0,1 user reviews,1,0,1
933561,True,0,No user reviews,0,0,0
933562,True,0,No user reviews,0,0,0
933563,True,0,No user reviews,0,0,0
933566,True,0,3 user reviews,0,3,3
933570,True,0,1 user reviews,1,0,1
933571,True,0,No user reviews,0,0,0
933572,True,0,No user reviews,0,0,0
933573,True,0,No user reviews,0,0,0
933580,True,0,No user reviews,0,0,0
933590,True,0,No user reviews,0,0,0
933600,True,0,3 user reviews,3,0,3
933610,True,8,Very Positive,84,20,104
933620,True,0,7 user reviews,6,1,7
933630,True,5,Mixed,5,5,10
933650,True,0,No user reviews,0,0,0
933660,True,0,6 user reviews,3,3,6
933670,True,0,No user reviews,0,0,0
933680,True,0,No user reviews,0,0,0
933690,True,0,5 user reviews,1,4,5
933700,True,4,Mostly Negative,11,21,32
933710,True,0,6 user reviews,2,4,6
933720,True,2,Very Negative,12,51,63
933740,True,0,No user reviews,0,0,0
933750,True,0,No user reviews,0,0,0
933751,True,0,No user reviews,0,0,0
933752,True,0,No user reviews,0,0,0
933753,True,0,1 user reviews,0,1,1
933754,True,0,No user reviews,0,0,0
933755,True,0,No user reviews,0,0,0
933756,True,0,No user reviews,0,0,0
933757,True,0,No user reviews,0,0,0
933758,True,0,No user reviews,0,0,0
933759,True,0,No user reviews,0,0,0
933760,True,0,No user reviews,0,0,0
933761,True,0,No user reviews,0,0,0
933762,True,0,No user reviews,0,0,0
933763,True,0,No user reviews,0,0,0
933764,True,0,No user reviews,0,0,0
933765,True,0,No user reviews,0,0,0
933770,True,0,8 user reviews,8,0,8
933790,True,0,1 user reviews,1,0,1
933820,True,6,Mostly Positive,504,134,638
933830,True,0,9 user reviews,6,3,9
933840,True,0,3 user reviews,1,2,3
933850,True,0,No user reviews,0,0,0
933860,True,6,Mostly Positive,81,23,104
933890,True,0,1 user reviews,1,0,1
933900,True,0,No user reviews,0,0,0
933920,True,0,8 user reviews,3,5,8
933930,True,0,No user reviews,0,0,0
933940,True,7,Positive,12,3,15
933970,True,5,Mixed,6,9,15
933980,True,0,7 user reviews,3,4,7
933990,True,0,No user reviews,0,0,0
934060,True,0,No user reviews,0,0,0
934070,True,7,Positive,30,0,30
934120,True,5,Mixed,4,6,10
934130,True,0,1 user reviews,0,1,1
934131,True,0,No user reviews,0,0,0
934170,True,0,3 user reviews,3,0,3
934180,True,0,7 user reviews,4,3,7
934200,True,0,No user reviews,0,0,0
934220,True,0,6 user reviews,3,3,6
934240,True,0,No user reviews,0,0,0
934250,True,0,No user reviews,0,0,0
934260,True,0,No user reviews,0,0,0
934300,True,0,No user reviews,0,0,0
934310,True,0,No user reviews,0,0,0
934320,True,0,No user reviews,0,0,0
934321,True,0,No user reviews,0,0,0
934330,True,0,No user reviews,0,0,0
934331,True,0,No user reviews,0,0,0
934340,True,0,No user reviews,0,0,0
934341,True,0,No user reviews,0,0,0
934350,True,0,No user reviews,0,0,0
934351,True,0,No user reviews,0,0,0
934352,True,0,No user reviews,0,0,0
934353,True,0,No user reviews,0,0,0
934360,True,0,No user reviews,0,0,0
934361,True,0,No user reviews,0,0,0
934400,True,0,No user reviews,0,0,0
934410,True,7,Positive,13,0,13
934430,True,0,1 user reviews,1,0,1
934450,True,0,No user reviews,0,0,0
934470,True,0,1 user reviews,0,1,1
934480,True,0,No user reviews,0,0,0
934500,True,0,No user reviews,0,0,0
934510,True,0,No user reviews,0,0,0
934520,True,0,No user reviews,0,0,0
934540,True,5,Mixed,12,8,20
934550,True,0,1 user reviews,1,0,1
934580,True,0,No user reviews,0,0,0
934590,True,0,2 user reviews,0,2,2
934600,True,0,4 user reviews,2,2,4
934610,True,0,No user reviews,0,0,0
934630,True,7,Positive,9,1,10
934640,True,0,No user reviews,0,0,0
934650,True,0,8 user reviews,5,3,8
934660,True,0,6 user reviews,3,3,6
934670,True,0,No user reviews,0,0,0
934680,True,0,8 user reviews,6,2,8
934690,True,0,2 user reviews,1,1,2
934710,True,0,No user reviews,0,0,0
934780,True,6,Mostly Positive,261,98,359
934790,True,0,No user reviews,0,0,0
934800,True,0,1 user reviews,1,0,1
934810,True,0,1 user reviews,1,0,1
934830,True,0,No user reviews,0,0,0
934840,True,0,No user reviews,0,0,0
934850,True,0,No user reviews,0,0,0
934860,True,0,No user reviews,0,0,0
934900,True,0,No user reviews,0,0,0
934920,True,0,1 user reviews,1,0,1
934930,True,8,Very Positive,170,38,208
934950,True,0,7 user reviews,4,3,7
934960,True,0,No user reviews,0,0,0
934961,True,0,No user reviews,0,0,0
934990,True,5,Mixed,7,4,11
935000,True,0,No user reviews,0,0,0
935010,True,0,1 user reviews,1,0,1
935040,True,0,No user reviews,0,0,0
935060,True,0,No user reviews,0,0,0
935070,True,7,Positive,37,6,43
935080,True,0,4 user reviews,4,0,4
935110,True,0,No user reviews,0,0,0
935120,True,0,No user reviews,0,0,0
935140,True,0,No user reviews,0,0,0
935180,True,0,4 user reviews,1,3,4
935190,True,0,8 user reviews,4,4,8
935240,True,0,1 user reviews,0,1,1
935250,True,0,4 user reviews,4,0,4
935270,True,8,Very Positive,160,21,181
935320,True,0,1 user reviews,1,0,1
935340,True,0,No user reviews,0,0,0
935350,True,0,2 user reviews,1,1,2
935360,True,7,Positive,13,3,16
935380,True,0,No user reviews,0,0,0
935390,True,0,No user reviews,0,0,0
935400,True,8,Very Positive,63,9,72
935420,True,0,No user reviews,0,0,0
935430,True,0,9 user reviews,5,4,9
935440,True,0,7 user reviews,7,0,7
935450,True,0,No user reviews,0,0,0
935460,True,0,3 user reviews,0,3,3
935490,True,0,4 user reviews,2,2,4
935500,True,0,6 user reviews,2,4,6
935510,True,0,6 user reviews,3,3,6
935511,True,7,Positive,10,0,10
935512,True,0,5 user reviews,4,1,5
935513,True,0,8 user reviews,6,2,8
935514,True,0,1 user reviews,1,0,1
935540,True,0,1 user reviews,1,0,1
935550,True,0,No user reviews,0,0,0
935560,True,7,Positive,20,3,23
935570,True,5,Mixed,7,7,14
935580,True,8,Very Positive,124,11,135
935590,True,0,2 user reviews,2,0,2
935600,True,0,No user reviews,0,0,0
935610,True,0,4 user reviews,1,3,4
935630,True,0,No user reviews,0,0,0
935640,True,7,Positive,14,1,15
935660,True,0,No user reviews,0,0,0
935670,True,0,No user reviews,0,0,0
935680,True,0,2 user reviews,0,2,2
935700,True,0,6 user reviews,2,4,6
935710,True,0,No user reviews,0,0,0
935720,True,0,3 user reviews,1,2,3
935750,True,7,Positive,8,2,10
935770,True,0,No user reviews,0,0,0
935790,True,0,4 user reviews,3,1,4
935810,True,0,4 user reviews,1,3,4
935830,True,0,No user reviews,0,0,0
935840,True,0,No user reviews,0,0,0
935850,True,0,No user reviews,0,0,0
935860,True,0,2 user reviews,2,0,2
935880,True,8,Very Positive,498,34,532
935910,True,0,8 user reviews,6,2,8
935920,True,0,No user reviews,0,0,0
935930,True,8,Very Positive,105,14,119
935940,True,0,3 user reviews,0,3,3
935950,True,0,1 user reviews,1,0,1
935960,True,0,4 user reviews,0,4,4
935970,True,0,No user reviews,0,0,0
935980,True,5,Mixed,12,11,23
936000,True,0,1 user reviews,1,0,1
936010,True,0,5 user reviews,3,2,5
936020,True,0,2 user reviews,2,0,2
936030,True,7,Positive,14,1,15
936040,True,0,3 user reviews,2,1,3
936060,True,0,No user reviews,0,0,0
936070,True,0,2 user reviews,2,0,2
936080,True,0,1 user reviews,1,0,1
936090,True,0,2 user reviews,1,1,2
936100,True,0,7 user reviews,1,6,7
936110,True,0,No user reviews,0,0,0
936120,True,0,No user reviews,0,0,0
936121,True,0,No user reviews,0,0,0
936140,True,5,Mixed,73,35,108
936150,True,0,No user reviews,0,0,0
936160,True,8,Very Positive,80,9,89
936170,True,0,3 user reviews,3,0,3
936180,True,6,Mostly Positive,26,9,35
936190,True,7,Positive,28,1,29
936210,True,0,1 user reviews,1,0,1
936250,True,0,No user reviews,0,0,0
936270,True,0,No user reviews,0,0,0
936280,True,0,No user reviews,0,0,0
936290,True,0,No user reviews,0,0,0
936300,True,0,No user reviews,0,0,0
936310,True,0,No user reviews,0,0,0
936340,True,0,No user reviews,0,0,0
936350,True,0,No user reviews,0,0,0
936360,True,0,No user reviews,0,0,0
936370,True,0,1 user reviews,1,0,1
936390,True,0,No user reviews,0,0,0
936400,True,0,No user reviews,0,0,0
936420,True,0,No user reviews,0,0,0
936430,True,0,No user reviews,0,0,0
936440,True,0,No user reviews,0,0,0
936450,True,0,No user reviews,0,0,0
936460,True,0,No user reviews,0,0,0
936470,True,0,No user reviews,0,0,0
936480,True,0,No user reviews,0,0,0
936490,True,5,Mixed,55,57,112
936500,True,6,Mostly Positive,66,20,86
936510,True,0,2 user reviews,1,1,2
936530,True,6,Mostly Positive,30,10,40
936560,True,0,2 user reviews,1,1,2
936570,True,0,No user reviews,0,0,0
936580,True,0,No user reviews,0,0,0
936590,True,0,No user reviews,0,0,0
936600,True,0,1 user reviews,1,0,1
936610,True,7,Positive,24,5,29
936620,True,5,Mixed,13,9,22
936630,True,0,6 user reviews,6,0,6
936650,True,7,Positive,25,0,25
936660,True,0,No user reviews,0,0,0
936670,True,5,Mixed,20,24,44
936690,True,0,No user reviews,0,0,0
936700,True,7,Positive,15,0,15
936710,True,0,No user reviews,0,0,0
936720,True,8,Very Positive,319,29,348
936740,True,7,Positive,13,2,15
936750,True,0,No user reviews,0,0,0
936770,True,0,No user reviews,0,0,0
936780,True,0,No user reviews,0,0,0
936800,True,0,4 user reviews,1,3,4
936810,True,0,3 user reviews,0,3,3
936820,True,0,2 user reviews,1,1,2
936850,True,0,No user reviews,0,0,0
936870,True,0,No user reviews,0,0,0
936890,True,0,No user reviews,0,0,0
936900,True,0,No user reviews,0,0,0
936910,True,0,No user reviews,0,0,0
936920,True,0,No user reviews,0,0,0
936930,True,0,9 user reviews,4,5,9
936940,True,0,No user reviews,0,0,0
936950,True,0,No user reviews,0,0,0
936960,True,6,Mostly Positive,82,33,115
936970,True,0,No user reviews,0,0,0
936980,True,5,Mixed,24,11,35
937020,True,0,No user reviews,0,0,0
937040,True,0,No user reviews,0,0,0
937050,True,0,5 user reviews,4,1,5
937070,True,0,1 user reviews,1,0,1
937090,True,0,1 user reviews,1,0,1
937110,True,0,No user reviews,0,0,0
937120,True,0,No user reviews,0,0,0
937130,True,0,No user reviews,0,0,0
937140,True,0,2 user reviews,2,0,2
937160,True,0,1 user reviews,1,0,1
937170,True,8,Very Positive,156,12,168
937180,True,0,No user reviews,0,0,0
937210,True,7,Positive,12,2,14
937230,True,0,No user reviews,0,0,0
937240,True,0,No user reviews,0,0,0
937250,True,0,No user reviews,0,0,0
937300,True,8,Very Positive,48,4,52
937310,True,0,No user reviews,0,0,0
937320,True,0,1 user reviews,1,0,1
937350,True,0,No user reviews,0,0,0
937360,True,0,2 user reviews,1,1,2
937370,True,0,No user reviews,0,0,0
937390,True,0,1 user reviews,1,0,1
937400,True,0,No user reviews,0,0,0
937420,True,0,No user reviews,0,0,0
937430,True,0,No user reviews,0,0,0
937440,True,0,No user reviews,0,0,0
937450,True,0,No user reviews,0,0,0
937460,True,0,No user reviews,0,0,0
937480,True,0,No user reviews,0,0,0
937490,True,7,Positive,15,0,15
937510,True,0,No user reviews,0,0,0
937520,True,0,6 user reviews,6,0,6
937530,True,7,Positive,24,6,30
937550,True,0,No user reviews,0,0,0
937570,True,7,Positive,18,0,18
937580,True,8,Very Positive,103,1,104
937600,True,0,No user reviews,0,0,0
937620,True,0,1 user reviews,0,1,1
937630,True,0,4 user reviews,4,0,4
937650,True,0,No user reviews,0,0,0
937680,True,0,No user reviews,0,0,0
937690,True,0,No user reviews,0,0,0
937720,True,0,4 user reviews,4,0,4
937730,True,5,Mixed,13,6,19
937740,True,0,6 user reviews,2,4,6
937770,True,0,8 user reviews,6,2,8
937780,True,0,2 user reviews,0,2,2
937790,True,0,No user reviews,0,0,0
937791,True,0,1 user reviews,1,0,1
937792,True,0,1 user reviews,1,0,1
937820,True,0,2 user reviews,1,1,2
937830,True,0,No user reviews,0,0,0
937850,True,8,Very Positive,58,3,61
937860,True,0,1 user reviews,0,1,1
937870,True,7,Positive,13,3,16
937880,True,0,1 user reviews,0,1,1
937890,True,6,Mostly Positive,92,28,120
937891,True,5,Mixed,148,210,358
937910,True,0,No user reviews,0,0,0
937930,True,0,No user reviews,0,0,0
937940,True,5,Mixed,17,10,27
937950,True,5,Mixed,13,14,27
937960,True,0,No user reviews,0,0,0
937970,True,0,4 user reviews,2,2,4
937980,True,0,No user reviews,0,0,0
938000,True,0,4 user reviews,2,2,4
938030,True,7,Positive,18,0,18
938040,True,0,No user reviews,0,0,0
938050,True,0,No user reviews,0,0,0
938060,True,0,No user reviews,0,0,0
938070,True,0,7 user reviews,7,0,7
938090,True,0,No user reviews,0,0,0
938100,True,0,3 user reviews,3,0,3
938110,True,0,No user reviews,0,0,0
938120,True,0,1 user reviews,1,0,1
938130,True,0,No user reviews,0,0,0
938140,True,0,No user reviews,0,0,0
938150,True,0,No user reviews,0,0,0
938160,True,0,No user reviews,0,0,0
938170,True,0,4 user reviews,4,0,4
938180,True,0,No user reviews,0,0,0
938200,True,0,No user reviews,0,0,0
938210,True,0,1 user reviews,0,1,1
938220,True,8,Very Positive,160,13,173
938240,True,7,Positive,13,2,15
938250,True,0,8 user reviews,5,3,8
938260,True,0,3 user reviews,3,0,3
938270,True,6,Mostly Positive,11,3,14
938280,True,0,2 user reviews,2,0,2
938290,True,0,No user reviews,0,0,0
938300,True,5,Mixed,27,17,44
938310,True,7,Positive,25,0,25
938320,True,0,8 user reviews,4,4,8
938340,True,0,No user reviews,0,0,0
938350,True,0,6 user reviews,4,2,6
938360,True,0,1 user reviews,1,0,1
938370,True,0,No user reviews,0,0,0
938380,True,5,Mixed,45,20,65
938390,True,3,Negative,1,9,10
938400,True,5,Mixed,7,5,12
938410,True,0,5 user reviews,5,0,5
938420,True,0,No user reviews,0,0,0
938430,True,0,No user reviews,0,0,0
938440,True,0,No user reviews,0,0,0
938450,True,0,No user reviews,0,0,0
938460,True,8,Very Positive,144,9,153
938480,True,0,9 user reviews,8,1,9
938490,True,7,Positive,15,2,17
938500,True,4,Mostly Negative,22,56,78
938510,True,0,1 user reviews,1,0,1
938520,True,0,1 user reviews,0,1,1
938530,True,0,No user reviews,0,0,0
938540,True,0,No user reviews,0,0,0
938550,True,0,No user reviews,0,0,0
938560,True,8,Very Positive,354,46,400
938590,True,0,1 user reviews,0,1,1
938600,True,0,5 user reviews,4,1,5
938610,True,0,1 user reviews,1,0,1
938630,True,0,2 user reviews,2,0,2
938640,True,0,5 user reviews,3,2,5
938660,True,0,No user reviews,0,0,0
938680,True,0,No user reviews,0,0,0
938721,True,0,1 user reviews,1,0,1
938740,True,0,6 user reviews,5,1,6
938760,True,0,7 user reviews,4,3,7
938770,True,0,No user reviews,0,0,0
938810,True,0,No user reviews,0,0,0
938820,True,0,1 user reviews,0,1,1
938840,True,0,2 user reviews,0,2,2
938870,True,0,1 user reviews,0,1,1
938880,True,0,No user reviews,0,0,0
938890,True,0,8 user reviews,6,2,8
938900,True,0,No user reviews,0,0,0
938910,True,0,No user reviews,0,0,0
938920,True,0,No user reviews,0,0,0
938940,True,0,7 user reviews,2,5,7
938950,True,0,No user reviews,0,0,0
938960,True,0,4 user reviews,4,0,4
938980,True,0,4 user reviews,4,0,4
938990,True,0,No user reviews,0,0,0
938991,True,0,No user reviews,0,0,0
939000,True,8,Very Positive,135,33,168
939010,True,0,No user reviews,0,0,0
939030,True,0,No user reviews,0,0,0
939040,True,0,No user reviews,0,0,0
939050,True,0,5 user reviews,4,1,5
939051,True,0,8 user reviews,5,3,8
939060,True,7,Positive,8,2,10
939070,True,0,No user reviews,0,0,0
939090,True,0,No user reviews,0,0,0
939100,True,6,Mostly Positive,284,105,389
939110,True,0,No user reviews,0,0,0
939120,True,5,Mixed,23,15,38
939150,True,0,2 user reviews,2,0,2
939160,True,5,Mixed,8,4,12
939180,True,5,Mixed,13,11,24
939200,True,0,2 user reviews,2,0,2
939210,True,0,No user reviews,0,0,0
939230,True,0,8 user reviews,6,2,8
939240,True,0,4 user reviews,2,2,4
939250,True,0,No user reviews,0,0,0
939300,True,0,No user reviews,0,0,0
939310,True,0,No user reviews,0,0,0
939311,True,0,No user reviews,0,0,0
939312,True,0,No user reviews,0,0,0
939320,True,0,No user reviews,0,0,0
939330,True,0,No user reviews,0,0,0
939340,True,0,No user reviews,0,0,0
939350,True,7,Positive,33,8,41
939360,True,7,Positive,25,5,30
939370,True,0,No user reviews,0,0,0
939380,True,0,No user reviews,0,0,0
939390,True,4,Mostly Negative,3,10,13
939400,True,8,Very Positive,198,16,214
939410,True,0,3 user reviews,1,2,3
939420,True,0,No user reviews,0,0,0
939450,True,6,Mostly Positive,17,6,23
939470,True,0,No user reviews,0,0,0
939480,True,0,No user reviews,0,0,0
939490,True,0,No user reviews,0,0,0
939510,True,5,Mixed,629,386,1015
939520,True,5,Mixed,389,392,781
939540,True,0,1 user reviews,1,0,1
939550,True,0,No user reviews,0,0,0
939560,True,0,2 user reviews,2,0,2
939570,True,0,No user reviews,0,0,0
939580,True,0,No user reviews,0,0,0
939590,True,0,No user reviews,0,0,0
939600,True,8,Very Positive,108,12,120
939620,True,7,Positive,17,0,17
939630,True,0,No user reviews,0,0,0
939640,True,0,No user reviews,0,0,0
939650,True,0,No user reviews,0,0,0
939670,True,0,No user reviews,0,0,0
939680,True,0,No user reviews,0,0,0
939700,True,0,No user reviews,0,0,0
939710,True,0,No user reviews,0,0,0
939730,True,0,2 user reviews,1,1,2
939740,True,0,No user reviews,0,0,0
939750,True,0,3 user reviews,1,2,3
939770,True,0,No user reviews,0,0,0
939790,True,8,Very Positive,66,3,69
939810,True,0,2 user reviews,0,2,2
939830,True,0,6 user reviews,6,0,6
939840,True,5,Mixed,25,21,46
939850,True,6,Mostly Positive,1104,453,1557
939860,True,0,No user reviews,0,0,0
939870,True,0,No user reviews,0,0,0
939890,True,0,No user reviews,0,0,0
939900,True,0,No user reviews,0,0,0
939910,True,0,No user reviews,0,0,0
939920,True,0,7 user reviews,2,5,7
939930,True,0,6 user reviews,2,4,6
939940,True,5,Mixed,8,5,13
939960,True,6,Mostly Positive,4576,1312,5888
939990,True,6,Mostly Positive,77,23,100
940010,True,0,3 user reviews,3,0,3
940020,True,0,No user reviews,0,0,0
940030,True,0,No user reviews,0,0,0
940050,True,0,No user reviews,0,0,0
940070,True,0,No user reviews,0,0,0
940090,True,0,No user reviews,0,0,0
940140,True,0,6 user reviews,6,0,6
940150,True,7,Positive,12,1,13
940180,True,0,1 user reviews,1,0,1
940190,True,0,4 user reviews,2,2,4
940200,True,0,No user reviews,0,0,0
940220,True,8,Very Positive,643,62,705
940240,True,0,1 user reviews,1,0,1
940250,True,0,No user reviews,0,0,0
940270,True,0,No user reviews,0,0,0
940290,True,0,No user reviews,0,0,0
940300,True,6,Mostly Positive,22,8,30
940310,True,8,Very Positive,98,20,118
940320,True,0,2 user reviews,2,0,2
940330,True,0,1 user reviews,0,1,1
940340,True,0,No user reviews,0,0,0
940350,True,0,1 user reviews,0,1,1
940370,True,0,No user reviews,0,0,0
940380,True,0,No user reviews,0,0,0
940390,True,0,2 user reviews,1,1,2
940400,True,0,No user reviews,0,0,0
940410,True,0,1 user reviews,1,0,1
940420,True,0,No user reviews,0,0,0
940440,True,0,No user reviews,0,0,0
940450,True,0,No user reviews,0,0,0
940460,True,0,1 user reviews,1,0,1
940480,True,0,1 user reviews,1,0,1
940510,True,0,No user reviews,0,0,0
940520,True,0,4 user reviews,1,3,4
940530,True,0,3 user reviews,3,0,3
940550,True,0,No user reviews,0,0,0
940570,True,0,No user reviews,0,0,0
940580,True,5,Mixed,13,10,23
940590,True,0,1 user reviews,1,0,1
940600,True,0,1 user reviews,0,1,1
940620,True,0,1 user reviews,1,0,1
940630,True,0,1 user reviews,0,1,1
940640,True,0,2 user reviews,2,0,2
940650,True,5,Mixed,11,7,18
940670,True,0,No user reviews,0,0,0
940671,True,0,No user reviews,0,0,0
940672,True,0,No user reviews,0,0,0
940680,True,8,Very Positive,125,16,141
940700,True,0,1 user reviews,1,0,1
940710,True,8,Very Positive,71,3,74
940730,True,0,3 user reviews,3,0,3
940731,True,0,4 user reviews,4,0,4
940732,True,0,1 user reviews,1,0,1
940733,True,0,1 user reviews,1,0,1
940734,True,0,1 user reviews,1,0,1
940735,True,0,1 user reviews,1,0,1
940736,True,0,2 user reviews,2,0,2
940737,True,0,No user reviews,0,0,0
940738,True,0,No user reviews,0,0,0
940739,True,0,1 user reviews,0,1,1
940740,True,0,1 user reviews,1,0,1
940750,True,0,2 user reviews,2,0,2
940770,True,0,2 user reviews,2,0,2
940771,True,0,No user reviews,0,0,0
940780,True,0,5 user reviews,5,0,5
940790,True,7,Positive,10,2,12
940800,True,0,5 user reviews,5,0,5
940810,True,0,3 user reviews,1,2,3
940830,True,0,3 user reviews,3,0,3
940850,True,0,1 user reviews,1,0,1
940870,True,7,Positive,17,4,21
940910,True,8,Very Positive,266,40,306
940920,True,0,5 user reviews,4,1,5
940970,True,0,No user reviews,0,0,0
940980,True,0,No user reviews,0,0,0
940990,True,0,1 user reviews,1,0,1
941000,True,0,5 user reviews,5,0,5
941010,True,0,No user reviews,0,0,0
941020,True,7,Positive,30,4,34
941030,True,0,2 user reviews,2,0,2
941040,True,0,5 user reviews,3,2,5
941050,True,0,1 user reviews,1,0,1
941080,True,0,No user reviews,0,0,0
941100,True,7,Positive,16,0,16
941120,True,0,No user reviews,0,0,0
941130,True,0,No user reviews,0,0,0
941140,True,0,No user reviews,0,0,0
941150,True,0,2 user reviews,1,1,2
941160,True,0,9 user reviews,7,2,9
941170,True,0,No user reviews,0,0,0
941180,True,0,No user reviews,0,0,0
941200,True,0,1 user reviews,0,1,1
941220,True,7,Positive,14,0,14
941241,True,0,No user reviews,0,0,0
941250,True,0,No user reviews,0,0,0
941300,True,0,2 user reviews,2,0,2
941320,True,0,5 user reviews,3,2,5
941330,True,0,No user reviews,0,0,0
941340,True,0,1 user reviews,1,0,1
941350,True,0,3 user reviews,2,1,3
941360,True,0,No user reviews,0,0,0
941390,True,0,2 user reviews,2,0,2
941400,True,0,No user reviews,0,0,0
941410,True,0,2 user reviews,2,0,2
941420,True,0,No user reviews,0,0,0
941440,True,0,1 user reviews,1,0,1
941450,True,0,No user reviews,0,0,0
941460,True,0,No user reviews,0,0,0
941480,True,8,Very Positive,60,13,73
941490,True,7,Positive,17,1,18
941540,True,7,Positive,11,0,11
941550,True,0,1 user reviews,1,0,1
941560,True,0,1 user reviews,1,0,1
941570,True,7,Positive,36,4,40
941580,True,0,No user reviews,0,0,0
941600,True,0,No user reviews,0,0,0
941620,True,0,2 user reviews,2,0,2
941630,True,0,1 user reviews,1,0,1
941640,True,0,No user reviews,0,0,0
941650,True,0,5 user reviews,5,0,5
941660,True,0,No user reviews,0,0,0
941670,True,0,No user reviews,0,0,0
941710,True,0,No user reviews,0,0,0
941730,True,6,Mostly Positive,25,8,33
941790,True,0,6 user reviews,5,1,6
941800,True,0,1 user reviews,1,0,1
941850,True,5,Mixed,37,26,63
941880,True,0,No user reviews,0,0,0
941890,True,0,No user reviews,0,0,0
941900,True,0,No user reviews,0,0,0
941910,True,0,No user reviews,0,0,0
941920,True,5,Mixed,10,7,17
941951,True,0,2 user reviews,2,0,2
941952,True,7,Positive,21,3,24
941953,True,0,3 user reviews,3,0,3
941954,True,0,5 user reviews,5,0,5
941955,True,0,9 user reviews,9,0,9
941956,True,0,6 user reviews,6,0,6
941957,True,0,4 user reviews,4,0,4
941958,True,0,6 user reviews,6,0,6
941959,True,7,Positive,12,0,12
941960,True,0,8 user reviews,8,0,8
941961,True,7,Positive,14,1,15
941962,True,0,2 user reviews,1,1,2
941963,True,0,No user reviews,0,0,0
941964,True,0,2 user reviews,2,0,2
941965,True,0,No user reviews,0,0,0
941966,True,0,1 user reviews,0,1,1
941967,True,0,3 user reviews,3,0,3
941968,True,0,1 user reviews,0,1,1
941970,True,0,2 user reviews,0,2,2
941971,True,0,2 user reviews,1,1,2
941972,True,0,1 user reviews,0,1,1
941973,True,0,1 user reviews,1,0,1
941980,True,0,1 user reviews,1,0,1
942000,True,0,No user reviews,0,0,0
942010,True,0,No user reviews,0,0,0
942020,True,0,4 user reviews,4,0,4
942030,True,0,3 user reviews,3,0,3
942050,True,7,Positive,11,2,13
942060,True,7,Positive,30,2,32
942070,True,0,No user reviews,0,0,0
942080,True,0,No user reviews,0,0,0
942100,True,0,No user reviews,0,0,0
942140,True,0,1 user reviews,0,1,1
942170,True,0,No user reviews,0,0,0
942180,True,0,3 user reviews,3,0,3
942190,True,6,Mostly Positive,10,3,13
942200,True,7,Positive,20,0,20
942210,True,0,4 user reviews,3,1,4
942220,True,0,No user reviews,0,0,0
942230,True,7,Positive,10,2,12
942240,True,0,7 user reviews,6,1,7
942250,True,7,Positive,13,3,16
942270,True,7,Positive,14,1,15
942280,True,7,Positive,11,1,12
942290,True,5,Mixed,161,105,266
942300,True,0,7 user reviews,3,4,7
942310,True,0,No user reviews,0,0,0
942340,True,0,1 user reviews,0,1,1
942350,True,0,No user reviews,0,0,0
942351,True,0,No user reviews,0,0,0
942352,True,0,No user reviews,0,0,0
942353,True,0,1 user reviews,0,1,1
942354,True,0,No user reviews,0,0,0
942355,True,0,No user reviews,0,0,0
942356,True,0,No user reviews,0,0,0
942360,True,0,No user reviews,0,0,0
942370,True,0,No user reviews,0,0,0
942380,True,0,3 user reviews,3,0,3
942390,True,0,No user reviews,0,0,0
942420,True,0,No user reviews,0,0,0
942430,True,0,3 user reviews,3,0,3
942440,True,0,No user reviews,0,0,0
942460,True,0,No user reviews,0,0,0
942480,True,0,5 user reviews,2,3,5
942490,True,0,No user reviews,0,0,0
942510,True,0,No user reviews,0,0,0
942520,True,0,6 user reviews,6,0,6
942530,True,0,1 user reviews,1,0,1
942540,True,0,6 user reviews,6,0,6
942580,True,5,Mixed,7,10,17
942590,True,0,4 user reviews,3,1,4
942600,True,0,No user reviews,0,0,0
942660,True,0,No user reviews,0,0,0
942670,True,0,No user reviews,0,0,0
942680,True,0,No user reviews,0,0,0
942760,True,0,4 user reviews,0,4,4
942770,True,0,3 user reviews,1,2,3
942790,True,0,No user reviews,0,0,0
942800,True,7,Positive,21,4,25
942810,True,0,No user reviews,0,0,0
942820,True,0,No user reviews,0,0,0
942830,True,0,No user reviews,0,0,0
942840,True,0,No user reviews,0,0,0
942850,True,8,Very Positive,71,7,78
942870,True,0,1 user reviews,1,0,1
942880,True,0,No user reviews,0,0,0
942900,True,4,Mostly Negative,4,8,12
942930,True,0,No user reviews,0,0,0
942970,True,8,Very Positive,1176,80,1256
942980,True,0,No user reviews,0,0,0
943010,True,0,No user reviews,0,0,0
943020,True,0,No user reviews,0,0,0
943030,True,0,2 user reviews,0,2,2
943040,True,0,No user reviews,0,0,0
943070,True,0,1 user reviews,1,0,1
943080,True,0,2 user reviews,0,2,2
943120,True,0,No user reviews,0,0,0
943121,True,0,No user reviews,0,0,0
943122,True,0,No user reviews,0,0,0
943123,True,0,No user reviews,0,0,0
943130,True,4,Mostly Negative,34,57,91
943140,True,8,Very Positive,75,16,91
943150,True,5,Mixed,239,280,519
943170,True,0,No user reviews,0,0,0
943180,True,0,No user reviews,0,0,0
943190,True,7,Positive,18,2,20
943200,True,6,Mostly Positive,10,4,14
943210,True,0,No user reviews,0,0,0
943230,True,0,4 user reviews,3,1,4
943240,True,0,No user reviews,0,0,0
943260,True,8,Very Positive,133,32,165
943270,True,0,No user reviews,0,0,0
943290,True,0,No user reviews,0,0,0
943310,True,0,No user reviews,0,0,0
943350,True,0,No user reviews,0,0,0
943380,True,5,Mixed,30,14,44
943390,True,0,No user reviews,0,0,0
943410,True,8,Very Positive,60,6,66
943420,True,6,Mostly Positive,8,3,11
943440,True,0,2 user reviews,1,1,2
943450,True,0,No user reviews,0,0,0
943490,True,0,No user reviews,0,0,0
943510,True,0,3 user reviews,3,0,3
943520,True,0,7 user reviews,7,0,7
943530,True,0,No user reviews,0,0,0
943590,True,0,4 user reviews,4,0,4
943640,True,0,No user reviews,0,0,0
943670,True,0,No user reviews,0,0,0
943680,True,0,8 user reviews,3,5,8
943690,True,0,1 user reviews,1,0,1
943700,True,0,No user reviews,0,0,0
943710,True,0,No user reviews,0,0,0
943720,True,0,No user reviews,0,0,0
943730,True,0,No user reviews,0,0,0
943740,True,5,Mixed,134,72,206
943750,True,0,No user reviews,0,0,0
943790,True,0,No user reviews,0,0,0
943810,True,7,Positive,11,2,13
943820,True,0,No user reviews,0,0,0
943830,True,5,Mixed,6,5,11
943831,True,0,3 user reviews,1,2,3
943840,True,0,4 user reviews,2,2,4
943841,True,0,No user reviews,0,0,0
943842,True,0,1 user reviews,1,0,1
943843,True,0,No user reviews,0,0,0
943844,True,0,4 user reviews,4,0,4
943850,True,0,No user reviews,0,0,0
943860,True,7,Positive,13,2,15
943870,True,0,No user reviews,0,0,0
943871,True,0,1 user reviews,0,1,1
943880,True,0,No user reviews,0,0,0
943900,True,6,Mostly Positive,15,5,20
943910,True,0,No user reviews,0,0,0
943920,True,0,3 user reviews,3,0,3
943930,True,0,No user reviews,0,0,0
943950,True,0,5 user reviews,5,0,5
943960,True,0,No user reviews,0,0,0
943970,True,0,2 user reviews,1,1,2
943980,True,5,Mixed,12,7,19
944010,True,8,Very Positive,113,5,118
944020,True,7,Positive,21,0,21
944030,True,0,1 user reviews,1,0,1
944050,True,0,No user reviews,0,0,0
944060,True,0,No user reviews,0,0,0
944070,True,7,Positive,27,4,31
944071,True,6,Mostly Positive,53,20,73
944080,True,7,Positive,16,0,16
944090,True,0,No user reviews,0,0,0
944100,True,0,8 user reviews,6,2,8
944110,True,0,No user reviews,0,0,0
944120,True,0,No user reviews,0,0,0
944160,True,0,No user reviews,0,0,0
944170,True,0,No user reviews,0,0,0
944180,True,7,Positive,25,5,30
944200,True,0,1 user reviews,1,0,1
944220,True,8,Very Positive,302,14,316
944240,True,0,No user reviews,0,0,0
944250,True,0,No user reviews,0,0,0
944260,True,0,3 user reviews,1,2,3
944290,True,5,Mixed,329,236,565
944300,True,0,4 user reviews,4,0,4
944330,True,8,Very Positive,125,31,156
944340,True,7,Positive,24,1,25
944350,True,0,9 user reviews,7,2,9
944380,True,0,4 user reviews,2,2,4
944420,True,0,2 user reviews,0,2,2
944430,True,0,No user reviews,0,0,0
944440,True,0,2 user reviews,2,0,2
944450,True,0,No user reviews,0,0,0
944490,True,0,No user reviews,0,0,0
944500,True,0,3 user reviews,2,1,3
944520,True,0,No user reviews,0,0,0
944530,True,0,8 user reviews,7,1,8
944540,True,0,No user reviews,0,0,0
944570,True,0,No user reviews,0,0,0
944590,True,7,Positive,16,0,16
944600,True,0,No user reviews,0,0,0
944610,True,0,2 user reviews,2,0,2
944620,True,0,No user reviews,0,0,0
944630,True,0,No user reviews,0,0,0
944640,True,0,3 user reviews,2,1,3
944650,True,7,Positive,12,3,15
944660,True,0,No user reviews,0,0,0
944690,True,7,Positive,10,1,11
944710,True,0,1 user reviews,0,1,1
944720,True,0,No user reviews,0,0,0
944730,True,0,No user reviews,0,0,0
944740,True,0,2 user reviews,0,2,2
944770,True,0,2 user reviews,2,0,2
944790,True,0,No user reviews,0,0,0
944810,True,7,Positive,9,1,10
944820,True,0,No user reviews,0,0,0
944830,True,0,1 user reviews,1,0,1
944840,True,0,No user reviews,0,0,0
944860,True,0,5 user reviews,3,2,5
944870,True,0,No user reviews,0,0,0
944890,True,0,No user reviews,0,0,0
944891,True,0,No user reviews,0,0,0
944892,True,0,No user reviews,0,0,0
944893,True,0,No user reviews,0,0,0
944900,True,0,No user reviews,0,0,0
944910,True,0,9 user reviews,7,2,9
944920,True,8,Very Positive,100,20,120
944930,True,0,No user reviews,0,0,0
944940,True,0,No user reviews,0,0,0
944950,True,0,No user reviews,0,0,0
944960,True,0,No user reviews,0,0,0
944970,True,0,No user reviews,0,0,0
944980,True,0,No user reviews,0,0,0
945000,True,0,No user reviews,0,0,0
945010,True,0,No user reviews,0,0,0
945011,True,0,No user reviews,0,0,0
945020,True,0,No user reviews,0,0,0
945031,True,0,No user reviews,0,0,0
945032,True,0,No user reviews,0,0,0
945033,True,0,No user reviews,0,0,0
945040,True,0,No user reviews,0,0,0
945050,True,0,No user reviews,0,0,0
945070,True,0,2 user reviews,0,2,2
945080,True,0,No user reviews,0,0,0
945100,True,0,7 user reviews,7,0,7
945120,True,0,No user reviews,0,0,0
945130,True,0,No user reviews,0,0,0
945140,True,5,Mixed,18,10,28
945160,True,5,Mixed,11,6,17
945170,True,0,No user reviews,0,0,0
945180,True,0,No user reviews,0,0,0
945190,True,0,No user reviews,0,0,0
945200,True,0,No user reviews,0,0,0
945220,True,0,No user reviews,0,0,0
945230,True,0,No user reviews,0,0,0
945240,True,0,5 user reviews,5,0,5
945250,True,0,No user reviews,0,0,0
945280,True,0,5 user reviews,5,0,5
945310,True,0,No user reviews,0,0,0
945330,True,0,No user reviews,0,0,0
945340,True,7,Positive,16,2,18
945350,True,0,No user reviews,0,0,0
945360,True,9,Overwhelmingly Positive,168027,5771,173798
945370,True,0,No user reviews,0,0,0
945390,True,0,1 user reviews,1,0,1
945400,True,0,No user reviews,0,0,0
945401,True,0,No user reviews,0,0,0
945402,True,0,1 user reviews,1,0,1
945403,True,0,No user reviews,0,0,0
945404,True,0,No user reviews,0,0,0
945430,True,0,No user reviews,0,0,0
945440,True,8,Very Positive,78,6,84
945450,True,0,1 user reviews,1,0,1
945460,True,8,Very Positive,82,9,91
945480,True,0,2 user reviews,2,0,2
945481,True,0,No user reviews,0,0,0
945482,True,0,1 user reviews,1,0,1
945483,True,0,1 user reviews,1,0,1
945490,True,0,1 user reviews,1,0,1
945500,True,0,No user reviews,0,0,0
945520,True,0,No user reviews,0,0,0
945530,True,0,1 user reviews,1,0,1
945550,True,0,No user reviews,0,0,0
945570,True,0,No user reviews,0,0,0
945580,True,7,Positive,19,0,19
945590,True,0,5 user reviews,4,1,5
945610,True,0,No user reviews,0,0,0
945620,True,0,No user reviews,0,0,0
945630,True,0,No user reviews,0,0,0
945640,True,0,No user reviews,0,0,0
945680,True,6,Mostly Positive,36,15,51
945690,True,0,No user reviews,0,0,0
945700,True,0,8 user reviews,0,8,8
945710,True,6,Mostly Positive,304,105,409
945720,True,7,Positive,10,1,11
945740,True,0,No user reviews,0,0,0
945760,True,0,No user reviews,0,0,0
945770,True,0,No user reviews,0,0,0
945780,True,0,1 user reviews,1,0,1
945790,True,0,1 user reviews,1,0,1
945810,True,0,No user reviews,0,0,0
945820,True,0,1 user reviews,0,1,1
945830,True,6,Mostly Positive,10,3,13
945831,True,0,9 user reviews,4,5,9
945832,True,0,7 user reviews,6,1,7
945840,True,0,No user reviews,0,0,0
945850,True,0,No user reviews,0,0,0
945870,True,0,No user reviews,0,0,0
945880,True,0,No user reviews,0,0,0
945890,True,4,Mostly Negative,5,8,13
945910,True,0,2 user reviews,0,2,2
945920,True,0,No user reviews,0,0,0
945930,True,0,No user reviews,0,0,0
945931,True,0,No user reviews,0,0,0
945940,True,0,No user reviews,0,0,0
945950,True,0,4 user reviews,2,2,4
945970,True,0,No user reviews,0,0,0
945990,True,0,No user reviews,0,0,0
946000,True,7,Positive,10,1,11
946010,True,8,Very Positive,53,9,62
946040,True,0,No user reviews,0,0,0
946050,True,0,No user reviews,0,0,0
946060,True,0,No user reviews,0,0,0
946070,True,0,4 user reviews,2,2,4
946080,True,0,1 user reviews,1,0,1
946090,True,6,Mostly Positive,156,50,206
946110,True,8,Very Positive,42,10,52
946130,True,0,No user reviews,0,0,0
946140,True,0,No user reviews,0,0,0
946150,True,0,No user reviews,0,0,0
946160,True,0,No user reviews,0,0,0
946170,True,0,1 user reviews,1,0,1
946180,True,0,1 user reviews,1,0,1
946190,True,0,1 user reviews,1,0,1
946210,True,0,3 user reviews,0,3,3
946240,True,0,No user reviews,0,0,0
946250,True,0,No user reviews,0,0,0
946300,True,0,2 user reviews,2,0,2
946310,True,0,4 user reviews,4,0,4
946330,True,0,No user reviews,0,0,0
946340,True,0,6 user reviews,5,1,6
946350,True,0,No user reviews,0,0,0
946360,True,0,No user reviews,0,0,0
946370,True,0,No user reviews,0,0,0
946380,True,7,Positive,9,1,10
946390,True,0,No user reviews,0,0,0
946391,True,0,No user reviews,0,0,0
946392,True,0,No user reviews,0,0,0
946393,True,0,No user reviews,0,0,0
946394,True,0,No user reviews,0,0,0
946395,True,0,No user reviews,0,0,0
946396,True,0,No user reviews,0,0,0
946397,True,0,No user reviews,0,0,0
946398,True,0,No user reviews,0,0,0
946399,True,0,No user reviews,0,0,0
946400,True,0,1 user reviews,1,0,1
946420,True,0,No user reviews,0,0,0
946430,True,8,Very Positive,104,4,108
946440,True,0,No user reviews,0,0,0
946460,True,7,Positive,11,2,13
946500,True,0,3 user reviews,1,2,3
946520,True,0,No user reviews,0,0,0
946530,True,0,No user reviews,0,0,0
946550,True,5,Mixed,7,6,13
946560,True,7,Positive,34,2,36
946590,True,0,No user reviews,0,0,0
946600,True,3,Negative,3,19,22
946610,True,7,Positive,36,7,43
946620,True,0,No user reviews,0,0,0
946650,True,7,Positive,15,3,18
946660,True,8,Very Positive,77,14,91
946670,True,4,Mostly Negative,8,16,24
946680,True,0,No user reviews,0,0,0
946690,True,0,No user reviews,0,0,0
946700,True,5,Mixed,11,6,17
946710,True,0,No user reviews,0,0,0
946720,True,0,No user reviews,0,0,0
946740,True,0,No user reviews,0,0,0
946750,True,0,No user reviews,0,0,0
946770,True,0,No user reviews,0,0,0
946780,True,7,Positive,17,2,19
946790,True,0,No user reviews,0,0,0
946800,True,5,Mixed,13,8,21
946810,True,0,1 user reviews,0,1,1
946820,True,0,3 user reviews,3,0,3
946860,True,0,8 user reviews,8,0,8
946870,True,0,6 user reviews,6,0,6
946900,True,0,No user reviews,0,0,0
946901,True,0,No user reviews,0,0,0
946902,True,0,No user reviews,0,0,0
946910,True,0,No user reviews,0,0,0
946920,True,0,No user reviews,0,0,0
946930,True,0,1 user reviews,1,0,1
946940,True,0,1 user reviews,1,0,1
946950,True,0,1 user reviews,1,0,1
946960,True,0,No user reviews,0,0,0
946970,True,0,3 user reviews,3,0,3
946980,True,0,No user reviews,0,0,0
946990,True,5,Mixed,33,17,50
947000,True,8,Very Positive,46,7,53
947040,True,0,No user reviews,0,0,0
947060,True,0,2 user reviews,2,0,2
947070,True,0,2 user reviews,2,0,2
947080,True,0,No user reviews,0,0,0
947110,True,0,No user reviews,0,0,0
947120,True,0,No user reviews,0,0,0
947130,True,0,No user reviews,0,0,0
947230,True,0,No user reviews,0,0,0
947240,True,0,No user reviews,0,0,0
947250,True,0,2 user reviews,2,0,2
947260,True,0,2 user reviews,2,0,2
947270,True,0,1 user reviews,0,1,1
947290,True,0,7 user reviews,6,1,7
947300,True,8,Very Positive,398,53,451
947310,True,0,1 user reviews,0,1,1
947320,True,0,No user reviews,0,0,0
947330,True,0,1 user reviews,1,0,1
947340,True,0,No user reviews,0,0,0
947350,True,0,No user reviews,0,0,0
947360,True,0,2 user reviews,2,0,2
947390,True,0,3 user reviews,2,1,3
947400,True,0,1 user reviews,1,0,1
947430,True,0,1 user reviews,1,0,1
947450,True,0,7 user reviews,7,0,7
947460,True,0,No user reviews,0,0,0
947470,True,0,1 user reviews,0,1,1
947490,True,0,3 user reviews,2,1,3
947510,True,6,Mostly Positive,580,239,819
947530,True,0,No user reviews,0,0,0
947540,True,0,No user reviews,0,0,0
947550,True,0,2 user reviews,2,0,2
947560,True,0,No user reviews,0,0,0
947580,True,0,No user reviews,0,0,0
947590,True,0,No user reviews,0,0,0
947600,True,8,Very Positive,244,28,272
947610,True,0,No user reviews,0,0,0
947620,True,0,No user reviews,0,0,0
947640,True,0,No user reviews,0,0,0
947650,True,8,Very Positive,94,2,96
947660,True,7,Positive,34,0,34
947670,True,7,Positive,27,0,27
947680,True,0,2 user reviews,2,0,2
947690,True,0,No user reviews,0,0,0
947700,True,0,6 user reviews,6,0,6
947710,True,0,No user reviews,0,0,0
947720,True,0,No user reviews,0,0,0
947730,True,0,1 user reviews,1,0,1
947740,True,0,No user reviews,0,0,0
947741,True,0,No user reviews,0,0,0
947750,True,0,No user reviews,0,0,0
947760,True,0,No user reviews,0,0,0
947770,True,0,No user reviews,0,0,0
947800,True,0,No user reviews,0,0,0
947810,True,0,No user reviews,0,0,0
947820,True,7,Positive,11,0,11
947830,True,0,2 user reviews,1,1,2
947870,True,0,No user reviews,0,0,0
947880,True,0,1 user reviews,1,0,1
947890,True,0,No user reviews,0,0,0
947910,True,0,No user reviews,0,0,0
947920,True,0,No user reviews,0,0,0
947930,True,7,Positive,15,3,18
947940,True,0,No user reviews,0,0,0
947950,True,0,5 user reviews,3,2,5
947960,True,0,2 user reviews,2,0,2
947970,True,0,7 user reviews,5,2,7
947980,True,0,No user reviews,0,0,0
948000,True,0,No user reviews,0,0,0
948020,True,7,Positive,19,2,21
948070,True,0,2 user reviews,1,1,2
948080,True,0,No user reviews,0,0,0
948100,True,0,5 user reviews,5,0,5
948110,True,0,No user reviews,0,0,0
948120,True,0,3 user reviews,0,3,3
948200,True,0,2 user reviews,0,2,2
948220,True,6,Mostly Positive,11,3,14
948230,True,0,No user reviews,0,0,0
948240,True,0,8 user reviews,8,0,8
948250,True,0,1 user reviews,1,0,1
948270,True,0,No user reviews,0,0,0
948320,True,6,Mostly Positive,28,12,40
948330,True,0,2 user reviews,1,1,2
948340,True,0,No user reviews,0,0,0
948350,True,0,No user reviews,0,0,0
948360,True,0,1 user reviews,1,0,1
948361,True,0,No user reviews,0,0,0
948370,True,0,No user reviews,0,0,0
948380,True,0,No user reviews,0,0,0
948390,True,0,No user reviews,0,0,0
948410,True,0,No user reviews,0,0,0
948411,True,0,No user reviews,0,0,0
948420,True,0,No user reviews,0,0,0
948430,True,7,Positive,14,1,15
948440,True,0,No user reviews,0,0,0
948460,True,0,No user reviews,0,0,0
948470,True,5,Mixed,9,7,16
948490,True,0,No user reviews,0,0,0
948510,True,0,No user reviews,0,0,0
948540,True,0,No user reviews,0,0,0
948541,True,0,No user reviews,0,0,0
948542,True,0,No user reviews,0,0,0
948550,True,0,No user reviews,0,0,0
948570,True,0,No user reviews,0,0,0
948571,True,0,No user reviews,0,0,0
948572,True,0,No user reviews,0,0,0
948590,True,0,No user reviews,0,0,0
948600,True,0,No user reviews,0,0,0
948620,True,0,No user reviews,0,0,0
948621,True,0,No user reviews,0,0,0
948630,True,8,Very Positive,344,48,392
948640,True,6,Mostly Positive,99,32,131
948650,True,0,2 user reviews,1,1,2
948660,True,0,2 user reviews,1,1,2
948670,True,0,No user reviews,0,0,0
948680,True,8,Very Positive,161,17,178
948690,True,0,1 user reviews,0,1,1
948710,True,6,Mostly Positive,8,3,11
948720,True,0,9 user reviews,5,4,9
948730,True,0,3 user reviews,2,1,3
948740,True,8,Very Positive,1095,76,1171
948750,True,0,No user reviews,0,0,0
948770,True,0,2 user reviews,2,0,2
948780,True,0,No user reviews,0,0,0
948790,True,0,No user reviews,0,0,0
948810,True,0,No user reviews,0,0,0
948830,True,0,3 user reviews,3,0,3
948840,True,0,No user reviews,0,0,0
948850,True,0,No user reviews,0,0,0
948880,True,0,No user reviews,0,0,0
948900,True,8,Very Positive,71,6,77
948910,True,0,No user reviews,0,0,0
948930,True,0,No user reviews,0,0,0
948940,True,0,No user reviews,0,0,0
948950,True,0,No user reviews,0,0,0
948960,True,7,Positive,24,6,30
948970,True,0,No user reviews,0,0,0
948990,True,7,Positive,10,0,10
949000,True,0,No user reviews,0,0,0
949030,True,7,Positive,17,2,19
949050,True,0,No user reviews,0,0,0
949060,True,0,No user reviews,0,0,0
949070,True,0,5 user reviews,4,1,5
949080,True,7,Positive,18,3,21
949081,True,6,Mostly Positive,10,3,13
949090,True,0,No user reviews,0,0,0
949130,True,0,No user reviews,0,0,0
949150,True,0,6 user reviews,5,1,6
949160,True,0,No user reviews,0,0,0
949170,True,0,3 user reviews,1,2,3
949200,True,0,No user reviews,0,0,0
949210,True,5,Mixed,11,5,16
949221,True,0,2 user reviews,1,1,2
949250,True,0,3 user reviews,3,0,3
949260,True,0,No user reviews,0,0,0
949261,True,0,No user reviews,0,0,0
949280,True,0,No user reviews,0,0,0
949281,True,0,No user reviews,0,0,0
949290,True,8,Very Positive,273,11,284
949300,True,0,No user reviews,0,0,0
949301,True,0,No user reviews,0,0,0
949302,True,0,No user reviews,0,0,0
949303,True,0,No user reviews,0,0,0
949304,True,0,No user reviews,0,0,0
949305,True,0,No user reviews,0,0,0
949330,True,0,No user reviews,0,0,0
949340,True,0,No user reviews,0,0,0
949350,True,0,No user reviews,0,0,0
949360,True,0,No user reviews,0,0,0
949361,True,0,No user reviews,0,0,0
949370,True,0,No user reviews,0,0,0
949380,True,0,No user reviews,0,0,0
949390,True,0,No user reviews,0,0,0
949400,True,0,No user reviews,0,0,0
949420,True,0,No user reviews,0,0,0
949430,True,0,No user reviews,0,0,0
949440,True,0,No user reviews,0,0,0
949450,True,0,2 user reviews,2,0,2
949490,True,0,No user reviews,0,0,0
949491,True,0,No user reviews,0,0,0
949492,True,0,No user reviews,0,0,0
949494,True,0,No user reviews,0,0,0
949495,True,0,No user reviews,0,0,0
949500,True,5,Mixed,17,8,25
949510,True,0,1 user reviews,0,1,1
949520,True,0,1 user reviews,0,1,1
949530,True,6,Mostly Positive,18,5,23
949550,True,0,No user reviews,0,0,0
949570,True,0,No user reviews,0,0,0
949600,True,8,Very Positive,91,2,93
949610,True,0,1 user reviews,1,0,1
949630,True,5,Mixed,11,7,18
949640,True,0,2 user reviews,2,0,2
949641,True,0,1 user reviews,1,0,1
949642,True,0,1 user reviews,1,0,1
949650,True,0,8 user reviews,8,0,8
949660,True,0,No user reviews,0,0,0
949661,True,0,No user reviews,0,0,0
949662,True,0,No user reviews,0,0,0
949663,True,0,No user reviews,0,0,0
949664,True,0,No user reviews,0,0,0
949665,True,0,No user reviews,0,0,0
949670,True,7,Positive,12,1,13
949680,True,0,8 user reviews,4,4,8
949690,True,0,No user reviews,0,0,0
949700,True,0,2 user reviews,1,1,2
949710,True,0,3 user reviews,0,3,3
949720,True,0,No user reviews,0,0,0
949730,True,0,No user reviews,0,0,0
949740,True,0,No user reviews,0,0,0
949750,True,0,2 user reviews,1,1,2
949760,True,0,No user reviews,0,0,0
949770,True,7,Positive,15,1,16
949780,True,0,1 user reviews,1,0,1
949790,True,7,Positive,37,5,42
949800,True,5,Mixed,10,6,16
949810,True,0,5 user reviews,1,4,5
949820,True,0,3 user reviews,3,0,3
949830,True,0,No user reviews,0,0,0
949860,True,0,No user reviews,0,0,0
949870,True,7,Positive,29,7,36
949880,True,0,8 user reviews,4,4,8
949890,True,0,4 user reviews,3,1,4
949900,True,0,No user reviews,0,0,0
949910,True,0,No user reviews,0,0,0
949930,True,0,1 user reviews,0,1,1
949960,True,0,9 user reviews,3,6,9
949970,True,0,3 user reviews,2,1,3
949990,True,7,Positive,10,2,12
950050,True,6,Mostly Positive,41,13,54
950080,True,0,No user reviews,0,0,0
950100,True,0,No user reviews,0,0,0
950130,True,0,4 user reviews,3,1,4
950140,True,7,Positive,30,3,33
950150,True,0,No user reviews,0,0,0
950160,True,0,3 user reviews,1,2,3
950180,True,0,No user reviews,0,0,0
950200,True,0,1 user reviews,1,0,1
950210,True,6,Mostly Positive,21,7,28
950240,True,0,No user reviews,0,0,0
950250,True,0,No user reviews,0,0,0
950260,True,0,No user reviews,0,0,0
950270,True,0,No user reviews,0,0,0
950271,True,0,No user reviews,0,0,0
950290,True,0,No user reviews,0,0,0
950300,True,7,Positive,38,3,41
950310,True,0,6 user reviews,6,0,6
950330,True,0,1 user reviews,0,1,1
950360,True,5,Mixed,17,18,35
950370,True,0,8 user reviews,4,4,8
950380,True,0,No user reviews,0,0,0
950400,True,5,Mixed,8,7,15
950460,True,0,No user reviews,0,0,0
950490,True,0,1 user reviews,1,0,1
950500,True,0,No user reviews,0,0,0
950510,True,0,1 user reviews,0,1,1
950530,True,0,1 user reviews,1,0,1
950556,True,0,6 user reviews,6,0,6
950557,True,6,Mostly Positive,11,3,14
950558,True,7,Positive,9,1,10
950559,True,0,8 user reviews,6,2,8
950560,True,0,7 user reviews,7,0,7
950561,True,0,5 user reviews,5,0,5
950562,True,0,7 user reviews,5,2,7
950570,True,0,No user reviews,0,0,0
950580,True,0,No user reviews,0,0,0
950590,True,0,1 user reviews,1,0,1
950600,True,0,No user reviews,0,0,0
950620,True,0,No user reviews,0,0,0
950630,True,0,No user reviews,0,0,0
950640,True,0,No user reviews,0,0,0
950670,True,5,Mixed,1332,855,2187
950680,True,0,No user reviews,0,0,0
950690,True,0,No user reviews,0,0,0
950700,True,5,Mixed,14,9,23
950730,True,0,No user reviews,0,0,0
950740,True,8,Very Positive,93,13,106
950750,True,0,1 user reviews,1,0,1
950760,True,7,Positive,10,0,10
950770,True,0,No user reviews,0,0,0
950780,True,0,No user reviews,0,0,0
950810,True,0,5 user reviews,3,2,5
950820,True,7,Positive,18,2,20
950850,True,7,Positive,18,3,21
950860,True,0,1 user reviews,1,0,1
950880,True,0,No user reviews,0,0,0
950890,True,0,3 user reviews,3,0,3
950910,True,0,No user reviews,0,0,0
950920,True,0,No user reviews,0,0,0
950940,True,0,No user reviews,0,0,0
950950,True,0,1 user reviews,0,1,1
950980,True,0,No user reviews,0,0,0
950990,True,5,Mixed,45,24,69
951000,True,8,Very Positive,305,18,323
951010,True,0,4 user reviews,3,1,4
951030,True,0,5 user reviews,3,2,5
951040,True,0,No user reviews,0,0,0
951050,True,0,2 user reviews,2,0,2
951070,True,0,No user reviews,0,0,0
951100,True,0,No user reviews,0,0,0
951110,True,0,2 user reviews,1,1,2
951130,True,0,2 user reviews,2,0,2
951140,True,0,4 user reviews,3,1,4
951160,True,0,1 user reviews,0,1,1
951170,True,0,No user reviews,0,0,0
951190,True,0,3 user reviews,3,0,3
951210,True,0,No user reviews,0,0,0
951220,True,0,2 user reviews,2,0,2
951240,True,6,Mostly Positive,22,7,29
951250,True,0,No user reviews,0,0,0
951260,True,6,Mostly Positive,75,19,94
951310,True,0,No user reviews,0,0,0
951320,True,0,5 user reviews,1,4,5
951330,True,6,Mostly Positive,26,8,34
951350,True,0,1 user reviews,1,0,1
951360,True,0,3 user reviews,2,1,3
951370,True,7,Positive,12,3,15
951400,True,0,No user reviews,0,0,0
951410,True,0,No user reviews,0,0,0
951420,True,0,1 user reviews,1,0,1
951430,True,8,Very Positive,88,12,100
951440,True,8,Very Positive,692,145,837
951450,True,0,4 user reviews,2,2,4
951460,True,7,Positive,14,1,15
951470,True,0,No user reviews,0,0,0
951490,True,0,No user reviews,0,0,0
951500,True,0,6 user reviews,1,5,6
951510,True,0,9 user reviews,5,4,9
951530,True,0,No user reviews,0,0,0
951550,True,0,1 user reviews,0,1,1
951560,True,0,No user reviews,0,0,0
951570,True,0,No user reviews,0,0,0
951610,True,0,2 user reviews,2,0,2
951640,True,5,Mixed,6,6,12
951650,True,7,Positive,32,1,33
951660,True,0,3 user reviews,3,0,3
951661,True,0,No user reviews,0,0,0
951664,True,0,1 user reviews,1,0,1
951668,True,0,No user reviews,0,0,0
951670,True,8,Very Positive,144,29,173
951680,True,0,9 user reviews,7,2,9
951690,True,0,No user reviews,0,0,0
951700,True,0,9 user reviews,8,1,9
951740,True,7,Positive,34,5,39
951750,True,7,Positive,22,1,23
951760,True,0,6 user reviews,1,5,6
951770,True,0,No user reviews,0,0,0
951780,True,0,2 user reviews,0,2,2
951790,True,0,No user reviews,0,0,0
951800,True,0,No user reviews,0,0,0
951820,True,0,No user reviews,0,0,0
951830,True,7,Positive,10,0,10
951840,True,0,No user reviews,0,0,0
951850,True,0,No user reviews,0,0,0
951860,True,0,No user reviews,0,0,0
951870,True,0,2 user reviews,1,1,2
951910,True,0,No user reviews,0,0,0
951920,True,0,1 user reviews,0,1,1
951930,True,0,No user reviews,0,0,0
951940,True,7,Positive,21,4,25
951950,True,0,No user reviews,0,0,0
951980,True,0,No user reviews,0,0,0
952000,True,0,No user reviews,0,0,0
952010,True,0,8 user reviews,4,4,8
952020,True,5,Mixed,6,8,14
952030,True,0,8 user reviews,1,7,8
952040,True,8,Very Positive,343,54,397
952050,True,0,9 user reviews,9,0,9
952060,True,6,Mostly Positive,6305,2156,8461
952070,True,5,Mixed,491,669,1160
952080,True,7,Positive,8,2,10
952090,True,0,No user reviews,0,0,0
952120,True,0,No user reviews,0,0,0
952130,True,0,5 user reviews,5,0,5
952140,True,0,No user reviews,0,0,0
952150,True,0,No user reviews,0,0,0
952170,True,0,No user reviews,0,0,0
952180,True,0,No user reviews,0,0,0
952200,True,7,Positive,40,5,45
952210,True,0,No user reviews,0,0,0
952230,True,0,3 user reviews,2,1,3
952240,True,0,No user reviews,0,0,0
952250,True,0,No user reviews,0,0,0
952270,True,0,No user reviews,0,0,0
952290,True,0,9 user reviews,9,0,9
952320,True,0,No user reviews,0,0,0
952330,True,0,2 user reviews,2,0,2
952340,True,0,No user reviews,0,0,0
952370,True,0,No user reviews,0,0,0
952390,True,0,4 user reviews,1,3,4
952400,True,0,9 user reviews,7,2,9
952410,True,0,No user reviews,0,0,0
952420,True,7,Positive,10,0,10
952430,True,0,No user reviews,0,0,0
952440,True,0,No user reviews,0,0,0
952460,True,5,Mixed,11,6,17
952480,True,0,No user reviews,0,0,0
952490,True,7,Positive,12,0,12
952500,True,0,No user reviews,0,0,0
952510,True,0,No user reviews,0,0,0
952540,True,8,Very Positive,63,7,70
952560,True,0,No user reviews,0,0,0
952570,True,0,3 user reviews,1,2,3
952630,True,0,No user reviews,0,0,0
952640,True,0,No user reviews,0,0,0
952650,True,0,3 user reviews,1,2,3
952651,True,0,1 user reviews,0,1,1
952652,True,0,No user reviews,0,0,0
952670,True,0,3 user reviews,3,0,3
952671,True,0,No user reviews,0,0,0
952680,True,0,1 user reviews,0,1,1
952690,True,0,No user reviews,0,0,0
952700,True,0,No user reviews,0,0,0
952710,True,0,No user reviews,0,0,0
952740,True,0,No user reviews,0,0,0
952741,True,0,No user reviews,0,0,0
952742,True,0,No user reviews,0,0,0
952743,True,0,No user reviews,0,0,0
952770,True,0,No user reviews,0,0,0
952780,True,0,No user reviews,0,0,0
952781,True,0,No user reviews,0,0,0
952782,True,0,No user reviews,0,0,0
952783,True,0,No user reviews,0,0,0
952784,True,0,No user reviews,0,0,0
952785,True,0,No user reviews,0,0,0
952786,True,0,No user reviews,0,0,0
952787,True,0,No user reviews,0,0,0
952788,True,0,No user reviews,0,0,0
952789,True,0,No user reviews,0,0,0
952790,True,0,No user reviews,0,0,0
952791,True,0,No user reviews,0,0,0
952792,True,0,No user reviews,0,0,0
952793,True,0,No user reviews,0,0,0
952794,True,0,No user reviews,0,0,0
952795,True,0,No user reviews,0,0,0
952796,True,0,No user reviews,0,0,0
952797,True,0,No user reviews,0,0,0
952798,True,0,No user reviews,0,0,0
952799,True,0,No user reviews,0,0,0
952800,True,0,No user reviews,0,0,0
952801,True,0,No user reviews,0,0,0
952802,True,0,No user reviews,0,0,0
952803,True,0,No user reviews,0,0,0
952804,True,0,No user reviews,0,0,0
952805,True,0,No user reviews,0,0,0
952806,True,0,No user reviews,0,0,0
952807,True,0,No user reviews,0,0,0
952808,True,0,No user reviews,0,0,0
952809,True,0,No user reviews,0,0,0
952810,True,0,No user reviews,0,0,0
952811,True,0,No user reviews,0,0,0
952812,True,0,No user reviews,0,0,0
952813,True,0,No user reviews,0,0,0
952814,True,0,No user reviews,0,0,0
952815,True,0,No user reviews,0,0,0
952816,True,0,No user reviews,0,0,0
952817,True,0,No user reviews,0,0,0
952818,True,0,No user reviews,0,0,0
952819,True,0,No user reviews,0,0,0
952820,True,0,No user reviews,0,0,0
952850,True,0,No user reviews,0,0,0
952860,True,8,Very Positive,143,33,176
952870,True,0,No user reviews,0,0,0
952890,True,8,Very Positive,70,12,82
952891,True,7,Positive,23,1,24
952892,True,7,Positive,14,0,14
952900,True,0,1 user reviews,1,0,1
952910,True,0,1 user reviews,1,0,1
952920,True,0,9 user reviews,6,3,9
952930,True,0,5 user reviews,3,2,5
952940,True,0,No user reviews,0,0,0
952950,True,6,Mostly Positive,42,12,54
952960,True,0,No user reviews,0,0,0
952970,True,0,No user reviews,0,0,0
952980,True,0,No user reviews,0,0,0
953000,True,0,No user reviews,0,0,0
953010,True,0,No user reviews,0,0,0
953020,True,0,4 user reviews,1,3,4
953050,True,0,9 user reviews,1,8,9
953060,True,5,Mixed,5,6,11
953080,True,7,Positive,12,0,12
953094,True,0,No user reviews,0,0,0
953095,True,0,No user reviews,0,0,0
953096,True,0,No user reviews,0,0,0
953101,True,0,No user reviews,0,0,0
953106,True,0,No user reviews,0,0,0
953110,True,0,No user reviews,0,0,0
953120,True,0,1 user reviews,0,1,1
953140,True,0,No user reviews,0,0,0
953150,True,0,2 user reviews,1,1,2
953160,True,0,No user reviews,0,0,0
953170,True,0,No user reviews,0,0,0
953190,True,0,1 user reviews,0,1,1
953210,True,0,No user reviews,0,0,0
953220,True,0,1 user reviews,1,0,1
953230,True,8,Very Positive,82,7,89
953240,True,0,2 user reviews,1,1,2
953250,True,0,No user reviews,0,0,0
953270,True,7,Positive,34,5,39
953290,True,0,No user reviews,0,0,0
953310,True,0,No user reviews,0,0,0
953340,True,0,1 user reviews,1,0,1
953350,True,0,No user reviews,0,0,0
953370,True,5,Mixed,47,33,80
953380,True,0,No user reviews,0,0,0
953390,True,0,No user reviews,0,0,0
953400,True,0,No user reviews,0,0,0
953440,True,0,No user reviews,0,0,0
953450,True,7,Positive,19,1,20
953490,True,8,Very Positive,4611,322,4933
953510,True,0,No user reviews,0,0,0
953550,True,0,No user reviews,0,0,0
953560,True,0,No user reviews,0,0,0
953570,True,0,No user reviews,0,0,0
953580,True,5,Mixed,191,136,327
953610,True,0,9 user reviews,5,4,9
953630,True,0,No user reviews,0,0,0
953631,True,0,No user reviews,0,0,0
953632,True,0,No user reviews,0,0,0
953633,True,0,No user reviews,0,0,0
953634,True,0,No user reviews,0,0,0
953635,True,0,No user reviews,0,0,0
953636,True,0,No user reviews,0,0,0
953637,True,0,No user reviews,0,0,0
953638,True,0,No user reviews,0,0,0
953639,True,0,No user reviews,0,0,0
953640,True,0,1 user reviews,0,1,1
953650,True,0,No user reviews,0,0,0
953660,True,6,Mostly Positive,31,13,44
953670,True,0,No user reviews,0,0,0
953671,True,0,No user reviews,0,0,0
953672,True,0,No user reviews,0,0,0
953673,True,0,No user reviews,0,0,0
953674,True,0,No user reviews,0,0,0
953675,True,0,No user reviews,0,0,0
953676,True,0,No user reviews,0,0,0
953680,True,0,No user reviews,0,0,0
953681,True,0,4 user reviews,3,1,4
953682,True,0,No user reviews,0,0,0
953690,True,7,Positive,11,2,13
953700,True,0,1 user reviews,1,0,1
953720,True,0,No user reviews,0,0,0
953721,True,0,No user reviews,0,0,0
953722,True,0,No user reviews,0,0,0
953723,True,0,No user reviews,0,0,0
953724,True,0,No user reviews,0,0,0
953725,True,0,No user reviews,0,0,0
953726,True,0,No user reviews,0,0,0
953727,True,0,No user reviews,0,0,0
953728,True,0,No user reviews,0,0,0
953729,True,0,No user reviews,0,0,0
953730,True,0,No user reviews,0,0,0
953740,True,0,5 user reviews,3,2,5
953750,True,0,1 user reviews,0,1,1
953760,True,0,No user reviews,0,0,0
953780,True,0,No user reviews,0,0,0
953790,True,0,1 user reviews,0,1,1
953800,True,0,1 user reviews,1,0,1
953810,True,0,No user reviews,0,0,0
953820,True,0,4 user reviews,4,0,4
953830,True,0,No user reviews,0,0,0
953840,True,6,Mostly Positive,87,22,109
953860,True,0,No user reviews,0,0,0
953870,True,5,Mixed,30,16,46
953880,True,0,No user reviews,0,0,0
953900,True,7,Positive,20,4,24
953910,True,0,No user reviews,0,0,0
953920,True,0,1 user reviews,1,0,1
953940,True,6,Mostly Positive,91,28,119
953950,True,0,6 user reviews,6,0,6
953980,True,0,3 user reviews,2,1,3
953981,True,0,6 user reviews,2,4,6
953990,True,5,Mixed,13,6,19
954000,True,5,Mixed,9,6,15
954010,True,0,4 user reviews,4,0,4
954020,True,0,No user reviews,0,0,0
954030,True,0,9 user reviews,7,2,9
954060,True,8,Very Positive,82,3,85
954070,True,0,No user reviews,0,0,0
954080,True,6,Mostly Positive,21,9,30
954090,True,0,No user reviews,0,0,0
954100,True,0,No user reviews,0,0,0
954101,True,0,5 user reviews,4,1,5
954102,True,0,No user reviews,0,0,0
954103,True,7,Positive,11,0,11
954110,True,0,No user reviews,0,0,0
954120,True,0,No user reviews,0,0,0
954130,True,0,No user reviews,0,0,0
954140,True,0,No user reviews,0,0,0
954150,True,7,Positive,22,4,26
954160,True,0,No user reviews,0,0,0
954170,True,0,No user reviews,0,0,0
954200,True,0,No user reviews,0,0,0
954210,True,0,No user reviews,0,0,0
954220,True,0,No user reviews,0,0,0
954221,True,0,No user reviews,0,0,0
954230,True,0,No user reviews,0,0,0
954240,True,0,3 user reviews,3,0,3
954250,True,0,No user reviews,0,0,0
954270,True,7,Positive,17,4,21
954280,True,8,Very Positive,62,5,67
954290,True,0,No user reviews,0,0,0
954310,True,0,No user reviews,0,0,0
954320,True,0,No user reviews,0,0,0
954350,True,0,No user reviews,0,0,0
954360,True,0,No user reviews,0,0,0
954370,True,0,No user reviews,0,0,0
954400,True,0,No user reviews,0,0,0
954410,True,0,No user reviews,0,0,0
954420,True,0,2 user reviews,2,0,2
954460,True,0,No user reviews,0,0,0
954480,True,0,No user reviews,0,0,0
954510,True,0,No user reviews,0,0,0
954530,True,5,Mixed,7,7,14
954540,True,0,No user reviews,0,0,0
954550,True,0,No user reviews,0,0,0
954560,True,7,Positive,14,1,15
954590,True,7,Positive,13,2,15
954600,True,0,2 user reviews,2,0,2
954601,True,0,1 user reviews,1,0,1
954602,True,0,5 user reviews,4,1,5
954603,True,0,9 user reviews,7,2,9
954604,True,0,No user reviews,0,0,0
954605,True,0,No user reviews,0,0,0
954606,True,0,1 user reviews,1,0,1
954607,True,0,No user reviews,0,0,0
954609,True,0,1 user reviews,1,0,1
954610,True,6,Mostly Positive,131,50,181
954620,True,0,No user reviews,0,0,0
954630,True,0,No user reviews,0,0,0
954650,True,8,Very Positive,543,100,643
954670,True,0,No user reviews,0,0,0
954680,True,0,No user reviews,0,0,0
954690,True,0,4 user reviews,4,0,4
954710,True,0,No user reviews,0,0,0
954720,True,0,8 user reviews,5,3,8
954730,True,0,No user reviews,0,0,0
954740,True,8,Very Positive,2682,208,2890
954760,True,0,No user reviews,0,0,0
954770,True,0,No user reviews,0,0,0
954780,True,0,No user reviews,0,0,0
954800,True,0,1 user reviews,1,0,1
954810,True,5,Mixed,10,6,16
954820,True,0,No user reviews,0,0,0
954860,True,0,8 user reviews,7,1,8
954870,True,8,Very Positive,316,40,356
954880,True,6,Mostly Positive,12,4,16
954920,True,0,2 user reviews,2,0,2
954940,True,0,No user reviews,0,0,0
954950,True,0,1 user reviews,1,0,1
954960,True,0,No user reviews,0,0,0
954970,True,0,2 user reviews,0,2,2
955020,True,0,No user reviews,0,0,0
955030,True,0,No user reviews,0,0,0
955050,True,8,Very Positive,3494,333,3827
955060,True,5,Mixed,187,111,298
955070,True,5,Mixed,5,7,12
955080,True,0,No user reviews,0,0,0
955090,True,0,No user reviews,0,0,0
955120,True,0,1 user reviews,1,0,1
955130,True,7,Positive,28,2,30
955140,True,0,No user reviews,0,0,0
955170,True,0,4 user reviews,3,1,4
955180,True,0,2 user reviews,2,0,2
955181,True,0,No user reviews,0,0,0
955182,True,0,1 user reviews,1,0,1
955190,True,0,4 user reviews,4,0,4
955210,True,0,1 user reviews,1,0,1
955240,True,0,No user reviews,0,0,0
955250,True,0,6 user reviews,5,1,6
955260,True,0,9 user reviews,7,2,9
955290,True,0,No user reviews,0,0,0
955300,True,0,1 user reviews,0,1,1
955320,True,8,Very Positive,61,4,65
955360,True,5,Mixed,5,5,10
955370,True,7,Positive,10,1,11
955380,True,0,6 user reviews,1,5,6
955400,True,7,Positive,19,2,21
955410,True,7,Positive,10,0,10
955440,True,0,No user reviews,0,0,0
955470,True,7,Positive,23,2,25
955480,True,0,No user reviews,0,0,0
955490,True,0,4 user reviews,3,1,4
955500,True,0,No user reviews,0,0,0
955520,True,0,No user reviews,0,0,0
955530,True,0,No user reviews,0,0,0
955540,True,0,1 user reviews,1,0,1
955550,True,0,2 user reviews,2,0,2
955560,True,8,Very Positive,428,33,461
955570,True,0,1 user reviews,1,0,1
955580,True,5,Mixed,16,9,25
955590,True,0,1 user reviews,1,0,1
955600,True,0,3 user reviews,1,2,3
955610,True,0,3 user reviews,3,0,3
955620,True,0,No user reviews,0,0,0
955640,True,7,Positive,16,2,18
955650,True,0,No user reviews,0,0,0
955670,True,0,4 user reviews,3,1,4
955700,True,0,3 user reviews,3,0,3
955710,True,0,6 user reviews,6,0,6
955740,True,8,Very Positive,204,4,208
955750,True,0,No user reviews,0,0,0
955760,True,0,No user reviews,0,0,0
955780,True,0,No user reviews,0,0,0
955790,True,0,6 user reviews,6,0,6
955810,True,0,No user reviews,0,0,0
955830,True,0,2 user reviews,2,0,2
955840,True,0,1 user reviews,1,0,1
955860,True,0,3 user reviews,2,1,3
955870,True,0,No user reviews,0,0,0
955890,True,0,1 user reviews,0,1,1
955900,True,8,Very Positive,124,11,135
955910,True,0,No user reviews,0,0,0
955940,True,0,No user reviews,0,0,0
955950,True,0,No user reviews,0,0,0
955970,True,0,No user reviews,0,0,0
955980,True,0,1 user reviews,0,1,1
955990,True,0,3 user reviews,2,1,3
956000,True,0,1 user reviews,1,0,1
956010,True,7,Positive,9,2,11
956030,True,8,Very Positive,217,17,234
956060,True,4,Mostly Negative,9,15,24
956070,True,0,7 user reviews,7,0,7
956080,True,0,No user reviews,0,0,0
956090,True,0,5 user reviews,5,0,5
956100,True,0,6 user reviews,5,1,6
956120,True,0,No user reviews,0,0,0
956140,True,0,No user reviews,0,0,0
956150,True,0,2 user reviews,0,2,2
956200,True,0,3 user reviews,3,0,3
956210,True,0,4 user reviews,3,1,4
956220,True,0,No user reviews,0,0,0
956230,True,0,No user reviews,0,0,0
956240,True,0,1 user reviews,1,0,1
956260,True,0,No user reviews,0,0,0
956270,True,0,No user reviews,0,0,0
956280,True,0,No user reviews,0,0,0
956290,True,0,No user reviews,0,0,0
956300,True,0,No user reviews,0,0,0
956310,True,0,5 user reviews,5,0,5
956320,True,0,No user reviews,0,0,0
956330,True,0,No user reviews,0,0,0
956340,True,0,No user reviews,0,0,0
956350,True,0,2 user reviews,2,0,2
956360,True,0,5 user reviews,5,0,5
956380,True,0,5 user reviews,5,0,5
956390,True,0,1 user reviews,1,0,1
956400,True,0,1 user reviews,1,0,1
956430,True,0,2 user reviews,1,1,2
956440,True,0,No user reviews,0,0,0
956450,True,8,Very Positive,194,15,209
956460,True,0,No user reviews,0,0,0
956470,True,0,No user reviews,0,0,0
956480,True,0,4 user reviews,1,3,4
956490,True,0,No user reviews,0,0,0
956500,True,7,Positive,21,3,24
956540,True,0,No user reviews,0,0,0
956550,True,0,4 user reviews,2,2,4
956560,True,7,Positive,18,1,19
956580,True,0,No user reviews,0,0,0
956590,True,0,1 user reviews,0,1,1
956600,True,6,Mostly Positive,33,12,45
956610,True,0,No user reviews,0,0,0
956620,True,0,6 user reviews,5,1,6
956630,True,0,No user reviews,0,0,0
956640,True,0,2 user reviews,2,0,2
956650,True,0,1 user reviews,1,0,1
956680,True,8,Very Positive,714,82,796
956700,True,0,No user reviews,0,0,0
956701,True,0,No user reviews,0,0,0
956702,True,0,No user reviews,0,0,0
956703,True,0,No user reviews,0,0,0
956704,True,0,No user reviews,0,0,0
956705,True,0,No user reviews,0,0,0
956706,True,0,No user reviews,0,0,0
956707,True,0,No user reviews,0,0,0
956708,True,0,No user reviews,0,0,0
956709,True,0,No user reviews,0,0,0
956720,True,0,No user reviews,0,0,0
956721,True,0,No user reviews,0,0,0
956722,True,0,No user reviews,0,0,0
956723,True,0,No user reviews,0,0,0
956724,True,0,No user reviews,0,0,0
956725,True,0,No user reviews,0,0,0
956726,True,0,1 user reviews,1,0,1
956727,True,0,No user reviews,0,0,0
956728,True,0,No user reviews,0,0,0
956729,True,0,No user reviews,0,0,0
956730,True,0,No user reviews,0,0,0
956731,True,0,No user reviews,0,0,0
956732,True,0,No user reviews,0,0,0
956733,True,0,No user reviews,0,0,0
956734,True,0,No user reviews,0,0,0
956735,True,0,No user reviews,0,0,0
956736,True,0,No user reviews,0,0,0
956737,True,0,No user reviews,0,0,0
956738,True,0,No user reviews,0,0,0
956739,True,0,No user reviews,0,0,0
956750,True,0,No user reviews,0,0,0
956751,True,0,No user reviews,0,0,0
956752,True,0,No user reviews,0,0,0
956753,True,0,No user reviews,0,0,0
956760,True,0,No user reviews,0,0,0
956761,True,0,No user reviews,0,0,0
956762,True,0,No user reviews,0,0,0
956763,True,0,No user reviews,0,0,0
956764,True,0,No user reviews,0,0,0
956765,True,0,No user reviews,0,0,0
956766,True,0,No user reviews,0,0,0
956767,True,0,No user reviews,0,0,0
956768,True,0,No user reviews,0,0,0
956769,True,0,1 user reviews,1,0,1
956770,True,0,No user reviews,0,0,0
956771,True,0,No user reviews,0,0,0
956772,True,0,No user reviews,0,0,0
956780,True,0,No user reviews,0,0,0
956840,True,0,No user reviews,0,0,0
956860,True,0,No user reviews,0,0,0
956861,True,0,No user reviews,0,0,0
956862,True,0,No user reviews,0,0,0
956863,True,0,No user reviews,0,0,0
956864,True,0,No user reviews,0,0,0
956865,True,0,No user reviews,0,0,0
956866,True,0,No user reviews,0,0,0
956867,True,0,No user reviews,0,0,0
956868,True,0,No user reviews,0,0,0
956869,True,0,No user reviews,0,0,0
956870,True,0,No user reviews,0,0,0
956880,True,0,No user reviews,0,0,0
956890,True,0,No user reviews,0,0,0
956891,True,0,No user reviews,0,0,0
956892,True,0,No user reviews,0,0,0
956893,True,0,No user reviews,0,0,0
956894,True,0,No user reviews,0,0,0
956895,True,0,No user reviews,0,0,0
956896,True,0,No user reviews,0,0,0
956897,True,0,No user reviews,0,0,0
956898,True,0,No user reviews,0,0,0
956899,True,0,No user reviews,0,0,0
956900,True,0,No user reviews,0,0,0
956920,True,0,No user reviews,0,0,0
956921,True,0,No user reviews,0,0,0
956922,True,0,No user reviews,0,0,0
956923,True,0,No user reviews,0,0,0
956924,True,0,No user reviews,0,0,0
956930,True,0,No user reviews,0,0,0
956940,True,0,No user reviews,0,0,0
956941,True,0,No user reviews,0,0,0
956942,True,0,No user reviews,0,0,0
956943,True,0,No user reviews,0,0,0
956944,True,0,No user reviews,0,0,0
956945,True,0,No user reviews,0,0,0
956946,True,0,No user reviews,0,0,0
956947,True,0,No user reviews,0,0,0
956948,True,0,No user reviews,0,0,0
956949,True,0,No user reviews,0,0,0
956990,True,0,2 user reviews,2,0,2
957040,True,0,No user reviews,0,0,0
957050,True,5,Mixed,28,38,66
957060,True,0,No user reviews,0,0,0
957070,True,0,9 user reviews,8,1,9
957080,True,0,5 user reviews,2,3,5
957090,True,0,No user reviews,0,0,0
957110,True,7,Positive,13,2,15
957120,True,0,8 user reviews,8,0,8
957122,True,0,3 user reviews,2,1,3
957124,True,0,4 user reviews,4,0,4
957126,True,0,7 user reviews,5,2,7
957130,True,0,No user reviews,0,0,0
957140,True,0,No user reviews,0,0,0
957150,True,0,No user reviews,0,0,0
957210,True,0,No user reviews,0,0,0
957220,True,0,No user reviews,0,0,0
957230,True,0,No user reviews,0,0,0
957270,True,0,No user reviews,0,0,0
957280,True,0,1 user reviews,1,0,1
957290,True,0,No user reviews,0,0,0
957300,True,0,No user reviews,0,0,0
957310,True,0,No user reviews,0,0,0
957320,True,0,No user reviews,0,0,0
957330,True,0,No user reviews,0,0,0
957340,True,0,No user reviews,0,0,0
957350,True,0,1 user reviews,1,0,1
957390,True,0,3 user reviews,2,1,3
957410,True,5,Mixed,8,8,16
957430,True,6,Mostly Positive,8,3,11
957440,True,6,Mostly Positive,12,4,16
957450,True,0,No user reviews,0,0,0
957490,True,0,No user reviews,0,0,0
957510,True,0,No user reviews,0,0,0
957530,True,0,1 user reviews,1,0,1
957531,True,0,No user reviews,0,0,0
957532,True,0,No user reviews,0,0,0
957533,True,0,No user reviews,0,0,0
957534,True,0,No user reviews,0,0,0
957535,True,0,No user reviews,0,0,0
957536,True,0,No user reviews,0,0,0
957537,True,0,1 user reviews,1,0,1
957538,True,0,1 user reviews,1,0,1
957539,True,0,No user reviews,0,0,0
957541,True,0,No user reviews,0,0,0
957570,True,0,7 user reviews,7,0,7
957590,True,0,No user reviews,0,0,0
957600,True,0,No user reviews,0,0,0
957601,True,0,No user reviews,0,0,0
957602,True,0,No user reviews,0,0,0
957603,True,0,No user reviews,0,0,0
957604,True,0,No user reviews,0,0,0
957605,True,0,No user reviews,0,0,0
957607,True,0,No user reviews,0,0,0
957610,True,0,No user reviews,0,0,0
957630,True,0,3 user reviews,3,0,3
957660,True,0,No user reviews,0,0,0
957680,True,0,8 user reviews,8,0,8
957690,True,6,Mostly Positive,142,55,197
957695,True,0,1 user reviews,1,0,1
957697,True,0,No user reviews,0,0,0
957698,True,0,No user reviews,0,0,0
957710,True,5,Mixed,67,38,105
957720,True,8,Very Positive,128,22,150
957730,True,0,1 user reviews,1,0,1
957733,True,0,No user reviews,0,0,0
957760,True,0,No user reviews,0,0,0
957761,True,0,No user reviews,0,0,0
957762,True,0,No user reviews,0,0,0
957770,True,0,3 user reviews,3,0,3
957780,True,5,Mixed,7,5,12
957790,True,6,Mostly Positive,530,168,698
957800,True,0,No user reviews,0,0,0
957810,True,0,No user reviews,0,0,0
957820,True,7,Positive,20,2,22
957830,True,0,No user reviews,0,0,0
957840,True,0,No user reviews,0,0,0
957850,True,0,3 user reviews,3,0,3
957880,True,0,No user reviews,0,0,0
957890,True,0,7 user reviews,6,1,7
957900,True,0,No user reviews,0,0,0
957901,True,0,No user reviews,0,0,0
957902,True,0,No user reviews,0,0,0
957903,True,0,No user reviews,0,0,0
957904,True,0,No user reviews,0,0,0
957905,True,0,No user reviews,0,0,0
957906,True,0,No user reviews,0,0,0
957910,True,0,No user reviews,0,0,0
957911,True,0,No user reviews,0,0,0
957912,True,0,No user reviews,0,0,0
957913,True,0,No user reviews,0,0,0
957914,True,0,No user reviews,0,0,0
957915,True,0,No user reviews,0,0,0
957916,True,0,No user reviews,0,0,0
957917,True,0,No user reviews,0,0,0
957919,True,0,No user reviews,0,0,0
957920,True,0,No user reviews,0,0,0
957921,True,0,No user reviews,0,0,0
957930,True,0,1 user reviews,0,1,1
957950,True,0,No user reviews,0,0,0
957960,True,0,No user reviews,0,0,0
957970,True,0,1 user reviews,0,1,1
957971,True,0,No user reviews,0,0,0
957972,True,0,No user reviews,0,0,0
957973,True,0,No user reviews,0,0,0
957974,True,0,No user reviews,0,0,0
957975,True,0,No user reviews,0,0,0
957976,True,0,No user reviews,0,0,0
957977,True,0,No user reviews,0,0,0
957978,True,0,No user reviews,0,0,0
957979,True,0,No user reviews,0,0,0
957980,True,0,No user reviews,0,0,0
957981,True,0,No user reviews,0,0,0
957982,True,0,No user reviews,0,0,0
957983,True,0,No user reviews,0,0,0
957984,True,0,No user reviews,0,0,0
957985,True,0,No user reviews,0,0,0
957986,True,0,No user reviews,0,0,0
957987,True,0,No user reviews,0,0,0
957988,True,0,No user reviews,0,0,0
957989,True,0,No user reviews,0,0,0
957990,True,0,No user reviews,0,0,0
957991,True,0,No user reviews,0,0,0
957992,True,0,No user reviews,0,0,0
957993,True,0,No user reviews,0,0,0
957994,True,0,No user reviews,0,0,0
957995,True,0,No user reviews,0,0,0
957996,True,0,No user reviews,0,0,0
957997,True,0,No user reviews,0,0,0
957998,True,0,No user reviews,0,0,0
957999,True,0,No user reviews,0,0,0
958000,True,0,No user reviews,0,0,0
958001,True,0,No user reviews,0,0,0
958010,True,0,No user reviews,0,0,0
958030,True,0,No user reviews,0,0,0
958050,True,7,Positive,20,3,23
958060,True,0,No user reviews,0,0,0
958070,True,0,No user reviews,0,0,0
958090,True,0,2 user reviews,2,0,2
958130,True,0,2 user reviews,0,2,2
958140,True,0,No user reviews,0,0,0
958150,True,0,No user reviews,0,0,0
958160,True,0,No user reviews,0,0,0
958190,True,0,No user reviews,0,0,0
958200,True,0,2 user reviews,2,0,2
958210,True,5,Mixed,14,7,21
958220,True,0,2 user reviews,2,0,2
958230,True,0,8 user reviews,1,7,8
958240,True,0,No user reviews,0,0,0
958250,True,0,No user reviews,0,0,0
958260,True,0,No user reviews,0,0,0
958280,True,5,Mixed,5,5,10
958290,True,0,No user reviews,0,0,0
958300,True,0,7 user reviews,5,2,7
958310,True,0,4 user reviews,2,2,4
958320,True,5,Mixed,46,27,73
958340,True,0,No user reviews,0,0,0
958360,True,0,No user reviews,0,0,0
958370,True,8,Very Positive,129,13,142
958380,True,0,2 user reviews,2,0,2
958381,True,0,2 user reviews,2,0,2
958390,True,0,No user reviews,0,0,0
958400,True,5,Mixed,244,214,458
958430,True,0,No user reviews,0,0,0
958440,True,0,No user reviews,0,0,0
958460,True,0,No user reviews,0,0,0
958480,True,6,Mostly Positive,196,57,253
958490,True,0,4 user reviews,3,1,4
958510,True,0,No user reviews,0,0,0
958530,True,0,No user reviews,0,0,0
958540,True,0,No user reviews,0,0,0
958570,True,0,No user reviews,0,0,0
958580,True,0,No user reviews,0,0,0
958590,True,0,No user reviews,0,0,0
958600,True,0,No user reviews,0,0,0
958640,True,0,1 user reviews,1,0,1
958650,True,0,No user reviews,0,0,0
958660,True,0,No user reviews,0,0,0
958680,True,0,No user reviews,0,0,0
958690,True,0,7 user reviews,7,0,7
958710,True,0,No user reviews,0,0,0
958711,True,0,No user reviews,0,0,0
958720,True,0,No user reviews,0,0,0
958730,True,0,2 user reviews,0,2,2
958740,True,8,Very Positive,47,10,57
958750,True,0,No user reviews,0,0,0
958760,True,0,No user reviews,0,0,0
958790,True,0,5 user reviews,5,0,5
958800,True,0,No user reviews,0,0,0
958820,True,0,No user reviews,0,0,0
958840,True,0,No user reviews,0,0,0
958870,True,0,1 user reviews,1,0,1
958880,True,7,Positive,18,2,20
958900,True,0,1 user reviews,0,1,1
958910,True,0,No user reviews,0,0,0
958930,True,0,No user reviews,0,0,0
958940,True,0,No user reviews,0,0,0
958950,True,0,1 user reviews,1,0,1
958960,True,0,6 user reviews,0,6,6
958970,True,0,No user reviews,0,0,0
958980,True,7,Positive,11,1,12
958990,True,0,2 user reviews,1,1,2
959000,True,7,Positive,33,2,35
959020,True,0,3 user reviews,3,0,3
959030,True,0,5 user reviews,3,2,5
959050,True,7,Positive,22,2,24
959060,True,0,1 user reviews,1,0,1
959070,True,0,No user reviews,0,0,0
959080,True,0,No user reviews,0,0,0
959090,True,0,2 user reviews,2,0,2
959110,True,0,No user reviews,0,0,0
959130,True,0,5 user reviews,4,1,5
959140,True,0,No user reviews,0,0,0
959150,True,7,Positive,12,2,14
959160,True,7,Positive,15,0,15
959170,True,0,No user reviews,0,0,0
959190,True,0,No user reviews,0,0,0
959200,True,0,8 user reviews,5,3,8
959210,True,0,No user reviews,0,0,0
959220,True,0,No user reviews,0,0,0
959230,True,0,No user reviews,0,0,0
959250,True,0,No user reviews,0,0,0
959260,True,0,2 user reviews,1,1,2
959280,True,0,No user reviews,0,0,0
959290,True,0,No user reviews,0,0,0
959320,True,0,No user reviews,0,0,0
959340,True,0,1 user reviews,0,1,1
959350,True,7,Positive,11,1,12
959380,True,0,No user reviews,0,0,0
959400,True,0,4 user reviews,4,0,4
959410,True,7,Positive,40,1,41
959430,True,0,No user reviews,0,0,0
959450,True,0,No user reviews,0,0,0
959460,True,0,No user reviews,0,0,0
959490,True,0,No user reviews,0,0,0
959500,True,0,No user reviews,0,0,0
959510,True,0,No user reviews,0,0,0
959520,True,5,Mixed,169,84,253
959530,True,0,No user reviews,0,0,0
959540,True,0,2 user reviews,1,1,2
959550,True,0,No user reviews,0,0,0
959560,True,0,No user reviews,0,0,0
959570,True,0,No user reviews,0,0,0
959580,True,0,No user reviews,0,0,0
959590,True,0,1 user reviews,1,0,1
959610,True,0,No user reviews,0,0,0
959620,True,0,No user reviews,0,0,0
959630,True,0,No user reviews,0,0,0
959640,True,0,No user reviews,0,0,0
959650,True,0,No user reviews,0,0,0
959660,True,0,No user reviews,0,0,0
959670,True,0,No user reviews,0,0,0
959680,True,0,No user reviews,0,0,0
959690,True,0,No user reviews,0,0,0
959700,True,0,No user reviews,0,0,0
959710,True,0,6 user reviews,6,0,6
959730,True,0,3 user reviews,3,0,3
959750,True,0,No user reviews,0,0,0
959760,True,0,No user reviews,0,0,0
959770,True,0,4 user reviews,2,2,4
959780,True,0,No user reviews,0,0,0
959790,True,0,No user reviews,0,0,0
959800,True,0,No user reviews,0,0,0
959816,True,0,No user reviews,0,0,0
959820,True,0,No user reviews,0,0,0
959830,True,0,2 user reviews,2,0,2
959840,True,0,No user reviews,0,0,0
959850,True,0,3 user reviews,2,1,3
959870,True,0,1 user reviews,1,0,1
959880,True,0,No user reviews,0,0,0
959890,True,8,Very Positive,51,3,54
959910,True,0,No user reviews,0,0,0
959920,True,0,6 user reviews,3,3,6
959930,True,0,No user reviews,0,0,0
959950,True,0,No user reviews,0,0,0
960030,True,0,5 user reviews,5,0,5
960040,True,6,Mostly Positive,18,6,24
960060,True,0,No user reviews,0,0,0
960090,True,9,Overwhelmingly Positive,23546,1071,24617
960120,True,0,1 user reviews,0,1,1
960130,True,0,No user reviews,0,0,0
960140,True,0,1 user reviews,1,0,1
960150,True,0,5 user reviews,3,2,5
960170,True,8,Very Positive,881,155,1036
960180,True,0,No user reviews,0,0,0
960190,True,8,Very Positive,48,12,60
960200,True,0,4 user reviews,2,2,4
960220,True,0,5 user reviews,5,0,5
960240,True,0,2 user reviews,2,0,2
960270,True,0,No user reviews,0,0,0
960290,True,0,No user reviews,0,0,0
960300,True,0,1 user reviews,0,1,1
960310,True,7,Positive,39,0,39
960320,True,0,No user reviews,0,0,0
960330,True,0,No user reviews,0,0,0
960340,True,0,No user reviews,0,0,0
960360,True,6,Mostly Positive,10,4,14
960420,True,7,Positive,21,1,22
960550,True,0,4 user reviews,4,0,4
960590,True,0,7 user reviews,5,2,7
960600,True,0,2 user reviews,1,1,2
960610,True,0,6 user reviews,1,5,6
960620,True,0,No user reviews,0,0,0
960630,True,0,No user reviews,0,0,0
960640,True,0,No user reviews,0,0,0
960650,True,0,No user reviews,0,0,0
960660,True,0,2 user reviews,1,1,2
960680,True,4,Mostly Negative,5,9,14
960690,True,9,Overwhelmingly Positive,1659,72,1731
960700,True,0,3 user reviews,3,0,3
960710,True,7,Positive,43,4,47
960720,True,0,No user reviews,0,0,0
960740,True,5,Mixed,23,17,40
960770,True,0,No user reviews,0,0,0
960771,True,0,No user reviews,0,0,0
960781,True,0,No user reviews,0,0,0
960790,True,0,No user reviews,0,0,0
960800,True,0,No user reviews,0,0,0
960820,True,0,2 user reviews,2,0,2
960831,True,8,Very Positive,51,9,60
960890,True,0,No user reviews,0,0,0
960900,True,0,5 user reviews,4,1,5
960910,True,8,Very Positive,407,92,499
960920,True,4,Mostly Negative,83,148,231
960940,True,0,No user reviews,0,0,0
960980,True,8,Very Positive,188,35,223
960990,True,8,Very Positive,753,104,857
961000,True,0,2 user reviews,2,0,2
961010,True,7,Positive,9,1,10
961020,True,0,No user reviews,0,0,0
961030,True,0,No user reviews,0,0,0
961040,True,5,Mixed,9,8,17
961060,True,0,3 user reviews,2,1,3
961080,True,0,No user reviews,0,0,0
961090,True,0,No user reviews,0,0,0
961100,True,0,No user reviews,0,0,0
961110,True,0,2 user reviews,2,0,2
961140,True,0,No user reviews,0,0,0
961150,True,5,Mixed,15,10,25
961160,True,0,No user reviews,0,0,0
961170,True,0,No user reviews,0,0,0
961190,True,0,No user reviews,0,0,0
961200,True,0,No user reviews,0,0,0
961210,True,0,No user reviews,0,0,0
961220,True,0,7 user reviews,6,1,7
961230,True,0,1 user reviews,1,0,1
961240,True,0,1 user reviews,0,1,1
961260,True,0,No user reviews,0,0,0
961280,True,0,No user reviews,0,0,0
961290,True,0,No user reviews,0,0,0
961300,True,0,No user reviews,0,0,0
961320,True,0,No user reviews,0,0,0
961330,True,0,No user reviews,0,0,0
961340,True,0,No user reviews,0,0,0
961350,True,0,No user reviews,0,0,0
961360,True,0,No user reviews,0,0,0
961370,True,0,No user reviews,0,0,0
961400,True,0,No user reviews,0,0,0
961410,True,0,1 user reviews,1,0,1
961420,True,6,Mostly Positive,15,5,20
961440,True,0,No user reviews,0,0,0
961450,True,0,No user reviews,0,0,0
961470,True,0,No user reviews,0,0,0
961471,True,0,No user reviews,0,0,0
961472,True,0,No user reviews,0,0,0
961490,True,8,Very Positive,82,13,95
961500,True,0,No user reviews,0,0,0
961510,True,7,Positive,19,3,22
961520,True,0,No user reviews,0,0,0
961540,True,0,No user reviews,0,0,0
961560,True,0,2 user reviews,1,1,2
961570,True,0,1 user reviews,1,0,1
961580,True,0,1 user reviews,1,0,1
961590,True,0,No user reviews,0,0,0
961620,True,8,Very Positive,76,10,86
961630,True,0,1 user reviews,1,0,1
961640,True,7,Positive,15,1,16
961660,True,8,Very Positive,70,2,72
961680,True,0,No user reviews,0,0,0
961700,True,0,6 user reviews,4,2,6
961710,True,0,1 user reviews,0,1,1
961720,True,0,2 user reviews,0,2,2
961730,True,0,5 user reviews,2,3,5
961740,True,0,2 user reviews,1,1,2
961750,True,0,No user reviews,0,0,0
961780,True,0,No user reviews,0,0,0
961810,True,0,No user reviews,0,0,0
961830,True,0,No user reviews,0,0,0
961840,True,7,Positive,18,4,22
961850,True,0,1 user reviews,1,0,1
961860,True,5,Mixed,22,10,32
961870,True,0,No user reviews,0,0,0
961910,True,0,No user reviews,0,0,0
961920,True,0,1 user reviews,0,1,1
961930,True,8,Very Positive,182,24,206
961960,True,0,No user reviews,0,0,0
961970,True,0,No user reviews,0,0,0
961980,True,0,1 user reviews,1,0,1
961990,True,0,6 user reviews,6,0,6
962000,True,0,No user reviews,0,0,0
962030,True,0,No user reviews,0,0,0
962040,True,0,No user reviews,0,0,0
962050,True,0,3 user reviews,1,2,3
962060,True,0,1 user reviews,1,0,1
962070,True,0,No user reviews,0,0,0
962090,True,0,No user reviews,0,0,0
962100,True,0,No user reviews,0,0,0
962120,True,0,No user reviews,0,0,0
962130,True,8,Very Positive,5853,781,6634
962140,True,0,No user reviews,0,0,0
962150,True,7,Positive,13,3,16
962160,True,0,No user reviews,0,0,0
962170,True,0,No user reviews,0,0,0
962190,True,0,No user reviews,0,0,0
962220,True,7,Positive,9,1,10
962230,True,0,No user reviews,0,0,0
962240,True,0,No user reviews,0,0,0
962250,True,0,1 user reviews,1,0,1
962270,True,0,No user reviews,0,0,0
962280,True,0,1 user reviews,1,0,1
962290,True,0,No user reviews,0,0,0
962300,True,0,No user reviews,0,0,0
962301,True,0,No user reviews,0,0,0
962302,True,0,No user reviews,0,0,0
962303,True,0,No user reviews,0,0,0
962304,True,0,No user reviews,0,0,0
962305,True,0,No user reviews,0,0,0
962306,True,0,1 user reviews,0,1,1
962310,True,0,No user reviews,0,0,0
962340,True,0,No user reviews,0,0,0
962360,True,0,No user reviews,0,0,0
962370,True,0,1 user reviews,1,0,1
962380,True,0,1 user reviews,1,0,1
962390,True,0,No user reviews,0,0,0
962400,True,8,Very Positive,298,38,336
962410,True,0,No user reviews,0,0,0
962420,True,0,No user reviews,0,0,0
962421,True,0,No user reviews,0,0,0
962430,True,0,No user reviews,0,0,0
962490,True,0,No user reviews,0,0,0
962500,True,0,1 user reviews,1,0,1
962510,True,0,5 user reviews,4,1,5
962540,True,0,8 user reviews,6,2,8
962580,True,6,Mostly Positive,141,47,188
962590,True,0,No user reviews,0,0,0
962610,True,0,2 user reviews,2,0,2
962630,True,5,Mixed,7,7,14
962640,True,0,No user reviews,0,0,0
962650,True,0,No user reviews,0,0,0
962680,True,0,1 user reviews,1,0,1
962700,True,0,No user reviews,0,0,0
962710,True,0,4 user reviews,2,2,4
962730,True,8,Very Positive,5633,829,6462
962750,True,6,Mostly Positive,141,42,183
962760,True,0,No user reviews,0,0,0
962780,True,0,No user reviews,0,0,0
962810,True,0,No user reviews,0,0,0
962820,True,0,No user reviews,0,0,0
962850,True,4,Mostly Negative,7,12,19
962860,True,0,2 user reviews,0,2,2
962880,True,0,No user reviews,0,0,0
962890,True,0,No user reviews,0,0,0
962920,True,0,No user reviews,0,0,0
962921,True,0,1 user reviews,1,0,1
962922,True,0,No user reviews,0,0,0
962923,True,0,No user reviews,0,0,0
962924,True,0,1 user reviews,1,0,1
962925,True,0,No user reviews,0,0,0
962950,True,0,No user reviews,0,0,0
962960,True,0,4 user reviews,4,0,4
962970,True,5,Mixed,28,13,41
962980,True,0,No user reviews,0,0,0
962990,True,0,No user reviews,0,0,0
963000,True,8,Very Positive,651,35,686
963020,True,0,1 user reviews,1,0,1
963040,True,0,1 user reviews,0,1,1
963050,True,0,No user reviews,0,0,0
963060,True,0,4 user reviews,4,0,4
963110,True,0,3 user reviews,0,3,3
963150,True,0,1 user reviews,0,1,1
963170,True,0,1 user reviews,0,1,1
963180,True,0,No user reviews,0,0,0
963190,True,0,No user reviews,0,0,0
963200,True,0,4 user reviews,1,3,4
963210,True,0,No user reviews,0,0,0
963220,True,0,No user reviews,0,0,0
963230,True,7,Positive,15,1,16
963260,True,0,6 user reviews,5,1,6
963280,True,7,Positive,45,3,48
963290,True,0,No user reviews,0,0,0
963300,True,5,Mixed,10,8,18
963330,True,8,Very Positive,46,7,53
963350,True,0,No user reviews,0,0,0
963370,True,0,4 user reviews,2,2,4
963400,True,5,Mixed,77,34,111
963410,True,0,No user reviews,0,0,0
963420,True,0,No user reviews,0,0,0
963450,True,8,Very Positive,213,36,249
963470,True,0,2 user reviews,2,0,2
963490,True,0,4 user reviews,3,1,4
963500,True,4,Mostly Negative,2,8,10
963510,True,0,No user reviews,0,0,0
963570,True,0,2 user reviews,2,0,2
963580,True,0,No user reviews,0,0,0
963590,True,0,No user reviews,0,0,0
963600,True,0,No user reviews,0,0,0
963660,True,0,6 user reviews,4,2,6
963670,True,0,No user reviews,0,0,0
963680,True,7,Positive,15,1,16
963690,True,8,Very Positive,422,31,453
963710,True,9,Overwhelmingly Positive,1145,55,1200
963720,True,0,No user reviews,0,0,0
963740,True,0,No user reviews,0,0,0
963750,True,0,No user reviews,0,0,0
963770,True,0,No user reviews,0,0,0
963780,True,0,No user reviews,0,0,0
963830,True,0,No user reviews,0,0,0
963860,True,0,5 user reviews,4,1,5
963870,True,0,No user reviews,0,0,0
963900,True,0,6 user reviews,4,2,6
963910,True,0,No user reviews,0,0,0
963930,True,8,Very Positive,793,195,988
963940,True,0,No user reviews,0,0,0
963960,True,0,2 user reviews,2,0,2
963980,True,0,No user reviews,0,0,0
964000,True,0,No user reviews,0,0,0
964020,True,0,No user reviews,0,0,0
964040,True,0,No user reviews,0,0,0
964050,True,0,2 user reviews,0,2,2
964060,True,0,No user reviews,0,0,0
964070,True,0,2 user reviews,2,0,2
964080,True,5,Mixed,15,7,22
964100,True,0,1 user reviews,1,0,1
964110,True,0,2 user reviews,2,0,2
964120,True,0,No user reviews,0,0,0
964130,True,7,Positive,36,8,44
964150,True,0,No user reviews,0,0,0
964170,True,0,1 user reviews,0,1,1
964180,True,0,No user reviews,0,0,0
964190,True,0,No user reviews,0,0,0
964200,True,0,No user reviews,0,0,0
964210,True,0,4 user reviews,4,0,4
964220,True,0,3 user reviews,3,0,3
964230,True,0,9 user reviews,7,2,9
964240,True,0,No user reviews,0,0,0
964280,True,0,No user reviews,0,0,0
964290,True,0,No user reviews,0,0,0
964320,True,0,No user reviews,0,0,0
964330,True,0,No user reviews,0,0,0
964340,True,0,5 user reviews,4,1,5
964350,True,0,1 user reviews,1,0,1
964370,True,0,2 user reviews,2,0,2
964390,True,0,7 user reviews,2,5,7
964420,True,0,1 user reviews,0,1,1
964450,True,0,No user reviews,0,0,0
964460,True,6,Mostly Positive,8,3,11
964480,True,0,No user reviews,0,0,0
964500,True,0,No user reviews,0,0,0
964510,True,0,No user reviews,0,0,0
964520,True,0,No user reviews,0,0,0
964530,True,0,2 user reviews,1,1,2
964540,True,0,No user reviews,0,0,0
964550,True,0,No user reviews,0,0,0
964560,True,0,No user reviews,0,0,0
964561,True,0,No user reviews,0,0,0
964562,True,0,No user reviews,0,0,0
964563,True,0,No user reviews,0,0,0
964564,True,0,No user reviews,0,0,0
964565,True,0,No user reviews,0,0,0
964566,True,0,No user reviews,0,0,0
964567,True,0,No user reviews,0,0,0
964570,True,8,Very Positive,116,24,140
964580,True,0,No user reviews,0,0,0
964590,True,0,2 user reviews,2,0,2
964620,True,0,No user reviews,0,0,0
964630,True,0,1 user reviews,1,0,1
964640,True,0,No user reviews,0,0,0
964650,True,6,Mostly Positive,169,47,216
964660,True,0,No user reviews,0,0,0
964670,True,0,No user reviews,0,0,0
964671,True,0,No user reviews,0,0,0
964672,True,0,No user reviews,0,0,0
964700,True,0,6 user reviews,5,1,6
964710,True,0,No user reviews,0,0,0
964750,True,0,3 user reviews,1,2,3
964760,True,0,No user reviews,0,0,0
964770,True,0,5 user reviews,3,2,5
964780,True,0,No user reviews,0,0,0
964800,True,0,No user reviews,0,0,0
964810,True,0,3 user reviews,3,0,3
964840,True,0,No user reviews,0,0,0
964880,True,0,1 user reviews,1,0,1
964890,True,0,No user reviews,0,0,0
964910,True,0,No user reviews,0,0,0
964920,True,0,2 user reviews,0,2,2
964930,True,0,1 user reviews,1,0,1
964931,True,0,No user reviews,0,0,0
964932,True,0,No user reviews,0,0,0
964933,True,0,No user reviews,0,0,0
964934,True,0,No user reviews,0,0,0
964935,True,0,No user reviews,0,0,0
964936,True,0,No user reviews,0,0,0
964937,True,0,No user reviews,0,0,0
964938,True,0,No user reviews,0,0,0
964960,True,0,No user reviews,0,0,0
964990,True,7,Positive,25,1,26
965000,True,0,3 user reviews,1,2,3
965010,True,7,Positive,18,2,20
965030,True,0,4 user reviews,3,1,4
965040,True,0,No user reviews,0,0,0
965060,True,0,9 user reviews,5,4,9
965070,True,0,No user reviews,0,0,0
965080,True,0,1 user reviews,0,1,1
965100,True,0,No user reviews,0,0,0
965101,True,0,No user reviews,0,0,0
965102,True,0,No user reviews,0,0,0
965110,True,0,2 user reviews,1,1,2
965120,True,0,1 user reviews,0,1,1
965130,True,0,2 user reviews,1,1,2
965140,True,0,No user reviews,0,0,0
965180,True,0,No user reviews,0,0,0
965200,True,0,No user reviews,0,0,0
965210,True,0,No user reviews,0,0,0
965220,True,8,Very Positive,382,50,432
965230,True,8,Very Positive,286,43,329
965240,True,0,2 user reviews,2,0,2
965270,True,0,No user reviews,0,0,0
965280,True,0,No user reviews,0,0,0
965290,True,0,No user reviews,0,0,0
965300,True,6,Mostly Positive,66,17,83
965310,True,5,Mixed,63,30,93
965320,True,5,Mixed,58,55,113
965340,True,7,Positive,9,1,10
965350,True,0,1 user reviews,1,0,1
965360,True,0,No user reviews,0,0,0
965370,True,0,No user reviews,0,0,0
965400,True,0,No user reviews,0,0,0
965410,True,0,3 user reviews,2,1,3
965420,True,0,No user reviews,0,0,0
965430,True,0,2 user reviews,2,0,2
965470,True,0,7 user reviews,7,0,7
965480,True,8,Very Positive,112,27,139
965490,True,7,Positive,11,0,11
965500,True,0,No user reviews,0,0,0
965510,True,0,6 user reviews,6,0,6
965520,True,0,No user reviews,0,0,0
965530,True,0,No user reviews,0,0,0
965540,True,0,No user reviews,0,0,0
965580,True,8,Very Positive,550,34,584
965590,True,8,Very Positive,68,0,68
965600,True,8,Very Positive,72,6,78
965610,True,7,Positive,22,2,24
965630,True,0,No user reviews,0,0,0
965640,True,7,Positive,28,5,33
965650,True,0,No user reviews,0,0,0
965670,True,8,Very Positive,131,9,140
965680,True,8,Very Positive,76,6,82
965690,True,0,No user reviews,0,0,0
965700,True,0,No user reviews,0,0,0
965710,True,0,No user reviews,0,0,0
965720,True,0,No user reviews,0,0,0
965730,True,0,1 user reviews,0,1,1
965750,True,0,No user reviews,0,0,0
965751,True,0,No user reviews,0,0,0
965760,True,0,No user reviews,0,0,0
965780,True,0,No user reviews,0,0,0
965781,True,0,No user reviews,0,0,0
965790,True,0,No user reviews,0,0,0
965810,True,8,Very Positive,61,7,68
965820,True,0,6 user reviews,6,0,6
965830,True,8,Very Positive,45,5,50
965840,True,0,2 user reviews,1,1,2
965850,True,0,No user reviews,0,0,0
965860,True,0,6 user reviews,6,0,6
965880,True,0,No user reviews,0,0,0
965890,True,0,No user reviews,0,0,0
965900,True,0,1 user reviews,1,0,1
965910,True,0,No user reviews,0,0,0
965920,True,0,No user reviews,0,0,0
965940,True,0,6 user reviews,3,3,6
965950,True,0,No user reviews,0,0,0
965960,True,0,2 user reviews,2,0,2
965970,True,0,No user reviews,0,0,0
965980,True,0,No user reviews,0,0,0
965990,True,0,No user reviews,0,0,0
966000,True,5,Mixed,11,5,16
966010,True,7,Positive,13,1,14
966020,True,0,4 user reviews,4,0,4
966030,True,0,No user reviews,0,0,0
966050,True,0,1 user reviews,0,1,1
966070,True,7,Positive,24,2,26
966090,True,7,Positive,12,3,15
966100,True,0,No user reviews,0,0,0
966130,True,0,No user reviews,0,0,0
966140,True,0,1 user reviews,0,1,1
966150,True,0,No user reviews,0,0,0
966160,True,0,No user reviews,0,0,0
966180,True,0,3 user reviews,3,0,3
966210,True,0,5 user reviews,4,1,5
966240,True,0,3 user reviews,2,1,3
966250,True,0,1 user reviews,1,0,1
966320,True,8,Very Positive,492,7,499
966330,True,8,Very Positive,587,119,706
966350,True,7,Positive,33,0,33
966360,True,7,Positive,14,0,14
966370,True,0,3 user reviews,1,2,3
966380,True,0,No user reviews,0,0,0
966390,True,0,No user reviews,0,0,0
966400,True,7,Positive,16,3,19
966410,True,0,No user reviews,0,0,0
966420,True,0,No user reviews,0,0,0
966430,True,6,Mostly Positive,126,34,160
966440,True,0,No user reviews,0,0,0
966450,True,0,No user reviews,0,0,0
966460,True,0,No user reviews,0,0,0
966470,True,0,No user reviews,0,0,0
966490,True,0,1 user reviews,1,0,1
966491,True,0,No user reviews,0,0,0
966492,True,0,No user reviews,0,0,0
966493,True,0,No user reviews,0,0,0
966494,True,0,No user reviews,0,0,0
966495,True,0,No user reviews,0,0,0
966497,True,0,1 user reviews,1,0,1
966498,True,0,No user reviews,0,0,0
966499,True,0,No user reviews,0,0,0
966500,True,0,No user reviews,0,0,0
966520,True,0,No user reviews,0,0,0
966521,True,0,No user reviews,0,0,0
966522,True,0,No user reviews,0,0,0
966523,True,0,No user reviews,0,0,0
966524,True,0,No user reviews,0,0,0
966525,True,0,No user reviews,0,0,0
966526,True,0,No user reviews,0,0,0
966527,True,0,No user reviews,0,0,0
966528,True,0,No user reviews,0,0,0
966529,True,0,1 user reviews,1,0,1
966530,True,5,Mixed,16,13,29
966540,True,0,No user reviews,0,0,0
966560,True,5,Mixed,29,21,50
966580,True,0,3 user reviews,3,0,3
966590,True,0,7 user reviews,7,0,7
966600,True,0,1 user reviews,0,1,1
966610,True,8,Very Positive,85,21,106
966620,True,0,No user reviews,0,0,0
966630,True,7,Positive,37,1,38
966650,True,0,No user reviews,0,0,0
966660,True,0,7 user reviews,6,1,7
966670,True,7,Positive,12,1,13
966680,True,8,Very Positive,165,9,174
966690,True,7,Positive,29,5,34
966700,True,0,No user reviews,0,0,0
966710,True,0,No user reviews,0,0,0
966720,True,5,Mixed,8,4,12
966730,True,0,No user reviews,0,0,0
966750,True,0,1 user reviews,0,1,1
966760,True,0,3 user reviews,2,1,3
966800,True,0,No user reviews,0,0,0
966810,True,0,No user reviews,0,0,0
966820,True,0,No user reviews,0,0,0
966830,True,0,No user reviews,0,0,0
966840,True,0,3 user reviews,3,0,3
966841,True,0,2 user reviews,1,1,2
966842,True,0,1 user reviews,1,0,1
966843,True,0,1 user reviews,1,0,1
966845,True,0,1 user reviews,1,0,1
966870,True,0,4 user reviews,4,0,4
967010,True,0,No user reviews,0,0,0
967020,True,0,No user reviews,0,0,0
967050,True,8,Very Positive,3856,400,4256
967060,True,0,1 user reviews,1,0,1
967070,True,0,No user reviews,0,0,0
967100,True,0,4 user reviews,3,1,4
967120,True,0,No user reviews,0,0,0
967130,True,8,Very Positive,40,10,50
967150,True,0,1 user reviews,0,1,1
967170,True,0,8 user reviews,0,8,8
967180,True,0,1 user reviews,0,1,1
967210,True,0,1 user reviews,1,0,1
967230,True,0,No user reviews,0,0,0
967240,True,7,Positive,30,7,37
967250,True,6,Mostly Positive,71,22,93
967271,True,0,1 user reviews,1,0,1
967272,True,0,3 user reviews,2,1,3
967274,True,0,2 user reviews,1,1,2
967275,True,4,Mostly Negative,3,10,13
967276,True,0,1 user reviews,0,1,1
967278,True,0,1 user reviews,0,1,1
967279,True,0,4 user reviews,1,3,4
967280,True,0,6 user reviews,6,0,6
967281,True,0,5 user reviews,3,2,5
967282,True,7,Positive,12,1,13
967283,True,0,3 user reviews,2,1,3
967285,True,0,1 user reviews,1,0,1
967287,True,0,4 user reviews,2,2,4
967288,True,0,No user reviews,0,0,0
967289,True,0,3 user reviews,1,2,3
967290,True,0,2 user reviews,2,0,2
967300,True,0,1 user reviews,1,0,1
967320,True,0,1 user reviews,0,1,1
967330,True,8,Very Positive,45,6,51
967340,True,0,No user reviews,0,0,0
967350,True,0,5 user reviews,4,1,5
967370,True,0,6 user reviews,5,1,6
967380,True,7,Positive,38,6,44
967390,True,0,No user reviews,0,0,0
967400,True,0,6 user reviews,3,3,6
967410,True,6,Mostly Positive,48,18,66
967420,True,0,No user reviews,0,0,0
967430,True,0,4 user reviews,2,2,4
967440,True,0,5 user reviews,1,4,5
967450,True,0,3 user reviews,1,2,3
967460,True,0,No user reviews,0,0,0
967490,True,0,No user reviews,0,0,0
967750,True,0,No user reviews,0,0,0
967910,True,0,2 user reviews,2,0,2
967940,True,0,2 user reviews,2,0,2
967950,True,0,No user reviews,0,0,0
967960,True,0,No user reviews,0,0,0
967980,True,0,No user reviews,0,0,0
967981,True,0,No user reviews,0,0,0
968170,True,7,Positive,10,0,10
968180,True,0,No user reviews,0,0,0
968190,True,0,No user reviews,0,0,0
968200,True,0,No user reviews,0,0,0
968210,True,0,3 user reviews,3,0,3
968220,True,0,No user reviews,0,0,0
968230,True,0,No user reviews,0,0,0
968240,True,0,No user reviews,0,0,0
968250,True,8,Very Positive,113,13,126
968260,True,0,No user reviews,0,0,0
968270,True,0,3 user reviews,3,0,3
968271,True,0,No user reviews,0,0,0
968272,True,0,No user reviews,0,0,0
968273,True,0,No user reviews,0,0,0
968290,True,7,Positive,32,2,34
968300,True,0,6 user reviews,6,0,6
968310,True,0,No user reviews,0,0,0
968320,True,0,2 user reviews,2,0,2
968350,True,7,Positive,27,0,27
968360,True,0,6 user reviews,4,2,6
968370,True,7,Positive,26,4,30
968380,True,0,3 user reviews,2,1,3
968390,True,8,Very Positive,47,7,54
968410,True,0,No user reviews,0,0,0
968420,True,0,No user reviews,0,0,0
968430,True,0,No user reviews,0,0,0
968440,True,0,No user reviews,0,0,0
968450,True,0,3 user reviews,1,2,3
968460,True,0,6 user reviews,4,2,6
968470,True,0,8 user reviews,8,0,8
968480,True,0,No user reviews,0,0,0
968490,True,0,2 user reviews,2,0,2
968500,True,0,No user reviews,0,0,0
968540,True,0,5 user reviews,1,4,5
968550,True,0,No user reviews,0,0,0
968570,True,0,2 user reviews,1,1,2
968580,True,0,3 user reviews,1,2,3
968590,True,0,No user reviews,0,0,0
968600,True,0,No user reviews,0,0,0
968620,True,0,No user reviews,0,0,0
968630,True,0,No user reviews,0,0,0
968640,True,0,No user reviews,0,0,0
968680,True,0,1 user reviews,1,0,1
968690,True,0,No user reviews,0,0,0
968700,True,0,No user reviews,0,0,0
968710,True,0,No user reviews,0,0,0
968730,True,7,Positive,8,2,10
968740,True,0,No user reviews,0,0,0
968750,True,0,No user reviews,0,0,0
968760,True,7,Positive,24,3,27
968770,True,0,No user reviews,0,0,0
968790,True,8,Very Positive,158,33,191
968800,True,0,No user reviews,0,0,0
968820,True,6,Mostly Positive,25,9,34
968830,True,0,4 user reviews,3,1,4
968840,True,0,5 user reviews,3,2,5
968860,True,0,No user reviews,0,0,0
968870,True,6,Mostly Positive,70,27,97
968880,True,0,5 user reviews,4,1,5
968890,True,0,No user reviews,0,0,0
968900,True,0,No user reviews,0,0,0
968901,True,0,No user reviews,0,0,0
968902,True,0,No user reviews,0,0,0
968910,True,0,1 user reviews,1,0,1
968911,True,0,3 user reviews,3,0,3
968920,True,0,4 user reviews,1,3,4
968930,True,0,No user reviews,0,0,0
968940,True,4,Mostly Negative,6,11,17
968950,True,6,Mostly Positive,15,6,21
968960,True,0,1 user reviews,1,0,1
968970,True,6,Mostly Positive,223,70,293
968980,True,0,No user reviews,0,0,0
968990,True,0,2 user reviews,1,1,2
969020,True,8,Very Positive,73,14,87
969030,True,0,1 user reviews,1,0,1
969040,True,0,No user reviews,0,0,0
969041,True,0,No user reviews,0,0,0
969042,True,0,No user reviews,0,0,0
969043,True,0,No user reviews,0,0,0
969044,True,0,No user reviews,0,0,0
969045,True,0,No user reviews,0,0,0
969060,True,0,2 user reviews,1,1,2
969070,True,0,No user reviews,0,0,0
969090,True,0,No user reviews,0,0,0
969100,True,0,No user reviews,0,0,0
969110,True,0,No user reviews,0,0,0
969130,True,0,5 user reviews,5,0,5
969140,True,0,3 user reviews,2,1,3
969160,True,0,No user reviews,0,0,0
969170,True,0,No user reviews,0,0,0
969180,True,0,No user reviews,0,0,0
969190,True,0,No user reviews,0,0,0
969200,True,0,1 user reviews,0,1,1
969220,True,0,4 user reviews,4,0,4
969230,True,0,4 user reviews,1,3,4
969240,True,0,No user reviews,0,0,0
969250,True,0,9 user reviews,7,2,9
969260,True,0,No user reviews,0,0,0
969261,True,0,No user reviews,0,0,0
969262,True,0,No user reviews,0,0,0
969270,True,7,Positive,10,0,10
969280,True,0,No user reviews,0,0,0
969290,True,0,No user reviews,0,0,0
969300,True,0,No user reviews,0,0,0
969310,True,0,No user reviews,0,0,0
969320,True,0,No user reviews,0,0,0
969330,True,0,No user reviews,0,0,0
969340,True,0,3 user reviews,3,0,3
969350,True,0,3 user reviews,3,0,3
969380,True,0,No user reviews,0,0,0
969410,True,0,No user reviews,0,0,0
969420,True,0,No user reviews,0,0,0
969430,True,0,No user reviews,0,0,0
969440,True,0,No user reviews,0,0,0
969450,True,0,No user reviews,0,0,0
969480,True,7,Positive,21,0,21
969510,True,0,No user reviews,0,0,0
969520,True,0,No user reviews,0,0,0
969530,True,0,3 user reviews,3,0,3
969540,True,0,8 user reviews,7,1,8
969550,True,0,No user reviews,0,0,0
969560,True,5,Mixed,10,5,15
969570,True,5,Mixed,12,17,29
969580,True,0,8 user reviews,4,4,8
969590,True,0,9 user reviews,7,2,9
969600,True,0,No user reviews,0,0,0
969620,True,0,No user reviews,0,0,0
969630,True,0,No user reviews,0,0,0
969651,True,0,No user reviews,0,0,0
969652,True,0,No user reviews,0,0,0
969653,True,0,No user reviews,0,0,0
969654,True,0,No user reviews,0,0,0
969655,True,0,No user reviews,0,0,0
969656,True,0,No user reviews,0,0,0
969657,True,0,No user reviews,0,0,0
969658,True,0,No user reviews,0,0,0
969659,True,0,No user reviews,0,0,0
969680,True,0,1 user reviews,1,0,1
969690,True,7,Positive,12,1,13
969700,True,8,Very Positive,126,7,133
969710,True,5,Mixed,7,6,13
969730,True,0,1 user reviews,1,0,1
969740,True,0,4 user reviews,4,0,4
969760,True,0,No user reviews,0,0,0
969770,True,0,1 user reviews,1,0,1
969771,True,0,No user reviews,0,0,0
969772,True,0,No user reviews,0,0,0
969773,True,0,No user reviews,0,0,0
969780,True,0,1 user reviews,1,0,1
969790,True,0,1 user reviews,1,0,1
969800,True,0,No user reviews,0,0,0
969820,True,0,No user reviews,0,0,0
969850,True,0,No user reviews,0,0,0
969860,True,0,2 user reviews,0,2,2
969870,True,0,4 user reviews,1,3,4
969880,True,5,Mixed,11,7,18
969890,True,0,6 user reviews,6,0,6
969900,True,0,5 user reviews,4,1,5
969920,True,0,No user reviews,0,0,0
969940,True,0,2 user reviews,0,2,2
969950,True,0,3 user reviews,1,2,3
969970,True,5,Mixed,7,6,13
969990,True,9,Overwhelmingly Positive,4384,161,4545
970000,True,0,2 user reviews,1,1,2
970020,True,0,No user reviews,0,0,0
970030,True,0,No user reviews,0,0,0
970060,True,7,Positive,13,0,13
970070,True,7,Positive,35,0,35
970080,True,0,No user reviews,0,0,0
970090,True,0,5 user reviews,5,0,5
970100,True,7,Positive,10,1,11
970110,True,0,5 user reviews,5,0,5
970120,True,0,No user reviews,0,0,0
970130,True,5,Mixed,7,4,11
970140,True,7,Positive,16,2,18
970150,True,0,5 user reviews,1,4,5
970160,True,0,No user reviews,0,0,0
970170,True,0,3 user reviews,3,0,3
970180,True,0,No user reviews,0,0,0
970190,True,5,Mixed,20,14,34
970200,True,0,3 user reviews,3,0,3
970210,True,0,No user reviews,0,0,0
970240,True,0,4 user reviews,4,0,4
970260,True,0,3 user reviews,1,2,3
970270,True,0,No user reviews,0,0,0
970300,True,0,4 user reviews,4,0,4
970360,True,0,1 user reviews,0,1,1
970370,True,0,No user reviews,0,0,0
970400,True,6,Mostly Positive,20,8,28
970410,True,0,No user reviews,0,0,0
970440,True,0,3 user reviews,3,0,3
970450,True,0,No user reviews,0,0,0
970460,True,0,No user reviews,0,0,0
970470,True,0,2 user reviews,2,0,2
970510,True,0,5 user reviews,5,0,5
970520,True,0,No user reviews,0,0,0
970530,True,0,No user reviews,0,0,0
970550,True,0,1 user reviews,0,1,1
970560,True,8,Very Positive,102,1,103
970570,True,8,Very Positive,410,36,446
970580,True,0,6 user reviews,5,1,6
970600,True,5,Mixed,8,4,12
970610,True,0,No user reviews,0,0,0
970620,True,0,No user reviews,0,0,0
970630,True,0,No user reviews,0,0,0
970640,True,7,Positive,12,1,13
970650,True,0,2 user reviews,0,2,2
970660,True,3,Negative,4,27,31
970670,True,0,2 user reviews,2,0,2
970680,True,0,No user reviews,0,0,0
970690,True,0,1 user reviews,0,1,1
970700,True,0,No user reviews,0,0,0
970710,True,0,8 user reviews,3,5,8
970730,True,0,No user reviews,0,0,0
970740,True,0,No user reviews,0,0,0
970760,True,0,3 user reviews,3,0,3
970780,True,0,No user reviews,0,0,0
970800,True,0,No user reviews,0,0,0
970810,True,0,2 user reviews,2,0,2
970820,True,0,No user reviews,0,0,0
970830,True,8,Very Positive,442,93,535
970840,True,0,No user reviews,0,0,0
970850,True,0,5 user reviews,5,0,5
970870,True,0,6 user reviews,5,1,6
970880,True,0,3 user reviews,3,0,3
970890,True,0,3 user reviews,3,0,3
970900,True,0,3 user reviews,3,0,3
970910,True,0,2 user reviews,2,0,2
970930,True,0,1 user reviews,1,0,1
970940,True,0,5 user reviews,1,4,5
970960,True,6,Mostly Positive,155,49,204
970970,True,3,Negative,1,10,11
970980,True,0,No user reviews,0,0,0
970990,True,0,No user reviews,0,0,0
971030,True,0,No user reviews,0,0,0
971060,True,0,8 user reviews,4,4,8
971070,True,0,7 user reviews,6,1,7
971080,True,0,1 user reviews,1,0,1
971090,True,0,3 user reviews,1,2,3
971100,True,0,2 user reviews,2,0,2
971120,True,5,Mixed,41,18,59
971130,True,0,2 user reviews,2,0,2
971150,True,0,1 user reviews,1,0,1
971170,True,0,No user reviews,0,0,0
971180,True,0,No user reviews,0,0,0
971210,True,0,No user reviews,0,0,0
971230,True,0,No user reviews,0,0,0
971240,True,0,1 user reviews,1,0,1
971241,True,0,No user reviews,0,0,0
971242,True,0,3 user reviews,2,1,3
971243,True,0,No user reviews,0,0,0
971250,True,0,1 user reviews,1,0,1
971251,True,0,2 user reviews,2,0,2
971252,True,0,No user reviews,0,0,0
971260,True,0,No user reviews,0,0,0
971280,True,0,2 user reviews,2,0,2
971340,True,0,No user reviews,0,0,0
971350,True,5,Mixed,25,22,47
971390,True,0,No user reviews,0,0,0
971400,True,0,No user reviews,0,0,0
971430,True,7,Positive,39,1,40
971460,True,5,Mixed,19,14,33
971480,True,7,Positive,15,3,18
971491,True,0,No user reviews,0,0,0
971500,True,7,Positive,13,0,13
971520,True,0,No user reviews,0,0,0
971530,True,0,No user reviews,0,0,0
971540,True,0,5 user reviews,5,0,5
971570,True,0,2 user reviews,1,1,2
971600,True,7,Positive,16,0,16
971610,True,0,4 user reviews,3,1,4
971620,True,8,Very Positive,192,35,227
971630,True,5,Mixed,24,23,47
971640,True,0,1 user reviews,1,0,1
971650,True,5,Mixed,13,13,26
971680,True,8,Very Positive,318,14,332
971690,True,7,Positive,23,0,23
971710,True,0,No user reviews,0,0,0
971720,True,0,No user reviews,0,0,0
971730,True,0,No user reviews,0,0,0
971740,True,0,3 user reviews,3,0,3
971750,True,0,3 user reviews,2,1,3
971760,True,5,Mixed,18,27,45
971770,True,0,2 user reviews,2,0,2
971780,True,0,3 user reviews,3,0,3
971790,True,5,Mixed,240,187,427
971800,True,0,No user reviews,0,0,0
971810,True,0,No user reviews,0,0,0
971880,True,0,7 user reviews,5,2,7
971900,True,0,4 user reviews,1,3,4
971910,True,0,1 user reviews,0,1,1
971924,True,8,Very Positive,56,3,59
971925,True,8,Very Positive,124,15,139
971940,True,0,No user reviews,0,0,0
971950,True,0,1 user reviews,1,0,1
971951,True,0,No user reviews,0,0,0
971952,True,0,No user reviews,0,0,0
971953,True,0,No user reviews,0,0,0
971954,True,0,No user reviews,0,0,0
971955,True,0,No user reviews,0,0,0
971956,True,0,No user reviews,0,0,0
971957,True,0,No user reviews,0,0,0
971958,True,0,No user reviews,0,0,0
971959,True,0,No user reviews,0,0,0
971960,True,0,No user reviews,0,0,0
971961,True,0,No user reviews,0,0,0
971962,True,0,No user reviews,0,0,0
971963,True,0,No user reviews,0,0,0
971964,True,0,No user reviews,0,0,0
971965,True,0,No user reviews,0,0,0
971970,True,0,No user reviews,0,0,0
971980,True,0,No user reviews,0,0,0
971995,True,7,Positive,38,3,41
971996,True,9,Overwhelmingly Positive,769,22,791
971998,True,8,Very Positive,139,9,148
971999,True,8,Very Positive,81,6,87
972000,True,0,No user reviews,0,0,0
972010,True,0,No user reviews,0,0,0
972050,True,0,No user reviews,0,0,0
972060,True,0,No user reviews,0,0,0
972070,True,0,No user reviews,0,0,0
972080,True,0,3 user reviews,3,0,3
972090,True,0,No user reviews,0,0,0
972100,True,0,No user reviews,0,0,0
972130,True,0,No user reviews,0,0,0
972150,True,0,2 user reviews,2,0,2
972160,True,7,Positive,15,2,17
972170,True,5,Mixed,159,73,232
972180,True,0,4 user reviews,2,2,4
972200,True,0,No user reviews,0,0,0
972230,True,0,4 user reviews,2,2,4
972260,True,0,2 user reviews,1,1,2
972261,True,0,2 user reviews,1,1,2
972280,True,0,5 user reviews,3,2,5
972290,True,0,7 user reviews,5,2,7
972300,True,0,No user reviews,0,0,0
972310,True,0,No user reviews,0,0,0
972350,True,7,Positive,32,4,36
972351,True,4,Mostly Negative,23,52,75
972360,True,0,No user reviews,0,0,0
972370,True,6,Mostly Positive,24,9,33
972380,True,0,No user reviews,0,0,0
972420,True,0,1 user reviews,1,0,1
972430,True,0,6 user reviews,3,3,6
972480,True,0,2 user reviews,1,1,2
972510,True,0,No user reviews,0,0,0
972520,True,0,3 user reviews,3,0,3
972530,True,0,No user reviews,0,0,0
972560,True,0,No user reviews,0,0,0
972600,True,0,No user reviews,0,0,0
972620,True,0,2 user reviews,1,1,2
972640,True,0,No user reviews,0,0,0
972650,True,0,1 user reviews,1,0,1
972660,True,9,Overwhelmingly Positive,1763,77,1840
972720,True,0,No user reviews,0,0,0
972740,True,6,Mostly Positive,104,27,131
972760,True,7,Positive,13,3,16
972770,True,7,Positive,31,1,32
972840,True,0,No user reviews,0,0,0
972850,True,0,No user reviews,0,0,0
972860,True,0,No user reviews,0,0,0
972870,True,0,No user reviews,0,0,0
972880,True,0,No user reviews,0,0,0
972890,True,0,1 user reviews,1,0,1
972910,True,7,Positive,9,2,11
972920,True,4,Mostly Negative,3,10,13
972940,True,0,3 user reviews,3,0,3
972950,True,0,No user reviews,0,0,0
972960,True,0,No user reviews,0,0,0
972980,True,0,No user reviews,0,0,0
972990,True,0,No user reviews,0,0,0
973000,True,5,Mixed,19,12,31
973020,True,0,No user reviews,0,0,0
973040,True,0,3 user reviews,1,2,3
973050,True,7,Positive,19,3,22
973060,True,0,7 user reviews,6,1,7
973070,True,0,No user reviews,0,0,0
973090,True,5,Mixed,27,24,51
973100,True,0,7 user reviews,7,0,7
973110,True,0,3 user reviews,1,2,3
973130,True,0,No user reviews,0,0,0
973170,True,0,5 user reviews,4,1,5
973180,True,0,No user reviews,0,0,0
973200,True,0,No user reviews,0,0,0
973220,True,8,Very Positive,69,2,71
973230,True,0,No user reviews,0,0,0
973240,True,5,Mixed,17,8,25
973250,True,0,No user reviews,0,0,0
973260,True,0,4 user reviews,1,3,4
973270,True,0,1 user reviews,1,0,1
973280,True,0,No user reviews,0,0,0
973290,True,0,No user reviews,0,0,0
973300,True,0,6 user reviews,6,0,6
973310,True,0,No user reviews,0,0,0
973320,True,0,No user reviews,0,0,0
973330,True,0,No user reviews,0,0,0
973350,True,0,No user reviews,0,0,0
973360,True,0,1 user reviews,1,0,1
973370,True,0,1 user reviews,1,0,1
973380,True,0,No user reviews,0,0,0
973390,True,0,No user reviews,0,0,0
973400,True,0,No user reviews,0,0,0
973410,True,0,7 user reviews,7,0,7
973430,True,0,No user reviews,0,0,0
973440,True,0,2 user reviews,2,0,2
973450,True,0,No user reviews,0,0,0
973460,True,0,No user reviews,0,0,0
973490,True,0,No user reviews,0,0,0
973500,True,0,No user reviews,0,0,0
973520,True,0,No user reviews,0,0,0
973550,True,0,2 user reviews,1,1,2
973560,True,0,No user reviews,0,0,0
973580,True,6,Mostly Positive,917,276,1193
973590,True,0,7 user reviews,4,3,7
973600,True,7,Positive,38,9,47
973610,True,0,2 user reviews,2,0,2
973611,True,0,4 user reviews,4,0,4
973612,True,0,No user reviews,0,0,0
973640,True,0,2 user reviews,0,2,2
973690,True,0,No user reviews,0,0,0
973700,True,5,Mixed,21,10,31
973720,True,0,2 user reviews,0,2,2
973740,True,0,2 user reviews,2,0,2
973750,True,0,8 user reviews,6,2,8
973760,True,8,Very Positive,2122,298,2420
973770,True,0,1 user reviews,0,1,1
973780,True,0,No user reviews,0,0,0
973800,True,5,Mixed,9,10,19
973830,True,0,1 user reviews,1,0,1
973840,True,0,1 user reviews,1,0,1
973850,True,7,Positive,18,1,19
973860,True,0,No user reviews,0,0,0
973910,True,6,Mostly Positive,23,7,30
973920,True,0,No user reviews,0,0,0
973992,True,0,No user reviews,0,0,0
973993,True,0,No user reviews,0,0,0
973994,True,0,No user reviews,0,0,0
973995,True,0,No user reviews,0,0,0
973996,True,0,No user reviews,0,0,0
973997,True,0,No user reviews,0,0,0
974000,True,0,No user reviews,0,0,0
974001,True,0,No user reviews,0,0,0
974010,True,0,No user reviews,0,0,0
974040,True,0,4 user reviews,3,1,4
974050,True,0,No user reviews,0,0,0
974060,True,0,No user reviews,0,0,0
974070,True,0,No user reviews,0,0,0
974080,True,0,No user reviews,0,0,0
974110,True,0,8 user reviews,8,0,8
974130,True,0,No user reviews,0,0,0
974140,True,0,No user reviews,0,0,0
974150,True,0,No user reviews,0,0,0
974160,True,0,2 user reviews,1,1,2
974180,True,0,8 user reviews,5,3,8
974200,True,0,No user reviews,0,0,0
974220,True,0,No user reviews,0,0,0
974240,True,0,3 user reviews,2,1,3
974250,True,0,1 user reviews,0,1,1
974260,True,0,No user reviews,0,0,0
974270,True,0,1 user reviews,1,0,1
974290,True,0,9 user reviews,8,1,9
974300,True,7,Positive,11,0,11
974301,True,0,5 user reviews,5,0,5
974302,True,0,No user reviews,0,0,0
974310,True,0,1 user reviews,1,0,1
974320,True,0,7 user reviews,3,4,7
974330,True,0,4 user reviews,1,3,4
974340,True,0,No user reviews,0,0,0
974341,True,0,No user reviews,0,0,0
974342,True,0,No user reviews,0,0,0
974350,True,0,1 user reviews,1,0,1
974351,True,0,4 user reviews,1,3,4
974352,True,0,No user reviews,0,0,0
974353,True,0,2 user reviews,2,0,2
974354,True,0,1 user reviews,1,0,1
974360,True,0,No user reviews,0,0,0
974361,True,0,No user reviews,0,0,0
974362,True,0,1 user reviews,1,0,1
974363,True,0,No user reviews,0,0,0
974364,True,0,1 user reviews,1,0,1
974370,True,0,8 user reviews,3,5,8
974390,True,7,Positive,12,2,14
974400,True,5,Mixed,7,10,17
974420,True,0,No user reviews,0,0,0
974430,True,0,1 user reviews,1,0,1
974450,True,0,1 user reviews,1,0,1
974470,True,0,No user reviews,0,0,0
974510,True,0,No user reviews,0,0,0
974520,True,0,No user reviews,0,0,0
974530,True,0,4 user reviews,2,2,4
974550,True,0,No user reviews,0,0,0
974560,True,0,No user reviews,0,0,0
974570,True,8,Very Positive,46,9,55
974590,True,0,No user reviews,0,0,0
974600,True,0,7 user reviews,6,1,7
974610,True,6,Mostly Positive,36,14,50
974620,True,0,8 user reviews,4,4,8
974630,True,0,No user reviews,0,0,0
974650,True,7,Positive,35,0,35
974670,True,0,5 user reviews,2,3,5
974680,True,0,7 user reviews,4,3,7
974720,True,0,7 user reviews,5,2,7
974721,True,4,Mostly Negative,5,8,13
974722,True,0,6 user reviews,4,2,6
974723,True,7,Positive,10,2,12
974724,True,0,3 user reviews,2,1,3
974725,True,0,4 user reviews,3,1,4
974726,True,5,Mixed,17,8,25
974727,True,0,No user reviews,0,0,0
974728,True,0,No user reviews,0,0,0
974729,True,0,No user reviews,0,0,0
974730,True,0,No user reviews,0,0,0
974740,True,0,2 user reviews,2,0,2
974750,True,0,No user reviews,0,0,0
974780,True,0,No user reviews,0,0,0
974800,True,0,No user reviews,0,0,0
974830,True,0,No user reviews,0,0,0
974840,True,0,No user reviews,0,0,0
974850,True,0,1 user reviews,1,0,1
974860,True,0,2 user reviews,2,0,2
974870,True,7,Positive,16,0,16
974880,True,0,No user reviews,0,0,0
974890,True,0,No user reviews,0,0,0
974900,True,0,No user reviews,0,0,0
974910,True,8,Very Positive,65,3,68
974920,True,0,2 user reviews,1,1,2
974930,True,0,No user reviews,0,0,0
974950,True,0,No user reviews,0,0,0
974970,True,0,6 user reviews,6,0,6
975000,True,6,Mostly Positive,20,6,26
975020,True,5,Mixed,11,9,20
975030,True,0,No user reviews,0,0,0
975040,True,0,No user reviews,0,0,0
975050,True,0,No user reviews,0,0,0
975080,True,0,No user reviews,0,0,0
975081,True,0,No user reviews,0,0,0
975082,True,0,No user reviews,0,0,0
975100,True,0,2 user reviews,1,1,2
975110,True,0,No user reviews,0,0,0
975120,True,5,Mixed,6,4,10
975150,True,7,Positive,27,4,31
975160,True,0,No user reviews,0,0,0
975200,True,0,2 user reviews,1,1,2
975220,True,0,2 user reviews,0,2,2
975230,True,7,Positive,14,2,16
975240,True,6,Mostly Positive,43,11,54
975260,True,0,No user reviews,0,0,0
975261,True,0,No user reviews,0,0,0
975270,True,7,Positive,44,2,46
975280,True,7,Positive,8,2,10
975290,True,7,Positive,11,0,11
975300,True,0,No user reviews,0,0,0
975301,True,0,No user reviews,0,0,0
975302,True,0,No user reviews,0,0,0
975303,True,0,No user reviews,0,0,0
975350,True,0,No user reviews,0,0,0
975360,True,0,7 user reviews,6,1,7
975370,True,0,No user reviews,0,0,0
975380,True,0,No user reviews,0,0,0
975390,True,7,Positive,14,3,17
975400,True,8,Very Positive,207,50,257
975410,True,6,Mostly Positive,17,5,22
975430,True,7,Positive,9,1,10
975440,True,0,No user reviews,0,0,0
975450,True,0,No user reviews,0,0,0
975460,True,0,No user reviews,0,0,0
975470,True,5,Mixed,29,16,45
975480,True,0,No user reviews,0,0,0
975490,True,0,No user reviews,0,0,0
975500,True,0,No user reviews,0,0,0
975510,True,6,Mostly Positive,58,21,79
975520,True,0,No user reviews,0,0,0
975530,True,0,2 user reviews,1,1,2
975540,True,0,No user reviews,0,0,0
975541,True,0,No user reviews,0,0,0
975542,True,0,No user reviews,0,0,0
975550,True,0,3 user reviews,2,1,3
975560,True,7,Positive,16,2,18
975600,True,0,5 user reviews,4,1,5
975610,True,0,No user reviews,0,0,0
975620,True,0,1 user reviews,1,0,1
975640,True,5,Mixed,7,7,14
975660,True,5,Mixed,5,6,11
975670,True,0,No user reviews,0,0,0
975680,True,5,Mixed,66,44,110
975690,True,0,2 user reviews,2,0,2
975700,True,0,No user reviews,0,0,0
975710,True,0,1 user reviews,1,0,1
975750,True,0,No user reviews,0,0,0
975760,True,6,Mostly Positive,19,6,25
975770,True,0,5 user reviews,4,1,5
975780,True,0,No user reviews,0,0,0
975800,True,0,2 user reviews,2,0,2
975860,True,0,No user reviews,0,0,0
975910,True,0,6 user reviews,5,1,6
975930,True,0,No user reviews,0,0,0
975950,True,7,Positive,24,6,30
975980,True,0,No user reviews,0,0,0
976010,True,8,Very Positive,160,15,175
976020,True,0,No user reviews,0,0,0
976030,True,7,Positive,36,6,42
976040,True,0,No user reviews,0,0,0
976050,True,0,1 user reviews,1,0,1
976051,True,0,No user reviews,0,0,0
976060,True,0,No user reviews,0,0,0
976070,True,0,1 user reviews,0,1,1
976080,True,0,2 user reviews,2,0,2
976090,True,0,1 user reviews,1,0,1
976100,True,0,No user reviews,0,0,0
976120,True,7,Positive,38,6,44
976160,True,0,3 user reviews,1,2,3
976170,True,0,1 user reviews,0,1,1
976180,True,7,Positive,39,0,39
976190,True,0,No user reviews,0,0,0
976210,True,5,Mixed,24,12,36
976220,True,0,No user reviews,0,0,0
976230,True,0,3 user reviews,1,2,3
976240,True,0,1 user reviews,0,1,1
976260,True,0,5 user reviews,5,0,5
976280,True,0,2 user reviews,2,0,2
976290,True,0,No user reviews,0,0,0
976310,True,8,Very Positive,6911,1707,8618
976320,True,0,No user reviews,0,0,0
976330,True,0,9 user reviews,9,0,9
976340,True,5,Mixed,9,6,15
976350,True,0,1 user reviews,1,0,1
976360,True,0,2 user reviews,2,0,2
976370,True,0,No user reviews,0,0,0
976371,True,0,No user reviews,0,0,0
976380,True,0,No user reviews,0,0,0
976390,True,8,Very Positive,52,3,55
976410,True,0,No user reviews,0,0,0
976420,True,7,Positive,13,1,14
976480,True,0,No user reviews,0,0,0
976500,True,7,Positive,11,1,12
976520,True,0,No user reviews,0,0,0
976530,True,0,No user reviews,0,0,0
976531,True,0,No user reviews,0,0,0
976540,True,0,No user reviews,0,0,0
976560,True,0,No user reviews,0,0,0
976570,True,5,Mixed,7,7,14
976630,True,0,No user reviews,0,0,0
976650,True,0,No user reviews,0,0,0
976660,True,0,No user reviews,0,0,0
976661,True,0,No user reviews,0,0,0
976662,True,0,1 user reviews,1,0,1
976663,True,0,2 user reviews,2,0,2
976664,True,0,1 user reviews,0,1,1
976680,True,0,No user reviews,0,0,0
976690,True,0,No user reviews,0,0,0
976700,True,7,Positive,15,1,16
976720,True,0,4 user reviews,3,1,4
976730,True,8,Very Positive,68308,6317,74625
976750,True,0,No user reviews,0,0,0
976770,True,0,No user reviews,0,0,0
976780,True,6,Mostly Positive,46,16,62
976800,True,4,Mostly Negative,9,16,25
976810,True,0,No user reviews,0,0,0
976830,True,0,3 user reviews,3,0,3
976840,True,0,1 user reviews,0,1,1
976850,True,0,5 user reviews,5,0,5
976870,True,0,2 user reviews,2,0,2
976890,True,0,No user reviews,0,0,0
976900,True,0,No user reviews,0,0,0
976910,True,0,No user reviews,0,0,0
976920,True,8,Very Positive,42,8,50
976930,True,0,2 user reviews,2,0,2
976940,True,0,No user reviews,0,0,0
976960,True,0,9 user reviews,9,0,9
976970,True,0,2 user reviews,2,0,2
976980,True,0,No user reviews,0,0,0
977000,True,0,4 user reviews,4,0,4
977010,True,0,No user reviews,0,0,0
977020,True,0,No user reviews,0,0,0
977040,True,0,No user reviews,0,0,0
977050,True,0,No user reviews,0,0,0
977060,True,0,No user reviews,0,0,0
977070,True,0,6 user reviews,6,0,6
977080,True,0,2 user reviews,2,0,2
977100,True,7,Positive,13,1,14
977110,True,0,3 user reviews,2,1,3
977160,True,0,No user reviews,0,0,0
977170,True,0,No user reviews,0,0,0
977180,True,0,1 user reviews,1,0,1
977210,True,0,No user reviews,0,0,0
977220,True,0,8 user reviews,5,3,8
977230,True,8,Very Positive,104,3,107
977250,True,0,1 user reviews,1,0,1
977270,True,0,No user reviews,0,0,0
977280,True,0,No user reviews,0,0,0
977290,True,0,1 user reviews,1,0,1
977300,True,6,Mostly Positive,11,3,14
977310,True,0,2 user reviews,2,0,2
977320,True,0,No user reviews,0,0,0
977330,True,0,No user reviews,0,0,0
977340,True,5,Mixed,7,9,16
977360,True,0,No user reviews,0,0,0
977370,True,0,No user reviews,0,0,0
977380,True,0,No user reviews,0,0,0
977390,True,7,Positive,14,1,15
977400,True,0,No user reviews,0,0,0
977410,True,0,No user reviews,0,0,0
977420,True,5,Mixed,126,74,200
977430,True,0,1 user reviews,1,0,1
977450,True,0,No user reviews,0,0,0
977460,True,8,Very Positive,101,14,115
977490,True,0,1 user reviews,1,0,1
977500,True,0,2 user reviews,2,0,2
977510,True,0,No user reviews,0,0,0
977520,True,0,No user reviews,0,0,0
977530,True,0,3 user reviews,3,0,3
977540,True,0,No user reviews,0,0,0
977560,True,6,Mostly Positive,7,3,10
977570,True,5,Mixed,36,32,68
977580,True,0,No user reviews,0,0,0
977590,True,0,3 user reviews,1,2,3
977610,True,8,Very Positive,151,26,177
977630,True,0,No user reviews,0,0,0
977640,True,5,Mixed,12,6,18
977650,True,8,Very Positive,66,16,82
977670,True,0,2 user reviews,2,0,2
977690,True,7,Positive,17,3,20
977710,True,0,No user reviews,0,0,0
977720,True,5,Mixed,117,66,183
977750,True,0,No user reviews,0,0,0
977770,True,0,No user reviews,0,0,0
977780,True,0,No user reviews,0,0,0
977790,True,0,3 user reviews,1,2,3
977800,True,0,No user reviews,0,0,0
977810,True,7,Positive,40,3,43
977820,True,0,No user reviews,0,0,0
977830,True,0,No user reviews,0,0,0
977840,True,0,6 user reviews,6,0,6
977880,True,0,No user reviews,0,0,0
977900,True,0,4 user reviews,3,1,4
977920,True,0,No user reviews,0,0,0
977930,True,0,2 user reviews,2,0,2
977950,True,9,Overwhelmingly Positive,915,38,953
977980,True,0,No user reviews,0,0,0
978010,True,0,4 user reviews,4,0,4
978040,True,0,3 user reviews,2,1,3
978070,True,0,No user reviews,0,0,0
978080,True,0,No user reviews,0,0,0
978110,True,0,No user reviews,0,0,0
978120,True,0,No user reviews,0,0,0
978140,True,7,Positive,17,0,17
978150,True,0,No user reviews,0,0,0
978160,True,0,No user reviews,0,0,0
978161,True,0,No user reviews,0,0,0
978162,True,0,No user reviews,0,0,0
978170,True,0,No user reviews,0,0,0
978180,True,5,Mixed,5,5,10
978190,True,6,Mostly Positive,12,5,17
978200,True,0,No user reviews,0,0,0
978210,True,0,3 user reviews,2,1,3
978240,True,0,No user reviews,0,0,0
978250,True,8,Very Positive,76,3,79
978270,True,0,No user reviews,0,0,0
978290,True,0,No user reviews,0,0,0
978310,True,0,No user reviews,0,0,0
978340,True,0,4 user reviews,4,0,4
978350,True,0,No user reviews,0,0,0
978360,True,7,Positive,17,4,21
978380,True,0,1 user reviews,1,0,1
978440,True,0,4 user reviews,4,0,4
978450,True,0,1 user reviews,0,1,1
978460,True,0,No user reviews,0,0,0
978470,True,4,Mostly Negative,5,10,15
978490,True,0,No user reviews,0,0,0
978500,True,0,No user reviews,0,0,0
978510,True,0,7 user reviews,7,0,7
978520,True,8,Very Positive,446,81,527
978530,True,0,No user reviews,0,0,0
978531,True,0,No user reviews,0,0,0
978532,True,0,No user reviews,0,0,0
978580,True,0,1 user reviews,0,1,1
978600,True,0,No user reviews,0,0,0
978610,True,0,2 user reviews,0,2,2
978620,True,0,No user reviews,0,0,0
978630,True,0,No user reviews,0,0,0
978640,True,7,Positive,10,1,11
978650,True,0,1 user reviews,0,1,1
978660,True,0,1 user reviews,1,0,1
978670,True,0,No user reviews,0,0,0
978680,True,8,Very Positive,63,15,78
978690,True,7,Positive,18,1,19
978700,True,0,No user reviews,0,0,0
978710,True,0,1 user reviews,1,0,1
978720,True,5,Mixed,32,17,49
978730,True,0,1 user reviews,1,0,1
978740,True,0,2 user reviews,2,0,2
978760,True,0,No user reviews,0,0,0
978780,True,9,Overwhelmingly Positive,1153,45,1198
978790,True,0,3 user reviews,3,0,3
978800,True,0,2 user reviews,2,0,2
978810,True,0,No user reviews,0,0,0
978830,True,0,No user reviews,0,0,0
978840,True,0,No user reviews,0,0,0
978850,True,0,No user reviews,0,0,0
978851,True,0,1 user reviews,0,1,1
978852,True,0,No user reviews,0,0,0
978853,True,0,No user reviews,0,0,0
978854,True,0,No user reviews,0,0,0
978855,True,0,No user reviews,0,0,0
978856,True,0,No user reviews,0,0,0
978857,True,0,No user reviews,0,0,0
978858,True,0,No user reviews,0,0,0
978859,True,0,No user reviews,0,0,0
978860,True,0,No user reviews,0,0,0
978861,True,0,1 user reviews,1,0,1
978862,True,0,No user reviews,0,0,0
978863,True,0,No user reviews,0,0,0
978864,True,0,No user reviews,0,0,0
978865,True,0,No user reviews,0,0,0
978866,True,0,No user reviews,0,0,0
978867,True,0,No user reviews,0,0,0
978870,True,6,Mostly Positive,19,5,24
978880,True,0,4 user reviews,4,0,4
978890,True,0,No user reviews,0,0,0
978910,True,0,No user reviews,0,0,0
978920,True,0,No user reviews,0,0,0
978960,True,5,Mixed,37,22,59
978970,True,0,No user reviews,0,0,0
978980,True,0,No user reviews,0,0,0
978990,True,0,5 user reviews,3,2,5
979000,True,0,1 user reviews,0,1,1
979010,True,5,Mixed,22,11,33
979030,True,0,No user reviews,0,0,0
979050,True,0,No user reviews,0,0,0
979060,True,0,No user reviews,0,0,0
979070,True,0,No user reviews,0,0,0
979080,True,0,No user reviews,0,0,0
979090,True,7,Positive,26,2,28
979100,True,0,No user reviews,0,0,0
979110,True,8,Very Positive,1229,179,1408
979120,True,8,Very Positive,1073,114,1187
979130,True,0,1 user reviews,1,0,1
979131,True,0,4 user reviews,4,0,4
979132,True,0,1 user reviews,0,1,1
979133,True,0,No user reviews,0,0,0
979140,True,0,No user reviews,0,0,0
979160,True,0,5 user reviews,4,1,5
979190,True,0,No user reviews,0,0,0
979220,True,0,No user reviews,0,0,0
979260,True,0,No user reviews,0,0,0
979280,True,0,3 user reviews,3,0,3
979290,True,0,No user reviews,0,0,0
979300,True,0,1 user reviews,0,1,1
979310,True,0,No user reviews,0,0,0
979330,True,5,Mixed,16,10,26
979340,True,0,No user reviews,0,0,0
979350,True,0,No user reviews,0,0,0
979360,True,0,No user reviews,0,0,0
979390,True,0,1 user reviews,0,1,1
979400,True,6,Mostly Positive,13,5,18
979410,True,0,No user reviews,0,0,0
979450,True,0,7 user reviews,7,0,7
979460,True,0,No user reviews,0,0,0
979461,True,0,No user reviews,0,0,0
979462,True,0,No user reviews,0,0,0
979463,True,0,No user reviews,0,0,0
979464,True,0,1 user reviews,1,0,1
979465,True,0,2 user reviews,0,2,2
979466,True,0,No user reviews,0,0,0
979467,True,0,No user reviews,0,0,0
979468,True,0,No user reviews,0,0,0
979469,True,0,No user reviews,0,0,0
979470,True,0,No user reviews,0,0,0
979480,True,0,No user reviews,0,0,0
979500,True,0,No user reviews,0,0,0
979510,True,0,No user reviews,0,0,0
979520,True,7,Positive,9,1,10
979530,True,0,6 user reviews,5,1,6
979550,True,0,2 user reviews,1,1,2
979560,True,5,Mixed,44,29,73
979580,True,0,2 user reviews,2,0,2
979590,True,0,No user reviews,0,0,0
979600,True,8,Very Positive,301,5,306
979610,True,0,No user reviews,0,0,0
979620,True,0,3 user reviews,2,1,3
979640,True,8,Very Positive,140,17,157
979650,True,0,1 user reviews,1,0,1
979680,True,0,No user reviews,0,0,0
979690,True,0,No user reviews,0,0,0
979700,True,0,2 user reviews,2,0,2
979710,True,8,Very Positive,69,6,75
979720,True,0,7 user reviews,5,2,7
979730,True,0,No user reviews,0,0,0
979740,True,0,7 user reviews,5,2,7
979760,True,0,No user reviews,0,0,0
979780,True,0,2 user reviews,2,0,2
979790,True,0,No user reviews,0,0,0
979800,True,5,Mixed,14,9,23
979810,True,5,Mixed,5,5,10
979830,True,0,No user reviews,0,0,0
979850,True,0,No user reviews,0,0,0
979851,True,0,No user reviews,0,0,0
979852,True,0,No user reviews,0,0,0
979860,True,0,No user reviews,0,0,0
979861,True,0,No user reviews,0,0,0
979870,True,0,No user reviews,0,0,0
979880,True,0,1 user reviews,1,0,1
979890,True,0,1 user reviews,0,1,1
979900,True,0,2 user reviews,2,0,2
979910,True,0,7 user reviews,3,4,7
979920,True,0,No user reviews,0,0,0
979930,True,8,Very Positive,52,8,60
979950,True,0,No user reviews,0,0,0
979970,True,5,Mixed,8,4,12
979990,True,0,No user reviews,0,0,0
980000,True,0,No user reviews,0,0,0
980030,True,0,No user reviews,0,0,0
980050,True,0,1 user reviews,1,0,1
980080,True,0,No user reviews,0,0,0
980090,True,0,1 user reviews,1,0,1
980100,True,0,No user reviews,0,0,0
980160,True,0,No user reviews,0,0,0
980180,True,0,No user reviews,0,0,0
980190,True,0,2 user reviews,2,0,2
980210,True,0,No user reviews,0,0,0
980240,True,0,No user reviews,0,0,0
980270,True,0,No user reviews,0,0,0
980271,True,0,No user reviews,0,0,0
980272,True,0,No user reviews,0,0,0
980290,True,0,No user reviews,0,0,0
980291,True,0,1 user reviews,1,0,1
980300,True,9,Overwhelmingly Positive,1948,62,2010
980320,True,5,Mixed,6,4,10
980330,True,0,No user reviews,0,0,0
980360,True,0,No user reviews,0,0,0
980370,True,0,2 user reviews,2,0,2
980380,True,0,No user reviews,0,0,0
980390,True,0,3 user reviews,3,0,3
980400,True,0,2 user reviews,2,0,2
980410,True,0,1 user reviews,1,0,1
980420,True,0,1 user reviews,1,0,1
980430,True,0,No user reviews,0,0,0
980440,True,0,2 user reviews,1,1,2
980450,True,0,No user reviews,0,0,0
980460,True,0,2 user reviews,2,0,2
980470,True,0,No user reviews,0,0,0
980480,True,7,Positive,19,0,19
980490,True,0,4 user reviews,4,0,4
980520,True,0,5 user reviews,5,0,5
980541,True,0,6 user reviews,1,5,6
980542,True,4,Mostly Negative,4,8,12
980543,True,0,2 user reviews,2,0,2
980544,True,5,Mixed,9,7,16
980545,True,0,4 user reviews,1,3,4
980546,True,0,4 user reviews,4,0,4
980547,True,0,7 user reviews,4,3,7
980548,True,5,Mixed,12,8,20
980549,True,0,2 user reviews,1,1,2
980550,True,0,1 user reviews,1,0,1
980560,True,0,2 user reviews,0,2,2
980570,True,0,No user reviews,0,0,0
980590,True,7,Positive,16,1,17
980591,True,6,Mostly Positive,10,3,13
980592,True,7,Positive,17,0,17
980600,True,0,3 user reviews,3,0,3
980610,True,0,No user reviews,0,0,0
980630,True,0,No user reviews,0,0,0
980690,True,0,4 user reviews,3,1,4
980700,True,0,No user reviews,0,0,0
980710,True,0,No user reviews,0,0,0
980720,True,0,5 user reviews,5,0,5
980730,True,0,No user reviews,0,0,0
980740,True,0,No user reviews,0,0,0
980750,True,0,2 user reviews,2,0,2
980760,True,0,1 user reviews,1,0,1
980770,True,0,2 user reviews,1,1,2
980800,True,0,No user reviews,0,0,0
980810,True,0,No user reviews,0,0,0
980820,True,0,No user reviews,0,0,0
980830,True,8,Very Positive,52,6,58
980850,True,0,1 user reviews,0,1,1
980860,True,0,No user reviews,0,0,0
980880,True,0,9 user reviews,8,1,9
980930,True,0,No user reviews,0,0,0
980940,True,6,Mostly Positive,152,58,210
980950,True,0,No user reviews,0,0,0
981010,True,0,No user reviews,0,0,0
981020,True,7,Positive,41,1,42
981040,True,0,No user reviews,0,0,0
981050,True,0,2 user reviews,1,1,2
981070,True,0,No user reviews,0,0,0
981080,True,0,No user reviews,0,0,0
981090,True,0,No user reviews,0,0,0
981120,True,0,No user reviews,0,0,0
981130,True,0,2 user reviews,0,2,2
981140,True,0,2 user reviews,0,2,2
981150,True,0,No user reviews,0,0,0
981160,True,6,Mostly Positive,9,3,12
981180,True,0,No user reviews,0,0,0
981230,True,0,No user reviews,0,0,0
981240,True,0,No user reviews,0,0,0
981250,True,0,1 user reviews,1,0,1
981260,True,6,Mostly Positive,46,13,59
981270,True,0,2 user reviews,2,0,2
981280,True,0,No user reviews,0,0,0
981290,True,0,No user reviews,0,0,0
981300,True,8,Very Positive,49,9,58
981310,True,0,No user reviews,0,0,0
981320,True,0,1 user reviews,0,1,1
981330,True,0,No user reviews,0,0,0
981340,True,0,No user reviews,0,0,0
981360,True,0,No user reviews,0,0,0
981380,True,0,No user reviews,0,0,0
981420,True,7,Positive,37,2,39
981430,True,8,Very Positive,447,25,472
981440,True,0,3 user reviews,3,0,3
981450,True,0,1 user reviews,1,0,1
981460,True,0,No user reviews,0,0,0
981470,True,0,No user reviews,0,0,0
981480,True,0,No user reviews,0,0,0
981500,True,0,2 user reviews,2,0,2
981510,True,0,No user reviews,0,0,0
981530,True,0,No user reviews,0,0,0
981540,True,0,No user reviews,0,0,0
981550,True,5,Mixed,13,6,19
981590,True,0,3 user reviews,2,1,3
981610,True,0,1 user reviews,1,0,1
981620,True,0,5 user reviews,5,0,5
981630,True,0,6 user reviews,6,0,6
981660,True,0,No user reviews,0,0,0
981670,True,0,1 user reviews,1,0,1
981690,True,0,2 user reviews,0,2,2
981700,True,0,1 user reviews,1,0,1
981701,True,0,2 user reviews,2,0,2
981702,True,0,1 user reviews,1,0,1
981710,True,0,1 user reviews,1,0,1
981720,True,0,No user reviews,0,0,0
981730,True,0,No user reviews,0,0,0
981750,True,8,Very Positive,151,32,183
981770,True,8,Very Positive,89,8,97
981790,True,0,7 user reviews,1,6,7
981800,True,0,3 user reviews,1,2,3
981810,True,0,No user reviews,0,0,0
981830,True,0,No user reviews,0,0,0
981840,True,0,No user reviews,0,0,0
981850,True,0,8 user reviews,6,2,8
981870,True,0,No user reviews,0,0,0
981880,True,7,Positive,14,1,15
981900,True,0,No user reviews,0,0,0
981910,True,5,Mixed,5,6,11
981960,True,6,Mostly Positive,10,4,14
981980,True,0,No user reviews,0,0,0
981990,True,0,No user reviews,0,0,0
982010,True,0,No user reviews,0,0,0
982020,True,0,1 user reviews,1,0,1
982040,True,7,Positive,13,3,16
982050,True,0,1 user reviews,1,0,1
982060,True,8,Very Positive,48,12,60
982070,True,0,No user reviews,0,0,0
982071,True,0,No user reviews,0,0,0
982090,True,0,No user reviews,0,0,0
982100,True,0,2 user reviews,0,2,2
982110,True,7,Positive,29,0,29
982120,True,0,1 user reviews,1,0,1
982130,True,0,No user reviews,0,0,0
982150,True,8,Very Positive,146,19,165
982180,True,0,5 user reviews,3,2,5
982190,True,0,No user reviews,0,0,0
982200,True,0,4 user reviews,4,0,4
982201,True,0,2 user reviews,2,0,2
982220,True,8,Very Positive,128,13,141
982240,True,0,4 user reviews,0,4,4
982250,True,0,4 user reviews,4,0,4
982260,True,0,No user reviews,0,0,0
982270,True,8,Very Positive,126,7,133
982290,True,0,No user reviews,0,0,0
982310,True,0,No user reviews,0,0,0
982320,True,0,No user reviews,0,0,0
982370,True,0,No user reviews,0,0,0
982380,True,0,No user reviews,0,0,0
982390,True,0,1 user reviews,1,0,1
982400,True,0,No user reviews,0,0,0
982410,True,0,No user reviews,0,0,0
982420,True,0,No user reviews,0,0,0
982440,True,5,Mixed,33,16,49
982450,True,6,Mostly Positive,15,6,21
982460,True,0,No user reviews,0,0,0
982461,True,0,No user reviews,0,0,0
982470,True,0,1 user reviews,1,0,1
982471,True,0,No user reviews,0,0,0
982472,True,0,No user reviews,0,0,0
982473,True,0,No user reviews,0,0,0
982480,True,0,3 user reviews,0,3,3
982490,True,0,No user reviews,0,0,0
982510,True,0,No user reviews,0,0,0
982520,True,5,Mixed,17,11,28
982540,True,7,Positive,10,0,10
982580,True,6,Mostly Positive,7,3,10
982590,True,5,Mixed,23,13,36
982600,True,0,No user reviews,0,0,0
982610,True,0,No user reviews,0,0,0
982630,True,0,No user reviews,0,0,0
982640,True,0,No user reviews,0,0,0
982650,True,0,No user reviews,0,0,0
982660,True,0,No user reviews,0,0,0
982670,True,0,3 user reviews,2,1,3
982690,True,0,1 user reviews,0,1,1
982700,True,6,Mostly Positive,36,13,49
982710,True,0,No user reviews,0,0,0
982720,True,0,No user reviews,0,0,0
982750,True,0,No user reviews,0,0,0
982760,True,5,Mixed,7,7,14
982780,True,0,No user reviews,0,0,0
982800,True,0,6 user reviews,4,2,6
982810,True,0,No user reviews,0,0,0
982830,True,0,No user reviews,0,0,0
982840,True,0,3 user reviews,3,0,3
982850,True,0,2 user reviews,1,1,2
982910,True,0,No user reviews,0,0,0
982960,True,0,No user reviews,0,0,0
982970,True,6,Mostly Positive,117,43,160
982980,True,0,No user reviews,0,0,0
982990,True,0,2 user reviews,2,0,2
983040,True,0,No user reviews,0,0,0
983050,True,7,Positive,11,0,11
983060,True,0,No user reviews,0,0,0
983070,True,0,No user reviews,0,0,0
983080,True,0,No user reviews,0,0,0
983090,True,0,No user reviews,0,0,0
983100,True,0,2 user reviews,2,0,2
983120,True,0,No user reviews,0,0,0
983140,True,7,Positive,21,0,21
983150,True,0,1 user reviews,1,0,1
983160,True,0,5 user reviews,2,3,5
983170,True,0,2 user reviews,1,1,2
983190,True,0,No user reviews,0,0,0
983240,True,0,3 user reviews,2,1,3
983260,True,0,No user reviews,0,0,0
983270,True,0,No user reviews,0,0,0
983271,True,0,No user reviews,0,0,0
983280,True,0,3 user reviews,3,0,3
983290,True,7,Positive,18,4,22
983300,True,0,1 user reviews,1,0,1
983320,True,0,No user reviews,0,0,0
983330,True,0,No user reviews,0,0,0
983340,True,0,2 user reviews,1,1,2
983350,True,8,Very Positive,151,23,174
983360,True,0,No user reviews,0,0,0
983380,True,0,No user reviews,0,0,0
983390,True,0,No user reviews,0,0,0
983440,True,4,Mostly Negative,6,10,16
983441,True,0,8 user reviews,5,3,8
983442,True,0,2 user reviews,1,1,2
983450,True,7,Positive,9,1,10
983460,True,0,No user reviews,0,0,0
983470,True,0,No user reviews,0,0,0
983480,True,0,No user reviews,0,0,0
983490,True,0,No user reviews,0,0,0
983500,True,0,No user reviews,0,0,0
983520,True,0,2 user reviews,2,0,2
983530,True,0,No user reviews,0,0,0
983580,True,0,No user reviews,0,0,0
983590,True,0,2 user reviews,2,0,2
983610,True,0,1 user reviews,0,1,1
983640,True,0,6 user reviews,6,0,6
983650,True,0,No user reviews,0,0,0
983660,True,0,No user reviews,0,0,0
983670,True,5,Mixed,8,9,17
983680,True,0,No user reviews,0,0,0
983760,True,0,9 user reviews,9,0,9
983780,True,0,2 user reviews,1,1,2
983790,True,0,3 user reviews,3,0,3
983800,True,0,No user reviews,0,0,0
983820,True,0,8 user reviews,2,6,8
983830,True,0,6 user reviews,5,1,6
983840,True,5,Mixed,5,6,11
983870,True,0,No user reviews,0,0,0
983880,True,5,Mixed,5,6,11
983890,True,0,5 user reviews,1,4,5
983900,True,0,2 user reviews,2,0,2
983920,True,0,No user reviews,0,0,0
983930,True,0,No user reviews,0,0,0
983950,True,0,No user reviews,0,0,0
983970,True,0,No user reviews,0,0,0
983980,True,0,9 user reviews,6,3,9
983990,True,0,2 user reviews,2,0,2
984000,True,0,No user reviews,0,0,0
984010,True,0,No user reviews,0,0,0
984020,True,0,5 user reviews,5,0,5
984030,True,0,1 user reviews,1,0,1
984070,True,0,9 user reviews,6,3,9
984080,True,0,5 user reviews,0,5,5
984090,True,0,No user reviews,0,0,0
984100,True,0,No user reviews,0,0,0
984110,True,0,4 user reviews,4,0,4
984130,True,0,2 user reviews,2,0,2
984150,True,0,1 user reviews,0,1,1
984160,True,0,No user reviews,0,0,0
984161,True,0,No user reviews,0,0,0
984162,True,0,No user reviews,0,0,0
984170,True,0,1 user reviews,0,1,1
984180,True,7,Positive,20,5,25
984200,True,0,1 user reviews,1,0,1
984210,True,0,7 user reviews,5,2,7
984220,True,7,Positive,12,2,14
984230,True,0,No user reviews,0,0,0
984240,True,0,No user reviews,0,0,0
984250,True,0,2 user reviews,2,0,2
984260,True,0,No user reviews,0,0,0
984270,True,0,1 user reviews,1,0,1
984280,True,0,No user reviews,0,0,0
984300,True,0,5 user reviews,4,1,5
984330,True,0,No user reviews,0,0,0
984340,True,0,1 user reviews,1,0,1
984360,True,0,5 user reviews,5,0,5
984370,True,0,No user reviews,0,0,0
984440,True,0,No user reviews,0,0,0
984450,True,7,Positive,19,0,19
984470,True,7,Positive,9,1,10
984490,True,0,No user reviews,0,0,0
984510,True,0,3 user reviews,3,0,3
984520,True,0,4 user reviews,1,3,4
984530,True,0,No user reviews,0,0,0
984540,True,0,6 user reviews,6,0,6
984550,True,0,No user reviews,0,0,0
984560,True,8,Very Positive,293,41,334
984570,True,0,No user reviews,0,0,0
984580,True,0,No user reviews,0,0,0
984590,True,0,2 user reviews,2,0,2
984610,True,7,Positive,32,1,33
984630,True,0,No user reviews,0,0,0
984660,True,5,Mixed,9,8,17
984680,True,8,Very Positive,188,45,233
984690,True,0,No user reviews,0,0,0
984710,True,0,2 user reviews,0,2,2
984711,True,0,2 user reviews,0,2,2
984720,True,7,Positive,37,5,42
984730,True,0,4 user reviews,3,1,4
984740,True,0,2 user reviews,0,2,2
984741,True,0,2 user reviews,0,2,2
984780,True,8,Very Positive,327,46,373
984800,True,6,Mostly Positive,105,39,144
984810,True,0,No user reviews,0,0,0
984820,True,0,3 user reviews,0,3,3
984830,True,0,1 user reviews,1,0,1
984850,True,0,No user reviews,0,0,0
984860,True,0,No user reviews,0,0,0
984870,True,0,No user reviews,0,0,0
984880,True,0,1 user reviews,1,0,1
984910,True,0,5 user reviews,5,0,5
984920,True,0,No user reviews,0,0,0
984930,True,0,3 user reviews,1,2,3
984970,True,0,1 user reviews,1,0,1
984980,True,0,No user reviews,0,0,0
984990,True,0,No user reviews,0,0,0
985000,True,0,No user reviews,0,0,0
985020,True,0,No user reviews,0,0,0
985040,True,7,Positive,29,5,34
985050,True,0,No user reviews,0,0,0
985060,True,0,No user reviews,0,0,0
985070,True,0,1 user reviews,0,1,1
985080,True,7,Positive,20,0,20
985090,True,0,No user reviews,0,0,0
985110,True,7,Positive,10,1,11
985130,True,0,No user reviews,0,0,0
985140,True,0,No user reviews,0,0,0
985150,True,0,No user reviews,0,0,0
985180,True,0,No user reviews,0,0,0
985190,True,0,3 user reviews,3,0,3
985200,True,0,No user reviews,0,0,0
985240,True,0,No user reviews,0,0,0
985250,True,0,No user reviews,0,0,0
985260,True,8,Very Positive,78,10,88
985270,True,0,No user reviews,0,0,0
985280,True,0,1 user reviews,0,1,1
985290,True,0,No user reviews,0,0,0
985330,True,0,6 user reviews,4,2,6
985340,True,0,No user reviews,0,0,0
985400,True,5,Mixed,11,5,16
985410,True,0,No user reviews,0,0,0
985420,True,0,1 user reviews,0,1,1
985430,True,5,Mixed,25,14,39
985450,True,0,No user reviews,0,0,0
985460,True,0,3 user reviews,3,0,3
985470,True,0,2 user reviews,2,0,2
985500,True,0,4 user reviews,2,2,4
985510,True,7,Positive,11,2,13
985520,True,0,No user reviews,0,0,0
985530,True,0,6 user reviews,4,2,6
985540,True,0,No user reviews,0,0,0
985550,True,0,No user reviews,0,0,0
985560,True,0,No user reviews,0,0,0
985580,True,0,3 user reviews,2,1,3
985590,True,7,Positive,20,0,20
985600,True,0,No user reviews,0,0,0
985620,True,0,4 user reviews,4,0,4
985630,True,0,No user reviews,0,0,0
985640,True,0,4 user reviews,2,2,4
985650,True,0,No user reviews,0,0,0
985660,True,0,1 user reviews,0,1,1
985680,True,0,No user reviews,0,0,0
985690,True,0,1 user reviews,1,0,1
985700,True,0,No user reviews,0,0,0
985710,True,0,9 user reviews,1,8,9
985720,True,4,Mostly Negative,6,12,18
985740,True,0,No user reviews,0,0,0
985750,True,0,No user reviews,0,0,0
985760,True,5,Mixed,40,19,59
985770,True,0,1 user reviews,0,1,1
985780,True,0,No user reviews,0,0,0
985790,True,0,No user reviews,0,0,0
985800,True,6,Mostly Positive,7,3,10
985830,True,0,No user reviews,0,0,0
985840,True,0,No user reviews,0,0,0
985860,True,0,1 user reviews,1,0,1
985870,True,0,No user reviews,0,0,0
985890,True,8,Very Positive,2810,262,3072
985900,True,0,No user reviews,0,0,0
985920,True,3,Negative,2,10,12
985930,True,0,No user reviews,0,0,0
985940,True,0,3 user reviews,1,2,3
985950,True,6,Mostly Positive,89,33,122
986000,True,0,No user reviews,0,0,0
986001,True,0,No user reviews,0,0,0
986010,True,0,No user reviews,0,0,0
986020,True,8,Very Positive,50,7,57
986040,True,0,No user reviews,0,0,0
986050,True,0,No user reviews,0,0,0
986060,True,0,No user reviews,0,0,0
986070,True,7,Positive,10,0,10
986080,True,5,Mixed,6,5,11
986090,True,7,Positive,41,0,41
986110,True,0,No user reviews,0,0,0
986120,True,0,2 user reviews,1,1,2
986130,True,0,No user reviews,0,0,0
986140,True,0,1 user reviews,1,0,1
986170,True,0,2 user reviews,2,0,2
986180,True,0,No user reviews,0,0,0
986220,True,0,No user reviews,0,0,0
986230,True,0,1 user reviews,1,0,1
986240,True,0,2 user reviews,2,0,2
986250,True,7,Positive,30,1,31
986280,True,7,Positive,16,1,17
986290,True,0,No user reviews,0,0,0
986300,True,0,1 user reviews,1,0,1
986310,True,0,No user reviews,0,0,0
986320,True,0,No user reviews,0,0,0
986340,True,0,7 user reviews,5,2,7
986350,True,0,No user reviews,0,0,0
986370,True,0,7 user reviews,7,0,7
986400,True,0,1 user reviews,0,1,1
986470,True,0,No user reviews,0,0,0
986490,True,0,No user reviews,0,0,0
986500,True,0,No user reviews,0,0,0
986510,True,7,Positive,17,0,17
986520,True,0,No user reviews,0,0,0
986630,True,0,No user reviews,0,0,0
986670,True,0,1 user reviews,1,0,1
986680,True,0,9 user reviews,8,1,9
986700,True,0,No user reviews,0,0,0
986710,True,7,Positive,11,1,12
986760,True,0,No user reviews,0,0,0
986770,True,0,No user reviews,0,0,0
986780,True,0,No user reviews,0,0,0
986790,True,0,2 user reviews,1,1,2
986800,True,8,Very Positive,147,1,148
986820,True,7,Positive,15,2,17
986830,True,7,Positive,11,1,12
986840,True,0,No user reviews,0,0,0
986850,True,6,Mostly Positive,54,19,73
986860,True,0,No user reviews,0,0,0
986870,True,0,1 user reviews,1,0,1
986920,True,0,1 user reviews,1,0,1
986930,True,0,No user reviews,0,0,0
986950,True,0,No user reviews,0,0,0
986970,True,0,No user reviews,0,0,0
986990,True,7,Positive,15,2,17
987000,True,7,Positive,24,6,30
987020,True,8,Very Positive,343,40,383
987040,True,0,2 user reviews,0,2,2
987050,True,6,Mostly Positive,21,8,29
987060,True,0,1 user reviews,1,0,1
987070,True,7,Positive,11,0,11
987110,True,0,No user reviews,0,0,0
987120,True,0,No user reviews,0,0,0
987140,True,0,No user reviews,0,0,0
987150,True,5,Mixed,61,37,98
987170,True,0,9 user reviews,6,3,9
987180,True,0,9 user reviews,6,3,9
987190,True,7,Positive,18,4,22
987200,True,5,Mixed,14,8,22
987210,True,6,Mostly Positive,8,3,11
987220,True,0,No user reviews,0,0,0
987230,True,6,Mostly Positive,136,55,191
987240,True,0,No user reviews,0,0,0
987250,True,0,1 user reviews,0,1,1
987260,True,0,No user reviews,0,0,0
987270,True,7,Positive,12,3,15
987280,True,0,No user reviews,0,0,0
987290,True,7,Positive,15,3,18
987310,True,0,No user reviews,0,0,0
987320,True,0,No user reviews,0,0,0
987330,True,5,Mixed,12,12,24
987340,True,0,3 user reviews,3,0,3
987350,True,8,Very Positive,52,8,60
987370,True,0,No user reviews,0,0,0
987400,True,7,Positive,37,7,44
987410,True,7,Positive,14,2,16
987430,True,0,No user reviews,0,0,0
987440,True,0,1 user reviews,1,0,1
987450,True,0,No user reviews,0,0,0
987460,True,0,No user reviews,0,0,0
987490,True,0,2 user reviews,0,2,2
987500,True,0,2 user reviews,2,0,2
987570,True,0,6 user reviews,5,1,6
987580,True,0,4 user reviews,4,0,4
987590,True,0,9 user reviews,4,5,9
987600,True,0,No user reviews,0,0,0
987620,True,0,1 user reviews,1,0,1
987630,True,5,Mixed,5,5,10
987650,True,0,No user reviews,0,0,0
987660,True,0,2 user reviews,1,1,2
987670,True,0,3 user reviews,3,0,3
987680,True,0,No user reviews,0,0,0
987710,True,0,7 user reviews,7,0,7
987720,True,5,Mixed,87,42,129
987730,True,7,Positive,10,2,12
987740,True,0,8 user reviews,6,2,8
987770,True,7,Positive,30,6,36
987780,True,0,1 user reviews,1,0,1
987790,True,0,No user reviews,0,0,0
987800,True,0,2 user reviews,1,1,2
987810,True,0,7 user reviews,6,1,7
987820,True,0,No user reviews,0,0,0
987830,True,0,No user reviews,0,0,0
987850,True,5,Mixed,19,12,31
987860,True,0,No user reviews,0,0,0
987880,True,7,Positive,18,1,19
987900,True,0,No user reviews,0,0,0
987910,True,0,No user reviews,0,0,0
987930,True,0,No user reviews,0,0,0
987950,True,6,Mostly Positive,20,6,26
987980,True,0,No user reviews,0,0,0
987990,True,0,3 user reviews,3,0,3
988000,True,0,No user reviews,0,0,0
988010,True,0,2 user reviews,2,0,2
988011,True,0,No user reviews,0,0,0
988012,True,0,No user reviews,0,0,0
988013,True,0,No user reviews,0,0,0
988014,True,0,No user reviews,0,0,0
988015,True,0,No user reviews,0,0,0
988016,True,0,No user reviews,0,0,0
988017,True,0,No user reviews,0,0,0
988018,True,0,No user reviews,0,0,0
988019,True,0,No user reviews,0,0,0
988020,True,0,No user reviews,0,0,0
988021,True,0,1 user reviews,1,0,1
988040,True,0,No user reviews,0,0,0
988041,True,0,2 user reviews,2,0,2
988042,True,0,No user reviews,0,0,0
988043,True,0,1 user reviews,1,0,1
988044,True,0,No user reviews,0,0,0
988045,True,0,No user reviews,0,0,0
988046,True,0,No user reviews,0,0,0
988047,True,0,No user reviews,0,0,0
988070,True,0,1 user reviews,0,1,1
988080,True,0,1 user reviews,0,1,1
988100,True,7,Positive,13,2,15
988110,True,0,3 user reviews,3,0,3
988150,True,0,2 user reviews,2,0,2
988160,True,7,Positive,10,0,10
988170,True,0,7 user reviews,2,5,7
988171,True,5,Mixed,12,6,18
988172,True,5,Mixed,10,9,19
988180,True,4,Mostly Negative,5,8,13
988190,True,0,7 user reviews,4,3,7
988210,True,0,No user reviews,0,0,0
988220,True,0,No user reviews,0,0,0
988230,True,0,No user reviews,0,0,0
988240,True,5,Mixed,11,8,19
988250,True,0,2 user reviews,2,0,2
988310,True,7,Positive,20,1,21
988320,True,0,5 user reviews,5,0,5
988330,True,0,1 user reviews,0,1,1
988340,True,4,Mostly Negative,3,7,10
988350,True,0,No user reviews,0,0,0
988360,True,0,No user reviews,0,0,0
988410,True,0,No user reviews,0,0,0
988430,True,0,No user reviews,0,0,0
988440,True,5,Mixed,62,77,139
988450,True,5,Mixed,25,13,38
988470,True,7,Positive,39,6,45
988480,True,0,No user reviews,0,0,0
988490,True,8,Very Positive,50,3,53
988500,True,0,No user reviews,0,0,0
988550,True,0,No user reviews,0,0,0
988590,True,0,No user reviews,0,0,0
988620,True,0,3 user reviews,3,0,3
988621,True,0,2 user reviews,2,0,2
988630,True,0,No user reviews,0,0,0
988640,True,0,No user reviews,0,0,0
988650,True,7,Positive,11,1,12
988690,True,0,No user reviews,0,0,0
988720,True,0,No user reviews,0,0,0
988740,True,0,No user reviews,0,0,0
988750,True,0,3 user reviews,3,0,3
988760,True,0,No user reviews,0,0,0
988780,True,0,No user reviews,0,0,0
988810,True,0,8 user reviews,7,1,8
988830,True,0,No user reviews,0,0,0
988840,True,0,No user reviews,0,0,0
988850,True,0,No user reviews,0,0,0
988870,True,0,2 user reviews,2,0,2
988890,True,0,4 user reviews,3,1,4
988910,True,8,Very Positive,470,40,510
988920,True,0,1 user reviews,0,1,1
988940,True,5,Mixed,14,9,23
988950,True,0,No user reviews,0,0,0
988960,True,0,No user reviews,0,0,0
988970,True,0,No user reviews,0,0,0
988980,True,0,6 user reviews,5,1,6
988990,True,0,No user reviews,0,0,0
989000,True,0,1 user reviews,0,1,1
989010,True,0,3 user reviews,1,2,3
989030,True,0,No user reviews,0,0,0
989040,True,0,3 user reviews,1,2,3
989050,True,5,Mixed,10,7,17
989060,True,0,5 user reviews,5,0,5
989080,True,7,Positive,9,1,10
989110,True,0,1 user reviews,0,1,1
989120,True,0,No user reviews,0,0,0
989140,True,0,1 user reviews,1,0,1
989150,True,0,No user reviews,0,0,0
989160,True,0,3 user reviews,2,1,3
989170,True,0,5 user reviews,5,0,5
989190,True,0,No user reviews,0,0,0
989210,True,0,No user reviews,0,0,0
989220,True,0,No user reviews,0,0,0
989230,True,0,No user reviews,0,0,0
989240,True,0,No user reviews,0,0,0
989250,True,0,2 user reviews,0,2,2
989260,True,0,2 user reviews,1,1,2
989270,True,0,No user reviews,0,0,0
989280,True,0,No user reviews,0,0,0
989320,True,0,No user reviews,0,0,0
989340,True,0,6 user reviews,5,1,6
989350,True,0,No user reviews,0,0,0
989360,True,0,No user reviews,0,0,0
989370,True,0,2 user reviews,2,0,2
989390,True,0,No user reviews,0,0,0
989400,True,0,1 user reviews,1,0,1
989430,True,0,3 user reviews,3,0,3
989450,True,0,3 user reviews,2,1,3
989460,True,0,No user reviews,0,0,0
989480,True,0,No user reviews,0,0,0
989490,True,0,No user reviews,0,0,0
989500,True,0,No user reviews,0,0,0
989520,True,0,1 user reviews,0,1,1
989530,True,0,No user reviews,0,0,0
989550,True,6,Mostly Positive,63,16,79
989560,True,0,7 user reviews,5,2,7
989580,True,5,Mixed,11,9,20
989640,True,0,2 user reviews,2,0,2
989650,True,0,2 user reviews,0,2,2
989670,True,0,No user reviews,0,0,0
989680,True,0,1 user reviews,0,1,1
989690,True,6,Mostly Positive,327,133,460
989700,True,0,No user reviews,0,0,0
989710,True,0,2 user reviews,1,1,2
989720,True,0,No user reviews,0,0,0
989730,True,0,No user reviews,0,0,0
989740,True,0,No user reviews,0,0,0
989741,True,0,No user reviews,0,0,0
989750,True,0,1 user reviews,1,0,1
989770,True,6,Mostly Positive,82,28,110
989780,True,0,7 user reviews,0,7,7
989790,True,0,No user reviews,0,0,0
989810,True,0,2 user reviews,1,1,2
989860,True,0,No user reviews,0,0,0
989870,True,0,No user reviews,0,0,0
989900,True,0,No user reviews,0,0,0
989960,True,7,Positive,13,0,13
989970,True,0,1 user reviews,1,0,1
989980,True,0,No user reviews,0,0,0
990010,True,0,No user reviews,0,0,0
990020,True,0,1 user reviews,1,0,1
990030,True,7,Positive,20,5,25
990040,True,0,No user reviews,0,0,0
990050,True,8,Very Positive,221,55,276
990060,True,0,No user reviews,0,0,0
990070,True,0,No user reviews,0,0,0
990090,True,0,No user reviews,0,0,0
990100,True,0,No user reviews,0,0,0
990160,True,0,4 user reviews,1,3,4
990170,True,0,No user reviews,0,0,0
990180,True,7,Positive,16,0,16
990200,True,0,No user reviews,0,0,0
990201,True,0,No user reviews,0,0,0
990202,True,0,No user reviews,0,0,0
990230,True,0,5 user reviews,4,1,5
990240,True,0,3 user reviews,2,1,3
990250,True,0,No user reviews,0,0,0
990270,True,0,No user reviews,0,0,0
990280,True,0,6 user reviews,5,1,6
990310,True,0,No user reviews,0,0,0
990320,True,0,No user reviews,0,0,0
990330,True,0,No user reviews,0,0,0
990340,True,0,No user reviews,0,0,0
990360,True,6,Mostly Positive,26,8,34
990390,True,0,1 user reviews,1,0,1
990400,True,0,2 user reviews,2,0,2
990410,True,0,No user reviews,0,0,0
990430,True,7,Positive,18,0,18
990480,True,0,1 user reviews,0,1,1
990500,True,0,1 user reviews,1,0,1
990630,True,0,No user reviews,0,0,0
990640,True,7,Positive,28,7,35
990650,True,4,Mostly Negative,93,280,373
990720,True,0,No user reviews,0,0,0
990730,True,5,Mixed,7,5,12
990731,True,0,3 user reviews,3,0,3
990732,True,0,1 user reviews,1,0,1
990733,True,0,7 user reviews,7,0,7
990740,True,0,8 user reviews,4,4,8
990750,True,0,6 user reviews,5,1,6
990762,True,0,2 user reviews,2,0,2
990770,True,0,No user reviews,0,0,0
990830,True,0,No user reviews,0,0,0
990840,True,0,6 user reviews,3,3,6
990850,True,5,Mixed,6,8,14
990890,True,0,No user reviews,0,0,0
990900,True,7,Positive,11,0,11
990920,True,0,No user reviews,0,0,0
990930,True,5,Mixed,11,10,21
990931,True,0,5 user reviews,4,1,5
990932,True,5,Mixed,7,5,12
990940,True,0,2 user reviews,2,0,2
990950,True,0,1 user reviews,0,1,1
990960,True,0,2 user reviews,1,1,2
990970,True,0,No user reviews,0,0,0
991010,True,0,No user reviews,0,0,0
991011,True,0,No user reviews,0,0,0
991060,True,0,1 user reviews,1,0,1
991061,True,0,No user reviews,0,0,0
991063,True,0,No user reviews,0,0,0
991064,True,0,1 user reviews,1,0,1
991065,True,0,No user reviews,0,0,0
991066,True,0,1 user reviews,0,1,1
991067,True,0,No user reviews,0,0,0
991068,True,0,No user reviews,0,0,0
991069,True,0,2 user reviews,2,0,2
991070,True,6,Mostly Positive,19,7,26
991080,True,0,2 user reviews,2,0,2
991130,True,0,No user reviews,0,0,0
991170,True,8,Very Positive,457,86,543
991220,True,0,No user reviews,0,0,0
991230,True,0,6 user reviews,3,3,6
991240,True,0,7 user reviews,6,1,7
991260,True,5,Mixed,285,134,419
991270,True,9,Overwhelmingly Positive,770,27,797
991280,True,0,9 user reviews,5,4,9
991290,True,0,No user reviews,0,0,0
991430,True,7,Positive,11,0,11
991450,True,0,No user reviews,0,0,0
991480,True,0,9 user reviews,8,1,9
991490,True,0,1 user reviews,1,0,1
991500,True,0,5 user reviews,4,1,5
991510,True,0,6 user reviews,6,0,6
991520,True,0,2 user reviews,0,2,2
991530,True,0,No user reviews,0,0,0
991560,True,5,Mixed,77,56,133
991580,True,0,No user reviews,0,0,0
991600,True,8,Very Positive,100,12,112
991610,True,0,No user reviews,0,0,0
991620,True,0,3 user reviews,3,0,3
991630,True,0,No user reviews,0,0,0
991660,True,0,1 user reviews,0,1,1
991680,True,0,No user reviews,0,0,0
991690,True,0,No user reviews,0,0,0
991730,True,0,No user reviews,0,0,0
991740,True,0,No user reviews,0,0,0
991750,True,0,4 user reviews,4,0,4
991760,True,0,No user reviews,0,0,0
991770,True,0,2 user reviews,2,0,2
991771,True,0,1 user reviews,1,0,1
991772,True,0,No user reviews,0,0,0
991773,True,0,8 user reviews,2,6,8
991774,True,0,1 user reviews,1,0,1
991780,True,5,Mixed,16,12,28
991790,True,0,No user reviews,0,0,0
991800,True,0,No user reviews,0,0,0
991810,True,5,Mixed,95,41,136
991850,True,0,No user reviews,0,0,0
991860,True,0,4 user reviews,3,1,4
991870,True,7,Positive,13,0,13
991890,True,0,1 user reviews,1,0,1
991930,True,0,No user reviews,0,0,0
991960,True,7,Positive,10,1,11
992000,True,0,1 user reviews,0,1,1
992030,True,0,No user reviews,0,0,0
992040,True,0,6 user reviews,5,1,6
992050,True,6,Mostly Positive,13,4,17
992070,True,0,No user reviews,0,0,0
992080,True,0,No user reviews,0,0,0
992100,True,0,No user reviews,0,0,0
992120,True,7,Positive,22,0,22
992130,True,0,No user reviews,0,0,0
992140,True,0,No user reviews,0,0,0
992150,True,0,No user reviews,0,0,0
992160,True,0,1 user reviews,1,0,1
992170,True,7,Positive,39,4,43
992171,True,7,Positive,18,3,21
992172,True,7,Positive,40,4,44
992173,True,7,Positive,22,1,23
992174,True,8,Very Positive,54,2,56
992175,True,8,Very Positive,57,6,63
992176,True,7,Positive,40,7,47
992180,True,0,1 user reviews,1,0,1
992200,True,7,Positive,9,1,10
992210,True,7,Positive,9,1,10
992240,True,0,No user reviews,0,0,0
992250,True,0,No user reviews,0,0,0
992260,True,0,1 user reviews,1,0,1
992270,True,0,No user reviews,0,0,0
992300,True,8,Very Positive,554,100,654
992310,True,0,No user reviews,0,0,0
992330,True,7,Positive,18,4,22
992360,True,0,1 user reviews,0,1,1
992370,True,0,No user reviews,0,0,0
992420,True,0,1 user reviews,1,0,1
992440,True,0,No user reviews,0,0,0
992470,True,0,No user reviews,0,0,0
992480,True,0,1 user reviews,0,1,1
992490,True,0,2 user reviews,1,1,2
992520,True,0,No user reviews,0,0,0
992560,True,0,No user reviews,0,0,0
992600,True,0,No user reviews,0,0,0
992610,True,0,8 user reviews,8,0,8
992620,True,0,No user reviews,0,0,0
992640,True,5,Mixed,491,494,985
992680,True,0,No user reviews,0,0,0
992690,True,0,No user reviews,0,0,0
992700,True,0,No user reviews,0,0,0
992710,True,0,No user reviews,0,0,0
992720,True,0,No user reviews,0,0,0
992730,True,8,Very Positive,56,10,66
992740,True,0,2 user reviews,2,0,2
992750,True,0,No user reviews,0,0,0
992770,True,0,No user reviews,0,0,0
992780,True,0,No user reviews,0,0,0
992790,True,0,No user reviews,0,0,0
992820,True,0,No user reviews,0,0,0
992830,True,0,No user reviews,0,0,0
992840,True,0,No user reviews,0,0,0
992850,True,0,No user reviews,0,0,0
992860,True,0,No user reviews,0,0,0
992870,True,0,4 user reviews,3,1,4
992880,True,0,1 user reviews,1,0,1
992890,True,0,3 user reviews,2,1,3
992910,True,6,Mostly Positive,286,110,396
992920,True,0,No user reviews,0,0,0
992930,True,0,No user reviews,0,0,0
992950,True,0,5 user reviews,4,1,5
992960,True,0,6 user reviews,4,2,6
992970,True,0,1 user reviews,1,0,1
992990,True,7,Positive,10,0,10
993020,True,0,5 user reviews,5,0,5
993030,True,0,No user reviews,0,0,0
993090,True,8,Very Positive,81,4,85
993100,True,0,1 user reviews,0,1,1
993110,True,0,No user reviews,0,0,0
993160,True,0,No user reviews,0,0,0
993170,True,0,1 user reviews,1,0,1
993180,True,0,1 user reviews,1,0,1
993181,True,0,No user reviews,0,0,0
993200,True,0,No user reviews,0,0,0
993220,True,0,No user reviews,0,0,0
993240,True,0,No user reviews,0,0,0
993241,True,0,No user reviews,0,0,0
993250,True,0,4 user reviews,2,2,4
993260,True,0,No user reviews,0,0,0
993270,True,0,9 user reviews,9,0,9
993290,True,0,No user reviews,0,0,0
993300,True,0,No user reviews,0,0,0
993330,True,0,No user reviews,0,0,0
993340,True,5,Mixed,38,20,58
993370,True,0,No user reviews,0,0,0
993390,True,0,No user reviews,0,0,0
993400,True,0,4 user reviews,1,3,4
993410,True,0,1 user reviews,1,0,1
993420,True,0,No user reviews,0,0,0
993490,True,0,No user reviews,0,0,0
993500,True,0,5 user reviews,4,1,5
993520,True,0,4 user reviews,2,2,4
993530,True,0,No user reviews,0,0,0
993550,True,0,No user reviews,0,0,0
993580,True,0,4 user reviews,4,0,4
993590,True,0,No user reviews,0,0,0
993610,True,0,1 user reviews,1,0,1
993620,True,0,No user reviews,0,0,0
993630,True,0,1 user reviews,1,0,1
993640,True,5,Mixed,11,5,16
993650,True,0,No user reviews,0,0,0
993660,True,0,No user reviews,0,0,0
993670,True,0,No user reviews,0,0,0
993680,True,0,5 user reviews,2,3,5
993690,True,5,Mixed,25,18,43
993710,True,0,No user reviews,0,0,0
993740,True,8,Very Positive,46,6,52
993750,True,0,6 user reviews,2,4,6
993770,True,0,No user reviews,0,0,0
993780,True,7,Positive,23,1,24
993790,True,8,Very Positive,167,10,177
993810,True,0,2 user reviews,2,0,2
993840,True,0,6 user reviews,6,0,6
993850,True,0,2 user reviews,2,0,2
993860,True,0,No user reviews,0,0,0
993870,True,0,No user reviews,0,0,0
993880,True,0,No user reviews,0,0,0
993890,True,0,4 user reviews,4,0,4
993910,True,0,No user reviews,0,0,0
993911,True,0,No user reviews,0,0,0
993912,True,0,No user reviews,0,0,0
993920,True,0,No user reviews,0,0,0
993921,True,0,1 user reviews,1,0,1
993922,True,0,1 user reviews,1,0,1
993923,True,0,No user reviews,0,0,0
993924,True,0,1 user reviews,0,1,1
993925,True,0,No user reviews,0,0,0
993926,True,0,No user reviews,0,0,0
993927,True,0,No user reviews,0,0,0
993928,True,0,No user reviews,0,0,0
993929,True,0,No user reviews,0,0,0
993930,True,0,No user reviews,0,0,0
993931,True,0,No user reviews,0,0,0
993932,True,0,No user reviews,0,0,0
993933,True,0,No user reviews,0,0,0
993940,True,0,No user reviews,0,0,0
993950,True,0,No user reviews,0,0,0
993960,True,0,No user reviews,0,0,0
993980,True,0,2 user reviews,1,1,2
993990,True,0,3 user reviews,2,1,3
994000,True,0,No user reviews,0,0,0
994020,True,7,Positive,35,2,37
994030,True,0,No user reviews,0,0,0
994040,True,7,Positive,12,0,12
994060,True,0,No user reviews,0,0,0
994110,True,0,No user reviews,0,0,0
994120,True,0,No user reviews,0,0,0
994130,True,0,No user reviews,0,0,0
994140,True,8,Very Positive,77,4,81
994160,True,6,Mostly Positive,12,5,17
994170,True,0,No user reviews,0,0,0
994180,True,0,4 user reviews,3,1,4
994190,True,0,No user reviews,0,0,0
994200,True,7,Positive,9,2,11
994210,True,6,Mostly Positive,10,3,13
994220,True,8,Very Positive,379,41,420
994230,True,0,4 user reviews,2,2,4
994250,True,0,No user reviews,0,0,0
994260,True,0,No user reviews,0,0,0
994280,True,8,Very Positive,830,140,970
994290,True,0,No user reviews,0,0,0
994300,True,0,1 user reviews,1,0,1
994310,True,0,3 user reviews,0,3,3
994320,True,5,Mixed,19,19,38
994330,True,0,No user reviews,0,0,0
994340,True,7,Positive,20,0,20
994350,True,6,Mostly Positive,9,3,12
994360,True,0,3 user reviews,3,0,3
994420,True,0,No user reviews,0,0,0
994430,True,0,No user reviews,0,0,0
994450,True,0,No user reviews,0,0,0
994460,True,0,No user reviews,0,0,0
994480,True,0,No user reviews,0,0,0
994490,True,0,No user reviews,0,0,0
994500,True,7,Positive,26,2,28
994510,True,0,No user reviews,0,0,0
994520,True,0,No user reviews,0,0,0
994530,True,0,No user reviews,0,0,0
994560,True,0,No user reviews,0,0,0
994580,True,0,No user reviews,0,0,0
994590,True,0,No user reviews,0,0,0
994610,True,0,No user reviews,0,0,0
994650,True,0,1 user reviews,1,0,1
994660,True,0,No user reviews,0,0,0
994670,True,7,Positive,12,1,13
994680,True,0,No user reviews,0,0,0
994710,True,0,No user reviews,0,0,0
994730,True,8,Very Positive,173,17,190
994740,True,0,No user reviews,0,0,0
994750,True,0,No user reviews,0,0,0
994760,True,0,No user reviews,0,0,0
994790,True,0,2 user reviews,2,0,2
994800,True,0,No user reviews,0,0,0
994840,True,0,No user reviews,0,0,0
994860,True,0,4 user reviews,4,0,4
994870,True,0,9 user reviews,6,3,9
994880,True,0,1 user reviews,1,0,1
994890,True,5,Mixed,24,12,36
994900,True,0,3 user reviews,3,0,3
994910,True,0,No user reviews,0,0,0
994930,True,0,No user reviews,0,0,0
994950,True,0,No user reviews,0,0,0
994970,True,0,No user reviews,0,0,0
994980,True,0,No user reviews,0,0,0
995000,True,0,8 user reviews,5,3,8
995020,True,0,No user reviews,0,0,0
995021,True,0,No user reviews,0,0,0
995030,True,0,No user reviews,0,0,0
995040,True,0,1 user reviews,1,0,1
995050,True,8,Very Positive,124,22,146
995060,True,0,No user reviews,0,0,0
995070,True,0,No user reviews,0,0,0
995140,True,5,Mixed,6,7,13
995160,True,0,6 user reviews,6,0,6
995170,True,0,1 user reviews,1,0,1
995190,True,0,No user reviews,0,0,0
995210,True,4,Mostly Negative,5,9,14
995230,True,8,Very Positive,127,22,149
995240,True,7,Positive,9,2,11
995270,True,0,No user reviews,0,0,0
995280,True,0,6 user reviews,3,3,6
995290,True,0,No user reviews,0,0,0
995300,True,0,4 user reviews,3,1,4
995310,True,0,No user reviews,0,0,0
995330,True,0,No user reviews,0,0,0
995340,True,0,No user reviews,0,0,0
995380,True,7,Positive,27,3,30
995430,True,0,8 user reviews,3,5,8
995450,True,5,Mixed,10,5,15
995460,True,8,Very Positive,61,1,62
995470,True,0,7 user reviews,6,1,7
995480,True,0,1 user reviews,0,1,1
995490,True,0,5 user reviews,5,0,5
995560,True,0,No user reviews,0,0,0
995580,True,0,No user reviews,0,0,0
995590,True,0,1 user reviews,0,1,1
995610,True,7,Positive,12,0,12
995640,True,0,2 user reviews,1,1,2
995650,True,0,5 user reviews,4,1,5
995651,True,0,4 user reviews,3,1,4
995652,True,0,5 user reviews,3,2,5
995653,True,0,5 user reviews,3,2,5
995654,True,0,7 user reviews,5,2,7
995660,True,5,Mixed,6,8,14
995670,True,5,Mixed,9,4,13
995680,True,0,No user reviews,0,0,0
995700,True,0,1 user reviews,0,1,1
995710,True,0,No user reviews,0,0,0
995720,True,0,No user reviews,0,0,0
995770,True,7,Positive,25,1,26
995780,True,6,Mostly Positive,32,10,42
995790,True,0,6 user reviews,4,2,6
995800,True,0,No user reviews,0,0,0
995810,True,0,No user reviews,0,0,0
995850,True,0,No user reviews,0,0,0
995860,True,7,Positive,33,5,38
995870,True,7,Positive,9,1,10
995890,True,0,1 user reviews,1,0,1
995900,True,0,2 user reviews,2,0,2
995910,True,0,3 user reviews,1,2,3
995920,True,0,2 user reviews,2,0,2
995930,True,0,No user reviews,0,0,0
995940,True,0,No user reviews,0,0,0
995950,True,0,2 user reviews,2,0,2
995960,True,5,Mixed,21,24,45
995970,True,5,Mixed,9,8,17
995980,True,8,Very Positive,172,28,200
996000,True,7,Positive,10,0,10
996010,True,0,No user reviews,0,0,0
996050,True,5,Mixed,9,4,13
996060,True,7,Positive,12,0,12
996080,True,7,Positive,27,3,30
996090,True,0,No user reviews,0,0,0
996140,True,0,No user reviews,0,0,0
996150,True,0,1 user reviews,1,0,1
996160,True,0,5 user reviews,3,2,5
996170,True,0,No user reviews,0,0,0
996180,True,0,4 user reviews,4,0,4
996210,True,0,No user reviews,0,0,0
996220,True,0,No user reviews,0,0,0
996230,True,0,No user reviews,0,0,0
996240,True,0,No user reviews,0,0,0
996250,True,0,No user reviews,0,0,0
996260,True,0,No user reviews,0,0,0
996280,True,0,1 user reviews,1,0,1
996300,True,0,1 user reviews,0,1,1
996310,True,0,No user reviews,0,0,0
996311,True,0,No user reviews,0,0,0
996312,True,0,No user reviews,0,0,0
996313,True,0,No user reviews,0,0,0
996314,True,0,No user reviews,0,0,0
996330,True,0,No user reviews,0,0,0
996340,True,0,No user reviews,0,0,0
996350,True,0,No user reviews,0,0,0
996360,True,0,No user reviews,0,0,0
996370,True,0,No user reviews,0,0,0
996380,True,5,Mixed,182,207,389
996410,True,0,No user reviews,0,0,0
996430,True,0,1 user reviews,0,1,1
996450,True,7,Positive,14,3,17
996470,True,5,Mixed,1224,540,1764
996480,True,0,No user reviews,0,0,0
996520,True,0,No user reviews,0,0,0
996530,True,0,No user reviews,0,0,0
996540,True,0,No user reviews,0,0,0
996541,True,0,No user reviews,0,0,0
996550,True,0,9 user reviews,9,0,9
996560,True,0,No user reviews,0,0,0
996570,True,0,No user reviews,0,0,0
996580,True,8,Very Positive,3124,190,3314
996590,True,0,No user reviews,0,0,0
996600,True,0,No user reviews,0,0,0
996620,True,0,2 user reviews,2,0,2
996630,True,0,1 user reviews,1,0,1
996640,True,0,No user reviews,0,0,0
996650,True,0,2 user reviews,2,0,2
996670,True,0,No user reviews,0,0,0
996680,True,0,No user reviews,0,0,0
996710,True,0,No user reviews,0,0,0
996720,True,7,Positive,12,0,12
996721,True,0,2 user reviews,2,0,2
996730,True,0,1 user reviews,0,1,1
996740,True,0,No user reviews,0,0,0
996741,True,0,5 user reviews,5,0,5
996742,True,0,3 user reviews,3,0,3
996760,True,0,No user reviews,0,0,0
996770,True,8,Very Positive,152,32,184
996820,True,0,No user reviews,0,0,0
996830,True,3,Negative,0,24,24
996850,True,0,No user reviews,0,0,0
996860,True,0,6 user reviews,5,1,6
996890,True,0,No user reviews,0,0,0
996900,True,0,No user reviews,0,0,0
996910,True,0,4 user reviews,3,1,4
996920,True,0,6 user reviews,6,0,6
996970,True,0,No user reviews,0,0,0
996980,True,7,Positive,11,1,12
996990,True,0,7 user reviews,4,3,7
997000,True,0,3 user reviews,1,2,3
997020,True,0,1 user reviews,0,1,1
997030,True,0,5 user reviews,5,0,5
997040,True,0,No user reviews,0,0,0
997041,True,0,2 user reviews,2,0,2
997042,True,0,No user reviews,0,0,0
997050,True,5,Mixed,5,5,10
997060,True,0,1 user reviews,1,0,1
997070,True,5,Mixed,3974,1945,5919
997100,True,0,No user reviews,0,0,0
997120,True,6,Mostly Positive,8,3,11
997150,True,0,No user reviews,0,0,0
997160,True,0,No user reviews,0,0,0
997163,True,0,No user reviews,0,0,0
997170,True,0,5 user reviews,5,0,5
997180,True,0,No user reviews,0,0,0
997210,True,0,No user reviews,0,0,0
997240,True,0,5 user reviews,3,2,5
997250,True,0,No user reviews,0,0,0
997251,True,0,No user reviews,0,0,0
997252,True,0,No user reviews,0,0,0
997253,True,0,No user reviews,0,0,0
997254,True,0,No user reviews,0,0,0
997260,True,0,8 user reviews,8,0,8
997270,True,0,No user reviews,0,0,0
997280,True,0,3 user reviews,3,0,3
997290,True,0,No user reviews,0,0,0
997310,True,0,1 user reviews,1,0,1
997330,True,7,Positive,26,0,26
997340,True,0,1 user reviews,0,1,1
997360,True,0,6 user reviews,6,0,6
997370,True,0,7 user reviews,6,1,7
997380,True,7,Positive,16,2,18
997390,True,0,No user reviews,0,0,0
997430,True,0,4 user reviews,4,0,4
997460,True,0,No user reviews,0,0,0
997470,True,0,1 user reviews,1,0,1
997480,True,0,4 user reviews,4,0,4
997500,True,0,No user reviews,0,0,0
997520,True,0,No user reviews,0,0,0
997530,True,0,No user reviews,0,0,0
997540,True,0,No user reviews,0,0,0
997560,True,0,2 user reviews,2,0,2
997620,True,0,No user reviews,0,0,0
997640,True,0,No user reviews,0,0,0
997650,True,0,No user reviews,0,0,0
997670,True,0,1 user reviews,1,0,1
997700,True,7,Positive,8,2,10
997710,True,5,Mixed,6,5,11
997720,True,7,Positive,9,1,10
997730,True,0,2 user reviews,2,0,2
997740,True,0,No user reviews,0,0,0
997750,True,0,1 user reviews,1,0,1
997760,True,0,No user reviews,0,0,0
997770,True,0,No user reviews,0,0,0
997820,True,0,No user reviews,0,0,0
997830,True,0,No user reviews,0,0,0
997840,True,0,No user reviews,0,0,0
997870,True,0,3 user reviews,0,3,3
997900,True,0,No user reviews,0,0,0
997910,True,0,No user reviews,0,0,0
997920,True,0,No user reviews,0,0,0
997950,True,0,6 user reviews,4,2,6
998000,True,0,No user reviews,0,0,0
998010,True,0,9 user reviews,2,7,9
998020,True,0,9 user reviews,4,5,9
998030,True,0,No user reviews,0,0,0
998040,True,0,No user reviews,0,0,0
998041,True,0,No user reviews,0,0,0
998050,True,0,No user reviews,0,0,0
998051,True,0,No user reviews,0,0,0
998060,True,0,No user reviews,0,0,0
998061,True,0,No user reviews,0,0,0
998062,True,0,No user reviews,0,0,0
998063,True,0,No user reviews,0,0,0
998064,True,0,No user reviews,0,0,0
998065,True,0,No user reviews,0,0,0
998066,True,0,No user reviews,0,0,0
998067,True,0,No user reviews,0,0,0
998068,True,0,No user reviews,0,0,0
998069,True,0,No user reviews,0,0,0
998070,True,0,No user reviews,0,0,0
998071,True,0,No user reviews,0,0,0
998072,True,0,No user reviews,0,0,0
998073,True,0,No user reviews,0,0,0
998080,True,0,No user reviews,0,0,0
998081,True,0,No user reviews,0,0,0
998090,True,0,No user reviews,0,0,0
998091,True,0,No user reviews,0,0,0
998100,True,0,No user reviews,0,0,0
998101,True,0,No user reviews,0,0,0
998110,True,0,No user reviews,0,0,0
998111,True,0,No user reviews,0,0,0
998120,True,0,No user reviews,0,0,0
998121,True,0,No user reviews,0,0,0
998130,True,0,No user reviews,0,0,0
998140,True,0,No user reviews,0,0,0
998141,True,0,No user reviews,0,0,0
998142,True,0,No user reviews,0,0,0
998150,True,0,No user reviews,0,0,0
998160,True,0,No user reviews,0,0,0
998170,True,0,No user reviews,0,0,0
998180,True,0,No user reviews,0,0,0
998181,True,0,No user reviews,0,0,0
998190,True,0,No user reviews,0,0,0
998191,True,0,No user reviews,0,0,0
998200,True,0,No user reviews,0,0,0
998201,True,0,No user reviews,0,0,0
998202,True,0,No user reviews,0,0,0
998210,True,0,No user reviews,0,0,0
998211,True,0,No user reviews,0,0,0
998212,True,0,No user reviews,0,0,0
998213,True,0,No user reviews,0,0,0
998214,True,0,No user reviews,0,0,0
998220,True,7,Positive,12,1,13
998230,True,0,No user reviews,0,0,0
998231,True,0,No user reviews,0,0,0
998232,True,0,No user reviews,0,0,0
998233,True,0,No user reviews,0,0,0
998234,True,0,No user reviews,0,0,0
998240,True,0,No user reviews,0,0,0
998241,True,0,No user reviews,0,0,0
998242,True,0,No user reviews,0,0,0
998243,True,0,No user reviews,0,0,0
998244,True,0,No user reviews,0,0,0
998245,True,0,No user reviews,0,0,0
998246,True,0,No user reviews,0,0,0
998247,True,0,No user reviews,0,0,0
998248,True,0,No user reviews,0,0,0
998249,True,0,No user reviews,0,0,0
998250,True,0,No user reviews,0,0,0
998251,True,0,No user reviews,0,0,0
998252,True,0,No user reviews,0,0,0
998253,True,0,No user reviews,0,0,0
998254,True,0,No user reviews,0,0,0
998255,True,0,No user reviews,0,0,0
998256,True,0,No user reviews,0,0,0
998257,True,0,No user reviews,0,0,0
998258,True,0,No user reviews,0,0,0
998259,True,0,No user reviews,0,0,0
998260,True,0,No user reviews,0,0,0
998261,True,0,No user reviews,0,0,0
998270,True,0,1 user reviews,1,0,1
998280,True,0,No user reviews,0,0,0
998281,True,0,No user reviews,0,0,0
998282,True,0,No user reviews,0,0,0
998283,True,0,No user reviews,0,0,0
998284,True,0,No user reviews,0,0,0
998285,True,0,No user reviews,0,0,0
998286,True,0,No user reviews,0,0,0
998287,True,0,No user reviews,0,0,0
998288,True,0,No user reviews,0,0,0
998289,True,0,No user reviews,0,0,0
998290,True,0,No user reviews,0,0,0
998291,True,0,No user reviews,0,0,0
998292,True,0,No user reviews,0,0,0
998293,True,0,No user reviews,0,0,0
998294,True,0,No user reviews,0,0,0
998295,True,0,No user reviews,0,0,0
998296,True,0,No user reviews,0,0,0
998297,True,0,No user reviews,0,0,0
998298,True,0,No user reviews,0,0,0
998299,True,0,No user reviews,0,0,0
998300,True,0,No user reviews,0,0,0
998310,True,0,No user reviews,0,0,0
998311,True,0,No user reviews,0,0,0
998312,True,0,No user reviews,0,0,0
998320,True,0,No user reviews,0,0,0
998321,True,0,No user reviews,0,0,0
998330,True,5,Mixed,9,5,14
998340,True,0,No user reviews,0,0,0
998380,True,0,No user reviews,0,0,0
998390,True,0,No user reviews,0,0,0
998400,True,0,No user reviews,0,0,0
998470,True,5,Mixed,6,4,10
998480,True,0,2 user reviews,1,1,2
998490,True,7,Positive,21,0,21
998500,True,0,No user reviews,0,0,0
998530,True,0,1 user reviews,0,1,1
998540,True,0,No user reviews,0,0,0
998550,True,0,6 user reviews,5,1,6
998560,True,0,No user reviews,0,0,0
998570,True,6,Mostly Positive,13,5,18
998580,True,0,1 user reviews,1,0,1
998590,True,0,1 user reviews,1,0,1
998600,True,0,No user reviews,0,0,0
998620,True,0,No user reviews,0,0,0
998630,True,0,5 user reviews,5,0,5
998660,True,0,No user reviews,0,0,0
998680,True,0,1 user reviews,1,0,1
998690,True,0,No user reviews,0,0,0
998730,True,0,2 user reviews,2,0,2
998740,True,8,Very Positive,212,28,240
998760,True,0,No user reviews,0,0,0
998780,True,0,No user reviews,0,0,0
998790,True,0,6 user reviews,3,3,6
998800,True,0,No user reviews,0,0,0
998801,True,0,No user reviews,0,0,0
998802,True,0,No user reviews,0,0,0
998803,True,0,No user reviews,0,0,0
998804,True,0,No user reviews,0,0,0
998805,True,0,No user reviews,0,0,0
998806,True,0,No user reviews,0,0,0
998810,True,7,Positive,27,1,28
998820,True,0,No user reviews,0,0,0
998830,True,0,4 user reviews,3,1,4
998850,True,5,Mixed,11,5,16
998870,True,0,No user reviews,0,0,0
998890,True,0,1 user reviews,0,1,1
998900,True,0,No user reviews,0,0,0
998930,True,6,Mostly Positive,200,53,253
998940,True,8,Very Positive,182,22,204
998950,True,0,No user reviews,0,0,0
998960,True,0,4 user reviews,4,0,4
998961,True,0,1 user reviews,1,0,1
998970,True,0,5 user reviews,2,3,5
998990,True,6,Mostly Positive,8,3,11
999020,True,8,Very Positive,300,50,350
999030,True,0,1 user reviews,1,0,1
999040,True,0,2 user reviews,1,1,2
999050,True,0,2 user reviews,1,1,2
999070,True,0,No user reviews,0,0,0
999150,True,0,3 user reviews,1,2,3
999180,True,0,No user reviews,0,0,0
999190,True,0,3 user reviews,0,3,3
999200,True,0,No user reviews,0,0,0
999220,True,6,Mostly Positive,1159,406,1565
999250,True,0,2 user reviews,2,0,2
999260,True,6,Mostly Positive,34,12,46
999270,True,0,No user reviews,0,0,0
999280,True,0,No user reviews,0,0,0
999290,True,0,4 user reviews,3,1,4
999300,True,0,2 user reviews,1,1,2
999301,True,0,No user reviews,0,0,0
999302,True,0,2 user reviews,1,1,2
999310,True,0,2 user reviews,2,0,2
999330,True,0,No user reviews,0,0,0
999340,True,0,No user reviews,0,0,0
999350,True,0,6 user reviews,6,0,6
999360,True,0,No user reviews,0,0,0
999370,True,0,No user reviews,0,0,0
999380,True,0,No user reviews,0,0,0
999410,True,7,Positive,31,1,32
999420,True,0,No user reviews,0,0,0
999421,True,0,No user reviews,0,0,0
999430,True,0,2 user reviews,2,0,2
999440,True,0,No user reviews,0,0,0
999450,True,0,No user reviews,0,0,0
999470,True,0,No user reviews,0,0,0
999480,True,0,3 user reviews,0,3,3
999490,True,0,3 user reviews,3,0,3
999520,True,0,No user reviews,0,0,0
999530,True,0,No user reviews,0,0,0
999550,True,7,Positive,10,1,11
999560,True,0,No user reviews,0,0,0
999570,True,0,No user reviews,0,0,0
999580,True,0,No user reviews,0,0,0
999640,True,5,Mixed,17,13,30
999660,True,5,Mixed,6,4,10
999670,True,0,No user reviews,0,0,0
999680,True,0,No user reviews,0,0,0
999700,True,0,No user reviews,0,0,0
999720,True,0,2 user reviews,2,0,2
999730,True,0,No user reviews,0,0,0
999750,True,0,No user reviews,0,0,0
999760,True,0,No user reviews,0,0,0
999780,True,0,No user reviews,0,0,0
999790,True,0,No user reviews,0,0,0
999820,True,0,No user reviews,0,0,0
999830,True,0,No user reviews,0,0,0
999840,True,0,4 user reviews,4,0,4
999860,True,6,Mostly Positive,46,12,58
999870,True,0,No user reviews,0,0,0
999880,True,0,No user reviews,0,0,0
999890,True,0,No user reviews,0,0,0
999900,True,0,No user reviews,0,0,0
999910,True,0,No user reviews,0,0,0
999930,True,0,No user reviews,0,0,0
999940,True,0,No user reviews,0,0,0
999950,True,0,No user reviews,0,0,0
999960,True,0,No user reviews,0,0,0
999970,True,0,No user reviews,0,0,0
999980,True,0,No user reviews,0,0,0
999990,True,0,1 user reviews,1,0,1
1000000,True,0,No user reviews,0,0,0
1000010,True,8,Very Positive,159,22,181
1000030,True,9,Overwhelmingly Positive,616,16,632
1000040,True,0,No user reviews,0,0,0
1000060,True,0,No user reviews,0,0,0
1000080,True,8,Very Positive,79,18,97
1000100,True,0,No user reviews,0,0,0
1000110,True,0,No user reviews,0,0,0
1000120,True,0,1 user reviews,0,1,1
1000130,True,0,5 user reviews,5,0,5
1000140,True,0,3 user reviews,1,2,3
1000150,True,0,1 user reviews,0,1,1
1000160,True,0,1 user reviews,1,0,1
1000170,True,0,1 user reviews,0,1,1
1000180,True,0,1 user reviews,0,1,1
1000190,True,0,No user reviews,0,0,0
1000200,True,0,2 user reviews,2,0,2
1000210,True,0,1 user reviews,1,0,1
1000220,True,0,No user reviews,0,0,0
1000230,True,0,No user reviews,0,0,0
1000240,True,0,No user reviews,0,0,0
1000250,True,0,No user reviews,0,0,0
1000290,True,0,No user reviews,0,0,0
1000310,True,0,2 user reviews,0,2,2
1000360,True,0,No user reviews,0,0,0
1000370,True,0,1 user reviews,0,1,1
1000380,True,0,No user reviews,0,0,0
1000400,True,0,9 user reviews,9,0,9
1000410,True,8,Very Positive,534,54,588
1000420,True,0,No user reviews,0,0,0
1000460,True,0,No user reviews,0,0,0
1000470,True,6,Mostly Positive,23,7,30
1000480,True,5,Mixed,7,4,11
1000490,True,0,No user reviews,0,0,0
1000510,True,5,Mixed,12,7,19
1000540,True,0,No user reviews,0,0,0
1000550,True,0,6 user reviews,4,2,6
1000560,True,0,No user reviews,0,0,0
1000570,True,0,No user reviews,0,0,0
1000600,True,0,No user reviews,0,0,0
1000620,True,0,No user reviews,0,0,0
1000621,True,0,No user reviews,0,0,0
1000630,True,0,No user reviews,0,0,0
1000640,True,7,Positive,47,2,49
1000650,True,0,No user reviews,0,0,0
1000680,True,0,No user reviews,0,0,0
1000690,True,0,No user reviews,0,0,0
1000700,True,0,No user reviews,0,0,0
1000710,True,0,2 user reviews,2,0,2
1000711,True,0,3 user reviews,3,0,3
1000712,True,0,1 user reviews,1,0,1
1000713,True,0,2 user reviews,2,0,2
1000714,True,0,1 user reviews,0,1,1
1000715,True,0,1 user reviews,1,0,1
1000716,True,0,No user reviews,0,0,0
1000717,True,0,3 user reviews,3,0,3
1000718,True,0,3 user reviews,3,0,3
1000719,True,0,No user reviews,0,0,0
1000730,True,0,No user reviews,0,0,0
1000750,True,0,No user reviews,0,0,0
1000760,True,0,No user reviews,0,0,0
1000770,True,0,9 user reviews,8,1,9
1000780,True,0,1 user reviews,1,0,1
1000781,True,0,1 user reviews,1,0,1
1000782,True,0,5 user reviews,5,0,5
1000783,True,0,1 user reviews,1,0,1
1000790,True,0,1 user reviews,0,1,1
1000800,True,0,No user reviews,0,0,0
1000810,True,0,No user reviews,0,0,0
1000830,True,8,Very Positive,55,2,57
1000840,True,0,No user reviews,0,0,0
1000860,True,0,4 user reviews,3,1,4
1000870,True,0,1 user reviews,0,1,1
1000880,True,0,No user reviews,0,0,0
1000890,True,0,No user reviews,0,0,0
1000900,True,0,No user reviews,0,0,0
1000910,True,0,No user reviews,0,0,0
1000920,True,0,No user reviews,0,0,0
1000940,True,0,No user reviews,0,0,0
1000970,True,0,No user reviews,0,0,0
1000980,True,0,No user reviews,0,0,0
1000990,True,0,9 user reviews,7,2,9
1001010,True,0,1 user reviews,1,0,1
1001040,True,5,Mixed,36,20,56
1001050,True,0,1 user reviews,0,1,1
1001060,True,5,Mixed,21,18,39
1001070,True,7,Positive,25,4,29
1001090,True,0,No user reviews,0,0,0
1001100,True,0,1 user reviews,1,0,1
1001110,True,0,1 user reviews,1,0,1
1001120,True,0,No user reviews,0,0,0
1001140,True,8,Very Positive,93,15,108
1001150,True,7,Positive,15,3,18
1001160,True,0,No user reviews,0,0,0
1001170,True,0,5 user reviews,0,5,5
1001180,True,0,No user reviews,0,0,0
1001200,True,0,8 user reviews,7,1,8
1001210,True,0,No user reviews,0,0,0
1001220,True,8,Very Positive,84,21,105
1001230,True,0,5 user reviews,5,0,5
1001240,True,5,Mixed,7,10,17
1001260,True,0,No user reviews,0,0,0
1001270,True,0,No user reviews,0,0,0
1001280,True,0,2 user reviews,2,0,2
1001290,True,0,No user reviews,0,0,0
1001291,True,0,1 user reviews,0,1,1
1001320,True,0,No user reviews,0,0,0
1001321,True,0,1 user reviews,1,0,1
1001370,True,0,4 user reviews,4,0,4
1001371,True,0,7 user reviews,7,0,7
1001380,True,0,5 user reviews,3,2,5
1001390,True,0,3 user reviews,0,3,3
1001410,True,0,No user reviews,0,0,0
1001420,True,0,No user reviews,0,0,0
1001430,True,0,5 user reviews,5,0,5
1001440,True,0,No user reviews,0,0,0
1001450,True,0,No user reviews,0,0,0
1001470,True,0,No user reviews,0,0,0
1001490,True,5,Mixed,7,5,12
1001500,True,0,7 user reviews,5,2,7
1001510,True,0,No user reviews,0,0,0
1001520,True,0,No user reviews,0,0,0
1001530,True,0,No user reviews,0,0,0
1001550,True,0,No user reviews,0,0,0
1001570,True,0,2 user reviews,2,0,2
1001580,True,0,No user reviews,0,0,0
1001590,True,0,2 user reviews,2,0,2
1001600,True,0,6 user reviews,5,1,6
1001610,True,0,No user reviews,0,0,0
1001620,True,0,3 user reviews,3,0,3
1001630,True,0,No user reviews,0,0,0
1001640,True,4,Mostly Negative,3,9,12
1001660,True,0,2 user reviews,2,0,2
1001690,True,0,3 user reviews,1,2,3
1001720,True,0,No user reviews,0,0,0
1001730,True,0,No user reviews,0,0,0
1001740,True,0,4 user reviews,4,0,4
1001760,True,0,1 user reviews,0,1,1
1001780,True,0,No user reviews,0,0,0
1001783,True,0,No user reviews,0,0,0
1001784,True,0,No user reviews,0,0,0
1001800,True,8,Very Positive,58,13,71
1001810,True,0,1 user reviews,0,1,1
1001850,True,0,No user reviews,0,0,0
1001860,True,0,No user reviews,0,0,0
1001870,True,0,No user reviews,0,0,0
1001880,True,0,8 user reviews,7,1,8
1001910,True,0,6 user reviews,5,1,6
1001920,True,0,No user reviews,0,0,0
1001930,True,0,No user reviews,0,0,0
1001950,True,0,4 user reviews,3,1,4
1001960,True,0,1 user reviews,0,1,1
1001970,True,0,1 user reviews,0,1,1
1001980,True,5,Mixed,25,11,36
1001990,True,0,3 user reviews,1,2,3
1002000,True,0,3 user reviews,3,0,3
1002010,True,0,No user reviews,0,0,0
1002020,True,5,Mixed,7,5,12
1002030,True,6,Mostly Positive,15,6,21
1002040,True,0,No user reviews,0,0,0
1002060,True,0,2 user reviews,2,0,2
1002090,True,0,No user reviews,0,0,0
1002100,True,0,3 user reviews,3,0,3
1002130,True,7,Positive,12,3,15
1002150,True,0,No user reviews,0,0,0
1002170,True,0,No user reviews,0,0,0
1002180,True,0,3 user reviews,1,2,3
1002200,True,0,2 user reviews,2,0,2
1002210,True,0,1 user reviews,1,0,1
1002230,True,0,2 user reviews,1,1,2
1002250,True,0,No user reviews,0,0,0
1002270,True,7,Positive,12,2,14
1002280,True,0,4 user reviews,2,2,4
1002290,True,0,No user reviews,0,0,0
1002300,True,8,Very Positive,143,17,160
1002310,True,0,1 user reviews,1,0,1
1002360,True,0,No user reviews,0,0,0
1002400,True,0,No user reviews,0,0,0
1002410,True,0,4 user reviews,3,1,4
1002420,True,0,3 user reviews,2,1,3
1002430,True,8,Very Positive,102,6,108
1002440,True,0,4 user reviews,2,2,4
1002450,True,0,No user reviews,0,0,0
1002480,True,0,No user reviews,0,0,0
1002490,True,5,Mixed,4,6,10
1002500,True,0,1 user reviews,1,0,1
1002510,True,7,Positive,12,0,12
1002520,True,0,4 user reviews,4,0,4
1002540,True,0,7 user reviews,4,3,7
1002560,True,8,Very Positive,94,3,97
1002570,True,0,No user reviews,0,0,0
1002571,True,0,No user reviews,0,0,0
1002580,True,0,1 user reviews,1,0,1
1002600,True,0,No user reviews,0,0,0
1002610,True,6,Mostly Positive,14,4,18
1002620,True,0,2 user reviews,2,0,2
1002630,True,7,Positive,8,2,10
1002650,True,0,3 user reviews,1,2,3
1002670,True,0,4 user reviews,3,1,4
1002690,True,0,No user reviews,0,0,0
1002710,True,0,No user reviews,0,0,0
1002740,True,0,No user reviews,0,0,0
1002750,True,0,3 user reviews,0,3,3
1002760,True,0,No user reviews,0,0,0
1002790,True,0,No user reviews,0,0,0
1002800,True,0,3 user reviews,2,1,3
1002810,True,0,1 user reviews,1,0,1
1002820,True,0,No user reviews,0,0,0
1002830,True,5,Mixed,8,4,12
1002850,True,0,No user reviews,0,0,0
1002860,True,0,No user reviews,0,0,0
1002870,True,0,No user reviews,0,0,0
1002871,True,0,No user reviews,0,0,0
1002872,True,0,No user reviews,0,0,0
1002873,True,0,No user reviews,0,0,0
1002890,True,0,No user reviews,0,0,0
1002900,True,0,No user reviews,0,0,0
1002910,True,0,2 user reviews,2,0,2
1002920,True,0,No user reviews,0,0,0
1002930,True,0,No user reviews,0,0,0
1002940,True,0,1 user reviews,1,0,1
1002950,True,0,No user reviews,0,0,0
1002960,True,6,Mostly Positive,13,4,17
1002970,True,7,Positive,13,2,15
1002980,True,0,No user reviews,0,0,0
1003000,True,0,2 user reviews,1,1,2
1003010,True,0,No user reviews,0,0,0
1003020,True,7,Positive,17,1,18
1003030,True,0,No user reviews,0,0,0
1003070,True,0,7 user reviews,5,2,7
1003090,True,8,Very Positive,105,14,119
1003110,True,0,No user reviews,0,0,0
1003120,True,0,No user reviews,0,0,0
1003150,True,0,1 user reviews,0,1,1
1003160,True,0,No user reviews,0,0,0
1003170,True,0,1 user reviews,0,1,1
1003190,True,0,3 user reviews,3,0,3
1003200,True,0,6 user reviews,4,2,6
1003220,True,0,No user reviews,0,0,0
1003230,True,0,2 user reviews,2,0,2
1003250,True,0,No user reviews,0,0,0
1003260,True,0,No user reviews,0,0,0
1003280,True,0,No user reviews,0,0,0
1003310,True,5,Mixed,16,7,23
1003320,True,7,Positive,15,2,17
1003360,True,6,Mostly Positive,72,21,93
1003370,True,0,8 user reviews,7,1,8
1003390,True,0,No user reviews,0,0,0
1003400,True,0,2 user reviews,2,0,2
1003410,True,0,No user reviews,0,0,0
1003430,True,0,No user reviews,0,0,0
1003450,True,0,3 user reviews,2,1,3
1003460,True,0,No user reviews,0,0,0
1003480,True,6,Mostly Positive,11,4,15
1003490,True,7,Positive,17,2,19
1003500,True,0,No user reviews,0,0,0
1003520,True,8,Very Positive,805,119,924
1003530,True,0,No user reviews,0,0,0
1003540,True,0,No user reviews,0,0,0
1003550,True,0,No user reviews,0,0,0
1003560,True,0,8 user reviews,7,1,8
1003570,True,0,2 user reviews,2,0,2
1003600,True,7,Positive,12,1,13
1003650,True,0,1 user reviews,0,1,1
1003670,True,0,3 user reviews,1,2,3
1003680,True,0,No user reviews,0,0,0
1003681,True,0,No user reviews,0,0,0
1003682,True,0,No user reviews,0,0,0
1003690,True,0,1 user reviews,1,0,1
1003700,True,0,No user reviews,0,0,0
1003720,True,0,No user reviews,0,0,0
1003730,True,7,Positive,30,1,31
1003740,True,0,No user reviews,0,0,0
1003750,True,0,2 user reviews,2,0,2
1003760,True,0,1 user reviews,1,0,1
1003780,True,0,7 user reviews,7,0,7
1003790,True,0,No user reviews,0,0,0
1003800,True,7,Positive,10,2,12
1003830,True,0,1 user reviews,0,1,1
1003840,True,0,No user reviews,0,0,0
1003850,True,0,1 user reviews,1,0,1
1003860,True,7,Positive,10,0,10
1003870,True,0,No user reviews,0,0,0
1003880,True,6,Mostly Positive,7,3,10
1003890,True,8,Very Positive,427,93,520
1003900,True,0,No user reviews,0,0,0
1003920,True,0,No user reviews,0,0,0
1003930,True,0,No user reviews,0,0,0
1003940,True,0,No user reviews,0,0,0
1003950,True,0,No user reviews,0,0,0
1003960,True,0,No user reviews,0,0,0
1003980,True,0,No user reviews,0,0,0
1003990,True,0,No user reviews,0,0,0
1004000,True,5,Mixed,9,8,17
1004030,True,0,4 user reviews,3,1,4
1004040,True,0,4 user reviews,3,1,4
1004050,True,0,4 user reviews,0,4,4
1004060,True,0,No user reviews,0,0,0
1004090,True,0,No user reviews,0,0,0
1004100,True,0,2 user reviews,1,1,2
1004120,True,0,No user reviews,0,0,0
1004130,True,0,No user reviews,0,0,0
1004150,True,0,3 user reviews,3,0,3
1004160,True,0,No user reviews,0,0,0
1004170,True,0,No user reviews,0,0,0
1004180,True,0,1 user reviews,0,1,1
1004190,True,0,No user reviews,0,0,0
1004200,True,0,2 user reviews,2,0,2
1004210,True,7,Positive,30,2,32
1004220,True,0,4 user reviews,4,0,4
1004230,True,0,1 user reviews,1,0,1
1004240,True,9,Overwhelmingly Positive,499,23,522
1004260,True,0,9 user reviews,9,0,9
1004270,True,6,Mostly Positive,182,73,255
1004280,True,0,No user reviews,0,0,0
1004290,True,0,No user reviews,0,0,0
1004300,True,0,No user reviews,0,0,0
1004301,True,0,No user reviews,0,0,0
1004310,True,0,3 user reviews,3,0,3
1004320,True,0,3 user reviews,1,2,3
1004330,True,8,Very Positive,57,3,60
1004340,True,0,1 user reviews,1,0,1
1004350,True,0,No user reviews,0,0,0
1004370,True,0,No user reviews,0,0,0
1004390,True,0,No user reviews,0,0,0
1004410,True,0,No user reviews,0,0,0
1004440,True,0,No user reviews,0,0,0
1004450,True,0,No user reviews,0,0,0
1004470,True,0,No user reviews,0,0,0
1004480,True,0,No user reviews,0,0,0
1004490,True,6,Mostly Positive,73,22,95
1004500,True,0,3 user reviews,3,0,3
1004510,True,7,Positive,18,1,19
1004530,True,0,No user reviews,0,0,0
1004540,True,0,No user reviews,0,0,0
1004550,True,0,2 user reviews,0,2,2
1004560,True,5,Mixed,26,16,42
1004570,True,0,No user reviews,0,0,0
1004590,True,0,1 user reviews,0,1,1
1004600,True,0,1 user reviews,1,0,1
1004610,True,8,Very Positive,83,6,89
1004650,True,0,6 user reviews,4,2,6
1004680,True,0,No user reviews,0,0,0
1004710,True,0,No user reviews,0,0,0
1004720,True,0,No user reviews,0,0,0
1004740,True,7,Positive,36,5,41
1004750,True,5,Mixed,23,12,35
1004770,True,8,Very Positive,208,1,209
1004780,True,0,2 user reviews,1,1,2
1004790,True,0,No user reviews,0,0,0
1004800,True,0,No user reviews,0,0,0
1004820,True,0,No user reviews,0,0,0
1004860,True,7,Positive,26,4,30
1004890,True,6,Mostly Positive,13,4,17
1004891,True,7,Positive,15,0,15
1004892,True,0,7 user reviews,6,1,7
1004893,True,0,4 user reviews,3,1,4
1004894,True,0,9 user reviews,6,3,9
1004900,True,0,3 user reviews,2,1,3
1004910,True,0,No user reviews,0,0,0
1004911,True,0,1 user reviews,1,0,1
1004912,True,0,1 user reviews,0,1,1
1004913,True,0,No user reviews,0,0,0
1004914,True,0,No user reviews,0,0,0
1004915,True,0,1 user reviews,1,0,1
1004916,True,0,No user reviews,0,0,0
1004917,True,0,1 user reviews,1,0,1
1004918,True,0,1 user reviews,1,0,1
1004919,True,0,7 user reviews,4,3,7
1004920,True,0,9 user reviews,7,2,9
1004921,True,0,7 user reviews,7,0,7
1004930,True,0,4 user reviews,4,0,4
1004940,True,7,Positive,9,1,10
1004950,True,7,Positive,10,0,10
1004960,True,0,4 user reviews,4,0,4
1004970,True,0,3 user reviews,1,2,3
1004980,True,0,4 user reviews,2,2,4
1004990,True,0,4 user reviews,2,2,4
1005000,True,0,3 user reviews,3,0,3
1005010,True,0,3 user reviews,2,1,3
1005020,True,0,2 user reviews,1,1,2
1005030,True,0,2 user reviews,1,1,2
1005040,True,0,No user reviews,0,0,0
1005050,True,0,7 user reviews,6,1,7
1005060,True,0,4 user reviews,4,0,4
1005080,True,0,No user reviews,0,0,0
1005090,True,0,No user reviews,0,0,0
1005100,True,0,No user reviews,0,0,0
1005130,True,6,Mostly Positive,10,4,14
1005150,True,0,No user reviews,0,0,0
1005160,True,0,No user reviews,0,0,0
1005180,True,0,No user reviews,0,0,0
1005250,True,0,No user reviews,0,0,0
1005270,True,0,No user reviews,0,0,0
1005280,True,0,No user reviews,0,0,0
1005300,True,9,Overwhelmingly Positive,990,44,1034
1005310,True,0,4 user reviews,4,0,4
1005320,True,0,No user reviews,0,0,0
1005330,True,0,No user reviews,0,0,0
1005340,True,0,No user reviews,0,0,0
1005350,True,0,No user reviews,0,0,0
1005390,True,0,No user reviews,0,0,0
1005400,True,0,No user reviews,0,0,0
1005410,True,8,Very Positive,55,2,57
1005420,True,0,3 user reviews,0,3,3
1005450,True,7,Positive,23,0,23
1005460,True,0,3 user reviews,2,1,3
1005470,True,0,No user reviews,0,0,0
1005480,True,0,No user reviews,0,0,0
1005520,True,0,2 user reviews,2,0,2
1005530,True,0,9 user reviews,2,7,9
1005541,True,0,1 user reviews,0,1,1
1005550,True,0,7 user reviews,5,2,7
1005560,True,0,No user reviews,0,0,0
1005580,True,4,Mostly Negative,14,25,39
1005630,True,0,9 user reviews,6,3,9
1005730,True,7,Positive,10,0,10
1005750,True,0,No user reviews,0,0,0
1005770,True,0,No user reviews,0,0,0
1005780,True,0,1 user reviews,0,1,1
1005790,True,5,Mixed,18,8,26
1005810,True,0,No user reviews,0,0,0
1005811,True,0,No user reviews,0,0,0
1005812,True,0,No user reviews,0,0,0
1005813,True,0,No user reviews,0,0,0
1005814,True,0,No user reviews,0,0,0
1005815,True,0,No user reviews,0,0,0
1005816,True,0,No user reviews,0,0,0
1005820,True,0,No user reviews,0,0,0
1005870,True,0,No user reviews,0,0,0
1005880,True,0,No user reviews,0,0,0
1005890,True,0,4 user reviews,4,0,4
1005900,True,0,6 user reviews,5,1,6
1005910,True,0,No user reviews,0,0,0
1005920,True,0,1 user reviews,1,0,1
1005930,True,8,Very Positive,47,7,54
1005940,True,0,No user reviews,0,0,0
1005950,True,0,2 user reviews,1,1,2
1005960,True,0,No user reviews,0,0,0
1005970,True,0,No user reviews,0,0,0
1005971,True,6,Mostly Positive,10,4,14
1005972,True,0,7 user reviews,5,2,7
1005990,True,0,8 user reviews,6,2,8
1006000,True,0,No user reviews,0,0,0
1006030,True,0,No user reviews,0,0,0
1006090,True,0,No user reviews,0,0,0
1006120,True,0,3 user reviews,3,0,3
1006130,True,0,No user reviews,0,0,0
1006140,True,0,7 user reviews,7,0,7
1006150,True,5,Mixed,8,5,13
1006160,True,0,5 user reviews,5,0,5
1006170,True,0,No user reviews,0,0,0
1006190,True,0,1 user reviews,1,0,1
1006210,True,0,No user reviews,0,0,0
1006220,True,8,Very Positive,50,0,50
1006230,True,0,No user reviews,0,0,0
1006250,True,7,Positive,19,1,20
1006270,True,7,Positive,12,1,13
1006280,True,0,1 user reviews,1,0,1
1006290,True,0,No user reviews,0,0,0
1006300,True,0,No user reviews,0,0,0
1006340,True,0,No user reviews,0,0,0
1006350,True,0,No user reviews,0,0,0
1006360,True,0,No user reviews,0,0,0
1006370,True,0,No user reviews,0,0,0
1006380,True,0,No user reviews,0,0,0
1006390,True,0,No user reviews,0,0,0
1006400,True,0,2 user reviews,2,0,2
1006410,True,0,No user reviews,0,0,0
1006430,True,0,3 user reviews,3,0,3
1006440,True,0,9 user reviews,7,2,9
1006450,True,0,4 user reviews,3,1,4
1006460,True,0,5 user reviews,5,0,5
1006470,True,0,1 user reviews,0,1,1
1006480,True,0,No user reviews,0,0,0
1006510,True,6,Mostly Positive,461,134,595
1006540,True,0,No user reviews,0,0,0
1006590,True,0,No user reviews,0,0,0
1006600,True,0,7 user reviews,5,2,7
1006620,True,0,No user reviews,0,0,0
1006650,True,0,No user reviews,0,0,0
1006680,True,0,No user reviews,0,0,0
1006700,True,5,Mixed,8,6,14
1006710,True,7,Positive,10,0,10
1006720,True,0,3 user reviews,3,0,3
1006730,True,0,No user reviews,0,0,0
1006760,True,0,3 user reviews,3,0,3
1006770,True,0,1 user reviews,0,1,1
1006800,True,0,1 user reviews,1,0,1
1006820,True,0,No user reviews,0,0,0
1006821,True,0,No user reviews,0,0,0
1006822,True,0,No user reviews,0,0,0
1006830,True,0,No user reviews,0,0,0
1006840,True,0,No user reviews,0,0,0
1006850,True,5,Mixed,6,4,10
1006870,True,0,No user reviews,0,0,0
1006880,True,0,No user reviews,0,0,0
1006890,True,0,No user reviews,0,0,0
1006900,True,0,5 user reviews,2,3,5
1006910,True,0,No user reviews,0,0,0
1006920,True,0,4 user reviews,3,1,4
1006930,True,6,Mostly Positive,21,6,27
1006950,True,0,No user reviews,0,0,0
1006960,True,0,No user reviews,0,0,0
1006961,True,0,No user reviews,0,0,0
1006962,True,0,No user reviews,0,0,0
1006963,True,0,No user reviews,0,0,0
1006964,True,0,No user reviews,0,0,0
1006970,True,0,No user reviews,0,0,0
1006971,True,0,1 user reviews,0,1,1
1006972,True,0,No user reviews,0,0,0
1006973,True,0,No user reviews,0,0,0
1006974,True,0,No user reviews,0,0,0
1006980,True,0,No user reviews,0,0,0
1006981,True,0,3 user reviews,3,0,3
1006982,True,0,1 user reviews,0,1,1
1006990,True,0,No user reviews,0,0,0
1007020,True,0,No user reviews,0,0,0
1007040,True,9,Overwhelmingly Positive,1962,86,2048
1007050,True,7,Positive,17,1,18
1007060,True,0,1 user reviews,1,0,1
1007070,True,0,3 user reviews,2,1,3
1007080,True,0,1 user reviews,0,1,1
1007110,True,0,No user reviews,0,0,0
1007111,True,0,No user reviews,0,0,0
1007112,True,0,No user reviews,0,0,0
1007113,True,0,No user reviews,0,0,0
1007140,True,0,5 user reviews,4,1,5
1007170,True,0,No user reviews,0,0,0
1007180,True,0,2 user reviews,2,0,2
1007190,True,0,No user reviews,0,0,0
1007200,True,0,2 user reviews,1,1,2
1007210,True,0,1 user reviews,1,0,1
1007230,True,0,1 user reviews,1,0,1
1007240,True,0,2 user reviews,0,2,2
1007250,True,0,3 user reviews,3,0,3
1007251,True,0,1 user reviews,1,0,1
1007260,True,0,No user reviews,0,0,0
1007280,True,0,4 user reviews,2,2,4
1007310,True,0,No user reviews,0,0,0
1007340,True,0,No user reviews,0,0,0
1007341,True,0,No user reviews,0,0,0
1007350,True,5,Mixed,21,10,31
1007360,True,0,No user reviews,0,0,0
1007380,True,0,No user reviews,0,0,0
1007390,True,0,4 user reviews,3,1,4
1007400,True,5,Mixed,29,37,66
1007410,True,0,No user reviews,0,0,0
1007420,True,0,No user reviews,0,0,0
1007421,True,0,No user reviews,0,0,0
1007430,True,0,4 user reviews,4,0,4
1007440,True,0,2 user reviews,1,1,2
1007470,True,0,No user reviews,0,0,0
1007490,True,0,3 user reviews,0,3,3
1007500,True,0,No user reviews,0,0,0
1007510,True,0,No user reviews,0,0,0
1007520,True,7,Positive,9,1,10
1007540,True,0,No user reviews,0,0,0
1007550,True,0,No user reviews,0,0,0
1007560,True,0,5 user reviews,2,3,5
1007570,True,0,No user reviews,0,0,0
1007580,True,7,Positive,11,0,11
1007590,True,0,No user reviews,0,0,0
1007600,True,0,No user reviews,0,0,0
1007620,True,0,No user reviews,0,0,0
1007630,True,8,Very Positive,48,2,50
1007640,True,0,No user reviews,0,0,0
1007660,True,0,No user reviews,0,0,0
1007670,True,0,No user reviews,0,0,0
1007730,True,0,7 user reviews,4,3,7
1007740,True,0,No user reviews,0,0,0
1007760,True,0,No user reviews,0,0,0
1007780,True,6,Mostly Positive,17,6,23
1007800,True,0,4 user reviews,4,0,4
1007810,True,0,7 user reviews,7,0,7
1007820,True,0,No user reviews,0,0,0
1007830,True,0,5 user reviews,4,1,5
1007840,True,6,Mostly Positive,30,8,38
1007870,True,0,No user reviews,0,0,0
1007880,True,0,2 user reviews,2,0,2
1007890,True,0,No user reviews,0,0,0
1007910,True,0,5 user reviews,4,1,5
1007920,True,0,No user reviews,0,0,0
1007930,True,0,1 user reviews,1,0,1
1007940,True,0,8 user reviews,6,2,8
1007950,True,0,No user reviews,0,0,0
1007970,True,0,5 user reviews,0,5,5
1007980,True,0,1 user reviews,1,0,1
1007990,True,0,3 user reviews,1,2,3
1008000,True,0,No user reviews,0,0,0
1008010,True,0,7 user reviews,7,0,7
1008020,True,8,Very Positive,248,32,280
1008040,True,0,No user reviews,0,0,0
1008060,True,0,2 user reviews,2,0,2
1008070,True,0,No user reviews,0,0,0
1008080,True,0,No user reviews,0,0,0
1008140,True,0,4 user reviews,2,2,4
1008160,True,0,1 user reviews,0,1,1
1008170,True,0,No user reviews,0,0,0
1008180,True,0,No user reviews,0,0,0
1008210,True,0,2 user reviews,2,0,2
1008230,True,0,No user reviews,0,0,0
1008240,True,0,No user reviews,0,0,0
1008250,True,0,1 user reviews,1,0,1
1008260,True,0,2 user reviews,1,1,2
1008280,True,0,3 user reviews,3,0,3
1008290,True,5,Mixed,7,5,12
1008300,True,0,1 user reviews,1,0,1
1008320,True,0,7 user reviews,4,3,7
1008350,True,0,No user reviews,0,0,0
1008360,True,0,No user reviews,0,0,0
1008370,True,0,1 user reviews,1,0,1
1008390,True,0,1 user reviews,0,1,1
1008400,True,0,No user reviews,0,0,0
1008410,True,0,4 user reviews,1,3,4
1008420,True,0,No user reviews,0,0,0
1008430,True,0,1 user reviews,1,0,1
1008450,True,0,1 user reviews,1,0,1
1008460,True,7,Positive,23,3,26
1008470,True,0,No user reviews,0,0,0
1008510,True,5,Mixed,32,17,49
1008520,True,6,Mostly Positive,18,6,24
1008540,True,0,No user reviews,0,0,0
1008580,True,0,No user reviews,0,0,0
1008590,True,0,No user reviews,0,0,0
1008600,True,0,No user reviews,0,0,0
1008610,True,0,2 user reviews,0,2,2
1008650,True,0,No user reviews,0,0,0
1008670,True,0,No user reviews,0,0,0
1008680,True,0,4 user reviews,4,0,4
1008690,True,0,No user reviews,0,0,0
1008700,True,0,7 user reviews,6,1,7
1008710,True,6,Mostly Positive,245,72,317
1008730,True,0,2 user reviews,2,0,2
1008740,True,0,7 user reviews,6,1,7
1008750,True,0,No user reviews,0,0,0
1008760,True,0,No user reviews,0,0,0
1008770,True,0,No user reviews,0,0,0
1008800,True,8,Very Positive,55,4,59
1008810,True,0,No user reviews,0,0,0
1008820,True,0,No user reviews,0,0,0
1008830,True,7,Positive,12,1,13
1008840,True,0,No user reviews,0,0,0
1008850,True,0,1 user reviews,0,1,1
1008870,True,0,9 user reviews,6,3,9
1008890,True,0,No user reviews,0,0,0
1008900,True,0,No user reviews,0,0,0
1008910,True,0,1 user reviews,1,0,1
1008920,True,6,Mostly Positive,43,14,57
1008950,True,0,No user reviews,0,0,0
1008970,True,0,1 user reviews,1,0,1
1008990,True,0,No user reviews,0,0,0
1009030,True,0,No user reviews,0,0,0
1009040,True,0,No user reviews,0,0,0
1009080,True,0,No user reviews,0,0,0
1009100,True,0,2 user reviews,1,1,2
1009130,True,0,No user reviews,0,0,0
1009140,True,0,1 user reviews,1,0,1
1009150,True,0,2 user reviews,0,2,2
1009180,True,0,9 user reviews,6,3,9
1009190,True,0,No user reviews,0,0,0
1009200,True,0,No user reviews,0,0,0
1009210,True,0,2 user reviews,2,0,2
1009220,True,0,No user reviews,0,0,0
1009230,True,0,1 user reviews,0,1,1
1009240,True,0,No user reviews,0,0,0
1009250,True,0,No user reviews,0,0,0
1009280,True,0,No user reviews,0,0,0
1009290,True,5,Mixed,757,352,1109
1009300,True,0,1 user reviews,1,0,1
1009310,True,0,No user reviews,0,0,0
1009320,True,0,No user reviews,0,0,0
1009321,True,0,No user reviews,0,0,0
1009322,True,0,No user reviews,0,0,0
1009330,True,0,3 user reviews,3,0,3
1009350,True,0,5 user reviews,4,1,5
1009370,True,0,1 user reviews,1,0,1
1009390,True,0,2 user reviews,2,0,2
1009400,True,0,1 user reviews,1,0,1
1009410,True,0,No user reviews,0,0,0
1009420,True,0,No user reviews,0,0,0
1009430,True,0,No user reviews,0,0,0
1009450,True,8,Very Positive,107,4,111
1009460,True,7,Positive,14,1,15
1009480,True,0,No user reviews,0,0,0
1009510,True,0,No user reviews,0,0,0
1009530,True,0,No user reviews,0,0,0
1009540,True,0,No user reviews,0,0,0
1009560,True,0,No user reviews,0,0,0
1009570,True,0,No user reviews,0,0,0
1009580,True,0,No user reviews,0,0,0
1009590,True,0,2 user reviews,2,0,2
1009620,True,0,No user reviews,0,0,0
1009640,True,0,No user reviews,0,0,0
1009670,True,0,No user reviews,0,0,0
1009680,True,0,No user reviews,0,0,0
1009690,True,0,No user reviews,0,0,0
1009700,True,7,Positive,15,1,16
1009710,True,0,No user reviews,0,0,0
1009711,True,0,No user reviews,0,0,0
1009740,True,0,No user reviews,0,0,0
1009750,True,8,Very Positive,73,1,74
1009760,True,0,No user reviews,0,0,0
1009770,True,0,No user reviews,0,0,0
1009780,True,0,2 user reviews,2,0,2
1009810,True,0,1 user reviews,1,0,1
1009820,True,8,Very Positive,140,34,174
1009821,True,8,Very Positive,241,50,291
1009830,True,0,No user reviews,0,0,0
1009840,True,0,No user reviews,0,0,0
1009850,True,0,No user reviews,0,0,0
1009870,True,0,No user reviews,0,0,0
1009890,True,0,No user reviews,0,0,0
1009900,True,0,1 user reviews,0,1,1
1009910,True,0,No user reviews,0,0,0
1009920,True,0,7 user reviews,6,1,7
1009940,True,0,3 user reviews,1,2,3
1009950,True,0,No user reviews,0,0,0
1009960,True,0,6 user reviews,6,0,6
1009970,True,0,No user reviews,0,0,0
1009980,True,0,No user reviews,0,0,0
1009990,True,0,No user reviews,0,0,0
1010000,True,0,1 user reviews,1,0,1
1010070,True,0,1 user reviews,1,0,1
1010080,True,0,No user reviews,0,0,0
1010100,True,8,Very Positive,59,2,61
1010110,True,0,2 user reviews,2,0,2
1010120,True,0,1 user reviews,0,1,1
1010130,True,7,Positive,18,4,22
1010131,True,7,Positive,15,3,18
1010132,True,0,9 user reviews,9,0,9
1010133,True,5,Mixed,7,4,11
1010134,True,7,Positive,24,4,28
1010135,True,5,Mixed,18,17,35
1010136,True,7,Positive,37,8,45
1010137,True,5,Mixed,14,7,21
1010138,True,6,Mostly Positive,9,3,12
1010139,True,7,Positive,39,6,45
1010150,True,0,2 user reviews,2,0,2
1010170,True,5,Mixed,29,14,43
1010190,True,0,1 user reviews,1,0,1
1010210,True,0,5 user reviews,5,0,5
1010220,True,7,Positive,26,2,28
1010230,True,7,Positive,18,1,19
1010240,True,8,Very Positive,69,2,71
1010260,True,0,8 user reviews,3,5,8
1010270,True,5,Mixed,80,45,125
1010290,True,0,2 user reviews,2,0,2
1010300,True,0,No user reviews,0,0,0
1010320,True,0,No user reviews,0,0,0
1010330,True,0,1 user reviews,1,0,1
1010340,True,0,No user reviews,0,0,0
1010350,True,0,1 user reviews,1,0,1
1010380,True,0,3 user reviews,1,2,3
1010410,True,0,5 user reviews,3,2,5
1010420,True,0,1 user reviews,1,0,1
1010430,True,0,No user reviews,0,0,0
1010440,True,0,No user reviews,0,0,0
1010450,True,5,Mixed,13,9,22
1010460,True,0,5 user reviews,0,5,5
1010480,True,0,No user reviews,0,0,0
1010490,True,0,5 user reviews,3,2,5
1010510,True,0,No user reviews,0,0,0
1010520,True,0,1 user reviews,0,1,1
1010530,True,0,No user reviews,0,0,0
1010531,True,0,No user reviews,0,0,0
1010532,True,0,No user reviews,0,0,0
1010540,True,0,5 user reviews,4,1,5
1010560,True,0,No user reviews,0,0,0
1010590,True,0,2 user reviews,0,2,2
1010600,True,6,Mostly Positive,34,9,43
1010630,True,0,No user reviews,0,0,0
1010650,True,0,6 user reviews,5,1,6
1010660,True,6,Mostly Positive,12,5,17
1010670,True,8,Very Positive,108,9,117
1010680,True,0,No user reviews,0,0,0
1010710,True,0,No user reviews,0,0,0
1010720,True,0,No user reviews,0,0,0
1010730,True,0,No user reviews,0,0,0
1010740,True,0,1 user reviews,0,1,1
1010750,True,8,Very Positive,1865,113,1978
1010780,True,7,Positive,21,0,21
1010800,True,0,No user reviews,0,0,0
1010820,True,7,Positive,46,0,46
1010821,True,7,Positive,19,0,19
1010830,True,7,Positive,18,1,19
1010840,True,0,5 user reviews,4,1,5
1010850,True,0,No user reviews,0,0,0
1010860,True,5,Mixed,39,30,69
1010870,True,0,2 user reviews,2,0,2
1010890,True,0,No user reviews,0,0,0
1010910,True,0,No user reviews,0,0,0
1010920,True,0,1 user reviews,1,0,1
1010930,True,0,3 user reviews,2,1,3
1010940,True,0,No user reviews,0,0,0
1010950,True,0,2 user reviews,2,0,2
1010970,True,7,Positive,29,3,32
1010990,True,0,No user reviews,0,0,0
1011000,True,0,No user reviews,0,0,0
1011010,True,0,No user reviews,0,0,0
1011020,True,0,No user reviews,0,0,0
1011030,True,5,Mixed,14,7,21
1011040,True,0,No user reviews,0,0,0
1011060,True,0,No user reviews,0,0,0
1011070,True,6,Mostly Positive,24,7,31
1011090,True,7,Positive,21,5,26
1011100,True,0,No user reviews,0,0,0
1011110,True,0,No user reviews,0,0,0
1011120,True,0,2 user reviews,2,0,2
1011130,True,8,Very Positive,44,8,52
1011140,True,0,2 user reviews,0,2,2
1011170,True,0,No user reviews,0,0,0
1011171,True,0,1 user reviews,1,0,1
1011172,True,0,1 user reviews,1,0,1
1011173,True,0,1 user reviews,0,1,1
1011174,True,0,3 user reviews,0,3,3
1011175,True,0,No user reviews,0,0,0
1011176,True,0,No user reviews,0,0,0
1011177,True,0,No user reviews,0,0,0
1011178,True,0,No user reviews,0,0,0
1011179,True,0,No user reviews,0,0,0
1011180,True,0,No user reviews,0,0,0
1011190,True,8,Very Positive,156,32,188
1011200,True,0,No user reviews,0,0,0
1011210,True,0,No user reviews,0,0,0
1011211,True,0,No user reviews,0,0,0
1011212,True,0,No user reviews,0,0,0
1011213,True,0,No user reviews,0,0,0
1011214,True,0,No user reviews,0,0,0
1011215,True,0,No user reviews,0,0,0
1011216,True,0,No user reviews,0,0,0
1011217,True,0,No user reviews,0,0,0
1011218,True,0,No user reviews,0,0,0
1011240,True,0,3 user reviews,3,0,3
1011260,True,0,2 user reviews,2,0,2
1011270,True,5,Mixed,19,11,30
1011280,True,0,8 user reviews,8,0,8
1011290,True,8,Very Positive,50,6,56
1011300,True,0,3 user reviews,3,0,3
1011310,True,0,No user reviews,0,0,0
1011320,True,0,No user reviews,0,0,0
1011350,True,0,No user reviews,0,0,0
1011360,True,0,No user reviews,0,0,0
1011370,True,0,1 user reviews,0,1,1
1011390,True,8,Very Positive,291,56,347
1011400,True,0,6 user reviews,5,1,6
1011420,True,5,Mixed,13,8,21
1011440,True,0,No user reviews,0,0,0
1011460,True,0,1 user reviews,1,0,1
1011470,True,0,8 user reviews,7,1,8
1011510,True,0,No user reviews,0,0,0
1011520,True,0,No user reviews,0,0,0
1011521,True,0,No user reviews,0,0,0
1011522,True,0,No user reviews,0,0,0
1011523,True,0,No user reviews,0,0,0
1011524,True,0,1 user reviews,1,0,1
1011530,True,0,No user reviews,0,0,0
1011540,True,0,No user reviews,0,0,0
1011550,True,5,Mixed,7,4,11
1011590,True,0,No user reviews,0,0,0
1011600,True,0,No user reviews,0,0,0
1011610,True,8,Very Positive,169,21,190
1011620,True,0,4 user reviews,4,0,4
1011630,True,6,Mostly Positive,11,4,15
1011640,True,0,No user reviews,0,0,0
1011650,True,0,No user reviews,0,0,0
1011670,True,0,No user reviews,0,0,0
1011690,True,0,No user reviews,0,0,0
1011700,True,7,Positive,27,2,29
1011720,True,0,No user reviews,0,0,0
1011730,True,0,No user reviews,0,0,0
1011740,True,0,1 user reviews,0,1,1
1011760,True,0,1 user reviews,0,1,1
1011770,True,0,No user reviews,0,0,0
1011780,True,0,No user reviews,0,0,0
1011800,True,0,No user reviews,0,0,0
1011810,True,0,No user reviews,0,0,0
1011820,True,0,No user reviews,0,0,0
1011830,True,7,Positive,39,5,44
1011850,True,0,No user reviews,0,0,0
1011860,True,0,No user reviews,0,0,0
1011870,True,0,1 user reviews,1,0,1
1011890,True,7,Positive,12,1,13
1011900,True,7,Positive,16,2,18
1011920,True,0,No user reviews,0,0,0
1011940,True,8,Very Positive,111,10,121
1011950,True,0,2 user reviews,2,0,2
1011960,True,0,No user reviews,0,0,0
1011970,True,0,No user reviews,0,0,0
1011980,True,0,No user reviews,0,0,0
1011990,True,7,Positive,32,0,32
1012010,True,0,1 user reviews,1,0,1
1012030,True,8,Very Positive,72,6,78
1012070,True,0,2 user reviews,1,1,2
1012080,True,0,3 user reviews,3,0,3
1012081,True,5,Mixed,4,6,10
1012100,True,0,8 user reviews,3,5,8
1012101,True,0,3 user reviews,1,2,3
1012102,True,7,Positive,22,1,23
1012120,True,0,No user reviews,0,0,0
1012130,True,0,No user reviews,0,0,0
1012150,True,0,No user reviews,0,0,0
1012160,True,0,2 user reviews,1,1,2
1012180,True,0,No user reviews,0,0,0
1012190,True,0,No user reviews,0,0,0
1012200,True,0,No user reviews,0,0,0
1012201,True,0,No user reviews,0,0,0
1012202,True,0,No user reviews,0,0,0
1012203,True,0,No user reviews,0,0,0
1012210,True,0,4 user reviews,1,3,4
1012220,True,0,7 user reviews,6,1,7
1012230,True,0,No user reviews,0,0,0
1012240,True,0,No user reviews,0,0,0
1012270,True,0,1 user reviews,1,0,1
1012280,True,0,2 user reviews,2,0,2
1012290,True,0,No user reviews,0,0,0
1012360,True,0,1 user reviews,1,0,1
1012370,True,0,3 user reviews,1,2,3
1012380,True,0,1 user reviews,0,1,1
1012381,True,0,No user reviews,0,0,0
1012390,True,0,No user reviews,0,0,0
1012400,True,0,1 user reviews,0,1,1
1012401,True,0,1 user reviews,1,0,1
1012402,True,0,4 user reviews,3,1,4
1012403,True,0,2 user reviews,2,0,2
1012404,True,0,1 user reviews,0,1,1
1012405,True,0,5 user reviews,5,0,5
1012406,True,0,No user reviews,0,0,0
1012410,True,7,Positive,26,5,31
1012420,True,0,No user reviews,0,0,0
1012430,True,0,1 user reviews,1,0,1
1012450,True,0,5 user reviews,5,0,5
1012460,True,5,Mixed,8,7,15
1012470,True,0,No user reviews,0,0,0
1012490,True,0,1 user reviews,1,0,1
1012510,True,0,No user reviews,0,0,0
1012530,True,0,3 user reviews,3,0,3
1012560,True,8,Very Positive,889,69,958
1012570,True,0,No user reviews,0,0,0
1012580,True,0,9 user reviews,6,3,9
1012600,True,0,No user reviews,0,0,0
1012610,True,8,Very Positive,233,57,290
1012630,True,8,Very Positive,113,3,116
1012640,True,0,No user reviews,0,0,0
1012650,True,0,No user reviews,0,0,0
1012670,True,0,1 user reviews,1,0,1
1012710,True,0,1 user reviews,0,1,1
1012720,True,0,3 user reviews,2,1,3
1012730,True,0,No user reviews,0,0,0
1012740,True,0,No user reviews,0,0,0
1012760,True,0,No user reviews,0,0,0
1012790,True,6,Mostly Positive,241,71,312
1012800,True,0,1 user reviews,1,0,1
1012810,True,0,1 user reviews,1,0,1
1012830,True,6,Mostly Positive,8,3,11
1012840,True,6,Mostly Positive,466,127,593
1012850,True,0,9 user reviews,9,0,9
1012860,True,0,No user reviews,0,0,0
1012880,True,8,Very Positive,791,70,861
1012890,True,0,No user reviews,0,0,0
1012900,True,5,Mixed,21,15,36
1012930,True,0,No user reviews,0,0,0
1012940,True,0,No user reviews,0,0,0
1012960,True,0,7 user reviews,6,1,7
1012970,True,6,Mostly Positive,19,5,24
1012980,True,7,Positive,16,4,20
1012990,True,7,Positive,9,1,10
1013000,True,0,1 user reviews,0,1,1
1013010,True,0,No user reviews,0,0,0
1013040,True,6,Mostly Positive,21,8,29
1013070,True,0,7 user reviews,4,3,7
1013080,True,0,No user reviews,0,0,0
1013090,True,0,2 user reviews,2,0,2
1013100,True,0,4 user reviews,4,0,4
1013110,True,0,No user reviews,0,0,0
1013120,True,0,3 user reviews,2,1,3
1013130,True,5,Mixed,7,6,13
1013150,True,0,No user reviews,0,0,0
1013180,True,7,Positive,42,3,45
1013190,True,7,Positive,12,0,12
1013200,True,0,No user reviews,0,0,0
1013210,True,0,No user reviews,0,0,0
1013211,True,0,No user reviews,0,0,0
1013212,True,0,No user reviews,0,0,0
1013213,True,0,No user reviews,0,0,0
1013230,True,0,1 user reviews,1,0,1
1013280,True,7,Positive,19,0,19
1013290,True,0,1 user reviews,1,0,1
1013300,True,5,Mixed,31,16,47
1013310,True,5,Mixed,33,18,51
1013320,True,0,No user reviews,0,0,0
1013330,True,0,No user reviews,0,0,0
1013340,True,0,No user reviews,0,0,0
1013350,True,0,3 user reviews,1,2,3
1013400,True,0,No user reviews,0,0,0
1013410,True,0,8 user reviews,1,7,8
1013420,True,0,No user reviews,0,0,0
1013430,True,0,No user reviews,0,0,0
1013450,True,0,4 user reviews,3,1,4
1013500,True,0,No user reviews,0,0,0
1013540,True,8,Very Positive,54,12,66
1013550,True,0,No user reviews,0,0,0
1013560,True,0,No user reviews,0,0,0
1013580,True,0,6 user reviews,5,1,6
1013600,True,0,6 user reviews,6,0,6
1013630,True,0,1 user reviews,1,0,1
1013650,True,7,Positive,42,2,44
1013660,True,0,No user reviews,0,0,0
1013670,True,0,2 user reviews,2,0,2
1013680,True,0,No user reviews,0,0,0
1013700,True,5,Mixed,7,5,12
1013710,True,5,Mixed,8,4,12
1013740,True,0,No user reviews,0,0,0
1013750,True,6,Mostly Positive,11,3,14
1013780,True,0,No user reviews,0,0,0
1013790,True,0,No user reviews,0,0,0
1013810,True,0,No user reviews,0,0,0
1013820,True,0,5 user reviews,4,1,5
1013830,True,0,No user reviews,0,0,0
1013850,True,0,No user reviews,0,0,0
1013870,True,7,Positive,42,4,46
1013890,True,0,2 user reviews,1,1,2
1013910,True,0,No user reviews,0,0,0
1013940,True,0,No user reviews,0,0,0
1013950,True,0,3 user reviews,3,0,3
1013960,True,7,Positive,10,2,12
1013970,True,0,No user reviews,0,0,0
1013980,True,0,No user reviews,0,0,0
1014000,True,0,No user reviews,0,0,0
1014010,True,5,Mixed,6,5,11
1014030,True,0,1 user reviews,0,1,1
1014040,True,5,Mixed,11,7,18
1014050,True,0,3 user reviews,1,2,3
1014100,True,6,Mostly Positive,11,4,15
1014110,True,5,Mixed,8,4,12
1014120,True,0,No user reviews,0,0,0
1014130,True,6,Mostly Positive,45,16,61
1014140,True,8,Very Positive,73,3,76
1014180,True,0,No user reviews,0,0,0
1014240,True,0,No user reviews,0,0,0
1014270,True,0,5 user reviews,5,0,5
1014280,True,7,Positive,31,2,33
1014290,True,0,2 user reviews,2,0,2
1014300,True,0,7 user reviews,6,1,7
1014310,True,0,1 user reviews,1,0,1
1014350,True,0,No user reviews,0,0,0
1014360,True,0,2 user reviews,2,0,2
1014370,True,0,No user reviews,0,0,0
1014400,True,0,No user reviews,0,0,0
1014420,True,7,Positive,9,1,10
1014450,True,0,1 user reviews,1,0,1
1014460,True,6,Mostly Positive,13,4,17
1014470,True,0,No user reviews,0,0,0
1014540,True,0,No user reviews,0,0,0
1014550,True,0,No user reviews,0,0,0
1014560,True,6,Mostly Positive,7,3,10
1014570,True,7,Positive,14,2,16
1014580,True,0,7 user reviews,7,0,7
1014590,True,0,9 user reviews,3,6,9
1014600,True,0,No user reviews,0,0,0
1014610,True,0,No user reviews,0,0,0
1014620,True,0,4 user reviews,3,1,4
1014640,True,0,No user reviews,0,0,0
1014660,True,0,1 user reviews,1,0,1
1014700,True,0,No user reviews,0,0,0
1014710,True,0,7 user reviews,5,2,7
1014720,True,0,No user reviews,0,0,0
1014730,True,6,Mostly Positive,61,26,87
1014740,True,0,No user reviews,0,0,0
1014750,True,0,3 user reviews,3,0,3
1014780,True,0,No user reviews,0,0,0
1014790,True,0,1 user reviews,1,0,1
1014810,True,5,Mixed,22,17,39
1014820,True,0,3 user reviews,2,1,3
1014840,True,0,1 user reviews,1,0,1
1014850,True,0,3 user reviews,3,0,3
1014870,True,0,No user reviews,0,0,0
1014880,True,0,No user reviews,0,0,0
1014890,True,0,5 user reviews,2,3,5
1014900,True,5,Mixed,6,5,11
1014910,True,0,No user reviews,0,0,0
1014920,True,0,No user reviews,0,0,0
1014930,True,0,No user reviews,0,0,0
1014940,True,0,No user reviews,0,0,0
1014960,True,0,No user reviews,0,0,0
1014970,True,0,No user reviews,0,0,0
1014980,True,0,No user reviews,0,0,0
1014990,True,0,6 user reviews,5,1,6
1015020,True,0,9 user reviews,7,2,9
1015030,True,7,Positive,43,5,48
1015050,True,7,Positive,12,1,13
1015080,True,7,Positive,16,4,20
1015090,True,5,Mixed,30,35,65
1015100,True,0,3 user reviews,2,1,3
1015110,True,0,3 user reviews,3,0,3
1015120,True,0,No user reviews,0,0,0
1015130,True,5,Mixed,36,17,53
1015140,True,6,Mostly Positive,163,44,207
1015150,True,0,No user reviews,0,0,0
1015160,True,8,Very Positive,250,12,262
1015170,True,0,No user reviews,0,0,0
1015180,True,0,1 user reviews,0,1,1
1015220,True,0,No user reviews,0,0,0
1015221,True,0,No user reviews,0,0,0
1015222,True,0,No user reviews,0,0,0
1015240,True,0,4 user reviews,2,2,4
1015250,True,0,1 user reviews,1,0,1
1015290,True,0,No user reviews,0,0,0
1015350,True,4,Mostly Negative,4,8,12
1015370,True,0,No user reviews,0,0,0
1015430,True,6,Mostly Positive,17,6,23
1015460,True,0,No user reviews,0,0,0
1015470,True,0,2 user reviews,0,2,2
1015480,True,6,Mostly Positive,24,9,33
1015490,True,0,No user reviews,0,0,0
1015500,True,4,Mostly Negative,330,584,914
1015530,True,0,3 user reviews,2,1,3
1015540,True,0,2 user reviews,0,2,2
1015550,True,0,1 user reviews,1,0,1
1015560,True,0,No user reviews,0,0,0
1015580,True,0,No user reviews,0,0,0
1015590,True,0,No user reviews,0,0,0
1015600,True,0,No user reviews,0,0,0
1015610,True,5,Mixed,60,33,93
1015650,True,0,No user reviews,0,0,0
1015660,True,7,Positive,17,3,20
1015680,True,0,No user reviews,0,0,0
1015690,True,0,No user reviews,0,0,0
1015700,True,0,No user reviews,0,0,0
1015710,True,4,Mostly Negative,5,10,15
1015720,True,7,Positive,44,5,49
1015730,True,7,Positive,32,7,39
1015750,True,0,8 user reviews,6,2,8
1015770,True,7,Positive,31,7,38
1015790,True,5,Mixed,16,9,25
1015800,True,5,Mixed,10,6,16
1015810,True,0,No user reviews,0,0,0
1015820,True,0,No user reviews,0,0,0
1015830,True,5,Mixed,13,18,31
1015840,True,0,No user reviews,0,0,0
1015850,True,0,No user reviews,0,0,0
1015860,True,0,No user reviews,0,0,0
1015880,True,6,Mostly Positive,20,7,27
1015890,True,0,No user reviews,0,0,0
1015900,True,0,6 user reviews,6,0,6
1015920,True,0,No user reviews,0,0,0
1015930,True,4,Mostly Negative,79,121,200
1015940,True,7,Positive,40,0,40
1015960,True,0,No user reviews,0,0,0
1015970,True,0,No user reviews,0,0,0
1015980,True,5,Mixed,7,4,11
1015990,True,0,No user reviews,0,0,0
1016000,True,0,No user reviews,0,0,0
1016010,True,0,4 user reviews,2,2,4
1016030,True,0,No user reviews,0,0,0
1016050,True,0,No user reviews,0,0,0
1016070,True,2,Very Negative,12,65,77
1016080,True,5,Mixed,13,14,27
1016100,True,0,1 user reviews,1,0,1
1016110,True,0,No user reviews,0,0,0
1016120,True,8,Very Positive,931,228,1159
1016130,True,0,3 user reviews,3,0,3
1016150,True,0,3 user reviews,0,3,3
1016180,True,0,No user reviews,0,0,0
1016220,True,0,No user reviews,0,0,0
1016250,True,5,Mixed,9,6,15
1016260,True,0,No user reviews,0,0,0
1016300,True,0,4 user reviews,4,0,4
1016330,True,0,2 user reviews,2,0,2
1016360,True,0,No user reviews,0,0,0
1016390,True,0,No user reviews,0,0,0
1016420,True,0,7 user reviews,5,2,7
1016430,True,0,8 user reviews,8,0,8
1016480,True,0,No user reviews,0,0,0
1016500,True,0,No user reviews,0,0,0
1016510,True,0,No user reviews,0,0,0
1016520,True,0,5 user reviews,5,0,5
1016530,True,0,No user reviews,0,0,0
1016540,True,0,No user reviews,0,0,0
1016550,True,0,No user reviews,0,0,0
1016560,True,0,No user reviews,0,0,0
1016580,True,0,No user reviews,0,0,0
1016590,True,0,No user reviews,0,0,0
1016600,True,8,Very Positive,95,11,106
1016610,True,0,4 user reviews,2,2,4
1016620,True,0,No user reviews,0,0,0
1016630,True,7,Positive,15,0,15
1016640,True,0,No user reviews,0,0,0
1016650,True,0,1 user reviews,1,0,1
1016660,True,0,5 user reviews,4,1,5
1016690,True,0,2 user reviews,1,1,2
1016700,True,0,No user reviews,0,0,0
1016710,True,3,Negative,2,11,13
1016720,True,5,Mixed,16,13,29
1016730,True,5,Mixed,138,65,203
1016740,True,0,2 user reviews,0,2,2
1016750,True,0,No user reviews,0,0,0
1016760,True,6,Mostly Positive,13,5,18
1016770,True,8,Very Positive,82,10,92
1016780,True,0,No user reviews,0,0,0
1016790,True,6,Mostly Positive,81,31,112
1016800,True,6,Mostly Positive,580,177,757
1016810,True,5,Mixed,14,12,26
1016830,True,0,No user reviews,0,0,0
1016840,True,5,Mixed,41,26,67
1016850,True,0,1 user reviews,1,0,1
1016860,True,8,Very Positive,61,14,75
1016890,True,0,No user reviews,0,0,0
1016920,True,8,Very Positive,1036,59,1095
1016930,True,5,Mixed,39,24,63
1016940,True,7,Positive,10,2,12
1016950,True,0,No user reviews,0,0,0
1016960,True,8,Very Positive,223,45,268
1016970,True,0,No user reviews,0,0,0
1016980,True,0,6 user reviews,4,2,6
1017030,True,8,Very Positive,55,7,62
1017060,True,5,Mixed,41,25,66
1017070,True,0,No user reviews,0,0,0
1017100,True,0,No user reviews,0,0,0
1017130,True,0,6 user reviews,5,1,6
1017170,True,0,No user reviews,0,0,0
1017180,True,8,Very Positive,895,128,1023
1017220,True,0,No user reviews,0,0,0
1017230,True,0,No user reviews,0,0,0
1017240,True,0,1 user reviews,1,0,1
1017270,True,0,1 user reviews,1,0,1
1017280,True,0,No user reviews,0,0,0
1017310,True,0,No user reviews,0,0,0
1017330,True,0,No user reviews,0,0,0
1017350,True,0,5 user reviews,3,2,5
1017360,True,0,No user reviews,0,0,0
1017370,True,0,No user reviews,0,0,0
1017380,True,0,No user reviews,0,0,0
1017390,True,0,No user reviews,0,0,0
1017391,True,0,No user reviews,0,0,0
1017410,True,0,1 user reviews,1,0,1
1017440,True,0,1 user reviews,1,0,1
1017470,True,0,No user reviews,0,0,0
1017480,True,0,No user reviews,0,0,0
1017490,True,0,No user reviews,0,0,0
1017510,True,7,Positive,16,1,17
1017520,True,7,Positive,34,7,41
1017530,True,0,No user reviews,0,0,0
1017540,True,0,No user reviews,0,0,0
1017560,True,0,8 user reviews,7,1,8
1017570,True,0,No user reviews,0,0,0
1017580,True,5,Mixed,7,4,11
1017600,True,0,1 user reviews,0,1,1
1017610,True,0,2 user reviews,2,0,2
1017620,True,0,2 user reviews,1,1,2
1017630,True,0,4 user reviews,4,0,4
1017650,True,0,No user reviews,0,0,0
1017660,True,0,No user reviews,0,0,0
1017670,True,0,9 user reviews,8,1,9
1017680,True,0,No user reviews,0,0,0
1017690,True,0,No user reviews,0,0,0
1017700,True,0,No user reviews,0,0,0
1017710,True,0,No user reviews,0,0,0
1017720,True,0,No user reviews,0,0,0
1017730,True,0,No user reviews,0,0,0
1017750,True,0,1 user reviews,0,1,1
1017760,True,0,No user reviews,0,0,0
1017770,True,0,No user reviews,0,0,0
1017780,True,6,Mostly Positive,23,9,32
1017790,True,0,No user reviews,0,0,0
1017800,True,0,No user reviews,0,0,0
1017810,True,0,2 user reviews,2,0,2
1017820,True,0,No user reviews,0,0,0
1017830,True,0,No user reviews,0,0,0
1017840,True,0,No user reviews,0,0,0
1017850,True,0,No user reviews,0,0,0
1017870,True,0,No user reviews,0,0,0
1017880,True,0,5 user reviews,3,2,5
1017890,True,0,No user reviews,0,0,0
1017900,True,6,Mostly Positive,1548,393,1941
1017910,True,0,4 user reviews,3,1,4
1017920,True,0,No user reviews,0,0,0
1017940,True,6,Mostly Positive,12,4,16
1017990,True,0,No user reviews,0,0,0
1018000,True,5,Mixed,21,15,36
1018010,True,8,Very Positive,221,50,271
1018020,True,6,Mostly Positive,80,22,102
1018030,True,0,No user reviews,0,0,0
1018040,True,5,Mixed,9,4,13
1018050,True,0,No user reviews,0,0,0
1018060,True,0,No user reviews,0,0,0
1018080,True,0,3 user reviews,2,1,3
1018090,True,0,4 user reviews,1,3,4
1018100,True,0,No user reviews,0,0,0
1018110,True,0,No user reviews,0,0,0
1018120,True,0,No user reviews,0,0,0
1018130,True,7,Positive,24,2,26
1018140,True,0,No user reviews,0,0,0
1018150,True,0,No user reviews,0,0,0
1018151,True,0,No user reviews,0,0,0
1018160,True,8,Very Positive,135,32,167
1018170,True,0,No user reviews,0,0,0
1018180,True,0,No user reviews,0,0,0
1018190,True,0,No user reviews,0,0,0
1018210,True,0,No user reviews,0,0,0
1018220,True,0,No user reviews,0,0,0
1018240,True,0,5 user reviews,5,0,5
1018270,True,5,Mixed,11,11,22
1018320,True,0,1 user reviews,1,0,1
1018350,True,0,No user reviews,0,0,0
1018360,True,0,No user reviews,0,0,0
1018361,True,0,No user reviews,0,0,0
1018362,True,0,No user reviews,0,0,0
1018363,True,0,No user reviews,0,0,0
1018364,True,0,No user reviews,0,0,0
1018370,True,0,No user reviews,0,0,0
1018380,True,0,No user reviews,0,0,0
1018420,True,0,7 user reviews,6,1,7
1018440,True,0,No user reviews,0,0,0
1018460,True,0,No user reviews,0,0,0
1018470,True,0,No user reviews,0,0,0
1018480,True,0,1 user reviews,1,0,1
1018530,True,8,Very Positive,58,8,66
1018560,True,0,2 user reviews,2,0,2
1018590,True,0,3 user reviews,2,1,3
1018610,True,0,7 user reviews,4,3,7
1018640,True,0,No user reviews,0,0,0
1018650,True,0,No user reviews,0,0,0
1018670,True,0,1 user reviews,1,0,1
1018680,True,7,Positive,38,9,47
1018700,True,0,No user reviews,0,0,0
1018720,True,0,3 user reviews,2,1,3
1018730,True,0,No user reviews,0,0,0
1018740,True,0,No user reviews,0,0,0
1018750,True,0,No user reviews,0,0,0
1018760,True,0,4 user reviews,4,0,4
1018761,True,0,6 user reviews,6,0,6
1018770,True,0,1 user reviews,0,1,1
1018800,True,8,Very Positive,279,18,297
1018810,True,0,1 user reviews,1,0,1
1018820,True,0,4 user reviews,2,2,4
1018830,True,8,Very Positive,113,8,121
1018850,True,9,Overwhelmingly Positive,649,4,653
1018860,True,0,2 user reviews,2,0,2
1018870,True,5,Mixed,12,8,20
1018880,True,7,Positive,25,1,26
1018890,True,0,No user reviews,0,0,0
1018900,True,0,2 user reviews,2,0,2
1018930,True,0,No user reviews,0,0,0
1018940,True,0,No user reviews,0,0,0
1018950,True,0,No user reviews,0,0,0
1018960,True,0,2 user reviews,0,2,2
1018990,True,7,Positive,15,0,15
1019000,True,0,No user reviews,0,0,0
1019010,True,0,No user reviews,0,0,0
1019020,True,0,2 user reviews,2,0,2
1019030,True,0,No user reviews,0,0,0
1019040,True,0,5 user reviews,3,2,5
1019060,True,0,2 user reviews,1,1,2
1019070,True,0,4 user reviews,4,0,4
1019080,True,0,1 user reviews,0,1,1
1019090,True,0,No user reviews,0,0,0
1019100,True,0,No user reviews,0,0,0
1019110,True,0,No user reviews,0,0,0
1019120,True,0,No user reviews,0,0,0
1019130,True,0,No user reviews,0,0,0
1019132,True,0,No user reviews,0,0,0
1019133,True,0,3 user reviews,2,1,3
1019140,True,0,No user reviews,0,0,0
1019150,True,0,No user reviews,0,0,0
1019170,True,0,1 user reviews,0,1,1
1019180,True,0,No user reviews,0,0,0
1019210,True,0,No user reviews,0,0,0
1019211,True,0,No user reviews,0,0,0
1019213,True,0,No user reviews,0,0,0
1019230,True,7,Positive,14,1,15
1019240,True,0,No user reviews,0,0,0
1019250,True,0,No user reviews,0,0,0
1019260,True,0,No user reviews,0,0,0
1019270,True,0,2 user reviews,2,0,2
1019280,True,0,No user reviews,0,0,0
1019290,True,0,No user reviews,0,0,0
1019300,True,0,No user reviews,0,0,0
1019310,True,8,Very Positive,222,47,269
1019320,True,0,No user reviews,0,0,0
1019340,True,0,No user reviews,0,0,0
1019360,True,0,1 user reviews,0,1,1
1019370,True,0,No user reviews,0,0,0
1019380,True,0,No user reviews,0,0,0
1019400,True,0,3 user reviews,3,0,3
1019420,True,8,Very Positive,59,12,71
1019450,True,5,Mixed,24,17,41
1019470,True,0,No user reviews,0,0,0
1019500,True,0,No user reviews,0,0,0
1019510,True,0,4 user reviews,1,3,4
1019511,True,0,4 user reviews,3,1,4
1019512,True,0,2 user reviews,0,2,2
1019513,True,0,2 user reviews,1,1,2
1019530,True,0,No user reviews,0,0,0
1019540,True,7,Positive,9,1,10
1019550,True,6,Mostly Positive,229,89,318
1019580,True,0,No user reviews,0,0,0
1019590,True,7,Positive,43,1,44
1019630,True,0,8 user reviews,5,3,8
1019640,True,0,1 user reviews,1,0,1
1019660,True,0,No user reviews,0,0,0
1019690,True,0,No user reviews,0,0,0
1019700,True,0,No user reviews,0,0,0
1019710,True,0,1 user reviews,0,1,1
1019720,True,0,No user reviews,0,0,0
1019730,True,0,2 user reviews,2,0,2
1019740,True,0,No user reviews,0,0,0
1019770,True,0,No user reviews,0,0,0
1019790,True,0,2 user reviews,1,1,2
1019800,True,0,No user reviews,0,0,0
1019820,True,0,2 user reviews,2,0,2
1019830,True,0,No user reviews,0,0,0
1019840,True,0,No user reviews,0,0,0
1019870,True,0,No user reviews,0,0,0
1019910,True,0,No user reviews,0,0,0
1019920,True,7,Positive,14,0,14
1019930,True,7,Positive,30,3,33
1019931,True,0,No user reviews,0,0,0
1019940,True,5,Mixed,79,36,115
1019960,True,0,1 user reviews,1,0,1
1019961,True,0,No user reviews,0,0,0
1019962,True,0,No user reviews,0,0,0
1019963,True,0,No user reviews,0,0,0
1019964,True,0,1 user reviews,1,0,1
1019965,True,0,1 user reviews,1,0,1
1019966,True,0,2 user reviews,0,2,2
1019967,True,0,No user reviews,0,0,0
1019968,True,0,No user reviews,0,0,0
1019969,True,0,No user reviews,0,0,0
1019970,True,0,No user reviews,0,0,0
1019971,True,0,No user reviews,0,0,0
1019980,True,0,No user reviews,0,0,0
1019981,True,0,No user reviews,0,0,0
1019982,True,0,No user reviews,0,0,0
1019983,True,0,No user reviews,0,0,0
1019984,True,0,1 user reviews,1,0,1
1019985,True,0,1 user reviews,1,0,1
1019986,True,0,No user reviews,0,0,0
1019987,True,0,No user reviews,0,0,0
1019988,True,0,No user reviews,0,0,0
1019989,True,0,1 user reviews,1,0,1
1019990,True,0,No user reviews,0,0,0
1019991,True,0,No user reviews,0,0,0
1019992,True,0,No user reviews,0,0,0
1019993,True,0,1 user reviews,1,0,1
1019994,True,0,1 user reviews,1,0,1
1020010,True,0,No user reviews,0,0,0
1020020,True,0,1 user reviews,1,0,1
1020030,True,6,Mostly Positive,30,11,41
1020040,True,0,1 user reviews,1,0,1
1020050,True,5,Mixed,11,5,16
1020070,True,0,No user reviews,0,0,0
1020080,True,0,No user reviews,0,0,0
1020090,True,0,7 user reviews,7,0,7
1020100,True,7,Positive,11,1,12
1020120,True,0,2 user reviews,2,0,2
1020140,True,0,No user reviews,0,0,0
1020210,True,6,Mostly Positive,11,4,15
1020230,True,0,No user reviews,0,0,0
1020250,True,0,2 user reviews,1,1,2
1020270,True,7,Positive,28,4,32
1020290,True,0,4 user reviews,3,1,4
1020310,True,0,No user reviews,0,0,0
1020320,True,0,No user reviews,0,0,0
1020330,True,0,2 user reviews,2,0,2
1020340,True,8,Very Positive,256,45,301
1020350,True,0,No user reviews,0,0,0
1020360,True,0,No user reviews,0,0,0
1020370,True,0,No user reviews,0,0,0
1020380,True,0,No user reviews,0,0,0
1020390,True,0,4 user reviews,3,1,4
1020400,True,0,No user reviews,0,0,0
1020410,True,0,No user reviews,0,0,0
1020420,True,0,No user reviews,0,0,0
1020430,True,0,No user reviews,0,0,0
1020440,True,0,2 user reviews,1,1,2
1020450,True,0,6 user reviews,6,0,6
1020460,True,0,No user reviews,0,0,0
1020470,True,8,Very Positive,207,47,254
1020480,True,0,2 user reviews,1,1,2
1020490,True,0,2 user reviews,2,0,2
1020520,True,0,No user reviews,0,0,0
1020540,True,5,Mixed,10,10,20
1020560,True,0,3 user reviews,2,1,3
1020570,True,0,No user reviews,0,0,0
1020571,True,0,No user reviews,0,0,0
1020572,True,0,No user reviews,0,0,0
1020580,True,0,No user reviews,0,0,0
1020590,True,7,Positive,34,0,34
1020600,True,0,9 user reviews,5,4,9
1020610,True,0,No user reviews,0,0,0
1020630,True,0,1 user reviews,1,0,1
1020631,True,0,1 user reviews,1,0,1
1020640,True,0,No user reviews,0,0,0
1020650,True,0,1 user reviews,1,0,1
1020660,True,4,Mostly Negative,3,10,13
1020670,True,0,No user reviews,0,0,0
1020700,True,0,No user reviews,0,0,0
1020710,True,0,No user reviews,0,0,0
1020730,True,8,Very Positive,132,13,145
1020780,True,0,No user reviews,0,0,0
1020800,True,5,Mixed,24,12,36
1020820,True,6,Mostly Positive,84,31,115
1020830,True,0,No user reviews,0,0,0
1020840,True,0,1 user reviews,1,0,1
1020880,True,0,No user reviews,0,0,0
1020910,True,0,No user reviews,0,0,0
1020930,True,0,No user reviews,0,0,0
1020940,True,7,Positive,34,0,34
1020980,True,0,1 user reviews,0,1,1
1021010,True,0,No user reviews,0,0,0
1021011,True,0,No user reviews,0,0,0
1021030,True,0,No user reviews,0,0,0
1021060,True,0,1 user reviews,1,0,1
1021070,True,6,Mostly Positive,74,31,105
1021080,True,0,No user reviews,0,0,0
1021090,True,0,No user reviews,0,0,0
1021100,True,0,No user reviews,0,0,0
1021110,True,0,No user reviews,0,0,0
1021120,True,0,6 user reviews,2,4,6
1021130,True,0,3 user reviews,3,0,3
1021150,True,0,No user reviews,0,0,0
1021160,True,0,No user reviews,0,0,0
1021170,True,0,No user reviews,0,0,0
1021180,True,0,No user reviews,0,0,0
1021190,True,0,7 user reviews,5,2,7
1021200,True,0,No user reviews,0,0,0
1021210,True,0,No user reviews,0,0,0
1021220,True,0,No user reviews,0,0,0
1021240,True,0,No user reviews,0,0,0
1021250,True,0,No user reviews,0,0,0
1021260,True,0,No user reviews,0,0,0
1021280,True,7,Positive,25,0,25
1021290,True,0,No user reviews,0,0,0
1021370,True,0,3 user reviews,3,0,3
1021580,True,0,No user reviews,0,0,0
1021640,True,0,3 user reviews,3,0,3
1021650,True,0,No user reviews,0,0,0
1021670,True,0,2 user reviews,0,2,2
1021680,True,0,6 user reviews,5,1,6
1021690,True,0,3 user reviews,1,2,3
1021730,True,0,No user reviews,0,0,0
1021740,True,0,1 user reviews,0,1,1
1021741,True,0,No user reviews,0,0,0
1021742,True,0,No user reviews,0,0,0
1021770,True,8,Very Positive,64,2,66
1021780,True,3,Negative,1,23,24
1021790,True,5,Mixed,487,256,743
1021800,True,0,2 user reviews,1,1,2
1021820,True,0,2 user reviews,2,0,2
1021830,True,0,No user reviews,0,0,0
1021840,True,0,No user reviews,0,0,0
1021850,True,0,No user reviews,0,0,0
1021860,True,0,4 user reviews,4,0,4
1021880,True,0,1 user reviews,1,0,1
1021890,True,0,No user reviews,0,0,0
1021900,True,0,1 user reviews,1,0,1
1021901,True,0,No user reviews,0,0,0
1021910,True,0,No user reviews,0,0,0
1021940,True,0,No user reviews,0,0,0
1021950,True,0,No user reviews,0,0,0
1021960,True,0,No user reviews,0,0,0
1021980,True,0,No user reviews,0,0,0
1021990,True,0,No user reviews,0,0,0
1022000,True,0,No user reviews,0,0,0
1022010,True,6,Mostly Positive,12,4,16
1022040,True,0,3 user reviews,1,2,3
1022060,True,0,No user reviews,0,0,0
1022120,True,0,1 user reviews,1,0,1
1022130,True,0,7 user reviews,6,1,7
1022150,True,0,No user reviews,0,0,0
1022160,True,0,1 user reviews,1,0,1
1022170,True,0,1 user reviews,0,1,1
1022180,True,0,No user reviews,0,0,0
1022190,True,0,No user reviews,0,0,0
1022200,True,0,No user reviews,0,0,0
1022230,True,5,Mixed,57,26,83
1022270,True,0,2 user reviews,2,0,2
1022280,True,0,2 user reviews,1,1,2
1022310,True,6,Mostly Positive,346,112,458
1022320,True,0,No user reviews,0,0,0
1022330,True,0,No user reviews,0,0,0
1022340,True,0,No user reviews,0,0,0
1022343,True,0,No user reviews,0,0,0
1022344,True,0,No user reviews,0,0,0
1022345,True,0,No user reviews,0,0,0
1022350,True,0,No user reviews,0,0,0
1022360,True,0,No user reviews,0,0,0
1022361,True,0,No user reviews,0,0,0
1022362,True,0,No user reviews,0,0,0
1022365,True,0,No user reviews,0,0,0
1022366,True,0,No user reviews,0,0,0
1022367,True,0,No user reviews,0,0,0
1022380,True,0,1 user reviews,0,1,1
1022391,True,0,No user reviews,0,0,0
1022392,True,0,1 user reviews,1,0,1
1022393,True,0,No user reviews,0,0,0
1022394,True,0,No user reviews,0,0,0
1022395,True,0,No user reviews,0,0,0
1022396,True,0,No user reviews,0,0,0
1022397,True,0,No user reviews,0,0,0
1022400,True,0,No user reviews,0,0,0
1022401,True,0,No user reviews,0,0,0
1022402,True,0,No user reviews,0,0,0
1022410,True,0,No user reviews,0,0,0
1022411,True,0,No user reviews,0,0,0
1022412,True,0,No user reviews,0,0,0
1022413,True,0,No user reviews,0,0,0
1022414,True,0,No user reviews,0,0,0
1022415,True,0,No user reviews,0,0,0
1022416,True,0,No user reviews,0,0,0
1022417,True,0,No user reviews,0,0,0
1022418,True,0,1 user reviews,1,0,1
1022419,True,0,No user reviews,0,0,0
1022420,True,0,No user reviews,0,0,0
1022421,True,0,No user reviews,0,0,0
1022422,True,0,No user reviews,0,0,0
1022423,True,0,No user reviews,0,0,0
1022424,True,0,1 user reviews,1,0,1
1022425,True,0,No user reviews,0,0,0
1022426,True,0,No user reviews,0,0,0
1022427,True,0,No user reviews,0,0,0
1022428,True,0,No user reviews,0,0,0
1022429,True,0,No user reviews,0,0,0
1022430,True,0,No user reviews,0,0,0
1022431,True,0,No user reviews,0,0,0
1022432,True,0,No user reviews,0,0,0
1022433,True,0,No user reviews,0,0,0
1022435,True,0,No user reviews,0,0,0
1022436,True,0,No user reviews,0,0,0
1022437,True,0,No user reviews,0,0,0
1022438,True,0,1 user reviews,1,0,1
1022439,True,0,No user reviews,0,0,0
1022440,True,0,No user reviews,0,0,0
1022441,True,0,No user reviews,0,0,0
1022442,True,0,No user reviews,0,0,0
1022443,True,0,1 user reviews,1,0,1
1022444,True,0,No user reviews,0,0,0
1022445,True,0,No user reviews,0,0,0
1022446,True,0,No user reviews,0,0,0
1022447,True,0,No user reviews,0,0,0
1022448,True,0,2 user reviews,2,0,2
1022449,True,0,1 user reviews,1,0,1
1022450,True,0,No user reviews,0,0,0
1022460,True,0,2 user reviews,2,0,2
1022461,True,0,No user reviews,0,0,0
1022462,True,0,No user reviews,0,0,0
1022463,True,0,No user reviews,0,0,0
1022464,True,0,No user reviews,0,0,0
1022465,True,0,No user reviews,0,0,0
1022466,True,0,No user reviews,0,0,0
1022467,True,0,No user reviews,0,0,0
1022468,True,0,1 user reviews,1,0,1
1022469,True,0,No user reviews,0,0,0
1022470,True,0,No user reviews,0,0,0
1022471,True,0,No user reviews,0,0,0
1022472,True,0,No user reviews,0,0,0
1022473,True,0,No user reviews,0,0,0
1022474,True,0,No user reviews,0,0,0
1022475,True,0,No user reviews,0,0,0
1022476,True,0,No user reviews,0,0,0
1022477,True,0,No user reviews,0,0,0
1022478,True,0,1 user reviews,1,0,1
1022479,True,0,No user reviews,0,0,0
1022480,True,7,Positive,24,5,29
1022490,True,0,No user reviews,0,0,0
1022491,True,0,No user reviews,0,0,0
1022492,True,0,No user reviews,0,0,0
1022493,True,0,No user reviews,0,0,0
1022494,True,0,No user reviews,0,0,0
1022495,True,0,No user reviews,0,0,0
1022496,True,0,No user reviews,0,0,0
1022497,True,0,1 user reviews,1,0,1
1022498,True,0,No user reviews,0,0,0
1022499,True,0,No user reviews,0,0,0
1022500,True,0,No user reviews,0,0,0
1022501,True,0,No user reviews,0,0,0
1022502,True,0,No user reviews,0,0,0
1022503,True,0,No user reviews,0,0,0
1022504,True,0,No user reviews,0,0,0
1022505,True,0,No user reviews,0,0,0
1022506,True,0,No user reviews,0,0,0
1022507,True,0,No user reviews,0,0,0
1022508,True,0,No user reviews,0,0,0
1022509,True,0,No user reviews,0,0,0
1022510,True,0,1 user reviews,1,0,1
1022511,True,0,No user reviews,0,0,0
1022512,True,0,No user reviews,0,0,0
1022513,True,0,No user reviews,0,0,0
1022514,True,0,No user reviews,0,0,0
1022530,True,0,2 user reviews,1,1,2
1022540,True,0,No user reviews,0,0,0
1022550,True,0,3 user reviews,3,0,3
1022570,True,0,5 user reviews,4,1,5
1022590,True,0,No user reviews,0,0,0
1022600,True,0,No user reviews,0,0,0
1022610,True,0,7 user reviews,7,0,7
1022630,True,0,No user reviews,0,0,0
1022640,True,0,1 user reviews,1,0,1
1022650,True,0,4 user reviews,3,1,4
1022700,True,0,5 user reviews,3,2,5
1022710,True,5,Mixed,47,23,70
1022720,True,0,No user reviews,0,0,0
1022770,True,0,6 user reviews,4,2,6
1022780,True,6,Mostly Positive,40,12,52
1022790,True,0,No user reviews,0,0,0
1022820,True,0,No user reviews,0,0,0
1022830,True,5,Mixed,8,9,17
1022840,True,0,No user reviews,0,0,0
1022850,True,8,Very Positive,94,4,98
1022860,True,0,No user reviews,0,0,0
1022870,True,7,Positive,14,0,14
1022910,True,0,5 user reviews,4,1,5
1022920,True,0,No user reviews,0,0,0
1022950,True,0,No user reviews,0,0,0
1022980,True,5,Mixed,135,70,205
1022990,True,7,Positive,11,1,12
1023010,True,0,1 user reviews,1,0,1
1023030,True,0,1 user reviews,1,0,1
1023040,True,0,No user reviews,0,0,0
1023060,True,0,2 user reviews,1,1,2
1023080,True,0,No user reviews,0,0,0
1023090,True,0,No user reviews,0,0,0
1023100,True,0,No user reviews,0,0,0
1023110,True,0,1 user reviews,1,0,1
1023130,True,0,1 user reviews,1,0,1
1023140,True,0,No user reviews,0,0,0
1023150,True,0,2 user reviews,2,0,2
1023160,True,0,1 user reviews,1,0,1
1023170,True,0,No user reviews,0,0,0
1023180,True,0,No user reviews,0,0,0
1023260,True,0,5 user reviews,4,1,5
1023270,True,0,No user reviews,0,0,0
1023280,True,0,No user reviews,0,0,0
1023310,True,0,1 user reviews,1,0,1
1023320,True,0,No user reviews,0,0,0
1023330,True,0,No user reviews,0,0,0
1023340,True,0,No user reviews,0,0,0
1023370,True,0,No user reviews,0,0,0
1023390,True,0,6 user reviews,3,3,6
1023400,True,0,No user reviews,0,0,0
1023410,True,0,2 user reviews,2,0,2
1023420,True,0,No user reviews,0,0,0
1023430,True,0,No user reviews,0,0,0
1023510,True,0,7 user reviews,3,4,7
1023540,True,0,No user reviews,0,0,0
1023550,True,7,Positive,27,0,27
1023560,True,0,2 user reviews,2,0,2
1023570,True,0,No user reviews,0,0,0
1023580,True,0,No user reviews,0,0,0
1023610,True,0,No user reviews,0,0,0
1023620,True,0,No user reviews,0,0,0
1023640,True,0,6 user reviews,4,2,6
1023650,True,0,1 user reviews,1,0,1
1023660,True,0,No user reviews,0,0,0
1023670,True,0,No user reviews,0,0,0
1023680,True,0,5 user reviews,2,3,5
1023690,True,7,Positive,17,1,18
1023700,True,7,Positive,18,3,21
1023710,True,0,4 user reviews,4,0,4
1023720,True,0,3 user reviews,3,0,3
1023740,True,8,Very Positive,79,16,95
1023750,True,0,4 user reviews,3,1,4
1023760,True,0,No user reviews,0,0,0
1023770,True,0,No user reviews,0,0,0
1023780,True,0,2 user reviews,2,0,2
1023790,True,0,No user reviews,0,0,0
1023801,True,0,No user reviews,0,0,0
1023802,True,7,Positive,11,1,12
1023810,True,0,No user reviews,0,0,0
1023820,True,0,No user reviews,0,0,0
1023830,True,0,No user reviews,0,0,0
1023860,True,0,3 user reviews,3,0,3
1023870,True,5,Mixed,12,14,26
1023920,True,0,No user reviews,0,0,0
1023930,True,6,Mostly Positive,9,3,12
1023940,True,0,No user reviews,0,0,0
1023960,True,0,1 user reviews,0,1,1
1023970,True,6,Mostly Positive,23,6,29
1023980,True,5,Mixed,12,18,30
1023990,True,0,No user reviews,0,0,0
1024010,True,8,Very Positive,106,18,124
1024040,True,0,No user reviews,0,0,0
1024050,True,0,No user reviews,0,0,0
1024070,True,0,No user reviews,0,0,0
1024080,True,0,6 user reviews,4,2,6
1024090,True,0,No user reviews,0,0,0
1024100,True,0,4 user reviews,4,0,4
1024110,True,6,Mostly Positive,31,12,43
1024150,True,0,2 user reviews,0,2,2
1024160,True,0,No user reviews,0,0,0
1024210,True,0,5 user reviews,4,1,5
1024220,True,0,2 user reviews,0,2,2
1024240,True,0,No user reviews,0,0,0
1024250,True,0,1 user reviews,0,1,1
1024330,True,0,No user reviews,0,0,0
1024380,True,6,Mostly Positive,558,158,716
1024400,True,0,9 user reviews,7,2,9
1024410,True,0,No user reviews,0,0,0
1024420,True,0,No user reviews,0,0,0
1024430,True,4,Mostly Negative,5,8,13
1024450,True,0,No user reviews,0,0,0
1024460,True,7,Positive,31,4,35
1024470,True,0,No user reviews,0,0,0
1024480,True,5,Mixed,60,45,105
1024490,True,0,2 user reviews,2,0,2
1024520,True,0,No user reviews,0,0,0
1024530,True,0,1 user reviews,1,0,1
1024540,True,0,3 user reviews,2,1,3
1024550,True,0,No user reviews,0,0,0
1024551,True,0,2 user reviews,2,0,2
1024570,True,0,3 user reviews,3,0,3
1024590,True,0,4 user reviews,3,1,4
1024600,True,0,5 user reviews,1,4,5
1024610,True,0,No user reviews,0,0,0
1024620,True,0,No user reviews,0,0,0
1024630,True,6,Mostly Positive,14,5,19
1024640,True,6,Mostly Positive,10,3,13
1024650,True,5,Mixed,100,73,173
1024660,True,7,Positive,34,6,40
1024670,True,6,Mostly Positive,11,3,14
1024690,True,0,1 user reviews,0,1,1
1024700,True,0,3 user reviews,1,2,3
1024701,True,6,Mostly Positive,7,3,10
1024702,True,7,Positive,15,2,17
1024703,True,0,9 user reviews,6,3,9
1024704,True,0,7 user reviews,1,6,7
1024710,True,0,No user reviews,0,0,0
1024720,True,0,No user reviews,0,0,0
1024730,True,0,2 user reviews,2,0,2
1024740,True,0,No user reviews,0,0,0
1024760,True,0,No user reviews,0,0,0
1024770,True,7,Positive,29,6,35
1024780,True,0,1 user reviews,0,1,1
1024790,True,0,No user reviews,0,0,0
1024800,True,0,3 user reviews,3,0,3
1024810,True,0,3 user reviews,3,0,3
1024840,True,0,No user reviews,0,0,0
1024860,True,0,2 user reviews,2,0,2
1024870,True,0,No user reviews,0,0,0
1024890,True,0,No user reviews,0,0,0
1024910,True,0,No user reviews,0,0,0
1024912,True,0,No user reviews,0,0,0
1024913,True,0,No user reviews,0,0,0
1024914,True,0,No user reviews,0,0,0
1024915,True,0,No user reviews,0,0,0
1024920,True,0,No user reviews,0,0,0
1024950,True,0,3 user reviews,2,1,3
1024960,True,0,No user reviews,0,0,0
1024970,True,0,No user reviews,0,0,0
1024980,True,0,No user reviews,0,0,0
1024990,True,0,No user reviews,0,0,0
1025000,True,0,4 user reviews,3,1,4
1025010,True,0,No user reviews,0,0,0
1025020,True,0,1 user reviews,1,0,1
1025040,True,0,No user reviews,0,0,0
1025060,True,0,No user reviews,0,0,0
1025061,True,0,No user reviews,0,0,0
1025070,True,0,3 user reviews,3,0,3
1025080,True,0,No user reviews,0,0,0
1025090,True,0,No user reviews,0,0,0
1025100,True,0,No user reviews,0,0,0
1025130,True,0,9 user reviews,9,0,9
1025140,True,8,Very Positive,82,7,89
1025160,True,0,2 user reviews,2,0,2
1025170,True,0,No user reviews,0,0,0
1025171,True,0,No user reviews,0,0,0
1025172,True,0,No user reviews,0,0,0
1025173,True,0,No user reviews,0,0,0
1025180,True,0,No user reviews,0,0,0
1025200,True,0,No user reviews,0,0,0
1025220,True,0,No user reviews,0,0,0
1025230,True,0,No user reviews,0,0,0
1025240,True,0,2 user reviews,2,0,2
1025250,True,7,Positive,18,3,21
1025260,True,0,No user reviews,0,0,0
1025270,True,0,1 user reviews,0,1,1
1025280,True,0,1 user reviews,1,0,1
1025290,True,0,1 user reviews,1,0,1
1025320,True,0,No user reviews,0,0,0
1025330,True,0,No user reviews,0,0,0
1025340,True,5,Mixed,17,8,25
1025360,True,0,1 user reviews,1,0,1
1025370,True,0,No user reviews,0,0,0
1025380,True,0,No user reviews,0,0,0
1025390,True,0,No user reviews,0,0,0
1025400,True,0,No user reviews,0,0,0
1025410,True,6,Mostly Positive,47,12,59
1025420,True,0,1 user reviews,1,0,1
1025430,True,0,1 user reviews,0,1,1
1025440,True,8,Very Positive,260,48,308
1025450,True,0,1 user reviews,0,1,1
1025460,True,0,7 user reviews,7,0,7
1025480,True,0,4 user reviews,4,0,4
1025490,True,0,No user reviews,0,0,0
1025510,True,0,2 user reviews,1,1,2
1025520,True,0,1 user reviews,1,0,1
1025530,True,0,4 user reviews,2,2,4
1025540,True,0,3 user reviews,2,1,3
1025550,True,0,2 user reviews,1,1,2
1025560,True,0,No user reviews,0,0,0
1025570,True,0,No user reviews,0,0,0
1025590,True,0,9 user reviews,8,1,9
1025600,True,8,Very Positive,595,116,711
1025620,True,0,No user reviews,0,0,0
1025640,True,0,No user reviews,0,0,0
1025650,True,0,1 user reviews,0,1,1
1025660,True,0,No user reviews,0,0,0
1025680,True,0,No user reviews,0,0,0
1025690,True,0,No user reviews,0,0,0
1025700,True,0,No user reviews,0,0,0
1025710,True,0,No user reviews,0,0,0
1025720,True,0,No user reviews,0,0,0
1025730,True,0,No user reviews,0,0,0
1025740,True,4,Mostly Negative,4,7,11
1025780,True,0,No user reviews,0,0,0
1025820,True,0,No user reviews,0,0,0
1025870,True,0,4 user reviews,0,4,4
1025890,True,0,1 user reviews,1,0,1
1025900,True,0,No user reviews,0,0,0
1025910,True,0,No user reviews,0,0,0
1025990,True,0,1 user reviews,1,0,1
1026000,True,0,No user reviews,0,0,0
1026010,True,0,3 user reviews,3,0,3
1026020,True,0,2 user reviews,2,0,2
1026050,True,0,No user reviews,0,0,0
1026060,True,0,1 user reviews,0,1,1
1026070,True,0,6 user reviews,5,1,6
1026080,True,0,4 user reviews,2,2,4
1026090,True,0,1 user reviews,1,0,1
1026110,True,0,No user reviews,0,0,0
1026130,True,7,Positive,27,2,29
1026140,True,0,No user reviews,0,0,0
1026150,True,0,No user reviews,0,0,0
1026160,True,8,Very Positive,47,8,55
1026170,True,0,No user reviews,0,0,0
1026171,True,0,2 user reviews,2,0,2
1026180,True,0,No user reviews,0,0,0
1026200,True,5,Mixed,16,9,25
1026210,True,0,1 user reviews,0,1,1
1026220,True,0,No user reviews,0,0,0
1026240,True,0,No user reviews,0,0,0
1026340,True,0,No user reviews,0,0,0
1026370,True,0,8 user reviews,8,0,8
1026380,True,7,Positive,10,2,12
1026390,True,0,6 user reviews,5,1,6
1026400,True,8,Very Positive,64,1,65
1026420,True,6,Mostly Positive,136,40,176
1026430,True,0,3 user reviews,3,0,3
1026450,True,0,No user reviews,0,0,0
1026460,True,0,No user reviews,0,0,0
1026520,True,0,No user reviews,0,0,0
1026560,True,0,2 user reviews,2,0,2
1026570,True,0,No user reviews,0,0,0
1026610,True,0,7 user reviews,7,0,7
1026630,True,0,No user reviews,0,0,0
1026631,True,0,No user reviews,0,0,0
1026640,True,0,No user reviews,0,0,0
1026650,True,0,No user reviews,0,0,0
1026651,True,0,No user reviews,0,0,0
1026660,True,0,No user reviews,0,0,0
1026670,True,0,3 user reviews,3,0,3
1026680,True,5,Mixed,580,343,923
1026700,True,0,No user reviews,0,0,0
1026720,True,0,No user reviews,0,0,0
1026740,True,0,3 user reviews,2,1,3
1026750,True,0,1 user reviews,1,0,1
1026760,True,0,No user reviews,0,0,0
1026770,True,0,4 user reviews,1,3,4
1026800,True,0,1 user reviews,1,0,1
1026810,True,0,No user reviews,0,0,0
1026820,True,0,4 user reviews,4,0,4
1026840,True,0,No user reviews,0,0,0
1026880,True,0,4 user reviews,4,0,4
1026910,True,0,1 user reviews,1,0,1
1026930,True,0,No user reviews,0,0,0
1026940,True,0,3 user reviews,3,0,3
1026960,True,0,8 user reviews,4,4,8
1026970,True,5,Mixed,11,5,16
1026990,True,0,No user reviews,0,0,0
1027040,True,0,No user reviews,0,0,0
1027060,True,0,No user reviews,0,0,0
1027120,True,0,No user reviews,0,0,0
1027130,True,5,Mixed,8,4,12
1027140,True,0,5 user reviews,3,2,5
1027150,True,0,No user reviews,0,0,0
1027190,True,7,Positive,14,1,15
1027230,True,0,4 user reviews,4,0,4
1027250,True,7,Positive,28,5,33
1027280,True,0,No user reviews,0,0,0
1027290,True,0,No user reviews,0,0,0
1027480,True,0,No user reviews,0,0,0
1027520,True,0,4 user reviews,2,2,4
1027530,True,0,1 user reviews,0,1,1
1027550,True,0,No user reviews,0,0,0
1027570,True,0,No user reviews,0,0,0
1027580,True,0,No user reviews,0,0,0
1027590,True,0,No user reviews,0,0,0
1027600,True,5,Mixed,7,4,11
1027610,True,0,1 user reviews,1,0,1
1027620,True,7,Positive,42,1,43
1027630,True,0,No user reviews,0,0,0
1027640,True,0,No user reviews,0,0,0
1027650,True,0,No user reviews,0,0,0
1027660,True,0,No user reviews,0,0,0
1027670,True,0,No user reviews,0,0,0
1027690,True,0,1 user reviews,0,1,1
1027700,True,0,No user reviews,0,0,0
1027710,True,0,No user reviews,0,0,0
1027720,True,0,4 user reviews,4,0,4
1027740,True,0,No user reviews,0,0,0
1027760,True,0,No user reviews,0,0,0
1027780,True,0,No user reviews,0,0,0
1027790,True,0,1 user reviews,1,0,1
1027800,True,0,3 user reviews,2,1,3
1027810,True,0,No user reviews,0,0,0
1027830,True,0,1 user reviews,1,0,1
1027880,True,0,4 user reviews,4,0,4
1027900,True,0,5 user reviews,5,0,5
1027910,True,0,No user reviews,0,0,0
1027920,True,0,No user reviews,0,0,0
1027930,True,0,1 user reviews,1,0,1
1027940,True,0,No user reviews,0,0,0
1027950,True,0,No user reviews,0,0,0
1027960,True,0,2 user reviews,1,1,2
1027970,True,6,Mostly Positive,9,3,12
1027990,True,0,2 user reviews,2,0,2
1028010,True,0,1 user reviews,1,0,1
1028030,True,0,1 user reviews,1,0,1
1028070,True,0,No user reviews,0,0,0
1028110,True,0,2 user reviews,0,2,2
1028120,True,0,2 user reviews,2,0,2
1028130,True,5,Mixed,12,7,19
1028160,True,0,2 user reviews,0,2,2
1028170,True,0,No user reviews,0,0,0
1028190,True,0,No user reviews,0,0,0
1028210,True,8,Very Positive,55,5,60
1028240,True,0,1 user reviews,0,1,1
1028250,True,0,2 user reviews,2,0,2
1028260,True,0,No user reviews,0,0,0
1028270,True,8,Very Positive,50,6,56
1028280,True,0,No user reviews,0,0,0
1028290,True,0,2 user reviews,2,0,2
1028300,True,7,Positive,11,0,11
1028310,True,0,No user reviews,0,0,0
1028320,True,0,No user reviews,0,0,0
1028330,True,0,No user reviews,0,0,0
1028340,True,0,6 user reviews,5,1,6
1028350,True,0,No user reviews,0,0,0
1028360,True,0,1 user reviews,0,1,1
1028380,True,0,No user reviews,0,0,0
1028400,True,0,No user reviews,0,0,0
1028410,True,0,1 user reviews,0,1,1
1028420,True,7,Positive,19,0,19
1028430,True,5,Mixed,81,75,156
1028440,True,5,Mixed,21,10,31
1028450,True,0,No user reviews,0,0,0
1028460,True,0,2 user reviews,2,0,2
