441280,True,8,Very Positive,135,11,146
441290,True,0,No user reviews,0,0,0
441300,True,0,1 user reviews,1,0,1
441301,True,0,No user reviews,0,0,0
441340,True,6,Mostly Positive,584,228,812
441350,True,6,Mostly Positive,39,14,53
441370,True,0,No user reviews,0,0,0
441380,True,5,Mixed,127,70,197
441420,True,0,No user reviews,0,0,0
441430,True,0,No user reviews,0,0,0
441440,True,5,Mixed,43,20,63
441450,True,5,Mixed,10,7,17
441451,True,0,No user reviews,0,0,0
441452,True,0,No user reviews,0,0,0
441453,True,0,No user reviews,0,0,0
441454,True,0,No user reviews,0,0,0
441455,True,0,No user reviews,0,0,0
441456,True,0,No user reviews,0,0,0
441457,True,0,No user reviews,0,0,0
441470,True,0,No user reviews,0,0,0
441480,True,0,4 user reviews,3,1,4
441490,True,0,No user reviews,0,0,0
441510,True,0,6 user reviews,5,1,6
441520,True,0,No user reviews,0,0,0
441540,True,8,Very Positive,72,0,72
441550,True,8,Very Positive,360,56,416
441560,True,0,No user reviews,0,0,0
441600,True,8,Very Positive,336,56,392
441610,True,0,1 user reviews,1,0,1
441630,True,0,No user reviews,0,0,0
441640,True,0,9 user reviews,1,8,9
441670,True,6,Mostly Positive,63,20,83
441680,True,5,Mixed,15,10,25
441690,True,0,No user reviews,0,0,0
441700,True,8,Very Positive,48,9,57
441710,True,0,4 user reviews,4,0,4
441720,True,5,Mixed,9,12,21
441730,True,5,Mixed,13,16,29
441750,True,0,No user reviews,0,0,0
441760,True,0,No user reviews,0,0,0
441770,True,7,Positive,41,2,43
441780,True,0,No user reviews,0,0,0
441781,True,0,No user reviews,0,0,0
441782,True,0,3 user reviews,3,0,3
441790,True,4,Mostly Negative,171,352,523
441810,True,0,No user reviews,0,0,0
441830,True,6,Mostly Positive,622,259,881
441850,True,0,1 user reviews,0,1,1
441870,True,6,Mostly Positive,871,355,1226
441910,True,0,No user reviews,0,0,0
441920,True,5,Mixed,188,180,368
441930,True,0,No user reviews,0,0,0
441940,True,0,7 user reviews,7,0,7
441950,True,0,1 user reviews,1,0,1
441960,True,0,1 user reviews,1,0,1
441990,True,0,No user reviews,0,0,0
442000,True,3,Negative,1,16,17
442010,True,5,Mixed,324,169,493
442020,True,0,No user reviews,0,0,0
442050,True,5,Mixed,21,20,41
442051,True,6,Mostly Positive,74,27,101
442052,True,6,Mostly Positive,50,14,64
442070,True,8,Very Positive,410,40,450
442080,True,6,Mostly Positive,315,121,436
442090,True,0,1 user reviews,1,0,1
442100,True,0,No user reviews,0,0,0
442101,True,0,No user reviews,0,0,0
442120,True,8,Very Positive,313,21,334
442140,True,0,8 user reviews,5,3,8
442180,True,0,3 user reviews,0,3,3
442190,True,0,5 user reviews,2,3,5
442210,True,8,Very Positive,70,6,76
442220,True,0,7 user reviews,5,2,7
442230,True,0,No user reviews,0,0,0
442240,True,0,No user reviews,0,0,0
442260,True,0,8 user reviews,7,1,8
442280,True,0,No user reviews,0,0,0
442290,True,5,Mixed,23,12,35
442310,True,0,No user reviews,0,0,0
442311,True,0,No user reviews,0,0,0
442312,True,0,No user reviews,0,0,0
442313,True,0,No user reviews,0,0,0
442314,True,0,No user reviews,0,0,0
442315,True,0,No user reviews,0,0,0
442316,True,0,No user reviews,0,0,0
442317,True,0,No user reviews,0,0,0
442318,True,0,No user reviews,0,0,0
442319,True,0,No user reviews,0,0,0
442320,True,0,No user reviews,0,0,0
442321,True,0,No user reviews,0,0,0
442322,True,0,No user reviews,0,0,0
442323,True,0,No user reviews,0,0,0
442324,True,0,No user reviews,0,0,0
442325,True,0,No user reviews,0,0,0
442326,True,0,No user reviews,0,0,0
442327,True,0,No user reviews,0,0,0
442328,True,0,No user reviews,0,0,0
442329,True,0,No user reviews,0,0,0
442330,True,0,No user reviews,0,0,0
442331,True,0,No user reviews,0,0,0
442332,True,0,No user reviews,0,0,0
442333,True,0,No user reviews,0,0,0
442334,True,0,No user reviews,0,0,0
442335,True,0,No user reviews,0,0,0
442336,True,0,No user reviews,0,0,0
442337,True,0,No user reviews,0,0,0
442338,True,0,No user reviews,0,0,0
442339,True,0,No user reviews,0,0,0
442360,True,0,No user reviews,0,0,0
442500,True,6,Mostly Positive,295,94,389
442510,True,0,No user reviews,0,0,0
442660,True,5,Mixed,31,19,50
442690,True,0,No user reviews,0,0,0
442700,True,0,No user reviews,0,0,0
442710,True,0,4 user reviews,4,0,4
442720,True,0,No user reviews,0,0,0
442760,True,0,2 user reviews,0,2,2
442770,True,0,9 user reviews,4,5,9
442780,True,6,Mostly Positive,857,282,1139
442790,True,0,No user reviews,0,0,0
442810,True,0,3 user reviews,0,3,3
442830,True,0,2 user reviews,2,0,2
442840,True,0,1 user reviews,1,0,1
442860,True,0,No user reviews,0,0,0
442890,True,5,Mixed,27,18,45
442900,True,0,No user reviews,0,0,0
442990,True,0,No user reviews,0,0,0
443000,True,8,Very Positive,51,12,63
443020,True,6,Mostly Positive,49,15,64
443030,True,0,No user reviews,0,0,0
443050,True,0,No user reviews,0,0,0
443070,True,0,4 user reviews,0,4,4
443080,True,5,Mixed,9,10,19
443100,True,0,No user reviews,0,0,0
443110,True,0,1 user reviews,1,0,1
443180,True,0,No user reviews,0,0,0
443190,True,0,No user reviews,0,0,0
443200,True,0,No user reviews,0,0,0
443201,True,0,No user reviews,0,0,0
443202,True,0,No user reviews,0,0,0
443204,True,0,No user reviews,0,0,0
443205,True,0,No user reviews,0,0,0
443206,True,0,No user reviews,0,0,0
443230,True,0,No user reviews,0,0,0
443240,True,0,No user reviews,0,0,0
443250,True,5,Mixed,7,4,11
443260,True,5,Mixed,21,13,34
443270,True,0,No user reviews,0,0,0
443300,True,0,1 user reviews,1,0,1
443320,True,0,No user reviews,0,0,0
443330,True,6,Mostly Positive,47,19,66
443360,True,5,Mixed,6,7,13
443370,True,5,Mixed,14,11,25
443380,True,8,Very Positive,44,6,50
443390,True,0,3 user reviews,3,0,3
443400,True,0,3 user reviews,3,0,3
443420,True,6,Mostly Positive,35,11,46
443430,True,7,Positive,10,1,11
443440,True,0,No user reviews,0,0,0
443450,True,5,Mixed,20,9,29
443460,True,7,Positive,14,2,16
443470,True,0,No user reviews,0,0,0
443510,True,0,No user reviews,0,0,0
443530,True,0,No user reviews,0,0,0
443550,True,0,No user reviews,0,0,0
443570,True,0,9 user reviews,6,3,9
443580,True,6,Mostly Positive,14,6,20
443590,True,0,No user reviews,0,0,0
443620,True,6,Mostly Positive,15,4,19
443630,True,7,Positive,16,3,19
443640,True,0,No user reviews,0,0,0
443650,True,6,Mostly Positive,42,16,58
443660,True,0,No user reviews,0,0,0
443670,True,0,No user reviews,0,0,0
443680,True,0,9 user reviews,6,3,9
443690,True,0,4 user reviews,4,0,4
443691,True,7,Positive,34,7,41
443700,True,6,Mostly Positive,9,3,12
443710,True,0,1 user reviews,0,1,1
443720,True,7,Positive,9,2,11
443730,True,8,Very Positive,77,13,90
443740,True,0,No user reviews,0,0,0
443750,True,0,No user reviews,0,0,0
443760,True,0,2 user reviews,2,0,2
443770,True,0,No user reviews,0,0,0
443780,True,0,1 user reviews,0,1,1
443790,True,0,No user reviews,0,0,0
443800,True,5,Mixed,29,16,45
443810,True,6,Mostly Positive,1626,592,2218
443830,True,5,Mixed,10,7,17
443840,True,0,No user reviews,0,0,0
443850,True,5,Mixed,6,6,12
443860,True,8,Very Positive,85,12,97
443880,True,7,Positive,36,4,40
443890,True,7,Positive,28,4,32
443900,True,4,Mostly Negative,6,11,17
443910,True,0,1 user reviews,1,0,1
443970,True,5,Mixed,71,34,105
443980,True,5,Mixed,19,9,28
444000,True,8,Very Positive,79,8,87
444020,True,0,6 user reviews,3,3,6
444030,True,0,1 user reviews,0,1,1
444031,True,0,No user reviews,0,0,0
444032,True,0,No user reviews,0,0,0
444040,True,0,No user reviews,0,0,0
444090,True,6,Mostly Positive,2752,809,3561
444130,True,6,Mostly Positive,38,15,53
444140,True,8,Very Positive,214,23,237
444160,True,5,Mixed,20,24,44
444170,True,7,Positive,38,2,40
444180,True,5,Mixed,32,15,47
444190,True,7,Positive,10,2,12
444200,True,6,Mostly Positive,122,51,173
444210,True,0,4 user reviews,0,4,4
444220,True,5,Mixed,50,42,92
444250,True,0,8 user reviews,6,2,8
444260,True,5,Mixed,63,49,112
444270,True,6,Mostly Positive,13,4,17
444280,True,7,Positive,30,5,35
444320,True,5,Mixed,12,16,28
444330,True,0,1 user reviews,1,0,1
444350,True,4,Mostly Negative,23,82,105
444360,True,0,1 user reviews,1,0,1
444390,True,0,2 user reviews,2,0,2
444410,True,5,Mixed,7,5,12
444420,True,3,Negative,2,12,14
444430,True,0,7 user reviews,5,2,7
444440,True,5,Mixed,6,9,15
444450,True,0,No user reviews,0,0,0
444460,True,3,Negative,3,23,26
444470,True,0,4 user reviews,3,1,4
444480,True,5,Mixed,50,31,81
444490,True,6,Mostly Positive,119,46,165
444510,True,0,No user reviews,0,0,0
444520,True,5,Mixed,7,6,13
444530,True,7,Positive,31,3,34
444540,True,0,No user reviews,0,0,0
444550,True,7,Positive,8,2,10
444560,True,0,2 user reviews,1,1,2
444580,True,4,Mostly Negative,26,47,73
444590,True,8,Very Positive,194,41,235
444600,True,0,No user reviews,0,0,0
444610,True,0,1 user reviews,1,0,1
444611,True,0,1 user reviews,1,0,1
444620,True,0,1 user reviews,1,0,1
444640,True,8,Very Positive,218,36,254
444650,True,5,Mixed,16,20,36
444660,True,0,No user reviews,0,0,0
444670,True,8,Very Positive,58,8,66
444680,True,7,Positive,12,2,14
444690,True,5,Mixed,40,31,71
444700,True,0,No user reviews,0,0,0
444710,True,7,Positive,17,0,17
444720,True,5,Mixed,85,60,145
444740,True,0,3 user reviews,1,2,3
444750,True,0,No user reviews,0,0,0
444760,True,0,1 user reviews,1,0,1
444770,True,8,Very Positive,43,7,50
444780,True,0,No user reviews,0,0,0
444800,True,8,Very Positive,119,13,132
444820,True,0,2 user reviews,2,0,2
444830,True,0,8 user reviews,6,2,8
444870,True,0,3 user reviews,2,1,3
444880,True,6,Mostly Positive,85,30,115
444890,True,0,2 user reviews,1,1,2
444910,True,0,No user reviews,0,0,0
444930,True,8,Very Positive,55,7,62
444940,True,8,Very Positive,109,17,126
444950,True,0,2 user reviews,1,1,2
444970,True,6,Mostly Positive,68,23,91
444980,True,0,No user reviews,0,0,0
444990,True,0,2 user reviews,0,2,2
445000,True,0,5 user reviews,4,1,5
445020,True,5,Mixed,111,58,169
445040,True,7,Positive,41,3,44
445050,True,0,2 user reviews,1,1,2
445070,True,6,Mostly Positive,12,5,17
445080,True,0,No user reviews,0,0,0
445110,True,8,Very Positive,164,18,182
445130,True,5,Mixed,8,4,12
445140,True,5,Mixed,22,11,33
445150,True,0,No user reviews,0,0,0
445170,True,7,Positive,10,0,10
445180,True,0,No user reviews,0,0,0
445190,True,8,Very Positive,1077,219,1296
445200,True,0,No user reviews,0,0,0
445210,True,5,Mixed,9,4,13
445220,True,8,Very Positive,3780,385,4165
445230,True,0,8 user reviews,5,3,8
445260,True,7,Positive,13,0,13
445261,True,0,5 user reviews,4,1,5
445262,True,0,No user reviews,0,0,0
445280,True,0,No user reviews,0,0,0
445310,True,5,Mixed,151,110,261
445320,True,0,1 user reviews,1,0,1
445321,True,0,2 user reviews,1,1,2
445330,True,0,No user reviews,0,0,0
445340,True,0,3 user reviews,3,0,3
445341,True,0,1 user reviews,1,0,1
445350,True,0,8 user reviews,2,6,8
445380,True,0,2 user reviews,1,1,2
445390,True,0,No user reviews,0,0,0
445420,True,7,Positive,38,7,45
445430,True,7,Positive,11,2,13
445440,True,0,No user reviews,0,0,0
445450,True,0,No user reviews,0,0,0
445490,True,0,No user reviews,0,0,0
445550,True,0,2 user reviews,2,0,2
445600,True,5,Mixed,26,15,41
445670,True,5,Mixed,5,7,12
445680,True,0,9 user reviews,9,0,9
445690,True,6,Mostly Positive,76,24,100
445700,True,0,No user reviews,0,0,0
445710,True,0,No user reviews,0,0,0
445720,True,4,Mostly Negative,6,17,23
445750,True,8,Very Positive,51,9,60
445770,True,8,Very Positive,150,25,175
445780,True,0,No user reviews,0,0,0
445790,True,0,No user reviews,0,0,0
445800,True,8,Very Positive,83,15,98
445840,True,0,1 user reviews,1,0,1
445850,True,0,No user reviews,0,0,0
445860,True,6,Mostly Positive,20,7,27
445870,True,0,9 user reviews,7,2,9
445890,True,0,8 user reviews,8,0,8
445900,True,0,No user reviews,0,0,0
445920,True,0,2 user reviews,2,0,2
445930,True,0,No user reviews,0,0,0
445931,True,0,No user reviews,0,0,0
445950,True,7,Positive,9,1,10
445980,True,8,Very Positive,3291,272,3563
445990,True,5,Mixed,21,11,32
446000,True,6,Mostly Positive,107,33,140
446010,True,0,5 user reviews,2,3,5
446020,True,6,Mostly Positive,2191,631,2822
446040,True,7,Positive,40,9,49
446050,True,0,4 user reviews,1,3,4
446060,True,7,Positive,23,1,24
446070,True,7,Positive,9,1,10
446080,True,0,No user reviews,0,0,0
446090,True,0,5 user reviews,5,0,5
446100,True,7,Positive,29,7,36
446110,True,0,1 user reviews,1,0,1
446120,True,6,Mostly Positive,170,45,215
446132,True,0,No user reviews,0,0,0
446135,True,0,No user reviews,0,0,0
446142,True,0,No user reviews,0,0,0
446150,True,0,No user reviews,0,0,0
446240,True,5,Mixed,10,7,17
446250,True,7,Positive,8,2,10
446270,True,0,1 user reviews,1,0,1
446310,True,8,Very Positive,83,5,88
446320,True,0,No user reviews,0,0,0
446330,True,8,Very Positive,67,4,71
446340,True,0,No user reviews,0,0,0
446350,True,0,No user reviews,0,0,0
446360,True,0,1 user reviews,1,0,1
446361,True,0,No user reviews,0,0,0
446362,True,0,No user reviews,0,0,0
446363,True,0,No user reviews,0,0,0
446364,True,0,No user reviews,0,0,0
446365,True,0,No user reviews,0,0,0
446366,True,0,No user reviews,0,0,0
446367,True,0,No user reviews,0,0,0
446368,True,0,No user reviews,0,0,0
446369,True,0,No user reviews,0,0,0
446380,True,8,Very Positive,126,22,148
446390,True,6,Mostly Positive,186,75,261
446430,True,0,1 user reviews,0,1,1
446440,True,0,1 user reviews,0,1,1
446450,True,0,5 user reviews,1,4,5
446460,True,0,5 user reviews,4,1,5
446470,True,0,6 user reviews,3,3,6
446480,True,0,6 user reviews,1,5,6
446490,True,4,Mostly Negative,3,7,10
446510,True,0,2 user reviews,2,0,2
446520,True,5,Mixed,6,4,10
446530,True,0,No user reviews,0,0,0
446540,True,5,Mixed,31,24,55
446550,True,5,Mixed,30,16,46
446560,True,6,Mostly Positive,193,74,267
446570,True,0,4 user reviews,0,4,4
446590,True,5,Mixed,22,17,39
446600,True,8,Very Positive,55,11,66
446610,True,5,Mixed,15,11,26
446620,True,8,Very Positive,172,15,187
446640,True,8,Very Positive,123,7,130
446650,True,0,No user reviews,0,0,0
446690,True,0,No user reviews,0,0,0
446710,True,0,No user reviews,0,0,0
446720,True,0,No user reviews,0,0,0
446740,True,0,6 user reviews,5,1,6
446750,True,7,Positive,17,0,17
446760,True,7,Positive,14,2,16
446770,True,0,3 user reviews,3,0,3
446780,True,4,Mostly Negative,27,54,81
446790,True,5,Mixed,283,153,436
446800,True,6,Mostly Positive,2900,729,3629
446810,True,8,Very Positive,102,23,125
446830,True,7,Positive,39,4,43
446840,True,8,Very Positive,65,1,66
446850,True,7,Positive,15,1,16
446860,True,0,No user reviews,0,0,0
446870,True,4,Mostly Negative,3,9,12
446880,True,0,No user reviews,0,0,0
446882,True,0,No user reviews,0,0,0
446890,True,0,1 user reviews,1,0,1
446900,True,0,2 user reviews,0,2,2
446910,True,7,Positive,44,1,45
446950,True,0,No user reviews,0,0,0
446960,True,0,1 user reviews,1,0,1
446980,True,7,Positive,28,5,33
446990,True,7,Positive,41,8,49
447000,True,7,Positive,15,1,16
447010,True,0,No user reviews,0,0,0
447020,True,8,Very Positive,5193,441,5634
447040,True,8,Very Positive,10257,2446,12703
447080,True,0,No user reviews,0,0,0
447100,True,4,Mostly Negative,5,13,18
447120,True,8,Very Positive,280,65,345
447150,True,8,Very Positive,791,45,836
447170,True,5,Mixed,62,33,95
447180,True,5,Mixed,39,23,62
447190,True,8,Very Positive,76,15,91
447200,True,8,Very Positive,72,9,81
447210,True,7,Positive,33,3,36
447220,True,0,9 user reviews,9,0,9
447240,True,7,Positive,13,1,14
447250,True,0,1 user reviews,1,0,1
447260,True,0,No user reviews,0,0,0
447261,True,0,No user reviews,0,0,0
447270,True,0,2 user reviews,2,0,2
447290,True,8,Very Positive,403,90,493
447300,True,0,No user reviews,0,0,0
447310,True,6,Mostly Positive,33,12,45
447330,True,0,No user reviews,0,0,0
447340,True,0,No user reviews,0,0,0
447400,True,0,6 user reviews,6,0,6
447410,True,7,Positive,12,0,12
447440,True,0,No user reviews,0,0,0
447480,True,0,1 user reviews,1,0,1
447500,True,4,Mostly Negative,132,303,435
447510,True,8,Very Positive,82,3,85
447530,True,9,Overwhelmingly Positive,6987,201,7188
447540,True,0,2 user reviews,0,2,2
447570,True,0,6 user reviews,6,0,6
447680,True,0,No user reviews,0,0,0
447681,True,0,No user reviews,0,0,0
447682,True,0,No user reviews,0,0,0
447683,True,0,No user reviews,0,0,0
447684,True,0,No user reviews,0,0,0
447685,True,0,No user reviews,0,0,0
447686,True,0,No user reviews,0,0,0
447687,True,0,No user reviews,0,0,0
447690,True,6,Mostly Positive,22,7,29
447700,True,7,Positive,34,6,40
447740,True,0,No user reviews,0,0,0
447760,True,0,No user reviews,0,0,0
447780,True,8,Very Positive,102,19,121
447800,True,6,Mostly Positive,45,13,58
447820,True,8,Very Positive,7670,1203,8873
447840,True,0,No user reviews,0,0,0
447850,True,4,Mostly Negative,3,8,11
447860,True,5,Mixed,9,7,16
447870,True,0,No user reviews,0,0,0
447890,True,6,Mostly Positive,123,45,168
447920,True,0,7 user reviews,1,6,7
447930,True,0,2 user reviews,2,0,2
447940,True,0,5 user reviews,1,4,5
447950,True,7,Positive,20,2,22
447960,True,5,Mixed,15,10,25
447980,True,0,8 user reviews,8,0,8
447990,True,0,1 user reviews,1,0,1
448000,True,5,Mixed,27,32,59
448010,True,7,Positive,11,0,11
448020,True,4,Mostly Negative,17,28,45
448050,True,7,Positive,12,2,14
448060,True,4,Mostly Negative,5,13,18
448070,True,5,Mixed,31,44,75
448080,True,8,Very Positive,125,7,132
448090,True,0,8 user reviews,4,4,8
448100,True,0,No user reviews,0,0,0
448110,True,0,6 user reviews,4,2,6
448140,True,0,3 user reviews,0,3,3
448150,True,5,Mixed,17,8,25
448160,True,7,Positive,35,4,39
448170,True,7,Positive,32,8,40
448180,True,0,5 user reviews,5,0,5
448182,True,0,8 user reviews,8,0,8
448183,True,0,2 user reviews,2,0,2
448184,True,4,Mostly Negative,20,31,51
448185,True,0,5 user reviews,4,1,5
448186,True,7,Positive,12,3,15
448187,True,0,No user reviews,0,0,0
448188,True,7,Positive,13,3,16
448189,True,0,No user reviews,0,0,0
448190,True,5,Mixed,23,16,39
448191,True,7,Positive,11,0,11
448192,True,5,Mixed,10,9,19
448194,True,0,6 user reviews,6,0,6
448195,True,0,6 user reviews,6,0,6
448198,True,6,Mostly Positive,10,3,13
448199,True,0,3 user reviews,3,0,3
448200,True,0,No user reviews,0,0,0
448201,True,0,No user reviews,0,0,0
448202,True,0,1 user reviews,1,0,1
448203,True,0,2 user reviews,1,1,2
448204,True,0,1 user reviews,1,0,1
448205,True,0,No user reviews,0,0,0
448206,True,0,No user reviews,0,0,0
448207,True,0,No user reviews,0,0,0
448208,True,0,No user reviews,0,0,0
448209,True,0,No user reviews,0,0,0
448212,True,0,No user reviews,0,0,0
448230,True,0,9 user reviews,4,5,9
448240,True,5,Mixed,153,122,275
448270,True,0,No user reviews,0,0,0
448280,True,8,Very Positive,1270,149,1419
448290,True,8,Very Positive,211,40,251
448300,True,0,1 user reviews,0,1,1
448310,True,0,3 user reviews,1,2,3
448320,True,6,Mostly Positive,113,30,143
448370,True,8,Very Positive,625,39,664
448380,True,7,Positive,11,1,12
448390,True,0,No user reviews,0,0,0
448400,True,8,Very Positive,56,11,67
448440,True,5,Mixed,36,35,71
448450,True,0,1 user reviews,1,0,1
448460,True,0,No user reviews,0,0,0
448470,True,5,Mixed,17,14,31
448480,True,5,Mixed,5,5,10
448500,True,7,Positive,15,1,16
448510,True,8,Very Positive,3198,239,3437
448520,True,0,8 user reviews,8,0,8
448530,True,0,8 user reviews,7,1,8
448540,True,5,Mixed,15,14,29
448550,True,0,4 user reviews,3,1,4
448560,True,5,Mixed,22,24,46
448570,True,0,No user reviews,0,0,0
448580,True,8,Very Positive,109,16,125
448610,True,5,Mixed,30,19,49
448620,True,4,Mostly Negative,7,16,23
448630,True,4,Mostly Negative,9,19,28
448640,True,7,Positive,16,4,20
448650,True,6,Mostly Positive,15,4,19
448670,True,5,Mixed,18,16,34
448690,True,0,9 user reviews,4,5,9
448710,True,0,2 user reviews,2,0,2
448720,True,6,Mostly Positive,7,3,10
448730,True,5,Mixed,6,4,10
448750,True,0,9 user reviews,5,4,9
448760,True,0,1 user reviews,1,0,1
448780,True,6,Mostly Positive,211,72,283
448790,True,0,7 user reviews,3,4,7
448800,True,7,Positive,24,4,28
448810,True,0,7 user reviews,6,1,7
448820,True,0,8 user reviews,5,3,8
448830,True,5,Mixed,16,9,25
448850,True,8,Very Positive,834,52,886
448860,True,0,No user reviews,0,0,0
448880,True,0,3 user reviews,1,2,3
448910,True,8,Very Positive,58,11,69
448930,True,0,No user reviews,0,0,0
448960,True,7,Positive,11,1,12
448980,True,0,No user reviews,0,0,0
448990,True,0,2 user reviews,1,1,2
449000,True,0,No user reviews,0,0,0
449010,True,0,No user reviews,0,0,0
449011,True,0,No user reviews,0,0,0
449020,True,0,4 user reviews,3,1,4
449040,True,6,Mostly Positive,19,5,24
449050,True,0,2 user reviews,1,1,2
449060,True,8,Very Positive,60,11,71
449070,True,0,7 user reviews,2,5,7
449080,True,0,No user reviews,0,0,0
449090,True,6,Mostly Positive,26,11,37
449100,True,0,8 user reviews,6,2,8
449120,True,0,9 user reviews,5,4,9
449130,True,0,No user reviews,0,0,0
449140,True,7,Positive,29,3,32
449150,True,0,5 user reviews,4,1,5
449160,True,0,5 user reviews,5,0,5
449170,True,7,Positive,29,1,30
449180,True,0,3 user reviews,3,0,3
449190,True,0,No user reviews,0,0,0
449200,True,5,Mixed,10,15,25
449210,True,8,Very Positive,182,23,205
449220,True,7,Positive,22,3,25
449230,True,3,Negative,0,14,14
449240,True,0,5 user reviews,5,0,5
449250,True,8,Very Positive,144,9,153
449300,True,5,Mixed,102,83,185
449310,True,0,3 user reviews,2,1,3
449320,True,0,9 user reviews,6,3,9
449330,True,0,5 user reviews,3,2,5
449340,True,7,Positive,13,0,13
449350,True,5,Mixed,7,7,14
449360,True,7,Positive,17,0,17
449370,True,0,1 user reviews,1,0,1
449380,True,7,Positive,10,1,11
449390,True,0,5 user reviews,3,2,5
449391,True,0,4 user reviews,3,1,4
449392,True,0,2 user reviews,2,0,2
449393,True,5,Mixed,9,8,17
449394,True,0,2 user reviews,2,0,2
449400,True,0,2 user reviews,2,0,2
449420,True,0,No user reviews,0,0,0
449450,True,6,Mostly Positive,7,3,10
449460,True,5,Mixed,35,21,56
449470,True,0,2 user reviews,2,0,2
449480,True,0,No user reviews,0,0,0
449500,True,0,3 user reviews,0,3,3
449510,True,5,Mixed,26,15,41
449520,True,0,4 user reviews,2,2,4
449530,True,5,Mixed,73,37,110
449540,True,8,Very Positive,1414,175,1589
449550,True,8,Very Positive,80,3,83
449560,True,0,1 user reviews,1,0,1
449570,True,0,1 user reviews,1,0,1
449600,True,0,No user reviews,0,0,0
449601,True,0,No user reviews,0,0,0
449602,True,0,No user reviews,0,0,0
449603,True,0,No user reviews,0,0,0
449604,True,0,No user reviews,0,0,0
449605,True,0,No user reviews,0,0,0
449610,True,8,Very Positive,364,40,404
449610,True,8,Very Positive,364,40,404
449640,True,6,Mostly Positive,19,5,24
449670,True,5,Mixed,9,4,13
449671,True,0,6 user reviews,4,2,6
449680,True,8,Very Positive,140,33,173
449690,True,5,Mixed,13,9,22
449700,True,0,6 user reviews,6,0,6
449710,True,6,Mostly Positive,165,60,225
449720,True,7,Positive,8,2,10
449730,True,8,Very Positive,91,12,103
449740,True,0,No user reviews,0,0,0
449760,True,6,Mostly Positive,21,9,30
449770,True,0,2 user reviews,2,0,2
449780,True,0,No user reviews,0,0,0
449800,True,8,Very Positive,1409,321,1730
449820,True,5,Mixed,23,25,48
449900,True,0,No user reviews,0,0,0
449910,True,0,No user reviews,0,0,0
449920,True,0,No user reviews,0,0,0
449930,True,0,1 user reviews,1,0,1
449940,True,5,Mixed,7,5,12
449950,True,0,3 user reviews,3,0,3
449960,True,8,Very Positive,3401,349,3750
449970,True,0,No user reviews,0,0,0
449980,True,8,Very Positive,220,27,247
449981,True,5,Mixed,13,9,22
449990,True,0,No user reviews,0,0,0
450010,True,6,Mostly Positive,7,3,10
450020,True,0,1 user reviews,0,1,1
450030,True,0,6 user reviews,1,5,6
450040,True,4,Mostly Negative,2,8,10
450050,True,5,Mixed,12,16,28
450060,True,5,Mixed,11,12,23
450070,True,0,No user reviews,0,0,0
450080,True,0,8 user reviews,5,3,8
450090,True,0,No user reviews,0,0,0
450091,True,0,No user reviews,0,0,0
450092,True,0,No user reviews,0,0,0
450093,True,0,No user reviews,0,0,0
450094,True,0,No user reviews,0,0,0
450095,True,0,No user reviews,0,0,0
450096,True,0,No user reviews,0,0,0
450097,True,0,No user reviews,0,0,0
450098,True,0,No user reviews,0,0,0
450099,True,0,No user reviews,0,0,0
450100,True,0,2 user reviews,2,0,2
450110,True,7,Positive,10,2,12
450120,True,7,Positive,34,7,41
450130,True,0,6 user reviews,2,4,6
450140,True,8,Very Positive,51,1,52
450150,True,0,1 user reviews,1,0,1
450170,True,6,Mostly Positive,51,17,68
450190,True,5,Mixed,30,13,43
450200,True,0,No user reviews,0,0,0
450210,True,0,No user reviews,0,0,0
450220,True,7,Positive,19,1,20
450230,True,0,1 user reviews,1,0,1
450240,True,0,No user reviews,0,0,0
450250,True,6,Mostly Positive,15,4,19
450260,True,0,3 user reviews,0,3,3
450270,True,0,No user reviews,0,0,0
450280,True,0,No user reviews,0,0,0
450290,True,5,Mixed,6,8,14
450300,True,0,No user reviews,0,0,0
450310,True,0,1 user reviews,1,0,1
450320,True,0,No user reviews,0,0,0
450330,True,0,No user reviews,0,0,0
450340,True,0,No user reviews,0,0,0
450341,True,0,No user reviews,0,0,0
450342,True,0,No user reviews,0,0,0
450350,True,0,No user reviews,0,0,0
450370,True,0,No user reviews,0,0,0
450390,True,8,Very Positive,94,2,96
450430,True,0,No user reviews,0,0,0
450440,True,8,Very Positive,84,12,96
450460,True,0,No user reviews,0,0,0
450470,True,0,No user reviews,0,0,0
450480,True,0,3 user reviews,1,2,3
450500,True,8,Very Positive,193,17,210
450510,True,0,No user reviews,0,0,0
450530,True,0,7 user reviews,1,6,7
450540,True,9,Overwhelmingly Positive,6655,226,6881
450550,True,8,Very Positive,109,7,116
450570,True,0,8 user reviews,1,7,8
450590,True,4,Mostly Negative,7,17,24
450600,True,5,Mixed,8,9,17
450630,True,0,9 user reviews,7,2,9
450650,True,0,7 user reviews,7,0,7
450660,True,8,Very Positive,251,30,281
450670,True,6,Mostly Positive,82,32,114
450700,True,6,Mostly Positive,89,31,120
450740,True,4,Mostly Negative,6,10,16
450750,True,0,6 user reviews,5,1,6
450760,True,0,6 user reviews,6,0,6
450770,True,0,No user reviews,0,0,0
450780,True,0,No user reviews,0,0,0
450790,True,6,Mostly Positive,111,30,141
450810,True,0,5 user reviews,5,0,5
450811,True,0,6 user reviews,5,1,6
450812,True,7,Positive,22,1,23
450820,True,5,Mixed,10,6,16
450850,True,4,Mostly Negative,6,10,16
450860,True,5,Mixed,51,34,85
450870,True,0,No user reviews,0,0,0
450880,True,0,1 user reviews,1,0,1
450881,True,0,No user reviews,0,0,0
450890,True,0,No user reviews,0,0,0
450950,True,8,Very Positive,76,5,81
450960,True,6,Mostly Positive,10,3,13
450980,True,0,No user reviews,0,0,0
451000,True,0,9 user reviews,8,1,9
451010,True,8,Very Positive,118,16,134
451020,True,8,Very Positive,1513,211,1724
451030,True,0,9 user reviews,9,0,9
451040,True,0,1 user reviews,1,0,1
451050,True,8,Very Positive,48,3,51
451060,True,0,2 user reviews,0,2,2
451080,True,6,Mostly Positive,17,7,24
451100,True,0,4 user reviews,4,0,4
451110,True,0,2 user reviews,0,2,2
451130,True,0,2 user reviews,1,1,2
451140,True,6,Mostly Positive,14,4,18
451160,True,0,3 user reviews,3,0,3
451180,True,0,6 user reviews,1,5,6
451200,True,0,8 user reviews,8,0,8
451210,True,0,4 user reviews,1,3,4
451230,True,0,1 user reviews,0,1,1
451241,True,0,No user reviews,0,0,0
451280,True,0,2 user reviews,1,1,2
451290,True,0,9 user reviews,9,0,9
451310,True,6,Mostly Positive,16,6,22
451320,True,5,Mixed,25,14,39
451330,True,0,No user reviews,0,0,0
451340,True,5,Mixed,2658,1328,3986
451350,True,0,6 user reviews,3,3,6
451360,True,0,No user reviews,0,0,0
451370,True,0,4 user reviews,4,0,4
451380,True,0,No user reviews,0,0,0
451400,True,5,Mixed,18,14,32
451410,True,0,3 user reviews,2,1,3
451421,True,0,No user reviews,0,0,0
451422,True,0,No user reviews,0,0,0
451430,True,0,1 user reviews,0,1,1
451440,True,0,No user reviews,0,0,0
451442,True,0,2 user reviews,1,1,2
451443,True,0,1 user reviews,0,1,1
451450,True,0,7 user reviews,5,2,7
451460,True,0,No user reviews,0,0,0
451461,True,0,No user reviews,0,0,0
451462,True,0,No user reviews,0,0,0
451463,True,0,No user reviews,0,0,0
451464,True,0,No user reviews,0,0,0
451465,True,0,No user reviews,0,0,0
451466,True,0,No user reviews,0,0,0
451467,True,0,No user reviews,0,0,0
451468,True,0,No user reviews,0,0,0
451469,True,0,No user reviews,0,0,0
451480,True,0,3 user reviews,1,2,3
451490,True,0,4 user reviews,4,0,4
451500,True,0,1 user reviews,1,0,1
451510,True,0,No user reviews,0,0,0
451520,True,8,Very Positive,665,114,779
451540,True,0,2 user reviews,2,0,2
451560,True,0,2 user reviews,0,2,2
451570,True,6,Mostly Positive,55,15,70
451580,True,0,No user reviews,0,0,0
451590,True,0,No user reviews,0,0,0
451600,True,8,Very Positive,100,7,107
451630,True,7,Positive,12,1,13
451640,True,7,Positive,35,4,39
451650,True,8,Very Positive,217,53,270
451660,True,5,Mixed,9,10,19
451670,True,3,Negative,2,16,18
451680,True,0,No user reviews,0,0,0
451690,True,0,7 user reviews,4,3,7
451700,True,0,1 user reviews,1,0,1
451710,True,0,1 user reviews,1,0,1
451730,True,0,No user reviews,0,0,0
451760,True,9,Overwhelmingly Positive,670,25,695
451780,True,6,Mostly Positive,150,62,212
451790,True,0,No user reviews,0,0,0
451800,True,0,8 user reviews,5,3,8
451810,True,0,No user reviews,0,0,0
451820,True,0,No user reviews,0,0,0
451840,True,8,Very Positive,461,89,550
451870,True,0,9 user reviews,6,3,9
451880,True,6,Mostly Positive,78,24,102
451900,True,5,Mixed,10,8,18
451920,True,5,Mixed,35,21,56
451930,True,7,Positive,11,1,12
451940,True,0,1 user reviews,1,0,1
451950,True,0,7 user reviews,1,6,7
451960,True,0,2 user reviews,1,1,2
451980,True,0,9 user reviews,9,0,9
451990,True,6,Mostly Positive,67,20,87
452000,True,5,Mixed,6,7,13
452040,True,0,No user reviews,0,0,0
452050,True,0,No user reviews,0,0,0
452060,True,8,Very Positive,915,134,1049
452070,True,0,3 user reviews,0,3,3
452080,True,0,No user reviews,0,0,0
452100,True,0,1 user reviews,1,0,1
452110,True,0,No user reviews,0,0,0
452120,True,7,Positive,18,4,22
452130,True,0,No user reviews,0,0,0
452140,True,0,No user reviews,0,0,0
452150,True,0,No user reviews,0,0,0
452160,True,0,No user reviews,0,0,0
452170,True,0,No user reviews,0,0,0
452180,True,0,2 user reviews,2,0,2
452190,True,0,No user reviews,0,0,0
452191,True,0,No user reviews,0,0,0
452192,True,0,No user reviews,0,0,0
452193,True,0,No user reviews,0,0,0
452200,True,0,No user reviews,0,0,0
452201,True,0,No user reviews,0,0,0
452220,True,0,No user reviews,0,0,0
452230,True,0,2 user reviews,2,0,2
452240,True,0,7 user reviews,7,0,7
452250,True,0,1 user reviews,0,1,1
452251,True,0,1 user reviews,0,1,1
452260,True,0,No user reviews,0,0,0
452270,True,0,2 user reviews,1,1,2
452280,True,0,1 user reviews,1,0,1
452290,True,0,No user reviews,0,0,0
452300,True,0,No user reviews,0,0,0
452320,True,6,Mostly Positive,9,3,12
452330,True,0,No user reviews,0,0,0
452340,True,5,Mixed,8,12,20
452350,True,0,1 user reviews,1,0,1
452360,True,0,2 user reviews,1,1,2
452370,True,0,No user reviews,0,0,0
452380,True,0,No user reviews,0,0,0
452410,True,7,Positive,19,4,23
452420,True,8,Very Positive,70,16,86
452430,True,6,Mostly Positive,48,20,68
452440,True,8,Very Positive,128,10,138
452450,True,5,Mixed,11,15,26
452470,True,0,No user reviews,0,0,0
452490,True,0,9 user reviews,6,3,9
452510,True,8,Very Positive,349,25,374
452520,True,0,8 user reviews,2,6,8
452521,True,6,Mostly Positive,8,3,11
452522,True,5,Mixed,6,7,13
452523,True,0,1 user reviews,1,0,1
452530,True,8,Very Positive,66,8,74
452540,True,8,Very Positive,218,33,251
452570,True,9,Overwhelmingly Positive,519,14,533
452600,True,0,No user reviews,0,0,0
452610,True,0,No user reviews,0,0,0
452620,True,0,1 user reviews,1,0,1
452630,True,0,No user reviews,0,0,0
452640,True,0,1 user reviews,0,1,1
452650,True,0,6 user reviews,2,4,6
452660,True,0,1 user reviews,1,0,1
452670,True,0,2 user reviews,2,0,2
452680,True,0,No user reviews,0,0,0
452690,True,0,No user reviews,0,0,0
452700,True,0,1 user reviews,1,0,1
452710,True,0,2 user reviews,2,0,2
452740,True,0,2 user reviews,2,0,2
452750,True,0,No user reviews,0,0,0
452760,True,0,3 user reviews,3,0,3
452770,True,0,9 user reviews,8,1,9
452771,True,0,8 user reviews,4,4,8
452800,True,0,No user reviews,0,0,0
452810,True,0,No user reviews,0,0,0
452850,True,0,No user reviews,0,0,0
452860,True,8,Very Positive,88,7,95
452890,True,0,No user reviews,0,0,0
452900,True,0,1 user reviews,1,0,1
452920,True,0,2 user reviews,2,0,2
452930,True,0,2 user reviews,1,1,2
452940,True,7,Positive,33,0,33
452950,True,0,9 user reviews,3,6,9
452960,True,6,Mostly Positive,39,11,50
452970,True,5,Mixed,48,27,75
452980,True,0,5 user reviews,3,2,5
452981,True,0,3 user reviews,3,0,3
452982,True,0,3 user reviews,3,0,3
453000,True,0,No user reviews,0,0,0
453020,True,7,Positive,19,2,21
453030,True,0,4 user reviews,3,1,4
453060,True,0,No user reviews,0,0,0
453090,True,8,Very Positive,2020,145,2165
453100,True,8,Very Positive,56,10,66
453130,True,6,Mostly Positive,7,3,10
453150,True,0,No user reviews,0,0,0
453160,True,0,2 user reviews,2,0,2
453170,True,0,8 user reviews,6,2,8
453190,True,0,No user reviews,0,0,0
453200,True,0,4 user reviews,3,1,4
453220,True,0,7 user reviews,5,2,7
453240,True,0,6 user reviews,3,3,6
453250,True,0,3 user reviews,3,0,3
453260,True,0,No user reviews,0,0,0
453270,True,5,Mixed,40,23,63
453280,True,8,Very Positive,61,11,72
453290,True,6,Mostly Positive,130,36,166
453300,True,6,Mostly Positive,51,14,65
453310,True,8,Very Positive,126,31,157
453320,True,0,2 user reviews,2,0,2
453330,True,0,5 user reviews,4,1,5
453340,True,9,Overwhelmingly Positive,639,27,666
453350,True,0,8 user reviews,2,6,8
453360,True,5,Mixed,37,25,62
453370,True,0,No user reviews,0,0,0
453380,True,7,Positive,12,1,13
453390,True,7,Positive,21,3,24
453400,True,7,Positive,33,2,35
453410,True,0,1 user reviews,0,1,1
453420,True,0,No user reviews,0,0,0
453440,True,0,6 user reviews,5,1,6
453450,True,6,Mostly Positive,10,3,13
453460,True,0,3 user reviews,2,1,3
453470,True,0,No user reviews,0,0,0
453480,True,8,Very Positive,159,39,198
453490,True,0,No user reviews,0,0,0
453500,True,7,Positive,12,2,14
453510,True,0,6 user reviews,6,0,6
453590,True,0,1 user reviews,1,0,1
453620,True,7,Positive,10,2,12
453630,True,0,4 user reviews,2,2,4
453640,True,0,No user reviews,0,0,0
453650,True,7,Positive,14,2,16
453660,True,0,9 user reviews,6,3,9
453670,True,3,Negative,4,24,28
453680,True,6,Mostly Positive,28,10,38
453690,True,8,Very Positive,169,38,207
453700,True,0,7 user reviews,6,1,7
453710,True,7,Positive,39,9,48
453720,True,6,Mostly Positive,51,19,70
453730,True,4,Mostly Negative,3,7,10
453740,True,7,Positive,10,2,12
453750,True,6,Mostly Positive,236,72,308
453760,True,0,No user reviews,0,0,0
453770,True,6,Mostly Positive,8,3,11
453780,True,7,Positive,12,0,12
453790,True,8,Very Positive,91,8,99
453810,True,5,Mixed,9,7,16
453820,True,3,Negative,6,36,42
453830,True,0,5 user reviews,5,0,5
453840,True,0,No user reviews,0,0,0
453850,True,5,Mixed,22,26,48
453860,True,0,No user reviews,0,0,0
453870,True,6,Mostly Positive,17,7,24
453880,True,0,3 user reviews,2,1,3
453890,True,7,Positive,10,2,12
453900,True,0,No user reviews,0,0,0
453910,True,7,Positive,14,3,17
453920,True,0,6 user reviews,6,0,6
453950,True,7,Positive,9,2,11
453960,True,5,Mixed,33,22,55
453980,True,0,6 user reviews,1,5,6
453990,True,7,Positive,37,1,38
454000,True,0,No user reviews,0,0,0
454010,True,0,No user reviews,0,0,0
454030,True,5,Mixed,17,10,27
454060,True,6,Mostly Positive,505,133,638
454070,True,5,Mixed,84,59,143
454080,True,5,Mixed,5,6,11
454100,True,5,Mixed,77,35,112
454110,True,0,No user reviews,0,0,0
454120,True,0,No user reviews,0,0,0
454130,True,5,Mixed,9,4,13
454140,True,8,Very Positive,128,13,141
454160,True,8,Very Positive,63,3,66
454170,True,0,4 user reviews,4,0,4
454180,True,5,Mixed,44,21,65
454190,True,8,Very Positive,61,6,67
454200,True,4,Mostly Negative,8,15,23
454220,True,6,Mostly Positive,43,17,60
454230,True,4,Mostly Negative,3,8,11
454240,True,0,2 user reviews,2,0,2
454250,True,8,Very Positive,187,38,225
454260,True,0,4 user reviews,2,2,4
454280,True,0,No user reviews,0,0,0
454300,True,0,No user reviews,0,0,0
454320,True,8,Very Positive,73,7,80
454330,True,0,6 user reviews,4,2,6
454340,True,0,No user reviews,0,0,0
454350,True,5,Mixed,328,373,701
454360,True,0,No user reviews,0,0,0
454370,True,0,6 user reviews,3,3,6
454380,True,8,Very Positive,63,1,64
454390,True,0,3 user reviews,3,0,3
454410,True,8,Very Positive,95,22,117
454420,True,0,1 user reviews,1,0,1
454430,True,0,1 user reviews,0,1,1
454440,True,0,No user reviews,0,0,0
454450,True,0,4 user reviews,4,0,4
454460,True,5,Mixed,11,5,16
454480,True,0,1 user reviews,0,1,1
454490,True,0,No user reviews,0,0,0
454510,True,8,Very Positive,67,8,75
454520,True,0,5 user reviews,2,3,5
454530,True,8,Very Positive,69,6,75
454540,True,0,5 user reviews,0,5,5
454550,True,5,Mixed,37,20,57
454560,True,4,Mostly Negative,7,11,18
454570,True,5,Mixed,13,10,23
454580,True,6,Mostly Positive,10,4,14
454590,True,0,No user reviews,0,0,0
454600,True,0,4 user reviews,1,3,4
454610,True,5,Mixed,11,10,21
454630,True,0,8 user reviews,7,1,8
454640,True,0,No user reviews,0,0,0
454650,True,8,Very Positive,6308,1264,7572
454660,True,0,1 user reviews,1,0,1
454670,True,0,2 user reviews,2,0,2
454680,True,4,Mostly Negative,4,7,11
454690,True,0,7 user reviews,5,2,7
454700,True,0,2 user reviews,0,2,2
454720,True,0,7 user reviews,4,3,7
454730,True,0,4 user reviews,0,4,4
454740,True,0,3 user reviews,3,0,3
454750,True,0,4 user reviews,4,0,4
454760,True,0,No user reviews,0,0,0
454770,True,7,Positive,13,3,16
454780,True,0,2 user reviews,2,0,2
454790,True,7,Positive,20,1,21
454791,True,0,1 user reviews,1,0,1
454800,True,0,7 user reviews,4,3,7
454830,True,0,3 user reviews,3,0,3
454870,True,0,7 user reviews,5,2,7
454890,True,8,Very Positive,92,21,113
454900,True,7,Positive,30,4,34
454910,True,0,No user reviews,0,0,0
454920,True,0,No user reviews,0,0,0
454950,True,8,Very Positive,136,34,170
454960,True,0,4 user reviews,4,0,4
454970,True,0,4 user reviews,3,1,4
454980,True,0,1 user reviews,1,0,1
455000,True,0,1 user reviews,0,1,1
455020,True,0,No user reviews,0,0,0
455030,True,0,No user reviews,0,0,0
455040,True,8,Very Positive,307,72,379
455041,True,7,Positive,37,1,38
455050,True,0,4 user reviews,3,1,4
455080,True,0,6 user reviews,5,1,6
455100,True,7,Positive,15,2,17
455110,True,5,Mixed,6,5,11
455120,True,5,Mixed,220,162,382
455130,True,0,No user reviews,0,0,0
455150,True,0,No user reviews,0,0,0
455160,True,0,No user reviews,0,0,0
455170,True,0,No user reviews,0,0,0
455190,True,7,Positive,8,2,10
455200,True,4,Mostly Negative,4,7,11
455220,True,5,Mixed,11,5,16
455222,True,0,2 user reviews,1,1,2
455223,True,0,6 user reviews,5,1,6
455224,True,0,2 user reviews,2,0,2
455230,True,0,8 user reviews,7,1,8
455250,True,0,No user reviews,0,0,0
455270,True,0,6 user reviews,4,2,6
455280,True,0,1 user reviews,1,0,1
455290,True,0,2 user reviews,2,0,2
455300,True,0,No user reviews,0,0,0
455310,True,6,Mostly Positive,15,5,20
455320,True,0,1 user reviews,0,1,1
455340,True,5,Mixed,17,11,28
455360,True,0,No user reviews,0,0,0
455370,True,0,7 user reviews,7,0,7
455380,True,0,No user reviews,0,0,0
455400,True,8,Very Positive,396,22,418
455411,True,0,No user reviews,0,0,0
455440,True,0,9 user reviews,6,3,9
455451,True,0,No user reviews,0,0,0
455460,True,0,8 user reviews,5,3,8
455470,True,0,1 user reviews,1,0,1
455480,True,0,1 user reviews,0,1,1
455490,True,5,Mixed,29,15,44
455510,True,0,No user reviews,0,0,0
455520,True,7,Positive,10,2,12
455521,True,0,No user reviews,0,0,0
455530,True,0,4 user reviews,4,0,4
455560,True,0,No user reviews,0,0,0
455561,True,0,No user reviews,0,0,0
455562,True,0,No user reviews,0,0,0
455570,True,8,Very Positive,47,8,55
455572,True,8,Very Positive,57,8,65
455574,True,0,5 user reviews,2,3,5
455576,True,0,3 user reviews,2,1,3
455578,True,0,1 user reviews,0,1,1
455580,True,6,Mostly Positive,7,3,10
455590,True,0,6 user reviews,5,1,6
455610,True,5,Mixed,12,11,23
455611,True,0,2 user reviews,1,1,2
455612,True,0,1 user reviews,0,1,1
455620,True,0,No user reviews,0,0,0
455630,True,0,No user reviews,0,0,0
455640,True,0,3 user reviews,2,1,3
455660,True,0,No user reviews,0,0,0
455670,True,0,No user reviews,0,0,0
455690,True,7,Positive,22,2,24
455700,True,5,Mixed,14,8,22
455710,True,5,Mixed,8,7,15
455720,True,0,5 user reviews,3,2,5
455740,True,0,1 user reviews,1,0,1
455750,True,0,1 user reviews,1,0,1
455760,True,0,No user reviews,0,0,0
455770,True,0,7 user reviews,6,1,7
455810,True,0,8 user reviews,5,3,8
455820,True,8,Very Positive,444,55,499
455830,True,0,8 user reviews,6,2,8
455900,True,0,No user reviews,0,0,0
455910,True,5,Mixed,428,189,617
455920,True,0,No user reviews,0,0,0
455940,True,4,Mostly Negative,7,11,18
455950,True,0,No user reviews,0,0,0
455960,True,5,Mixed,10,12,22
455970,True,0,8 user reviews,3,5,8
455980,True,8,Very Positive,676,143,819
455990,True,0,2 user reviews,2,0,2
456000,True,0,No user reviews,0,0,0
456020,True,0,No user reviews,0,0,0
456030,True,0,No user reviews,0,0,0
456050,True,0,7 user reviews,6,1,7
456090,True,0,8 user reviews,1,7,8
456100,True,0,No user reviews,0,0,0
456110,True,0,No user reviews,0,0,0
456120,True,0,No user reviews,0,0,0
456130,True,0,5 user reviews,4,1,5
456140,True,0,No user reviews,0,0,0
456150,True,0,2 user reviews,0,2,2
456160,True,0,4 user reviews,2,2,4
456170,True,6,Mostly Positive,52,15,67
456180,True,5,Mixed,41,28,69
456200,True,0,3 user reviews,3,0,3
456210,True,0,5 user reviews,3,2,5
456220,True,4,Mostly Negative,7,14,21
456221,True,0,2 user reviews,0,2,2
456230,True,0,1 user reviews,1,0,1
456231,True,0,1 user reviews,0,1,1
456250,True,0,No user reviews,0,0,0
456280,True,4,Mostly Negative,38,65,103
456290,True,0,No user reviews,0,0,0
456370,True,0,No user reviews,0,0,0
456390,True,0,6 user reviews,6,0,6
456400,True,0,No user reviews,0,0,0
456410,True,0,No user reviews,0,0,0
456420,True,0,6 user reviews,0,6,6
456430,True,8,Very Positive,138,17,155
456440,True,0,3 user reviews,2,1,3
456450,True,0,3 user reviews,0,3,3
456470,True,7,Positive,9,2,11
456480,True,0,5 user reviews,4,1,5
456510,True,0,2 user reviews,2,0,2
456540,True,6,Mostly Positive,66,25,91
456560,True,0,No user reviews,0,0,0
456600,True,7,Positive,12,0,12
456630,True,8,Very Positive,152,38,190
456640,True,0,No user reviews,0,0,0
456660,True,0,6 user reviews,3,3,6
456670,True,8,Very Positive,1230,210,1440
456690,True,0,1 user reviews,1,0,1
456730,True,0,2 user reviews,2,0,2
456740,True,0,4 user reviews,4,0,4
456750,True,9,Overwhelmingly Positive,2280,87,2367
456760,True,7,Positive,16,3,19
456780,True,5,Mixed,22,12,34
456800,True,0,7 user reviews,7,0,7
456801,True,0,No user reviews,0,0,0
456802,True,0,No user reviews,0,0,0
456810,True,5,Mixed,22,11,33
456820,True,0,4 user reviews,3,1,4
456821,True,0,No user reviews,0,0,0
456830,True,7,Positive,12,1,13
456880,True,0,No user reviews,0,0,0
456890,True,0,No user reviews,0,0,0
456891,True,0,No user reviews,0,0,0
456910,True,0,2 user reviews,2,0,2
456920,True,0,1 user reviews,1,0,1
456960,True,0,No user reviews,0,0,0
456980,True,6,Mostly Positive,11,4,15
457000,True,0,No user reviews,0,0,0
457010,True,6,Mostly Positive,101,37,138
457030,True,0,No user reviews,0,0,0
457040,True,0,No user reviews,0,0,0
457070,True,0,No user reviews,0,0,0
457080,True,0,1 user reviews,1,0,1
457082,True,0,No user reviews,0,0,0
457083,True,0,No user reviews,0,0,0
457084,True,0,1 user reviews,0,1,1
457085,True,0,5 user reviews,2,3,5
457086,True,6,Mostly Positive,19,7,26
457087,True,0,8 user reviews,6,2,8
457088,True,0,No user reviews,0,0,0
457090,True,0,5 user reviews,4,1,5
457100,True,0,No user reviews,0,0,0
457120,True,0,7 user reviews,6,1,7
457130,True,7,Positive,30,6,36
457140,True,9,Overwhelmingly Positive,19653,822,20475
457160,True,7,Positive,27,3,30
457162,True,8,Very Positive,111,15,126
457180,True,0,1 user reviews,0,1,1
457190,True,8,Very Positive,58,2,60
457191,True,8,Very Positive,84,12,96
457192,True,8,Very Positive,156,26,182
457194,True,7,Positive,34,6,40
457195,True,8,Very Positive,131,15,146
457196,True,8,Very Positive,49,6,55
457197,True,8,Very Positive,224,21,245
457198,True,8,Very Positive,74,7,81
457199,True,8,Very Positive,58,6,64
457200,True,0,7 user reviews,3,4,7
457201,True,0,9 user reviews,6,3,9
457210,True,9,Overwhelmingly Positive,682,29,711
457220,True,0,1 user reviews,1,0,1
457221,True,0,No user reviews,0,0,0
457222,True,0,No user reviews,0,0,0
457223,True,0,No user reviews,0,0,0
457224,True,0,No user reviews,0,0,0
457230,True,0,1 user reviews,1,0,1
457320,True,8,Very Positive,326,30,356
457330,True,5,Mixed,50,34,84
457340,True,6,Mostly Positive,32,9,41
457350,True,0,No user reviews,0,0,0
457360,True,0,No user reviews,0,0,0
457370,True,7,Positive,15,2,17
457380,True,5,Mixed,35,17,52
457410,True,0,No user reviews,0,0,0
457420,True,0,1 user reviews,1,0,1
457450,True,5,Mixed,4,6,10
457470,True,0,No user reviews,0,0,0
457480,True,6,Mostly Positive,91,27,118
457490,True,8,Very Positive,49,9,58
457520,True,5,Mixed,37,16,53
457530,True,8,Very Positive,84,19,103
457550,True,7,Positive,26,3,29
457560,True,0,No user reviews,0,0,0
457570,True,8,Very Positive,109,17,126
457580,True,6,Mostly Positive,103,35,138
457590,True,0,No user reviews,0,0,0
457600,True,5,Mixed,67,34,101
457610,True,0,4 user reviews,1,3,4
457650,True,0,2 user reviews,1,1,2
457660,True,5,Mixed,10,5,15
457670,True,0,No user reviews,0,0,0
457680,True,6,Mostly Positive,167,51,218
457690,True,5,Mixed,4,6,10
457710,True,4,Mostly Negative,29,102,131
457720,True,0,4 user reviews,3,1,4
457730,True,5,Mixed,109,79,188
457760,True,5,Mixed,359,155,514
457770,True,7,Positive,12,1,13
457790,True,0,No user reviews,0,0,0
457810,True,5,Mixed,5,6,11
457820,True,5,Mixed,13,12,25
457830,True,0,No user reviews,0,0,0
457840,True,7,Positive,21,2,23
457841,True,7,Positive,15,3,18
457842,True,7,Positive,31,4,35
457860,True,8,Very Positive,355,60,415
457870,True,0,3 user reviews,1,2,3
457890,True,8,Very Positive,57,5,62
457960,True,8,Very Positive,506,57,563
457980,True,0,6 user reviews,2,4,6
457990,True,0,1 user reviews,1,0,1
458000,True,6,Mostly Positive,248,96,344
458010,True,0,No user reviews,0,0,0
458030,True,0,5 user reviews,4,1,5
458040,True,7,Positive,8,2,10
458060,True,4,Mostly Negative,5,17,22
458080,True,0,No user reviews,0,0,0
458100,True,0,3 user reviews,1,2,3
458110,True,0,2 user reviews,1,1,2
458120,True,0,No user reviews,0,0,0
458160,True,0,4 user reviews,4,0,4
458170,True,7,Positive,13,0,13
458190,True,0,6 user reviews,2,4,6
458200,True,0,2 user reviews,1,1,2
458230,True,0,2 user reviews,1,1,2
458250,True,0,1 user reviews,1,0,1
458260,True,0,2 user reviews,2,0,2
458270,True,0,1 user reviews,1,0,1
458280,True,0,1 user reviews,1,0,1
458290,True,0,8 user reviews,5,3,8
458300,True,0,1 user reviews,1,0,1
458310,True,0,1 user reviews,1,0,1
458320,True,0,1 user reviews,1,0,1
458330,True,7,Positive,33,8,41
458360,True,7,Positive,13,0,13
458370,True,5,Mixed,10,6,16
458380,True,7,Positive,31,4,35
458400,True,0,1 user reviews,1,0,1
458410,True,0,No user reviews,0,0,0
458420,True,5,Mixed,11,6,17
458440,True,0,No user reviews,0,0,0
458441,True,0,No user reviews,0,0,0
458442,True,0,No user reviews,0,0,0
458443,True,0,No user reviews,0,0,0
458444,True,0,No user reviews,0,0,0
458445,True,0,2 user reviews,2,0,2
458450,True,0,4 user reviews,1,3,4
458460,True,0,No user reviews,0,0,0
458470,True,8,Very Positive,134,6,140
458480,True,8,Very Positive,62,7,69
458490,True,5,Mixed,9,6,15
458500,True,0,1 user reviews,0,1,1
458510,True,5,Mixed,7,4,11
458520,True,6,Mostly Positive,22,7,29
458530,True,0,4 user reviews,2,2,4
458540,True,7,Positive,16,1,17
458560,True,0,1 user reviews,0,1,1
458580,True,8,Very Positive,154,34,188
458590,True,0,1 user reviews,1,0,1
458600,True,4,Mostly Negative,9,14,23
458620,True,0,No user reviews,0,0,0
458630,True,5,Mixed,46,30,76
458640,True,5,Mixed,14,7,21
458660,True,6,Mostly Positive,9,3,12
458670,True,0,No user reviews,0,0,0
458680,True,7,Positive,28,3,31
458700,True,5,Mixed,8,4,12
458710,True,9,Overwhelmingly Positive,1053,54,1107
458730,True,8,Very Positive,276,56,332
458740,True,0,1 user reviews,1,0,1
458750,True,7,Positive,32,2,34
458760,True,7,Positive,12,0,12
458770,True,5,Mixed,77,62,139
458790,True,7,Positive,16,0,16
458800,True,0,No user reviews,0,0,0
458810,True,0,No user reviews,0,0,0
458820,True,0,2 user reviews,0,2,2
458830,True,5,Mixed,81,60,141
458840,True,5,Mixed,11,10,21
458841,True,0,6 user reviews,5,1,6
458860,True,7,Positive,17,0,17
458870,True,0,No user reviews,0,0,0
458880,True,0,No user reviews,0,0,0
458890,True,0,No user reviews,0,0,0
458910,True,0,2 user reviews,2,0,2
458920,True,5,Mixed,79,70,149
458930,True,0,No user reviews,0,0,0
458960,True,5,Mixed,9,8,17
458970,True,0,No user reviews,0,0,0
458990,True,5,Mixed,8,10,18
459010,True,8,Very Positive,262,39,301
459020,True,5,Mixed,15,14,29
459040,True,0,6 user reviews,3,3,6
459050,True,0,No user reviews,0,0,0
459070,True,0,1 user reviews,1,0,1
459080,True,5,Mixed,43,53,96
459090,True,8,Very Positive,173,16,189
459110,True,0,No user reviews,0,0,0
459120,True,6,Mostly Positive,30,9,39
459130,True,6,Mostly Positive,14,5,19
459140,True,7,Positive,15,1,16
459150,True,7,Positive,12,1,13
459160,True,0,5 user reviews,4,1,5
459170,True,0,8 user reviews,2,6,8
459210,True,0,No user reviews,0,0,0
459220,True,8,Very Positive,2417,257,2674
459240,True,0,3 user reviews,3,0,3
459260,True,5,Mixed,12,12,24
459280,True,6,Mostly Positive,8,3,11
459290,True,0,5 user reviews,4,1,5
459310,True,5,Mixed,65,39,104
459320,True,0,No user reviews,0,0,0
459330,True,0,No user reviews,0,0,0
459350,True,7,Positive,27,4,31
459360,True,0,7 user reviews,4,3,7
459361,True,0,4 user reviews,1,3,4
459362,True,0,2 user reviews,2,0,2
459363,True,0,No user reviews,0,0,0
459370,True,7,Positive,13,2,15
459380,True,0,No user reviews,0,0,0
459410,True,0,5 user reviews,2,3,5
459450,True,7,Positive,13,1,14
459460,True,0,No user reviews,0,0,0
459470,True,5,Mixed,19,18,37
459480,True,0,1 user reviews,1,0,1
459490,True,0,2 user reviews,2,0,2
459500,True,0,8 user reviews,5,3,8
459520,True,7,Positive,9,1,10
459540,True,6,Mostly Positive,31,11,42
459550,True,6,Mostly Positive,50,18,68
459560,True,0,No user reviews,0,0,0
459580,True,0,9 user reviews,9,0,9
459590,True,0,No user reviews,0,0,0
459610,True,7,Positive,17,3,20
459630,True,0,6 user reviews,1,5,6
459640,True,5,Mixed,8,4,12
459670,True,0,No user reviews,0,0,0
459680,True,6,Mostly Positive,28,10,38
459730,True,0,2 user reviews,2,0,2
459740,True,0,No user reviews,0,0,0
459741,True,0,No user reviews,0,0,0
459742,True,0,No user reviews,0,0,0
459743,True,0,No user reviews,0,0,0
459744,True,0,No user reviews,0,0,0
459750,True,0,6 user reviews,6,0,6
459760,True,0,7 user reviews,4,3,7
459770,True,0,No user reviews,0,0,0
459780,True,0,4 user reviews,4,0,4
459790,True,0,6 user reviews,6,0,6
459820,True,8,Very Positive,206,37,243
459830,True,6,Mostly Positive,17,5,22
459850,True,0,2 user reviews,2,0,2
459851,True,0,4 user reviews,4,0,4
459852,True,0,3 user reviews,3,0,3
459853,True,0,5 user reviews,4,1,5
459870,True,0,5 user reviews,3,2,5
459880,True,5,Mixed,6,4,10
459890,True,0,No user reviews,0,0,0
459900,True,0,No user reviews,0,0,0
459910,True,7,Positive,11,0,11
459940,True,5,Mixed,105,49,154
460010,True,0,3 user reviews,3,0,3
460030,True,0,2 user reviews,2,0,2
460040,True,0,No user reviews,0,0,0
460060,True,5,Mixed,17,8,25
460070,True,0,1 user reviews,0,1,1
460090,True,0,No user reviews,0,0,0
460110,True,0,No user reviews,0,0,0
460120,True,8,Very Positive,1234,79,1313
460140,True,7,Positive,17,0,17
460150,True,5,Mixed,15,9,24
460160,True,8,Very Positive,136,14,150
460190,True,0,7 user reviews,7,0,7
460210,True,0,4 user reviews,4,0,4
460220,True,8,Very Positive,50,4,54
460230,True,6,Mostly Positive,48,15,63
460240,True,0,2 user reviews,1,1,2
460250,True,7,Positive,19,1,20
460260,True,0,1 user reviews,1,0,1
460280,True,0,No user reviews,0,0,0
460300,True,0,No user reviews,0,0,0
460320,True,0,No user reviews,0,0,0
460340,True,6,Mostly Positive,61,18,79
460350,True,0,No user reviews,0,0,0
460390,True,7,Positive,36,2,38
460420,True,7,Positive,23,0,23
460430,True,8,Very Positive,536,44,580
460440,True,0,1 user reviews,1,0,1
460450,True,0,No user reviews,0,0,0
460460,True,0,No user reviews,0,0,0
460470,True,7,Positive,9,1,10
460500,True,0,No user reviews,0,0,0
460510,True,0,2 user reviews,1,1,2
460540,True,0,1 user reviews,1,0,1
460560,True,0,8 user reviews,8,0,8
460570,True,0,No user reviews,0,0,0
460580,True,5,Mixed,6,6,12
460590,True,0,1 user reviews,1,0,1
460630,True,7,Positive,31,0,31
460640,True,5,Mixed,22,21,43
460650,True,5,Mixed,11,10,21
460670,True,0,No user reviews,0,0,0
460690,True,0,No user reviews,0,0,0
460700,True,8,Very Positive,225,52,277
460710,True,0,2 user reviews,2,0,2
460730,True,0,No user reviews,0,0,0
460740,True,0,No user reviews,0,0,0
460750,True,7,Positive,19,4,23
460760,True,0,1 user reviews,1,0,1
460780,True,8,Very Positive,61,4,65
460790,True,8,Very Positive,4094,425,4519
460810,True,8,Very Positive,1888,220,2108
460830,True,0,1 user reviews,1,0,1
460840,True,0,No user reviews,0,0,0
460850,True,0,8 user reviews,8,0,8
460870,True,8,Very Positive,159,30,189
460880,True,0,No user reviews,0,0,0
460890,True,7,Positive,8,2,10
460910,True,6,Mostly Positive,11,3,14
460920,True,6,Mostly Positive,3974,1055,5029
460930,True,6,Mostly Positive,11491,3325,14816
460940,True,5,Mixed,11,9,20
460950,True,9,Overwhelmingly Positive,10153,198,10351
460960,True,8,Very Positive,128,8,136
460970,True,7,Positive,12,3,15
460980,True,0,No user reviews,0,0,0
460990,True,5,Mixed,16,8,24
461010,True,8,Very Positive,50,12,62
461020,True,0,No user reviews,0,0,0
461030,True,5,Mixed,9,4,13
461040,True,7,Positive,14,2,16
461050,True,0,1 user reviews,1,0,1
461060,True,0,No user reviews,0,0,0
461090,True,0,No user reviews,0,0,0
461100,True,0,No user reviews,0,0,0
461110,True,0,No user reviews,0,0,0
461120,True,0,No user reviews,0,0,0
461130,True,0,3 user reviews,3,0,3
461150,True,0,No user reviews,0,0,0
461160,True,7,Positive,9,1,10
461170,True,8,Very Positive,131,17,148
461180,True,0,2 user reviews,2,0,2
461190,True,0,No user reviews,0,0,0
461200,True,0,2 user reviews,2,0,2
461210,True,5,Mixed,24,18,42
461220,True,8,Very Positive,71,8,79
461230,True,8,Very Positive,58,11,69
461240,True,7,Positive,12,2,14
461241,True,7,Positive,9,1,10
461242,True,8,Very Positive,94,8,102
461243,True,0,6 user reviews,5,1,6
461244,True,8,Very Positive,263,15,278
461245,True,7,Positive,9,1,10
461246,True,7,Positive,10,1,11
461247,True,7,Positive,18,0,18
461248,True,7,Positive,30,2,32
461249,True,8,Very Positive,113,4,117
461250,True,0,4 user reviews,4,0,4
461280,True,0,3 user reviews,3,0,3
461300,True,0,No user reviews,0,0,0
461320,True,0,3 user reviews,2,1,3
461330,True,0,No user reviews,0,0,0
461340,True,7,Positive,15,2,17
461350,True,6,Mostly Positive,7,3,10
461360,True,7,Positive,13,3,16
461370,True,0,4 user reviews,2,2,4
461380,True,5,Mixed,11,11,22
461390,True,0,9 user reviews,3,6,9
461400,True,5,Mixed,8,12,20
461410,True,7,Positive,42,7,49
461420,True,0,No user reviews,0,0,0
461430,True,5,Mixed,1134,580,1714
461440,True,0,No user reviews,0,0,0
461470,True,0,No user reviews,0,0,0
461480,True,7,Positive,12,1,13
461490,True,5,Mixed,19,17,36
461500,True,7,Positive,29,7,36
461510,True,5,Mixed,9,5,14
461520,True,4,Mostly Negative,10,40,50
461530,True,0,No user reviews,0,0,0
461540,True,0,No user reviews,0,0,0
461550,True,0,No user reviews,0,0,0
461560,True,8,Very Positive,101,7,108
461580,True,0,2 user reviews,1,1,2
461590,True,0,4 user reviews,3,1,4
461600,True,0,1 user reviews,1,0,1
461610,True,0,No user reviews,0,0,0
461620,True,8,Very Positive,377,60,437
461640,True,8,Very Positive,337,53,390
461650,True,5,Mixed,10,5,15
461660,True,0,No user reviews,0,0,0
461680,True,4,Mostly Negative,14,26,40
461700,True,8,Very Positive,240,16,256
461710,True,7,Positive,19,2,21
461730,True,6,Mostly Positive,55,19,74
461740,True,7,Positive,28,0,28
461750,True,0,1 user reviews,1,0,1
461760,True,0,9 user reviews,4,5,9
461780,True,4,Mostly Negative,20,53,73
461800,True,8,Very Positive,127,22,149
461810,True,7,Positive,22,3,25
461820,True,0,2 user reviews,1,1,2
461830,True,0,2 user reviews,1,1,2
461840,True,8,Very Positive,746,52,798
461850,True,0,4 user reviews,2,2,4
461860,True,5,Mixed,6,5,11
461870,True,5,Mixed,574,639,1213
461880,True,4,Mostly Negative,5,16,21
461890,True,5,Mixed,68,36,104
461900,True,5,Mixed,28,14,42
461930,True,0,No user reviews,0,0,0
461931,True,0,No user reviews,0,0,0
461932,True,0,No user reviews,0,0,0
461933,True,0,No user reviews,0,0,0
461934,True,0,No user reviews,0,0,0
461935,True,0,No user reviews,0,0,0
461940,True,4,Mostly Negative,4,10,14
461950,True,6,Mostly Positive,453,171,624
461970,True,0,No user reviews,0,0,0
461990,True,0,2 user reviews,0,2,2
462000,True,8,Very Positive,70,10,80
462050,True,5,Mixed,5,5,10
462070,True,0,8 user reviews,3,5,8
462081,True,0,4 user reviews,4,0,4
462082,True,0,No user reviews,0,0,0
462083,True,0,1 user reviews,1,0,1
462084,True,0,No user reviews,0,0,0
462085,True,0,No user reviews,0,0,0
462086,True,0,No user reviews,0,0,0
462087,True,0,1 user reviews,1,0,1
462088,True,0,No user reviews,0,0,0
462089,True,0,No user reviews,0,0,0
462100,True,8,Very Positive,137,26,163
462110,True,0,7 user reviews,3,4,7
462130,True,0,5 user reviews,5,0,5
462140,True,0,4 user reviews,3,1,4
462170,True,0,5 user reviews,5,0,5
462210,True,0,No user reviews,0,0,0
462211,True,0,3 user reviews,1,2,3
462212,True,0,1 user reviews,1,0,1
462213,True,0,No user reviews,0,0,0
462214,True,0,No user reviews,0,0,0
462220,True,7,Positive,9,2,11
462240,True,6,Mostly Positive,10,4,14
462250,True,0,1 user reviews,1,0,1
462260,True,6,Mostly Positive,28,9,37
462261,True,7,Positive,31,6,37
462280,True,0,5 user reviews,4,1,5
462290,True,5,Mixed,10,8,18
462310,True,0,No user reviews,0,0,0
462351,True,0,No user reviews,0,0,0
462360,True,0,No user reviews,0,0,0
462380,True,0,No user reviews,0,0,0
462390,True,0,6 user reviews,6,0,6
462391,True,0,4 user reviews,4,0,4
462400,True,0,1 user reviews,0,1,1
462440,True,4,Mostly Negative,73,120,193
462460,True,0,8 user reviews,6,2,8
462480,True,7,Positive,31,4,35
462520,True,7,Positive,13,2,15
462530,True,0,1 user reviews,0,1,1
462540,True,0,No user reviews,0,0,0
462550,True,0,1 user reviews,1,0,1
462570,True,0,8 user reviews,6,2,8
462580,True,0,3 user reviews,1,2,3
462590,True,7,Positive,12,0,12
462600,True,0,6 user reviews,5,1,6
462601,True,0,No user reviews,0,0,0
462603,True,0,No user reviews,0,0,0
462604,True,0,No user reviews,0,0,0
462605,True,0,2 user reviews,2,0,2
462610,True,5,Mixed,7,4,11
462611,True,0,4 user reviews,4,0,4
462620,True,7,Positive,30,2,32
462630,True,0,2 user reviews,2,0,2
462640,True,5,Mixed,10,5,15
462660,True,0,No user reviews,0,0,0
462670,True,0,3 user reviews,3,0,3
462680,True,6,Mostly Positive,144,41,185
462700,True,5,Mixed,24,16,40
462720,True,0,No user reviews,0,0,0
462730,True,5,Mixed,17,10,27
462740,True,0,1 user reviews,1,0,1
462770,True,8,Very Positive,3427,381,3808
462780,True,8,Very Positive,1875,311,2186
462830,True,4,Mostly Negative,11,29,40
462860,True,6,Mostly Positive,19,8,27
462880,True,0,5 user reviews,5,0,5
462910,True,0,3 user reviews,3,0,3
462920,True,5,Mixed,16,20,36
462930,True,5,Mixed,81,42,123
462940,True,6,Mostly Positive,77,23,100
462950,True,5,Mixed,7,7,14
462960,True,5,Mixed,92,41,133
462990,True,8,Very Positive,166,13,179
463000,True,0,1 user reviews,0,1,1
463010,True,0,5 user reviews,2,3,5
463020,True,7,Positive,12,0,12
463030,True,5,Mixed,92,54,146
463060,True,0,3 user reviews,2,1,3
463070,True,7,Positive,27,1,28
463080,True,0,No user reviews,0,0,0
463090,True,0,1 user reviews,1,0,1
463100,True,0,4 user reviews,0,4,4
463110,True,6,Mostly Positive,93,34,127
463120,True,0,No user reviews,0,0,0
463130,True,0,No user reviews,0,0,0
463140,True,0,No user reviews,0,0,0
463150,True,6,Mostly Positive,183,47,230
463160,True,6,Mostly Positive,62,20,82
463170,True,5,Mixed,56,43,99
463180,True,0,8 user reviews,5,3,8
463190,True,0,No user reviews,0,0,0
463200,True,0,1 user reviews,1,0,1
463210,True,8,Very Positive,230,50,280
463220,True,6,Mostly Positive,111,39,150
463240,True,0,6 user reviews,6,0,6
463250,True,0,2 user reviews,1,1,2
463270,True,8,Very Positive,557,68,625
463290,True,8,Very Positive,88,7,95
463310,True,0,No user reviews,0,0,0
463320,True,5,Mixed,9,13,22
463330,True,0,No user reviews,0,0,0
463350,True,6,Mostly Positive,153,63,216
463360,True,0,1 user reviews,1,0,1
463390,True,7,Positive,13,2,15
463400,True,7,Positive,13,3,16
463410,True,0,No user reviews,0,0,0
463430,True,0,6 user reviews,2,4,6
463440,True,0,1 user reviews,0,1,1
463450,True,0,4 user reviews,4,0,4
463460,True,5,Mixed,9,6,15
463470,True,6,Mostly Positive,7,3,10
463480,True,0,5 user reviews,4,1,5
463490,True,0,No user reviews,0,0,0
463510,True,0,8 user reviews,4,4,8
463530,True,9,Overwhelmingly Positive,2323,107,2430
463540,True,0,No user reviews,0,0,0
463590,True,7,Positive,11,1,12
463600,True,0,No user reviews,0,0,0
463610,True,0,No user reviews,0,0,0
463630,True,0,1 user reviews,1,0,1
463640,True,6,Mostly Positive,10,3,13
463650,True,0,6 user reviews,6,0,6
463670,True,0,9 user reviews,5,4,9
463690,True,0,No user reviews,0,0,0
463700,True,8,Very Positive,73,11,84
463710,True,4,Mostly Negative,3,8,11
463720,True,8,Very Positive,161,26,187
463740,True,8,Very Positive,248,8,256
463750,True,7,Positive,19,0,19
463760,True,6,Mostly Positive,21,7,28
463780,True,0,No user reviews,0,0,0
463790,True,5,Mixed,8,5,13
463791,True,7,Positive,41,6,47
463792,True,0,No user reviews,0,0,0
463794,True,0,4 user reviews,4,0,4
463795,True,6,Mostly Positive,46,19,65
463796,True,0,9 user reviews,7,2,9
463797,True,6,Mostly Positive,7,3,10
463798,True,0,9 user reviews,5,4,9
463799,True,7,Positive,11,2,13
463800,True,8,Very Positive,50,10,60
463810,True,0,3 user reviews,3,0,3
463830,True,0,2 user reviews,0,2,2
463850,True,6,Mostly Positive,92,28,120
463860,True,5,Mixed,24,28,52
463870,True,5,Mixed,7,4,11
463880,True,5,Mixed,10,7,17
463900,True,0,No user reviews,0,0,0
463901,True,0,No user reviews,0,0,0
463902,True,0,No user reviews,0,0,0
463903,True,0,No user reviews,0,0,0
463904,True,0,No user reviews,0,0,0
463920,True,0,4 user reviews,1,3,4
463930,True,8,Very Positive,169,6,175
463940,True,0,No user reviews,0,0,0
463950,True,0,No user reviews,0,0,0
463951,True,0,No user reviews,0,0,0
463980,True,8,Very Positive,143,27,170
463990,True,0,No user reviews,0,0,0
464000,True,6,Mostly Positive,24,8,32
464020,True,0,5 user reviews,2,3,5
464040,True,0,No user reviews,0,0,0
464050,True,0,3 user reviews,2,1,3
464060,True,8,Very Positive,2667,254,2921
464070,True,0,3 user reviews,2,1,3
464080,True,6,Mostly Positive,30,9,39
464100,True,5,Mixed,55,28,83
464110,True,0,5 user reviews,5,0,5
464120,True,0,9 user reviews,8,1,9
464130,True,0,No user reviews,0,0,0
464140,True,0,No user reviews,0,0,0
464150,True,6,Mostly Positive,157,44,201
464160,True,0,1 user reviews,1,0,1
464170,True,5,Mixed,20,16,36
464180,True,0,No user reviews,0,0,0
464190,True,0,1 user reviews,1,0,1
464200,True,0,4 user reviews,2,2,4
464201,True,0,5 user reviews,4,1,5
464202,True,0,7 user reviews,5,2,7
464203,True,0,No user reviews,0,0,0
464204,True,0,3 user reviews,1,2,3
464205,True,0,3 user reviews,1,2,3
464206,True,0,2 user reviews,1,1,2
464210,True,0,2 user reviews,2,0,2
464220,True,0,3 user reviews,3,0,3
464230,True,6,Mostly Positive,16,6,22
464240,True,5,Mixed,11,5,16
464250,True,0,No user reviews,0,0,0
464260,True,7,Positive,19,3,22
464270,True,0,No user reviews,0,0,0
464290,True,0,No user reviews,0,0,0
464300,True,0,3 user reviews,2,1,3
464310,True,0,No user reviews,0,0,0
464320,True,0,No user reviews,0,0,0
464330,True,0,No user reviews,0,0,0
464340,True,5,Mixed,231,292,523
464350,True,8,Very Positive,713,88,801
464360,True,9,Overwhelmingly Positive,748,38,786
464380,True,3,Negative,2,10,12
464390,True,0,No user reviews,0,0,0
464400,True,7,Positive,22,1,23
464410,True,6,Mostly Positive,7,3,10
464420,True,0,9 user reviews,7,2,9
464430,True,0,9 user reviews,9,0,9
464440,True,5,Mixed,15,10,25
464450,True,8,Very Positive,181,9,190
464460,True,0,No user reviews,0,0,0
464470,True,5,Mixed,72,87,159
464490,True,7,Positive,29,1,30
464500,True,7,Positive,27,1,28
464510,True,0,1 user reviews,1,0,1
464511,True,0,1 user reviews,1,0,1
464512,True,0,1 user reviews,1,0,1
464513,True,0,1 user reviews,1,0,1
464520,True,0,1 user reviews,1,0,1
464521,True,0,No user reviews,0,0,0
464522,True,0,1 user reviews,1,0,1
464523,True,0,1 user reviews,1,0,1
464524,True,0,1 user reviews,1,0,1
464525,True,0,No user reviews,0,0,0
464530,True,5,Mixed,9,5,14
464540,True,0,3 user reviews,1,2,3
464550,True,0,No user reviews,0,0,0
464560,True,0,No user reviews,0,0,0
464580,True,0,No user reviews,0,0,0
464590,True,6,Mostly Positive,10,3,13
464591,True,0,7 user reviews,7,0,7
464610,True,0,5 user reviews,5,0,5
464620,True,8,Very Positive,349,25,374
464630,True,0,5 user reviews,0,5,5
464640,True,0,No user reviews,0,0,0
464650,True,7,Positive,24,4,28
464660,True,0,3 user reviews,3,0,3
464670,True,0,8 user reviews,6,2,8
464680,True,0,1 user reviews,0,1,1
464681,True,0,No user reviews,0,0,0
464690,True,3,Negative,5,23,28
464700,True,0,5 user reviews,2,3,5
464720,True,0,2 user reviews,2,0,2
464730,True,0,1 user reviews,1,0,1
464740,True,0,2 user reviews,2,0,2
464760,True,4,Mostly Negative,7,11,18
464780,True,7,Positive,17,2,19
464790,True,0,No user reviews,0,0,0
464800,True,0,1 user reviews,0,1,1
464810,True,0,No user reviews,0,0,0
464820,True,0,6 user reviews,0,6,6
464840,True,7,Positive,32,5,37
464850,True,5,Mixed,146,96,242
464860,True,0,No user reviews,0,0,0
464880,True,6,Mostly Positive,314,90,404
464890,True,5,Mixed,16,8,24
464900,True,7,Positive,28,0,28
464920,True,8,Very Positive,4723,977,5700
464930,True,0,No user reviews,0,0,0
464940,True,0,2 user reviews,2,0,2
464950,True,0,3 user reviews,3,0,3
464960,True,7,Positive,40,2,42
464970,True,0,No user reviews,0,0,0
465000,True,5,Mixed,22,11,33
465010,True,0,2 user reviews,1,1,2
465020,True,8,Very Positive,99,8,107
465040,True,0,1 user reviews,1,0,1
465050,True,0,2 user reviews,2,0,2
465060,True,0,5 user reviews,5,0,5
465070,True,7,Positive,10,0,10
465090,True,0,1 user reviews,0,1,1
465100,True,8,Very Positive,128,17,145
465120,True,0,No user reviews,0,0,0
465130,True,7,Positive,17,3,20
465150,True,7,Positive,21,4,25
465170,True,5,Mixed,30,19,49
465180,True,7,Positive,17,1,18
465190,True,0,7 user reviews,3,4,7
465200,True,8,Very Positive,178,8,186
465210,True,0,No user reviews,0,0,0
465220,True,0,7 user reviews,7,0,7
465230,True,0,1 user reviews,1,0,1
465240,True,8,Very Positive,601,113,714
465250,True,5,Mixed,13,6,19
465280,True,6,Mostly Positive,61,19,80
465290,True,0,No user reviews,0,0,0
465291,True,0,No user reviews,0,0,0
465292,True,0,1 user reviews,1,0,1
465310,True,7,Positive,18,3,21
465320,True,0,No user reviews,0,0,0
465340,True,0,No user reviews,0,0,0
465360,True,7,Positive,29,7,36
465400,True,0,No user reviews,0,0,0
465410,True,0,No user reviews,0,0,0
465420,True,0,No user reviews,0,0,0
465440,True,0,1 user reviews,1,0,1
465450,True,6,Mostly Positive,16,6,22
465460,True,0,No user reviews,0,0,0
465470,True,0,No user reviews,0,0,0
465480,True,8,Very Positive,50,0,50
465490,True,8,Very Positive,557,88,645
465510,True,4,Mostly Negative,6,15,21
465520,True,7,Positive,38,3,41
465530,True,0,No user reviews,0,0,0
465540,True,5,Mixed,6,8,14
465550,True,0,No user reviews,0,0,0
465560,True,0,No user reviews,0,0,0
465570,True,0,No user reviews,0,0,0
465600,True,0,5 user reviews,4,1,5
465610,True,0,No user reviews,0,0,0
465630,True,0,No user reviews,0,0,0
465650,True,8,Very Positive,374,28,402
465660,True,5,Mixed,33,28,61
465670,True,0,3 user reviews,3,0,3
465680,True,0,No user reviews,0,0,0
465691,True,0,1 user reviews,1,0,1
465710,True,0,No user reviews,0,0,0
465720,True,5,Mixed,29,14,43
465730,True,0,1 user reviews,1,0,1
465750,True,0,7 user reviews,6,1,7
465760,True,5,Mixed,33,24,57
465780,True,8,Very Positive,327,74,401
465830,True,0,No user reviews,0,0,0
465831,True,0,No user reviews,0,0,0
465832,True,0,No user reviews,0,0,0
465833,True,0,No user reviews,0,0,0
465834,True,0,No user reviews,0,0,0
465840,True,7,Positive,20,5,25
465860,True,0,3 user reviews,2,1,3
465870,True,5,Mixed,8,5,13
465890,True,7,Positive,11,0,11
465900,True,7,Positive,9,1,10
465920,True,0,4 user reviews,4,0,4
465930,True,5,Mixed,13,8,21
465940,True,0,No user reviews,0,0,0
465950,True,0,No user reviews,0,0,0
465960,True,0,4 user reviews,2,2,4
465970,True,0,2 user reviews,2,0,2
465980,True,7,Positive,35,1,36
465990,True,0,6 user reviews,4,2,6
466000,True,7,Positive,20,0,20
466010,True,0,6 user reviews,6,0,6
466020,True,0,8 user reviews,8,0,8
466030,True,0,7 user reviews,7,0,7
466040,True,0,1 user reviews,1,0,1
466050,True,0,7 user reviews,7,0,7
466060,True,0,8 user reviews,8,0,8
466070,True,0,1 user reviews,1,0,1
466080,True,0,2 user reviews,2,0,2
466100,True,0,7 user reviews,5,2,7
466110,True,8,Very Positive,332,25,357
466130,True,8,Very Positive,110,21,131
466160,True,7,Positive,13,0,13
466170,True,5,Mixed,9,4,13
466200,True,0,2 user reviews,2,0,2
466210,True,0,8 user reviews,3,5,8
466220,True,5,Mixed,96,71,167
466240,True,5,Mixed,491,233,724
466250,True,0,No user reviews,0,0,0
466260,True,0,No user reviews,0,0,0
466270,True,7,Positive,16,3,19
466280,True,0,3 user reviews,2,1,3
466290,True,0,3 user reviews,3,0,3
466300,True,8,Very Positive,1081,69,1150
466350,True,5,Mixed,24,20,44
466360,True,0,No user reviews,0,0,0
466380,True,0,1 user reviews,1,0,1
466390,True,0,7 user reviews,7,0,7
466420,True,5,Mixed,9,7,16
466430,True,8,Very Positive,52,1,53
466440,True,0,No user reviews,0,0,0
466450,True,0,No user reviews,0,0,0
466460,True,0,No user reviews,0,0,0
466490,True,4,Mostly Negative,10,19,29
466500,True,5,Mixed,429,326,755
466510,True,0,No user reviews,0,0,0
466520,True,6,Mostly Positive,14,6,20
466530,True,0,No user reviews,0,0,0
466540,True,6,Mostly Positive,9,3,12
466541,True,0,5 user reviews,4,1,5
466542,True,7,Positive,10,2,12
466543,True,5,Mixed,6,8,14
466544,True,7,Positive,18,3,21
466545,True,7,Positive,15,3,18
466546,True,5,Mixed,12,15,27
466547,True,6,Mostly Positive,7,3,10
466548,True,7,Positive,9,2,11
466549,True,5,Mixed,9,6,15
466550,True,6,Mostly Positive,9,3,12
466551,True,0,6 user reviews,4,2,6
466560,True,8,Very Positive,9228,1507,10735
466580,True,0,2 user reviews,1,1,2
466590,True,0,No user reviews,0,0,0
466630,True,9,Overwhelmingly Positive,657,18,675
466660,True,8,Very Positive,54,12,66
466710,True,7,Positive,13,0,13
466720,True,0,No user reviews,0,0,0
466730,True,5,Mixed,15,14,29
466740,True,6,Mostly Positive,115,42,157
466770,True,0,5 user reviews,5,0,5
466780,True,5,Mixed,6,8,14
466800,True,8,Very Positive,111,27,138
466810,True,7,Positive,19,1,20
466820,True,7,Positive,14,0,14
466840,True,5,Mixed,50,39,89
466860,True,5,Mixed,13,6,19
466870,True,8,Very Positive,104,17,121
466890,True,3,Negative,5,27,32
466900,True,0,2 user reviews,2,0,2
466910,True,6,Mostly Positive,25,7,32
466920,True,6,Mostly Positive,24,9,33
466930,True,0,No user reviews,0,0,0
466940,True,5,Mixed,107,83,190
466960,True,0,No user reviews,0,0,0
466980,True,6,Mostly Positive,54,19,73
467000,True,5,Mixed,32,31,63
467010,True,4,Mostly Negative,8,16,24
467030,True,0,No user reviews,0,0,0
467031,True,0,No user reviews,0,0,0
467032,True,0,No user reviews,0,0,0
467033,True,0,No user reviews,0,0,0
467034,True,0,No user reviews,0,0,0
467035,True,0,No user reviews,0,0,0
467036,True,0,No user reviews,0,0,0
467037,True,0,No user reviews,0,0,0
467038,True,0,No user reviews,0,0,0
467039,True,0,No user reviews,0,0,0
467040,True,0,No user reviews,0,0,0
467041,True,0,No user reviews,0,0,0
467042,True,0,No user reviews,0,0,0
467043,True,0,No user reviews,0,0,0
467044,True,0,No user reviews,0,0,0
467045,True,0,No user reviews,0,0,0
467046,True,0,No user reviews,0,0,0
467047,True,0,No user reviews,0,0,0
467048,True,0,No user reviews,0,0,0
467049,True,0,No user reviews,0,0,0
467050,True,0,No user reviews,0,0,0
467051,True,0,No user reviews,0,0,0
467070,True,0,No user reviews,0,0,0
467090,True,0,6 user reviews,5,1,6
467100,True,0,No user reviews,0,0,0
467110,True,0,No user reviews,0,0,0
467120,True,0,2 user reviews,2,0,2
467130,True,0,1 user reviews,1,0,1
467140,True,0,1 user reviews,1,0,1
467160,True,0,2 user reviews,2,0,2
467170,True,0,5 user reviews,4,1,5
467180,True,0,No user reviews,0,0,0
467190,True,0,No user reviews,0,0,0
467200,True,0,No user reviews,0,0,0
467210,True,8,Very Positive,74,4,78
467220,True,0,6 user reviews,4,2,6
467230,True,0,5 user reviews,5,0,5
467260,True,0,1 user reviews,1,0,1
467270,True,6,Mostly Positive,28,9,37
467290,True,7,Positive,35,6,41
467300,True,0,6 user reviews,6,0,6
467310,True,0,4 user reviews,1,3,4
467320,True,8,Very Positive,47,11,58
467330,True,7,Positive,21,4,25
467340,True,0,No user reviews,0,0,0
467350,True,0,4 user reviews,2,2,4
467360,True,7,Positive,23,4,27
467370,True,5,Mixed,13,13,26
467380,True,7,Positive,29,2,31
467390,True,5,Mixed,35,29,64
467400,True,6,Mostly Positive,22,6,28
467430,True,5,Mixed,13,6,19
467440,True,0,1 user reviews,1,0,1
467470,True,7,Positive,13,0,13
467480,True,0,9 user reviews,5,4,9
467490,True,7,Positive,20,2,22
467500,True,0,1 user reviews,1,0,1
467510,True,0,3 user reviews,3,0,3
467511,True,0,2 user reviews,2,0,2
467512,True,0,3 user reviews,2,1,3
467513,True,0,No user reviews,0,0,0
467514,True,0,No user reviews,0,0,0
467515,True,0,4 user reviews,1,3,4
467516,True,0,No user reviews,0,0,0
467517,True,0,1 user reviews,1,0,1
467518,True,0,No user reviews,0,0,0
467520,True,5,Mixed,111,133,244
467540,True,0,No user reviews,0,0,0
467570,True,4,Mostly Negative,42,75,117
467600,True,0,2 user reviews,2,0,2
467620,True,0,3 user reviews,3,0,3
467650,True,0,1 user reviews,1,0,1
467660,True,6,Mostly Positive,297,88,385
467680,True,6,Mostly Positive,86,31,117
467700,True,0,No user reviews,0,0,0
467710,True,7,Positive,8,2,10
467720,True,5,Mixed,15,8,23
467740,True,0,No user reviews,0,0,0
467750,True,0,No user reviews,0,0,0
467760,True,8,Very Positive,91,7,98
467770,True,0,3 user reviews,3,0,3
467780,True,7,Positive,25,0,25
467790,True,0,3 user reviews,2,1,3
467810,True,7,Positive,36,1,37
467820,True,8,Very Positive,202,20,222
467850,True,5,Mixed,58,27,85
467870,True,0,No user reviews,0,0,0
467890,True,5,Mixed,14,10,24
467900,True,5,Mixed,31,22,53
467910,True,5,Mixed,15,9,24
467930,True,6,Mostly Positive,137,40,177
467940,True,0,7 user reviews,7,0,7
467950,True,6,Mostly Positive,30,12,42
467960,True,5,Mixed,98,79,177
467970,True,0,No user reviews,0,0,0
467980,True,8,Very Positive,279,15,294
467990,True,5,Mixed,72,37,109
468000,True,5,Mixed,42,51,93
468010,True,0,No user reviews,0,0,0
468020,True,0,No user reviews,0,0,0
468040,True,0,No user reviews,0,0,0
468050,True,8,Very Positive,75,4,79
468060,True,8,Very Positive,148,4,152
468070,True,5,Mixed,41,21,62
468080,True,0,2 user reviews,1,1,2
468100,True,6,Mostly Positive,37,12,49
468110,True,7,Positive,10,0,10
468130,True,0,3 user reviews,3,0,3
468140,True,0,No user reviews,0,0,0
468150,True,0,5 user reviews,3,2,5
468160,True,5,Mixed,21,18,39
468170,True,7,Positive,13,3,16
468180,True,0,No user reviews,0,0,0
468190,True,0,No user reviews,0,0,0
468240,True,8,Very Positive,52,6,58
468250,True,6,Mostly Positive,77,28,105
468270,True,0,No user reviews,0,0,0
468280,True,7,Positive,17,2,19
468310,True,7,Positive,17,4,21
468320,True,0,5 user reviews,2,3,5
468330,True,0,5 user reviews,4,1,5
468350,True,0,2 user reviews,1,1,2
468360,True,0,No user reviews,0,0,0
468410,True,8,Very Positive,332,47,379
468420,True,0,No user reviews,0,0,0
468430,True,0,No user reviews,0,0,0
468460,True,0,8 user reviews,6,2,8
468490,True,5,Mixed,76,33,109
468510,True,5,Mixed,5,7,12
468520,True,0,No user reviews,0,0,0
468530,True,7,Positive,28,6,34
468540,True,0,1 user reviews,1,0,1
468550,True,7,Positive,30,0,30
468560,True,5,Mixed,10,15,25
468570,True,5,Mixed,15,22,37
468580,True,0,1 user reviews,1,0,1
468600,True,0,1 user reviews,1,0,1
468610,True,0,No user reviews,0,0,0
468630,True,0,No user reviews,0,0,0
468650,True,0,1 user reviews,0,1,1
468670,True,7,Positive,18,4,22
468680,True,0,No user reviews,0,0,0
468690,True,0,1 user reviews,0,1,1
468700,True,7,Positive,12,2,14
468720,True,0,2 user reviews,1,1,2
468721,True,0,3 user reviews,3,0,3
468722,True,0,No user reviews,0,0,0
468723,True,7,Positive,17,2,19
468724,True,0,No user reviews,0,0,0
468726,True,7,Positive,40,8,48
468727,True,0,6 user reviews,6,0,6
468728,True,0,No user reviews,0,0,0
468729,True,0,1 user reviews,1,0,1
468730,True,6,Mostly Positive,8,3,11
468731,True,0,4 user reviews,4,0,4
468732,True,0,No user reviews,0,0,0
468733,True,5,Mixed,14,9,23
468734,True,0,3 user reviews,2,1,3
468735,True,0,1 user reviews,1,0,1
468736,True,0,3 user reviews,2,1,3
468737,True,7,Positive,21,1,22
468739,True,0,No user reviews,0,0,0
468740,True,7,Positive,18,3,21
468750,True,0,No user reviews,0,0,0
468780,True,0,6 user reviews,6,0,6
468790,True,0,No user reviews,0,0,0
468800,True,5,Mixed,22,12,34
468820,True,8,Very Positive,119,10,129
468890,True,0,No user reviews,0,0,0
468900,True,0,3 user reviews,1,2,3
468920,True,8,Very Positive,897,133,1030
468930,True,5,Mixed,27,17,44
469050,True,0,No user reviews,0,0,0
469520,True,0,No user reviews,0,0,0
469530,True,0,No user reviews,0,0,0
469540,True,0,No user reviews,0,0,0
469550,True,0,5 user reviews,4,1,5
469560,True,5,Mixed,7,5,12
469600,True,6,Mostly Positive,939,263,1202
469610,True,6,Mostly Positive,813,280,1093
469650,True,0,1 user reviews,0,1,1
469660,True,7,Positive,45,1,46
469670,True,0,1 user reviews,1,0,1
469680,True,0,No user reviews,0,0,0
469710,True,7,Positive,16,4,20
469720,True,8,Very Positive,206,36,242
469730,True,8,Very Positive,205,26,231
469740,True,0,1 user reviews,1,0,1
469750,True,0,No user reviews,0,0,0
469780,True,0,1 user reviews,1,0,1
469790,True,8,Very Positive,191,3,194
469800,True,6,Mostly Positive,98,28,126
469820,True,8,Very Positive,2875,275,3150
469850,True,0,1 user reviews,1,0,1
469880,True,0,No user reviews,0,0,0
469890,True,8,Very Positive,56,12,68
469900,True,5,Mixed,5,6,11
469910,True,0,No user reviews,0,0,0
469920,True,6,Mostly Positive,389,114,503
469930,True,0,No user reviews,0,0,0
469940,True,0,No user reviews,0,0,0
469980,True,6,Mostly Positive,9,3,12
469990,True,0,8 user reviews,5,3,8
470000,True,0,2 user reviews,2,0,2
470011,True,0,2 user reviews,2,0,2
470012,True,0,1 user reviews,1,0,1
470020,True,0,1 user reviews,0,1,1
470030,True,0,1 user reviews,1,0,1
470040,True,5,Mixed,8,9,17
470060,True,6,Mostly Positive,31,9,40
470070,True,4,Mostly Negative,52,147,199
470080,True,0,No user reviews,0,0,0
470090,True,7,Positive,13,2,15
470110,True,0,3 user reviews,3,0,3
470120,True,0,1 user reviews,1,0,1
470130,True,0,No user reviews,0,0,0
470140,True,0,1 user reviews,1,0,1
470150,True,0,No user reviews,0,0,0
470151,True,0,1 user reviews,0,1,1
470160,True,0,No user reviews,0,0,0
470170,True,5,Mixed,8,8,16
470180,True,0,No user reviews,0,0,0
470190,True,0,7 user reviews,7,0,7
470200,True,0,No user reviews,0,0,0
470210,True,6,Mostly Positive,33,9,42
470220,True,6,Mostly Positive,8417,2995,11412
470230,True,0,No user reviews,0,0,0
470240,True,0,3 user reviews,2,1,3
470250,True,0,9 user reviews,8,1,9
470260,True,6,Mostly Positive,713,212,925
470270,True,6,Mostly Positive,40,15,55
470280,True,4,Mostly Negative,4,15,19
470290,True,0,No user reviews,0,0,0
470291,True,0,No user reviews,0,0,0
470292,True,0,No user reviews,0,0,0
470300,True,6,Mostly Positive,32,11,43
470310,True,8,Very Positive,999,57,1056
470320,True,0,No user reviews,0,0,0
470330,True,0,No user reviews,0,0,0
470340,True,0,No user reviews,0,0,0
470350,True,0,No user reviews,0,0,0
470360,True,0,No user reviews,0,0,0
470370,True,0,No user reviews,0,0,0
470380,True,0,No user reviews,0,0,0
470390,True,0,No user reviews,0,0,0
470400,True,0,No user reviews,0,0,0
470410,True,0,No user reviews,0,0,0
470420,True,0,No user reviews,0,0,0
470430,True,0,No user reviews,0,0,0
470440,True,7,Positive,11,0,11
470450,True,6,Mostly Positive,9,3,12
470470,True,7,Positive,23,0,23
470480,True,7,Positive,8,2,10
470490,True,5,Mixed,6,4,10
470500,True,0,No user reviews,0,0,0
470540,True,0,No user reviews,0,0,0
470570,True,0,No user reviews,0,0,0
470580,True,7,Positive,12,1,13
470590,True,7,Positive,23,3,26
470610,True,0,1 user reviews,1,0,1
470670,True,0,1 user reviews,1,0,1
470690,True,7,Positive,19,0,19
470691,True,0,4 user reviews,3,1,4
470740,True,6,Mostly Positive,62,21,83
470750,True,5,Mixed,16,10,26
470760,True,0,6 user reviews,4,2,6
470770,True,0,No user reviews,0,0,0
470780,True,8,Very Positive,51,1,52
470800,True,0,No user reviews,0,0,0
470870,True,0,No user reviews,0,0,0
470890,True,0,4 user reviews,0,4,4
471010,True,6,Mostly Positive,292,83,375
471160,True,5,Mixed,15,7,22
471170,True,6,Mostly Positive,19,6,25
471200,True,0,3 user reviews,3,0,3
471220,True,0,3 user reviews,2,1,3
471230,True,0,No user reviews,0,0,0
471240,True,0,3 user reviews,3,0,3
471250,True,0,No user reviews,0,0,0
471260,True,6,Mostly Positive,16,5,21
471270,True,0,7 user reviews,5,2,7
471310,True,0,1 user reviews,0,1,1
471320,True,0,No user reviews,0,0,0
471330,True,8,Very Positive,143,35,178
471350,True,6,Mostly Positive,11,4,15
471380,True,5,Mixed,9,5,14
471390,True,0,3 user reviews,2,1,3
471400,True,0,4 user reviews,4,0,4
471410,True,0,No user reviews,0,0,0
471420,True,0,No user reviews,0,0,0
471450,True,0,No user reviews,0,0,0
471520,True,0,No user reviews,0,0,0
471550,True,6,Mostly Positive,596,156,752
471570,True,7,Positive,36,1,37
471580,True,0,2 user reviews,1,1,2
471610,True,0,No user reviews,0,0,0
471630,True,0,2 user reviews,2,0,2
471640,True,0,7 user reviews,5,2,7
471650,True,5,Mixed,12,16,28
471660,True,8,Very Positive,300,42,342
471700,True,5,Mixed,13,6,19
471710,True,8,Very Positive,99,0,99
471730,True,0,9 user reviews,6,3,9
471740,True,0,1 user reviews,1,0,1
471741,True,0,5 user reviews,5,0,5
471750,True,0,No user reviews,0,0,0
471760,True,0,No user reviews,0,0,0
471770,True,0,6 user reviews,4,2,6
471800,True,0,No user reviews,0,0,0
471810,True,8,Very Positive,110,9,119
471870,True,0,1 user reviews,1,0,1
471880,True,0,No user reviews,0,0,0
471890,True,0,4 user reviews,4,0,4
471891,True,6,Mostly Positive,36,12,48
471893,True,0,No user reviews,0,0,0
471894,True,0,1 user reviews,1,0,1
471895,True,0,1 user reviews,1,0,1
471896,True,0,No user reviews,0,0,0
471897,True,0,No user reviews,0,0,0
471898,True,0,No user reviews,0,0,0
471899,True,6,Mostly Positive,18,6,24
471900,True,0,No user reviews,0,0,0
471920,True,8,Very Positive,56,8,64
472030,True,0,No user reviews,0,0,0
472060,True,0,3 user reviews,3,0,3
472070,True,7,Positive,18,2,20
472350,True,7,Positive,28,4,32
472420,True,8,Very Positive,60,12,72
472490,True,7,Positive,13,2,15
472630,True,0,No user reviews,0,0,0
472670,True,0,No user reviews,0,0,0
472671,True,0,1 user reviews,1,0,1
472680,True,5,Mixed,8,5,13
472690,True,0,7 user reviews,6,1,7
472720,True,0,4 user reviews,3,1,4
472740,True,0,3 user reviews,0,3,3
472750,True,0,No user reviews,0,0,0
472770,True,0,7 user reviews,7,0,7
472810,True,0,3 user reviews,3,0,3
472811,True,0,3 user reviews,3,0,3
472830,True,0,2 user reviews,1,1,2
472840,True,0,6 user reviews,2,4,6
472841,True,0,No user reviews,0,0,0
472850,True,0,No user reviews,0,0,0
472860,True,0,5 user reviews,4,1,5
472861,True,0,No user reviews,0,0,0
472870,True,8,Very Positive,190,0,190
473050,True,0,1 user reviews,0,1,1
473090,True,0,No user reviews,0,0,0
473100,True,0,No user reviews,0,0,0
473110,True,0,No user reviews,0,0,0
473120,True,0,No user reviews,0,0,0
473140,True,0,3 user reviews,0,3,3
473410,True,0,No user reviews,0,0,0
473420,True,0,1 user reviews,1,0,1
473430,True,0,4 user reviews,3,1,4
473440,True,0,3 user reviews,2,1,3
473441,True,0,1 user reviews,1,0,1
473442,True,0,2 user reviews,2,0,2
473443,True,0,3 user reviews,3,0,3
473444,True,7,Positive,10,0,10
473445,True,0,1 user reviews,1,0,1
473446,True,0,3 user reviews,3,0,3
473447,True,0,4 user reviews,4,0,4
473450,True,6,Mostly Positive,62,21,83
473460,True,0,3 user reviews,3,0,3
473470,True,5,Mixed,39,24,63
473480,True,0,3 user reviews,2,1,3
473510,True,7,Positive,15,2,17
473520,True,5,Mixed,7,7,14
473530,True,7,Positive,25,2,27
473540,True,0,5 user reviews,1,4,5
473550,True,0,1 user reviews,0,1,1
473560,True,5,Mixed,58,55,113
473590,True,0,No user reviews,0,0,0
473600,True,0,No user reviews,0,0,0
473610,True,4,Mostly Negative,12,25,37
473660,True,0,No user reviews,0,0,0
473670,True,5,Mixed,28,29,57
473690,True,6,Mostly Positive,4192,1749,5941
473720,True,7,Positive,11,0,11
473770,True,8,Very Positive,528,30,558
473780,True,0,8 user reviews,7,1,8
473790,True,0,No user reviews,0,0,0
473810,True,4,Mostly Negative,6,16,22
473840,True,7,Positive,11,2,13
473850,True,6,Mostly Positive,93,39,132
473870,True,0,2 user reviews,2,0,2
473871,True,0,6 user reviews,6,0,6
473900,True,0,7 user reviews,0,7,7
473910,True,5,Mixed,89,54,143
473920,True,8,Very Positive,103,1,104
473950,True,8,Very Positive,280,11,291
473960,True,0,No user reviews,0,0,0
473970,True,5,Mixed,49,32,81
473980,True,0,No user reviews,0,0,0
474010,True,0,6 user reviews,1,5,6
474020,True,6,Mostly Positive,77,23,100
474030,True,0,No user reviews,0,0,0
474050,True,0,5 user reviews,2,3,5
474210,True,8,Very Positive,390,46,436
474220,True,8,Very Positive,75,10,85
474230,True,0,7 user reviews,7,0,7
474240,True,0,8 user reviews,2,6,8
474260,True,0,No user reviews,0,0,0
474620,True,7,Positive,9,1,10
474720,True,0,4 user reviews,3,1,4
474730,True,0,6 user reviews,4,2,6
474740,True,6,Mostly Positive,47,15,62
474750,True,8,Very Positive,1879,273,2152
474760,True,5,Mixed,12,9,21
474761,True,7,Positive,34,7,41
474762,True,5,Mixed,16,20,36
474763,True,8,Very Positive,64,16,80
474764,True,7,Positive,22,5,27
474765,True,7,Positive,21,5,26
474766,True,7,Positive,23,3,26
474770,True,0,No user reviews,0,0,0
474780,True,0,6 user reviews,0,6,6
474800,True,0,1 user reviews,0,1,1
474801,True,5,Mixed,4,6,10
474802,True,0,No user reviews,0,0,0
474803,True,0,1 user reviews,1,0,1
474810,True,0,4 user reviews,3,1,4
474830,True,6,Mostly Positive,12,4,16
474850,True,0,No user reviews,0,0,0
474860,True,0,No user reviews,0,0,0
474880,True,0,3 user reviews,2,1,3
474890,True,6,Mostly Positive,65,19,84
474910,True,5,Mixed,22,15,37
474930,True,0,1 user reviews,1,0,1
474960,True,8,Very Positive,2957,638,3595
474980,True,8,Very Positive,60,8,68
475010,True,0,1 user reviews,1,0,1
475050,True,0,5 user reviews,2,3,5
475070,True,0,No user reviews,0,0,0
475080,True,0,4 user reviews,1,3,4
475090,True,4,Mostly Negative,6,14,20
475110,True,0,No user reviews,0,0,0
475130,True,0,8 user reviews,6,2,8
475131,True,0,8 user reviews,8,0,8
475132,True,0,8 user reviews,6,2,8
475150,True,8,Very Positive,4084,429,4513
475180,True,4,Mostly Negative,49,166,215
475190,True,8,Very Positive,815,97,912
475210,True,0,3 user reviews,3,0,3
475220,True,0,5 user reviews,0,5,5
475230,True,0,3 user reviews,3,0,3
475240,True,6,Mostly Positive,124,32,156
475280,True,0,No user reviews,0,0,0
475290,True,0,No user reviews,0,0,0
475300,True,0,No user reviews,0,0,0
475320,True,0,No user reviews,0,0,0
475330,True,0,No user reviews,0,0,0
475340,True,0,No user reviews,0,0,0
475350,True,0,1 user reviews,1,0,1
475360,True,0,1 user reviews,1,0,1
475370,True,0,No user reviews,0,0,0
475380,True,0,No user reviews,0,0,0
475390,True,0,1 user reviews,1,0,1
475400,True,0,No user reviews,0,0,0
475410,True,0,No user reviews,0,0,0
475420,True,0,No user reviews,0,0,0
475430,True,5,Mixed,168,96,264
475450,True,0,No user reviews,0,0,0
475460,True,0,1 user reviews,1,0,1
475490,True,6,Mostly Positive,290,76,366
475520,True,6,Mostly Positive,7,3,10
475530,True,0,1 user reviews,1,0,1
475550,True,6,Mostly Positive,1474,372,1846
475620,True,0,7 user reviews,6,1,7
475630,True,5,Mixed,16,8,24
475960,True,7,Positive,16,1,17
476000,True,0,6 user reviews,6,0,6
476010,True,0,1 user reviews,1,0,1
476020,True,5,Mixed,26,15,41
476030,True,0,7 user reviews,2,5,7
476040,True,0,5 user reviews,4,1,5
476041,True,0,No user reviews,0,0,0
476050,True,0,No user reviews,0,0,0
476051,True,0,No user reviews,0,0,0
476052,True,0,No user reviews,0,0,0
476240,True,8,Very Positive,282,14,296
476250,True,0,No user reviews,0,0,0
476350,True,0,No user reviews,0,0,0
476351,True,0,1 user reviews,1,0,1
476352,True,0,2 user reviews,2,0,2
476353,True,0,2 user reviews,1,1,2
476354,True,0,No user reviews,0,0,0
476355,True,0,No user reviews,0,0,0
476356,True,0,No user reviews,0,0,0
476357,True,0,No user reviews,0,0,0
476370,True,0,2 user reviews,1,1,2
476390,True,0,No user reviews,0,0,0
476391,True,0,No user reviews,0,0,0
476392,True,0,No user reviews,0,0,0
476400,True,0,No user reviews,0,0,0
476410,True,7,Positive,31,0,31
476420,True,5,Mixed,76,36,112
476430,True,0,9 user reviews,9,0,9
476440,True,0,No user reviews,0,0,0
476450,True,6,Mostly Positive,18,7,25
476460,True,7,Positive,11,0,11
476470,True,0,1 user reviews,1,0,1
476480,True,5,Mixed,20,19,39
476490,True,8,Very Positive,76,7,83
476500,True,0,No user reviews,0,0,0
476510,True,7,Positive,12,3,15
476520,True,0,No user reviews,0,0,0
476530,True,8,Very Positive,291,29,320
476540,True,0,No user reviews,0,0,0
476561,True,0,No user reviews,0,0,0
476570,True,0,No user reviews,0,0,0
476600,True,5,Mixed,4773,3801,8574
476620,True,6,Mostly Positive,949,324,1273
476650,True,8,Very Positive,150,31,181
476670,True,0,3 user reviews,2,1,3
476680,True,0,No user reviews,0,0,0
476690,True,0,No user reviews,0,0,0
476700,True,6,Mostly Positive,228,71,299
476710,True,0,8 user reviews,1,7,8
476860,True,0,1 user reviews,0,1,1
476861,True,0,2 user reviews,2,0,2
476862,True,0,7 user reviews,5,2,7
476863,True,0,3 user reviews,3,0,3
476864,True,7,Positive,19,0,19
476865,True,0,4 user reviews,4,0,4
476866,True,0,2 user reviews,2,0,2
476867,True,7,Positive,12,0,12
476868,True,7,Positive,19,0,19
476869,True,7,Positive,16,1,17
476870,True,0,9 user reviews,9,0,9
476871,True,7,Positive,14,2,16
476910,True,0,No user reviews,0,0,0
476920,True,5,Mixed,28,31,59
476940,True,0,1 user reviews,1,0,1
476950,True,0,No user reviews,0,0,0
476951,True,0,No user reviews,0,0,0
476952,True,0,No user reviews,0,0,0
477000,True,0,1 user reviews,0,1,1
477010,True,0,2 user reviews,1,1,2
477020,True,0,8 user reviews,8,0,8
477030,True,0,6 user reviews,5,1,6
477040,True,0,No user reviews,0,0,0
477050,True,0,3 user reviews,3,0,3
477130,True,0,4 user reviews,4,0,4
477140,True,0,2 user reviews,1,1,2
477150,True,0,No user reviews,0,0,0
477151,True,0,No user reviews,0,0,0
477160,True,8,Very Positive,13942,776,14718
477170,True,5,Mixed,16,8,24
477180,True,4,Mostly Negative,3,7,10
477190,True,0,3 user reviews,3,0,3
477200,True,0,8 user reviews,8,0,8
477220,True,0,No user reviews,0,0,0
477240,True,0,No user reviews,0,0,0
477260,True,0,No user reviews,0,0,0
477270,True,8,Very Positive,401,93,494
477290,True,6,Mostly Positive,9,3,12
477310,True,7,Positive,38,1,39
477720,True,0,7 user reviews,5,2,7
477730,True,6,Mostly Positive,311,116,427
477740,True,9,Overwhelmingly Positive,1215,56,1271
477750,True,5,Mixed,11,9,20
477760,True,0,No user reviews,0,0,0
477770,True,8,Very Positive,529,115,644
477780,True,0,No user reviews,0,0,0
477781,True,0,No user reviews,0,0,0
477790,True,0,6 user reviews,5,1,6
477800,True,0,1 user reviews,0,1,1
477810,True,0,No user reviews,0,0,0
477820,True,0,5 user reviews,5,0,5
477830,True,0,No user reviews,0,0,0
477840,True,0,No user reviews,0,0,0
477870,True,8,Very Positive,288,71,359
477880,True,0,No user reviews,0,0,0
477881,True,0,4 user reviews,3,1,4
477890,True,0,3 user reviews,2,1,3
477900,True,7,Positive,31,4,35
477910,True,0,2 user reviews,2,0,2
477940,True,0,7 user reviews,2,5,7
477941,True,0,1 user reviews,1,0,1
477942,True,0,1 user reviews,0,1,1
477950,True,0,8 user reviews,7,1,8
477990,True,0,No user reviews,0,0,0
478000,True,0,1 user reviews,0,1,1
478010,True,0,7 user reviews,3,4,7
478020,True,0,2 user reviews,2,0,2
478030,True,0,3 user reviews,3,0,3
478031,True,0,No user reviews,0,0,0
478032,True,0,1 user reviews,1,0,1
478033,True,0,4 user reviews,4,0,4
478034,True,0,1 user reviews,1,0,1
478035,True,0,No user reviews,0,0,0
478036,True,0,No user reviews,0,0,0
478037,True,0,No user reviews,0,0,0
478038,True,0,No user reviews,0,0,0
478039,True,0,No user reviews,0,0,0
478040,True,0,2 user reviews,2,0,2
478041,True,0,No user reviews,0,0,0
478042,True,0,No user reviews,0,0,0
478043,True,0,No user reviews,0,0,0
478044,True,0,No user reviews,0,0,0
478045,True,0,No user reviews,0,0,0
478046,True,0,No user reviews,0,0,0
478047,True,0,No user reviews,0,0,0
478048,True,0,No user reviews,0,0,0
478049,True,0,3 user reviews,3,0,3
478050,True,0,No user reviews,0,0,0
478051,True,0,No user reviews,0,0,0
478052,True,0,No user reviews,0,0,0
478053,True,0,1 user reviews,1,0,1
478054,True,0,No user reviews,0,0,0
478055,True,0,No user reviews,0,0,0
478056,True,0,No user reviews,0,0,0
478057,True,0,1 user reviews,1,0,1
478058,True,0,No user reviews,0,0,0
478200,True,0,No user reviews,0,0,0
478210,True,4,Mostly Negative,7,13,20
478300,True,0,No user reviews,0,0,0
478301,True,0,No user reviews,0,0,0
478950,True,5,Mixed,42,20,62
478960,True,0,1 user reviews,1,0,1
478970,True,0,No user reviews,0,0,0
478980,True,0,7 user reviews,6,1,7
478990,True,0,No user reviews,0,0,0
479000,True,7,Positive,24,6,30
479010,True,6,Mostly Positive,90,27,117
479020,True,5,Mixed,36,19,55
479040,True,5,Mixed,10,7,17
479060,True,0,9 user reviews,7,2,9
479061,True,0,4 user reviews,3,1,4
479100,True,5,Mixed,38,40,78
479110,True,0,9 user reviews,8,1,9
479120,True,0,No user reviews,0,0,0
479130,True,5,Mixed,65,28,93
479140,True,7,Positive,13,2,15
479150,True,0,1 user reviews,1,0,1
479170,True,0,1 user reviews,0,1,1
479180,True,0,5 user reviews,0,5,5
479190,True,0,No user reviews,0,0,0
479200,True,0,2 user reviews,1,1,2
479220,True,0,No user reviews,0,0,0
479230,True,0,4 user reviews,3,1,4
479270,True,0,2 user reviews,1,1,2
479310,True,0,2 user reviews,2,0,2
479330,True,5,Mixed,11,5,16
479990,True,5,Mixed,34,16,50
480410,True,0,6 user reviews,5,1,6
480430,True,6,Mostly Positive,207,55,262
480450,True,8,Very Positive,85,3,88
480470,True,0,No user reviews,0,0,0
480480,True,8,Very Positive,48,12,60
480490,True,8,Very Positive,10291,1135,11426
480500,True,5,Mixed,8,4,12
480520,True,0,8 user reviews,6,2,8
480530,True,5,Mixed,29,16,45
480540,True,0,6 user reviews,5,1,6
480550,True,0,5 user reviews,5,0,5
480560,True,0,No user reviews,0,0,0
480580,True,0,6 user reviews,4,2,6
480590,True,0,3 user reviews,3,0,3
480591,True,0,1 user reviews,1,0,1
480592,True,0,1 user reviews,1,0,1
480593,True,0,1 user reviews,1,0,1
480594,True,0,1 user reviews,1,0,1
480595,True,0,1 user reviews,1,0,1
480600,True,0,No user reviews,0,0,0
480630,True,5,Mixed,315,453,768
480631,True,4,Mostly Negative,420,645,1065
480640,True,5,Mixed,210,124,334
480650,True,8,Very Positive,1293,267,1560
480690,True,7,Positive,31,3,34
480710,True,0,1 user reviews,0,1,1
480720,True,0,2 user reviews,1,1,2
480721,True,0,No user reviews,0,0,0
480722,True,0,No user reviews,0,0,0
480770,True,0,1 user reviews,1,0,1
480780,True,4,Mostly Negative,6,17,23
480900,True,5,Mixed,15,13,28
481080,True,7,Positive,11,1,12
481090,True,6,Mostly Positive,78,28,106
481110,True,5,Mixed,235,117,352
481120,True,0,1 user reviews,1,0,1
481121,True,0,No user reviews,0,0,0
481122,True,0,7 user reviews,6,1,7
481170,True,0,No user reviews,0,0,0
481171,True,0,No user reviews,0,0,0
481172,True,0,4 user reviews,4,0,4
481180,True,8,Very Positive,124,29,153
481190,True,5,Mixed,100,98,198
481360,True,0,8 user reviews,6,2,8
481420,True,5,Mixed,22,14,36
481490,True,0,3 user reviews,3,0,3
481510,True,8,Very Positive,6460,418,6878
481600,True,5,Mixed,11,5,16
481750,True,0,No user reviews,0,0,0
481870,True,5,Mixed,84,42,126
481900,True,0,No user reviews,0,0,0
481910,True,0,No user reviews,0,0,0
481930,True,0,No user reviews,0,0,0
481940,True,0,No user reviews,0,0,0
481950,True,0,4 user reviews,4,0,4
482040,True,0,No user reviews,0,0,0
482050,True,0,No user reviews,0,0,0
482060,True,0,No user reviews,0,0,0
482070,True,0,No user reviews,0,0,0
482210,True,0,5 user reviews,4,1,5
482220,True,0,No user reviews,0,0,0
482221,True,0,2 user reviews,2,0,2
482222,True,0,3 user reviews,3,0,3
482223,True,0,No user reviews,0,0,0
482224,True,0,No user reviews,0,0,0
482300,True,5,Mixed,150,76,226
482330,True,5,Mixed,16,11,27
482340,True,0,No user reviews,0,0,0
482370,True,0,No user reviews,0,0,0
482390,True,0,2 user reviews,2,0,2
482400,True,0,No user reviews,0,0,0
482410,True,0,1 user reviews,1,0,1
482420,True,6,Mostly Positive,11,4,15
482450,True,8,Very Positive,201,21,222
482460,True,0,5 user reviews,3,2,5
482470,True,0,No user reviews,0,0,0
482480,True,0,No user reviews,0,0,0
482490,True,0,No user reviews,0,0,0
482500,True,0,No user reviews,0,0,0
482510,True,0,No user reviews,0,0,0
482520,True,0,No user reviews,0,0,0
482530,True,0,No user reviews,0,0,0
482540,True,0,No user reviews,0,0,0
482550,True,0,No user reviews,0,0,0
482560,True,0,No user reviews,0,0,0
482570,True,0,No user reviews,0,0,0
482580,True,0,No user reviews,0,0,0
482590,True,0,No user reviews,0,0,0
482600,True,0,No user reviews,0,0,0
482610,True,0,No user reviews,0,0,0
482620,True,0,No user reviews,0,0,0
482630,True,0,No user reviews,0,0,0
482640,True,0,No user reviews,0,0,0
482650,True,0,No user reviews,0,0,0
482660,True,0,No user reviews,0,0,0
482670,True,0,No user reviews,0,0,0
482680,True,0,No user reviews,0,0,0
482690,True,0,No user reviews,0,0,0
482700,True,0,No user reviews,0,0,0
482710,True,0,No user reviews,0,0,0
482720,True,0,No user reviews,0,0,0
482770,True,0,No user reviews,0,0,0
482850,True,0,No user reviews,0,0,0
482870,True,0,No user reviews,0,0,0
482890,True,3,Negative,5,22,27
482920,True,5,Mixed,8,4,12
482990,True,7,Positive,45,3,48
483280,True,0,No user reviews,0,0,0
483300,True,0,No user reviews,0,0,0
483420,True,8,Very Positive,211,25,236
483450,True,5,Mixed,15,22,37
483490,True,0,4 user reviews,4,0,4
483670,True,0,No user reviews,0,0,0
483680,True,0,1 user reviews,1,0,1
483690,True,0,No user reviews,0,0,0
483700,True,0,No user reviews,0,0,0
483710,True,0,No user reviews,0,0,0
483720,True,0,No user reviews,0,0,0
483730,True,0,No user reviews,0,0,0
483740,True,0,No user reviews,0,0,0
483770,True,5,Mixed,53,67,120
483790,True,0,4 user reviews,4,0,4
483800,True,0,No user reviews,0,0,0
483810,True,0,1 user reviews,1,0,1
483820,True,0,1 user reviews,1,0,1
483830,True,0,No user reviews,0,0,0
483840,True,8,Very Positive,185,43,228
483850,True,5,Mixed,9,4,13
483870,True,0,No user reviews,0,0,0
483880,True,0,No user reviews,0,0,0
483890,True,0,No user reviews,0,0,0
483900,True,0,No user reviews,0,0,0
483910,True,0,No user reviews,0,0,0
483920,True,0,No user reviews,0,0,0
483940,True,0,No user reviews,0,0,0
483941,True,0,1 user reviews,1,0,1
483950,True,8,Very Positive,84,11,95
483960,True,5,Mixed,92,56,148
483970,True,8,Very Positive,42,8,50
483980,True,9,Overwhelmingly Positive,942,29,971
484340,True,0,No user reviews,0,0,0
484350,True,6,Mostly Positive,104,38,142
484360,True,0,No user reviews,0,0,0
484390,True,0,8 user reviews,8,0,8
484810,True,0,1 user reviews,1,0,1
484820,True,0,No user reviews,0,0,0
484830,True,6,Mostly Positive,8,3,11
484840,True,0,8 user reviews,7,1,8
484860,True,5,Mixed,8,4,12
484870,True,8,Very Positive,357,43,400
484890,True,0,7 user reviews,5,2,7
484900,True,6,Mostly Positive,474,159,633
484910,True,0,No user reviews,0,0,0
484920,True,0,No user reviews,0,0,0
484930,True,7,Positive,12,3,15
484940,True,0,No user reviews,0,0,0
484950,True,5,Mixed,86,48,134
484970,True,0,4 user reviews,4,0,4
484990,True,0,1 user reviews,1,0,1
485000,True,5,Mixed,7,4,11
485010,True,0,No user reviews,0,0,0
485020,True,0,No user reviews,0,0,0
485030,True,6,Mostly Positive,100,28,128
485040,True,8,Very Positive,118,20,138
485050,True,0,No user reviews,0,0,0
485070,True,0,No user reviews,0,0,0
485080,True,5,Mixed,13,7,20
485090,True,0,No user reviews,0,0,0
485100,True,0,No user reviews,0,0,0
485110,True,7,Positive,11,2,13
485120,True,7,Positive,34,2,36
485130,True,0,No user reviews,0,0,0
485140,True,0,No user reviews,0,0,0
485141,True,0,1 user reviews,0,1,1
485142,True,0,No user reviews,0,0,0
485143,True,0,No user reviews,0,0,0
485144,True,0,1 user reviews,1,0,1
485145,True,0,1 user reviews,1,0,1
485146,True,0,No user reviews,0,0,0
485150,True,0,5 user reviews,2,3,5
485160,True,0,9 user reviews,7,2,9
485170,True,0,No user reviews,0,0,0
485180,True,0,No user reviews,0,0,0
485190,True,0,No user reviews,0,0,0
485200,True,0,No user reviews,0,0,0
485210,True,0,No user reviews,0,0,0
485230,True,0,2 user reviews,1,1,2
485240,True,5,Mixed,14,12,26
485250,True,0,No user reviews,0,0,0
485260,True,0,4 user reviews,3,1,4
485270,True,0,8 user reviews,1,7,8
485280,True,7,Positive,42,0,42
485290,True,0,9 user reviews,9,0,9
485300,True,0,No user reviews,0,0,0
485301,True,0,No user reviews,0,0,0
485302,True,0,No user reviews,0,0,0
485310,True,5,Mixed,11,13,24
485330,True,4,Mostly Negative,15,31,46
485340,True,6,Mostly Positive,10,3,13
485350,True,5,Mixed,56,25,81
485360,True,8,Very Positive,43,9,52
485370,True,5,Mixed,79,37,116
485380,True,8,Very Positive,986,227,1213
485390,True,0,2 user reviews,0,2,2
485430,True,0,4 user reviews,2,2,4
485440,True,4,Mostly Negative,17,30,47
485450,True,5,Mixed,71,47,118
485460,True,8,Very Positive,527,129,656
485490,True,8,Very Positive,52,12,64
485500,True,5,Mixed,9,7,16
485510,True,8,Very Positive,3890,943,4833
485560,True,0,4 user reviews,4,0,4
485570,True,0,4 user reviews,4,0,4
485590,True,0,3 user reviews,2,1,3
485600,True,7,Positive,26,5,31
485610,True,7,Positive,30,5,35
485620,True,6,Mostly Positive,22,7,29
485630,True,5,Mixed,8,10,18
485640,True,5,Mixed,11,5,16
485650,True,0,5 user reviews,2,3,5
485660,True,0,9 user reviews,3,6,9
485670,True,5,Mixed,35,47,82
485680,True,7,Positive,18,1,19
485690,True,5,Mixed,122,62,184
485710,True,0,No user reviews,0,0,0
485720,True,0,No user reviews,0,0,0
485730,True,6,Mostly Positive,43,15,58
485740,True,5,Mixed,15,8,23
485750,True,5,Mixed,8,6,14
485760,True,0,No user reviews,0,0,0
485770,True,0,No user reviews,0,0,0
485790,True,0,3 user reviews,1,2,3
485800,True,0,2 user reviews,1,1,2
485810,True,0,No user reviews,0,0,0
485820,True,5,Mixed,19,21,40
485830,True,5,Mixed,6,7,13
485840,True,0,No user reviews,0,0,0
485860,True,5,Mixed,46,37,83
485870,True,8,Very Positive,99,19,118
485880,True,7,Positive,37,2,39
485890,True,5,Mixed,192,186,378
485900,True,8,Very Positive,119,22,141
485920,True,5,Mixed,8,6,14
485950,True,4,Mostly Negative,16,46,62
485960,True,0,No user reviews,0,0,0
485970,True,7,Positive,9,1,10
485980,True,8,Very Positive,699,135,834
485990,True,0,1 user reviews,1,0,1
486000,True,0,No user reviews,0,0,0
486001,True,0,No user reviews,0,0,0
486002,True,0,1 user reviews,1,0,1
486003,True,0,3 user reviews,3,0,3
486004,True,0,2 user reviews,1,1,2
486005,True,0,2 user reviews,1,1,2
486006,True,0,5 user reviews,4,1,5
486007,True,0,1 user reviews,1,0,1
486008,True,0,No user reviews,0,0,0
486009,True,0,No user reviews,0,0,0
486010,True,0,No user reviews,0,0,0
486011,True,0,No user reviews,0,0,0
486012,True,0,No user reviews,0,0,0
486020,True,0,4 user reviews,2,2,4
486040,True,0,2 user reviews,2,0,2
486050,True,0,No user reviews,0,0,0
486100,True,0,5 user reviews,1,4,5
486110,True,0,1 user reviews,1,0,1
486120,True,0,3 user reviews,1,2,3
486130,True,0,5 user reviews,2,3,5
486140,True,0,3 user reviews,2,1,3
486150,True,4,Mostly Negative,6,10,16
486160,True,0,No user reviews,0,0,0
486170,True,0,6 user reviews,1,5,6
486180,True,0,3 user reviews,3,0,3
486190,True,0,3 user reviews,3,0,3
486200,True,0,No user reviews,0,0,0
486210,True,0,No user reviews,0,0,0
486220,True,0,2 user reviews,2,0,2
486230,True,6,Mostly Positive,7,3,10
486270,True,0,No user reviews,0,0,0
486290,True,7,Positive,21,0,21
486300,True,4,Mostly Negative,3,8,11
486310,True,8,Very Positive,1684,180,1864
486320,True,0,1 user reviews,1,0,1
486350,True,0,2 user reviews,2,0,2
486360,True,0,7 user reviews,6,1,7
486370,True,7,Positive,20,4,24
486380,True,8,Very Positive,75,2,77
486420,True,0,No user reviews,0,0,0
486430,True,0,No user reviews,0,0,0
486440,True,7,Positive,19,4,23
486460,True,0,No user reviews,0,0,0
486470,True,5,Mixed,8,8,16
486480,True,0,8 user reviews,0,8,8
486490,True,0,9 user reviews,6,3,9
486500,True,0,2 user reviews,0,2,2
486510,True,8,Very Positive,147,26,173
486520,True,0,No user reviews,0,0,0
486530,True,0,No user reviews,0,0,0
486540,True,5,Mixed,25,12,37
486550,True,0,2 user reviews,0,2,2
486560,True,0,No user reviews,0,0,0
486570,True,5,Mixed,118,59,177
486571,True,5,Mixed,9,5,14
486590,True,0,No user reviews,0,0,0
486610,True,0,No user reviews,0,0,0
486630,True,0,5 user reviews,4,1,5
486640,True,0,5 user reviews,2,3,5
486650,True,6,Mostly Positive,172,44,216
486660,True,0,4 user reviews,4,0,4
486670,True,0,4 user reviews,2,2,4
486690,True,0,7 user reviews,4,3,7
486710,True,0,No user reviews,0,0,0
486720,True,8,Very Positive,309,38,347
486760,True,0,1 user reviews,0,1,1
486770,True,0,1 user reviews,1,0,1
486780,True,8,Very Positive,349,72,421
486810,True,7,Positive,24,5,29
486830,True,0,No user reviews,0,0,0
486850,True,5,Mixed,5,5,10
486860,True,8,Very Positive,259,38,297
486880,True,4,Mostly Negative,2,8,10
486890,True,0,1 user reviews,1,0,1
486940,True,0,4 user reviews,4,0,4
486960,True,0,No user reviews,0,0,0
486970,True,5,Mixed,10,15,25
486990,True,0,5 user reviews,2,3,5
487000,True,8,Very Positive,399,87,486
487010,True,0,1 user reviews,1,0,1
487020,True,7,Positive,13,1,14
487030,True,6,Mostly Positive,10,4,14
487040,True,6,Mostly Positive,10,4,14
487050,True,0,1 user reviews,1,0,1
487120,True,5,Mixed,1749,950,2699
487130,True,0,1 user reviews,1,0,1
487150,True,0,5 user reviews,3,2,5
487160,True,7,Positive,39,3,42
487180,True,5,Mixed,11,5,16
487210,True,6,Mostly Positive,95,27,122
487220,True,6,Mostly Positive,113,44,157
487240,True,7,Positive,10,0,10
487250,True,0,7 user reviews,5,2,7
487270,True,4,Mostly Negative,2,8,10
487280,True,8,Very Positive,56,7,63
487300,True,0,2 user reviews,2,0,2
487320,True,0,6 user reviews,3,3,6
487330,True,5,Mixed,13,7,20
487350,True,7,Positive,10,0,10
487370,True,5,Mixed,12,6,18
487380,True,0,8 user reviews,6,2,8
487390,True,0,No user reviews,0,0,0
487410,True,0,No user reviews,0,0,0
487420,True,0,5 user reviews,3,2,5
487430,True,8,Very Positive,169,12,181
487460,True,0,2 user reviews,2,0,2
487470,True,0,No user reviews,0,0,0
487480,True,0,1 user reviews,1,0,1
487490,True,0,No user reviews,0,0,0
487500,True,0,No user reviews,0,0,0
487510,True,0,No user reviews,0,0,0
487520,True,0,No user reviews,0,0,0
487530,True,5,Mixed,5,7,12
487540,True,0,No user reviews,0,0,0
487570,True,0,5 user reviews,4,1,5
487580,True,0,9 user reviews,5,4,9
487590,True,0,8 user reviews,7,1,8
487600,True,0,7 user reviews,6,1,7
487610,True,0,No user reviews,0,0,0
487630,True,5,Mixed,5,7,12
487680,True,0,No user reviews,0,0,0
487700,True,8,Very Positive,184,11,195
487710,True,0,No user reviews,0,0,0
487720,True,5,Mixed,341,447,788
487730,True,0,4 user reviews,4,0,4
487740,True,0,No user reviews,0,0,0
487770,True,6,Mostly Positive,26,7,33
487780,True,0,No user reviews,0,0,0
487800,True,0,No user reviews,0,0,0
487820,True,0,No user reviews,0,0,0
487840,True,0,No user reviews,0,0,0
487860,True,0,No user reviews,0,0,0
487880,True,0,No user reviews,0,0,0
487900,True,0,No user reviews,0,0,0
487920,True,0,No user reviews,0,0,0
487990,True,0,1 user reviews,1,0,1
488000,True,0,No user reviews,0,0,0
488010,True,0,2 user reviews,1,1,2
488020,True,0,2 user reviews,1,1,2
488040,True,6,Mostly Positive,47,14,61
488050,True,0,4 user reviews,3,1,4
488060,True,8,Very Positive,137,29,166
488070,True,0,7 user reviews,3,4,7
488080,True,0,1 user reviews,1,0,1
488110,True,0,No user reviews,0,0,0
488120,True,0,No user reviews,0,0,0
488130,True,0,No user reviews,0,0,0
488140,True,0,No user reviews,0,0,0
488150,True,5,Mixed,16,8,24
488160,True,0,No user reviews,0,0,0
488190,True,0,No user reviews,0,0,0
488210,True,5,Mixed,19,17,36
488220,True,0,2 user reviews,2,0,2
488250,True,0,1 user reviews,1,0,1
488260,True,0,1 user reviews,1,0,1
488280,True,8,Very Positive,88,17,105
488300,True,6,Mostly Positive,143,38,181
488310,True,9,Overwhelmingly Positive,1142,59,1201
488320,True,0,No user reviews,0,0,0
488330,True,0,1 user reviews,0,1,1
488340,True,7,Positive,26,3,29
488350,True,4,Mostly Negative,13,34,47
488360,True,5,Mixed,10,14,24
488370,True,0,1 user reviews,1,0,1
488380,True,0,No user reviews,0,0,0
488390,True,0,3 user reviews,3,0,3
488400,True,0,No user reviews,0,0,0
488430,True,0,No user reviews,0,0,0
488440,True,0,4 user reviews,2,2,4
488460,True,0,2 user reviews,2,0,2
488470,True,7,Positive,16,1,17
488480,True,0,2 user reviews,2,0,2
488500,True,0,1 user reviews,1,0,1
488520,True,0,5 user reviews,5,0,5
488530,True,0,No user reviews,0,0,0
488550,True,8,Very Positive,283,27,310
488560,True,0,1 user reviews,1,0,1
488580,True,6,Mostly Positive,21,6,27
488590,True,7,Positive,20,2,22
488620,True,0,No user reviews,0,0,0
488630,True,0,No user reviews,0,0,0
488640,True,0,No user reviews,0,0,0
488650,True,0,2 user reviews,2,0,2
488660,True,8,Very Positive,118,26,144
488690,True,7,Positive,16,4,20
488700,True,0,1 user reviews,1,0,1
488730,True,6,Mostly Positive,72,27,99
488750,True,0,1 user reviews,1,0,1
488760,True,8,Very Positive,88,14,102
488770,True,6,Mostly Positive,126,35,161
488790,True,6,Mostly Positive,5339,1678,7017
488800,True,0,No user reviews,0,0,0
488810,True,0,7 user reviews,6,1,7
488811,True,0,6 user reviews,5,1,6
488812,True,0,5 user reviews,4,1,5
488820,True,0,3 user reviews,3,0,3
488821,True,0,2 user reviews,0,2,2
488822,True,0,2 user reviews,1,1,2
488823,True,0,2 user reviews,2,0,2
488824,True,0,2 user reviews,1,1,2
488850,True,0,No user reviews,0,0,0
488860,True,0,No user reviews,0,0,0
488890,True,7,Positive,13,3,16
488910,True,0,3 user reviews,2,1,3
488920,True,6,Mostly Positive,181,49,230
488930,True,0,No user reviews,0,0,0
488950,True,5,Mixed,55,29,84
488960,True,7,Positive,11,1,12
488970,True,0,No user reviews,0,0,0
488980,True,0,No user reviews,0,0,0
488981,True,0,No user reviews,0,0,0
488990,True,0,No user reviews,0,0,0
488991,True,0,No user reviews,0,0,0
488992,True,0,No user reviews,0,0,0
488993,True,0,No user reviews,0,0,0
488994,True,0,No user reviews,0,0,0
488995,True,0,No user reviews,0,0,0
488996,True,0,1 user reviews,1,0,1
488997,True,0,No user reviews,0,0,0
488998,True,0,No user reviews,0,0,0
488999,True,0,No user reviews,0,0,0
489000,True,0,2 user reviews,0,2,2
489010,True,0,No user reviews,0,0,0
489020,True,5,Mixed,48,39,87
489030,True,0,No user reviews,0,0,0
489040,True,0,8 user reviews,8,0,8
489050,True,0,6 user reviews,2,4,6
489070,True,4,Mostly Negative,4,8,12
489080,True,0,2 user reviews,1,1,2
489090,True,0,No user reviews,0,0,0
489100,True,0,8 user reviews,7,1,8
489110,True,7,Positive,34,0,34
489120,True,0,5 user reviews,5,0,5
489140,True,8,Very Positive,300,37,337
489160,True,0,4 user reviews,3,1,4
489170,True,5,Mixed,28,15,43
489180,True,5,Mixed,45,21,66
489200,True,0,No user reviews,0,0,0
489220,True,5,Mixed,6,4,10
489240,True,0,7 user reviews,0,7,7
489250,True,0,No user reviews,0,0,0
489260,True,5,Mixed,26,19,45
489300,True,0,No user reviews,0,0,0
489320,True,0,No user reviews,0,0,0
489330,True,0,No user reviews,0,0,0
489350,True,0,No user reviews,0,0,0
489360,True,6,Mostly Positive,281,97,378
489370,True,5,Mixed,68,40,108
489380,True,8,Very Positive,355,32,387
489400,True,0,8 user reviews,6,2,8
489410,True,0,No user reviews,0,0,0
489440,True,6,Mostly Positive,23,6,29
489450,True,0,No user reviews,0,0,0
489460,True,6,Mostly Positive,200,82,282
489470,True,4,Mostly Negative,11,20,31
489490,True,0,2 user reviews,1,1,2
489500,True,0,No user reviews,0,0,0
489520,True,8,Very Positive,433,94,527
489530,True,0,2 user reviews,1,1,2
489540,True,0,No user reviews,0,0,0
489560,True,0,1 user reviews,1,0,1
489570,True,5,Mixed,20,17,37
489580,True,6,Mostly Positive,12,5,17
489590,True,0,2 user reviews,2,0,2
489600,True,6,Mostly Positive,251,99,350
489610,True,8,Very Positive,123,18,141
489620,True,0,No user reviews,0,0,0
489630,True,8,Very Positive,1348,332,1680
489640,True,0,No user reviews,0,0,0
489650,True,0,No user reviews,0,0,0
489660,True,6,Mostly Positive,30,10,40
489670,True,0,No user reviews,0,0,0
489700,True,0,3 user reviews,1,2,3
489720,True,7,Positive,16,2,18
489730,True,0,1 user reviews,1,0,1
489740,True,0,8 user reviews,6,2,8
489750,True,0,6 user reviews,2,4,6
489760,True,7,Positive,24,2,26
489780,True,0,1 user reviews,1,0,1
489810,True,0,5 user reviews,5,0,5
489830,True,8,Very Positive,29179,1905,31084
489890,True,5,Mixed,9,6,15
489900,True,0,2 user reviews,1,1,2
489910,True,0,5 user reviews,5,0,5
489920,True,0,No user reviews,0,0,0
489930,True,8,Very Positive,48,12,60
489940,True,5,Mixed,5648,3399,9047
489950,True,0,No user reviews,0,0,0
489970,True,0,No user reviews,0,0,0
489971,True,0,No user reviews,0,0,0
489972,True,0,No user reviews,0,0,0
489973,True,0,No user reviews,0,0,0
489974,True,0,No user reviews,0,0,0
489975,True,0,No user reviews,0,0,0
489976,True,0,No user reviews,0,0,0
489977,True,0,No user reviews,0,0,0
489978,True,0,No user reviews,0,0,0
489980,True,0,No user reviews,0,0,0
489990,True,0,No user reviews,0,0,0
490040,True,0,9 user reviews,8,1,9
490060,True,5,Mixed,20,15,35
490070,True,0,No user reviews,0,0,0
490071,True,0,No user reviews,0,0,0
490072,True,0,No user reviews,0,0,0
490073,True,0,No user reviews,0,0,0
490074,True,0,No user reviews,0,0,0
490075,True,0,No user reviews,0,0,0
490076,True,0,No user reviews,0,0,0
490080,True,5,Mixed,15,21,36
490090,True,6,Mostly Positive,19,8,27
490100,True,7,Positive,30,0,30
490130,True,0,1 user reviews,1,0,1
490160,True,7,Positive,32,1,33
490170,True,7,Positive,16,1,17
490180,True,0,5 user reviews,5,0,5
490190,True,0,1 user reviews,1,0,1
490191,True,0,1 user reviews,1,0,1
490192,True,0,No user reviews,0,0,0
490220,True,8,Very Positive,86,8,94
490230,True,7,Positive,21,1,22
490240,True,0,No user reviews,0,0,0
490250,True,7,Positive,18,4,22
490260,True,7,Positive,16,0,16
490270,True,7,Positive,33,1,34
490280,True,8,Very Positive,149,24,173
490300,True,0,4 user reviews,3,1,4
490310,True,0,5 user reviews,5,0,5
490320,True,0,8 user reviews,8,0,8
490330,True,5,Mixed,17,9,26
490360,True,0,No user reviews,0,0,0
490370,True,8,Very Positive,136,24,160
490380,True,3,Negative,4,20,24
490390,True,5,Mixed,7,4,11
490410,True,0,No user reviews,0,0,0
490411,True,0,No user reviews,0,0,0
490412,True,0,No user reviews,0,0,0
490430,True,0,1 user reviews,1,0,1
490450,True,6,Mostly Positive,117,45,162
490480,True,0,No user reviews,0,0,0
490490,True,8,Very Positive,135,16,151
490500,True,0,No user reviews,0,0,0
490510,True,0,7 user reviews,7,0,7
490520,True,0,No user reviews,0,0,0
490530,True,0,No user reviews,0,0,0
490540,True,0,No user reviews,0,0,0
490550,True,0,No user reviews,0,0,0
490560,True,0,No user reviews,0,0,0
490570,True,0,No user reviews,0,0,0
490580,True,0,No user reviews,0,0,0
490590,True,0,No user reviews,0,0,0
490600,True,0,No user reviews,0,0,0
490610,True,0,No user reviews,0,0,0
490620,True,0,No user reviews,0,0,0
490630,True,0,No user reviews,0,0,0
490640,True,0,No user reviews,0,0,0
490650,True,5,Mixed,719,621,1340
490660,True,0,No user reviews,0,0,0
490670,True,0,No user reviews,0,0,0
490680,True,0,No user reviews,0,0,0
490690,True,7,Positive,11,2,13
490700,True,0,No user reviews,0,0,0
490710,True,0,No user reviews,0,0,0
490720,True,0,No user reviews,0,0,0
490730,True,0,No user reviews,0,0,0
490740,True,0,No user reviews,0,0,0
490750,True,0,No user reviews,0,0,0
490760,True,0,No user reviews,0,0,0
490770,True,0,No user reviews,0,0,0
490780,True,0,No user reviews,0,0,0
490790,True,0,No user reviews,0,0,0
490800,True,0,No user reviews,0,0,0
490810,True,0,No user reviews,0,0,0
490820,True,8,Very Positive,66,16,82
490830,True,0,No user reviews,0,0,0
490850,True,0,2 user reviews,2,0,2
490860,True,7,Positive,27,3,30
490870,True,0,7 user reviews,5,2,7
490880,True,6,Mostly Positive,12,5,17
490890,True,6,Mostly Positive,24,8,32
490910,True,0,3 user reviews,2,1,3
490920,True,8,Very Positive,488,36,524
490930,True,6,Mostly Positive,90,25,115
490950,True,8,Very Positive,56,6,62
490980,True,6,Mostly Positive,31,10,41
490990,True,4,Mostly Negative,13,28,41
491000,True,6,Mostly Positive,93,30,123
491010,True,6,Mostly Positive,12,5,17
491020,True,0,2 user reviews,1,1,2
491040,True,8,Very Positive,401,21,422
491060,True,7,Positive,13,3,16
491070,True,0,3 user reviews,2,1,3
491090,True,5,Mixed,65,45,110
491100,True,0,1 user reviews,1,0,1
491110,True,0,5 user reviews,5,0,5
491130,True,7,Positive,14,2,16
491160,True,5,Mixed,20,10,30
491180,True,0,8 user reviews,5,3,8
491210,True,7,Positive,13,3,16
491220,True,6,Mostly Positive,7,3,10
491230,True,0,No user reviews,0,0,0
491240,True,7,Positive,12,0,12
491260,True,5,Mixed,35,21,56
491280,True,4,Mostly Negative,50,85,135
491290,True,0,3 user reviews,2,1,3
491300,True,0,No user reviews,0,0,0
491310,True,0,No user reviews,0,0,0
491320,True,0,No user reviews,0,0,0
491330,True,8,Very Positive,88,5,93
491340,True,0,1 user reviews,1,0,1
491350,True,7,Positive,24,2,26
491370,True,0,No user reviews,0,0,0
491380,True,0,No user reviews,0,0,0
491390,True,0,8 user reviews,8,0,8
491400,True,0,4 user reviews,3,1,4
491401,True,0,No user reviews,0,0,0
491402,True,0,No user reviews,0,0,0
491403,True,0,1 user reviews,1,0,1
491410,True,0,1 user reviews,0,1,1
491420,True,0,4 user reviews,3,1,4
491440,True,0,9 user reviews,7,2,9
491460,True,0,No user reviews,0,0,0
491470,True,5,Mixed,22,10,32
491480,True,0,No user reviews,0,0,0
491490,True,5,Mixed,10,5,15
491491,True,0,7 user reviews,6,1,7
491492,True,0,8 user reviews,6,2,8
491493,True,0,2 user reviews,2,0,2
491494,True,6,Mostly Positive,8,3,11
491495,True,5,Mixed,15,9,24
491496,True,0,4 user reviews,1,3,4
491498,True,0,8 user reviews,7,1,8
491499,True,0,4 user reviews,2,2,4
491500,True,0,No user reviews,0,0,0
491510,True,5,Mixed,10,6,16
491520,True,4,Mostly Negative,19,30,49
491530,True,6,Mostly Positive,229,94,323
491540,True,0,No user reviews,0,0,0
491550,True,0,No user reviews,0,0,0
491560,True,5,Mixed,9,7,16
491580,True,5,Mixed,6,4,10
491600,True,0,No user reviews,0,0,0
491610,True,0,No user reviews,0,0,0
491611,True,0,No user reviews,0,0,0
491612,True,0,No user reviews,0,0,0
491613,True,0,No user reviews,0,0,0
491620,True,7,Positive,26,6,32
491640,True,0,No user reviews,0,0,0
491650,True,5,Mixed,13,12,25
491660,True,0,6 user reviews,5,1,6
491670,True,6,Mostly Positive,18,7,25
491680,True,0,No user reviews,0,0,0
491690,True,0,3 user reviews,3,0,3
491700,True,0,9 user reviews,5,4,9
491710,True,0,8 user reviews,1,7,8
491720,True,0,8 user reviews,8,0,8
491740,True,0,2 user reviews,1,1,2
491770,True,4,Mostly Negative,16,36,52
491780,True,0,1 user reviews,1,0,1
491790,True,0,1 user reviews,0,1,1
491800,True,0,6 user reviews,1,5,6
491830,True,7,Positive,10,1,11
491840,True,0,No user reviews,0,0,0
491940,True,0,No user reviews,0,0,0
491950,True,8,Very Positive,3496,324,3820
491960,True,0,No user reviews,0,0,0
491970,True,0,No user reviews,0,0,0
491980,True,0,No user reviews,0,0,0
491990,True,0,No user reviews,0,0,0
492000,True,0,No user reviews,0,0,0
492010,True,0,No user reviews,0,0,0
492020,True,0,No user reviews,0,0,0
492030,True,0,No user reviews,0,0,0
492040,True,0,No user reviews,0,0,0
492050,True,0,No user reviews,0,0,0
492060,True,0,No user reviews,0,0,0
492070,True,0,1 user reviews,1,0,1
492080,True,5,Mixed,18,8,26
492090,True,6,Mostly Positive,12,5,17
492100,True,0,No user reviews,0,0,0
492140,True,6,Mostly Positive,32,9,41
492150,True,5,Mixed,98,44,142
492160,True,0,6 user reviews,2,4,6
492170,True,0,9 user reviews,4,5,9
492180,True,7,Positive,18,2,20
492200,True,0,3 user reviews,3,0,3
492220,True,5,Mixed,47,24,71
492230,True,5,Mixed,165,89,254
492250,True,0,No user reviews,0,0,0
492260,True,0,No user reviews,0,0,0
492270,True,5,Mixed,28,18,46
492280,True,5,Mixed,8,5,13
492290,True,6,Mostly Positive,96,28,124
492320,True,0,No user reviews,0,0,0
492330,True,0,1 user reviews,0,1,1
492331,True,0,No user reviews,0,0,0
492340,True,8,Very Positive,57,10,67
492360,True,0,No user reviews,0,0,0
492370,True,6,Mostly Positive,44,14,58
492380,True,0,No user reviews,0,0,0
492390,True,0,1 user reviews,1,0,1
492391,True,0,1 user reviews,0,1,1
492392,True,0,No user reviews,0,0,0
492400,True,0,3 user reviews,2,1,3
492410,True,6,Mostly Positive,12,4,16
492430,True,5,Mixed,17,13,30
492470,True,7,Positive,12,2,14
492480,True,0,5 user reviews,5,0,5
492490,True,4,Mostly Negative,9,17,26
492500,True,6,Mostly Positive,103,30,133
492510,True,7,Positive,16,4,20
492520,True,0,No user reviews,0,0,0
492530,True,7,Positive,38,8,46
492540,True,0,No user reviews,0,0,0
492560,True,0,1 user reviews,1,0,1
492580,True,0,1 user reviews,0,1,1
492581,True,0,2 user reviews,1,1,2
492590,True,0,No user reviews,0,0,0
492600,True,0,4 user reviews,1,3,4
492610,True,0,9 user reviews,3,6,9
492620,True,0,No user reviews,0,0,0
492630,True,8,Very Positive,209,33,242
492640,True,0,3 user reviews,3,0,3
492670,True,0,5 user reviews,5,0,5
492680,True,7,Positive,29,7,36
492690,True,7,Positive,10,0,10
492700,True,0,7 user reviews,7,0,7
492710,True,6,Mostly Positive,53,18,71
492720,True,8,Very Positive,4447,674,5121
492740,True,8,Very Positive,73,16,89
492750,True,0,6 user reviews,5,1,6
492760,True,8,Very Positive,59,9,68
492800,True,0,5 user reviews,3,2,5
492810,True,0,No user reviews,0,0,0
492820,True,0,4 user reviews,4,0,4
492821,True,0,3 user reviews,3,0,3
492822,True,0,4 user reviews,4,0,4
492830,True,0,3 user reviews,1,2,3
492840,True,0,No user reviews,0,0,0
492850,True,6,Mostly Positive,7,3,10
492860,True,0,1 user reviews,1,0,1
492870,True,5,Mixed,17,9,26
492880,True,0,No user reviews,0,0,0
492890,True,0,5 user reviews,4,1,5
492891,True,0,3 user reviews,2,1,3
492892,True,0,2 user reviews,2,0,2
492940,True,0,1 user reviews,1,0,1
492941,True,0,No user reviews,0,0,0
492942,True,0,No user reviews,0,0,0
492943,True,0,1 user reviews,1,0,1
492944,True,0,No user reviews,0,0,0
492945,True,0,1 user reviews,1,0,1
492946,True,0,1 user reviews,1,0,1
492947,True,0,No user reviews,0,0,0
492948,True,0,No user reviews,0,0,0
492949,True,0,No user reviews,0,0,0
492950,True,0,1 user reviews,0,1,1
492951,True,0,No user reviews,0,0,0
492952,True,0,1 user reviews,1,0,1
492953,True,0,No user reviews,0,0,0
492954,True,0,2 user reviews,2,0,2
492955,True,0,No user reviews,0,0,0
492956,True,0,No user reviews,0,0,0
492957,True,0,No user reviews,0,0,0
492958,True,0,2 user reviews,2,0,2
492959,True,0,No user reviews,0,0,0
492960,True,0,No user reviews,0,0,0
492961,True,0,No user reviews,0,0,0
492962,True,0,1 user reviews,1,0,1
492963,True,0,2 user reviews,2,0,2
492964,True,0,No user reviews,0,0,0
492965,True,0,No user reviews,0,0,0
492966,True,0,No user reviews,0,0,0
492967,True,0,No user reviews,0,0,0
492968,True,0,5 user reviews,3,2,5
492969,True,0,No user reviews,0,0,0
492970,True,0,No user reviews,0,0,0
492971,True,4,Mostly Negative,4,8,12
492972,True,0,No user reviews,0,0,0
492973,True,0,2 user reviews,1,1,2
492974,True,0,No user reviews,0,0,0
492975,True,0,No user reviews,0,0,0
492976,True,0,No user reviews,0,0,0
492977,True,0,1 user reviews,1,0,1
492978,True,0,No user reviews,0,0,0
492979,True,0,No user reviews,0,0,0
492980,True,0,No user reviews,0,0,0
492981,True,0,5 user reviews,5,0,5
492982,True,0,No user reviews,0,0,0
492983,True,0,1 user reviews,1,0,1
492984,True,0,No user reviews,0,0,0
492985,True,0,3 user reviews,3,0,3
492986,True,0,1 user reviews,1,0,1
492987,True,0,2 user reviews,1,1,2
492988,True,0,No user reviews,0,0,0
492989,True,0,No user reviews,0,0,0
493000,True,0,6 user reviews,2,4,6
493040,True,0,5 user reviews,4,1,5
493060,True,8,Very Positive,90,15,105
493070,True,0,8 user reviews,8,0,8
493080,True,8,Very Positive,135,14,149
493090,True,0,No user reviews,0,0,0
493100,True,7,Positive,22,4,26
493110,True,0,9 user reviews,8,1,9
493130,True,0,No user reviews,0,0,0
493150,True,0,3 user reviews,3,0,3
493160,True,0,No user reviews,0,0,0
493180,True,7,Positive,18,3,21
493190,True,8,Very Positive,89,1,90
493200,True,8,Very Positive,1005,129,1134
493210,True,0,No user reviews,0,0,0
493220,True,6,Mostly Positive,28,11,39
493230,True,0,3 user reviews,3,0,3
493240,True,0,2 user reviews,2,0,2
493290,True,6,Mostly Positive,12,4,16
493300,True,0,1 user reviews,1,0,1
493301,True,0,No user reviews,0,0,0
493310,True,7,Positive,22,4,26
493320,True,6,Mostly Positive,13,4,17
493330,True,0,2 user reviews,2,0,2
493340,True,8,Very Positive,15412,1926,17338
493360,True,0,No user reviews,0,0,0
493370,True,5,Mixed,10,8,18
493380,True,0,8 user reviews,6,2,8
493400,True,0,No user reviews,0,0,0
493410,True,6,Mostly Positive,13,5,18
493420,True,0,3 user reviews,2,1,3
493430,True,0,6 user reviews,6,0,6
493440,True,0,No user reviews,0,0,0
493450,True,5,Mixed,22,13,35
493480,True,0,No user reviews,0,0,0
493490,True,5,Mixed,974,487,1461
493500,True,0,5 user reviews,0,5,5
493520,True,8,Very Positive,7274,929,8203
493530,True,6,Mostly Positive,90,36,126
493540,True,8,Very Positive,104,18,122
493580,True,5,Mixed,27,36,63
493600,True,0,No user reviews,0,0,0
493610,True,0,7 user reviews,3,4,7
493620,True,6,Mostly Positive,7,3,10
493630,True,0,No user reviews,0,0,0
493640,True,0,No user reviews,0,0,0
493650,True,4,Mostly Negative,15,38,53
493670,True,0,3 user reviews,3,0,3
493700,True,7,Positive,9,1,10
493710,True,5,Mixed,12,6,18
493720,True,6,Mostly Positive,173,48,221
493770,True,0,3 user reviews,1,2,3
493780,True,0,1 user reviews,0,1,1
493790,True,5,Mixed,14,8,22
493810,True,0,1 user reviews,1,0,1
493820,True,0,1 user reviews,0,1,1
493840,True,5,Mixed,450,313,763
493850,True,0,No user reviews,0,0,0
493860,True,0,No user reviews,0,0,0
493880,True,4,Mostly Negative,4,12,16
493900,True,8,Very Positive,3510,247,3757
493910,True,0,No user reviews,0,0,0
493920,True,0,1 user reviews,1,0,1
493940,True,0,No user reviews,0,0,0
493950,True,7,Positive,38,0,38
493970,True,0,No user reviews,0,0,0
493980,True,0,3 user reviews,3,0,3
494000,True,0,4 user reviews,2,2,4
494020,True,0,1 user reviews,0,1,1
494040,True,0,3 user reviews,2,1,3
494050,True,5,Mixed,10,10,20
494074,True,0,No user reviews,0,0,0
494080,True,0,4 user reviews,3,1,4
494090,True,0,9 user reviews,4,5,9
494100,True,7,Positive,48,1,49
494110,True,0,No user reviews,0,0,0
494120,True,0,2 user reviews,1,1,2
494140,True,0,8 user reviews,3,5,8
494150,True,9,Overwhelmingly Positive,1390,56,1446
494160,True,0,6 user reviews,5,1,6
494170,True,7,Positive,17,4,21
494200,True,0,No user reviews,0,0,0
494220,True,0,1 user reviews,1,0,1
494230,True,8,Very Positive,171,14,185
494240,True,0,No user reviews,0,0,0
494250,True,0,No user reviews,0,0,0
494260,True,0,No user reviews,0,0,0
494270,True,0,No user reviews,0,0,0
494290,True,5,Mixed,6,4,10
494300,True,0,No user reviews,0,0,0
494310,True,7,Positive,40,1,41
494320,True,5,Mixed,43,31,74
494340,True,0,No user reviews,0,0,0
494350,True,4,Mostly Negative,7,11,18
494360,True,7,Positive,43,2,45
494370,True,6,Mostly Positive,15,4,19
494380,True,0,6 user reviews,1,5,6
494390,True,0,No user reviews,0,0,0
494391,True,0,4 user reviews,4,0,4
494392,True,0,9 user reviews,5,4,9
494400,True,0,No user reviews,0,0,0
494410,True,0,No user reviews,0,0,0
494420,True,7,Positive,10,0,10
494430,True,8,Very Positive,423,71,494
494440,True,5,Mixed,15,21,36
494450,True,5,Mixed,24,26,50
494460,True,5,Mixed,17,21,38
494470,True,5,Mixed,23,24,47
494480,True,0,1 user reviews,1,0,1
494510,True,0,2 user reviews,1,1,2
494520,True,0,4 user reviews,4,0,4
494521,True,0,1 user reviews,0,1,1
494522,True,5,Mixed,7,4,11
494523,True,7,Positive,11,2,13
494524,True,0,9 user reviews,6,3,9
494525,True,0,9 user reviews,2,7,9
494526,True,0,4 user reviews,2,2,4
494527,True,0,1 user reviews,1,0,1
494529,True,4,Mostly Negative,6,18,24
494530,True,4,Mostly Negative,3,10,13
494550,True,0,1 user reviews,0,1,1
494570,True,0,1 user reviews,1,0,1
494580,True,5,Mixed,25,11,36
494600,True,7,Positive,34,6,40
494630,True,5,Mixed,69,49,118
494640,True,0,No user reviews,0,0,0
494650,True,0,1 user reviews,1,0,1
494670,True,5,Mixed,69,70,139
494680,True,7,Positive,41,3,44
494700,True,5,Mixed,11,5,16
494710,True,0,No user reviews,0,0,0
494720,True,8,Very Positive,152,9,161
494740,True,7,Positive,25,4,29
494770,True,0,No user reviews,0,0,0
494780,True,0,8 user reviews,5,3,8
494790,True,0,1 user reviews,1,0,1
494810,True,8,Very Positive,148,20,168
494820,True,0,No user reviews,0,0,0
494830,True,5,Mixed,43,23,66
494840,True,6,Mostly Positive,2556,686,3242
494850,True,0,1 user reviews,0,1,1
494880,True,0,No user reviews,0,0,0
494881,True,0,1 user reviews,1,0,1
494900,True,7,Positive,20,3,23
494950,True,0,No user reviews,0,0,0
494960,True,8,Very Positive,59,10,69
494970,True,0,4 user reviews,3,1,4
494980,True,0,7 user reviews,4,3,7
494990,True,5,Mixed,6,9,15
495010,True,0,3 user reviews,2,1,3
495030,True,0,1 user reviews,1,0,1
495050,True,8,Very Positive,303,42,345
495090,True,5,Mixed,6,6,12
495110,True,8,Very Positive,154,14,168
495140,True,5,Mixed,360,164,524
495160,True,6,Mostly Positive,103,34,137
495200,True,0,3 user reviews,1,2,3
495230,True,0,3 user reviews,2,1,3
495270,True,0,No user reviews,0,0,0
495280,True,8,Very Positive,520,48,568
495290,True,8,Very Positive,93,13,106
495300,True,5,Mixed,11,7,18
495320,True,5,Mixed,6,5,11
495330,True,0,No user reviews,0,0,0
495350,True,5,Mixed,41,26,67
495360,True,0,2 user reviews,1,1,2
495361,True,0,No user reviews,0,0,0
495370,True,7,Positive,8,2,10
495371,True,0,9 user reviews,4,5,9
495380,True,5,Mixed,10,8,18
495390,True,0,5 user reviews,3,2,5
495400,True,0,No user reviews,0,0,0
495410,True,0,7 user reviews,7,0,7
495420,True,8,Very Positive,2820,578,3398
495450,True,0,No user reviews,0,0,0
495460,True,0,No user reviews,0,0,0
495470,True,0,No user reviews,0,0,0
495480,True,5,Mixed,75,44,119
495510,True,0,3 user reviews,2,1,3
495520,True,0,1 user reviews,1,0,1
495540,True,0,1 user reviews,0,1,1
495550,True,0,2 user reviews,2,0,2
495560,True,5,Mixed,403,211,614
495570,True,6,Mostly Positive,14,6,20
495580,True,5,Mixed,48,41,89
495600,True,0,2 user reviews,2,0,2
495620,True,0,No user reviews,0,0,0
495630,True,0,3 user reviews,3,0,3
495640,True,0,No user reviews,0,0,0
495680,True,6,Mostly Positive,7,3,10
495700,True,7,Positive,30,4,34
495720,True,8,Very Positive,86,14,100
495730,True,0,1 user reviews,0,1,1
495750,True,0,No user reviews,0,0,0
495760,True,6,Mostly Positive,9,3,12
495770,True,0,1 user reviews,0,1,1
495780,True,7,Positive,36,8,44
495790,True,0,No user reviews,0,0,0
495800,True,0,No user reviews,0,0,0
495820,True,0,5 user reviews,5,0,5
495830,True,7,Positive,8,2,10
495860,True,0,No user reviews,0,0,0
495880,True,0,No user reviews,0,0,0
495890,True,9,Overwhelmingly Positive,3619,165,3784
495900,True,6,Mostly Positive,23,6,29
495910,True,6,Mostly Positive,36,14,50
495920,True,7,Positive,9,2,11
495930,True,6,Mostly Positive,19,7,26
495950,True,3,Negative,4,17,21
495951,True,0,6 user reviews,3,3,6
495953,True,0,2 user reviews,1,1,2
495954,True,0,2 user reviews,1,1,2
495960,True,5,Mixed,10,9,19
495980,True,5,Mixed,32,18,50
495990,True,7,Positive,25,6,31
496000,True,0,4 user reviews,3,1,4
496010,True,0,No user reviews,0,0,0
496030,True,0,9 user reviews,7,2,9
496040,True,6,Mostly Positive,34,9,43
496070,True,0,No user reviews,0,0,0
496080,True,0,3 user reviews,2,1,3
496090,True,0,No user reviews,0,0,0
496100,True,2,Very Negative,10,65,75
496101,True,4,Mostly Negative,10,20,30
496102,True,0,4 user reviews,4,0,4
496103,True,7,Positive,22,5,27
496104,True,0,4 user reviews,4,0,4
496120,True,7,Positive,25,2,27
496160,True,0,No user reviews,0,0,0
496180,True,0,No user reviews,0,0,0
496190,True,7,Positive,9,2,11
496200,True,0,No user reviews,0,0,0
496210,True,0,No user reviews,0,0,0
496220,True,0,No user reviews,0,0,0
496230,True,0,5 user reviews,2,3,5
496240,True,6,Mostly Positive,3310,1079,4389
496250,True,8,Very Positive,135,23,158
496260,True,8,Very Positive,62,4,66
496290,True,5,Mixed,8,4,12
496300,True,8,Very Positive,2352,354,2706
496310,True,5,Mixed,6,6,12
496320,True,0,1 user reviews,1,0,1
496330,True,0,No user reviews,0,0,0
496340,True,5,Mixed,41,25,66
496350,True,7,Positive,35,3,38
496360,True,0,3 user reviews,0,3,3
496380,True,0,4 user reviews,2,2,4
496390,True,0,7 user reviews,4,3,7
496400,True,5,Mixed,7,10,17
496410,True,0,No user reviews,0,0,0
496430,True,0,3 user reviews,3,0,3
496431,True,6,Mostly Positive,7,3,10
496432,True,7,Positive,10,2,12
496434,True,0,No user reviews,0,0,0
496435,True,0,2 user reviews,1,1,2
496436,True,0,No user reviews,0,0,0
496437,True,0,No user reviews,0,0,0
496438,True,0,3 user reviews,3,0,3
496439,True,0,2 user reviews,2,0,2
496440,True,0,2 user reviews,1,1,2
496450,True,6,Mostly Positive,33,9,42
496460,True,5,Mixed,1019,685,1704
496480,True,0,9 user reviews,6,3,9
496490,True,5,Mixed,32,28,60
496510,True,5,Mixed,15,7,22
496520,True,0,2 user reviews,0,2,2
496530,True,5,Mixed,6,6,12
496540,True,7,Positive,12,3,15
496550,True,5,Mixed,88,130,218
496570,True,0,No user reviews,0,0,0
496580,True,7,Positive,33,1,34
496590,True,0,2 user reviews,1,1,2
496610,True,0,4 user reviews,2,2,4
496620,True,8,Very Positive,358,83,441
496630,True,7,Positive,42,5,47
496640,True,4,Mostly Negative,12,19,31
496650,True,4,Mostly Negative,8,19,27
496660,True,0,9 user reviews,4,5,9
496670,True,0,6 user reviews,3,3,6
496680,True,4,Mostly Negative,26,71,97
496690,True,0,3 user reviews,1,2,3
496710,True,0,1 user reviews,0,1,1
496720,True,0,No user reviews,0,0,0
496730,True,5,Mixed,104,57,161
496740,True,6,Mostly Positive,43,12,55
496750,True,4,Mostly Negative,14,29,43
496760,True,7,Positive,43,4,47
496790,True,0,4 user reviews,3,1,4
496800,True,0,3 user reviews,3,0,3
496810,True,8,Very Positive,397,71,468
496820,True,0,4 user reviews,2,2,4
496840,True,0,No user reviews,0,0,0
496850,True,0,4 user reviews,4,0,4
496890,True,6,Mostly Positive,244,62,306
496900,True,0,No user reviews,0,0,0
496910,True,5,Mixed,7,8,15
496930,True,5,Mixed,13,7,20
496940,True,0,2 user reviews,2,0,2
496950,True,5,Mixed,6,6,12
496960,True,4,Mostly Negative,3,7,10
496970,True,0,No user reviews,0,0,0
496971,True,0,1 user reviews,1,0,1
496972,True,0,3 user reviews,3,0,3
496980,True,0,9 user reviews,5,4,9
496990,True,0,8 user reviews,5,3,8
497000,True,0,5 user reviews,2,3,5
497010,True,0,1 user reviews,1,0,1
497020,True,5,Mixed,7,4,11
497040,True,6,Mostly Positive,8,3,11
497050,True,5,Mixed,11,11,22
497060,True,0,1 user reviews,1,0,1
497080,True,7,Positive,24,5,29
497090,True,0,No user reviews,0,0,0
497100,True,5,Mixed,16,7,23
497110,True,0,No user reviews,0,0,0
497140,True,0,No user reviews,0,0,0
497150,True,6,Mostly Positive,12,5,17
497160,True,0,No user reviews,0,0,0
497170,True,0,5 user reviews,5,0,5
497180,True,8,Very Positive,1005,187,1192
497190,True,0,4 user reviews,4,0,4
497200,True,0,No user reviews,0,0,0
497230,True,0,No user reviews,0,0,0
497240,True,0,3 user reviews,1,2,3
497260,True,0,6 user reviews,4,2,6
497270,True,6,Mostly Positive,10,4,14
497280,True,0,4 user reviews,2,2,4
497290,True,0,No user reviews,0,0,0
497300,True,0,7 user reviews,3,4,7
497310,True,0,4 user reviews,3,1,4
497320,True,0,No user reviews,0,0,0
497330,True,0,No user reviews,0,0,0
497360,True,5,Mixed,11,10,21
497380,True,0,No user reviews,0,0,0
497400,True,6,Mostly Positive,109,44,153
497420,True,7,Positive,18,4,22
497430,True,0,No user reviews,0,0,0
497440,True,5,Mixed,35,45,80
497450,True,7,Positive,31,6,37
497460,True,7,Positive,41,4,45
497470,True,5,Mixed,15,17,32
497480,True,0,1 user reviews,1,0,1
497490,True,0,1 user reviews,1,0,1
497510,True,7,Positive,16,1,17
497520,True,0,1 user reviews,1,0,1
497521,True,0,1 user reviews,1,0,1
497540,True,0,No user reviews,0,0,0
497560,True,0,8 user reviews,2,6,8
497580,True,5,Mixed,14,15,29
497590,True,0,1 user reviews,1,0,1
497600,True,0,No user reviews,0,0,0
497610,True,0,1 user reviews,1,0,1
497611,True,0,4 user reviews,3,1,4
497620,True,0,5 user reviews,5,0,5
497621,True,0,1 user reviews,1,0,1
497630,True,0,1 user reviews,0,1,1
497640,True,7,Positive,14,3,17
497660,True,5,Mixed,7,4,11
497670,True,7,Positive,10,2,12
497680,True,6,Mostly Positive,22,9,31
497690,True,7,Positive,21,0,21
497700,True,7,Positive,32,8,40
497710,True,0,7 user reviews,5,2,7
497720,True,5,Mixed,11,12,23
497730,True,5,Mixed,47,21,68
497760,True,0,3 user reviews,2,1,3
497770,True,0,No user reviews,0,0,0
497780,True,8,Very Positive,164,4,168
497790,True,0,6 user reviews,6,0,6
497800,True,8,Very Positive,130,4,134
497810,True,0,No user reviews,0,0,0
497811,True,0,No user reviews,0,0,0
497812,True,0,No user reviews,0,0,0
497813,True,0,No user reviews,0,0,0
497820,True,0,6 user reviews,6,0,6
497840,True,0,No user reviews,0,0,0
497841,True,0,No user reviews,0,0,0
497842,True,0,No user reviews,0,0,0
497850,True,8,Very Positive,183,44,227
497860,True,0,1 user reviews,1,0,1
497870,True,0,No user reviews,0,0,0
497880,True,0,5 user reviews,2,3,5
497890,True,0,No user reviews,0,0,0
497900,True,0,2 user reviews,1,1,2
497910,True,0,No user reviews,0,0,0
497930,True,0,No user reviews,0,0,0
497940,True,0,3 user reviews,1,2,3
497960,True,0,No user reviews,0,0,0
497970,True,7,Positive,22,2,24
497990,True,0,5 user reviews,4,1,5
498000,True,0,7 user reviews,5,2,7
498010,True,0,No user reviews,0,0,0
498020,True,0,7 user reviews,7,0,7
498030,True,0,2 user reviews,1,1,2
498040,True,0,No user reviews,0,0,0
498050,True,0,6 user reviews,1,5,6
498100,True,0,No user reviews,0,0,0
498101,True,0,No user reviews,0,0,0
498102,True,0,No user reviews,0,0,0
498110,True,0,2 user reviews,2,0,2
498140,True,0,No user reviews,0,0,0
498141,True,0,No user reviews,0,0,0
498142,True,0,No user reviews,0,0,0
498190,True,7,Positive,32,8,40
498200,True,0,No user reviews,0,0,0
498210,True,0,7 user reviews,5,2,7
498220,True,0,1 user reviews,0,1,1
498221,True,0,No user reviews,0,0,0
498222,True,0,No user reviews,0,0,0
498223,True,0,No user reviews,0,0,0
498230,True,0,1 user reviews,1,0,1
498240,True,6,Mostly Positive,3345,942,4287
498250,True,0,No user reviews,0,0,0
498260,True,0,No user reviews,0,0,0
498270,True,0,No user reviews,0,0,0
498280,True,0,8 user reviews,2,6,8
498290,True,0,1 user reviews,1,0,1
498300,True,4,Mostly Negative,5,9,14
498310,True,7,Positive,31,1,32
498320,True,0,No user reviews,0,0,0
498330,True,8,Very Positive,374,36,410
498340,True,5,Mixed,36,21,57
498360,True,0,2 user reviews,2,0,2
498370,True,0,2 user reviews,0,2,2
498380,True,0,6 user reviews,6,0,6
498390,True,0,2 user reviews,2,0,2
498400,True,0,2 user reviews,2,0,2
498410,True,0,No user reviews,0,0,0
498420,True,0,No user reviews,0,0,0
498450,True,0,4 user reviews,2,2,4
498460,True,0,4 user reviews,0,4,4
498470,True,7,Positive,44,0,44
498500,True,5,Mixed,64,29,93
498510,True,0,No user reviews,0,0,0
498520,True,7,Positive,9,2,11
498540,True,0,5 user reviews,3,2,5
498550,True,4,Mostly Negative,4,7,11
498570,True,8,Very Positive,79,13,92
498580,True,5,Mixed,6,7,13
498590,True,0,1 user reviews,1,0,1
498600,True,0,1 user reviews,0,1,1
498620,True,0,4 user reviews,3,1,4
498630,True,0,9 user reviews,2,7,9
498640,True,0,No user reviews,0,0,0
498660,True,8,Very Positive,53,10,63
498680,True,0,4 user reviews,1,3,4
498700,True,0,6 user reviews,4,2,6
498710,True,0,No user reviews,0,0,0
498720,True,0,6 user reviews,4,2,6
498730,True,0,No user reviews,0,0,0
498740,True,0,1 user reviews,1,0,1
498760,True,0,3 user reviews,3,0,3
498770,True,0,6 user reviews,6,0,6
498790,True,0,6 user reviews,3,3,6
498830,True,0,5 user reviews,5,0,5
498840,True,0,3 user reviews,1,2,3
498850,True,0,5 user reviews,4,1,5
498870,True,6,Mostly Positive,175,63,238
498880,True,0,No user reviews,0,0,0
498890,True,0,No user reviews,0,0,0
498900,True,0,No user reviews,0,0,0
498910,True,0,No user reviews,0,0,0
498930,True,0,No user reviews,0,0,0
498940,True,0,8 user reviews,4,4,8
498950,True,0,No user reviews,0,0,0
498960,True,0,No user reviews,0,0,0
498980,True,6,Mostly Positive,15,6,21
498990,True,0,9 user reviews,8,1,9
499010,True,0,No user reviews,0,0,0
499060,True,0,No user reviews,0,0,0
499070,True,6,Mostly Positive,10,3,13
499100,True,7,Positive,27,6,33
499110,True,7,Positive,16,1,17
499120,True,7,Positive,15,2,17
499130,True,0,No user reviews,0,0,0
499140,True,7,Positive,14,0,14
499150,True,0,No user reviews,0,0,0
499160,True,0,No user reviews,0,0,0
499200,True,0,No user reviews,0,0,0
499210,True,4,Mostly Negative,5,10,15
499220,True,0,No user reviews,0,0,0
499221,True,0,No user reviews,0,0,0
499222,True,0,No user reviews,0,0,0
499223,True,0,No user reviews,0,0,0
499224,True,0,No user reviews,0,0,0
499230,True,6,Mostly Positive,35,14,49
499250,True,0,1 user reviews,1,0,1
499270,True,0,No user reviews,0,0,0
499280,True,0,No user reviews,0,0,0
499300,True,0,No user reviews,0,0,0
499320,True,0,No user reviews,0,0,0
499330,True,5,Mixed,5,5,10
499340,True,7,Positive,19,1,20
499360,True,0,No user reviews,0,0,0
499370,True,7,Positive,13,2,15
499400,True,7,Positive,35,7,42
499410,True,7,Positive,9,1,10
499420,True,0,7 user reviews,3,4,7
499440,True,9,Overwhelmingly Positive,1343,38,1381
499450,True,0,No user reviews,0,0,0
499460,True,8,Very Positive,67,16,83
499500,True,0,No user reviews,0,0,0
499510,True,0,6 user reviews,5,1,6
499520,True,8,Very Positive,2587,380,2967
499530,True,0,3 user reviews,0,3,3
499540,True,0,2 user reviews,1,1,2
499550,True,0,5 user reviews,4,1,5
499560,True,0,No user reviews,0,0,0
499570,True,0,No user reviews,0,0,0
499571,True,0,No user reviews,0,0,0
499572,True,0,No user reviews,0,0,0
499573,True,0,No user reviews,0,0,0
499580,True,0,No user reviews,0,0,0
499590,True,5,Mixed,14,8,22
499600,True,0,No user reviews,0,0,0
499610,True,5,Mixed,9,10,19
499620,True,8,Very Positive,142,35,177
499650,True,0,No user reviews,0,0,0
499660,True,8,Very Positive,851,200,1051
499670,True,0,No user reviews,0,0,0
499690,True,0,No user reviews,0,0,0
499700,True,0,No user reviews,0,0,0
499710,True,0,No user reviews,0,0,0
499720,True,0,No user reviews,0,0,0
499730,True,0,No user reviews,0,0,0
499740,True,0,No user reviews,0,0,0
499750,True,0,No user reviews,0,0,0
499760,True,6,Mostly Positive,16,5,21
499790,True,0,No user reviews,0,0,0
499800,True,0,No user reviews,0,0,0
499810,True,0,No user reviews,0,0,0
499820,True,0,No user reviews,0,0,0
499830,True,0,No user reviews,0,0,0
499840,True,0,No user reviews,0,0,0
499850,True,0,No user reviews,0,0,0
499860,True,0,No user reviews,0,0,0
499870,True,0,No user reviews,0,0,0
499880,True,0,No user reviews,0,0,0
499890,True,8,Very Positive,87,10,97
499900,True,0,3 user reviews,1,2,3
499910,True,8,Very Positive,68,4,72
499930,True,0,No user reviews,0,0,0
499940,True,5,Mixed,8,6,14
499950,True,0,No user reviews,0,0,0
500080,True,0,1 user reviews,1,0,1
500090,True,0,2 user reviews,2,0,2
500100,True,0,3 user reviews,3,0,3
500110,True,7,Positive,24,4,28
500120,True,0,3 user reviews,2,1,3
500140,True,0,5 user reviews,2,3,5
500150,True,0,No user reviews,0,0,0
500160,True,0,1 user reviews,1,0,1
500170,True,4,Mostly Negative,6,16,22
500180,True,0,2 user reviews,2,0,2
500190,True,5,Mixed,24,13,37
500202,True,0,1 user reviews,0,1,1
500203,True,0,No user reviews,0,0,0
500204,True,0,No user reviews,0,0,0
500205,True,0,No user reviews,0,0,0
500206,True,0,No user reviews,0,0,0
500208,True,7,Positive,9,1,10
500210,True,0,4 user reviews,3,1,4
500211,True,6,Mostly Positive,20,8,28
500212,True,0,5 user reviews,4,1,5
500213,True,0,No user reviews,0,0,0
500214,True,0,9 user reviews,6,3,9
500215,True,0,1 user reviews,0,1,1
500216,True,0,1 user reviews,1,0,1
500217,True,0,No user reviews,0,0,0
500218,True,6,Mostly Positive,18,6,24
500219,True,0,No user reviews,0,0,0
500220,True,0,4 user reviews,3,1,4
500230,True,5,Mixed,17,8,25
500232,True,5,Mixed,9,6,15
500233,True,7,Positive,12,2,14
500234,True,7,Positive,13,3,16
500235,True,0,7 user reviews,5,2,7
500236,True,0,3 user reviews,1,2,3
500237,True,7,Positive,10,1,11
500238,True,0,2 user reviews,2,0,2
500239,True,5,Mixed,11,7,18
500240,True,0,1 user reviews,0,1,1
500241,True,0,8 user reviews,7,1,8
500242,True,0,2 user reviews,0,2,2
500243,True,0,5 user reviews,3,2,5
500244,True,7,Positive,9,2,11
500245,True,0,1 user reviews,1,0,1
500246,True,0,1 user reviews,1,0,1
500247,True,6,Mostly Positive,10,3,13
500248,True,5,Mixed,8,4,12
500249,True,0,4 user reviews,3,1,4
500250,True,0,1 user reviews,1,0,1
500260,True,8,Very Positive,202,49,251
500270,True,5,Mixed,30,26,56
500271,True,6,Mostly Positive,22,7,29
500272,True,6,Mostly Positive,34,10,44
500280,True,0,No user reviews,0,0,0
500290,True,6,Mostly Positive,17,5,22
500310,True,0,No user reviews,0,0,0
500320,True,5,Mixed,15,9,24
500330,True,0,No user reviews,0,0,0
500340,True,7,Positive,9,1,10
500350,True,0,5 user reviews,4,1,5
500360,True,0,1 user reviews,1,0,1
500370,True,0,8 user reviews,7,1,8
500380,True,0,No user reviews,0,0,0
500390,True,0,2 user reviews,2,0,2
500391,True,0,2 user reviews,1,1,2
500392,True,0,3 user reviews,3,0,3
500400,True,0,1 user reviews,0,1,1
500410,True,0,No user reviews,0,0,0
500420,True,6,Mostly Positive,24,8,32
500440,True,0,No user reviews,0,0,0
500460,True,7,Positive,16,0,16
500461,True,0,1 user reviews,1,0,1
500470,True,7,Positive,26,2,28
500480,True,5,Mixed,21,10,31
500490,True,0,No user reviews,0,0,0
500500,True,6,Mostly Positive,128,42,170
500510,True,0,No user reviews,0,0,0
500540,True,0,6 user reviews,4,2,6
500550,True,0,7 user reviews,6,1,7
500570,True,0,2 user reviews,1,1,2
500580,True,7,Positive,46,2,48
500590,True,7,Positive,20,0,20
500620,True,7,Positive,14,3,17
500650,True,0,1 user reviews,1,0,1
500660,True,0,No user reviews,0,0,0
500670,True,8,Very Positive,122,6,128
500680,True,0,6 user reviews,6,0,6
500690,True,7,Positive,21,1,22
500710,True,5,Mixed,76,74,150
500740,True,0,No user reviews,0,0,0
500750,True,0,5 user reviews,3,2,5
500760,True,0,2 user reviews,1,1,2
500770,True,0,No user reviews,0,0,0
500790,True,0,1 user reviews,1,0,1
500800,True,0,No user reviews,0,0,0
500810,True,8,Very Positive,433,85,518
500830,True,0,No user reviews,0,0,0
500840,True,0,No user reviews,0,0,0
500850,True,0,No user reviews,0,0,0
500860,True,0,No user reviews,0,0,0
500870,True,5,Mixed,41,24,65
500880,True,0,8 user reviews,7,1,8
500890,True,0,No user reviews,0,0,0
500910,True,0,No user reviews,0,0,0
500920,True,0,2 user reviews,1,1,2
500940,True,0,8 user reviews,6,2,8
500970,True,0,No user reviews,0,0,0
500980,True,0,5 user reviews,0,5,5
501000,True,0,No user reviews,0,0,0
501020,True,5,Mixed,12,6,18
501030,True,6,Mostly Positive,13,4,17
501040,True,0,7 user reviews,7,0,7
501050,True,0,1 user reviews,1,0,1
501060,True,0,6 user reviews,0,6,6
501080,True,6,Mostly Positive,649,213,862
501090,True,6,Mostly Positive,26,7,33
501110,True,5,Mixed,46,23,69
501120,True,8,Very Positive,146,19,165
501130,True,0,No user reviews,0,0,0
501150,True,0,No user reviews,0,0,0
501151,True,0,No user reviews,0,0,0
501170,True,0,2 user reviews,2,0,2
501171,True,0,1 user reviews,1,0,1
501172,True,0,No user reviews,0,0,0
501180,True,5,Mixed,8,4,12
501190,True,5,Mixed,48,24,72
501210,True,8,Very Positive,144,25,169
501220,True,5,Mixed,17,12,29
501230,True,0,No user reviews,0,0,0
501240,True,0,No user reviews,0,0,0
501250,True,0,No user reviews,0,0,0
501260,True,0,2 user reviews,2,0,2
501270,True,0,4 user reviews,3,1,4
501280,True,0,No user reviews,0,0,0
501290,True,0,No user reviews,0,0,0
501300,True,8,Very Positive,6443,421,6864
501310,True,0,4 user reviews,3,1,4
501320,True,5,Mixed,200,94,294
501350,True,6,Mostly Positive,51,17,68
501360,True,0,No user reviews,0,0,0
501380,True,0,No user reviews,0,0,0
501410,True,0,5 user reviews,4,1,5
501420,True,0,No user reviews,0,0,0
501430,True,6,Mostly Positive,13,4,17
501440,True,0,9 user reviews,3,6,9
501450,True,0,6 user reviews,5,1,6
501460,True,0,1 user reviews,1,0,1
501470,True,0,No user reviews,0,0,0
501480,True,6,Mostly Positive,10,3,13
501490,True,0,No user reviews,0,0,0
501500,True,0,4 user reviews,4,0,4
501510,True,0,1 user reviews,1,0,1
501530,True,7,Positive,17,2,19
501570,True,0,2 user reviews,2,0,2
501580,True,0,3 user reviews,3,0,3
501590,True,8,Very Positive,1174,235,1409
501600,True,0,1 user reviews,0,1,1
501610,True,0,4 user reviews,3,1,4
501620,True,5,Mixed,7,5,12
501630,True,6,Mostly Positive,16,5,21
501640,True,0,6 user reviews,4,2,6
501670,True,0,5 user reviews,5,0,5
501671,True,0,4 user reviews,4,0,4
501680,True,0,No user reviews,0,0,0
501730,True,0,No user reviews,0,0,0
501740,True,0,9 user reviews,2,7,9
501750,True,0,6 user reviews,6,0,6
501760,True,5,Mixed,32,32,64
501790,True,8,Very Positive,223,27,250
501820,True,0,No user reviews,0,0,0
501840,True,6,Mostly Positive,42,13,55
501850,True,0,No user reviews,0,0,0
501860,True,5,Mixed,36,27,63
501870,True,0,No user reviews,0,0,0
501890,True,0,No user reviews,0,0,0
501891,True,0,No user reviews,0,0,0
501930,True,6,Mostly Positive,16,5,21
501940,True,5,Mixed,11,9,20
501950,True,5,Mixed,18,8,26
501970,True,7,Positive,33,5,38
501990,True,8,Very Positive,58,11,69
502010,True,7,Positive,16,1,17
502050,True,0,No user reviews,0,0,0
502070,True,0,No user reviews,0,0,0
502090,True,4,Mostly Negative,3,8,11
502100,True,5,Mixed,11,5,16
502120,True,7,Positive,20,3,23
502130,True,0,No user reviews,0,0,0
502140,True,5,Mixed,21,26,47
502150,True,7,Positive,9,1,10
502200,True,0,2 user reviews,1,1,2
502210,True,7,Positive,27,4,31
502230,True,8,Very Positive,74,6,80
502240,True,5,Mixed,18,23,41
502250,True,0,No user reviews,0,0,0
502260,True,0,No user reviews,0,0,0
502280,True,6,Mostly Positive,631,181,812
502300,True,5,Mixed,9,7,16
502310,True,0,No user reviews,0,0,0
502320,True,5,Mixed,19,9,28
502340,True,6,Mostly Positive,9,3,12
502350,True,0,No user reviews,0,0,0
502360,True,0,No user reviews,0,0,0
502361,True,0,No user reviews,0,0,0
502370,True,8,Very Positive,512,81,593
502380,True,0,4 user reviews,1,3,4
502390,True,0,No user reviews,0,0,0
502400,True,5,Mixed,11,6,17
502410,True,5,Mixed,5,6,11
502420,True,5,Mixed,13,16,29
502430,True,0,9 user reviews,5,4,9
502440,True,0,6 user reviews,2,4,6
502450,True,0,4 user reviews,0,4,4
502460,True,0,3 user reviews,3,0,3
502480,True,0,5 user reviews,3,2,5
502490,True,7,Positive,18,4,22
502500,True,8,Very Positive,5279,948,6227
502510,True,0,No user reviews,0,0,0
502520,True,8,Very Positive,2746,382,3128
502530,True,0,9 user reviews,7,2,9
502540,True,7,Positive,13,2,15
502550,True,5,Mixed,7,4,11
502560,True,0,2 user reviews,2,0,2
502570,True,7,Positive,44,2,46
502580,True,0,No user reviews,0,0,0
502590,True,0,No user reviews,0,0,0
502600,True,0,7 user reviews,4,3,7
502610,True,0,No user reviews,0,0,0
502620,True,0,No user reviews,0,0,0
502630,True,0,No user reviews,0,0,0
502650,True,5,Mixed,13,7,20
502700,True,0,8 user reviews,7,1,8
502710,True,5,Mixed,87,38,125
502720,True,6,Mostly Positive,28,12,40
502730,True,0,No user reviews,0,0,0
502740,True,8,Very Positive,128,14,142
502750,True,8,Very Positive,142,9,151
502770,True,6,Mostly Positive,204,58,262
502780,True,0,6 user reviews,5,1,6
502790,True,5,Mixed,6,5,11
502800,True,9,Overwhelmingly Positive,938,48,986
502810,True,0,4 user reviews,0,4,4
502820,True,6,Mostly Positive,420,173,593
502830,True,0,1 user reviews,1,0,1
502840,True,0,No user reviews,0,0,0
502841,True,0,1 user reviews,1,0,1
502842,True,0,1 user reviews,1,0,1
502860,True,0,3 user reviews,3,0,3
502870,True,7,Positive,37,6,43
502880,True,4,Mostly Negative,4,16,20
502890,True,7,Positive,15,2,17
502891,True,0,8 user reviews,8,0,8
502900,True,0,No user reviews,0,0,0
502910,True,0,6 user reviews,1,5,6
502920,True,0,6 user reviews,6,0,6
502930,True,0,No user reviews,0,0,0
502940,True,8,Very Positive,271,36,307
502960,True,0,No user reviews,0,0,0
502970,True,0,7 user reviews,6,1,7
502980,True,0,1 user reviews,1,0,1
502990,True,0,1 user reviews,0,1,1
503010,True,5,Mixed,8,9,17
503020,True,0,1 user reviews,1,0,1
503040,True,0,No user reviews,0,0,0
503050,True,0,1 user reviews,1,0,1
503060,True,0,7 user reviews,7,0,7
503070,True,0,9 user reviews,8,1,9
503080,True,0,4 user reviews,3,1,4
503090,True,0,4 user reviews,1,3,4
503100,True,6,Mostly Positive,35,15,50
503110,True,0,3 user reviews,3,0,3
503130,True,0,6 user reviews,5,1,6
503140,True,0,6 user reviews,6,0,6
503150,True,7,Positive,12,1,13
503160,True,0,No user reviews,0,0,0
503170,True,0,No user reviews,0,0,0
503180,True,8,Very Positive,90,19,109
503210,True,6,Mostly Positive,43,16,59
503220,True,4,Mostly Negative,4,9,13
503240,True,5,Mixed,17,20,37
503250,True,0,No user reviews,0,0,0
503260,True,0,No user reviews,0,0,0
503280,True,7,Positive,23,4,27
503290,True,0,6 user reviews,4,2,6
503300,True,6,Mostly Positive,561,144,705
503310,True,0,No user reviews,0,0,0
503320,True,0,6 user reviews,4,2,6
503340,True,7,Positive,34,6,40
503350,True,6,Mostly Positive,594,154,748
503370,True,5,Mixed,48,55,103
503380,True,0,2 user reviews,1,1,2
503390,True,5,Mixed,7,7,14
503400,True,8,Very Positive,298,15,313
503410,True,5,Mixed,8,4,12
503420,True,0,No user reviews,0,0,0
503430,True,0,2 user reviews,2,0,2
503440,True,0,No user reviews,0,0,0
503450,True,0,3 user reviews,1,2,3
503460,True,5,Mixed,11,8,19
503470,True,0,No user reviews,0,0,0
503480,True,5,Mixed,16,11,27
503490,True,0,No user reviews,0,0,0
503500,True,0,No user reviews,0,0,0
503550,True,6,Mostly Positive,35,11,46
503560,True,8,Very Positive,2979,458,3437
503580,True,8,Very Positive,583,113,696
503620,True,6,Mostly Positive,410,129,539
503630,True,0,5 user reviews,5,0,5
503650,True,7,Positive,9,1,10
503660,True,0,No user reviews,0,0,0
503670,True,0,No user reviews,0,0,0
503680,True,0,4 user reviews,4,0,4
503690,True,0,4 user reviews,3,1,4
503700,True,0,2 user reviews,0,2,2
503710,True,5,Mixed,6,4,10
503720,True,0,9 user reviews,6,3,9
503730,True,0,3 user reviews,1,2,3
503740,True,0,No user reviews,0,0,0
503750,True,0,1 user reviews,1,0,1
503760,True,0,No user reviews,0,0,0
503770,True,8,Very Positive,265,42,307
503780,True,0,5 user reviews,2,3,5
503790,True,0,No user reviews,0,0,0
503800,True,0,No user reviews,0,0,0
503810,True,0,No user reviews,0,0,0
503820,True,6,Mostly Positive,8,3,11
503830,True,5,Mixed,8,12,20
503860,True,7,Positive,23,0,23
503880,True,0,No user reviews,0,0,0
503890,True,0,No user reviews,0,0,0
503900,True,0,4 user reviews,1,3,4
503920,True,0,No user reviews,0,0,0
503930,True,0,No user reviews,0,0,0
503940,True,6,Mostly Positive,1813,470,2283
503950,True,6,Mostly Positive,13,4,17
503960,True,6,Mostly Positive,14,5,19
503980,True,0,6 user reviews,5,1,6
503990,True,0,No user reviews,0,0,0
504000,True,7,Positive,37,5,42
504010,True,5,Mixed,10,5,15
504030,True,0,No user reviews,0,0,0
504050,True,5,Mixed,519,241,760
504070,True,0,No user reviews,0,0,0
504090,True,7,Positive,14,0,14
504100,True,5,Mixed,8,8,16
504110,True,5,Mixed,8,5,13
504120,True,0,No user reviews,0,0,0
504130,True,6,Mostly Positive,241,74,315
504170,True,0,No user reviews,0,0,0
504200,True,0,No user reviews,0,0,0
504210,True,9,Overwhelmingly Positive,1251,61,1312
504220,True,0,No user reviews,0,0,0
504230,True,9,Overwhelmingly Positive,11039,273,11312
504240,True,0,1 user reviews,0,1,1
504260,True,0,5 user reviews,3,2,5
504270,True,0,No user reviews,0,0,0
504280,True,5,Mixed,7,6,13
504300,True,0,No user reviews,0,0,0
504310,True,5,Mixed,22,15,37
504350,True,0,No user reviews,0,0,0
504370,True,8,Very Positive,8524,1202,9726
504380,True,0,7 user reviews,6,1,7
504390,True,8,Very Positive,94,13,107
504400,True,6,Mostly Positive,40,11,51
504410,True,5,Mixed,15,9,24
504420,True,6,Mostly Positive,13,4,17
504430,True,6,Mostly Positive,11,3,14
504450,True,0,8 user reviews,3,5,8
504460,True,0,9 user reviews,8,1,9
504470,True,4,Mostly Negative,4,7,11
504490,True,0,7 user reviews,3,4,7
504500,True,0,4 user reviews,3,1,4
504510,True,0,No user reviews,0,0,0
504520,True,0,No user reviews,0,0,0
504530,True,0,No user reviews,0,0,0
504540,True,0,No user reviews,0,0,0
504550,True,0,5 user reviews,5,0,5
504560,True,5,Mixed,15,7,22
504570,True,0,1 user reviews,1,0,1
504580,True,0,4 user reviews,4,0,4
504590,True,0,No user reviews,0,0,0
504610,True,0,No user reviews,0,0,0
504620,True,0,3 user reviews,3,0,3
504630,True,0,2 user reviews,1,1,2
504640,True,0,4 user reviews,4,0,4
504650,True,6,Mostly Positive,50,16,66
504660,True,0,2 user reviews,1,1,2
504670,True,0,6 user reviews,4,2,6
504680,True,8,Very Positive,181,7,188
504690,True,7,Positive,18,3,21
504700,True,7,Positive,17,1,18
504710,True,5,Mixed,25,31,56
504720,True,5,Mixed,30,36,66
504740,True,0,No user reviews,0,0,0
504750,True,0,7 user reviews,5,2,7
504770,True,8,Very Positive,435,35,470
504790,True,7,Positive,25,1,26
504800,True,7,Positive,39,8,47
504810,True,5,Mixed,10,6,16
504840,True,7,Positive,10,0,10
504850,True,0,6 user reviews,5,1,6
504870,True,0,No user reviews,0,0,0
504880,True,6,Mostly Positive,15,4,19
504920,True,6,Mostly Positive,39,12,51
504930,True,0,1 user reviews,1,0,1
504950,True,0,No user reviews,0,0,0
504970,True,0,No user reviews,0,0,0
504980,True,5,Mixed,7,4,11
504990,True,0,No user reviews,0,0,0
505015,True,0,1 user reviews,1,0,1
505020,True,0,6 user reviews,4,2,6
505040,True,8,Very Positive,885,49,934
505060,True,8,Very Positive,192,13,205
505070,True,7,Positive,19,3,22
505080,True,5,Mixed,24,13,37
505090,True,5,Mixed,18,20,38
505100,True,0,2 user reviews,2,0,2
505110,True,0,4 user reviews,4,0,4
505120,True,0,9 user reviews,5,4,9
505130,True,0,No user reviews,0,0,0
505140,True,0,6 user reviews,3,3,6
505150,True,7,Positive,25,1,26
505170,True,6,Mostly Positive,629,193,822
505210,True,5,Mixed,49,22,71
505220,True,0,7 user reviews,4,3,7
505230,True,8,Very Positive,1611,133,1744
505240,True,0,No user reviews,0,0,0
505260,True,0,No user reviews,0,0,0
505270,True,0,4 user reviews,3,1,4
505290,True,0,2 user reviews,2,0,2
505330,True,6,Mostly Positive,44,17,61
505340,True,0,1 user reviews,1,0,1
505350,True,0,No user reviews,0,0,0
505380,True,0,No user reviews,0,0,0
505390,True,0,No user reviews,0,0,0
505400,True,0,8 user reviews,8,0,8
505410,True,0,1 user reviews,0,1,1
505420,True,0,7 user reviews,1,6,7
505430,True,0,No user reviews,0,0,0
505450,True,0,No user reviews,0,0,0
505451,True,0,No user reviews,0,0,0
505460,True,6,Mostly Positive,5328,1411,6739
505470,True,0,No user reviews,0,0,0
505480,True,0,No user reviews,0,0,0
505490,True,0,No user reviews,0,0,0
505500,True,0,No user reviews,0,0,0
505510,True,0,No user reviews,0,0,0
505520,True,0,No user reviews,0,0,0
505530,True,0,No user reviews,0,0,0
505540,True,6,Mostly Positive,70,26,96
505550,True,5,Mixed,6,5,11
505560,True,0,4 user reviews,3,1,4
505580,True,0,No user reviews,0,0,0
505590,True,0,No user reviews,0,0,0
505600,True,0,No user reviews,0,0,0
505610,True,0,4 user reviews,2,2,4
505620,True,0,No user reviews,0,0,0
505630,True,8,Very Positive,257,39,296
505640,True,8,Very Positive,256,53,309
505650,True,0,No user reviews,0,0,0
505660,True,7,Positive,14,0,14
505680,True,6,Mostly Positive,10,3,13
505700,True,8,Very Positive,138,5,143
505720,True,0,No user reviews,0,0,0
505730,True,6,Mostly Positive,132,48,180
505740,True,6,Mostly Positive,77,29,106
505750,True,7,Positive,21,4,25
505780,True,0,No user reviews,0,0,0
505790,True,0,No user reviews,0,0,0
505890,True,0,No user reviews,0,0,0
506030,True,0,5 user reviews,1,4,5
506040,True,6,Mostly Positive,13,4,17
506080,True,5,Mixed,6,4,10
506090,True,0,4 user reviews,2,2,4
506100,True,0,8 user reviews,4,4,8
506110,True,0,No user reviews,0,0,0
506120,True,0,No user reviews,0,0,0
506140,True,6,Mostly Positive,23,7,30
506150,True,7,Positive,10,1,11
506160,True,0,6 user reviews,3,3,6
506180,True,0,No user reviews,0,0,0
506210,True,0,No user reviews,0,0,0
506220,True,0,1 user reviews,1,0,1
506230,True,0,1 user reviews,1,0,1
506240,True,0,4 user reviews,3,1,4
506250,True,0,No user reviews,0,0,0
506260,True,5,Mixed,12,8,20
506270,True,0,No user reviews,0,0,0
506280,True,0,No user reviews,0,0,0
506300,True,0,4 user reviews,4,0,4
506310,True,0,No user reviews,0,0,0
506330,True,0,No user reviews,0,0,0
506340,True,0,No user reviews,0,0,0
506350,True,0,1 user reviews,1,0,1
506360,True,0,3 user reviews,2,1,3
506370,True,0,No user reviews,0,0,0
506380,True,0,No user reviews,0,0,0
506390,True,0,No user reviews,0,0,0
506400,True,0,No user reviews,0,0,0
506410,True,0,No user reviews,0,0,0
506440,True,0,1 user reviews,1,0,1
506450,True,0,No user reviews,0,0,0
506460,True,0,6 user reviews,6,0,6
506470,True,0,4 user reviews,3,1,4
506480,True,0,No user reviews,0,0,0
506500,True,6,Mostly Positive,252,94,346
506510,True,8,Very Positive,107,7,114
506540,True,4,Mostly Negative,5,17,22
506550,True,6,Mostly Positive,14,4,18
506570,True,0,5 user reviews,2,3,5
506590,True,6,Mostly Positive,17,7,24
506600,True,0,No user reviews,0,0,0
506610,True,8,Very Positive,3773,330,4103
506620,True,0,No user reviews,0,0,0
506640,True,0,No user reviews,0,0,0
506660,True,0,2 user reviews,0,2,2
506670,True,7,Positive,14,2,16
506700,True,0,5 user reviews,5,0,5
506720,True,0,No user reviews,0,0,0
506730,True,5,Mixed,142,90,232
506750,True,5,Mixed,6,4,10
506760,True,5,Mixed,7,9,16
506770,True,0,5 user reviews,4,1,5
506780,True,7,Positive,14,0,14
506800,True,5,Mixed,28,41,69
506801,True,0,No user reviews,0,0,0
506802,True,0,No user reviews,0,0,0
506803,True,0,No user reviews,0,0,0
506804,True,0,No user reviews,0,0,0
506830,True,0,5 user reviews,4,1,5
506840,True,0,7 user reviews,3,4,7
506850,True,0,2 user reviews,2,0,2
506860,True,0,No user reviews,0,0,0
506870,True,8,Very Positive,385,39,424
506900,True,6,Mostly Positive,198,74,272
506910,True,0,4 user reviews,4,0,4
506920,True,0,1 user reviews,1,0,1
506930,True,0,9 user reviews,4,5,9
506940,True,0,No user reviews,0,0,0
506960,True,0,5 user reviews,2,3,5
506970,True,5,Mixed,797,527,1324
506971,True,8,Very Positive,801,127,928
506980,True,0,No user reviews,0,0,0
507010,True,6,Mostly Positive,1099,373,1472
507020,True,0,2 user reviews,2,0,2
507030,True,7,Positive,8,2,10
507040,True,0,No user reviews,0,0,0
507050,True,0,9 user reviews,2,7,9
507060,True,0,9 user reviews,8,1,9
507070,True,7,Positive,29,1,30
507080,True,7,Positive,16,2,18
507120,True,5,Mixed,19,9,28
507130,True,0,No user reviews,0,0,0
507140,True,0,5 user reviews,4,1,5
507180,True,0,No user reviews,0,0,0
507210,True,0,3 user reviews,1,2,3
507270,True,0,2 user reviews,1,1,2
507300,True,0,3 user reviews,1,2,3
507310,True,0,No user reviews,0,0,0
507340,True,0,4 user reviews,2,2,4
507360,True,0,4 user reviews,1,3,4
507380,True,5,Mixed,6,6,12
507390,True,5,Mixed,67,63,130
507400,True,0,6 user reviews,5,1,6
507430,True,0,No user reviews,0,0,0
507440,True,0,5 user reviews,1,4,5
507450,True,0,No user reviews,0,0,0
507470,True,0,No user reviews,0,0,0
507480,True,0,No user reviews,0,0,0
507490,True,8,Very Positive,1075,229,1304
507510,True,5,Mixed,57,64,121
507520,True,8,Very Positive,43,10,53
507530,True,0,No user reviews,0,0,0
507540,True,0,No user reviews,0,0,0
507570,True,0,No user reviews,0,0,0
507580,True,0,No user reviews,0,0,0
507590,True,0,No user reviews,0,0,0
507591,True,0,No user reviews,0,0,0
507592,True,0,No user reviews,0,0,0
507593,True,0,No user reviews,0,0,0
507594,True,0,No user reviews,0,0,0
507620,True,0,No user reviews,0,0,0
507630,True,0,No user reviews,0,0,0
507640,True,0,No user reviews,0,0,0
507641,True,0,No user reviews,0,0,0
507642,True,0,1 user reviews,0,1,1
507643,True,0,No user reviews,0,0,0
507670,True,0,No user reviews,0,0,0
507680,True,0,No user reviews,0,0,0
507690,True,0,No user reviews,0,0,0
507691,True,0,No user reviews,0,0,0
507692,True,0,No user reviews,0,0,0
507720,True,0,No user reviews,0,0,0
507730,True,0,No user reviews,0,0,0
507740,True,0,4 user reviews,4,0,4
507750,True,0,No user reviews,0,0,0
507760,True,0,No user reviews,0,0,0
507770,True,0,No user reviews,0,0,0
507820,True,0,No user reviews,0,0,0
507830,True,0,No user reviews,0,0,0
507840,True,0,No user reviews,0,0,0
507850,True,0,No user reviews,0,0,0
507860,True,0,No user reviews,0,0,0
507870,True,0,No user reviews,0,0,0
507880,True,0,No user reviews,0,0,0
507881,True,0,No user reviews,0,0,0
507882,True,0,No user reviews,0,0,0
507890,True,0,No user reviews,0,0,0
507891,True,0,No user reviews,0,0,0
507892,True,0,No user reviews,0,0,0
507900,True,0,No user reviews,0,0,0
507901,True,0,No user reviews,0,0,0
507910,True,0,No user reviews,0,0,0
507911,True,0,No user reviews,0,0,0
507920,True,0,No user reviews,0,0,0
507921,True,0,No user reviews,0,0,0
507930,True,0,1 user reviews,0,1,1
507931,True,0,No user reviews,0,0,0
507980,True,0,No user reviews,0,0,0
507990,True,0,No user reviews,0,0,0
508000,True,0,1 user reviews,1,0,1
508010,True,0,No user reviews,0,0,0
508020,True,0,No user reviews,0,0,0
508030,True,0,No user reviews,0,0,0
508080,True,0,No user reviews,0,0,0
508090,True,0,No user reviews,0,0,0
508100,True,0,No user reviews,0,0,0
508101,True,0,No user reviews,0,0,0
508110,True,0,1 user reviews,0,1,1
508120,True,0,No user reviews,0,0,0
508130,True,0,No user reviews,0,0,0
508131,True,0,No user reviews,0,0,0
508132,True,0,No user reviews,0,0,0
508140,True,5,Mixed,127,65,192
508150,True,5,Mixed,30,14,44
508160,True,0,2 user reviews,2,0,2
508161,True,7,Positive,22,0,22
508162,True,0,5 user reviews,5,0,5
508163,True,0,5 user reviews,5,0,5
508165,True,0,2 user reviews,2,0,2
508170,True,6,Mostly Positive,77,20,97
508180,True,6,Mostly Positive,31,13,44
508190,True,5,Mixed,178,95,273
508200,True,0,8 user reviews,3,5,8
508230,True,5,Mixed,24,12,36
508250,True,0,No user reviews,0,0,0
508260,True,7,Positive,36,8,44
508270,True,0,No user reviews,0,0,0
508271,True,0,No user reviews,0,0,0
508280,True,0,3 user reviews,3,0,3
508290,True,5,Mixed,20,26,46
508300,True,5,Mixed,32,27,59
508320,True,0,No user reviews,0,0,0
508330,True,0,1 user reviews,1,0,1
508340,True,5,Mixed,7,5,12
508350,True,0,9 user reviews,6,3,9
508390,True,0,9 user reviews,8,1,9
508400,True,5,Mixed,25,36,61
508401,True,5,Mixed,25,23,48
508402,True,6,Mostly Positive,49,15,64
508403,True,7,Positive,40,8,48
508404,True,0,No user reviews,0,0,0
508405,True,0,1 user reviews,1,0,1
508410,True,5,Mixed,15,8,23
508420,True,0,No user reviews,0,0,0
508430,True,0,No user reviews,0,0,0
508440,True,9,Overwhelmingly Positive,23177,494,23671
508450,True,5,Mixed,104,101,205
508460,True,0,No user reviews,0,0,0
508470,True,0,No user reviews,0,0,0
508490,True,0,No user reviews,0,0,0
508510,True,0,No user reviews,0,0,0
508520,True,0,4 user reviews,4,0,4
508530,True,7,Positive,25,0,25
508540,True,0,5 user reviews,2,3,5
508550,True,6,Mostly Positive,325,107,432
508560,True,0,2 user reviews,1,1,2
508561,True,0,No user reviews,0,0,0
508580,True,6,Mostly Positive,16,5,21
508590,True,0,6 user reviews,0,6,6
508600,True,6,Mostly Positive,192,56,248
508610,True,0,3 user reviews,2,1,3
508620,True,0,No user reviews,0,0,0
508630,True,0,1 user reviews,0,1,1
508640,True,0,No user reviews,0,0,0
508650,True,0,6 user reviews,4,2,6
508660,True,3,Negative,0,11,11
508680,True,0,2 user reviews,1,1,2
508690,True,0,8 user reviews,3,5,8
508710,True,6,Mostly Positive,12,5,17
508730,True,0,7 user reviews,4,3,7
508740,True,5,Mixed,29,23,52
508760,True,0,7 user reviews,5,2,7
508770,True,0,1 user reviews,0,1,1
508771,True,0,2 user reviews,1,1,2
508772,True,0,1 user reviews,1,0,1
508780,True,0,No user reviews,0,0,0
508790,True,8,Very Positive,59,3,62
508800,True,0,No user reviews,0,0,0
508810,True,0,No user reviews,0,0,0
508820,True,5,Mixed,9,4,13
508830,True,0,1 user reviews,1,0,1
508840,True,6,Mostly Positive,49,15,64
508860,True,0,No user reviews,0,0,0
508890,True,0,1 user reviews,1,0,1
508900,True,9,Overwhelmingly Positive,727,24,751
508910,True,0,6 user reviews,5,1,6
508920,True,0,No user reviews,0,0,0
508930,True,0,6 user reviews,2,4,6
508940,True,0,6 user reviews,5,1,6
508950,True,0,4 user reviews,3,1,4
508980,True,8,Very Positive,218,37,255
508990,True,8,Very Positive,78,4,82
509020,True,0,1 user reviews,1,0,1
509030,True,0,1 user reviews,1,0,1
509031,True,0,1 user reviews,1,0,1
509032,True,0,No user reviews,0,0,0
509050,True,0,1 user reviews,1,0,1
509060,True,0,6 user reviews,6,0,6
509061,True,0,No user reviews,0,0,0
509070,True,5,Mixed,11,6,17
509090,True,0,No user reviews,0,0,0
509100,True,0,No user reviews,0,0,0
509110,True,8,Very Positive,54,7,61
509120,True,0,2 user reviews,1,1,2
509130,True,7,Positive,14,3,17
509140,True,0,No user reviews,0,0,0
509160,True,7,Positive,10,1,11
509170,True,0,2 user reviews,2,0,2
509190,True,0,3 user reviews,2,1,3
509200,True,0,No user reviews,0,0,0
509210,True,5,Mixed,14,8,22
509220,True,8,Very Positive,585,58,643
509230,True,0,6 user reviews,4,2,6
509250,True,8,Very Positive,432,61,493
509260,True,5,Mixed,5,6,11
509290,True,6,Mostly Positive,17,7,24
509300,True,0,No user reviews,0,0,0
509310,True,0,2 user reviews,2,0,2
509340,True,0,3 user reviews,3,0,3
509350,True,8,Very Positive,49,2,51
509360,True,5,Mixed,25,11,36
509380,True,0,No user reviews,0,0,0
509390,True,0,8 user reviews,4,4,8
509400,True,0,5 user reviews,4,1,5
509420,True,0,6 user reviews,1,5,6
509430,True,7,Positive,13,0,13
509440,True,3,Negative,2,10,12
509450,True,0,6 user reviews,3,3,6
509500,True,0,2 user reviews,2,0,2
509510,True,0,No user reviews,0,0,0
509520,True,0,1 user reviews,1,0,1
509521,True,0,No user reviews,0,0,0
509522,True,0,1 user reviews,1,0,1
509530,True,0,No user reviews,0,0,0
509540,True,6,Mostly Positive,50,15,65
509560,True,0,No user reviews,0,0,0
509570,True,8,Very Positive,120,12,132
509580,True,6,Mostly Positive,390,141,531
509590,True,0,3 user reviews,3,0,3
509600,True,5,Mixed,19,9,28
509610,True,4,Mostly Negative,4,11,15
509620,True,0,3 user reviews,3,0,3
509630,True,0,3 user reviews,2,1,3
509631,True,0,3 user reviews,1,2,3
509632,True,0,3 user reviews,2,1,3
509633,True,0,No user reviews,0,0,0
509634,True,0,No user reviews,0,0,0
509635,True,0,No user reviews,0,0,0
509636,True,0,No user reviews,0,0,0
509637,True,0,7 user reviews,7,0,7
509638,True,0,No user reviews,0,0,0
509639,True,0,No user reviews,0,0,0
509640,True,0,No user reviews,0,0,0
509641,True,0,No user reviews,0,0,0
509642,True,0,5 user reviews,5,0,5
509643,True,0,1 user reviews,1,0,1
509644,True,0,No user reviews,0,0,0
509645,True,0,2 user reviews,1,1,2
509646,True,0,No user reviews,0,0,0
509647,True,0,6 user reviews,4,2,6
509648,True,0,1 user reviews,1,0,1
509649,True,0,4 user reviews,4,0,4
509650,True,0,No user reviews,0,0,0
509651,True,0,No user reviews,0,0,0
509652,True,0,No user reviews,0,0,0
509653,True,0,No user reviews,0,0,0
509654,True,0,3 user reviews,3,0,3
509655,True,0,No user reviews,0,0,0
509656,True,0,No user reviews,0,0,0
509657,True,0,No user reviews,0,0,0
509658,True,0,No user reviews,0,0,0
509659,True,0,No user reviews,0,0,0
509660,True,0,1 user reviews,1,0,1
509661,True,0,No user reviews,0,0,0
509662,True,0,2 user reviews,2,0,2
509663,True,0,No user reviews,0,0,0
509664,True,0,2 user reviews,2,0,2
509665,True,0,1 user reviews,1,0,1
509666,True,0,No user reviews,0,0,0
509667,True,0,No user reviews,0,0,0
509668,True,0,No user reviews,0,0,0
509669,True,0,No user reviews,0,0,0
509670,True,0,No user reviews,0,0,0
509671,True,0,No user reviews,0,0,0
509672,True,0,No user reviews,0,0,0
509673,True,0,No user reviews,0,0,0
509674,True,0,No user reviews,0,0,0
509675,True,0,1 user reviews,1,0,1
509676,True,0,No user reviews,0,0,0
509677,True,0,1 user reviews,1,0,1
509678,True,0,No user reviews,0,0,0
509679,True,0,No user reviews,0,0,0
509680,True,0,2 user reviews,2,0,2
509681,True,0,1 user reviews,0,1,1
509682,True,0,No user reviews,0,0,0
509683,True,0,1 user reviews,1,0,1
509684,True,0,No user reviews,0,0,0
509685,True,0,No user reviews,0,0,0
509686,True,0,1 user reviews,1,0,1
509687,True,0,1 user reviews,1,0,1
509688,True,0,2 user reviews,2,0,2
509689,True,0,1 user reviews,1,0,1
509690,True,0,No user reviews,0,0,0
509691,True,0,No user reviews,0,0,0
509692,True,0,2 user reviews,2,0,2
509693,True,0,No user reviews,0,0,0
509694,True,0,1 user reviews,1,0,1
509695,True,0,No user reviews,0,0,0
509696,True,0,No user reviews,0,0,0
509697,True,0,No user reviews,0,0,0
509698,True,0,No user reviews,0,0,0
509699,True,0,2 user reviews,2,0,2
509700,True,0,No user reviews,0,0,0
509701,True,0,No user reviews,0,0,0
509702,True,0,No user reviews,0,0,0
509703,True,0,No user reviews,0,0,0
509704,True,0,No user reviews,0,0,0
509705,True,0,No user reviews,0,0,0
509706,True,0,No user reviews,0,0,0
509707,True,0,No user reviews,0,0,0
509708,True,0,No user reviews,0,0,0
509709,True,0,1 user reviews,1,0,1
509710,True,0,3 user reviews,1,2,3
509711,True,0,No user reviews,0,0,0
509712,True,0,No user reviews,0,0,0
509713,True,0,2 user reviews,1,1,2
509714,True,0,4 user reviews,2,2,4
509715,True,0,1 user reviews,1,0,1
509716,True,0,1 user reviews,1,0,1
509717,True,0,2 user reviews,1,1,2
509718,True,0,1 user reviews,1,0,1
509719,True,0,No user reviews,0,0,0
509720,True,0,No user reviews,0,0,0
509721,True,0,No user reviews,0,0,0
509722,True,0,No user reviews,0,0,0
509723,True,0,No user reviews,0,0,0
509724,True,0,4 user reviews,3,1,4
509725,True,0,No user reviews,0,0,0
509726,True,0,No user reviews,0,0,0
509727,True,0,No user reviews,0,0,0
509728,True,0,No user reviews,0,0,0
509729,True,0,No user reviews,0,0,0
509730,True,0,No user reviews,0,0,0
509731,True,0,No user reviews,0,0,0
509732,True,0,No user reviews,0,0,0
509733,True,0,No user reviews,0,0,0
509734,True,0,No user reviews,0,0,0
509735,True,0,No user reviews,0,0,0
509736,True,0,No user reviews,0,0,0
509737,True,0,1 user reviews,1,0,1
509738,True,0,No user reviews,0,0,0
509739,True,0,1 user reviews,1,0,1
509740,True,0,No user reviews,0,0,0
509741,True,0,No user reviews,0,0,0
509742,True,0,No user reviews,0,0,0
509743,True,0,1 user reviews,1,0,1
509744,True,0,No user reviews,0,0,0
509745,True,0,No user reviews,0,0,0
509746,True,0,No user reviews,0,0,0
509747,True,0,No user reviews,0,0,0
509748,True,0,No user reviews,0,0,0
509749,True,0,No user reviews,0,0,0
509770,True,5,Mixed,38,17,55
509780,True,7,Positive,13,1,14
509800,True,0,No user reviews,0,0,0
509810,True,0,No user reviews,0,0,0
509820,True,7,Positive,10,1,11
509830,True,0,1 user reviews,0,1,1
509840,True,6,Mostly Positive,44,13,57
509850,True,0,9 user reviews,7,2,9
509860,True,0,No user reviews,0,0,0
509880,True,0,No user reviews,0,0,0
509890,True,0,No user reviews,0,0,0
509900,True,0,No user reviews,0,0,0
509910,True,0,3 user reviews,2,1,3
509920,True,0,4 user reviews,2,2,4
509930,True,0,2 user reviews,0,2,2
509950,True,0,No user reviews,0,0,0
509960,True,0,7 user reviews,3,4,7
509980,True,6,Mostly Positive,2202,732,2934
510000,True,0,No user reviews,0,0,0
510040,True,7,Positive,21,1,22
510050,True,7,Positive,15,1,16
510060,True,7,Positive,20,0,20
510070,True,7,Positive,9,2,11
510080,True,0,9 user reviews,5,4,9
510090,True,0,1 user reviews,1,0,1
510100,True,0,No user reviews,0,0,0
510110,True,0,4 user reviews,2,2,4
510120,True,4,Mostly Negative,3,10,13
510130,True,0,No user reviews,0,0,0
510140,True,0,1 user reviews,1,0,1
510150,True,0,No user reviews,0,0,0
510160,True,0,No user reviews,0,0,0
510180,True,0,No user reviews,0,0,0
510190,True,0,No user reviews,0,0,0
510200,True,0,4 user reviews,2,2,4
510230,True,0,No user reviews,0,0,0
510240,True,7,Positive,13,3,16
510250,True,7,Positive,17,1,18
510270,True,0,No user reviews,0,0,0
510271,True,0,No user reviews,0,0,0
510280,True,0,3 user reviews,3,0,3
510290,True,6,Mostly Positive,23,6,29
510310,True,0,No user reviews,0,0,0
510320,True,7,Positive,10,2,12
510330,True,0,2 user reviews,0,2,2
510340,True,0,No user reviews,0,0,0
510350,True,0,No user reviews,0,0,0
510360,True,0,8 user reviews,3,5,8
510370,True,0,No user reviews,0,0,0
510380,True,0,6 user reviews,1,5,6
510390,True,0,9 user reviews,5,4,9
510400,True,0,1 user reviews,1,0,1
510410,True,5,Mixed,10,5,15
510420,True,8,Very Positive,571,32,603
510430,True,0,6 user reviews,6,0,6
510450,True,0,No user reviews,0,0,0
510470,True,0,No user reviews,0,0,0
510480,True,0,No user reviews,0,0,0
510490,True,8,Very Positive,236,57,293
510500,True,8,Very Positive,410,79,489
510510,True,5,Mixed,272,232,504
510520,True,8,Very Positive,69,8,77
510530,True,0,2 user reviews,2,0,2
510540,True,8,Very Positive,128,6,134
510550,True,0,8 user reviews,4,4,8
510570,True,5,Mixed,21,13,34
510590,True,7,Positive,41,7,48
510600,True,0,No user reviews,0,0,0
510610,True,0,1 user reviews,1,0,1
510620,True,8,Very Positive,82,7,89
510630,True,0,8 user reviews,6,2,8
510640,True,0,No user reviews,0,0,0
510650,True,6,Mostly Positive,39,13,52
510660,True,7,Positive,8,2,10
510670,True,0,No user reviews,0,0,0
510680,True,0,9 user reviews,9,0,9
510690,True,0,No user reviews,0,0,0
510700,True,0,7 user reviews,5,2,7
510710,True,0,No user reviews,0,0,0
510720,True,0,No user reviews,0,0,0
510730,True,0,1 user reviews,0,1,1
510740,True,7,Positive,16,3,19
510750,True,0,1 user reviews,0,1,1
510780,True,5,Mixed,5,5,10
510790,True,0,2 user reviews,1,1,2
510800,True,0,2 user reviews,2,0,2
510820,True,0,No user reviews,0,0,0
510830,True,0,8 user reviews,8,0,8
510840,True,0,8 user reviews,6,2,8
510850,True,5,Mixed,27,16,43
510910,True,6,Mostly Positive,31,11,42
510930,True,6,Mostly Positive,65,17,82
510940,True,0,1 user reviews,0,1,1
510950,True,0,No user reviews,0,0,0
510960,True,0,2 user reviews,2,0,2
510970,True,0,No user reviews,0,0,0
510980,True,0,No user reviews,0,0,0
510990,True,0,8 user reviews,7,1,8
511000,True,0,No user reviews,0,0,0
511010,True,0,9 user reviews,5,4,9
511070,True,0,2 user reviews,2,0,2
511090,True,5,Mixed,8,4,12
511110,True,0,No user reviews,0,0,0
511120,True,0,3 user reviews,2,1,3
511130,True,0,1 user reviews,1,0,1
511131,True,0,No user reviews,0,0,0
511140,True,8,Very Positive,82,9,91
511160,True,6,Mostly Positive,12,5,17
511170,True,0,2 user reviews,1,1,2
511190,True,5,Mixed,8,4,12
511200,True,0,1 user reviews,1,0,1
511230,True,0,3 user reviews,2,1,3
511240,True,0,2 user reviews,2,0,2
511250,True,0,7 user reviews,7,0,7
511270,True,0,No user reviews,0,0,0
511280,True,0,No user reviews,0,0,0
511300,True,0,3 user reviews,3,0,3
511301,True,0,1 user reviews,1,0,1
511310,True,3,Negative,2,13,15
511320,True,7,Positive,9,2,11
511330,True,5,Mixed,6,8,14
511340,True,5,Mixed,21,15,36
511350,True,8,Very Positive,118,4,122
511360,True,0,No user reviews,0,0,0
511370,True,7,Positive,18,1,19
511380,True,7,Positive,15,0,15
511390,True,0,3 user reviews,3,0,3
511400,True,0,No user reviews,0,0,0
511410,True,0,No user reviews,0,0,0
511420,True,0,No user reviews,0,0,0
511430,True,5,Mixed,36,19,55
511450,True,0,2 user reviews,2,0,2
511460,True,0,8 user reviews,4,4,8
511470,True,9,Overwhelmingly Positive,1021,26,1047
511480,True,0,No user reviews,0,0,0
511490,True,0,5 user reviews,3,2,5
511500,True,5,Mixed,16,8,24
511540,True,8,Very Positive,43,10,53
511560,True,5,Mixed,8,5,13
511570,True,7,Positive,37,5,42
511600,True,0,8 user reviews,5,3,8
511610,True,0,3 user reviews,2,1,3
511630,True,7,Positive,35,5,40
511650,True,0,No user reviews,0,0,0
511660,True,5,Mixed,7,9,16
511670,True,0,4 user reviews,2,2,4
511680,True,8,Very Positive,555,44,599
511690,True,0,5 user reviews,4,1,5
511700,True,7,Positive,10,0,10
511710,True,0,No user reviews,0,0,0
511720,True,5,Mixed,14,16,30
511730,True,0,No user reviews,0,0,0
511740,True,8,Very Positive,698,94,792
511750,True,0,6 user reviews,5,1,6
511760,True,0,2 user reviews,1,1,2
511780,True,0,No user reviews,0,0,0
511781,True,0,No user reviews,0,0,0
511782,True,0,No user reviews,0,0,0
511790,True,5,Mixed,13,10,23
511800,True,0,4 user reviews,4,0,4
511810,True,0,1 user reviews,0,1,1
511820,True,5,Mixed,6,5,11
511830,True,0,6 user reviews,2,4,6
511840,True,0,No user reviews,0,0,0
511850,True,0,No user reviews,0,0,0
511880,True,0,No user reviews,0,0,0
511920,True,0,2 user reviews,2,0,2
511930,True,0,No user reviews,0,0,0
511940,True,0,8 user reviews,7,1,8
511950,True,0,No user reviews,0,0,0
511960,True,0,3 user reviews,2,1,3
511970,True,0,No user reviews,0,0,0
512000,True,7,Positive,14,1,15
512010,True,0,9 user reviews,9,0,9
512020,True,5,Mixed,27,12,39
512030,True,0,No user reviews,0,0,0
512032,True,4,Mostly Negative,91,281,372
512033,True,5,Mixed,141,186,327
512034,True,5,Mixed,200,115,315
512035,True,5,Mixed,103,95,198
512060,True,8,Very Positive,347,19,366
512070,True,0,1 user reviews,1,0,1
512080,True,6,Mostly Positive,82,30,112
512090,True,0,3 user reviews,1,2,3
512100,True,7,Positive,14,1,15
512110,True,6,Mostly Positive,8,3,11
512120,True,7,Positive,9,2,11
512140,True,0,No user reviews,0,0,0
512150,True,7,Positive,23,0,23
512160,True,5,Mixed,31,18,49
512170,True,0,2 user reviews,1,1,2
512180,True,8,Very Positive,266,9,275
512190,True,0,No user reviews,0,0,0
512220,True,8,Very Positive,308,36,344
512230,True,7,Positive,22,1,23
512240,True,7,Positive,31,2,33
512250,True,8,Very Positive,2049,202,2251
512260,True,7,Positive,26,4,30
512270,True,0,No user reviews,0,0,0
512290,True,0,No user reviews,0,0,0
512300,True,8,Very Positive,163,25,188
512310,True,0,2 user reviews,2,0,2
512311,True,0,No user reviews,0,0,0
512312,True,0,No user reviews,0,0,0
512313,True,0,2 user reviews,1,1,2
512314,True,0,1 user reviews,1,0,1
512315,True,0,No user reviews,0,0,0
512340,True,5,Mixed,16,12,28
512350,True,5,Mixed,24,20,44
512360,True,0,No user reviews,0,0,0
512370,True,0,3 user reviews,3,0,3
512380,True,0,No user reviews,0,0,0
512400,True,0,6 user reviews,1,5,6
512410,True,0,9 user reviews,3,6,9
512420,True,7,Positive,8,2,10
512430,True,5,Mixed,12,11,23
512460,True,8,Very Positive,82,5,87
512470,True,6,Mostly Positive,28,9,37
512480,True,0,No user reviews,0,0,0
512490,True,8,Very Positive,281,5,286
512500,True,0,No user reviews,0,0,0
512530,True,0,No user reviews,0,0,0
512540,True,6,Mostly Positive,1452,533,1985
512550,True,0,4 user reviews,2,2,4
512560,True,0,2 user reviews,0,2,2
512600,True,7,Positive,26,5,31
512610,True,0,6 user reviews,4,2,6
512620,True,0,4 user reviews,4,0,4
512621,True,5,Mixed,6,4,10
512622,True,0,3 user reviews,3,0,3
512630,True,0,No user reviews,0,0,0
512640,True,5,Mixed,7,6,13
512670,True,0,1 user reviews,1,0,1
512680,True,0,6 user reviews,6,0,6
512700,True,0,1 user reviews,0,1,1
512710,True,0,No user reviews,0,0,0
512720,True,0,No user reviews,0,0,0
512740,True,7,Positive,18,3,21
512750,True,7,Positive,11,0,11
512770,True,0,5 user reviews,5,0,5
512790,True,8,Very Positive,1155,105,1260
512810,True,0,No user reviews,0,0,0
512830,True,0,7 user reviews,4,3,7
512850,True,0,No user reviews,0,0,0
512870,True,0,No user reviews,0,0,0
512880,True,0,1 user reviews,1,0,1
512890,True,8,Very Positive,115,4,119
512900,True,9,Overwhelmingly Positive,4580,147,4727
512920,True,0,1 user reviews,0,1,1
512930,True,0,No user reviews,0,0,0
512940,True,0,9 user reviews,4,5,9
512950,True,0,1 user reviews,1,0,1
512970,True,0,No user reviews,0,0,0
512980,True,0,No user reviews,0,0,0
512990,True,0,No user reviews,0,0,0
513000,True,5,Mixed,19,24,43
513010,True,0,3 user reviews,3,0,3
513030,True,5,Mixed,13,6,19
513031,True,5,Mixed,7,5,12
513032,True,4,Mostly Negative,4,14,18
513033,True,5,Mixed,12,9,21
513034,True,5,Mixed,11,5,16
513040,True,0,No user reviews,0,0,0
513050,True,0,7 user reviews,2,5,7
513060,True,0,6 user reviews,5,1,6
513090,True,0,1 user reviews,1,0,1
513091,True,0,No user reviews,0,0,0
513092,True,0,No user reviews,0,0,0
513093,True,0,4 user reviews,3,1,4
513094,True,0,No user reviews,0,0,0
513095,True,0,3 user reviews,1,2,3
513096,True,0,1 user reviews,1,0,1
513097,True,0,No user reviews,0,0,0
513098,True,0,No user reviews,0,0,0
513099,True,0,No user reviews,0,0,0
513100,True,0,No user reviews,0,0,0
513101,True,0,No user reviews,0,0,0
513102,True,0,No user reviews,0,0,0
513103,True,0,No user reviews,0,0,0
513104,True,0,No user reviews,0,0,0
513105,True,0,No user reviews,0,0,0
513106,True,0,1 user reviews,1,0,1
513107,True,0,1 user reviews,1,0,1
513108,True,0,1 user reviews,1,0,1
513109,True,0,No user reviews,0,0,0
513110,True,0,7 user reviews,7,0,7
513111,True,0,1 user reviews,0,1,1
513112,True,0,No user reviews,0,0,0
513113,True,0,No user reviews,0,0,0
513114,True,0,2 user reviews,1,1,2
513115,True,0,No user reviews,0,0,0
513116,True,0,2 user reviews,2,0,2
513117,True,0,2 user reviews,2,0,2
513118,True,0,No user reviews,0,0,0
513119,True,0,2 user reviews,2,0,2
513140,True,0,5 user reviews,3,2,5
513150,True,0,2 user reviews,1,1,2
513160,True,0,No user reviews,0,0,0
513170,True,0,4 user reviews,3,1,4
513190,True,6,Mostly Positive,21,7,28
513200,True,0,No user reviews,0,0,0
513210,True,0,2 user reviews,1,1,2
513230,True,4,Mostly Negative,74,121,195
513240,True,0,6 user reviews,3,3,6
513250,True,0,9 user reviews,9,0,9
513260,True,0,1 user reviews,1,0,1
513270,True,5,Mixed,11,6,17
513280,True,0,No user reviews,0,0,0
513290,True,5,Mixed,108,120,228
513300,True,0,9 user reviews,7,2,9
513310,True,0,No user reviews,0,0,0
513320,True,5,Mixed,32,47,79
513330,True,5,Mixed,36,54,90
513340,True,7,Positive,16,2,18
513360,True,8,Very Positive,83,11,94
513370,True,3,Negative,3,21,24
513420,True,5,Mixed,12,13,25
513430,True,5,Mixed,11,6,17
513440,True,0,No user reviews,0,0,0
513450,True,8,Very Positive,115,16,131
513460,True,5,Mixed,10,8,18
513470,True,0,No user reviews,0,0,0
513480,True,8,Very Positive,58,8,66
513490,True,0,No user reviews,0,0,0
513500,True,7,Positive,16,4,20
513510,True,8,Very Positive,1384,167,1551
513520,True,5,Mixed,8,4,12
513550,True,0,3 user reviews,3,0,3
513560,True,5,Mixed,21,19,40
513570,True,2,Very Negative,9,43,52
513580,True,0,6 user reviews,2,4,6
513590,True,4,Mostly Negative,9,18,27
513600,True,0,2 user reviews,2,0,2
513610,True,0,8 user reviews,6,2,8
513620,True,5,Mixed,15,22,37
513650,True,5,Mixed,71,38,109
513660,True,0,No user reviews,0,0,0
513670,True,0,No user reviews,0,0,0
513680,True,0,7 user reviews,4,3,7
513690,True,5,Mixed,31,21,52
513710,True,5,Mixed,11188,4824,16012
513720,True,6,Mostly Positive,14,6,20
513730,True,7,Positive,40,1,41
513740,True,4,Mostly Negative,4,12,16
513760,True,0,2 user reviews,2,0,2
513770,True,5,Mixed,4,6,10
513780,True,8,Very Positive,149,34,183
513790,True,5,Mixed,9,5,14
513800,True,7,Positive,26,0,26
513810,True,0,7 user reviews,2,5,7
513820,True,0,3 user reviews,2,1,3
513840,True,0,5 user reviews,5,0,5
513860,True,6,Mostly Positive,12,5,17
513880,True,5,Mixed,12,6,18
513890,True,8,Very Positive,141,13,154
513920,True,0,7 user reviews,6,1,7
513930,True,4,Mostly Negative,6,17,23
513960,True,0,3 user reviews,3,0,3
513980,True,6,Mostly Positive,13,4,17
513990,True,5,Mixed,17,11,28
514010,True,6,Mostly Positive,14,6,20
514020,True,0,No user reviews,0,0,0
514040,True,0,No user reviews,0,0,0
514050,True,0,7 user reviews,7,0,7
514070,True,0,No user reviews,0,0,0
514080,True,5,Mixed,8,6,14
514090,True,8,Very Positive,53,6,59
514100,True,0,No user reviews,0,0,0
514110,True,0,No user reviews,0,0,0
514120,True,0,No user reviews,0,0,0
514140,True,5,Mixed,8,5,13
514150,True,5,Mixed,13,9,22
514160,True,7,Positive,33,0,33
514170,True,5,Mixed,11,6,17
514180,True,7,Positive,16,4,20
514190,True,0,4 user reviews,4,0,4
514200,True,0,3 user reviews,2,1,3
514210,True,0,No user reviews,0,0,0
514220,True,0,2 user reviews,2,0,2
514230,True,0,No user reviews,0,0,0
514240,True,5,Mixed,31,40,71
514290,True,5,Mixed,30,38,68
514310,True,8,Very Positive,271,19,290
514320,True,0,No user reviews,0,0,0
514330,True,7,Positive,18,4,22
514331,True,0,1 user reviews,1,0,1
514332,True,0,1 user reviews,0,1,1
514340,True,7,Positive,16,1,17
514350,True,0,8 user reviews,6,2,8
514360,True,0,1 user reviews,0,1,1
514370,True,0,8 user reviews,6,2,8
514390,True,0,2 user reviews,1,1,2
514400,True,5,Mixed,7,5,12
514410,True,4,Mostly Negative,9,24,33
514450,True,0,6 user reviews,5,1,6
514460,True,4,Mostly Negative,9,14,23
514470,True,0,2 user reviews,2,0,2
514480,True,0,8 user reviews,6,2,8
514490,True,0,5 user reviews,2,3,5
514500,True,6,Mostly Positive,237,96,333
514510,True,0,1 user reviews,0,1,1
514520,True,0,3 user reviews,2,1,3
514530,True,0,3 user reviews,2,1,3
514540,True,0,2 user reviews,2,0,2
514550,True,0,3 user reviews,1,2,3
514570,True,5,Mixed,5,6,11
514580,True,7,Positive,35,3,38
514590,True,0,No user reviews,0,0,0
514600,True,0,No user reviews,0,0,0
514620,True,0,9 user reviews,9,0,9
514630,True,0,2 user reviews,0,2,2
514640,True,0,5 user reviews,4,1,5
514650,True,0,9 user reviews,8,1,9
514660,True,6,Mostly Positive,24,9,33
514670,True,5,Mixed,25,17,42
514690,True,0,No user reviews,0,0,0
514700,True,6,Mostly Positive,25,8,33
514720,True,0,4 user reviews,3,1,4
514730,True,0,3 user reviews,3,0,3
514740,True,0,2 user reviews,2,0,2
514750,True,7,Positive,12,1,13
514760,True,0,4 user reviews,4,0,4
514770,True,0,2 user reviews,2,0,2
514780,True,0,9 user reviews,3,6,9
514800,True,0,2 user reviews,1,1,2
514810,True,6,Mostly Positive,11,4,15
514820,True,0,1 user reviews,0,1,1
514830,True,6,Mostly Positive,14,6,20
514870,True,0,2 user reviews,2,0,2
514890,True,6,Mostly Positive,27,7,34
514900,True,6,Mostly Positive,1376,354,1730
514920,True,6,Mostly Positive,198,53,251
514930,True,0,2 user reviews,1,1,2
514970,True,4,Mostly Negative,9,14,23
514990,True,5,Mixed,47,24,71
515000,True,7,Positive,10,1,11
515010,True,0,9 user reviews,9,0,9
515020,True,7,Positive,14,0,14
515040,True,8,Very Positive,929,125,1054
515050,True,0,No user reviews,0,0,0
515060,True,0,6 user reviews,5,1,6
515090,True,0,7 user reviews,4,3,7
515100,True,0,6 user reviews,2,4,6
515110,True,0,4 user reviews,4,0,4
515120,True,0,2 user reviews,1,1,2
515130,True,0,8 user reviews,8,0,8
515140,True,0,2 user reviews,1,1,2
515150,True,0,3 user reviews,2,1,3
515160,True,0,3 user reviews,3,0,3
515170,True,0,5 user reviews,0,5,5
515171,True,0,3 user reviews,1,2,3
515180,True,6,Mostly Positive,871,235,1106
515190,True,5,Mixed,42,25,67
515191,True,6,Mostly Positive,301,86,387
515200,True,0,3 user reviews,0,3,3
515220,True,8,Very Positive,955,164,1119
515230,True,0,No user reviews,0,0,0
515240,True,0,1 user reviews,1,0,1
515260,True,6,Mostly Positive,59,19,78
515270,True,0,9 user reviews,8,1,9
515280,True,0,No user reviews,0,0,0
515300,True,4,Mostly Negative,3,8,11
515320,True,0,No user reviews,0,0,0
515330,True,0,No user reviews,0,0,0
515340,True,0,No user reviews,0,0,0
515350,True,0,No user reviews,0,0,0
515360,True,0,No user reviews,0,0,0
515370,True,0,No user reviews,0,0,0
515380,True,0,No user reviews,0,0,0
515390,True,0,No user reviews,0,0,0
515400,True,0,No user reviews,0,0,0
515410,True,0,No user reviews,0,0,0
515430,True,0,No user reviews,0,0,0
515440,True,0,No user reviews,0,0,0
515450,True,0,No user reviews,0,0,0
515460,True,0,No user reviews,0,0,0
515470,True,5,Mixed,25,31,56
515480,True,0,No user reviews,0,0,0
515490,True,0,No user reviews,0,0,0
515500,True,0,No user reviews,0,0,0
515510,True,0,No user reviews,0,0,0
515530,True,0,No user reviews,0,0,0
515540,True,0,No user reviews,0,0,0
515550,True,0,No user reviews,0,0,0
515560,True,0,No user reviews,0,0,0
515570,True,8,Very Positive,83,8,91
515580,True,0,No user reviews,0,0,0
515590,True,0,No user reviews,0,0,0
515600,True,0,No user reviews,0,0,0
515610,True,0,No user reviews,0,0,0
515620,True,0,No user reviews,0,0,0
515630,True,0,No user reviews,0,0,0
515640,True,0,No user reviews,0,0,0
515641,True,0,No user reviews,0,0,0
515642,True,0,No user reviews,0,0,0
515650,True,8,Very Positive,85,8,93
515660,True,0,No user reviews,0,0,0
515670,True,0,No user reviews,0,0,0
515680,True,0,5 user reviews,1,4,5
515690,True,5,Mixed,8,12,20
515700,True,0,2 user reviews,1,1,2
515710,True,8,Very Positive,80,17,97
515740,True,6,Mostly Positive,7,3,10
515750,True,0,No user reviews,0,0,0
515760,True,0,No user reviews,0,0,0
515761,True,0,No user reviews,0,0,0
515762,True,0,No user reviews,0,0,0
515763,True,0,No user reviews,0,0,0
515764,True,0,No user reviews,0,0,0
515765,True,0,No user reviews,0,0,0
515766,True,0,No user reviews,0,0,0
515767,True,0,No user reviews,0,0,0
515768,True,0,No user reviews,0,0,0
515769,True,0,No user reviews,0,0,0
515770,True,0,No user reviews,0,0,0
515771,True,0,No user reviews,0,0,0
515772,True,0,No user reviews,0,0,0
515800,True,0,No user reviews,0,0,0
515850,True,0,No user reviews,0,0,0
515880,True,0,No user reviews,0,0,0
515890,True,0,No user reviews,0,0,0
515900,True,0,2 user reviews,0,2,2
515910,True,5,Mixed,11,9,20
515950,True,0,No user reviews,0,0,0
515960,True,0,No user reviews,0,0,0
515970,True,0,No user reviews,0,0,0
515980,True,5,Mixed,24,19,43
515990,True,0,No user reviews,0,0,0
516000,True,0,1 user reviews,1,0,1
516010,True,0,No user reviews,0,0,0
516020,True,0,No user reviews,0,0,0
516030,True,5,Mixed,9,4,13
516040,True,5,Mixed,8,5,13
516050,True,0,1 user reviews,1,0,1
516090,True,0,No user reviews,0,0,0
516100,True,0,No user reviews,0,0,0
516110,True,8,Very Positive,342,29,371
516120,True,0,5 user reviews,5,0,5
516130,True,6,Mostly Positive,89,26,115
516250,True,0,9 user reviews,2,7,9
516260,True,0,No user reviews,0,0,0
516261,True,0,No user reviews,0,0,0
516262,True,0,No user reviews,0,0,0
516263,True,0,No user reviews,0,0,0
516264,True,0,No user reviews,0,0,0
516265,True,0,No user reviews,0,0,0
516266,True,0,No user reviews,0,0,0
516267,True,0,No user reviews,0,0,0
516268,True,0,No user reviews,0,0,0
516269,True,0,No user reviews,0,0,0
516270,True,0,No user reviews,0,0,0
516271,True,0,No user reviews,0,0,0
516272,True,0,No user reviews,0,0,0
516280,True,0,No user reviews,0,0,0
516281,True,0,No user reviews,0,0,0
516282,True,0,No user reviews,0,0,0
516283,True,0,No user reviews,0,0,0
516284,True,0,No user reviews,0,0,0
516285,True,0,No user reviews,0,0,0
516286,True,0,No user reviews,0,0,0
516287,True,0,1 user reviews,1,0,1
516288,True,0,No user reviews,0,0,0
516289,True,0,No user reviews,0,0,0
516290,True,0,No user reviews,0,0,0
516291,True,0,No user reviews,0,0,0
516292,True,0,No user reviews,0,0,0
516320,True,0,No user reviews,0,0,0
516330,True,0,1 user reviews,1,0,1
516331,True,0,2 user reviews,1,1,2
516340,True,0,No user reviews,0,0,0
516350,True,0,No user reviews,0,0,0
516360,True,0,No user reviews,0,0,0
516370,True,0,2 user reviews,2,0,2
516380,True,0,No user reviews,0,0,0
516400,True,0,No user reviews,0,0,0
516410,True,0,2 user reviews,2,0,2
516430,True,7,Positive,29,5,34
516440,True,0,2 user reviews,2,0,2
516450,True,0,9 user reviews,8,1,9
516460,True,0,1 user reviews,0,1,1
516470,True,0,6 user reviews,3,3,6
516480,True,8,Very Positive,180,2,182
516490,True,0,No user reviews,0,0,0
516500,True,7,Positive,12,2,14
516510,True,0,2 user reviews,2,0,2
516520,True,0,4 user reviews,4,0,4
516530,True,0,1 user reviews,0,1,1
516550,True,7,Positive,9,1,10
516560,True,0,6 user reviews,5,1,6
516570,True,7,Positive,11,0,11
516580,True,7,Positive,16,2,18
516590,True,6,Mostly Positive,61,20,81
516600,True,7,Positive,24,1,25
516610,True,0,4 user reviews,2,2,4
516620,True,0,No user reviews,0,0,0
516621,True,0,No user reviews,0,0,0
516622,True,0,No user reviews,0,0,0
516630,True,0,No user reviews,0,0,0
516640,True,0,3 user reviews,2,1,3
516650,True,5,Mixed,6,4,10
516660,True,0,No user reviews,0,0,0
516670,True,0,No user reviews,0,0,0
516680,True,0,4 user reviews,0,4,4
516710,True,0,1 user reviews,0,1,1
516740,True,0,1 user reviews,1,0,1
516750,True,8,Very Positive,10379,965,11344
516760,True,7,Positive,16,0,16
516770,True,0,2 user reviews,2,0,2
516780,True,0,No user reviews,0,0,0
516790,True,0,8 user reviews,5,3,8
516810,True,0,3 user reviews,3,0,3
516820,True,7,Positive,28,2,30
516830,True,0,No user reviews,0,0,0
516840,True,7,Positive,36,2,38
516850,True,0,No user reviews,0,0,0
516860,True,0,No user reviews,0,0,0
516870,True,0,2 user reviews,1,1,2
516890,True,0,7 user reviews,6,1,7
516900,True,0,3 user reviews,3,0,3
516910,True,0,1 user reviews,1,0,1
516920,True,0,6 user reviews,5,1,6
516930,True,0,No user reviews,0,0,0
516940,True,6,Mostly Positive,24,7,31
516950,True,0,4 user reviews,2,2,4
516960,True,0,3 user reviews,3,0,3
516970,True,0,No user reviews,0,0,0
516971,True,0,No user reviews,0,0,0
516972,True,0,No user reviews,0,0,0
516973,True,0,No user reviews,0,0,0
516974,True,0,No user reviews,0,0,0
516975,True,0,No user reviews,0,0,0
516976,True,0,No user reviews,0,0,0
516977,True,0,No user reviews,0,0,0
516978,True,0,No user reviews,0,0,0
516979,True,0,No user reviews,0,0,0
516980,True,0,No user reviews,0,0,0
516981,True,0,No user reviews,0,0,0
516982,True,0,No user reviews,0,0,0
516990,True,0,No user reviews,0,0,0
517000,True,8,Very Positive,52,11,63
517010,True,0,5 user reviews,1,4,5
517020,True,5,Mixed,25,16,41
517030,True,0,3 user reviews,3,0,3
517050,True,0,No user reviews,0,0,0
517060,True,0,9 user reviews,4,5,9
517100,True,6,Mostly Positive,8,3,11
517110,True,0,4 user reviews,0,4,4
517130,True,8,Very Positive,334,48,382
517140,True,0,8 user reviews,5,3,8
517160,True,8,Very Positive,303,67,370
517170,True,7,Positive,30,6,36
517190,True,0,1 user reviews,1,0,1
517210,True,7,Positive,10,2,12
517220,True,6,Mostly Positive,19,6,25
517230,True,0,No user reviews,0,0,0
517240,True,0,7 user reviews,3,4,7
517250,True,0,No user reviews,0,0,0
517270,True,0,4 user reviews,2,2,4
517280,True,0,4 user reviews,3,1,4
517290,True,0,No user reviews,0,0,0
517291,True,0,No user reviews,0,0,0
517292,True,0,No user reviews,0,0,0
517300,True,0,5 user reviews,1,4,5
517320,True,0,1 user reviews,1,0,1
517330,True,6,Mostly Positive,47,13,60
517340,True,0,4 user reviews,2,2,4
517350,True,5,Mixed,16,7,23
517360,True,5,Mixed,24,13,37
517370,True,6,Mostly Positive,81,24,105
517390,True,0,No user reviews,0,0,0
517400,True,0,8 user reviews,1,7,8
517410,True,0,No user reviews,0,0,0
517450,True,0,1 user reviews,1,0,1
517460,True,5,Mixed,6,5,11
517470,True,7,Positive,10,1,11
517480,True,0,3 user reviews,0,3,3
517500,True,0,3 user reviews,0,3,3
517510,True,0,8 user reviews,7,1,8
517530,True,0,No user reviews,0,0,0
517550,True,0,No user reviews,0,0,0
517560,True,0,1 user reviews,1,0,1
517620,True,0,4 user reviews,4,0,4
517630,True,5,Mixed,3197,2433,5630
517640,True,0,No user reviews,0,0,0
517660,True,0,3 user reviews,2,1,3
517670,True,8,Very Positive,65,12,77
517680,True,0,1 user reviews,1,0,1
517690,True,0,No user reviews,0,0,0
517710,True,8,Very Positive,1622,236,1858
517720,True,6,Mostly Positive,135,57,192
517730,True,0,No user reviews,0,0,0
517750,True,0,2 user reviews,1,1,2
517751,True,0,No user reviews,0,0,0
517752,True,0,1 user reviews,1,0,1
517760,True,0,No user reviews,0,0,0
517761,True,0,No user reviews,0,0,0
517762,True,0,No user reviews,0,0,0
517770,True,0,No user reviews,0,0,0
517780,True,6,Mostly Positive,86,25,111
517790,True,8,Very Positive,400,35,435
517810,True,6,Mostly Positive,149,59,208
517830,True,0,No user reviews,0,0,0
517831,True,5,Mixed,16,16,32
517910,True,7,Positive,20,2,22
517930,True,7,Positive,17,1,18
517960,True,0,6 user reviews,5,1,6
517970,True,0,7 user reviews,6,1,7
517990,True,0,8 user reviews,4,4,8
518000,True,0,4 user reviews,4,0,4
518020,True,0,No user reviews,0,0,0
518030,True,8,Very Positive,943,180,1123
518040,True,8,Very Positive,50,3,53
518060,True,6,Mostly Positive,242,88,330
518070,True,0,No user reviews,0,0,0
518080,True,0,No user reviews,0,0,0
518110,True,5,Mixed,11,10,21
518120,True,0,1 user reviews,1,0,1
518130,True,0,8 user reviews,5,3,8
518140,True,0,4 user reviews,2,2,4
518150,True,8,Very Positive,422,91,513
518190,True,0,3 user reviews,2,1,3
518200,True,0,No user reviews,0,0,0
518210,True,0,No user reviews,0,0,0
518211,True,0,No user reviews,0,0,0
518212,True,0,No user reviews,0,0,0
518213,True,0,No user reviews,0,0,0
518214,True,0,No user reviews,0,0,0
518215,True,0,No user reviews,0,0,0
518220,True,0,No user reviews,0,0,0
518230,True,0,1 user reviews,0,1,1
518240,True,0,No user reviews,0,0,0
518250,True,0,1 user reviews,1,0,1
518260,True,0,No user reviews,0,0,0
518270,True,0,No user reviews,0,0,0
518280,True,7,Positive,17,1,18
518320,True,0,9 user reviews,5,4,9
518360,True,0,4 user reviews,4,0,4
518370,True,0,1 user reviews,1,0,1
518390,True,0,No user reviews,0,0,0
518400,True,0,No user reviews,0,0,0
518410,True,0,No user reviews,0,0,0
518420,True,0,No user reviews,0,0,0
518430,True,0,No user reviews,0,0,0
518440,True,8,Very Positive,53,1,54
518450,True,0,4 user reviews,3,1,4
518460,True,0,5 user reviews,3,2,5
518470,True,0,No user reviews,0,0,0
518480,True,0,8 user reviews,8,0,8
518490,True,0,No user reviews,0,0,0
518500,True,0,1 user reviews,1,0,1
518510,True,0,No user reviews,0,0,0
518520,True,0,1 user reviews,1,0,1
518530,True,0,No user reviews,0,0,0
518540,True,0,No user reviews,0,0,0
518550,True,0,No user reviews,0,0,0
518560,True,0,No user reviews,0,0,0
518570,True,0,No user reviews,0,0,0
518580,True,8,Very Positive,75,4,79
518610,True,0,8 user reviews,6,2,8
518620,True,5,Mixed,6,5,11
518630,True,0,No user reviews,0,0,0
518640,True,0,No user reviews,0,0,0
518650,True,7,Positive,18,1,19
518660,True,5,Mixed,7,9,16
518670,True,8,Very Positive,59,8,67
518680,True,0,1 user reviews,1,0,1
518690,True,5,Mixed,14,8,22
518710,True,0,4 user reviews,4,0,4
518720,True,6,Mostly Positive,101,36,137
518730,True,8,Very Positive,78,7,85
518740,True,0,1 user reviews,1,0,1
518760,True,0,No user reviews,0,0,0
518780,True,0,No user reviews,0,0,0
518790,True,8,Very Positive,13151,2394,15545
518800,True,0,5 user reviews,1,4,5
518810,True,0,No user reviews,0,0,0
518811,True,0,No user reviews,0,0,0
518820,True,0,No user reviews,0,0,0
518821,True,0,No user reviews,0,0,0
518822,True,0,No user reviews,0,0,0
518823,True,0,No user reviews,0,0,0
518824,True,0,No user reviews,0,0,0
518825,True,0,No user reviews,0,0,0
518826,True,0,No user reviews,0,0,0
518827,True,0,No user reviews,0,0,0
518828,True,0,No user reviews,0,0,0
518829,True,0,No user reviews,0,0,0
518830,True,0,No user reviews,0,0,0
518831,True,0,No user reviews,0,0,0
518832,True,0,No user reviews,0,0,0
518833,True,0,No user reviews,0,0,0
518834,True,0,No user reviews,0,0,0
518835,True,0,No user reviews,0,0,0
518836,True,0,No user reviews,0,0,0
518837,True,0,No user reviews,0,0,0
518838,True,0,No user reviews,0,0,0
518839,True,0,No user reviews,0,0,0
518840,True,0,No user reviews,0,0,0
518841,True,0,No user reviews,0,0,0
518842,True,0,No user reviews,0,0,0
518843,True,0,No user reviews,0,0,0
518844,True,0,No user reviews,0,0,0
518845,True,0,No user reviews,0,0,0
518846,True,0,No user reviews,0,0,0
518847,True,0,No user reviews,0,0,0
518848,True,0,No user reviews,0,0,0
518849,True,0,No user reviews,0,0,0
518850,True,0,No user reviews,0,0,0
518851,True,0,No user reviews,0,0,0
518852,True,0,No user reviews,0,0,0
518853,True,0,No user reviews,0,0,0
518854,True,0,No user reviews,0,0,0
518855,True,0,No user reviews,0,0,0
518856,True,0,No user reviews,0,0,0
518857,True,0,No user reviews,0,0,0
518858,True,0,No user reviews,0,0,0
518859,True,0,No user reviews,0,0,0
518860,True,0,No user reviews,0,0,0
518861,True,0,No user reviews,0,0,0
518862,True,0,No user reviews,0,0,0
518863,True,0,No user reviews,0,0,0
518864,True,0,No user reviews,0,0,0
518865,True,0,No user reviews,0,0,0
518866,True,0,No user reviews,0,0,0
518867,True,0,No user reviews,0,0,0
518868,True,0,No user reviews,0,0,0
518869,True,0,No user reviews,0,0,0
518870,True,0,No user reviews,0,0,0
518871,True,0,No user reviews,0,0,0
518872,True,0,No user reviews,0,0,0
518873,True,0,No user reviews,0,0,0
518874,True,0,No user reviews,0,0,0
518875,True,0,No user reviews,0,0,0
518876,True,0,No user reviews,0,0,0
518877,True,0,No user reviews,0,0,0
518878,True,0,No user reviews,0,0,0
518879,True,0,No user reviews,0,0,0
518880,True,0,No user reviews,0,0,0
518881,True,0,No user reviews,0,0,0
518882,True,0,No user reviews,0,0,0
518883,True,0,No user reviews,0,0,0
518884,True,0,No user reviews,0,0,0
518885,True,0,No user reviews,0,0,0
518886,True,0,No user reviews,0,0,0
518887,True,0,No user reviews,0,0,0
518888,True,0,No user reviews,0,0,0
518889,True,0,No user reviews,0,0,0
518890,True,0,No user reviews,0,0,0
518891,True,0,No user reviews,0,0,0
518892,True,0,No user reviews,0,0,0
518893,True,0,No user reviews,0,0,0
518894,True,0,No user reviews,0,0,0
518895,True,0,No user reviews,0,0,0
518896,True,0,No user reviews,0,0,0
518897,True,0,No user reviews,0,0,0
518898,True,0,No user reviews,0,0,0
518899,True,0,No user reviews,0,0,0
518900,True,0,No user reviews,0,0,0
518901,True,0,No user reviews,0,0,0
518902,True,0,No user reviews,0,0,0
518903,True,0,No user reviews,0,0,0
518904,True,0,No user reviews,0,0,0
518905,True,0,No user reviews,0,0,0
518906,True,0,No user reviews,0,0,0
518907,True,0,No user reviews,0,0,0
518908,True,0,No user reviews,0,0,0
518909,True,0,No user reviews,0,0,0
518910,True,6,Mostly Positive,183,48,231
518920,True,5,Mixed,148,83,231
518940,True,0,No user reviews,0,0,0
518941,True,0,No user reviews,0,0,0
518942,True,0,No user reviews,0,0,0
518943,True,0,No user reviews,0,0,0
518944,True,0,No user reviews,0,0,0
518945,True,0,No user reviews,0,0,0
518946,True,0,No user reviews,0,0,0
518947,True,0,No user reviews,0,0,0
518948,True,0,No user reviews,0,0,0
518949,True,0,No user reviews,0,0,0
518950,True,0,No user reviews,0,0,0
518951,True,0,No user reviews,0,0,0
518952,True,0,No user reviews,0,0,0
518953,True,0,No user reviews,0,0,0
518954,True,0,No user reviews,0,0,0
518955,True,0,No user reviews,0,0,0
518956,True,0,No user reviews,0,0,0
518957,True,0,No user reviews,0,0,0
518958,True,0,No user reviews,0,0,0
518959,True,0,No user reviews,0,0,0
518960,True,0,No user reviews,0,0,0
518961,True,0,No user reviews,0,0,0
518962,True,0,No user reviews,0,0,0
518963,True,0,No user reviews,0,0,0
518964,True,0,No user reviews,0,0,0
518965,True,0,No user reviews,0,0,0
518966,True,0,No user reviews,0,0,0
518967,True,0,No user reviews,0,0,0
518968,True,0,No user reviews,0,0,0
518969,True,0,No user reviews,0,0,0
518970,True,0,No user reviews,0,0,0
518971,True,0,No user reviews,0,0,0
518972,True,0,No user reviews,0,0,0
518973,True,0,No user reviews,0,0,0
518974,True,0,No user reviews,0,0,0
518975,True,0,No user reviews,0,0,0
518976,True,0,No user reviews,0,0,0
518977,True,0,No user reviews,0,0,0
518978,True,0,No user reviews,0,0,0
518979,True,0,No user reviews,0,0,0
518980,True,0,No user reviews,0,0,0
518981,True,0,No user reviews,0,0,0
518982,True,0,No user reviews,0,0,0
518983,True,0,No user reviews,0,0,0
518984,True,0,No user reviews,0,0,0
518985,True,0,No user reviews,0,0,0
518986,True,0,No user reviews,0,0,0
518987,True,0,No user reviews,0,0,0
518988,True,0,No user reviews,0,0,0
518989,True,0,No user reviews,0,0,0
518990,True,0,No user reviews,0,0,0
518991,True,0,No user reviews,0,0,0
518992,True,0,No user reviews,0,0,0
518993,True,0,No user reviews,0,0,0
518994,True,0,No user reviews,0,0,0
518995,True,0,No user reviews,0,0,0
518996,True,0,No user reviews,0,0,0
518997,True,0,No user reviews,0,0,0
518998,True,0,No user reviews,0,0,0
518999,True,0,No user reviews,0,0,0
519000,True,0,No user reviews,0,0,0
519001,True,0,No user reviews,0,0,0
519002,True,0,No user reviews,0,0,0
519003,True,0,No user reviews,0,0,0
519004,True,0,No user reviews,0,0,0
519005,True,0,No user reviews,0,0,0
519006,True,0,No user reviews,0,0,0
519007,True,0,No user reviews,0,0,0
519008,True,0,No user reviews,0,0,0
519009,True,0,No user reviews,0,0,0
519010,True,0,No user reviews,0,0,0
519011,True,0,No user reviews,0,0,0
519012,True,0,No user reviews,0,0,0
519020,True,0,3 user reviews,2,1,3
519030,True,5,Mixed,22,13,35
519050,True,0,No user reviews,0,0,0
519070,True,0,No user reviews,0,0,0
519080,True,6,Mostly Positive,46,12,58
519100,True,0,No user reviews,0,0,0
519110,True,0,3 user reviews,3,0,3
519140,True,6,Mostly Positive,15,4,19
519160,True,5,Mixed,6,5,11
519170,True,0,1 user reviews,0,1,1
519180,True,3,Negative,2,20,22
519190,True,5,Mixed,1789,1224,3013
519200,True,0,9 user reviews,8,1,9
519210,True,0,No user reviews,0,0,0
519211,True,0,No user reviews,0,0,0
519212,True,0,No user reviews,0,0,0
519213,True,0,No user reviews,0,0,0
519214,True,0,No user reviews,0,0,0
519215,True,0,No user reviews,0,0,0
519216,True,0,No user reviews,0,0,0
519217,True,0,No user reviews,0,0,0
519218,True,0,No user reviews,0,0,0
519219,True,0,No user reviews,0,0,0
519220,True,0,No user reviews,0,0,0
519230,True,0,No user reviews,0,0,0
519240,True,0,2 user reviews,2,0,2
519250,True,0,No user reviews,0,0,0
519260,True,0,No user reviews,0,0,0
519270,True,0,No user reviews,0,0,0
519280,True,0,1 user reviews,1,0,1
519290,True,0,No user reviews,0,0,0
519300,True,0,2 user reviews,0,2,2
519310,True,0,No user reviews,0,0,0
519320,True,0,No user reviews,0,0,0
519330,True,0,No user reviews,0,0,0
519340,True,0,No user reviews,0,0,0
519350,True,0,No user reviews,0,0,0
519360,True,0,No user reviews,0,0,0
519370,True,0,No user reviews,0,0,0
519380,True,0,No user reviews,0,0,0
519390,True,0,No user reviews,0,0,0
519400,True,0,No user reviews,0,0,0
519410,True,0,No user reviews,0,0,0
519420,True,0,No user reviews,0,0,0
519430,True,0,No user reviews,0,0,0
519440,True,0,No user reviews,0,0,0
519450,True,0,No user reviews,0,0,0
519460,True,0,No user reviews,0,0,0
519461,True,0,No user reviews,0,0,0
519470,True,0,No user reviews,0,0,0
519471,True,0,No user reviews,0,0,0
519472,True,0,No user reviews,0,0,0
519480,True,0,No user reviews,0,0,0
519481,True,0,No user reviews,0,0,0
519482,True,0,No user reviews,0,0,0
519483,True,0,No user reviews,0,0,0
519490,True,0,6 user reviews,2,4,6
519510,True,0,No user reviews,0,0,0
519511,True,0,No user reviews,0,0,0
519512,True,0,No user reviews,0,0,0
519513,True,0,No user reviews,0,0,0
519514,True,0,No user reviews,0,0,0
519520,True,0,No user reviews,0,0,0
519521,True,0,No user reviews,0,0,0
519522,True,0,No user reviews,0,0,0
519530,True,0,No user reviews,0,0,0
519540,True,0,4 user reviews,4,0,4
519550,True,0,1 user reviews,0,1,1
519560,True,0,3 user reviews,1,2,3
519561,True,0,No user reviews,0,0,0
519562,True,0,No user reviews,0,0,0
519563,True,0,No user reviews,0,0,0
519564,True,0,No user reviews,0,0,0
519565,True,0,No user reviews,0,0,0
519566,True,0,No user reviews,0,0,0
519567,True,0,No user reviews,0,0,0
519568,True,0,No user reviews,0,0,0
519569,True,0,No user reviews,0,0,0
519570,True,0,No user reviews,0,0,0
519571,True,0,No user reviews,0,0,0
519572,True,0,No user reviews,0,0,0
519573,True,0,No user reviews,0,0,0
519574,True,0,No user reviews,0,0,0
519575,True,0,No user reviews,0,0,0
519576,True,0,No user reviews,0,0,0
519577,True,0,No user reviews,0,0,0
519578,True,0,No user reviews,0,0,0
519580,True,0,No user reviews,0,0,0
519581,True,0,No user reviews,0,0,0
519582,True,0,No user reviews,0,0,0
519583,True,0,No user reviews,0,0,0
519584,True,0,No user reviews,0,0,0
519585,True,0,No user reviews,0,0,0
519586,True,0,No user reviews,0,0,0
519587,True,0,No user reviews,0,0,0
519588,True,0,No user reviews,0,0,0
519589,True,0,No user reviews,0,0,0
519590,True,0,No user reviews,0,0,0
519600,True,0,No user reviews,0,0,0
519601,True,0,No user reviews,0,0,0
519602,True,0,No user reviews,0,0,0
519603,True,0,No user reviews,0,0,0
519604,True,0,No user reviews,0,0,0
519605,True,0,No user reviews,0,0,0
519606,True,0,No user reviews,0,0,0
519607,True,0,No user reviews,0,0,0
519608,True,0,No user reviews,0,0,0
519609,True,0,No user reviews,0,0,0
519610,True,0,No user reviews,0,0,0
519611,True,0,No user reviews,0,0,0
519612,True,0,No user reviews,0,0,0
519620,True,0,No user reviews,0,0,0
519621,True,0,No user reviews,0,0,0
519622,True,0,No user reviews,0,0,0
519623,True,0,No user reviews,0,0,0
519624,True,0,No user reviews,0,0,0
519625,True,0,No user reviews,0,0,0
519626,True,0,No user reviews,0,0,0
519627,True,0,No user reviews,0,0,0
519628,True,0,No user reviews,0,0,0
519629,True,0,No user reviews,0,0,0
519630,True,0,No user reviews,0,0,0
519631,True,0,No user reviews,0,0,0
519632,True,0,No user reviews,0,0,0
519633,True,0,No user reviews,0,0,0
519634,True,0,No user reviews,0,0,0
519640,True,0,No user reviews,0,0,0
519641,True,0,No user reviews,0,0,0
519642,True,0,No user reviews,0,0,0
519643,True,0,No user reviews,0,0,0
519644,True,0,No user reviews,0,0,0
519645,True,0,No user reviews,0,0,0
519646,True,0,No user reviews,0,0,0
519647,True,0,No user reviews,0,0,0
519648,True,0,No user reviews,0,0,0
519649,True,0,No user reviews,0,0,0
519650,True,0,No user reviews,0,0,0
519651,True,0,No user reviews,0,0,0
519652,True,0,No user reviews,0,0,0
519653,True,0,No user reviews,0,0,0
519654,True,0,No user reviews,0,0,0
519655,True,0,No user reviews,0,0,0
519670,True,0,No user reviews,0,0,0
519671,True,0,No user reviews,0,0,0
519672,True,0,No user reviews,0,0,0
519673,True,0,No user reviews,0,0,0
519674,True,0,No user reviews,0,0,0
519675,True,0,No user reviews,0,0,0
519676,True,0,No user reviews,0,0,0
519677,True,0,No user reviews,0,0,0
519678,True,0,No user reviews,0,0,0
519679,True,0,No user reviews,0,0,0
519680,True,0,No user reviews,0,0,0
519681,True,0,No user reviews,0,0,0
519682,True,0,No user reviews,0,0,0
519683,True,0,No user reviews,0,0,0
519684,True,0,No user reviews,0,0,0
519685,True,0,No user reviews,0,0,0
519686,True,0,No user reviews,0,0,0
519687,True,0,No user reviews,0,0,0
519688,True,0,No user reviews,0,0,0
519689,True,0,No user reviews,0,0,0
519690,True,0,No user reviews,0,0,0
519691,True,0,No user reviews,0,0,0
519692,True,0,No user reviews,0,0,0
519693,True,0,No user reviews,0,0,0
519694,True,0,No user reviews,0,0,0
519695,True,0,No user reviews,0,0,0
519696,True,0,No user reviews,0,0,0
519697,True,0,No user reviews,0,0,0
519698,True,0,No user reviews,0,0,0
519700,True,0,No user reviews,0,0,0
519701,True,0,No user reviews,0,0,0
519702,True,0,No user reviews,0,0,0
519703,True,0,No user reviews,0,0,0
519704,True,0,No user reviews,0,0,0
519705,True,0,No user reviews,0,0,0
519706,True,0,No user reviews,0,0,0
519707,True,0,No user reviews,0,0,0
519708,True,0,No user reviews,0,0,0
519709,True,0,No user reviews,0,0,0
519710,True,0,No user reviews,0,0,0
519711,True,0,No user reviews,0,0,0
519712,True,0,No user reviews,0,0,0
519713,True,0,No user reviews,0,0,0
519714,True,0,No user reviews,0,0,0
519715,True,0,No user reviews,0,0,0
519720,True,0,No user reviews,0,0,0
519721,True,0,No user reviews,0,0,0
519722,True,0,No user reviews,0,0,0
519723,True,0,No user reviews,0,0,0
519724,True,0,No user reviews,0,0,0
519725,True,0,No user reviews,0,0,0
519726,True,0,No user reviews,0,0,0
519727,True,0,No user reviews,0,0,0
519728,True,0,No user reviews,0,0,0
519729,True,0,No user reviews,0,0,0
519730,True,0,No user reviews,0,0,0
519731,True,0,No user reviews,0,0,0
519732,True,0,No user reviews,0,0,0
519733,True,0,No user reviews,0,0,0
519734,True,0,No user reviews,0,0,0
519735,True,0,No user reviews,0,0,0
519736,True,0,No user reviews,0,0,0
519737,True,0,No user reviews,0,0,0
519738,True,0,No user reviews,0,0,0
519740,True,0,No user reviews,0,0,0
519741,True,0,No user reviews,0,0,0
519742,True,0,No user reviews,0,0,0
519743,True,0,No user reviews,0,0,0
519744,True,0,No user reviews,0,0,0
519745,True,0,No user reviews,0,0,0
519746,True,0,No user reviews,0,0,0
519747,True,0,No user reviews,0,0,0
519748,True,0,No user reviews,0,0,0
519749,True,0,No user reviews,0,0,0
519750,True,0,No user reviews,0,0,0
519751,True,0,No user reviews,0,0,0
519752,True,0,No user reviews,0,0,0
519753,True,0,No user reviews,0,0,0
519754,True,0,No user reviews,0,0,0
519755,True,0,No user reviews,0,0,0
519756,True,0,No user reviews,0,0,0
519760,True,0,No user reviews,0,0,0
519761,True,0,No user reviews,0,0,0
519762,True,0,No user reviews,0,0,0
519763,True,0,No user reviews,0,0,0
519764,True,0,No user reviews,0,0,0
519765,True,0,No user reviews,0,0,0
519766,True,0,No user reviews,0,0,0
519767,True,0,No user reviews,0,0,0
519768,True,0,No user reviews,0,0,0
519769,True,0,No user reviews,0,0,0
519770,True,0,No user reviews,0,0,0
519780,True,0,No user reviews,0,0,0
519781,True,0,No user reviews,0,0,0
519782,True,0,No user reviews,0,0,0
519783,True,0,No user reviews,0,0,0
519784,True,0,No user reviews,0,0,0
519785,True,0,No user reviews,0,0,0
519786,True,0,No user reviews,0,0,0
519787,True,0,No user reviews,0,0,0
519788,True,0,No user reviews,0,0,0
519789,True,0,No user reviews,0,0,0
519790,True,0,No user reviews,0,0,0
519791,True,0,No user reviews,0,0,0
519800,True,0,No user reviews,0,0,0
519801,True,0,No user reviews,0,0,0
519802,True,0,No user reviews,0,0,0
519803,True,0,No user reviews,0,0,0
519804,True,0,No user reviews,0,0,0
519805,True,0,No user reviews,0,0,0
519806,True,0,No user reviews,0,0,0
519807,True,0,No user reviews,0,0,0
519808,True,0,No user reviews,0,0,0
519809,True,0,No user reviews,0,0,0
519810,True,0,No user reviews,0,0,0
519820,True,0,No user reviews,0,0,0
519821,True,0,No user reviews,0,0,0
519822,True,0,No user reviews,0,0,0
519823,True,0,No user reviews,0,0,0
519824,True,0,No user reviews,0,0,0
519825,True,0,No user reviews,0,0,0
519826,True,0,No user reviews,0,0,0
519827,True,0,No user reviews,0,0,0
519828,True,0,No user reviews,0,0,0
519829,True,0,No user reviews,0,0,0
519830,True,0,No user reviews,0,0,0
519831,True,0,No user reviews,0,0,0
519832,True,0,No user reviews,0,0,0
519833,True,0,No user reviews,0,0,0
519834,True,0,No user reviews,0,0,0
519835,True,0,No user reviews,0,0,0
519836,True,0,No user reviews,0,0,0
519840,True,0,No user reviews,0,0,0
519841,True,0,No user reviews,0,0,0
519842,True,0,No user reviews,0,0,0
519843,True,0,No user reviews,0,0,0
519844,True,0,No user reviews,0,0,0
519845,True,0,No user reviews,0,0,0
519846,True,0,No user reviews,0,0,0
519847,True,0,No user reviews,0,0,0
519848,True,0,No user reviews,0,0,0
519849,True,0,No user reviews,0,0,0
519850,True,0,No user reviews,0,0,0
519851,True,0,No user reviews,0,0,0
519852,True,0,No user reviews,0,0,0
519853,True,0,No user reviews,0,0,0
519854,True,0,No user reviews,0,0,0
519855,True,0,No user reviews,0,0,0
519856,True,0,No user reviews,0,0,0
519857,True,0,No user reviews,0,0,0
519858,True,0,No user reviews,0,0,0
519860,True,9,Overwhelmingly Positive,7384,128,7512
519870,True,0,4 user reviews,3,1,4
519880,True,0,No user reviews,0,0,0
519890,True,0,2 user reviews,1,1,2
519940,True,6,Mostly Positive,10,3,13
519950,True,0,No user reviews,0,0,0
519980,True,5,Mixed,7,4,11
519990,True,0,6 user reviews,2,4,6
520010,True,8,Very Positive,748,56,804
520030,True,0,No user reviews,0,0,0
520040,True,0,5 user reviews,3,2,5
520050,True,0,No user reviews,0,0,0
520051,True,0,No user reviews,0,0,0
520052,True,0,No user reviews,0,0,0
520053,True,0,No user reviews,0,0,0
520054,True,0,No user reviews,0,0,0
520055,True,0,No user reviews,0,0,0
520056,True,0,No user reviews,0,0,0
520057,True,0,No user reviews,0,0,0
520058,True,0,No user reviews,0,0,0
520059,True,0,No user reviews,0,0,0
520060,True,0,No user reviews,0,0,0
520061,True,0,No user reviews,0,0,0
520080,True,0,2 user reviews,1,1,2
520090,True,0,No user reviews,0,0,0
520100,True,0,No user reviews,0,0,0
520101,True,0,No user reviews,0,0,0
520102,True,0,No user reviews,0,0,0
520103,True,0,No user reviews,0,0,0
520104,True,0,No user reviews,0,0,0
520105,True,0,No user reviews,0,0,0
520106,True,0,No user reviews,0,0,0
520107,True,0,No user reviews,0,0,0
520108,True,0,No user reviews,0,0,0
520109,True,0,No user reviews,0,0,0
520110,True,0,No user reviews,0,0,0
520111,True,0,No user reviews,0,0,0
520112,True,0,No user reviews,0,0,0
520120,True,0,8 user reviews,5,3,8
520150,True,7,Positive,17,3,20
520160,True,0,No user reviews,0,0,0
520180,True,0,No user reviews,0,0,0
520190,True,0,No user reviews,0,0,0
520200,True,0,No user reviews,0,0,0
520210,True,4,Mostly Negative,3,7,10
520230,True,0,2 user reviews,2,0,2
520250,True,5,Mixed,13,8,21
520260,True,0,No user reviews,0,0,0
520270,True,6,Mostly Positive,30,12,42
520290,True,7,Positive,19,4,23
520300,True,0,3 user reviews,3,0,3
520310,True,0,1 user reviews,0,1,1
520320,True,0,1 user reviews,1,0,1
520340,True,0,No user reviews,0,0,0
520350,True,0,9 user reviews,5,4,9
520360,True,0,2 user reviews,2,0,2
520370,True,0,5 user reviews,4,1,5
520380,True,5,Mixed,14,12,26
520390,True,0,No user reviews,0,0,0
520420,True,0,No user reviews,0,0,0
520430,True,0,1 user reviews,1,0,1
520440,True,8,Very Positive,1612,85,1697
520470,True,6,Mostly Positive,24,8,32
520480,True,0,4 user reviews,4,0,4
520500,True,0,6 user reviews,4,2,6
520510,True,0,3 user reviews,2,1,3
520520,True,0,6 user reviews,2,4,6
520530,True,5,Mixed,14,20,34
520540,True,0,5 user reviews,5,0,5
520550,True,8,Very Positive,64,13,77
520570,True,0,No user reviews,0,0,0
520580,True,0,No user reviews,0,0,0
520590,True,0,No user reviews,0,0,0
520600,True,8,Very Positive,105,17,122
520610,True,6,Mostly Positive,22,9,31
520620,True,0,2 user reviews,2,0,2
520630,True,0,2 user reviews,0,2,2
520640,True,0,1 user reviews,1,0,1
520641,True,0,4 user reviews,4,0,4
520642,True,0,2 user reviews,2,0,2
520643,True,0,1 user reviews,1,0,1
520644,True,0,1 user reviews,1,0,1
520645,True,0,1 user reviews,1,0,1
520646,True,0,1 user reviews,1,0,1
520660,True,5,Mixed,11,5,16
520670,True,7,Positive,27,6,33
520680,True,5,Mixed,5,7,12
520700,True,0,No user reviews,0,0,0
520710,True,0,No user reviews,0,0,0
520720,True,6,Mostly Positive,469,164,633
520740,True,0,No user reviews,0,0,0
520750,True,7,Positive,11,1,12
520760,True,0,No user reviews,0,0,0
520761,True,0,No user reviews,0,0,0
520762,True,0,No user reviews,0,0,0
520763,True,0,No user reviews,0,0,0
520764,True,0,No user reviews,0,0,0
520765,True,0,No user reviews,0,0,0
520766,True,0,No user reviews,0,0,0
520767,True,0,No user reviews,0,0,0
520768,True,0,No user reviews,0,0,0
520769,True,0,No user reviews,0,0,0
520770,True,0,No user reviews,0,0,0
520771,True,0,No user reviews,0,0,0
520772,True,0,No user reviews,0,0,0
520780,True,0,3 user reviews,3,0,3
520810,True,0,2 user reviews,0,2,2
520820,True,7,Positive,17,1,18
520830,True,0,No user reviews,0,0,0
520840,True,5,Mixed,8,7,15
520850,True,7,Positive,41,3,44
520860,True,5,Mixed,21,13,34
520870,True,0,No user reviews,0,0,0
520871,True,0,2 user reviews,1,1,2
520872,True,0,No user reviews,0,0,0
520873,True,0,No user reviews,0,0,0
520900,True,5,Mixed,6,4,10
520910,True,0,3 user reviews,3,0,3
520930,True,0,6 user reviews,5,1,6
520940,True,6,Mostly Positive,302,115,417
520950,True,5,Mixed,252,113,365
520960,True,6,Mostly Positive,7,3,10
520970,True,0,No user reviews,0,0,0
520990,True,6,Mostly Positive,48,17,65
521000,True,0,5 user reviews,3,2,5
521010,True,0,1 user reviews,1,0,1
521070,True,0,No user reviews,0,0,0
521090,True,5,Mixed,9,4,13
521100,True,4,Mostly Negative,7,12,19
521110,True,0,No user reviews,0,0,0
521120,True,0,No user reviews,0,0,0
521121,True,0,No user reviews,0,0,0
521130,True,7,Positive,14,2,16
521140,True,0,1 user reviews,0,1,1
521150,True,8,Very Positive,683,148,831
521160,True,5,Mixed,15,9,24
521170,True,0,No user reviews,0,0,0
521200,True,7,Positive,15,0,15
521210,True,7,Positive,10,1,11
521220,True,8,Very Positive,73,14,87
521230,True,0,7 user reviews,7,0,7
521250,True,0,No user reviews,0,0,0
521260,True,0,No user reviews,0,0,0
521270,True,0,No user reviews,0,0,0
521280,True,7,Positive,19,2,21
521290,True,0,No user reviews,0,0,0
521300,True,0,3 user reviews,3,0,3
521310,True,0,1 user reviews,0,1,1
521320,True,0,No user reviews,0,0,0
521330,True,0,2 user reviews,2,0,2
521340,True,5,Mixed,43,31,74
521350,True,8,Very Positive,176,36,212
521370,True,0,No user reviews,0,0,0
521380,True,0,No user reviews,0,0,0
521420,True,5,Mixed,5,5,10
521430,True,6,Mostly Positive,8,3,11
521440,True,0,No user reviews,0,0,0
521450,True,5,Mixed,11,12,23
521470,True,0,9 user reviews,9,0,9
521480,True,0,2 user reviews,1,1,2
521500,True,8,Very Positive,69,15,84
521510,True,0,3 user reviews,2,1,3
521530,True,0,No user reviews,0,0,0
521540,True,7,Positive,19,4,23
521550,True,0,2 user reviews,1,1,2
521560,True,6,Mostly Positive,14,5,19
521570,True,0,8 user reviews,8,0,8
521580,True,5,Mixed,8,5,13
521590,True,5,Mixed,16,10,26
521600,True,0,6 user reviews,6,0,6
521610,True,0,7 user reviews,7,0,7
521620,True,7,Positive,9,1,10
521630,True,8,Very Positive,92,23,115
521650,True,0,3 user reviews,1,2,3
521660,True,0,No user reviews,0,0,0
521670,True,0,No user reviews,0,0,0
521680,True,0,2 user reviews,0,2,2
521690,True,0,2 user reviews,2,0,2
521700,True,0,1 user reviews,1,0,1
521710,True,0,No user reviews,0,0,0
521720,True,0,4 user reviews,1,3,4
521730,True,0,No user reviews,0,0,0
521740,True,0,No user reviews,0,0,0
521750,True,0,4 user reviews,3,1,4
521760,True,0,6 user reviews,5,1,6
521770,True,0,No user reviews,0,0,0
521790,True,5,Mixed,53,26,79
521800,True,7,Positive,17,1,18
521840,True,8,Very Positive,263,4,267
521850,True,0,2 user reviews,1,1,2
521860,True,6,Mostly Positive,18,5,23
521880,True,6,Mostly Positive,13,5,18
521890,True,6,Mostly Positive,1327,466,1793
521900,True,0,No user reviews,0,0,0
521901,True,0,No user reviews,0,0,0
521902,True,0,No user reviews,0,0,0
521903,True,0,No user reviews,0,0,0
521904,True,0,No user reviews,0,0,0
521905,True,0,No user reviews,0,0,0
521906,True,0,No user reviews,0,0,0
521920,True,8,Very Positive,125,19,144
521950,True,8,Very Positive,125,28,153
521962,True,0,No user reviews,0,0,0
521970,True,0,2 user reviews,0,2,2
521980,True,4,Mostly Negative,12,22,34
521990,True,0,8 user reviews,6,2,8
522000,True,0,5 user reviews,4,1,5
522010,True,0,6 user reviews,6,0,6
522020,True,6,Mostly Positive,71,20,91
522030,True,5,Mixed,52,30,82
522040,True,8,Very Positive,224,9,233
522050,True,0,5 user reviews,1,4,5
522070,True,0,No user reviews,0,0,0
522080,True,0,5 user reviews,5,0,5
522090,True,4,Mostly Negative,4,13,17
522120,True,8,Very Positive,101,5,106
522130,True,7,Positive,18,1,19
522140,True,0,No user reviews,0,0,0
522170,True,0,1 user reviews,0,1,1
522190,True,0,No user reviews,0,0,0
522200,True,5,Mixed,7,9,16
522210,True,8,Very Positive,97,20,117
522220,True,0,9 user reviews,6,3,9
522230,True,0,No user reviews,0,0,0
522240,True,6,Mostly Positive,42,12,54
522250,True,5,Mixed,16,7,23
522280,True,0,1 user reviews,1,0,1
522300,True,7,Positive,13,3,16
522331,True,0,2 user reviews,2,0,2
522333,True,0,7 user reviews,4,3,7
522334,True,0,7 user reviews,5,2,7
522335,True,0,No user reviews,0,0,0
522340,True,7,Positive,24,1,25
522470,True,8,Very Positive,854,120,974
522480,True,0,No user reviews,0,0,0
522490,True,8,Very Positive,54,1,55
522500,True,0,8 user reviews,5,3,8
522530,True,0,5 user reviews,2,3,5
522570,True,5,Mixed,28,40,68
522590,True,4,Mostly Negative,7,15,22
522600,True,0,No user reviews,0,0,0
522610,True,0,8 user reviews,6,2,8
522620,True,0,No user reviews,0,0,0
522630,True,0,No user reviews,0,0,0
522650,True,0,2 user reviews,2,0,2
522651,True,0,2 user reviews,2,0,2
522652,True,0,2 user reviews,2,0,2
522660,True,0,6 user reviews,3,3,6
522680,True,0,No user reviews,0,0,0
522690,True,5,Mixed,6,8,14
522700,True,0,7 user reviews,4,3,7
522710,True,7,Positive,17,0,17
522730,True,7,Positive,10,1,11
522740,True,0,9 user reviews,5,4,9
522750,True,0,2 user reviews,1,1,2
522770,True,0,No user reviews,0,0,0
522771,True,0,No user reviews,0,0,0
522772,True,0,No user reviews,0,0,0
522773,True,0,No user reviews,0,0,0
522774,True,0,No user reviews,0,0,0
522775,True,0,No user reviews,0,0,0
522776,True,0,No user reviews,0,0,0
522777,True,0,No user reviews,0,0,0
522778,True,0,No user reviews,0,0,0
522779,True,0,No user reviews,0,0,0
522780,True,0,No user reviews,0,0,0
522781,True,0,No user reviews,0,0,0
522790,True,0,No user reviews,0,0,0
522791,True,0,No user reviews,0,0,0
522792,True,0,No user reviews,0,0,0
522793,True,0,No user reviews,0,0,0
522794,True,0,No user reviews,0,0,0
522795,True,0,No user reviews,0,0,0
522796,True,0,No user reviews,0,0,0
522797,True,0,No user reviews,0,0,0
522798,True,0,No user reviews,0,0,0
522799,True,0,No user reviews,0,0,0
522800,True,0,No user reviews,0,0,0
522801,True,0,No user reviews,0,0,0
522810,True,0,No user reviews,0,0,0
522811,True,0,No user reviews,0,0,0
522812,True,0,No user reviews,0,0,0
522813,True,0,No user reviews,0,0,0
522814,True,0,No user reviews,0,0,0
522815,True,0,No user reviews,0,0,0
522816,True,0,No user reviews,0,0,0
522817,True,0,No user reviews,0,0,0
522818,True,0,No user reviews,0,0,0
522819,True,0,No user reviews,0,0,0
522820,True,0,No user reviews,0,0,0
522830,True,0,No user reviews,0,0,0
522840,True,0,No user reviews,0,0,0
522841,True,0,No user reviews,0,0,0
522842,True,0,No user reviews,0,0,0
522843,True,0,No user reviews,0,0,0
522844,True,0,No user reviews,0,0,0
522845,True,0,No user reviews,0,0,0
522846,True,0,No user reviews,0,0,0
522847,True,0,No user reviews,0,0,0
522848,True,0,No user reviews,0,0,0
522849,True,0,No user reviews,0,0,0
522850,True,0,No user reviews,0,0,0
522851,True,0,No user reviews,0,0,0
522860,True,0,No user reviews,0,0,0
522861,True,0,No user reviews,0,0,0
522862,True,0,No user reviews,0,0,0
522863,True,0,No user reviews,0,0,0
522864,True,0,No user reviews,0,0,0
522865,True,0,No user reviews,0,0,0
522866,True,0,No user reviews,0,0,0
522867,True,0,No user reviews,0,0,0
522868,True,0,No user reviews,0,0,0
522869,True,0,No user reviews,0,0,0
522870,True,0,No user reviews,0,0,0
522871,True,0,No user reviews,0,0,0
522880,True,6,Mostly Positive,36,11,47
522890,True,0,2 user reviews,0,2,2
522900,True,0,6 user reviews,6,0,6
522910,True,0,No user reviews,0,0,0
522930,True,0,No user reviews,0,0,0
522940,True,0,No user reviews,0,0,0
522950,True,0,1 user reviews,1,0,1
522960,True,0,4 user reviews,1,3,4
522980,True,0,No user reviews,0,0,0
522990,True,0,8 user reviews,8,0,8
523000,True,8,Very Positive,285,19,304
523030,True,7,Positive,24,2,26
523040,True,0,1 user reviews,1,0,1
523050,True,0,7 user reviews,7,0,7
523060,True,0,4 user reviews,2,2,4
523070,True,0,No user reviews,0,0,0
523080,True,5,Mixed,17,16,33
523090,True,7,Positive,27,3,30
523110,True,5,Mixed,30,32,62
523120,True,5,Mixed,119,79,198
523130,True,5,Mixed,7,6,13
523150,True,7,Positive,27,4,31
523160,True,6,Mostly Positive,10,4,14
523170,True,0,1 user reviews,1,0,1
523180,True,5,Mixed,7,4,11
523190,True,0,1 user reviews,0,1,1
523210,True,8,Very Positive,735,110,845
523220,True,0,2 user reviews,1,1,2
523230,True,7,Positive,12,2,14
523240,True,0,1 user reviews,1,0,1
523250,True,0,No user reviews,0,0,0
523260,True,0,No user reviews,0,0,0
523300,True,0,No user reviews,0,0,0
523301,True,0,No user reviews,0,0,0
523320,True,0,No user reviews,0,0,0
523321,True,0,No user reviews,0,0,0
523322,True,0,No user reviews,0,0,0
523323,True,0,No user reviews,0,0,0
523324,True,0,No user reviews,0,0,0
523325,True,0,No user reviews,0,0,0
523326,True,0,No user reviews,0,0,0
523327,True,0,No user reviews,0,0,0
523328,True,0,No user reviews,0,0,0
523329,True,0,No user reviews,0,0,0
523330,True,0,No user reviews,0,0,0
523331,True,0,No user reviews,0,0,0
523332,True,0,No user reviews,0,0,0
523333,True,0,No user reviews,0,0,0
523334,True,0,No user reviews,0,0,0
523335,True,0,No user reviews,0,0,0
523336,True,0,No user reviews,0,0,0
523337,True,0,No user reviews,0,0,0
523338,True,0,No user reviews,0,0,0
523339,True,0,No user reviews,0,0,0
523340,True,0,1 user reviews,1,0,1
523350,True,0,No user reviews,0,0,0
523360,True,0,No user reviews,0,0,0
523370,True,0,No user reviews,0,0,0
523380,True,0,6 user reviews,4,2,6
523390,True,0,No user reviews,0,0,0
523410,True,5,Mixed,7,4,11
523440,True,0,5 user reviews,5,0,5
523460,True,0,No user reviews,0,0,0
523470,True,0,No user reviews,0,0,0
523480,True,0,No user reviews,0,0,0
523481,True,0,No user reviews,0,0,0
523482,True,0,No user reviews,0,0,0
523483,True,0,No user reviews,0,0,0
523484,True,0,No user reviews,0,0,0
523485,True,0,No user reviews,0,0,0
523486,True,0,No user reviews,0,0,0
523487,True,0,No user reviews,0,0,0
523488,True,0,No user reviews,0,0,0
523489,True,0,No user reviews,0,0,0
523490,True,0,No user reviews,0,0,0
523500,True,5,Mixed,5,5,10
523501,True,0,6 user reviews,6,0,6
523502,True,0,5 user reviews,5,0,5
523503,True,0,2 user reviews,2,0,2
523504,True,0,4 user reviews,4,0,4
523505,True,0,3 user reviews,3,0,3
523506,True,0,4 user reviews,3,1,4
523507,True,0,4 user reviews,2,2,4
523508,True,4,Mostly Negative,5,8,13
523510,True,0,5 user reviews,4,1,5
523511,True,0,8 user reviews,5,3,8
523521,True,0,5 user reviews,3,2,5
523530,True,0,2 user reviews,1,1,2
523531,True,0,5 user reviews,5,0,5
523532,True,0,6 user reviews,5,1,6
523533,True,0,4 user reviews,3,1,4
523534,True,0,1 user reviews,1,0,1
523550,True,0,3 user reviews,2,1,3
523560,True,0,3 user reviews,1,2,3
523570,True,0,No user reviews,0,0,0
523580,True,0,No user reviews,0,0,0
523581,True,0,No user reviews,0,0,0
523582,True,0,No user reviews,0,0,0
523583,True,0,No user reviews,0,0,0
523590,True,0,No user reviews,0,0,0
523600,True,6,Mostly Positive,116,32,148
523610,True,4,Mostly Negative,7,13,20
523640,True,4,Mostly Negative,32,49,81
523650,True,6,Mostly Positive,482,205,687
523660,True,8,Very Positive,772,69,841
523670,True,0,2 user reviews,2,0,2
523680,True,0,6 user reviews,6,0,6
523690,True,0,1 user reviews,1,0,1
523710,True,5,Mixed,98,47,145
523720,True,0,9 user reviews,9,0,9
523730,True,5,Mixed,9,6,15
523740,True,0,2 user reviews,2,0,2
523750,True,0,No user reviews,0,0,0
523760,True,7,Positive,16,2,18
523770,True,0,No user reviews,0,0,0
523780,True,8,Very Positive,2449,148,2597
523810,True,5,Mixed,26,13,39
523820,True,0,No user reviews,0,0,0
523821,True,0,No user reviews,0,0,0
523840,True,0,2 user reviews,2,0,2
523850,True,0,1 user reviews,0,1,1
523851,True,0,1 user reviews,0,1,1
523852,True,0,1 user reviews,0,1,1
523860,True,0,No user reviews,0,0,0
523870,True,0,5 user reviews,5,0,5
523880,True,0,1 user reviews,0,1,1
523890,True,0,2 user reviews,2,0,2
523900,True,0,3 user reviews,3,0,3
523910,True,0,No user reviews,0,0,0
523940,True,5,Mixed,7,5,12
523950,True,0,No user reviews,0,0,0
523960,True,0,No user reviews,0,0,0
523970,True,0,5 user reviews,4,1,5
523980,True,0,2 user reviews,2,0,2
524000,True,0,No user reviews,0,0,0
524010,True,5,Mixed,114,76,190
524020,True,0,1 user reviews,0,1,1
524030,True,0,1 user reviews,0,1,1
524040,True,0,1 user reviews,1,0,1
524041,True,0,No user reviews,0,0,0
524042,True,0,No user reviews,0,0,0
524043,True,0,1 user reviews,1,0,1
524050,True,0,9 user reviews,8,1,9
524060,True,0,8 user reviews,5,3,8
524080,True,0,No user reviews,0,0,0
524120,True,7,Positive,25,5,30
524130,True,0,No user reviews,0,0,0
524140,True,0,No user reviews,0,0,0
524150,True,0,No user reviews,0,0,0
524170,True,0,No user reviews,0,0,0
524171,True,0,No user reviews,0,0,0
524172,True,0,No user reviews,0,0,0
524173,True,0,No user reviews,0,0,0
524174,True,0,No user reviews,0,0,0
524175,True,0,No user reviews,0,0,0
524176,True,0,1 user reviews,1,0,1
524190,True,0,No user reviews,0,0,0
524200,True,6,Mostly Positive,10,4,14
524210,True,0,No user reviews,0,0,0
524220,True,8,Very Positive,21048,2571,23619
524240,True,0,4 user reviews,2,2,4
524250,True,8,Very Positive,47,3,50
524260,True,7,Positive,20,2,22
524270,True,7,Positive,21,2,23
524280,True,5,Mixed,6,7,13
524290,True,6,Mostly Positive,8,3,11
524300,True,0,7 user reviews,5,2,7
524310,True,6,Mostly Positive,11,3,14
524320,True,7,Positive,8,2,10
524330,True,8,Very Positive,77,12,89
524350,True,0,1 user reviews,1,0,1
524360,True,0,7 user reviews,7,0,7
524380,True,5,Mixed,49,60,109
524390,True,5,Mixed,33,22,55
524410,True,0,No user reviews,0,0,0
524420,True,0,4 user reviews,1,3,4
524430,True,7,Positive,13,3,16
524440,True,0,No user reviews,0,0,0
524450,True,0,No user reviews,0,0,0
524490,True,7,Positive,18,2,20
524520,True,8,Very Positive,46,11,57
524530,True,0,No user reviews,0,0,0
524540,True,7,Positive,31,6,37
524550,True,0,No user reviews,0,0,0
524560,True,7,Positive,31,5,36
524570,True,0,No user reviews,0,0,0
524580,True,8,Very Positive,403,85,488
524590,True,0,2 user reviews,2,0,2
524591,True,0,1 user reviews,0,1,1
524592,True,0,1 user reviews,0,1,1
524593,True,0,2 user reviews,1,1,2
524594,True,0,3 user reviews,2,1,3
524595,True,0,1 user reviews,0,1,1
524596,True,0,1 user reviews,0,1,1
524600,True,7,Positive,32,8,40
524610,True,0,4 user reviews,0,4,4
524630,True,0,No user reviews,0,0,0
524640,True,8,Very Positive,112,20,132
524650,True,0,9 user reviews,8,1,9
524660,True,5,Mixed,11,8,19
524690,True,7,Positive,17,1,18
524700,True,0,No user reviews,0,0,0
524710,True,0,No user reviews,0,0,0
524720,True,0,No user reviews,0,0,0
524730,True,0,No user reviews,0,0,0
524740,True,0,No user reviews,0,0,0
524750,True,0,No user reviews,0,0,0
524760,True,0,No user reviews,0,0,0
524770,True,0,No user reviews,0,0,0
524780,True,0,No user reviews,0,0,0
524790,True,0,No user reviews,0,0,0
524800,True,0,No user reviews,0,0,0
524820,True,0,No user reviews,0,0,0
524830,True,0,No user reviews,0,0,0
524840,True,0,No user reviews,0,0,0
524850,True,8,Very Positive,350,39,389
524860,True,0,No user reviews,0,0,0
524870,True,0,No user reviews,0,0,0
524880,True,0,No user reviews,0,0,0
524910,True,8,Very Positive,167,18,185
524920,True,7,Positive,14,0,14
524940,True,0,3 user reviews,1,2,3
524970,True,5,Mixed,11,5,16
524990,True,0,No user reviews,0,0,0
525000,True,7,Positive,20,4,24
525011,True,5,Mixed,15,17,32
525012,True,0,5 user reviews,2,3,5
525014,True,0,1 user reviews,1,0,1
525015,True,0,1 user reviews,1,0,1
525016,True,0,1 user reviews,1,0,1
525017,True,0,2 user reviews,2,0,2
525018,True,0,No user reviews,0,0,0
525019,True,0,4 user reviews,4,0,4
525020,True,0,No user reviews,0,0,0
525030,True,5,Mixed,27,13,40
525031,True,5,Mixed,20,19,39
525032,True,0,1 user reviews,1,0,1
525033,True,0,No user reviews,0,0,0
525034,True,0,1 user reviews,1,0,1
525035,True,0,No user reviews,0,0,0
525036,True,0,1 user reviews,1,0,1
525037,True,0,4 user reviews,4,0,4
525040,True,8,Very Positive,139,17,156
525050,True,0,8 user reviews,8,0,8
525070,True,0,No user reviews,0,0,0
525080,True,5,Mixed,8,8,16
525100,True,0,1 user reviews,0,1,1
525140,True,0,No user reviews,0,0,0
525150,True,7,Positive,12,2,14
525180,True,0,No user reviews,0,0,0
525183,True,0,No user reviews,0,0,0
525185,True,0,No user reviews,0,0,0
525186,True,0,No user reviews,0,0,0
525190,True,0,4 user reviews,3,1,4
525210,True,6,Mostly Positive,12,5,17
525220,True,0,No user reviews,0,0,0
525221,True,0,No user reviews,0,0,0
525240,True,5,Mixed,45,39,84
525280,True,0,9 user reviews,4,5,9
525281,True,0,3 user reviews,1,2,3
525282,True,0,5 user reviews,3,2,5
525283,True,0,4 user reviews,4,0,4
525284,True,0,5 user reviews,5,0,5
525290,True,6,Mostly Positive,14,4,18
525300,True,5,Mixed,6,4,10
525320,True,0,No user reviews,0,0,0
525330,True,0,No user reviews,0,0,0
525340,True,0,No user reviews,0,0,0
525350,True,5,Mixed,6,8,14
525360,True,5,Mixed,13,6,19
525370,True,0,1 user reviews,0,1,1
525380,True,5,Mixed,87,45,132
525390,True,0,No user reviews,0,0,0
525420,True,5,Mixed,6,8,14
525430,True,7,Positive,12,1,13
525440,True,0,2 user reviews,1,1,2
525441,True,0,No user reviews,0,0,0
525442,True,0,2 user reviews,1,1,2
525450,True,7,Positive,17,0,17
525470,True,0,3 user reviews,3,0,3
525471,True,0,No user reviews,0,0,0
525480,True,8,Very Positive,1076,161,1237
525490,True,0,No user reviews,0,0,0
525500,True,6,Mostly Positive,13,4,17
525510,True,8,Very Positive,475,23,498
525520,True,0,8 user reviews,4,4,8
525530,True,4,Mostly Negative,2,8,10
525540,True,0,No user reviews,0,0,0
525550,True,0,6 user reviews,5,1,6
525580,True,0,No user reviews,0,0,0
525590,True,0,1 user reviews,0,1,1
525600,True,0,5 user reviews,2,3,5
525610,True,5,Mixed,69,52,121
525620,True,8,Very Positive,219,27,246
525640,True,8,Very Positive,363,47,410
525650,True,0,No user reviews,0,0,0
525660,True,0,7 user reviews,2,5,7
525680,True,8,Very Positive,230,23,253
525690,True,7,Positive,28,2,30
525700,True,5,Mixed,192,149,341
525710,True,0,No user reviews,0,0,0
525720,True,8,Very Positive,152,17,169
525730,True,0,No user reviews,0,0,0
525740,True,7,Positive,10,2,12
525750,True,0,No user reviews,0,0,0
525760,True,0,5 user reviews,5,0,5
525780,True,0,6 user reviews,5,1,6
525790,True,0,No user reviews,0,0,0
525791,True,0,No user reviews,0,0,0
525792,True,0,No user reviews,0,0,0
525793,True,0,No user reviews,0,0,0
525794,True,0,No user reviews,0,0,0
525795,True,0,No user reviews,0,0,0
525796,True,0,No user reviews,0,0,0
525797,True,0,No user reviews,0,0,0
525798,True,0,No user reviews,0,0,0
525799,True,0,No user reviews,0,0,0
525800,True,0,No user reviews,0,0,0
525801,True,0,No user reviews,0,0,0
525802,True,0,No user reviews,0,0,0
525803,True,0,No user reviews,0,0,0
525810,True,0,No user reviews,0,0,0
525811,True,0,No user reviews,0,0,0
525812,True,0,No user reviews,0,0,0
525813,True,0,No user reviews,0,0,0
525814,True,0,No user reviews,0,0,0
525815,True,0,No user reviews,0,0,0
525816,True,0,No user reviews,0,0,0
525817,True,0,No user reviews,0,0,0
525818,True,0,No user reviews,0,0,0
525819,True,0,No user reviews,0,0,0
525820,True,0,No user reviews,0,0,0
525821,True,0,No user reviews,0,0,0
525822,True,0,No user reviews,0,0,0
525823,True,0,No user reviews,0,0,0
525830,True,0,No user reviews,0,0,0
525831,True,0,No user reviews,0,0,0
525832,True,0,No user reviews,0,0,0
525833,True,0,No user reviews,0,0,0
525834,True,0,No user reviews,0,0,0
525835,True,0,No user reviews,0,0,0
525836,True,0,No user reviews,0,0,0
525837,True,0,No user reviews,0,0,0
525838,True,0,No user reviews,0,0,0
525839,True,0,No user reviews,0,0,0
525840,True,0,No user reviews,0,0,0
525841,True,0,No user reviews,0,0,0
525842,True,0,No user reviews,0,0,0
525860,True,0,No user reviews,0,0,0
525870,True,0,2 user reviews,2,0,2
525900,True,0,No user reviews,0,0,0
525910,True,7,Positive,13,1,14
525920,True,5,Mixed,47,33,80
525930,True,0,No user reviews,0,0,0
525950,True,7,Positive,9,2,11
525960,True,0,No user reviews,0,0,0
525970,True,0,4 user reviews,4,0,4
525971,True,0,2 user reviews,2,0,2
525980,True,0,No user reviews,0,0,0
526020,True,0,No user reviews,0,0,0
526030,True,0,1 user reviews,0,1,1
526040,True,6,Mostly Positive,14,5,19
526060,True,8,Very Positive,74,5,79
526070,True,0,No user reviews,0,0,0
526080,True,0,No user reviews,0,0,0
526081,True,0,No user reviews,0,0,0
526082,True,0,No user reviews,0,0,0
526083,True,0,No user reviews,0,0,0
526084,True,0,No user reviews,0,0,0
526085,True,0,No user reviews,0,0,0
526086,True,0,No user reviews,0,0,0
526087,True,0,No user reviews,0,0,0
526088,True,0,No user reviews,0,0,0
526089,True,0,No user reviews,0,0,0
526090,True,0,2 user reviews,1,1,2
526120,True,0,No user reviews,0,0,0
526121,True,0,1 user reviews,1,0,1
526122,True,0,No user reviews,0,0,0
526130,True,7,Positive,14,2,16
526140,True,8,Very Positive,243,42,285
526150,True,0,No user reviews,0,0,0
526160,True,6,Mostly Positive,947,343,1290
526200,True,0,No user reviews,0,0,0
526201,True,0,No user reviews,0,0,0
526202,True,0,No user reviews,0,0,0
526203,True,0,No user reviews,0,0,0
526204,True,0,No user reviews,0,0,0
526205,True,0,No user reviews,0,0,0
526206,True,0,No user reviews,0,0,0
526207,True,0,No user reviews,0,0,0
526208,True,0,No user reviews,0,0,0
526209,True,0,No user reviews,0,0,0
526210,True,0,No user reviews,0,0,0
526211,True,0,No user reviews,0,0,0
526212,True,0,No user reviews,0,0,0
526220,True,0,3 user reviews,3,0,3
526221,True,0,1 user reviews,1,0,1
526222,True,0,1 user reviews,1,0,1
526223,True,0,No user reviews,0,0,0
526224,True,0,No user reviews,0,0,0
526225,True,0,No user reviews,0,0,0
526226,True,0,No user reviews,0,0,0
526227,True,0,1 user reviews,1,0,1
526228,True,0,1 user reviews,1,0,1
526229,True,0,No user reviews,0,0,0
526230,True,0,No user reviews,0,0,0
526231,True,0,No user reviews,0,0,0
526232,True,0,No user reviews,0,0,0
526240,True,6,Mostly Positive,29,8,37
526260,True,0,No user reviews,0,0,0
526290,True,0,4 user reviews,0,4,4
526300,True,0,2 user reviews,1,1,2
526301,True,0,4 user reviews,3,1,4
526310,True,5,Mixed,6,4,10
526320,True,0,No user reviews,0,0,0
526340,True,0,No user reviews,0,0,0
526350,True,0,No user reviews,0,0,0
526370,True,6,Mostly Positive,106,36,142
526400,True,0,No user reviews,0,0,0
526410,True,0,6 user reviews,5,1,6
526411,True,0,5 user reviews,5,0,5
526420,True,0,No user reviews,0,0,0
526430,True,0,No user reviews,0,0,0
526440,True,0,4 user reviews,3,1,4
526450,True,0,4 user reviews,0,4,4
526470,True,0,No user reviews,0,0,0
526490,True,8,Very Positive,128,3,131
526510,True,7,Positive,17,2,19
526520,True,0,No user reviews,0,0,0
526530,True,0,3 user reviews,1,2,3
526531,True,0,8 user reviews,0,8,8
526532,True,0,2 user reviews,0,2,2
526540,True,5,Mixed,18,12,30
526550,True,0,5 user reviews,3,2,5
526560,True,0,No user reviews,0,0,0
526561,True,0,1 user reviews,1,0,1
526562,True,0,No user reviews,0,0,0
526570,True,0,No user reviews,0,0,0
526571,True,0,1 user reviews,1,0,1
526572,True,0,No user reviews,0,0,0
526580,True,0,No user reviews,0,0,0
526590,True,5,Mixed,10,7,17
526600,True,5,Mixed,10,7,17
526640,True,0,1 user reviews,1,0,1
526670,True,0,No user reviews,0,0,0
526680,True,0,2 user reviews,2,0,2
526720,True,0,No user reviews,0,0,0
526730,True,0,No user reviews,0,0,0
526740,True,4,Mostly Negative,121,195,316
526750,True,4,Mostly Negative,9,19,28
526760,True,0,No user reviews,0,0,0
526770,True,0,No user reviews,0,0,0
526780,True,0,9 user reviews,9,0,9
526800,True,0,9 user reviews,8,1,9
526830,True,0,No user reviews,0,0,0
526840,True,0,1 user reviews,0,1,1
526860,True,0,1 user reviews,1,0,1
526870,True,9,Overwhelmingly Positive,13586,388,13974
526880,True,0,5 user reviews,2,3,5
526890,True,0,9 user reviews,9,0,9
526910,True,0,3 user reviews,3,0,3
526920,True,0,5 user reviews,3,2,5
526960,True,0,5 user reviews,0,5,5
526980,True,0,5 user reviews,3,2,5
527000,True,0,5 user reviews,5,0,5
527010,True,0,1 user reviews,1,0,1
527020,True,0,1 user reviews,1,0,1
527021,True,0,8 user reviews,8,0,8
527022,True,0,2 user reviews,2,0,2
527040,True,0,2 user reviews,0,2,2
527070,True,8,Very Positive,305,38,343
527080,True,0,No user reviews,0,0,0
527090,True,0,No user reviews,0,0,0
527100,True,6,Mostly Positive,1142,311,1453
527110,True,0,7 user reviews,6,1,7
527120,True,0,No user reviews,0,0,0
527150,True,8,Very Positive,51,4,55
527160,True,5,Mixed,80,53,133
527170,True,0,1 user reviews,1,0,1
527180,True,0,9 user reviews,7,2,9
527190,True,8,Very Positive,91,3,94
527200,True,0,4 user reviews,4,0,4
527201,True,0,1 user reviews,1,0,1
527202,True,0,1 user reviews,1,0,1
527203,True,0,2 user reviews,2,0,2
527204,True,0,1 user reviews,0,1,1
527205,True,0,2 user reviews,2,0,2
527210,True,0,3 user reviews,2,1,3
527220,True,0,No user reviews,0,0,0
527230,True,8,Very Positive,3863,520,4383
527240,True,5,Mixed,18,17,35
527250,True,0,9 user reviews,7,2,9
527260,True,0,5 user reviews,4,1,5
527270,True,8,Very Positive,517,61,578
527280,True,5,Mixed,112,56,168
527290,True,8,Very Positive,125,19,144
527300,True,0,1 user reviews,1,0,1
527310,True,7,Positive,10,2,12
527320,True,0,9 user reviews,7,2,9
527330,True,0,4 user reviews,2,2,4
527340,True,8,Very Positive,281,68,349
527350,True,5,Mixed,11,5,16
527360,True,0,1 user reviews,0,1,1
527370,True,0,1 user reviews,1,0,1
527380,True,7,Positive,11,1,12
527390,True,0,No user reviews,0,0,0
527400,True,0,No user reviews,0,0,0
527401,True,0,No user reviews,0,0,0
527402,True,0,No user reviews,0,0,0
527403,True,0,No user reviews,0,0,0
527404,True,0,No user reviews,0,0,0
527405,True,0,No user reviews,0,0,0
527406,True,0,No user reviews,0,0,0
527407,True,0,No user reviews,0,0,0
527410,True,0,No user reviews,0,0,0
527420,True,6,Mostly Positive,29,9,38
527430,True,6,Mostly Positive,3523,1300,4823
527440,True,7,Positive,28,4,32
527450,True,6,Mostly Positive,281,120,401
527470,True,6,Mostly Positive,34,9,43
527510,True,3,Negative,4,18,22
527520,True,0,4 user reviews,1,3,4
527530,True,0,1 user reviews,0,1,1
527560,True,0,No user reviews,0,0,0
527580,True,6,Mostly Positive,13,4,17
527590,True,0,No user reviews,0,0,0
527610,True,6,Mostly Positive,19,6,25
527620,True,0,8 user reviews,8,0,8
527630,True,0,No user reviews,0,0,0
527640,True,0,1 user reviews,1,0,1
527641,True,0,1 user reviews,1,0,1
527642,True,0,No user reviews,0,0,0
527643,True,0,No user reviews,0,0,0
527644,True,0,No user reviews,0,0,0
527645,True,0,No user reviews,0,0,0
527646,True,0,No user reviews,0,0,0
527650,True,0,No user reviews,0,0,0
527651,True,0,No user reviews,0,0,0
527652,True,0,No user reviews,0,0,0
527660,True,0,No user reviews,0,0,0
527661,True,0,No user reviews,0,0,0
527662,True,0,No user reviews,0,0,0
527663,True,0,No user reviews,0,0,0
527664,True,0,No user reviews,0,0,0
527665,True,0,No user reviews,0,0,0
527680,True,0,No user reviews,0,0,0
527700,True,8,Very Positive,184,24,208
527710,True,8,Very Positive,82,20,102
527720,True,7,Positive,23,2,25
527730,True,0,9 user reviews,5,4,9
527740,True,7,Positive,28,7,35
527750,True,5,Mixed,12,18,30
527760,True,5,Mixed,14,12,26
527770,True,5,Mixed,4,6,10
527790,True,0,2 user reviews,0,2,2
527800,True,0,3 user reviews,1,2,3
527810,True,0,6 user reviews,5,1,6
527820,True,7,Positive,18,0,18
527830,True,0,No user reviews,0,0,0
527831,True,0,No user reviews,0,0,0
527832,True,0,No user reviews,0,0,0
527833,True,0,No user reviews,0,0,0
527834,True,0,No user reviews,0,0,0
527835,True,0,No user reviews,0,0,0
527836,True,0,No user reviews,0,0,0
527837,True,0,No user reviews,0,0,0
527838,True,0,No user reviews,0,0,0
527839,True,0,No user reviews,0,0,0
527840,True,0,No user reviews,0,0,0
527841,True,0,No user reviews,0,0,0
527842,True,0,No user reviews,0,0,0
527860,True,0,No user reviews,0,0,0
527880,True,0,4 user reviews,2,2,4
527890,True,0,4 user reviews,3,1,4
527900,True,5,Mixed,6,4,10
527910,True,0,6 user reviews,5,1,6
527920,True,0,9 user reviews,8,1,9
527930,True,0,3 user reviews,1,2,3
527940,True,0,3 user reviews,3,0,3
527950,True,5,Mixed,4,6,10
527960,True,0,3 user reviews,3,0,3
527980,True,0,No user reviews,0,0,0
527990,True,5,Mixed,56,25,81
528000,True,0,No user reviews,0,0,0
528010,True,5,Mixed,11,11,22
528020,True,0,4 user reviews,3,1,4
528040,True,0,No user reviews,0,0,0
528050,True,7,Positive,12,0,12
528051,True,7,Positive,11,1,12
528052,True,0,4 user reviews,4,0,4
528053,True,0,8 user reviews,8,0,8
528055,True,7,Positive,18,1,19
528056,True,7,Positive,17,0,17
528057,True,7,Positive,18,1,19
528058,True,0,4 user reviews,3,1,4
528060,True,0,No user reviews,0,0,0
528070,True,6,Mostly Positive,9,3,12
528110,True,7,Positive,14,0,14
528120,True,7,Positive,31,3,34
528140,True,0,No user reviews,0,0,0
528160,True,5,Mixed,72,31,103
528180,True,5,Mixed,9,13,22
528190,True,0,4 user reviews,2,2,4
528200,True,8,Very Positive,465,110,575
528220,True,0,No user reviews,0,0,0
528230,True,9,Overwhelmingly Positive,3384,109,3493
528250,True,6,Mostly Positive,29,8,37
528260,True,6,Mostly Positive,34,11,45
528270,True,7,Positive,25,3,28
528280,True,0,No user reviews,0,0,0
528290,True,0,1 user reviews,1,0,1
528300,True,5,Mixed,32,14,46
528310,True,0,3 user reviews,1,2,3
528330,True,6,Mostly Positive,11,3,14
528340,True,0,No user reviews,0,0,0
528341,True,0,No user reviews,0,0,0
528342,True,0,No user reviews,0,0,0
528343,True,0,No user reviews,0,0,0
528344,True,0,No user reviews,0,0,0
528345,True,0,No user reviews,0,0,0
528346,True,0,No user reviews,0,0,0
528347,True,0,No user reviews,0,0,0
528348,True,0,No user reviews,0,0,0
528349,True,0,No user reviews,0,0,0
528350,True,0,No user reviews,0,0,0
528351,True,0,No user reviews,0,0,0
528352,True,0,No user reviews,0,0,0
528360,True,0,No user reviews,0,0,0
528361,True,0,No user reviews,0,0,0
528362,True,0,No user reviews,0,0,0
528363,True,0,No user reviews,0,0,0
528364,True,0,No user reviews,0,0,0
528365,True,0,No user reviews,0,0,0
528366,True,0,No user reviews,0,0,0
528367,True,0,No user reviews,0,0,0
528368,True,0,No user reviews,0,0,0
528369,True,0,No user reviews,0,0,0
528370,True,0,No user reviews,0,0,0
528371,True,0,No user reviews,0,0,0
528372,True,0,No user reviews,0,0,0
528380,True,0,No user reviews,0,0,0
528381,True,0,No user reviews,0,0,0
528382,True,0,No user reviews,0,0,0
528383,True,0,No user reviews,0,0,0
528384,True,0,No user reviews,0,0,0
528385,True,0,No user reviews,0,0,0
528386,True,0,No user reviews,0,0,0
528387,True,0,No user reviews,0,0,0
528388,True,0,No user reviews,0,0,0
528389,True,0,No user reviews,0,0,0
528390,True,0,No user reviews,0,0,0
528391,True,0,No user reviews,0,0,0
528392,True,0,No user reviews,0,0,0
528420,True,0,2 user reviews,2,0,2
528430,True,6,Mostly Positive,20,8,28
528450,True,0,2 user reviews,1,1,2
528460,True,5,Mixed,66,34,100
528480,True,0,1 user reviews,1,0,1
528490,True,0,1 user reviews,1,0,1
528510,True,6,Mostly Positive,35,15,50
528520,True,0,No user reviews,0,0,0
528530,True,0,No user reviews,0,0,0
528550,True,6,Mostly Positive,349,104,453
528580,True,0,1 user reviews,1,0,1
528590,True,7,Positive,14,1,15
528610,True,6,Mostly Positive,166,71,237
528620,True,5,Mixed,16,8,24
528630,True,0,No user reviews,0,0,0
528640,True,5,Mixed,31,37,68
528660,True,6,Mostly Positive,79,22,101
528670,True,0,3 user reviews,3,0,3
528690,True,0,No user reviews,0,0,0
528700,True,0,7 user reviews,7,0,7
528710,True,0,No user reviews,0,0,0
528720,True,7,Positive,27,2,29
528730,True,6,Mostly Positive,44,17,61
528740,True,4,Mostly Negative,6,12,18
528770,True,0,2 user reviews,2,0,2
528790,True,0,1 user reviews,0,1,1
528810,True,0,1 user reviews,1,0,1
528820,True,5,Mixed,18,17,35
528860,True,0,9 user reviews,9,0,9
528870,True,0,No user reviews,0,0,0
528880,True,0,No user reviews,0,0,0
528881,True,0,No user reviews,0,0,0
528882,True,0,No user reviews,0,0,0
528883,True,0,No user reviews,0,0,0
528884,True,0,No user reviews,0,0,0
528885,True,0,No user reviews,0,0,0
528890,True,0,No user reviews,0,0,0
528891,True,0,No user reviews,0,0,0
528892,True,0,No user reviews,0,0,0
528900,True,0,6 user reviews,2,4,6
528910,True,0,5 user reviews,2,3,5
528930,True,0,3 user reviews,1,2,3
528950,True,0,3 user reviews,3,0,3
528960,True,7,Positive,16,2,18
528970,True,0,7 user reviews,2,5,7
528980,True,5,Mixed,7,4,11
528990,True,0,8 user reviews,8,0,8
529010,True,0,4 user reviews,1,3,4
529020,True,7,Positive,33,5,38
529030,True,0,No user reviews,0,0,0
529040,True,0,7 user reviews,6,1,7
529050,True,7,Positive,16,0,16
529060,True,4,Mostly Negative,32,58,90
529070,True,0,No user reviews,0,0,0
529090,True,0,2 user reviews,1,1,2
529100,True,7,Positive,30,1,31
529110,True,5,Mixed,53,26,79
529130,True,5,Mixed,30,17,47
529140,True,0,3 user reviews,3,0,3
529150,True,7,Positive,27,0,27
529160,True,8,Very Positive,87,13,100
529170,True,0,1 user reviews,0,1,1
529180,True,5,Mixed,2395,1856,4251
529190,True,0,No user reviews,0,0,0
529200,True,0,No user reviews,0,0,0
529240,True,5,Mixed,31,42,73
529260,True,0,2 user reviews,1,1,2
529280,True,0,7 user reviews,4,3,7
529310,True,0,No user reviews,0,0,0
529350,True,0,6 user reviews,4,2,6
529360,True,6,Mostly Positive,22,6,28
529390,True,8,Very Positive,93,7,100
529400,True,0,No user reviews,0,0,0
529410,True,7,Positive,28,7,35
529420,True,0,2 user reviews,2,0,2
529430,True,0,1 user reviews,1,0,1
529440,True,8,Very Positive,281,31,312
529450,True,6,Mostly Positive,18,6,24
529470,True,0,1 user reviews,1,0,1
529490,True,5,Mixed,56,26,82
529500,True,5,Mixed,20,10,30
529520,True,8,Very Positive,358,21,379
529530,True,0,No user reviews,0,0,0
529531,True,0,No user reviews,0,0,0
529540,True,0,No user reviews,0,0,0
529550,True,0,No user reviews,0,0,0
529580,True,0,2 user reviews,1,1,2
529590,True,8,Very Positive,182,42,224
529600,True,0,No user reviews,0,0,0
529610,True,0,3 user reviews,3,0,3
529620,True,7,Positive,30,6,36
529630,True,5,Mixed,8,5,13
529640,True,0,No user reviews,0,0,0
529660,True,8,Very Positive,254,34,288
529670,True,0,3 user reviews,2,1,3
529680,True,0,No user reviews,0,0,0
529690,True,7,Positive,10,0,10
529700,True,7,Positive,45,4,49
529720,True,0,7 user reviews,4,3,7
529730,True,0,2 user reviews,2,0,2
529740,True,0,No user reviews,0,0,0
529750,True,0,1 user reviews,1,0,1
529760,True,5,Mixed,6,8,14
529770,True,0,5 user reviews,4,1,5
529780,True,7,Positive,20,4,24
529790,True,0,9 user reviews,7,2,9
529820,True,5,Mixed,5,6,11
529830,True,5,Mixed,33,17,50
529840,True,0,No user reviews,0,0,0
529850,True,0,No user reviews,0,0,0
529860,True,0,7 user reviews,4,3,7
529870,True,0,6 user reviews,4,2,6
529890,True,6,Mostly Positive,42,12,54
529900,True,8,Very Positive,60,15,75
529910,True,5,Mixed,54,66,120
529920,True,0,4 user reviews,1,3,4
529930,True,6,Mostly Positive,51,17,68
529940,True,0,3 user reviews,2,1,3
529950,True,8,Very Positive,85,11,96
529970,True,7,Positive,21,3,24
529980,True,0,No user reviews,0,0,0
530010,True,0,1 user reviews,1,0,1
530020,True,6,Mostly Positive,42,16,58
530030,True,0,No user reviews,0,0,0
530040,True,5,Mixed,44,39,83
530050,True,0,No user reviews,0,0,0
530060,True,5,Mixed,24,35,59
530070,True,6,Mostly Positive,1736,710,2446
530080,True,0,5 user reviews,1,4,5
530090,True,0,No user reviews,0,0,0
530110,True,5,Mixed,9,6,15
530120,True,8,Very Positive,323,13,336
530130,True,0,8 user reviews,7,1,8
530140,True,0,4 user reviews,4,0,4
530150,True,0,No user reviews,0,0,0
530151,True,0,No user reviews,0,0,0
530152,True,0,1 user reviews,1,0,1
530160,True,6,Mostly Positive,29,11,40
530170,True,0,1 user reviews,0,1,1
530180,True,0,2 user reviews,2,0,2
530190,True,0,No user reviews,0,0,0
530200,True,0,No user reviews,0,0,0
530210,True,0,No user reviews,0,0,0
530240,True,4,Mostly Negative,5,10,15
530250,True,0,No user reviews,0,0,0
530280,True,0,No user reviews,0,0,0
530290,True,0,3 user reviews,3,0,3
530300,True,0,3 user reviews,3,0,3
530310,True,0,2 user reviews,2,0,2
530320,True,9,Overwhelmingly Positive,767,19,786
530330,True,6,Mostly Positive,36,15,51
530340,True,0,No user reviews,0,0,0
530350,True,8,Very Positive,263,19,282
530360,True,7,Positive,19,1,20
530370,True,7,Positive,11,1,12
530390,True,8,Very Positive,347,16,363
530400,True,0,1 user reviews,1,0,1
530410,True,0,No user reviews,0,0,0
530420,True,0,No user reviews,0,0,0
530421,True,0,No user reviews,0,0,0
530422,True,0,No user reviews,0,0,0
530423,True,0,No user reviews,0,0,0
530424,True,0,No user reviews,0,0,0
530425,True,0,No user reviews,0,0,0
530426,True,0,No user reviews,0,0,0
530427,True,0,No user reviews,0,0,0
530428,True,0,No user reviews,0,0,0
530429,True,0,No user reviews,0,0,0
530430,True,0,No user reviews,0,0,0
530431,True,0,No user reviews,0,0,0
530432,True,0,No user reviews,0,0,0
530433,True,0,No user reviews,0,0,0
530434,True,0,No user reviews,0,0,0
530435,True,0,No user reviews,0,0,0
530436,True,0,No user reviews,0,0,0
530437,True,0,No user reviews,0,0,0
530438,True,0,No user reviews,0,0,0
530439,True,0,No user reviews,0,0,0
530440,True,0,No user reviews,0,0,0
530441,True,0,No user reviews,0,0,0
530442,True,0,No user reviews,0,0,0
530443,True,0,No user reviews,0,0,0
530444,True,0,No user reviews,0,0,0
530445,True,0,No user reviews,0,0,0
530446,True,0,No user reviews,0,0,0
530447,True,0,No user reviews,0,0,0
530448,True,0,No user reviews,0,0,0
530449,True,0,No user reviews,0,0,0
530450,True,0,No user reviews,0,0,0
530451,True,0,No user reviews,0,0,0
530452,True,0,No user reviews,0,0,0
530453,True,0,No user reviews,0,0,0
530454,True,0,No user reviews,0,0,0
530455,True,0,No user reviews,0,0,0
530456,True,0,No user reviews,0,0,0
530457,True,0,No user reviews,0,0,0
530458,True,0,No user reviews,0,0,0
530459,True,0,No user reviews,0,0,0
530460,True,0,No user reviews,0,0,0
530461,True,0,No user reviews,0,0,0
530462,True,0,No user reviews,0,0,0
530463,True,0,No user reviews,0,0,0
530464,True,0,No user reviews,0,0,0
530470,True,0,No user reviews,0,0,0
530480,True,0,1 user reviews,1,0,1
530490,True,0,1 user reviews,1,0,1
530500,True,0,2 user reviews,0,2,2
530510,True,7,Positive,13,3,16
530520,True,5,Mixed,7,6,13
530530,True,0,1 user reviews,0,1,1
530540,True,4,Mostly Negative,4,8,12
530550,True,0,7 user reviews,6,1,7
530560,True,4,Mostly Negative,54,143,197
530570,True,0,No user reviews,0,0,0
530580,True,6,Mostly Positive,21,8,29
530590,True,0,No user reviews,0,0,0
530595,True,0,5 user reviews,4,1,5
530596,True,0,6 user reviews,6,0,6
530597,True,0,5 user reviews,5,0,5
530598,True,0,4 user reviews,4,0,4
530599,True,0,6 user reviews,3,3,6
530600,True,0,No user reviews,0,0,0
530610,True,5,Mixed,38,18,56
530611,True,8,Very Positive,162,28,190
530620,True,8,Very Positive,164,28,192
530630,True,5,Mixed,96,65,161
530640,True,0,2 user reviews,2,0,2
530641,True,0,1 user reviews,1,0,1
530650,True,0,4 user reviews,2,2,4
530660,True,0,9 user reviews,9,0,9
530661,True,0,3 user reviews,3,0,3
530670,True,0,No user reviews,0,0,0
530671,True,0,No user reviews,0,0,0
530690,True,0,7 user reviews,6,1,7
530700,True,5,Mixed,7,4,11
530710,True,8,Very Positive,286,41,327
530711,True,8,Very Positive,776,92,868
530720,True,0,3 user reviews,2,1,3
530730,True,0,No user reviews,0,0,0
530760,True,5,Mixed,318,388,706
530780,True,5,Mixed,163,108,271
530810,True,0,No user reviews,0,0,0
530820,True,0,3 user reviews,1,2,3
530830,True,0,9 user reviews,7,2,9
530840,True,0,No user reviews,0,0,0
530860,True,0,4 user reviews,1,3,4
530870,True,0,No user reviews,0,0,0
530890,True,8,Very Positive,1176,209,1385
530920,True,6,Mostly Positive,96,27,123
530930,True,5,Mixed,15,12,27
530940,True,0,1 user reviews,1,0,1
530950,True,5,Mixed,79,37,116
530960,True,5,Mixed,51,31,82
530970,True,0,No user reviews,0,0,0
530990,True,0,No user reviews,0,0,0
531010,True,0,No user reviews,0,0,0
531050,True,5,Mixed,75,40,115
531060,True,0,No user reviews,0,0,0
531070,True,0,No user reviews,0,0,0
531080,True,0,7 user reviews,6,1,7
531110,True,7,Positive,10,2,12
531120,True,0,No user reviews,0,0,0
531130,True,8,Very Positive,300,24,324
531131,True,8,Very Positive,315,27,342
531140,True,6,Mostly Positive,19,7,26
531150,True,0,5 user reviews,5,0,5
531151,True,0,5 user reviews,5,0,5
531152,True,0,2 user reviews,2,0,2
531153,True,0,1 user reviews,1,0,1
531154,True,0,No user reviews,0,0,0
531155,True,0,1 user reviews,1,0,1
531156,True,0,2 user reviews,2,0,2
531157,True,0,2 user reviews,2,0,2
531158,True,0,1 user reviews,1,0,1
531159,True,0,No user reviews,0,0,0
531160,True,0,4 user reviews,4,0,4
531161,True,0,2 user reviews,2,0,2
531162,True,0,No user reviews,0,0,0
531163,True,0,4 user reviews,4,0,4
531164,True,0,No user reviews,0,0,0
531165,True,0,3 user reviews,2,1,3
531166,True,0,4 user reviews,4,0,4
531167,True,0,No user reviews,0,0,0
531168,True,0,No user reviews,0,0,0
531169,True,0,1 user reviews,1,0,1
531170,True,0,1 user reviews,1,0,1
531171,True,0,No user reviews,0,0,0
531172,True,0,No user reviews,0,0,0
531180,True,8,Very Positive,48,10,58
531190,True,0,1 user reviews,1,0,1
531200,True,0,2 user reviews,1,1,2
531210,True,0,No user reviews,0,0,0
531220,True,0,No user reviews,0,0,0
531240,True,0,3 user reviews,2,1,3
531270,True,6,Mostly Positive,182,78,260
531310,True,0,No user reviews,0,0,0
531340,True,0,No user reviews,0,0,0
531360,True,0,No user reviews,0,0,0
531390,True,0,No user reviews,0,0,0
531430,True,0,No user reviews,0,0,0
531450,True,0,No user reviews,0,0,0
531460,True,0,No user reviews,0,0,0
531480,True,0,5 user reviews,3,2,5
531500,True,0,1 user reviews,0,1,1
531510,True,9,Overwhelmingly Positive,4059,89,4148
531520,True,0,3 user reviews,1,2,3
531530,True,7,Positive,41,8,49
531540,True,0,3 user reviews,1,2,3
531550,True,0,No user reviews,0,0,0
531560,True,0,No user reviews,0,0,0
531570,True,0,No user reviews,0,0,0
531580,True,0,No user reviews,0,0,0
531590,True,0,1 user reviews,1,0,1
531600,True,0,No user reviews,0,0,0
531601,True,0,No user reviews,0,0,0
531630,True,0,No user reviews,0,0,0
531640,True,8,Very Positive,118,28,146
531650,True,0,No user reviews,0,0,0
531660,True,6,Mostly Positive,114,30,144
531680,True,8,Very Positive,134,33,167
531720,True,0,No user reviews,0,0,0
531730,True,7,Positive,33,1,34
531740,True,6,Mostly Positive,26,11,37
531750,True,0,No user reviews,0,0,0
531770,True,0,5 user reviews,5,0,5
531780,True,5,Mixed,9,5,14
531800,True,5,Mixed,8,4,12
531810,True,0,No user reviews,0,0,0
531830,True,0,No user reviews,0,0,0
531850,True,0,No user reviews,0,0,0
531860,True,0,1 user reviews,0,1,1
531870,True,0,No user reviews,0,0,0
531880,True,0,No user reviews,0,0,0
531890,True,0,3 user reviews,2,1,3
531910,True,7,Positive,19,1,20
531920,True,0,3 user reviews,2,1,3
531930,True,6,Mostly Positive,210,56,266
531940,True,0,No user reviews,0,0,0
531950,True,0,No user reviews,0,0,0
531960,True,5,Mixed,10,5,15
531980,True,5,Mixed,17,10,27
531990,True,0,No user reviews,0,0,0
532000,True,0,No user reviews,0,0,0
532010,True,0,No user reviews,0,0,0
532021,True,7,Positive,39,1,40
532030,True,4,Mostly Negative,19,32,51
532050,True,0,No user reviews,0,0,0
532060,True,0,No user reviews,0,0,0
532070,True,0,1 user reviews,1,0,1
532080,True,0,2 user reviews,1,1,2
532090,True,0,8 user reviews,7,1,8
532100,True,0,No user reviews,0,0,0
532110,True,9,Overwhelmingly Positive,725,34,759
532120,True,7,Positive,8,2,10
532140,True,0,No user reviews,0,0,0
532170,True,7,Positive,41,6,47
532180,True,0,No user reviews,0,0,0
532190,True,8,Very Positive,386,31,417
532200,True,0,No user reviews,0,0,0
532210,True,8,Very Positive,4617,1120,5737
532230,True,0,No user reviews,0,0,0
532240,True,0,2 user reviews,1,1,2
532260,True,4,Mostly Negative,4,9,13
532270,True,8,Very Positive,92,18,110
532280,True,0,No user reviews,0,0,0
532290,True,7,Positive,21,5,26
532310,True,0,No user reviews,0,0,0
532320,True,8,Very Positive,85,9,94
532330,True,0,No user reviews,0,0,0
532440,True,0,No user reviews,0,0,0
532470,True,0,7 user reviews,6,1,7
532540,True,0,1 user reviews,1,0,1
532550,True,0,No user reviews,0,0,0
532600,True,0,1 user reviews,0,1,1
532610,True,0,No user reviews,0,0,0
532620,True,0,3 user reviews,3,0,3
532621,True,0,2 user reviews,2,0,2
532660,True,0,8 user reviews,4,4,8
532670,True,0,3 user reviews,1,2,3
532690,True,5,Mixed,7,5,12
532700,True,0,4 user reviews,3,1,4
532720,True,7,Positive,10,0,10
532730,True,0,1 user reviews,1,0,1
532740,True,0,No user reviews,0,0,0
532750,True,6,Mostly Positive,29,8,37
532770,True,0,5 user reviews,5,0,5
532790,True,0,No user reviews,0,0,0
532800,True,0,3 user reviews,3,0,3
532810,True,0,No user reviews,0,0,0
532820,True,5,Mixed,5,5,10
532840,True,6,Mostly Positive,153,60,213
532850,True,0,1 user reviews,1,0,1
532860,True,0,No user reviews,0,0,0
532890,True,0,8 user reviews,5,3,8
532900,True,0,3 user reviews,3,0,3
532920,True,5,Mixed,49,24,73
532940,True,0,1 user reviews,1,0,1
532950,True,3,Negative,3,13,16
532970,True,0,No user reviews,0,0,0
532980,True,7,Positive,26,0,26
533010,True,5,Mixed,15,12,27
533030,True,0,4 user reviews,1,3,4
533040,True,0,9 user reviews,8,1,9
533050,True,6,Mostly Positive,8,3,11
533060,True,0,6 user reviews,5,1,6
533070,True,0,4 user reviews,4,0,4
533080,True,0,4 user reviews,2,2,4
533090,True,0,6 user reviews,4,2,6
533100,True,0,No user reviews,0,0,0
533110,True,5,Mixed,103,52,155
533140,True,0,No user reviews,0,0,0
533170,True,4,Mostly Negative,21,46,67
533180,True,3,Negative,1,14,15
533190,True,0,No user reviews,0,0,0
533200,True,0,No user reviews,0,0,0
533220,True,0,No user reviews,0,0,0
533230,True,0,No user reviews,0,0,0
533240,True,0,1 user reviews,1,0,1
533260,True,6,Mostly Positive,10,4,14
533280,True,0,No user reviews,0,0,0
533300,True,8,Very Positive,1595,145,1740
533310,True,0,No user reviews,0,0,0
533330,True,5,Mixed,14,16,30
533340,True,4,Mostly Negative,5,20,25
533360,True,0,No user reviews,0,0,0
533370,True,0,No user reviews,0,0,0
533371,True,0,No user reviews,0,0,0
533372,True,0,No user reviews,0,0,0
533373,True,0,No user reviews,0,0,0
533374,True,0,No user reviews,0,0,0
533375,True,0,No user reviews,0,0,0
533376,True,0,No user reviews,0,0,0
533377,True,0,No user reviews,0,0,0
533378,True,0,No user reviews,0,0,0
533379,True,0,No user reviews,0,0,0
533380,True,0,No user reviews,0,0,0
533381,True,0,No user reviews,0,0,0
533382,True,0,No user reviews,0,0,0
533390,True,0,No user reviews,0,0,0
533391,True,0,No user reviews,0,0,0
533392,True,0,No user reviews,0,0,0
533393,True,0,No user reviews,0,0,0
533394,True,0,No user reviews,0,0,0
533395,True,0,No user reviews,0,0,0
533396,True,0,No user reviews,0,0,0
533397,True,0,No user reviews,0,0,0
533398,True,0,No user reviews,0,0,0
533399,True,0,No user reviews,0,0,0
533400,True,0,No user reviews,0,0,0
533401,True,0,No user reviews,0,0,0
533402,True,0,No user reviews,0,0,0
533410,True,0,No user reviews,0,0,0
533411,True,0,No user reviews,0,0,0
533412,True,0,No user reviews,0,0,0
533413,True,0,No user reviews,0,0,0
533414,True,0,No user reviews,0,0,0
533415,True,0,No user reviews,0,0,0
533416,True,0,No user reviews,0,0,0
533417,True,0,No user reviews,0,0,0
533418,True,0,No user reviews,0,0,0
533419,True,0,No user reviews,0,0,0
533420,True,0,No user reviews,0,0,0
533421,True,0,No user reviews,0,0,0
533422,True,0,No user reviews,0,0,0
533430,True,0,No user reviews,0,0,0
533431,True,0,No user reviews,0,0,0
533432,True,0,No user reviews,0,0,0
533433,True,0,No user reviews,0,0,0
533434,True,0,No user reviews,0,0,0
533435,True,0,No user reviews,0,0,0
533436,True,0,No user reviews,0,0,0
533437,True,0,No user reviews,0,0,0
533438,True,0,No user reviews,0,0,0
533439,True,0,No user reviews,0,0,0
533440,True,0,No user reviews,0,0,0
533441,True,0,No user reviews,0,0,0
533442,True,0,No user reviews,0,0,0
533450,True,0,No user reviews,0,0,0
533451,True,0,No user reviews,0,0,0
533452,True,0,No user reviews,0,0,0
533453,True,0,No user reviews,0,0,0
533454,True,0,No user reviews,0,0,0
533455,True,0,No user reviews,0,0,0
533456,True,0,No user reviews,0,0,0
533457,True,0,No user reviews,0,0,0
533458,True,0,No user reviews,0,0,0
533459,True,0,No user reviews,0,0,0
533460,True,0,No user reviews,0,0,0
533461,True,0,No user reviews,0,0,0
533462,True,0,No user reviews,0,0,0
533470,True,0,1 user reviews,0,1,1
533480,True,5,Mixed,128,56,184
533520,True,0,1 user reviews,1,0,1
533530,True,0,1 user reviews,1,0,1
533540,True,0,No user reviews,0,0,0
533550,True,0,No user reviews,0,0,0
533551,True,0,No user reviews,0,0,0
533552,True,0,1 user reviews,1,0,1
533553,True,0,No user reviews,0,0,0
533554,True,0,No user reviews,0,0,0
533555,True,0,No user reviews,0,0,0
533556,True,0,1 user reviews,1,0,1
533557,True,0,6 user reviews,3,3,6
533558,True,0,3 user reviews,2,1,3
533559,True,0,No user reviews,0,0,0
533560,True,0,2 user reviews,2,0,2
533570,True,0,2 user reviews,1,1,2
533580,True,7,Positive,13,0,13
533590,True,0,No user reviews,0,0,0
533591,True,0,No user reviews,0,0,0
533592,True,0,No user reviews,0,0,0
533600,True,0,No user reviews,0,0,0
533601,True,0,3 user reviews,1,2,3
533602,True,0,7 user reviews,2,5,7
533630,True,0,1 user reviews,1,0,1
533660,True,0,No user reviews,0,0,0
533670,True,0,1 user reviews,1,0,1
533690,True,6,Mostly Positive,11,3,14
533700,True,0,No user reviews,0,0,0
533740,True,0,No user reviews,0,0,0
533750,True,0,No user reviews,0,0,0
533770,True,0,7 user reviews,5,2,7
533780,True,7,Positive,20,4,24
533800,True,0,No user reviews,0,0,0
533810,True,0,5 user reviews,5,0,5
533820,True,5,Mixed,9,4,13
533830,True,0,No user reviews,0,0,0
533840,True,0,No user reviews,0,0,0
533850,True,6,Mostly Positive,31,9,40
533860,True,0,9 user reviews,5,4,9
533870,True,0,1 user reviews,1,0,1
533880,True,0,1 user reviews,1,0,1
533890,True,0,4 user reviews,3,1,4
533920,True,0,3 user reviews,0,3,3
533950,True,6,Mostly Positive,33,11,44
533960,True,0,2 user reviews,2,0,2
533970,True,0,No user reviews,0,0,0
534000,True,8,Very Positive,45,10,55
534010,True,0,7 user reviews,3,4,7
534030,True,0,No user reviews,0,0,0
534050,True,0,No user reviews,0,0,0
534110,True,0,4 user reviews,4,0,4
534140,True,0,3 user reviews,3,0,3
534160,True,7,Positive,15,2,17
534180,True,0,No user reviews,0,0,0
534190,True,0,7 user reviews,6,1,7
534200,True,0,4 user reviews,2,2,4
534210,True,0,4 user reviews,2,2,4
534220,True,0,No user reviews,0,0,0
534230,True,8,Very Positive,67,15,82
534240,True,0,No user reviews,0,0,0
534260,True,0,1 user reviews,1,0,1
534270,True,0,5 user reviews,4,1,5
534280,True,0,No user reviews,0,0,0
534290,True,8,Very Positive,82,4,86
534300,True,0,No user reviews,0,0,0
534320,True,0,6 user reviews,1,5,6
534330,True,7,Positive,26,3,29
534331,True,6,Mostly Positive,406,169,575
534350,True,0,5 user reviews,2,3,5
534360,True,5,Mixed,16,11,27
534370,True,5,Mixed,152,77,229
534380,True,0,No user reviews,0,0,0
534430,True,0,6 user reviews,4,2,6
534440,True,7,Positive,16,2,18
534460,True,0,No user reviews,0,0,0
534480,True,5,Mixed,12,17,29
534550,True,8,Very Positive,660,56,716
534560,True,0,No user reviews,0,0,0
534570,True,5,Mixed,18,10,28
534580,True,0,No user reviews,0,0,0
534590,True,0,No user reviews,0,0,0
534600,True,0,1 user reviews,1,0,1
534610,True,0,No user reviews,0,0,0
534611,True,0,No user reviews,0,0,0
534612,True,0,No user reviews,0,0,0
534613,True,0,No user reviews,0,0,0
534614,True,0,No user reviews,0,0,0
534615,True,0,No user reviews,0,0,0
534616,True,0,No user reviews,0,0,0
534617,True,0,No user reviews,0,0,0
534618,True,0,No user reviews,0,0,0
534619,True,0,No user reviews,0,0,0
534620,True,0,No user reviews,0,0,0
534621,True,0,No user reviews,0,0,0
534622,True,0,No user reviews,0,0,0
534623,True,0,No user reviews,0,0,0
534624,True,0,No user reviews,0,0,0
534625,True,0,No user reviews,0,0,0
534626,True,0,No user reviews,0,0,0
534627,True,0,No user reviews,0,0,0
534628,True,0,No user reviews,0,0,0
534629,True,0,No user reviews,0,0,0
534630,True,0,No user reviews,0,0,0
534631,True,0,No user reviews,0,0,0
534632,True,0,No user reviews,0,0,0
534633,True,0,No user reviews,0,0,0
534634,True,0,No user reviews,0,0,0
534635,True,0,No user reviews,0,0,0
534636,True,0,No user reviews,0,0,0
534640,True,0,2 user reviews,2,0,2
534650,True,0,1 user reviews,1,0,1
534660,True,0,No user reviews,0,0,0
534670,True,0,No user reviews,0,0,0
534680,True,7,Positive,12,1,13
534690,True,0,No user reviews,0,0,0
534720,True,7,Positive,31,4,35
534740,True,0,4 user reviews,1,3,4
534750,True,6,Mostly Positive,12,4,16
534780,True,0,6 user reviews,6,0,6
534820,True,4,Mostly Negative,26,40,66
534830,True,0,No user reviews,0,0,0
534840,True,7,Positive,29,3,32
534850,True,0,No user reviews,0,0,0
534870,True,0,8 user reviews,6,2,8
534880,True,0,6 user reviews,5,1,6
534910,True,5,Mixed,8,9,17
534920,True,0,4 user reviews,3,1,4
534930,True,0,No user reviews,0,0,0
534931,True,0,No user reviews,0,0,0
534950,True,0,No user reviews,0,0,0
534970,True,0,No user reviews,0,0,0
534980,True,0,9 user reviews,6,3,9
534990,True,7,Positive,30,5,35
535000,True,0,7 user reviews,7,0,7
535010,True,0,4 user reviews,3,1,4
535020,True,0,No user reviews,0,0,0
535021,True,0,No user reviews,0,0,0
535022,True,0,No user reviews,0,0,0
535023,True,0,No user reviews,0,0,0
535024,True,0,No user reviews,0,0,0
535025,True,0,No user reviews,0,0,0
535026,True,0,No user reviews,0,0,0
535027,True,0,No user reviews,0,0,0
535028,True,0,No user reviews,0,0,0
535029,True,0,No user reviews,0,0,0
535030,True,0,No user reviews,0,0,0
535031,True,0,No user reviews,0,0,0
535032,True,0,No user reviews,0,0,0
535040,True,0,No user reviews,0,0,0
535041,True,0,No user reviews,0,0,0
535042,True,0,No user reviews,0,0,0
535043,True,0,No user reviews,0,0,0
535044,True,0,No user reviews,0,0,0
535045,True,0,No user reviews,0,0,0
535046,True,0,No user reviews,0,0,0
535047,True,0,No user reviews,0,0,0
535048,True,0,No user reviews,0,0,0
535049,True,0,No user reviews,0,0,0
535050,True,0,No user reviews,0,0,0
535051,True,0,No user reviews,0,0,0
535052,True,0,No user reviews,0,0,0
535060,True,0,No user reviews,0,0,0
535061,True,0,No user reviews,0,0,0
535062,True,0,No user reviews,0,0,0
535063,True,0,No user reviews,0,0,0
535064,True,0,No user reviews,0,0,0
535065,True,0,No user reviews,0,0,0
535066,True,0,No user reviews,0,0,0
535067,True,0,No user reviews,0,0,0
535068,True,0,No user reviews,0,0,0
535069,True,0,No user reviews,0,0,0
535070,True,0,No user reviews,0,0,0
535071,True,0,No user reviews,0,0,0
535072,True,0,No user reviews,0,0,0
535080,True,0,No user reviews,0,0,0
535081,True,0,No user reviews,0,0,0
535082,True,0,No user reviews,0,0,0
535083,True,0,No user reviews,0,0,0
535084,True,0,No user reviews,0,0,0
535085,True,0,No user reviews,0,0,0
535086,True,0,No user reviews,0,0,0
535087,True,0,No user reviews,0,0,0
535088,True,0,No user reviews,0,0,0
535089,True,0,No user reviews,0,0,0
535090,True,0,No user reviews,0,0,0
535091,True,0,No user reviews,0,0,0
535092,True,0,No user reviews,0,0,0
535100,True,0,No user reviews,0,0,0
535101,True,0,No user reviews,0,0,0
535102,True,0,No user reviews,0,0,0
535103,True,0,No user reviews,0,0,0
535104,True,0,No user reviews,0,0,0
535105,True,0,No user reviews,0,0,0
535106,True,0,No user reviews,0,0,0
535107,True,0,No user reviews,0,0,0
535108,True,0,No user reviews,0,0,0
535109,True,0,No user reviews,0,0,0
535110,True,0,No user reviews,0,0,0
535111,True,0,No user reviews,0,0,0
535112,True,0,No user reviews,0,0,0
535120,True,0,No user reviews,0,0,0
535130,True,0,1 user reviews,0,1,1
535140,True,0,No user reviews,0,0,0
535150,True,6,Mostly Positive,32,10,42
535170,True,0,1 user reviews,0,1,1
535180,True,0,No user reviews,0,0,0
535190,True,7,Positive,13,1,14
535200,True,0,4 user reviews,4,0,4
535201,True,0,1 user reviews,1,0,1
535202,True,0,3 user reviews,2,1,3
535230,True,8,Very Positive,3499,450,3949
535240,True,0,1 user reviews,1,0,1
535260,True,0,6 user reviews,4,2,6
535270,True,0,2 user reviews,1,1,2
535280,True,7,Positive,22,1,23
535290,True,0,No user reviews,0,0,0
535310,True,0,1 user reviews,1,0,1
535330,True,7,Positive,17,1,18
535350,True,0,6 user reviews,3,3,6
535370,True,0,1 user reviews,0,1,1
535380,True,7,Positive,17,1,18
535410,True,7,Positive,18,2,20
535420,True,0,No user reviews,0,0,0
535440,True,0,No user reviews,0,0,0
535450,True,0,No user reviews,0,0,0
535460,True,7,Positive,42,3,45
535470,True,0,No user reviews,0,0,0
535480,True,8,Very Positive,1189,244,1433
535490,True,5,Mixed,25,34,59
535510,True,0,2 user reviews,2,0,2
535520,True,6,Mostly Positive,324,91,415
535530,True,0,4 user reviews,2,2,4
535540,True,0,No user reviews,0,0,0
535580,True,0,No user reviews,0,0,0
535600,True,0,No user reviews,0,0,0
535610,True,0,No user reviews,0,0,0
535630,True,0,7 user reviews,6,1,7
535650,True,7,Positive,14,1,15
535660,True,0,No user reviews,0,0,0
535680,True,0,2 user reviews,2,0,2
535690,True,0,4 user reviews,3,1,4
535700,True,5,Mixed,9,11,20
535720,True,0,1 user reviews,1,0,1
535750,True,0,2 user reviews,1,1,2
535760,True,0,6 user reviews,5,1,6
535770,True,0,No user reviews,0,0,0
535771,True,0,No user reviews,0,0,0
535780,True,0,No user reviews,0,0,0
535790,True,0,No user reviews,0,0,0
535810,True,0,No user reviews,0,0,0
535820,True,5,Mixed,11,9,20
535830,True,0,No user reviews,0,0,0
535840,True,0,7 user reviews,7,0,7
535850,True,4,Mostly Negative,23,85,108
535870,True,0,No user reviews,0,0,0
535890,True,0,9 user reviews,7,2,9
535910,True,7,Positive,18,0,18
535920,True,0,No user reviews,0,0,0
535930,True,8,Very Positive,7244,559,7803
535950,True,0,1 user reviews,1,0,1
535960,True,0,No user reviews,0,0,0
535970,True,0,2 user reviews,2,0,2
535971,True,0,1 user reviews,1,0,1
535980,True,7,Positive,25,4,29
535990,True,0,No user reviews,0,0,0
535991,True,0,No user reviews,0,0,0
535992,True,0,No user reviews,0,0,0
535993,True,0,No user reviews,0,0,0
535994,True,0,No user reviews,0,0,0
535995,True,0,No user reviews,0,0,0
535996,True,0,No user reviews,0,0,0
535997,True,0,No user reviews,0,0,0
535998,True,0,No user reviews,0,0,0
535999,True,0,No user reviews,0,0,0
536000,True,0,No user reviews,0,0,0
536001,True,0,No user reviews,0,0,0
536002,True,0,No user reviews,0,0,0
536003,True,0,No user reviews,0,0,0
536010,True,0,1 user reviews,0,1,1
536040,True,5,Mixed,23,27,50
536050,True,0,No user reviews,0,0,0
536070,True,0,No user reviews,0,0,0
536071,True,0,No user reviews,0,0,0
536072,True,0,No user reviews,0,0,0
536073,True,0,No user reviews,0,0,0
536074,True,0,No user reviews,0,0,0
536075,True,0,No user reviews,0,0,0
536076,True,0,No user reviews,0,0,0
536077,True,0,No user reviews,0,0,0
536078,True,0,No user reviews,0,0,0
536079,True,0,No user reviews,0,0,0
536080,True,0,No user reviews,0,0,0
536081,True,0,No user reviews,0,0,0
536082,True,0,No user reviews,0,0,0
536083,True,0,No user reviews,0,0,0
536084,True,0,No user reviews,0,0,0
536085,True,0,No user reviews,0,0,0
536086,True,0,No user reviews,0,0,0
536087,True,0,No user reviews,0,0,0
536088,True,0,No user reviews,0,0,0
536089,True,0,No user reviews,0,0,0
536090,True,0,No user reviews,0,0,0
536091,True,0,No user reviews,0,0,0
536092,True,0,No user reviews,0,0,0
536093,True,0,No user reviews,0,0,0
536094,True,0,No user reviews,0,0,0
536095,True,0,No user reviews,0,0,0
536096,True,0,No user reviews,0,0,0
536097,True,0,No user reviews,0,0,0
536098,True,0,No user reviews,0,0,0
536099,True,0,No user reviews,0,0,0
536100,True,0,No user reviews,0,0,0
536101,True,0,No user reviews,0,0,0
536102,True,0,No user reviews,0,0,0
536103,True,0,No user reviews,0,0,0
536104,True,0,No user reviews,0,0,0
536105,True,0,No user reviews,0,0,0
536106,True,0,No user reviews,0,0,0
536107,True,0,No user reviews,0,0,0
536108,True,0,No user reviews,0,0,0
536110,True,0,No user reviews,0,0,0
536111,True,0,No user reviews,0,0,0
536112,True,0,No user reviews,0,0,0
536113,True,0,No user reviews,0,0,0
536114,True,0,No user reviews,0,0,0
536115,True,0,No user reviews,0,0,0
536116,True,0,No user reviews,0,0,0
536117,True,0,No user reviews,0,0,0
536118,True,0,No user reviews,0,0,0
536119,True,0,No user reviews,0,0,0
536120,True,0,No user reviews,0,0,0
536121,True,0,No user reviews,0,0,0
536122,True,0,No user reviews,0,0,0
536123,True,0,No user reviews,0,0,0
536124,True,0,No user reviews,0,0,0
536125,True,0,No user reviews,0,0,0
536126,True,0,No user reviews,0,0,0
536127,True,0,No user reviews,0,0,0
536128,True,0,No user reviews,0,0,0
536129,True,0,No user reviews,0,0,0
536130,True,0,No user reviews,0,0,0
536131,True,0,No user reviews,0,0,0
536132,True,0,No user reviews,0,0,0
536133,True,0,No user reviews,0,0,0
536134,True,0,No user reviews,0,0,0
536135,True,0,No user reviews,0,0,0
536136,True,0,No user reviews,0,0,0
536137,True,0,No user reviews,0,0,0
536138,True,0,No user reviews,0,0,0
536139,True,0,No user reviews,0,0,0
536140,True,0,No user reviews,0,0,0
536141,True,0,No user reviews,0,0,0
536142,True,0,No user reviews,0,0,0
536143,True,0,No user reviews,0,0,0
536144,True,0,No user reviews,0,0,0
536145,True,0,No user reviews,0,0,0
536146,True,0,No user reviews,0,0,0
536150,True,0,No user reviews,0,0,0
536210,True,0,1 user reviews,0,1,1
536220,True,6,Mostly Positive,2888,1116,4004
536230,True,0,2 user reviews,2,0,2
536270,True,6,Mostly Positive,709,205,914
536280,True,5,Mixed,62,40,102
536310,True,0,No user reviews,0,0,0
536320,True,4,Mostly Negative,8,17,25
536330,True,0,No user reviews,0,0,0
536340,True,4,Mostly Negative,5,8,13
536370,True,0,4 user reviews,3,1,4
536380,True,0,No user reviews,0,0,0
536390,True,0,No user reviews,0,0,0
536410,True,0,7 user reviews,2,5,7
536420,True,5,Mixed,19,9,28
536430,True,7,Positive,10,2,12
536450,True,5,Mixed,13,9,22
536460,True,0,No user reviews,0,0,0
536470,True,0,9 user reviews,8,1,9
536490,True,0,6 user reviews,3,3,6
536510,True,0,9 user reviews,4,5,9
536520,True,0,5 user reviews,3,2,5
536530,True,5,Mixed,9,6,15
536540,True,5,Mixed,7,8,15
536541,True,0,1 user reviews,1,0,1
536543,True,0,7 user reviews,6,1,7
536544,True,0,2 user reviews,1,1,2
536545,True,4,Mostly Negative,3,8,11
536546,True,0,1 user reviews,0,1,1
536547,True,0,No user reviews,0,0,0
536548,True,0,No user reviews,0,0,0
536549,True,0,2 user reviews,0,2,2
536550,True,0,No user reviews,0,0,0
536560,True,8,Very Positive,48,7,55
536570,True,0,4 user reviews,1,3,4
536571,True,0,No user reviews,0,0,0
536572,True,0,No user reviews,0,0,0
536573,True,0,9 user reviews,3,6,9
536574,True,0,3 user reviews,2,1,3
536575,True,0,7 user reviews,2,5,7
536576,True,4,Mostly Negative,7,14,21
536577,True,0,2 user reviews,2,0,2
536578,True,0,3 user reviews,2,1,3
536579,True,0,1 user reviews,1,0,1
536580,True,0,No user reviews,0,0,0
536590,True,0,4 user reviews,4,0,4
536610,True,6,Mostly Positive,18,5,23
536630,True,4,Mostly Negative,3,7,10
536640,True,4,Mostly Negative,15,25,40
536660,True,5,Mixed,29,39,68
536670,True,0,2 user reviews,2,0,2
536680,True,5,Mixed,7,8,15
536690,True,6,Mostly Positive,18,5,23
536730,True,0,2 user reviews,1,1,2
536740,True,0,No user reviews,0,0,0
536741,True,0,2 user reviews,2,0,2
536750,True,5,Mixed,9,4,13
536760,True,0,1 user reviews,1,0,1
536770,True,7,Positive,24,0,24
536780,True,6,Mostly Positive,38,12,50
536790,True,0,No user reviews,0,0,0
536800,True,0,No user reviews,0,0,0
536850,True,0,No user reviews,0,0,0
536860,True,0,No user reviews,0,0,0
536880,True,0,No user reviews,0,0,0
536890,True,8,Very Positive,199,31,230
536900,True,0,7 user reviews,7,0,7
536910,True,0,No user reviews,0,0,0
536920,True,0,1 user reviews,1,0,1
536950,True,0,No user reviews,0,0,0
536960,True,5,Mixed,10,5,15
536990,True,8,Very Positive,42,9,51
537000,True,6,Mostly Positive,37,12,49
537020,True,0,3 user reviews,3,0,3
537030,True,0,No user reviews,0,0,0
537050,True,0,5 user reviews,5,0,5
537060,True,0,No user reviews,0,0,0
537080,True,0,3 user reviews,2,1,3
537090,True,0,7 user reviews,4,3,7
537100,True,6,Mostly Positive,54,14,68
537110,True,8,Very Positive,607,32,639
537120,True,0,2 user reviews,2,0,2
537130,True,0,No user reviews,0,0,0
537140,True,7,Positive,17,2,19
537170,True,0,1 user reviews,0,1,1
537180,True,5,Mixed,52,47,99
537190,True,0,No user reviews,0,0,0
537200,True,0,1 user reviews,0,1,1
537210,True,0,No user reviews,0,0,0
537230,True,0,2 user reviews,2,0,2
537240,True,0,No user reviews,0,0,0
537280,True,5,Mixed,4,6,10
537320,True,0,No user reviews,0,0,0
537321,True,0,No user reviews,0,0,0
537322,True,0,No user reviews,0,0,0
537324,True,0,No user reviews,0,0,0
537325,True,0,No user reviews,0,0,0
537330,True,7,Positive,24,0,24
537340,True,6,Mostly Positive,389,139,528
537360,True,5,Mixed,6,6,12
537380,True,0,1 user reviews,1,0,1
537410,True,0,2 user reviews,1,1,2
537420,True,0,No user reviews,0,0,0
537421,True,0,No user reviews,0,0,0
537422,True,0,No user reviews,0,0,0
537430,True,5,Mixed,44,56,100
537450,True,5,Mixed,117,69,186
537510,True,0,No user reviews,0,0,0
537520,True,5,Mixed,22,21,43
537540,True,0,No user reviews,0,0,0
537570,True,0,No user reviews,0,0,0
537580,True,0,1 user reviews,1,0,1
537590,True,0,No user reviews,0,0,0
537630,True,8,Very Positive,65,14,79
537640,True,0,No user reviews,0,0,0
537641,True,0,No user reviews,0,0,0
537642,True,0,No user reviews,0,0,0
537643,True,0,No user reviews,0,0,0
537644,True,0,No user reviews,0,0,0
537645,True,0,No user reviews,0,0,0
537646,True,0,No user reviews,0,0,0
537647,True,0,No user reviews,0,0,0
537648,True,0,No user reviews,0,0,0
537649,True,0,No user reviews,0,0,0
537650,True,0,No user reviews,0,0,0
537651,True,0,No user reviews,0,0,0
537652,True,0,No user reviews,0,0,0
537660,True,0,8 user reviews,4,4,8
537670,True,0,3 user reviews,3,0,3
537700,True,0,9 user reviews,5,4,9
537740,True,5,Mixed,10,7,17
537750,True,0,2 user reviews,1,1,2
537760,True,0,5 user reviews,5,0,5
537770,True,0,5 user reviews,4,1,5
537780,True,0,8 user reviews,8,0,8
537790,True,0,4 user reviews,2,2,4
537800,True,8,Very Positive,3362,462,3824
537870,True,0,No user reviews,0,0,0
537890,True,0,No user reviews,0,0,0
537900,True,0,No user reviews,0,0,0
537910,True,0,3 user reviews,2,1,3
537920,True,0,3 user reviews,2,1,3
537940,True,0,1 user reviews,0,1,1
537960,True,0,No user reviews,0,0,0
537970,True,0,No user reviews,0,0,0
537990,True,6,Mostly Positive,34,13,47
538000,True,6,Mostly Positive,8,3,11
538020,True,5,Mixed,102,96,198
538021,True,5,Mixed,11,6,17
538030,True,0,No user reviews,0,0,0
538040,True,0,2 user reviews,2,0,2
538050,True,0,5 user reviews,2,3,5
538060,True,5,Mixed,14,9,23
538070,True,8,Very Positive,257,27,284
538080,True,0,4 user reviews,2,2,4
538090,True,0,2 user reviews,2,0,2
538100,True,8,Very Positive,861,119,980
538110,True,0,No user reviews,0,0,0
538120,True,0,No user reviews,0,0,0
538130,True,0,2 user reviews,2,0,2
538140,True,0,6 user reviews,6,0,6
538150,True,0,3 user reviews,3,0,3
538160,True,0,No user reviews,0,0,0
538170,True,0,3 user reviews,2,1,3
538180,True,0,No user reviews,0,0,0
538190,True,7,Positive,14,3,17
538200,True,0,1 user reviews,1,0,1
538210,True,0,No user reviews,0,0,0
538220,True,0,8 user reviews,8,0,8
538230,True,0,No user reviews,0,0,0
538240,True,0,No user reviews,0,0,0
538250,True,0,No user reviews,0,0,0
538260,True,0,No user reviews,0,0,0
538270,True,0,No user reviews,0,0,0
538280,True,0,No user reviews,0,0,0
538290,True,0,1 user reviews,1,0,1
538300,True,0,1 user reviews,1,0,1
538310,True,0,2 user reviews,2,0,2
538330,True,7,Positive,12,3,15
538340,True,0,No user reviews,0,0,0
538350,True,0,1 user reviews,0,1,1
538351,True,0,No user reviews,0,0,0
538352,True,0,No user reviews,0,0,0
538360,True,0,No user reviews,0,0,0
538370,True,0,No user reviews,0,0,0
538380,True,0,No user reviews,0,0,0
538390,True,0,1 user reviews,1,0,1
538400,True,0,No user reviews,0,0,0
538410,True,0,3 user reviews,2,1,3
538420,True,0,No user reviews,0,0,0
538430,True,0,1 user reviews,1,0,1
538440,True,0,No user reviews,0,0,0
538450,True,0,No user reviews,0,0,0
538460,True,0,2 user reviews,2,0,2
538470,True,0,3 user reviews,0,3,3
538480,True,0,No user reviews,0,0,0
538490,True,0,2 user reviews,1,1,2
538500,True,0,1 user reviews,1,0,1
538510,True,0,4 user reviews,1,3,4
538550,True,7,Positive,19,4,23
538560,True,3,Negative,0,12,12
538570,True,0,1 user reviews,1,0,1
538580,True,0,No user reviews,0,0,0
538590,True,4,Mostly Negative,6,10,16
538600,True,0,2 user reviews,2,0,2
538610,True,0,2 user reviews,2,0,2
538620,True,0,No user reviews,0,0,0
538630,True,0,No user reviews,0,0,0
538640,True,0,No user reviews,0,0,0
538650,True,0,No user reviews,0,0,0
538670,True,0,No user reviews,0,0,0
538680,True,9,Overwhelmingly Positive,1858,89,1947
538690,True,0,No user reviews,0,0,0
538700,True,0,No user reviews,0,0,0
538710,True,7,Positive,28,3,31
538720,True,0,4 user reviews,4,0,4
538740,True,0,No user reviews,0,0,0
538750,True,0,No user reviews,0,0,0
538760,True,6,Mostly Positive,22,8,30
538780,True,0,No user reviews,0,0,0
538790,True,5,Mixed,8,7,15
538810,True,5,Mixed,134,83,217
538840,True,5,Mixed,55,25,80
538860,True,0,No user reviews,0,0,0
538870,True,5,Mixed,88,55,143
538880,True,0,1 user reviews,1,0,1
538890,True,0,No user reviews,0,0,0
538900,True,0,2 user reviews,2,0,2
538910,True,0,6 user reviews,6,0,6
538920,True,4,Mostly Negative,5,13,18
538930,True,0,1 user reviews,1,0,1
538950,True,0,No user reviews,0,0,0
538960,True,0,No user reviews,0,0,0
538970,True,0,No user reviews,0,0,0
538980,True,0,No user reviews,0,0,0
538990,True,5,Mixed,28,18,46
539001,True,0,No user reviews,0,0,0
539010,True,0,4 user reviews,2,2,4
539030,True,0,No user reviews,0,0,0
539040,True,0,2 user reviews,2,0,2
539050,True,5,Mixed,22,18,40
539090,True,6,Mostly Positive,9,3,12
539190,True,0,1 user reviews,1,0,1
539230,True,0,No user reviews,0,0,0
539240,True,0,1 user reviews,1,0,1
539250,True,0,4 user reviews,4,0,4
539260,True,0,3 user reviews,3,0,3
539270,True,6,Mostly Positive,46,12,58
539280,True,5,Mixed,9,8,17
539290,True,4,Mostly Negative,6,11,17
539300,True,4,Mostly Negative,7,15,22
539310,True,0,No user reviews,0,0,0
539320,True,0,No user reviews,0,0,0
539330,True,8,Very Positive,67,15,82
539340,True,7,Positive,31,6,37
539370,True,0,2 user reviews,2,0,2
539380,True,5,Mixed,18,8,26
539400,True,8,Very Positive,50,10,60
539420,True,0,No user reviews,0,0,0
539440,True,5,Mixed,23,27,50
539450,True,7,Positive,8,2,10
539460,True,0,4 user reviews,3,1,4
539470,True,8,Very Positive,792,158,950
539560,True,0,5 user reviews,3,2,5
539591,True,0,1 user reviews,0,1,1
539595,True,0,2 user reviews,1,1,2
539640,True,0,9 user reviews,3,6,9
539650,True,5,Mixed,22,10,32
539660,True,7,Positive,46,2,48
539670,True,8,Very Positive,76,13,89
539690,True,0,3 user reviews,1,2,3
539720,True,8,Very Positive,215,36,251
539730,True,7,Positive,14,0,14
539750,True,5,Mixed,23,13,36
539780,True,0,1 user reviews,1,0,1
539790,True,0,1 user reviews,1,0,1
539800,True,0,2 user reviews,2,0,2
539810,True,0,1 user reviews,1,0,1
539820,True,0,2 user reviews,2,0,2
539830,True,0,2 user reviews,1,1,2
539840,True,0,2 user reviews,2,0,2
539850,True,0,3 user reviews,3,0,3
539860,True,0,1 user reviews,1,0,1
539870,True,0,1 user reviews,1,0,1
539880,True,0,2 user reviews,2,0,2
539890,True,0,2 user reviews,2,0,2
539900,True,0,2 user reviews,2,0,2
539910,True,0,3 user reviews,3,0,3
539920,True,0,2 user reviews,2,0,2
539930,True,0,2 user reviews,2,0,2
539940,True,0,1 user reviews,1,0,1
539950,True,0,2 user reviews,1,1,2
539960,True,0,1 user reviews,1,0,1
539970,True,0,1 user reviews,1,0,1
539980,True,7,Positive,12,1,13
540000,True,0,2 user reviews,2,0,2
540010,True,0,4 user reviews,3,1,4
540020,True,4,Mostly Negative,7,14,21
540030,True,0,No user reviews,0,0,0
540040,True,0,1 user reviews,1,0,1
540060,True,7,Positive,29,3,32
540070,True,0,2 user reviews,1,1,2
540071,True,0,No user reviews,0,0,0
540100,True,5,Mixed,47,36,83
540130,True,0,No user reviews,0,0,0
540150,True,0,5 user reviews,3,2,5
540160,True,0,No user reviews,0,0,0
540170,True,0,No user reviews,0,0,0
540180,True,3,Negative,4,17,21
540190,True,5,Mixed,10,5,15
540200,True,0,No user reviews,0,0,0
540210,True,0,No user reviews,0,0,0
540220,True,0,1 user reviews,0,1,1
540230,True,5,Mixed,6,4,10
540250,True,0,2 user reviews,1,1,2
540320,True,0,5 user reviews,3,2,5
540330,True,0,7 user reviews,1,6,7
540340,True,5,Mixed,54,35,89
540350,True,0,1 user reviews,1,0,1
540360,True,0,4 user reviews,3,1,4
540380,True,0,No user reviews,0,0,0
540390,True,0,No user reviews,0,0,0
540410,True,7,Positive,14,0,14
540420,True,0,1 user reviews,1,0,1
540430,True,0,No user reviews,0,0,0
540440,True,0,1 user reviews,1,0,1
540450,True,0,No user reviews,0,0,0
540460,True,0,1 user reviews,1,0,1
540470,True,0,No user reviews,0,0,0
540480,True,0,No user reviews,0,0,0
540490,True,0,No user reviews,0,0,0
540500,True,7,Positive,11,2,13
540510,True,8,Very Positive,173,34,207
540520,True,0,No user reviews,0,0,0
540550,True,5,Mixed,5,6,11
540590,True,0,3 user reviews,1,2,3
540610,True,8,Very Positive,430,64,494
540630,True,0,No user reviews,0,0,0
540640,True,0,9 user reviews,7,2,9
540650,True,0,7 user reviews,4,3,7
540660,True,7,Positive,16,3,19
540670,True,0,No user reviews,0,0,0
540680,True,0,2 user reviews,2,0,2
540681,True,0,No user reviews,0,0,0
540682,True,0,No user reviews,0,0,0
540690,True,5,Mixed,20,14,34
540710,True,7,Positive,38,1,39
540711,True,7,Positive,31,2,33
540720,True,7,Positive,10,1,11
540721,True,7,Positive,13,0,13
540730,True,0,8 user reviews,8,0,8
540740,True,5,Mixed,16,19,35
540770,True,0,4 user reviews,4,0,4
540780,True,7,Positive,17,0,17
540810,True,5,Mixed,251,153,404
540820,True,0,5 user reviews,5,0,5
540840,True,8,Very Positive,604,56,660
540850,True,0,No user reviews,0,0,0
540860,True,6,Mostly Positive,31,13,44
540870,True,6,Mostly Positive,14,6,20
540880,True,8,Very Positive,113,5,118
540900,True,0,7 user reviews,7,0,7
541120,True,0,No user reviews,0,0,0
541130,True,0,9 user reviews,7,2,9
541150,True,0,No user reviews,0,0,0
541160,True,0,9 user reviews,9,0,9
541170,True,0,No user reviews,0,0,0
541190,True,0,No user reviews,0,0,0
541200,True,8,Very Positive,550,39,589
541210,True,8,Very Positive,1614,276,1890
541220,True,0,No user reviews,0,0,0
541230,True,8,Very Positive,91,14,105
541240,True,0,7 user reviews,6,1,7
541250,True,0,No user reviews,0,0,0
541260,True,0,No user reviews,0,0,0
541270,True,0,7 user reviews,4,3,7
541280,True,0,No user reviews,0,0,0
541300,True,5,Mixed,388,239,627
541310,True,0,No user reviews,0,0,0
541330,True,0,No user reviews,0,0,0
541350,True,5,Mixed,14,8,22
541370,True,0,8 user reviews,1,7,8
541380,True,4,Mostly Negative,6,19,25
541400,True,0,4 user reviews,3,1,4
541410,True,0,2 user reviews,2,0,2
541420,True,0,5 user reviews,4,1,5
541430,True,0,No user reviews,0,0,0
541450,True,5,Mixed,32,17,49
541460,True,0,1 user reviews,1,0,1
541470,True,0,1 user reviews,0,1,1
541480,True,0,No user reviews,0,0,0
541490,True,0,No user reviews,0,0,0
541500,True,0,2 user reviews,1,1,2
541510,True,0,No user reviews,0,0,0
541520,True,0,No user reviews,0,0,0
541530,True,0,No user reviews,0,0,0
541540,True,0,1 user reviews,1,0,1
541550,True,0,No user reviews,0,0,0
541560,True,0,7 user reviews,4,3,7
541570,True,9,Overwhelmingly Positive,1781,68,1849
541580,True,0,No user reviews,0,0,0
541590,True,0,No user reviews,0,0,0
541600,True,0,No user reviews,0,0,0
541610,True,0,1 user reviews,1,0,1
541620,True,0,3 user reviews,2,1,3
541630,True,0,No user reviews,0,0,0
541640,True,6,Mostly Positive,34,9,43
541650,True,0,No user reviews,0,0,0
541660,True,7,Positive,24,4,28
541670,True,6,Mostly Positive,145,38,183
541680,True,0,No user reviews,0,0,0
541690,True,0,No user reviews,0,0,0
541700,True,0,No user reviews,0,0,0
541710,True,0,No user reviews,0,0,0
541720,True,5,Mixed,12,13,25
541750,True,0,No user reviews,0,0,0
541760,True,0,1 user reviews,1,0,1
541770,True,0,2 user reviews,0,2,2
541790,True,0,No user reviews,0,0,0
541800,True,0,5 user reviews,3,2,5
541810,True,0,No user reviews,0,0,0
541820,True,0,No user reviews,0,0,0
541830,True,0,3 user reviews,3,0,3
541880,True,0,No user reviews,0,0,0
541890,True,0,No user reviews,0,0,0
541910,True,0,No user reviews,0,0,0
541920,True,0,9 user reviews,2,7,9
541930,True,8,Very Positive,103,6,109
541940,True,0,No user reviews,0,0,0
541950,True,0,No user reviews,0,0,0
541960,True,0,No user reviews,0,0,0
541970,True,0,1 user reviews,0,1,1
541980,True,0,No user reviews,0,0,0
542021,True,0,No user reviews,0,0,0
542030,True,7,Positive,28,2,30
542040,True,0,1 user reviews,1,0,1
542050,True,8,Very Positive,388,34,422
542100,True,0,2 user reviews,1,1,2
542110,True,0,8 user reviews,3,5,8
542120,True,0,No user reviews,0,0,0
542130,True,0,4 user reviews,3,1,4
542140,True,0,No user reviews,0,0,0
542150,True,7,Positive,21,0,21
542160,True,7,Positive,16,3,19
542170,True,0,No user reviews,0,0,0
542190,True,0,1 user reviews,1,0,1
542200,True,8,Very Positive,84,9,93
542210,True,0,2 user reviews,2,0,2
542220,True,0,8 user reviews,8,0,8
542240,True,0,6 user reviews,5,1,6
542260,True,8,Very Positive,65,11,76
542270,True,0,3 user reviews,1,2,3
542280,True,0,8 user reviews,2,6,8
542290,True,7,Positive,27,2,29
542300,True,0,1 user reviews,1,0,1
542310,True,6,Mostly Positive,26,7,33
542320,True,0,No user reviews,0,0,0
542330,True,0,2 user reviews,2,0,2
542340,True,4,Mostly Negative,21,37,58
542350,True,6,Mostly Positive,45,18,63
542380,True,7,Positive,10,0,10
542390,True,0,No user reviews,0,0,0
542400,True,6,Mostly Positive,57,22,79
542410,True,4,Mostly Negative,4,8,12
542430,True,4,Mostly Negative,10,35,45
542440,True,0,No user reviews,0,0,0
542450,True,5,Mixed,13,10,23
542470,True,0,No user reviews,0,0,0
542480,True,0,No user reviews,0,0,0
542490,True,0,5 user reviews,5,0,5
542491,True,0,4 user reviews,4,0,4
542500,True,0,1 user reviews,1,0,1
542501,True,0,1 user reviews,1,0,1
542510,True,0,No user reviews,0,0,0
542520,True,7,Positive,24,3,27
542530,True,0,4 user reviews,1,3,4
542540,True,0,No user reviews,0,0,0
542541,True,0,No user reviews,0,0,0
542542,True,0,No user reviews,0,0,0
542550,True,7,Positive,18,2,20
542570,True,0,8 user reviews,6,2,8
542590,True,0,No user reviews,0,0,0
542600,True,0,1 user reviews,1,0,1
542610,True,0,No user reviews,0,0,0
542611,True,0,No user reviews,0,0,0
542612,True,0,No user reviews,0,0,0
542620,True,0,3 user reviews,2,1,3
542640,True,0,No user reviews,0,0,0
542650,True,3,Negative,2,9,11
542660,True,6,Mostly Positive,42,11,53
542670,True,0,6 user reviews,1,5,6
542680,True,5,Mixed,7,4,11
542690,True,0,2 user reviews,2,0,2
542710,True,0,3 user reviews,3,0,3
542720,True,0,1 user reviews,1,0,1
542730,True,0,2 user reviews,0,2,2
542740,True,0,1 user reviews,1,0,1
542750,True,0,1 user reviews,0,1,1
542770,True,8,Very Positive,164,14,178
542780,True,0,1 user reviews,1,0,1
542790,True,0,No user reviews,0,0,0
542810,True,0,No user reviews,0,0,0
542820,True,6,Mostly Positive,10,3,13
542830,True,0,2 user reviews,1,1,2
542840,True,0,No user reviews,0,0,0
542850,True,0,No user reviews,0,0,0
542870,True,0,No user reviews,0,0,0
542880,True,0,No user reviews,0,0,0
542890,True,0,No user reviews,0,0,0
542900,True,0,No user reviews,0,0,0
542910,True,0,5 user reviews,3,2,5
542930,True,0,1 user reviews,1,0,1
542940,True,0,No user reviews,0,0,0
542960,True,0,No user reviews,0,0,0
542970,True,0,1 user reviews,1,0,1
542971,True,0,No user reviews,0,0,0
542972,True,0,3 user reviews,3,0,3
542974,True,0,No user reviews,0,0,0
542975,True,0,No user reviews,0,0,0
543000,True,0,No user reviews,0,0,0
543001,True,0,No user reviews,0,0,0
543002,True,0,No user reviews,0,0,0
543003,True,0,No user reviews,0,0,0
543004,True,0,No user reviews,0,0,0
543005,True,0,No user reviews,0,0,0
543010,True,5,Mixed,112,58,170
543030,True,5,Mixed,30,22,52
543040,True,0,3 user reviews,3,0,3
543050,True,0,6 user reviews,3,3,6
543070,True,7,Positive,16,1,17
543080,True,0,3 user reviews,3,0,3
543090,True,0,1 user reviews,1,0,1
543100,True,5,Mixed,23,10,33
543110,True,0,3 user reviews,3,0,3
543120,True,0,1 user reviews,0,1,1
543140,True,5,Mixed,13,8,21
543150,True,0,No user reviews,0,0,0
543160,True,0,6 user reviews,2,4,6
543170,True,0,3 user reviews,2,1,3
543180,True,6,Mostly Positive,40,14,54
543190,True,0,6 user reviews,6,0,6
543191,True,0,7 user reviews,7,0,7
543192,True,7,Positive,14,0,14
543193,True,0,9 user reviews,8,1,9
543200,True,0,1 user reviews,1,0,1
543210,True,0,No user reviews,0,0,0
543220,True,0,No user reviews,0,0,0
543230,True,0,No user reviews,0,0,0
543240,True,6,Mostly Positive,69,20,89
543250,True,0,No user reviews,0,0,0
543260,True,8,Very Positive,490,56,546
543270,True,7,Positive,13,3,16
543290,True,0,5 user reviews,3,2,5
543300,True,0,2 user reviews,1,1,2
543310,True,0,No user reviews,0,0,0
543320,True,5,Mixed,6,6,12
543330,True,0,No user reviews,0,0,0
543340,True,0,1 user reviews,1,0,1
543350,True,5,Mixed,9,4,13
543360,True,0,8 user reviews,0,8,8
543380,True,0,6 user reviews,3,3,6
543390,True,5,Mixed,75,41,116
543410,True,6,Mostly Positive,10,3,13
543430,True,5,Mixed,8,4,12
543440,True,7,Positive,21,4,25
543460,True,5,Mixed,341,265,606
543470,True,0,1 user reviews,1,0,1
543510,True,5,Mixed,7,5,12
543520,True,0,3 user reviews,2,1,3
543530,True,7,Positive,12,1,13
543540,True,0,3 user reviews,1,2,3
543560,True,0,No user reviews,0,0,0
543580,True,7,Positive,22,4,26
543600,True,7,Positive,15,1,16
543610,True,0,1 user reviews,1,0,1
543620,True,0,No user reviews,0,0,0
543640,True,0,No user reviews,0,0,0
543650,True,0,6 user reviews,1,5,6
543660,True,0,1 user reviews,1,0,1
543670,True,0,2 user reviews,1,1,2
543690,True,0,No user reviews,0,0,0
543691,True,0,No user reviews,0,0,0
543692,True,0,No user reviews,0,0,0
543693,True,0,No user reviews,0,0,0
543700,True,0,No user reviews,0,0,0
543710,True,5,Mixed,9,4,13
543720,True,0,3 user reviews,3,0,3
543730,True,0,No user reviews,0,0,0
543740,True,0,4 user reviews,2,2,4
543750,True,0,No user reviews,0,0,0
543810,True,0,No user reviews,0,0,0
543811,True,0,1 user reviews,0,1,1
543820,True,0,No user reviews,0,0,0
543821,True,0,No user reviews,0,0,0
543822,True,0,No user reviews,0,0,0
543823,True,0,No user reviews,0,0,0
543840,True,0,No user reviews,0,0,0
543850,True,0,No user reviews,0,0,0
543860,True,0,No user reviews,0,0,0
543870,True,8,Very Positive,210,46,256
543890,True,0,No user reviews,0,0,0
543900,True,5,Mixed,1048,610,1658
543910,True,0,1 user reviews,1,0,1
543920,True,0,No user reviews,0,0,0
543930,True,0,2 user reviews,1,1,2
543940,True,0,3 user reviews,3,0,3
543950,True,0,2 user reviews,0,2,2
543960,True,0,No user reviews,0,0,0
543980,True,8,Very Positive,96,10,106
543990,True,0,No user reviews,0,0,0
544000,True,0,No user reviews,0,0,0
544010,True,0,No user reviews,0,0,0
544030,True,0,No user reviews,0,0,0
544060,True,0,No user reviews,0,0,0
544080,True,0,No user reviews,0,0,0
544100,True,0,No user reviews,0,0,0
544120,True,0,No user reviews,0,0,0
544130,True,0,3 user reviews,3,0,3
544140,True,0,1 user reviews,0,1,1
544150,True,0,1 user reviews,1,0,1
544160,True,0,No user reviews,0,0,0
544180,True,7,Positive,11,0,11
544190,True,5,Mixed,8,4,12
544210,True,0,No user reviews,0,0,0
544220,True,0,9 user reviews,3,6,9
544230,True,0,No user reviews,0,0,0
544240,True,0,4 user reviews,2,2,4
544250,True,0,No user reviews,0,0,0
544260,True,0,1 user reviews,1,0,1
544270,True,5,Mixed,13,7,20
544290,True,0,4 user reviews,4,0,4
544300,True,0,No user reviews,0,0,0
544310,True,8,Very Positive,126,6,132
544320,True,0,No user reviews,0,0,0
544330,True,8,Very Positive,513,77,590
544360,True,0,No user reviews,0,0,0
544370,True,0,1 user reviews,0,1,1
544380,True,0,2 user reviews,2,0,2
544390,True,8,Very Positive,475,40,515
544400,True,7,Positive,10,0,10
544410,True,5,Mixed,9,7,16
544420,True,0,No user reviews,0,0,0
544430,True,0,No user reviews,0,0,0
544440,True,5,Mixed,6,4,10
544450,True,0,No user reviews,0,0,0
544460,True,0,No user reviews,0,0,0
544470,True,0,No user reviews,0,0,0
544480,True,4,Mostly Negative,5,12,17
544490,True,0,No user reviews,0,0,0
544520,True,0,1 user reviews,1,0,1
544530,True,6,Mostly Positive,26,9,35
544540,True,7,Positive,22,3,25
544550,True,8,Very Positive,1441,326,1767
544560,True,0,2 user reviews,1,1,2
544561,True,0,No user reviews,0,0,0
544570,True,0,No user reviews,0,0,0
544571,True,0,No user reviews,0,0,0
544580,True,7,Positive,14,1,15
544590,True,0,2 user reviews,1,1,2
544600,True,7,Positive,27,5,32
544610,True,8,Very Positive,1057,167,1224
544620,True,0,No user reviews,0,0,0
544630,True,7,Positive,10,1,11
544650,True,6,Mostly Positive,13,5,18
544670,True,0,No user reviews,0,0,0
544671,True,0,No user reviews,0,0,0
544680,True,0,4 user reviews,1,3,4
544700,True,0,No user reviews,0,0,0
544710,True,7,Positive,18,2,20
544730,True,0,No user reviews,0,0,0
544750,True,8,Very Positive,2463,552,3015
544760,True,0,No user reviews,0,0,0
544770,True,0,1 user reviews,0,1,1
544790,True,5,Mixed,34,19,53
544800,True,0,6 user reviews,4,2,6
544810,True,0,No user reviews,0,0,0
544820,True,0,2 user reviews,2,0,2
544830,True,0,2 user reviews,2,0,2
544831,True,0,No user reviews,0,0,0
544832,True,0,1 user reviews,1,0,1
544840,True,0,5 user reviews,3,2,5
544850,True,0,No user reviews,0,0,0
544870,True,5,Mixed,9,7,16
544880,True,0,3 user reviews,1,2,3
544890,True,0,No user reviews,0,0,0
544900,True,0,No user reviews,0,0,0
544920,True,6,Mostly Positive,625,221,846
544940,True,0,2 user reviews,2,0,2
544960,True,0,No user reviews,0,0,0
544970,True,8,Very Positive,238,10,248
544980,True,0,2 user reviews,2,0,2
544990,True,0,No user reviews,0,0,0
545000,True,0,No user reviews,0,0,0
545010,True,0,No user reviews,0,0,0
545020,True,0,7 user reviews,7,0,7
545030,True,8,Very Positive,51,3,54
545040,True,8,Very Positive,103,8,111
545050,True,5,Mixed,120,79,199
545060,True,5,Mixed,7,4,11
545070,True,0,No user reviews,0,0,0
545090,True,7,Positive,25,5,30
545100,True,6,Mostly Positive,97,30,127
545110,True,6,Mostly Positive,19,8,27
545120,True,0,No user reviews,0,0,0
545130,True,4,Mostly Negative,7,12,19
545140,True,0,No user reviews,0,0,0
545150,True,5,Mixed,10,8,18
545170,True,0,2 user reviews,2,0,2
545180,True,8,Very Positive,51,11,62
545190,True,0,No user reviews,0,0,0
545200,True,5,Mixed,9,6,15
545210,True,5,Mixed,8,6,14
545240,True,0,No user reviews,0,0,0
545260,True,0,1 user reviews,0,1,1
545270,True,5,Mixed,260,148,408
545290,True,0,No user reviews,0,0,0
545310,True,0,No user reviews,0,0,0
545330,True,5,Mixed,14,18,32
545340,True,0,8 user reviews,8,0,8
545400,True,0,8 user reviews,6,2,8
545410,True,8,Very Positive,53,13,66
545430,True,7,Positive,41,2,43
545450,True,0,No user reviews,0,0,0
545470,True,0,4 user reviews,3,1,4
545480,True,0,No user reviews,0,0,0
545481,True,0,No user reviews,0,0,0
545482,True,0,No user reviews,0,0,0
545490,True,0,6 user reviews,0,6,6
545500,True,0,No user reviews,0,0,0
545510,True,0,No user reviews,0,0,0
545511,True,0,No user reviews,0,0,0
545512,True,0,No user reviews,0,0,0
545513,True,0,No user reviews,0,0,0
545514,True,0,No user reviews,0,0,0
545530,True,0,No user reviews,0,0,0
545531,True,0,No user reviews,0,0,0
545532,True,0,No user reviews,0,0,0
545533,True,0,No user reviews,0,0,0
545534,True,0,No user reviews,0,0,0
545540,True,8,Very Positive,252,45,297
545560,True,0,3 user reviews,3,0,3
545570,True,0,No user reviews,0,0,0
545580,True,5,Mixed,26,23,49
545590,True,7,Positive,14,1,15
545600,True,8,Very Positive,144,31,175
545610,True,0,No user reviews,0,0,0
545620,True,5,Mixed,12,8,20
545630,True,0,No user reviews,0,0,0
545640,True,0,6 user reviews,4,2,6
545650,True,5,Mixed,63,72,135
545660,True,0,5 user reviews,5,0,5
545670,True,7,Positive,10,2,12
545690,True,8,Very Positive,173,10,183
545700,True,0,5 user reviews,1,4,5
545720,True,0,5 user reviews,3,2,5
545750,True,0,No user reviews,0,0,0
545760,True,0,No user reviews,0,0,0
545800,True,5,Mixed,7,7,14
545810,True,0,No user reviews,0,0,0
545820,True,0,8 user reviews,4,4,8
545830,True,5,Mixed,8,10,18
545840,True,0,1 user reviews,1,0,1
545850,True,7,Positive,9,1,10
545860,True,5,Mixed,14,12,26
545880,True,0,3 user reviews,3,0,3
545890,True,0,9 user reviews,6,3,9
545910,True,0,1 user reviews,1,0,1
545920,True,0,6 user reviews,3,3,6
545930,True,4,Mostly Negative,4,9,13
545940,True,7,Positive,12,1,13
545960,True,7,Positive,30,4,34
545980,True,8,Very Positive,196,15,211
545990,True,0,No user reviews,0,0,0
546030,True,0,7 user reviews,3,4,7
546040,True,0,3 user reviews,1,2,3
546050,True,8,Very Positive,1391,166,1557
546070,True,6,Mostly Positive,22,8,30
546080,True,8,Very Positive,67,16,83
546090,True,8,Very Positive,69,6,75
546100,True,0,5 user reviews,5,0,5
546110,True,0,3 user reviews,2,1,3
546120,True,0,No user reviews,0,0,0
546140,True,0,No user reviews,0,0,0
546150,True,6,Mostly Positive,48,19,67
546160,True,7,Positive,10,1,11
546170,True,7,Positive,13,0,13
546180,True,0,7 user reviews,5,2,7
546200,True,7,Positive,18,3,21
546210,True,5,Mixed,12,10,22
546220,True,7,Positive,10,2,12
546230,True,5,Mixed,9,4,13
546240,True,0,9 user reviews,2,7,9
546260,True,7,Positive,12,1,13
546310,True,0,8 user reviews,5,3,8
546311,True,0,4 user reviews,4,0,4
546312,True,0,4 user reviews,2,2,4
546320,True,0,9 user reviews,7,2,9
546330,True,7,Positive,10,0,10
546340,True,4,Mostly Negative,4,11,15
546350,True,5,Mixed,40,24,64
546360,True,5,Mixed,5,7,12
546370,True,0,2 user reviews,2,0,2
546371,True,0,6 user reviews,2,4,6
546372,True,0,4 user reviews,3,1,4
546373,True,4,Mostly Negative,6,10,16
546374,True,0,1 user reviews,1,0,1
546390,True,7,Positive,37,1,38
546400,True,4,Mostly Negative,9,21,30
546410,True,7,Positive,13,2,15
546430,True,6,Mostly Positive,613,232,845
546440,True,0,2 user reviews,0,2,2
546460,True,7,Positive,11,0,11
546480,True,0,No user reviews,0,0,0
546490,True,5,Mixed,12,9,21
546500,True,0,No user reviews,0,0,0
546520,True,0,1 user reviews,1,0,1
546550,True,7,Positive,35,2,37
546560,True,9,Overwhelmingly Positive,24622,367,24989
546590,True,0,No user reviews,0,0,0
546600,True,0,3 user reviews,3,0,3
546610,True,0,3 user reviews,2,1,3
546650,True,5,Mixed,11,5,16
546660,True,0,8 user reviews,1,7,8
546670,True,0,No user reviews,0,0,0
546690,True,0,No user reviews,0,0,0
546700,True,6,Mostly Positive,33,14,47
546720,True,0,No user reviews,0,0,0
546730,True,0,No user reviews,0,0,0
546780,True,7,Positive,17,2,19
546790,True,0,9 user reviews,8,1,9
546800,True,0,1 user reviews,1,0,1
546810,True,0,4 user reviews,4,0,4
546820,True,0,9 user reviews,4,5,9
546830,True,0,No user reviews,0,0,0
546860,True,0,1 user reviews,1,0,1
546870,True,0,5 user reviews,3,2,5
546880,True,0,No user reviews,0,0,0
546890,True,0,1 user reviews,1,0,1
546900,True,5,Mixed,19,24,43
546930,True,5,Mixed,81,76,157
546940,True,0,No user reviews,0,0,0
546960,True,0,No user reviews,0,0,0
546980,True,4,Mostly Negative,19,43,62
546990,True,5,Mixed,6,7,13
547000,True,0,1 user reviews,0,1,1
547020,True,0,No user reviews,0,0,0
547040,True,5,Mixed,7,5,12
547050,True,7,Positive,36,5,41
547060,True,0,No user reviews,0,0,0
547070,True,0,3 user reviews,3,0,3
547090,True,0,6 user reviews,3,3,6
547100,True,0,No user reviews,0,0,0
547120,True,7,Positive,12,1,13
547130,True,0,4 user reviews,3,1,4
547140,True,0,6 user reviews,4,2,6
547150,True,0,9 user reviews,6,3,9
547170,True,0,No user reviews,0,0,0
547180,True,5,Mixed,7,4,11
547200,True,0,8 user reviews,7,1,8
547210,True,0,3 user reviews,3,0,3
547230,True,0,1 user reviews,1,0,1
547240,True,0,No user reviews,0,0,0
547250,True,0,5 user reviews,0,5,5
547260,True,0,1 user reviews,0,1,1
547270,True,0,No user reviews,0,0,0
547271,True,0,No user reviews,0,0,0
547272,True,0,No user reviews,0,0,0
547273,True,0,No user reviews,0,0,0
547280,True,0,6 user reviews,6,0,6
547310,True,5,Mixed,19,10,29
547340,True,8,Very Positive,77,13,90
547350,True,0,No user reviews,0,0,0
547360,True,6,Mostly Positive,163,41,204
547370,True,0,No user reviews,0,0,0
547390,True,7,Positive,22,0,22
547400,True,0,No user reviews,0,0,0
547410,True,5,Mixed,109,112,221
547430,True,0,2 user reviews,2,0,2
547440,True,0,No user reviews,0,0,0
547470,True,0,4 user reviews,3,1,4
547480,True,8,Very Positive,79,2,81
547490,True,0,1 user reviews,1,0,1
547500,True,8,Very Positive,47,7,54
547501,True,6,Mostly Positive,51,17,68
547502,True,8,Very Positive,275,49,324
547520,True,0,4 user reviews,2,2,4
547530,True,0,No user reviews,0,0,0
547540,True,0,1 user reviews,1,0,1
547550,True,0,No user reviews,0,0,0
547560,True,0,1 user reviews,1,0,1
547561,True,0,1 user reviews,0,1,1
547562,True,0,1 user reviews,0,1,1
547570,True,0,4 user reviews,4,0,4
547580,True,0,No user reviews,0,0,0
547590,True,8,Very Positive,151,27,178
547610,True,0,No user reviews,0,0,0
547620,True,0,No user reviews,0,0,0
547630,True,0,1 user reviews,1,0,1
547650,True,0,No user reviews,0,0,0
547660,True,0,No user reviews,0,0,0
547670,True,0,No user reviews,0,0,0
547680,True,6,Mostly Positive,166,53,219
547690,True,0,No user reviews,0,0,0
547691,True,0,No user reviews,0,0,0
547692,True,0,No user reviews,0,0,0
547693,True,0,No user reviews,0,0,0
547694,True,0,No user reviews,0,0,0
547695,True,0,No user reviews,0,0,0
547696,True,0,No user reviews,0,0,0
547697,True,0,No user reviews,0,0,0
547698,True,0,No user reviews,0,0,0
547699,True,0,No user reviews,0,0,0
547700,True,0,No user reviews,0,0,0
547701,True,0,No user reviews,0,0,0
547702,True,0,No user reviews,0,0,0
547710,True,0,5 user reviews,4,1,5
547720,True,0,No user reviews,0,0,0
547730,True,0,3 user reviews,1,2,3
547740,True,0,6 user reviews,3,3,6
547750,True,0,3 user reviews,2,1,3
547760,True,6,Mostly Positive,15,4,19
547800,True,0,No user reviews,0,0,0
547820,True,0,5 user reviews,2,3,5
547830,True,0,No user reviews,0,0,0
547840,True,5,Mixed,8,6,14
547850,True,8,Very Positive,45,10,55
547860,True,5,Mixed,502,404,906
547870,True,0,No user reviews,0,0,0
547880,True,0,6 user reviews,4,2,6
547900,True,8,Very Positive,157,32,189
547910,True,6,Mostly Positive,188,61,249
547920,True,0,2 user reviews,0,2,2
547930,True,5,Mixed,8,4,12
547960,True,0,5 user reviews,3,2,5
547970,True,7,Positive,9,2,11
547980,True,7,Positive,38,2,40
547990,True,5,Mixed,8,5,13
548000,True,0,No user reviews,0,0,0
548010,True,5,Mixed,14,8,22
548020,True,5,Mixed,24,22,46
548050,True,7,Positive,12,2,14
548070,True,0,No user reviews,0,0,0
548080,True,5,Mixed,10,6,16
548110,True,0,5 user reviews,5,0,5
548130,True,7,Positive,13,1,14
548160,True,0,No user reviews,0,0,0
548170,True,0,2 user reviews,2,0,2
548190,True,0,No user reviews,0,0,0
548200,True,0,No user reviews,0,0,0
548210,True,0,No user reviews,0,0,0
548220,True,0,2 user reviews,2,0,2
548230,True,7,Positive,39,5,44
548240,True,6,Mostly Positive,13,5,18
548250,True,0,No user reviews,0,0,0
548260,True,0,4 user reviews,2,2,4
548270,True,0,No user reviews,0,0,0
548280,True,0,No user reviews,0,0,0
548290,True,0,5 user reviews,4,1,5
548300,True,0,No user reviews,0,0,0
548320,True,5,Mixed,7,5,12
548330,True,7,Positive,17,1,18
548340,True,8,Very Positive,207,15,222
548350,True,0,6 user reviews,0,6,6
548360,True,0,9 user reviews,6,3,9
548370,True,5,Mixed,40,58,98
548380,True,0,3 user reviews,2,1,3
548390,True,0,5 user reviews,4,1,5
548400,True,0,No user reviews,0,0,0
548410,True,0,2 user reviews,0,2,2
548420,True,8,Very Positive,103,22,125
548421,True,6,Mostly Positive,85,25,110
548430,True,9,Overwhelmingly Positive,27724,770,28494
548440,True,0,No user reviews,0,0,0
548450,True,5,Mixed,8,4,12
548470,True,0,8 user reviews,5,3,8
548480,True,4,Mostly Negative,11,27,38
548490,True,0,1 user reviews,1,0,1
548500,True,7,Positive,29,4,33
548510,True,0,1 user reviews,0,1,1
548520,True,0,No user reviews,0,0,0
548521,True,0,No user reviews,0,0,0
548522,True,0,No user reviews,0,0,0
548523,True,0,No user reviews,0,0,0
548524,True,0,No user reviews,0,0,0
548525,True,0,No user reviews,0,0,0
548540,True,0,1 user reviews,0,1,1
548560,True,5,Mixed,36,19,55
548570,True,5,Mixed,3427,2101,5528
548630,True,0,1 user reviews,1,0,1
548640,True,0,No user reviews,0,0,0
548641,True,0,No user reviews,0,0,0
548642,True,0,No user reviews,0,0,0
548643,True,0,No user reviews,0,0,0
548644,True,0,No user reviews,0,0,0
548645,True,0,No user reviews,0,0,0
548646,True,0,No user reviews,0,0,0
548647,True,0,No user reviews,0,0,0
548648,True,0,No user reviews,0,0,0
548649,True,0,No user reviews,0,0,0
548650,True,6,Mostly Positive,20,7,27
548660,True,0,9 user reviews,8,1,9
548680,True,7,Positive,38,4,42
548690,True,0,No user reviews,0,0,0
548700,True,0,1 user reviews,1,0,1
548710,True,0,1 user reviews,1,0,1
548720,True,0,2 user reviews,2,0,2
548730,True,0,No user reviews,0,0,0
548740,True,0,7 user reviews,3,4,7
548750,True,0,No user reviews,0,0,0
548760,True,5,Mixed,13,15,28
548770,True,0,No user reviews,0,0,0
548790,True,0,No user reviews,0,0,0
548810,True,6,Mostly Positive,9,3,12
548820,True,0,No user reviews,0,0,0
548821,True,0,1 user reviews,0,1,1
548830,True,0,No user reviews,0,0,0
548831,True,0,No user reviews,0,0,0
548840,True,8,Very Positive,63,15,78
548850,True,0,3 user reviews,2,1,3
548860,True,5,Mixed,11,6,17
548910,True,0,No user reviews,0,0,0
548920,True,0,No user reviews,0,0,0
548970,True,0,No user reviews,0,0,0
548971,True,0,No user reviews,0,0,0
548972,True,0,No user reviews,0,0,0
548980,True,0,No user reviews,0,0,0
549000,True,7,Positive,14,2,16
549030,True,0,9 user reviews,3,6,9
549040,True,5,Mixed,22,32,54
549070,True,0,9 user reviews,8,1,9
549071,True,0,6 user reviews,6,0,6
549080,True,8,Very Positive,110,25,135
549090,True,0,2 user reviews,2,0,2
549100,True,6,Mostly Positive,39,15,54
549110,True,0,No user reviews,0,0,0
549111,True,0,2 user reviews,1,1,2
549112,True,0,1 user reviews,1,0,1
549113,True,0,3 user reviews,3,0,3
549160,True,7,Positive,37,7,44
549170,True,5,Mixed,31,18,49
549180,True,5,Mixed,21,13,34
549190,True,0,5 user reviews,5,0,5
549200,True,7,Positive,13,0,13
549220,True,0,1 user reviews,1,0,1
549230,True,0,No user reviews,0,0,0
549240,True,5,Mixed,45,23,68
549250,True,0,No user reviews,0,0,0
549260,True,6,Mostly Positive,188,48,236
549280,True,0,2 user reviews,0,2,2
549290,True,0,3 user reviews,3,0,3
549300,True,0,1 user reviews,1,0,1
549310,True,0,1 user reviews,1,0,1
549320,True,0,1 user reviews,1,0,1
549321,True,0,No user reviews,0,0,0
549322,True,0,No user reviews,0,0,0
549323,True,0,No user reviews,0,0,0
549324,True,0,No user reviews,0,0,0
549325,True,0,No user reviews,0,0,0
549326,True,0,No user reviews,0,0,0
549327,True,0,No user reviews,0,0,0
549328,True,0,No user reviews,0,0,0
549329,True,0,No user reviews,0,0,0
549330,True,0,No user reviews,0,0,0
549331,True,0,No user reviews,0,0,0
549332,True,0,No user reviews,0,0,0
549370,True,0,No user reviews,0,0,0
549380,True,0,No user reviews,0,0,0
549390,True,6,Mostly Positive,20,7,27
549400,True,6,Mostly Positive,18,7,25
549410,True,0,No user reviews,0,0,0
549420,True,0,No user reviews,0,0,0
549421,True,0,No user reviews,0,0,0
549422,True,0,No user reviews,0,0,0
549430,True,0,No user reviews,0,0,0
549440,True,0,No user reviews,0,0,0
549441,True,0,No user reviews,0,0,0
549442,True,0,No user reviews,0,0,0
549443,True,0,No user reviews,0,0,0
549450,True,0,1 user reviews,1,0,1
549460,True,0,No user reviews,0,0,0
549461,True,0,No user reviews,0,0,0
549462,True,0,No user reviews,0,0,0
549463,True,0,No user reviews,0,0,0
549470,True,0,No user reviews,0,0,0
549480,True,0,No user reviews,0,0,0
549481,True,0,No user reviews,0,0,0
549490,True,0,2 user reviews,2,0,2
549500,True,0,No user reviews,0,0,0
549501,True,0,No user reviews,0,0,0
549502,True,0,No user reviews,0,0,0
549510,True,0,3 user reviews,3,0,3
549520,True,0,1 user reviews,0,1,1
549521,True,0,No user reviews,0,0,0
549522,True,0,No user reviews,0,0,0
549530,True,0,No user reviews,0,0,0
549540,True,0,No user reviews,0,0,0
549541,True,0,No user reviews,0,0,0
549550,True,0,1 user reviews,1,0,1
549560,True,0,No user reviews,0,0,0
549561,True,0,No user reviews,0,0,0
549562,True,0,No user reviews,0,0,0
549570,True,0,No user reviews,0,0,0
549580,True,0,No user reviews,0,0,0
549581,True,0,No user reviews,0,0,0
549582,True,0,No user reviews,0,0,0
549590,True,0,2 user reviews,2,0,2
549600,True,0,No user reviews,0,0,0
549601,True,0,No user reviews,0,0,0
549602,True,0,No user reviews,0,0,0
549610,True,0,No user reviews,0,0,0
549620,True,0,No user reviews,0,0,0
549630,True,0,No user reviews,0,0,0
549640,True,0,No user reviews,0,0,0
549650,True,0,No user reviews,0,0,0
549660,True,0,1 user reviews,1,0,1
549670,True,0,7 user reviews,4,3,7
549680,True,7,Positive,25,6,31
549700,True,0,7 user reviews,4,3,7
549720,True,0,1 user reviews,0,1,1
549740,True,7,Positive,19,1,20
549750,True,0,2 user reviews,2,0,2
549760,True,7,Positive,11,2,13
549770,True,0,3 user reviews,1,2,3
549780,True,0,3 user reviews,2,1,3
549790,True,0,No user reviews,0,0,0
549800,True,0,No user reviews,0,0,0
549830,True,0,1 user reviews,0,1,1
549840,True,7,Positive,20,1,21
549850,True,7,Positive,24,4,28
549860,True,8,Very Positive,258,35,293
549880,True,0,1 user reviews,1,0,1
549890,True,0,No user reviews,0,0,0
549900,True,0,6 user reviews,5,1,6
549910,True,5,Mixed,16,7,23
549920,True,0,No user reviews,0,0,0
549940,True,0,No user reviews,0,0,0
549950,True,5,Mixed,6,7,13
549960,True,0,No user reviews,0,0,0
549970,True,0,No user reviews,0,0,0
549971,True,0,1 user reviews,1,0,1
549990,True,0,No user reviews,0,0,0
550010,True,8,Very Positive,718,129,847
550040,True,0,No user reviews,0,0,0
550050,True,7,Positive,11,0,11
550060,True,8,Very Positive,68,0,68
550070,True,0,No user reviews,0,0,0
550080,True,8,Very Positive,278,42,320
550140,True,0,No user reviews,0,0,0
550160,True,7,Positive,16,0,16
550170,True,7,Positive,16,0,16
550180,True,0,No user reviews,0,0,0
550200,True,0,2 user reviews,2,0,2
550210,True,0,8 user reviews,7,1,8
550220,True,0,1 user reviews,1,0,1
550240,True,0,9 user reviews,4,5,9
550260,True,0,No user reviews,0,0,0
550270,True,0,1 user reviews,1,0,1
550280,True,0,No user reviews,0,0,0
550290,True,0,No user reviews,0,0,0
550300,True,0,No user reviews,0,0,0
550310,True,8,Very Positive,94,23,117
550320,True,9,Overwhelmingly Positive,513,26,539
550330,True,0,2 user reviews,1,1,2
550331,True,7,Positive,10,0,10
550332,True,0,3 user reviews,2,1,3
550333,True,0,1 user reviews,1,0,1
550334,True,0,2 user reviews,2,0,2
550335,True,0,1 user reviews,1,0,1
550340,True,8,Very Positive,73,14,87
550350,True,0,1 user reviews,1,0,1
550360,True,5,Mixed,23,12,35
550370,True,0,No user reviews,0,0,0
550380,True,0,1 user reviews,1,0,1
550381,True,0,2 user reviews,2,0,2
550382,True,0,2 user reviews,2,0,2
550390,True,6,Mostly Positive,7,3,10
550400,True,7,Positive,13,0,13
550410,True,0,No user reviews,0,0,0
550420,True,0,8 user reviews,7,1,8
550440,True,0,3 user reviews,2,1,3
550450,True,5,Mixed,8,4,12
550460,True,0,3 user reviews,3,0,3
550461,True,0,8 user reviews,8,0,8
550470,True,0,No user reviews,0,0,0
550480,True,0,1 user reviews,1,0,1
550520,True,0,No user reviews,0,0,0
550530,True,0,No user reviews,0,0,0
550540,True,0,7 user reviews,4,3,7
550560,True,0,No user reviews,0,0,0
550580,True,6,Mostly Positive,29,10,39
550590,True,8,Very Positive,80,5,85
550600,True,0,2 user reviews,0,2,2
550640,True,0,No user reviews,0,0,0
550650,True,0,8 user reviews,5,3,8
550670,True,4,Mostly Negative,30,95,125
550680,True,0,No user reviews,0,0,0
550690,True,0,No user reviews,0,0,0
550700,True,0,No user reviews,0,0,0
550710,True,0,1 user reviews,1,0,1
550740,True,0,No user reviews,0,0,0
550760,True,0,No user reviews,0,0,0
550761,True,0,No user reviews,0,0,0
550762,True,0,No user reviews,0,0,0
550763,True,0,No user reviews,0,0,0
550764,True,0,No user reviews,0,0,0
550765,True,0,No user reviews,0,0,0
550766,True,0,No user reviews,0,0,0
550767,True,0,No user reviews,0,0,0
550768,True,0,No user reviews,0,0,0
550769,True,0,No user reviews,0,0,0
550770,True,0,No user reviews,0,0,0
550771,True,0,No user reviews,0,0,0
550772,True,0,No user reviews,0,0,0
550773,True,0,No user reviews,0,0,0
550774,True,0,No user reviews,0,0,0
550775,True,0,No user reviews,0,0,0
550776,True,0,No user reviews,0,0,0
550777,True,0,No user reviews,0,0,0
550778,True,0,No user reviews,0,0,0
550779,True,0,No user reviews,0,0,0
550780,True,0,No user reviews,0,0,0
550781,True,0,No user reviews,0,0,0
550782,True,0,No user reviews,0,0,0
550783,True,0,No user reviews,0,0,0
550784,True,0,No user reviews,0,0,0
550790,True,0,No user reviews,0,0,0
550800,True,0,3 user reviews,3,0,3
550810,True,7,Positive,31,6,37
550820,True,0,2 user reviews,2,0,2
550830,True,0,No user reviews,0,0,0
550840,True,5,Mixed,57,44,101
550850,True,0,No user reviews,0,0,0
550870,True,0,2 user reviews,1,1,2
550880,True,6,Mostly Positive,11,4,15
550890,True,0,3 user reviews,2,1,3
550900,True,0,No user reviews,0,0,0
550910,True,0,No user reviews,0,0,0
550930,True,0,4 user reviews,4,0,4
550990,True,7,Positive,23,1,24
551020,True,0,No user reviews,0,0,0
551030,True,0,No user reviews,0,0,0
551050,True,4,Mostly Negative,4,7,11
551060,True,0,5 user reviews,5,0,5
551070,True,0,No user reviews,0,0,0
551080,True,6,Mostly Positive,25,8,33
551100,True,0,5 user reviews,4,1,5
551110,True,8,Very Positive,161,29,190
551130,True,0,No user reviews,0,0,0
551150,True,0,8 user reviews,8,0,8
551160,True,0,1 user reviews,1,0,1
551170,True,8,Very Positive,125,28,153
551190,True,8,Very Positive,59,6,65
551200,True,0,No user reviews,0,0,0
551210,True,0,No user reviews,0,0,0
551220,True,0,No user reviews,0,0,0
551230,True,0,No user reviews,0,0,0
551240,True,0,No user reviews,0,0,0
551250,True,0,No user reviews,0,0,0
551260,True,0,6 user reviews,6,0,6
551290,True,0,No user reviews,0,0,0
551300,True,0,No user reviews,0,0,0
551310,True,0,No user reviews,0,0,0
551320,True,5,Mixed,8,4,12
551330,True,0,No user reviews,0,0,0
551340,True,0,No user reviews,0,0,0
551341,True,0,No user reviews,0,0,0
551342,True,0,No user reviews,0,0,0
551343,True,0,No user reviews,0,0,0
551344,True,0,No user reviews,0,0,0
551345,True,0,No user reviews,0,0,0
551346,True,0,No user reviews,0,0,0
551347,True,0,No user reviews,0,0,0
551348,True,0,No user reviews,0,0,0
551349,True,0,No user reviews,0,0,0
551350,True,0,No user reviews,0,0,0
551360,True,0,2 user reviews,2,0,2
551370,True,5,Mixed,46,25,71
551380,True,0,5 user reviews,5,0,5
551390,True,0,No user reviews,0,0,0
551391,True,0,No user reviews,0,0,0
551392,True,0,No user reviews,0,0,0
551393,True,0,No user reviews,0,0,0
551394,True,0,No user reviews,0,0,0
551395,True,0,No user reviews,0,0,0
551410,True,0,No user reviews,0,0,0
551440,True,5,Mixed,14,7,21
551450,True,8,Very Positive,170,18,188
551500,True,0,1 user reviews,0,1,1
551510,True,0,No user reviews,0,0,0
551520,True,0,9 user reviews,6,3,9
551530,True,0,No user reviews,0,0,0
551540,True,0,No user reviews,0,0,0
551550,True,4,Mostly Negative,3,8,11
551560,True,0,5 user reviews,5,0,5
551570,True,0,6 user reviews,6,0,6
551580,True,7,Positive,36,5,41
551590,True,0,No user reviews,0,0,0
551610,True,0,9 user reviews,1,8,9
551620,True,8,Very Positive,66,6,72
551630,True,5,Mixed,15,15,30
551650,True,0,7 user reviews,4,3,7
551670,True,0,2 user reviews,1,1,2
551680,True,0,4 user reviews,3,1,4
551690,True,6,Mostly Positive,81,23,104
551700,True,6,Mostly Positive,174,49,223
551710,True,0,No user reviews,0,0,0
551720,True,5,Mixed,13,7,20
551730,True,6,Mostly Positive,345,90,435
551740,True,0,4 user reviews,1,3,4
551750,True,0,8 user reviews,6,2,8
551770,True,8,Very Positive,614,140,754
551780,True,0,6 user reviews,3,3,6
551790,True,0,5 user reviews,4,1,5
551810,True,0,2 user reviews,2,0,2
551820,True,6,Mostly Positive,7,3,10
551821,True,7,Positive,12,3,15
551840,True,0,5 user reviews,4,1,5
551850,True,0,No user reviews,0,0,0
551860,True,6,Mostly Positive,347,118,465
551880,True,7,Positive,32,8,40
551890,True,0,No user reviews,0,0,0
551891,True,0,No user reviews,0,0,0
551892,True,0,No user reviews,0,0,0
551893,True,0,No user reviews,0,0,0
551894,True,0,No user reviews,0,0,0
551895,True,0,No user reviews,0,0,0
551896,True,0,No user reviews,0,0,0
551897,True,0,No user reviews,0,0,0
551898,True,0,No user reviews,0,0,0
551900,True,0,No user reviews,0,0,0
551910,True,0,No user reviews,0,0,0
551911,True,0,No user reviews,0,0,0
551912,True,0,No user reviews,0,0,0
551913,True,0,No user reviews,0,0,0
551914,True,0,No user reviews,0,0,0
551915,True,0,No user reviews,0,0,0
551916,True,0,No user reviews,0,0,0
551917,True,0,No user reviews,0,0,0
551918,True,0,No user reviews,0,0,0
551919,True,0,No user reviews,0,0,0
551930,True,5,Mixed,11,8,19
551940,True,0,No user reviews,0,0,0
551941,True,0,No user reviews,0,0,0
551942,True,0,No user reviews,0,0,0
551943,True,0,No user reviews,0,0,0
551944,True,0,No user reviews,0,0,0
551945,True,0,No user reviews,0,0,0
551946,True,0,No user reviews,0,0,0
551947,True,0,No user reviews,0,0,0
551948,True,0,No user reviews,0,0,0
551949,True,0,No user reviews,0,0,0
551950,True,0,No user reviews,0,0,0
551951,True,0,No user reviews,0,0,0
551952,True,0,No user reviews,0,0,0
551953,True,0,No user reviews,0,0,0
551954,True,0,No user reviews,0,0,0
551960,True,0,1 user reviews,1,0,1
551970,True,0,1 user reviews,1,0,1
551971,True,0,2 user reviews,1,1,2
552000,True,0,1 user reviews,1,0,1
552010,True,0,2 user reviews,0,2,2
552011,True,0,No user reviews,0,0,0
552020,True,0,No user reviews,0,0,0
552030,True,5,Mixed,34,18,52
552050,True,0,No user reviews,0,0,0
552060,True,7,Positive,34,8,42
552070,True,0,No user reviews,0,0,0
552080,True,9,Overwhelmingly Positive,516,13,529
552090,True,5,Mixed,16,11,27
552100,True,8,Very Positive,5996,527,6523
552110,True,0,2 user reviews,1,1,2
552120,True,6,Mostly Positive,8,3,11
552130,True,5,Mixed,50,72,122
552140,True,0,3 user reviews,2,1,3
552150,True,0,1 user reviews,0,1,1
552160,True,8,Very Positive,64,5,69
552190,True,0,1 user reviews,1,0,1
552200,True,0,8 user reviews,8,0,8
552210,True,0,1 user reviews,1,0,1
552220,True,0,1 user reviews,1,0,1
552230,True,0,7 user reviews,3,4,7
552240,True,0,1 user reviews,1,0,1
552270,True,0,6 user reviews,3,3,6
552280,True,7,Positive,16,4,20
552300,True,0,6 user reviews,2,4,6
552310,True,0,5 user reviews,2,3,5
552330,True,0,2 user reviews,2,0,2
552340,True,0,No user reviews,0,0,0
552350,True,5,Mixed,10,7,17
552360,True,0,1 user reviews,1,0,1
552370,True,7,Positive,10,1,11
552380,True,0,4 user reviews,3,1,4
552390,True,5,Mixed,17,17,34
552400,True,7,Positive,11,1,12
552410,True,5,Mixed,16,11,27
552440,True,8,Very Positive,356,69,425
552450,True,8,Very Positive,320,55,375
552460,True,8,Very Positive,95,10,105
552480,True,0,No user reviews,0,0,0
552490,True,0,No user reviews,0,0,0
552500,True,8,Very Positive,17410,2971,20381
552520,True,6,Mostly Positive,21927,6900,28827
552530,True,0,No user reviews,0,0,0
552540,True,0,4 user reviews,2,2,4
552550,True,0,3 user reviews,0,3,3
552570,True,0,3 user reviews,2,1,3
552580,True,5,Mixed,9,5,14
552590,True,8,Very Positive,1157,93,1250
552600,True,8,Very Positive,235,48,283
552610,True,0,7 user reviews,7,0,7
552620,True,8,Very Positive,1848,323,2171
552630,True,0,8 user reviews,6,2,8
552640,True,0,1 user reviews,1,0,1
552641,True,0,No user reviews,0,0,0
552642,True,0,No user reviews,0,0,0
552643,True,0,1 user reviews,1,0,1
552650,True,0,1 user reviews,1,0,1
552651,True,4,Mostly Negative,5,9,14
552652,True,0,No user reviews,0,0,0
552653,True,0,No user reviews,0,0,0
552660,True,0,1 user reviews,0,1,1
552670,True,0,1 user reviews,0,1,1
552680,True,0,No user reviews,0,0,0
552690,True,0,4 user reviews,4,0,4
552700,True,6,Mostly Positive,716,181,897
552720,True,6,Mostly Positive,7,3,10
552730,True,0,No user reviews,0,0,0
552750,True,0,No user reviews,0,0,0
552760,True,0,No user reviews,0,0,0
552770,True,0,2 user reviews,2,0,2
552780,True,7,Positive,10,2,12
552800,True,0,3 user reviews,3,0,3
552810,True,0,No user reviews,0,0,0
552820,True,0,1 user reviews,1,0,1
552830,True,0,No user reviews,0,0,0
552850,True,0,3 user reviews,3,0,3
552860,True,0,No user reviews,0,0,0
552870,True,0,4 user reviews,3,1,4
552880,True,8,Very Positive,114,12,126
552890,True,0,No user reviews,0,0,0
552900,True,0,1 user reviews,1,0,1
552910,True,4,Mostly Negative,4,7,11
552920,True,5,Mixed,270,149,419
552940,True,0,1 user reviews,1,0,1
552950,True,0,2 user reviews,1,1,2
552960,True,0,2 user reviews,0,2,2
552970,True,5,Mixed,44,21,65
552990,True,8,Very Positive,123,18,141
553000,True,5,Mixed,4,6,10
553020,True,0,4 user reviews,4,0,4
553030,True,5,Mixed,13,8,21
553040,True,0,6 user reviews,5,1,6
553050,True,5,Mixed,8,4,12
553070,True,0,1 user reviews,1,0,1
553071,True,0,No user reviews,0,0,0
553072,True,0,No user reviews,0,0,0
553073,True,0,1 user reviews,1,0,1
553074,True,0,2 user reviews,2,0,2
553075,True,0,2 user reviews,2,0,2
553080,True,0,No user reviews,0,0,0
553090,True,0,1 user reviews,1,0,1
553100,True,0,9 user reviews,1,8,9
553110,True,5,Mixed,6,9,15
553120,True,0,3 user reviews,3,0,3
553130,True,0,2 user reviews,1,1,2
553140,True,0,No user reviews,0,0,0
553150,True,0,7 user reviews,2,5,7
553160,True,0,6 user reviews,6,0,6
553170,True,0,1 user reviews,1,0,1
553180,True,0,4 user reviews,2,2,4
553190,True,0,1 user reviews,1,0,1
553200,True,0,No user reviews,0,0,0
553210,True,6,Mostly Positive,196,78,274
553220,True,0,No user reviews,0,0,0
553221,True,0,No user reviews,0,0,0
553222,True,0,No user reviews,0,0,0
553223,True,0,No user reviews,0,0,0
553224,True,0,No user reviews,0,0,0
553225,True,0,No user reviews,0,0,0
553226,True,0,No user reviews,0,0,0
553227,True,0,No user reviews,0,0,0
553228,True,0,No user reviews,0,0,0
553229,True,0,No user reviews,0,0,0
553230,True,0,No user reviews,0,0,0
553231,True,0,No user reviews,0,0,0
553232,True,0,No user reviews,0,0,0
553233,True,0,No user reviews,0,0,0
553234,True,0,No user reviews,0,0,0
553235,True,0,No user reviews,0,0,0
553236,True,0,No user reviews,0,0,0
553237,True,0,No user reviews,0,0,0
553238,True,0,No user reviews,0,0,0
553239,True,0,No user reviews,0,0,0
553240,True,0,No user reviews,0,0,0
553241,True,0,No user reviews,0,0,0
553242,True,0,No user reviews,0,0,0
553243,True,0,No user reviews,0,0,0
553244,True,0,No user reviews,0,0,0
553245,True,0,No user reviews,0,0,0
553260,True,5,Mixed,192,133,325
553270,True,0,No user reviews,0,0,0
553271,True,0,No user reviews,0,0,0
553280,True,8,Very Positive,441,83,524
553290,True,5,Mixed,10,13,23
553310,True,9,Overwhelmingly Positive,2296,77,2373
553320,True,5,Mixed,11,13,24
553330,True,0,2 user reviews,2,0,2
553340,True,7,Positive,25,6,31
553350,True,0,No user reviews,0,0,0
553360,True,0,No user reviews,0,0,0
553370,True,0,1 user reviews,1,0,1
553380,True,0,2 user reviews,2,0,2
553381,True,0,No user reviews,0,0,0
553382,True,0,No user reviews,0,0,0
553383,True,0,No user reviews,0,0,0
553384,True,0,No user reviews,0,0,0
553385,True,0,No user reviews,0,0,0
553386,True,0,No user reviews,0,0,0
553387,True,0,No user reviews,0,0,0
553410,True,0,8 user reviews,4,4,8
553420,True,0,No user reviews,0,0,0
553430,True,0,5 user reviews,3,2,5
553440,True,0,4 user reviews,4,0,4
553450,True,6,Mostly Positive,17,7,24
553470,True,5,Mixed,8,8,16
553480,True,8,Very Positive,162,27,189
553490,True,0,2 user reviews,1,1,2
553500,True,0,2 user reviews,2,0,2
553510,True,0,No user reviews,0,0,0
553520,True,6,Mostly Positive,190,69,259
553530,True,0,No user reviews,0,0,0
553540,True,0,No user reviews,0,0,0
553570,True,0,2 user reviews,0,2,2
553590,True,0,5 user reviews,5,0,5
553610,True,5,Mixed,12,6,18
553620,True,0,No user reviews,0,0,0
553630,True,0,2 user reviews,0,2,2
553640,True,8,Very Positive,1886,427,2313
553650,True,0,No user reviews,0,0,0
553660,True,6,Mostly Positive,50,17,67
553670,True,7,Positive,16,0,16
553680,True,0,1 user reviews,0,1,1
553690,True,0,8 user reviews,3,5,8
553700,True,0,2 user reviews,2,0,2
553720,True,0,1 user reviews,1,0,1
553750,True,0,3 user reviews,3,0,3
553760,True,8,Very Positive,77,3,80
553780,True,0,2 user reviews,2,0,2
553790,True,8,Very Positive,42,8,50
553800,True,5,Mixed,11,11,22
553820,True,6,Mostly Positive,11,4,15
553830,True,0,3 user reviews,1,2,3
553861,True,0,1 user reviews,1,0,1
553880,True,6,Mostly Positive,83,33,116
553910,True,0,2 user reviews,1,1,2
553920,True,5,Mixed,6,6,12
553930,True,0,No user reviews,0,0,0
553940,True,0,No user reviews,0,0,0
553950,True,7,Positive,20,1,21
553960,True,5,Mixed,19,15,34
553980,True,0,No user reviews,0,0,0
554000,True,8,Very Positive,162,4,166
554010,True,0,No user reviews,0,0,0
554011,True,0,No user reviews,0,0,0
554012,True,0,No user reviews,0,0,0
554013,True,0,No user reviews,0,0,0
554014,True,0,No user reviews,0,0,0
554015,True,0,No user reviews,0,0,0
554016,True,0,No user reviews,0,0,0
554017,True,0,No user reviews,0,0,0
554018,True,0,No user reviews,0,0,0
554019,True,0,No user reviews,0,0,0
554020,True,0,No user reviews,0,0,0
554021,True,0,No user reviews,0,0,0
554022,True,0,No user reviews,0,0,0
554023,True,0,No user reviews,0,0,0
554024,True,0,No user reviews,0,0,0
554025,True,0,No user reviews,0,0,0
554026,True,0,No user reviews,0,0,0
554027,True,0,No user reviews,0,0,0
554028,True,0,No user reviews,0,0,0
554029,True,0,No user reviews,0,0,0
554030,True,0,No user reviews,0,0,0
554031,True,0,No user reviews,0,0,0
554032,True,0,No user reviews,0,0,0
554040,True,0,No user reviews,0,0,0
554041,True,0,No user reviews,0,0,0
554042,True,0,No user reviews,0,0,0
554043,True,0,No user reviews,0,0,0
554044,True,0,No user reviews,0,0,0
554045,True,0,No user reviews,0,0,0
554046,True,0,No user reviews,0,0,0
554047,True,0,No user reviews,0,0,0
554048,True,0,No user reviews,0,0,0
554049,True,0,No user reviews,0,0,0
554050,True,0,No user reviews,0,0,0
554051,True,0,No user reviews,0,0,0
554052,True,0,No user reviews,0,0,0
554053,True,0,No user reviews,0,0,0
554054,True,0,No user reviews,0,0,0
554055,True,0,No user reviews,0,0,0
554056,True,0,No user reviews,0,0,0
554057,True,0,No user reviews,0,0,0
554058,True,0,No user reviews,0,0,0
554059,True,0,No user reviews,0,0,0
554060,True,0,No user reviews,0,0,0
554061,True,0,No user reviews,0,0,0
554062,True,0,No user reviews,0,0,0
554070,True,0,No user reviews,0,0,0
554071,True,0,No user reviews,0,0,0
554072,True,0,No user reviews,0,0,0
554073,True,0,No user reviews,0,0,0
554074,True,0,No user reviews,0,0,0
554075,True,0,No user reviews,0,0,0
554076,True,0,No user reviews,0,0,0
554077,True,0,No user reviews,0,0,0
554078,True,0,No user reviews,0,0,0
554079,True,0,No user reviews,0,0,0
554080,True,0,No user reviews,0,0,0
554081,True,0,No user reviews,0,0,0
554082,True,0,No user reviews,0,0,0
554083,True,0,No user reviews,0,0,0
554084,True,0,No user reviews,0,0,0
554085,True,0,No user reviews,0,0,0
554086,True,0,No user reviews,0,0,0
554087,True,0,No user reviews,0,0,0
554088,True,0,No user reviews,0,0,0
554089,True,0,No user reviews,0,0,0
554090,True,0,No user reviews,0,0,0
554091,True,0,No user reviews,0,0,0
554092,True,0,No user reviews,0,0,0
554100,True,0,No user reviews,0,0,0
554101,True,0,No user reviews,0,0,0
554102,True,0,No user reviews,0,0,0
554103,True,0,No user reviews,0,0,0
554104,True,0,No user reviews,0,0,0
554105,True,0,No user reviews,0,0,0
554106,True,0,No user reviews,0,0,0
554107,True,0,No user reviews,0,0,0
554108,True,0,No user reviews,0,0,0
554109,True,0,No user reviews,0,0,0
554110,True,0,No user reviews,0,0,0
554111,True,0,No user reviews,0,0,0
554112,True,0,No user reviews,0,0,0
554113,True,0,No user reviews,0,0,0
554114,True,0,No user reviews,0,0,0
554115,True,0,No user reviews,0,0,0
554116,True,0,No user reviews,0,0,0
554117,True,0,No user reviews,0,0,0
554118,True,0,No user reviews,0,0,0
554119,True,0,No user reviews,0,0,0
554120,True,0,No user reviews,0,0,0
554121,True,0,No user reviews,0,0,0
554122,True,0,No user reviews,0,0,0
554130,True,0,No user reviews,0,0,0
554140,True,0,3 user reviews,2,1,3
554150,True,7,Positive,31,3,34
554170,True,0,No user reviews,0,0,0
554171,True,0,No user reviews,0,0,0
554172,True,0,No user reviews,0,0,0
554173,True,0,No user reviews,0,0,0
554174,True,0,No user reviews,0,0,0
554175,True,0,No user reviews,0,0,0
554176,True,0,No user reviews,0,0,0
554177,True,0,No user reviews,0,0,0
554178,True,0,No user reviews,0,0,0
554179,True,0,No user reviews,0,0,0
554180,True,7,Positive,20,5,25
554200,True,0,No user reviews,0,0,0
554220,True,7,Positive,33,7,40
554260,True,0,No user reviews,0,0,0
554270,True,0,No user reviews,0,0,0
554271,True,0,No user reviews,0,0,0
554272,True,0,1 user reviews,0,1,1
554273,True,0,No user reviews,0,0,0
554280,True,7,Positive,27,5,32
554290,True,7,Positive,34,3,37
554310,True,6,Mostly Positive,105,27,132
554320,True,0,2 user reviews,2,0,2
554321,True,0,2 user reviews,2,0,2
554330,True,7,Positive,22,2,24
554340,True,0,No user reviews,0,0,0
554350,True,0,No user reviews,0,0,0
554360,True,0,No user reviews,0,0,0
554370,True,0,No user reviews,0,0,0
554371,True,0,No user reviews,0,0,0
554380,True,8,Very Positive,127,25,152
554381,True,6,Mostly Positive,223,63,286
554390,True,7,Positive,17,0,17
554470,True,7,Positive,19,2,21
554480,True,0,No user reviews,0,0,0
554500,True,0,No user reviews,0,0,0
554530,True,7,Positive,24,6,30
554540,True,0,No user reviews,0,0,0
554550,True,0,6 user reviews,3,3,6
554560,True,0,3 user reviews,3,0,3
554570,True,5,Mixed,24,24,48
554590,True,0,2 user reviews,1,1,2
554600,True,8,Very Positive,184,14,198
554610,True,0,No user reviews,0,0,0
554620,True,8,Very Positive,9767,793,10560
554640,True,0,2 user reviews,0,2,2
554650,True,0,No user reviews,0,0,0
554660,True,0,3 user reviews,3,0,3
554680,True,0,9 user reviews,6,3,9
554690,True,0,1 user reviews,1,0,1
554700,True,0,8 user reviews,7,1,8
554710,True,0,No user reviews,0,0,0
554720,True,0,No user reviews,0,0,0
554750,True,5,Mixed,65,46,111
554770,True,0,1 user reviews,0,1,1
554780,True,0,No user reviews,0,0,0
554790,True,5,Mixed,7,7,14
554791,True,5,Mixed,30,23,53
554800,True,7,Positive,26,6,32
554810,True,8,Very Positive,51,12,63
554820,True,6,Mostly Positive,18,5,23
554840,True,0,No user reviews,0,0,0
554850,True,0,No user reviews,0,0,0
554870,True,7,Positive,17,2,19
554920,True,0,1 user reviews,1,0,1
554940,True,0,4 user reviews,3,1,4
554950,True,7,Positive,21,1,22
554960,True,0,No user reviews,0,0,0
554980,True,0,4 user reviews,3,1,4
555000,True,8,Very Positive,226,22,248
555010,True,5,Mixed,28,13,41
555020,True,0,1 user reviews,1,0,1
555030,True,0,No user reviews,0,0,0
555040,True,0,No user reviews,0,0,0
555050,True,6,Mostly Positive,81,22,103
555060,True,6,Mostly Positive,41,11,52
555070,True,0,No user reviews,0,0,0
555080,True,0,No user reviews,0,0,0
555090,True,0,No user reviews,0,0,0
555100,True,0,2 user reviews,1,1,2
555110,True,0,No user reviews,0,0,0
555120,True,0,9 user reviews,9,0,9
555130,True,0,2 user reviews,0,2,2
555150,True,6,Mostly Positive,1043,287,1330
555160,True,8,Very Positive,12369,739,13108
555170,True,0,6 user reviews,4,2,6
555180,True,5,Mixed,15,14,29
555210,True,8,Very Positive,290,50,340
555220,True,9,Overwhelmingly Positive,1559,62,1621
555230,True,0,1 user reviews,0,1,1
555250,True,0,No user reviews,0,0,0
555260,True,4,Mostly Negative,3,8,11
555270,True,0,No user reviews,0,0,0
555280,True,5,Mixed,7,4,11
555290,True,8,Very Positive,53,13,66
555300,True,5,Mixed,19,11,30
555310,True,6,Mostly Positive,11,3,14
555320,True,6,Mostly Positive,39,12,51
555340,True,0,2 user reviews,2,0,2
555360,True,0,1 user reviews,1,0,1
555370,True,0,5 user reviews,2,3,5
555380,True,0,No user reviews,0,0,0
555400,True,8,Very Positive,105,26,131
555410,True,0,4 user reviews,3,1,4
555420,True,0,No user reviews,0,0,0
555440,True,6,Mostly Positive,2321,716,3037
555450,True,4,Mostly Negative,14,43,57
555500,True,0,No user reviews,0,0,0
555510,True,5,Mixed,147,111,258
555520,True,0,4 user reviews,4,0,4
555530,True,0,5 user reviews,3,2,5
555531,True,5,Mixed,11,5,16
555532,True,0,3 user reviews,1,2,3
555540,True,0,No user reviews,0,0,0
555550,True,0,No user reviews,0,0,0
555570,True,5,Mixed,389,515,904
555580,True,7,Positive,20,0,20
555590,True,0,No user reviews,0,0,0
555600,True,7,Positive,19,1,20
555610,True,6,Mostly Positive,20,8,28
555630,True,7,Positive,33,2,35
555640,True,8,Very Positive,47,3,50
555650,True,5,Mixed,12,9,21
555660,True,4,Mostly Negative,24,39,63
555670,True,0,8 user reviews,0,8,8
555680,True,0,No user reviews,0,0,0
555710,True,6,Mostly Positive,44,13,57
555720,True,0,7 user reviews,6,1,7
555730,True,7,Positive,8,2,10
555740,True,0,No user reviews,0,0,0
555750,True,5,Mixed,111,65,176
555760,True,0,4 user reviews,2,2,4
555770,True,0,1 user reviews,1,0,1
555790,True,0,No user reviews,0,0,0
555810,True,0,1 user reviews,1,0,1
555820,True,0,5 user reviews,0,5,5
555830,True,0,No user reviews,0,0,0
555840,True,0,No user reviews,0,0,0
555850,True,0,4 user reviews,1,3,4
555861,True,0,No user reviews,0,0,0
555865,True,0,No user reviews,0,0,0
555880,True,8,Very Positive,924,124,1048
555890,True,0,5 user reviews,4,1,5
555910,True,0,No user reviews,0,0,0
555920,True,3,Negative,1,16,17
555930,True,0,4 user reviews,2,2,4
555950,True,8,Very Positive,909,98,1007
555960,True,0,No user reviews,0,0,0
555970,True,7,Positive,17,1,18
556000,True,0,4 user reviews,0,4,4
556030,True,0,No user reviews,0,0,0
556050,True,8,Very Positive,136,8,144
556060,True,7,Positive,16,4,20
556090,True,0,No user reviews,0,0,0
556100,True,0,No user reviews,0,0,0
556130,True,0,2 user reviews,2,0,2
556140,True,7,Positive,23,3,26
556150,True,0,1 user reviews,1,0,1
556160,True,0,No user reviews,0,0,0
556170,True,0,1 user reviews,1,0,1
556180,True,6,Mostly Positive,106,33,139
556190,True,6,Mostly Positive,14,4,18
556200,True,0,1 user reviews,0,1,1
556210,True,6,Mostly Positive,9,3,12
556212,True,5,Mixed,60,37,97
556213,True,5,Mixed,24,17,41
556214,True,0,5 user reviews,4,1,5
556217,True,0,9 user reviews,2,7,9
556218,True,0,3 user reviews,3,0,3
556219,True,0,6 user reviews,0,6,6
556220,True,0,2 user reviews,2,0,2
556221,True,5,Mixed,27,22,49
556222,True,5,Mixed,26,17,43
556223,True,0,4 user reviews,4,0,4
556224,True,0,3 user reviews,0,3,3
556225,True,0,4 user reviews,1,3,4
556226,True,0,5 user reviews,1,4,5
556229,True,0,3 user reviews,3,0,3
556230,True,5,Mixed,35,19,54
556240,True,8,Very Positive,140,25,165
556250,True,0,4 user reviews,4,0,4
556260,True,0,6 user reviews,4,2,6
556270,True,0,No user reviews,0,0,0
556280,True,6,Mostly Positive,44,18,62
556290,True,0,No user reviews,0,0,0
556300,True,3,Negative,0,11,11
556310,True,0,2 user reviews,2,0,2
556340,True,8,Very Positive,87,21,108
556350,True,0,1 user reviews,1,0,1
556352,True,0,No user reviews,0,0,0
556390,True,0,2 user reviews,1,1,2
556391,True,4,Mostly Negative,10,31,41
556392,True,5,Mixed,13,6,19
556400,True,0,No user reviews,0,0,0
556401,True,0,No user reviews,0,0,0
556402,True,0,No user reviews,0,0,0
556403,True,0,No user reviews,0,0,0
556404,True,0,No user reviews,0,0,0
556405,True,0,No user reviews,0,0,0
556406,True,0,No user reviews,0,0,0
556407,True,0,No user reviews,0,0,0
556408,True,0,No user reviews,0,0,0
556409,True,0,No user reviews,0,0,0
556410,True,0,No user reviews,0,0,0
556411,True,0,No user reviews,0,0,0
556412,True,0,No user reviews,0,0,0
556413,True,0,No user reviews,0,0,0
556420,True,0,No user reviews,0,0,0
556430,True,0,No user reviews,0,0,0
556450,True,0,No user reviews,0,0,0
556460,True,0,No user reviews,0,0,0
556470,True,6,Mostly Positive,105,32,137
556480,True,5,Mixed,37,31,68
556490,True,0,No user reviews,0,0,0
556500,True,0,2 user reviews,2,0,2
556520,True,5,Mixed,6,4,10
556530,True,6,Mostly Positive,9,3,12
556540,True,0,7 user reviews,5,2,7
556550,True,5,Mixed,33,32,65
556560,True,0,No user reviews,0,0,0
556570,True,0,4 user reviews,4,0,4
556600,True,0,No user reviews,0,0,0
556610,True,0,No user reviews,0,0,0
556640,True,6,Mostly Positive,119,33,152
556650,True,0,9 user reviews,9,0,9
556660,True,0,No user reviews,0,0,0
556670,True,0,1 user reviews,0,1,1
556680,True,0,5 user reviews,1,4,5
556690,True,0,No user reviews,0,0,0
556700,True,0,5 user reviews,2,3,5
556710,True,5,Mixed,10,5,15
556720,True,0,No user reviews,0,0,0
556740,True,6,Mostly Positive,106,39,145
556750,True,0,1 user reviews,1,0,1
556760,True,0,8 user reviews,7,1,8
556770,True,0,7 user reviews,2,5,7
556780,True,5,Mixed,17,9,26
556800,True,0,No user reviews,0,0,0
556810,True,0,1 user reviews,1,0,1
556820,True,5,Mixed,224,140,364
556830,True,0,4 user reviews,4,0,4
556840,True,0,9 user reviews,3,6,9
556850,True,0,1 user reviews,0,1,1
556860,True,6,Mostly Positive,81,31,112
556870,True,5,Mixed,37,22,59
556880,True,7,Positive,11,1,12
556890,True,7,Positive,28,6,34
556900,True,7,Positive,15,1,16
556920,True,5,Mixed,7,4,11
556930,True,0,No user reviews,0,0,0
556950,True,0,No user reviews,0,0,0
556960,True,7,Positive,11,0,11
556970,True,8,Very Positive,352,63,415
556990,True,0,5 user reviews,4,1,5
557000,True,0,5 user reviews,5,0,5
557001,True,0,1 user reviews,1,0,1
557003,True,0,No user reviews,0,0,0
557020,True,0,1 user reviews,1,0,1
557030,True,4,Mostly Negative,5,8,13
557040,True,5,Mixed,33,22,55
557070,True,0,No user reviews,0,0,0
557080,True,0,No user reviews,0,0,0
557081,True,0,No user reviews,0,0,0
557082,True,0,No user reviews,0,0,0
557083,True,0,No user reviews,0,0,0
557084,True,0,No user reviews,0,0,0
557085,True,0,No user reviews,0,0,0
557086,True,0,No user reviews,0,0,0
557087,True,0,No user reviews,0,0,0
557090,True,0,No user reviews,0,0,0
557120,True,0,No user reviews,0,0,0
557121,True,0,No user reviews,0,0,0
557122,True,0,No user reviews,0,0,0
557123,True,0,No user reviews,0,0,0
557124,True,0,No user reviews,0,0,0
557125,True,0,No user reviews,0,0,0
557140,True,0,No user reviews,0,0,0
557150,True,0,No user reviews,0,0,0
557180,True,0,No user reviews,0,0,0
557190,True,0,7 user reviews,4,3,7
557200,True,0,No user reviews,0,0,0
557210,True,0,No user reviews,0,0,0
557220,True,0,No user reviews,0,0,0
557230,True,0,No user reviews,0,0,0
557240,True,7,Positive,9,2,11
557250,True,0,No user reviews,0,0,0
557260,True,4,Mostly Negative,4,14,18
557280,True,6,Mostly Positive,10,3,13
557290,True,0,1 user reviews,1,0,1
557300,True,0,1 user reviews,0,1,1
557320,True,0,No user reviews,0,0,0
557330,True,7,Positive,19,4,23
557340,True,9,Overwhelmingly Positive,8474,380,8854
557350,True,0,5 user reviews,1,4,5
557380,True,0,6 user reviews,5,1,6
557390,True,0,3 user reviews,2,1,3
557400,True,8,Very Positive,141,24,165
557410,True,8,Very Positive,114,20,134
557420,True,0,3 user reviews,2,1,3
557450,True,0,No user reviews,0,0,0
557460,True,0,5 user reviews,4,1,5
557470,True,0,No user reviews,0,0,0
557520,True,5,Mixed,53,36,89
557540,True,0,No user reviews,0,0,0
557560,True,0,No user reviews,0,0,0
557570,True,7,Positive,17,0,17
557580,True,6,Mostly Positive,17,6,23
557600,True,9,Overwhelmingly Positive,2113,100,2213
557630,True,8,Very Positive,128,1,129
557640,True,0,No user reviews,0,0,0
557670,True,0,No user reviews,0,0,0
557680,True,5,Mixed,8,6,14
557690,True,0,No user reviews,0,0,0
557700,True,5,Mixed,9,5,14
557710,True,0,No user reviews,0,0,0
557720,True,0,5 user reviews,4,1,5
557730,True,7,Positive,10,1,11
557750,True,7,Positive,43,2,45
557760,True,0,1 user reviews,1,0,1
557770,True,0,5 user reviews,2,3,5
557780,True,0,7 user reviews,5,2,7
557790,True,0,3 user reviews,3,0,3
557800,True,0,1 user reviews,1,0,1
557810,True,5,Mixed,8,12,20
557830,True,0,9 user reviews,6,3,9
557840,True,0,No user reviews,0,0,0
557850,True,7,Positive,10,1,11
557860,True,7,Positive,11,1,12
557880,True,0,4 user reviews,1,3,4
557890,True,0,3 user reviews,3,0,3
557900,True,5,Mixed,20,9,29
557910,True,0,No user reviews,0,0,0
557940,True,0,3 user reviews,2,1,3
557960,True,0,5 user reviews,3,2,5
557970,True,0,5 user reviews,5,0,5
557980,True,0,2 user reviews,2,0,2
558000,True,0,3 user reviews,2,1,3
558010,True,0,No user reviews,0,0,0
558050,True,0,3 user reviews,1,2,3
558060,True,0,3 user reviews,1,2,3
558080,True,0,6 user reviews,6,0,6
558100,True,8,Very Positive,245,17,262
558110,True,6,Mostly Positive,96,29,125
558120,True,0,No user reviews,0,0,0
558130,True,0,6 user reviews,4,2,6
558140,True,0,No user reviews,0,0,0
558150,True,0,No user reviews,0,0,0
558160,True,0,1 user reviews,1,0,1
558190,True,0,3 user reviews,3,0,3
558200,True,0,2 user reviews,1,1,2
558210,True,0,1 user reviews,0,1,1
558220,True,0,No user reviews,0,0,0
558230,True,0,No user reviews,0,0,0
558241,True,7,Positive,40,4,44
558242,True,7,Positive,23,3,26
558243,True,7,Positive,15,0,15
558244,True,8,Very Positive,290,24,314
558245,True,8,Very Positive,417,65,482
558260,True,6,Mostly Positive,110,46,156
558280,True,0,No user reviews,0,0,0
558290,True,0,2 user reviews,2,0,2
558300,True,0,3 user reviews,2,1,3
558301,True,0,1 user reviews,1,0,1
558302,True,0,1 user reviews,1,0,1
558310,True,0,No user reviews,0,0,0
558320,True,7,Positive,13,3,16
558340,True,5,Mixed,9,6,15
558370,True,6,Mostly Positive,16,6,22
558390,True,0,6 user reviews,1,5,6
558391,True,0,4 user reviews,2,2,4
558410,True,6,Mostly Positive,15,4,19
558420,True,8,Very Positive,1797,271,2068
558430,True,0,No user reviews,0,0,0
558440,True,0,2 user reviews,2,0,2
558450,True,8,Very Positive,69,12,81
558460,True,0,No user reviews,0,0,0
558480,True,4,Mostly Negative,3,7,10
558490,True,5,Mixed,16,12,28
558500,True,0,No user reviews,0,0,0
558510,True,0,No user reviews,0,0,0
558511,True,0,No user reviews,0,0,0
558512,True,0,No user reviews,0,0,0
558513,True,0,No user reviews,0,0,0
558514,True,0,No user reviews,0,0,0
558540,True,0,No user reviews,0,0,0
558630,True,0,No user reviews,0,0,0
558640,True,0,3 user reviews,3,0,3
558641,True,0,2 user reviews,2,0,2
558650,True,0,1 user reviews,0,1,1
558660,True,6,Mostly Positive,22,7,29
558670,True,0,5 user reviews,5,0,5
558680,True,0,No user reviews,0,0,0
558690,True,0,No user reviews,0,0,0
558710,True,0,No user reviews,0,0,0
558720,True,0,2 user reviews,1,1,2
558740,True,0,5 user reviews,1,4,5
558750,True,0,5 user reviews,5,0,5
558760,True,0,6 user reviews,3,3,6
558761,True,0,3 user reviews,1,2,3
558762,True,0,9 user reviews,6,3,9
558770,True,0,No user reviews,0,0,0
558780,True,6,Mostly Positive,36,10,46
558790,True,7,Positive,38,0,38
558830,True,0,No user reviews,0,0,0
558831,True,0,No user reviews,0,0,0
558832,True,0,No user reviews,0,0,0
558833,True,0,No user reviews,0,0,0
558834,True,0,No user reviews,0,0,0
558835,True,0,No user reviews,0,0,0
558836,True,0,No user reviews,0,0,0
558840,True,0,No user reviews,0,0,0
558850,True,5,Mixed,15,7,22
558870,True,4,Mostly Negative,16,46,62
558880,True,0,No user reviews,0,0,0
558910,True,0,1 user reviews,1,0,1
558911,True,0,No user reviews,0,0,0
558912,True,0,No user reviews,0,0,0
558913,True,0,No user reviews,0,0,0
558914,True,0,No user reviews,0,0,0
558915,True,0,No user reviews,0,0,0
558916,True,0,No user reviews,0,0,0
558917,True,0,No user reviews,0,0,0
558918,True,0,No user reviews,0,0,0
558919,True,0,No user reviews,0,0,0
558920,True,0,No user reviews,0,0,0
558921,True,0,No user reviews,0,0,0
558922,True,0,No user reviews,0,0,0
558923,True,0,No user reviews,0,0,0
558924,True,0,No user reviews,0,0,0
558925,True,0,No user reviews,0,0,0
558926,True,0,No user reviews,0,0,0
558927,True,0,No user reviews,0,0,0
558928,True,0,No user reviews,0,0,0
558929,True,0,No user reviews,0,0,0
558970,True,0,No user reviews,0,0,0
558980,True,0,No user reviews,0,0,0
558990,True,9,Overwhelmingly Positive,1560,44,1604
559010,True,7,Positive,13,0,13
559030,True,0,3 user reviews,2,1,3
559040,True,0,8 user reviews,5,3,8
559070,True,7,Positive,18,3,21
559100,True,6,Mostly Positive,974,310,1284
559130,True,5,Mixed,11,11,22
559140,True,0,4 user reviews,2,2,4
559150,True,0,2 user reviews,2,0,2
559170,True,0,No user reviews,0,0,0
559200,True,0,2 user reviews,0,2,2
559210,True,9,Overwhelmingly Positive,1855,34,1889
559250,True,0,3 user reviews,3,0,3
559260,True,6,Mostly Positive,64,22,86
559280,True,0,3 user reviews,2,1,3
559300,True,0,No user reviews,0,0,0
559310,True,5,Mixed,60,33,93
559330,True,8,Very Positive,306,13,319
559340,True,5,Mixed,55,64,119
559350,True,0,8 user reviews,6,2,8
559360,True,0,No user reviews,0,0,0
559390,True,0,No user reviews,0,0,0
559391,True,0,No user reviews,0,0,0
559430,True,7,Positive,16,2,18
559440,True,0,No user reviews,0,0,0
559450,True,0,2 user reviews,0,2,2
559470,True,0,1 user reviews,1,0,1
559480,True,0,No user reviews,0,0,0
559510,True,0,No user reviews,0,0,0
559520,True,0,No user reviews,0,0,0
559530,True,0,No user reviews,0,0,0
559540,True,0,No user reviews,0,0,0
559550,True,0,No user reviews,0,0,0
559560,True,0,No user reviews,0,0,0
559570,True,0,No user reviews,0,0,0
559580,True,0,No user reviews,0,0,0
559590,True,0,1 user reviews,1,0,1
559610,True,8,Very Positive,530,40,570
559620,True,8,Very Positive,134,7,141
559630,True,0,3 user reviews,2,1,3
559640,True,7,Positive,36,7,43
559650,True,8,Very Positive,1078,90,1168
559670,True,0,4 user reviews,4,0,4
559680,True,8,Very Positive,198,35,233
559690,True,0,No user reviews,0,0,0
559700,True,0,No user reviews,0,0,0
559780,True,0,No user reviews,0,0,0
559790,True,0,No user reviews,0,0,0
559800,True,0,No user reviews,0,0,0
559840,True,7,Positive,14,1,15
559850,True,7,Positive,13,1,14
559860,True,0,No user reviews,0,0,0
559870,True,6,Mostly Positive,47,16,63
559880,True,0,No user reviews,0,0,0
559890,True,0,1 user reviews,1,0,1
559900,True,4,Mostly Negative,5,12,17
559910,True,6,Mostly Positive,123,50,173
559920,True,0,2 user reviews,0,2,2
559930,True,0,9 user reviews,9,0,9
559950,True,0,3 user reviews,3,0,3
559960,True,8,Very Positive,49,9,58
559970,True,0,2 user reviews,2,0,2
559990,True,0,1 user reviews,1,0,1
560000,True,8,Very Positive,111,7,118
560010,True,0,7 user reviews,4,3,7
560040,True,0,1 user reviews,1,0,1
560050,True,7,Positive,40,3,43
560080,True,0,9 user reviews,6,3,9
560090,True,0,No user reviews,0,0,0
560100,True,0,1 user reviews,1,0,1
560101,True,0,No user reviews,0,0,0
560102,True,0,No user reviews,0,0,0
560110,True,0,No user reviews,0,0,0
560130,True,8,Very Positive,3545,568,4113
560140,True,0,No user reviews,0,0,0
560150,True,6,Mostly Positive,11,4,15
560170,True,6,Mostly Positive,190,79,269
560180,True,0,5 user reviews,5,0,5
560200,True,0,6 user reviews,4,2,6
560220,True,7,Positive,9,1,10
560230,True,0,4 user reviews,1,3,4
560240,True,0,No user reviews,0,0,0
560250,True,5,Mixed,40,19,59
560260,True,8,Very Positive,274,48,322
560300,True,7,Positive,33,2,35
560340,True,0,3 user reviews,1,2,3
560350,True,5,Mixed,18,12,30
560360,True,0,No user reviews,0,0,0
560370,True,5,Mixed,89,43,132
560390,True,0,No user reviews,0,0,0
560400,True,0,1 user reviews,1,0,1
560410,True,5,Mixed,8,4,12
560430,True,8,Very Positive,184,18,202
560450,True,0,No user reviews,0,0,0
560490,True,0,No user reviews,0,0,0
560500,True,0,No user reviews,0,0,0
560510,True,0,9 user reviews,7,2,9
560520,True,0,No user reviews,0,0,0
560550,True,7,Positive,16,1,17
560570,True,0,2 user reviews,0,2,2
560580,True,0,No user reviews,0,0,0
560581,True,0,1 user reviews,1,0,1
560582,True,0,No user reviews,0,0,0
560590,True,0,No user reviews,0,0,0
560600,True,0,6 user reviews,6,0,6
560610,True,0,No user reviews,0,0,0
560630,True,0,No user reviews,0,0,0
560640,True,5,Mixed,35,21,56
560660,True,0,No user reviews,0,0,0
560670,True,0,No user reviews,0,0,0
560680,True,0,No user reviews,0,0,0
560690,True,0,No user reviews,0,0,0
560691,True,0,No user reviews,0,0,0
560700,True,0,No user reviews,0,0,0
560710,True,0,6 user reviews,5,1,6
560720,True,7,Positive,32,7,39
560730,True,5,Mixed,8,11,19
560740,True,6,Mostly Positive,13,5,18
560750,True,5,Mixed,11,8,19
560760,True,5,Mixed,10,10,20
560770,True,0,2 user reviews,2,0,2
560780,True,0,No user reviews,0,0,0
560790,True,0,No user reviews,0,0,0
560800,True,0,No user reviews,0,0,0
560820,True,0,9 user reviews,5,4,9
560870,True,0,4 user reviews,2,2,4
560900,True,0,No user reviews,0,0,0
560920,True,0,No user reviews,0,0,0
560930,True,0,1 user reviews,0,1,1
560940,True,7,Positive,12,3,15
560941,True,5,Mixed,8,4,12
560960,True,0,2 user reviews,1,1,2
560970,True,0,2 user reviews,2,0,2
560980,True,0,No user reviews,0,0,0
560990,True,0,3 user reviews,3,0,3
561000,True,7,Positive,25,3,28
561010,True,0,9 user reviews,6,3,9
561030,True,0,2 user reviews,2,0,2
561040,True,7,Positive,12,0,12
561050,True,0,1 user reviews,0,1,1
561060,True,0,1 user reviews,0,1,1
561080,True,7,Positive,39,2,41
561100,True,0,7 user reviews,4,3,7
561110,True,0,1 user reviews,1,0,1
561120,True,5,Mixed,20,14,34
561130,True,0,No user reviews,0,0,0
561140,True,0,7 user reviews,3,4,7
561150,True,7,Positive,10,0,10
561190,True,7,Positive,27,2,29
561200,True,0,No user reviews,0,0,0
561201,True,0,No user reviews,0,0,0
561202,True,0,No user reviews,0,0,0
561203,True,0,No user reviews,0,0,0
561204,True,0,No user reviews,0,0,0
561205,True,0,No user reviews,0,0,0
561206,True,0,No user reviews,0,0,0
561230,True,5,Mixed,11,7,18
561240,True,0,No user reviews,0,0,0
561260,True,7,Positive,14,1,15
561290,True,0,No user reviews,0,0,0
561310,True,0,No user reviews,0,0,0
561330,True,0,No user reviews,0,0,0
561340,True,0,3 user reviews,2,1,3
561350,True,0,No user reviews,0,0,0
561360,True,7,Positive,14,3,17
561390,True,0,1 user reviews,1,0,1
561400,True,7,Positive,9,2,11
561420,True,5,Mixed,5,5,10
561440,True,0,4 user reviews,4,0,4
561450,True,0,5 user reviews,3,2,5
561460,True,0,No user reviews,0,0,0
561470,True,8,Very Positive,59,3,62
561480,True,7,Positive,24,3,27
561490,True,0,7 user reviews,1,6,7
561510,True,0,3 user reviews,3,0,3
561527,True,0,4 user reviews,4,0,4
561530,True,0,No user reviews,0,0,0
561531,True,0,No user reviews,0,0,0
561532,True,0,No user reviews,0,0,0
561533,True,0,No user reviews,0,0,0
561534,True,0,No user reviews,0,0,0
561535,True,0,No user reviews,0,0,0
561536,True,0,No user reviews,0,0,0
561537,True,0,No user reviews,0,0,0
561538,True,0,No user reviews,0,0,0
561539,True,0,No user reviews,0,0,0
561540,True,0,No user reviews,0,0,0
561541,True,0,No user reviews,0,0,0
561542,True,0,No user reviews,0,0,0
561543,True,0,No user reviews,0,0,0
561544,True,0,No user reviews,0,0,0
561545,True,0,No user reviews,0,0,0
561546,True,0,No user reviews,0,0,0
561547,True,0,No user reviews,0,0,0
561548,True,0,No user reviews,0,0,0
561549,True,0,1 user reviews,1,0,1
561550,True,0,No user reviews,0,0,0
561551,True,0,No user reviews,0,0,0
561552,True,0,No user reviews,0,0,0
561553,True,0,No user reviews,0,0,0
561554,True,0,No user reviews,0,0,0
561555,True,0,No user reviews,0,0,0
561556,True,0,No user reviews,0,0,0
561557,True,0,No user reviews,0,0,0
561558,True,0,No user reviews,0,0,0
561559,True,0,No user reviews,0,0,0
561560,True,0,No user reviews,0,0,0
561561,True,0,No user reviews,0,0,0
561566,True,0,No user reviews,0,0,0
561567,True,0,No user reviews,0,0,0
561580,True,0,No user reviews,0,0,0
561590,True,5,Mixed,15,12,27
561600,True,8,Very Positive,163,37,200
561610,True,5,Mixed,84,37,121
561630,True,4,Mostly Negative,31,71,102
561631,True,4,Mostly Negative,15,33,48
561650,True,4,Mostly Negative,65,128,193
561660,True,0,No user reviews,0,0,0
561680,True,7,Positive,15,0,15
561690,True,0,1 user reviews,0,1,1
561710,True,0,No user reviews,0,0,0
561720,True,0,No user reviews,0,0,0
561730,True,6,Mostly Positive,38,10,48
561740,True,8,Very Positive,128,23,151
561770,True,6,Mostly Positive,76,31,107
561800,True,0,No user reviews,0,0,0
561811,True,0,No user reviews,0,0,0
561816,True,0,No user reviews,0,0,0
561820,True,0,No user reviews,0,0,0
561830,True,0,No user reviews,0,0,0
561860,True,0,No user reviews,0,0,0
561900,True,0,No user reviews,0,0,0
561920,True,0,No user reviews,0,0,0
561930,True,0,5 user reviews,5,0,5
561950,True,0,No user reviews,0,0,0
561970,True,0,3 user reviews,1,2,3
561990,True,0,No user reviews,0,0,0
562000,True,0,No user reviews,0,0,0
562010,True,0,2 user reviews,1,1,2
562040,True,0,No user reviews,0,0,0
562050,True,4,Mostly Negative,4,7,11
562060,True,0,No user reviews,0,0,0
562080,True,0,No user reviews,0,0,0
562090,True,0,No user reviews,0,0,0
562160,True,6,Mostly Positive,19,7,26
562170,True,0,No user reviews,0,0,0
562210,True,5,Mixed,9,6,15
562220,True,8,Very Positive,896,71,967
562230,True,8,Very Positive,343,49,392
562240,True,0,9 user reviews,2,7,9
562250,True,8,Very Positive,43,10,53
562260,True,7,Positive,14,1,15
562270,True,0,4 user reviews,2,2,4
562280,True,7,Positive,20,4,24
562290,True,0,9 user reviews,5,4,9
562310,True,0,3 user reviews,3,0,3
562320,True,6,Mostly Positive,25,8,33
562330,True,7,Positive,11,2,13
562340,True,4,Mostly Negative,14,26,40
562350,True,0,No user reviews,0,0,0
562360,True,8,Very Positive,258,33,291
562370,True,0,2 user reviews,0,2,2
562372,True,0,7 user reviews,2,5,7
562373,True,7,Positive,35,3,38
562374,True,0,3 user reviews,2,1,3
562375,True,5,Mixed,10,12,22
562376,True,5,Mixed,7,5,12
562378,True,5,Mixed,6,5,11
562379,True,7,Positive,11,2,13
562380,True,7,Positive,9,1,10
562381,True,7,Positive,22,4,26
562382,True,0,9 user reviews,8,1,9
562384,True,0,8 user reviews,3,5,8
562385,True,0,1 user reviews,1,0,1
562386,True,7,Positive,13,1,14
562387,True,0,1 user reviews,1,0,1
562388,True,0,2 user reviews,2,0,2
562389,True,0,8 user reviews,7,1,8
562390,True,0,2 user reviews,2,0,2
562391,True,0,2 user reviews,0,2,2
562392,True,0,No user reviews,0,0,0
562393,True,0,No user reviews,0,0,0
562394,True,0,No user reviews,0,0,0
562395,True,0,No user reviews,0,0,0
562397,True,0,1 user reviews,1,0,1
562398,True,0,8 user reviews,8,0,8
562399,True,6,Mostly Positive,30,8,38
562410,True,8,Very Positive,189,12,201
562420,True,5,Mixed,34,24,58
562430,True,0,4 user reviews,3,1,4
562450,True,0,6 user reviews,2,4,6
562460,True,0,5 user reviews,5,0,5
562470,True,6,Mostly Positive,23,8,31
562480,True,7,Positive,24,1,25
562490,True,5,Mixed,6,4,10
562500,True,8,Very Positive,472,72,544
562510,True,0,9 user reviews,6,3,9
562520,True,0,2 user reviews,1,1,2
562540,True,5,Mixed,7,5,12
562560,True,0,No user reviews,0,0,0
562570,True,6,Mostly Positive,65,26,91
562590,True,5,Mixed,211,100,311
562600,True,0,2 user reviews,1,1,2
562630,True,0,1 user reviews,1,0,1
562640,True,5,Mixed,10,5,15
562660,True,0,3 user reviews,1,2,3
562680,True,0,4 user reviews,3,1,4
562690,True,0,7 user reviews,5,2,7
562700,True,4,Mostly Negative,11,19,30
562720,True,0,No user reviews,0,0,0
562730,True,6,Mostly Positive,11,3,14
562740,True,0,5 user reviews,4,1,5
562750,True,0,No user reviews,0,0,0
562780,True,0,No user reviews,0,0,0
562790,True,0,No user reviews,0,0,0
562800,True,5,Mixed,8,9,17
562810,True,5,Mixed,1220,1558,2778
562820,True,0,No user reviews,0,0,0
562840,True,5,Mixed,14,12,26
562860,True,9,Overwhelmingly Positive,2323,105,2428
562870,True,0,1 user reviews,1,0,1
562890,True,0,1 user reviews,1,0,1
562891,True,0,1 user reviews,1,0,1
563100,True,0,No user reviews,0,0,0
563101,True,0,No user reviews,0,0,0
563102,True,0,1 user reviews,1,0,1
563103,True,0,3 user reviews,3,0,3
563104,True,0,No user reviews,0,0,0
563105,True,0,1 user reviews,1,0,1
563106,True,0,4 user reviews,4,0,4
563107,True,0,3 user reviews,3,0,3
563110,True,0,No user reviews,0,0,0
563120,True,5,Mixed,17,13,30
563130,True,0,8 user reviews,7,1,8
563150,True,5,Mixed,8,5,13
563160,True,0,2 user reviews,0,2,2
563170,True,0,4 user reviews,4,0,4
563180,True,7,Positive,26,1,27
563190,True,7,Positive,36,4,40
563200,True,8,Very Positive,63,15,78
563210,True,4,Mostly Negative,4,7,11
563250,True,0,5 user reviews,4,1,5
563260,True,7,Positive,21,1,22
563270,True,6,Mostly Positive,9,3,12
563290,True,0,No user reviews,0,0,0
563300,True,0,2 user reviews,2,0,2
563320,True,4,Mostly Negative,12,21,33
563330,True,5,Mixed,10,9,19
563340,True,5,Mixed,14,20,34
563360,True,5,Mixed,52,30,82
563370,True,0,2 user reviews,2,0,2
563380,True,0,3 user reviews,3,0,3
563390,True,7,Positive,9,2,11
563400,True,0,1 user reviews,0,1,1
563410,True,0,8 user reviews,8,0,8
563420,True,5,Mixed,5,7,12
563430,True,0,3 user reviews,3,0,3
563440,True,0,No user reviews,0,0,0
563470,True,0,No user reviews,0,0,0
563490,True,3,Negative,2,12,14
563500,True,0,6 user reviews,3,3,6
563520,True,0,5 user reviews,5,0,5
563530,True,0,No user reviews,0,0,0
563550,True,7,Positive,39,9,48
563560,True,0,No user reviews,0,0,0
563590,True,0,No user reviews,0,0,0
563600,True,0,No user reviews,0,0,0
563610,True,0,2 user reviews,1,1,2
563630,True,0,No user reviews,0,0,0
563640,True,0,No user reviews,0,0,0
563650,True,0,No user reviews,0,0,0
563670,True,0,No user reviews,0,0,0
563680,True,0,9 user reviews,3,6,9
563690,True,0,No user reviews,0,0,0
563710,True,7,Positive,9,2,11
563720,True,0,No user reviews,0,0,0
563730,True,0,No user reviews,0,0,0
563740,True,0,3 user reviews,3,0,3
563750,True,5,Mixed,65,40,105
563760,True,5,Mixed,13,15,28
563770,True,0,No user reviews,0,0,0
563780,True,0,3 user reviews,3,0,3
563790,True,0,1 user reviews,1,0,1
563810,True,7,Positive,33,2,35
563830,True,7,Positive,16,2,18
563840,True,8,Very Positive,889,116,1005
563850,True,0,No user reviews,0,0,0
563860,True,7,Positive,10,2,12
563880,True,0,1 user reviews,1,0,1
563890,True,0,8 user reviews,7,1,8
563900,True,0,No user reviews,0,0,0
563910,True,0,2 user reviews,1,1,2
563920,True,0,No user reviews,0,0,0
563950,True,0,No user reviews,0,0,0
563980,True,0,No user reviews,0,0,0
563990,True,0,No user reviews,0,0,0
564010,True,4,Mostly Negative,6,12,18
564030,True,0,5 user reviews,4,1,5
564040,True,7,Positive,11,2,13
564050,True,8,Very Positive,150,25,175
564060,True,0,1 user reviews,0,1,1
564070,True,5,Mixed,5,5,10
564080,True,0,6 user reviews,6,0,6
564090,True,0,1 user reviews,1,0,1
564100,True,0,1 user reviews,1,0,1
564140,True,0,1 user reviews,0,1,1
564150,True,5,Mixed,100,44,144
564160,True,7,Positive,32,5,37
564170,True,0,5 user reviews,5,0,5
564180,True,7,Positive,15,0,15
564190,True,8,Very Positive,48,4,52
564200,True,0,No user reviews,0,0,0
564210,True,6,Mostly Positive,8,3,11
564230,True,8,Very Positive,1429,154,1583
564240,True,0,No user reviews,0,0,0
564250,True,0,3 user reviews,2,1,3
564251,True,0,6 user reviews,1,5,6
564260,True,0,1 user reviews,1,0,1
564270,True,0,No user reviews,0,0,0
564280,True,0,4 user reviews,3,1,4
564290,True,0,2 user reviews,1,1,2
564300,True,0,8 user reviews,7,1,8
564310,True,8,Very Positive,876,69,945
564320,True,0,No user reviews,0,0,0
564321,True,0,No user reviews,0,0,0
564322,True,0,No user reviews,0,0,0
564323,True,0,No user reviews,0,0,0
564324,True,0,No user reviews,0,0,0
564330,True,0,5 user reviews,5,0,5
564340,True,0,2 user reviews,0,2,2
564360,True,4,Mostly Negative,21,43,64
564380,True,0,No user reviews,0,0,0
564390,True,0,No user reviews,0,0,0
564400,True,0,1 user reviews,1,0,1
564420,True,0,5 user reviews,5,0,5
564440,True,0,2 user reviews,2,0,2
564450,True,0,2 user reviews,2,0,2
564470,True,6,Mostly Positive,26,7,33
564480,True,0,4 user reviews,4,0,4
564490,True,3,Negative,5,24,29
564520,True,0,9 user reviews,6,3,9
564530,True,8,Very Positive,593,75,668
564540,True,0,No user reviews,0,0,0
564550,True,0,No user reviews,0,0,0
564560,True,0,No user reviews,0,0,0
564561,True,0,No user reviews,0,0,0
564562,True,0,No user reviews,0,0,0
564563,True,0,No user reviews,0,0,0
564564,True,0,No user reviews,0,0,0
564565,True,0,No user reviews,0,0,0
564566,True,0,No user reviews,0,0,0
564567,True,0,No user reviews,0,0,0
564568,True,0,No user reviews,0,0,0
564569,True,0,No user reviews,0,0,0
564570,True,0,No user reviews,0,0,0
564571,True,0,No user reviews,0,0,0
564572,True,0,No user reviews,0,0,0
564573,True,0,No user reviews,0,0,0
564574,True,0,No user reviews,0,0,0
564575,True,0,No user reviews,0,0,0
564576,True,0,No user reviews,0,0,0
564577,True,0,No user reviews,0,0,0
564578,True,0,No user reviews,0,0,0
564579,True,0,No user reviews,0,0,0
564590,True,0,No user reviews,0,0,0
564591,True,0,No user reviews,0,0,0
564592,True,0,No user reviews,0,0,0
564593,True,0,No user reviews,0,0,0
564594,True,0,No user reviews,0,0,0
564595,True,0,No user reviews,0,0,0
564596,True,0,No user reviews,0,0,0
564597,True,0,No user reviews,0,0,0
564598,True,0,No user reviews,0,0,0
564599,True,0,No user reviews,0,0,0
564600,True,0,No user reviews,0,0,0
564601,True,0,No user reviews,0,0,0
564602,True,0,No user reviews,0,0,0
564603,True,0,No user reviews,0,0,0
564604,True,0,No user reviews,0,0,0
564605,True,0,No user reviews,0,0,0
564606,True,0,No user reviews,0,0,0
564607,True,0,No user reviews,0,0,0
564608,True,0,No user reviews,0,0,0
564609,True,0,No user reviews,0,0,0
564610,True,0,No user reviews,0,0,0
564620,True,0,No user reviews,0,0,0
564621,True,0,No user reviews,0,0,0
564622,True,0,No user reviews,0,0,0
564623,True,0,No user reviews,0,0,0
564624,True,0,No user reviews,0,0,0
564625,True,0,No user reviews,0,0,0
564626,True,0,No user reviews,0,0,0
564627,True,0,No user reviews,0,0,0
564628,True,0,No user reviews,0,0,0
564629,True,0,No user reviews,0,0,0
564630,True,0,No user reviews,0,0,0
564631,True,0,No user reviews,0,0,0
564632,True,0,No user reviews,0,0,0
564633,True,0,No user reviews,0,0,0
564634,True,0,No user reviews,0,0,0
564635,True,0,No user reviews,0,0,0
564636,True,0,No user reviews,0,0,0
564637,True,0,No user reviews,0,0,0
564638,True,0,No user reviews,0,0,0
564639,True,0,No user reviews,0,0,0
564640,True,0,No user reviews,0,0,0
564641,True,0,No user reviews,0,0,0
564650,True,0,No user reviews,0,0,0
564651,True,0,No user reviews,0,0,0
564652,True,0,No user reviews,0,0,0
564653,True,0,No user reviews,0,0,0
564654,True,0,No user reviews,0,0,0
564655,True,0,No user reviews,0,0,0
564656,True,0,No user reviews,0,0,0
564657,True,0,No user reviews,0,0,0
564658,True,0,No user reviews,0,0,0
564659,True,0,No user reviews,0,0,0
564660,True,0,No user reviews,0,0,0
564661,True,0,No user reviews,0,0,0
564662,True,0,No user reviews,0,0,0
564663,True,0,No user reviews,0,0,0
564664,True,0,No user reviews,0,0,0
564665,True,0,No user reviews,0,0,0
564670,True,0,1 user reviews,1,0,1
564680,True,0,7 user reviews,5,2,7
564681,True,0,2 user reviews,2,0,2
564690,True,0,No user reviews,0,0,0
564700,True,7,Positive,13,1,14
564710,True,8,Very Positive,479,33,512
564720,True,0,2 user reviews,0,2,2
564730,True,0,5 user reviews,3,2,5
564740,True,0,No user reviews,0,0,0
564750,True,0,8 user reviews,8,0,8
564770,True,0,No user reviews,0,0,0
564780,True,5,Mixed,16,12,28
564790,True,6,Mostly Positive,66,26,92
564791,True,6,Mostly Positive,41,12,53
564792,True,4,Mostly Negative,43,78,121
564793,True,4,Mostly Negative,7,15,22
564794,True,5,Mixed,19,20,39
564800,True,0,No user reviews,0,0,0
564810,True,7,Positive,22,0,22
564850,True,0,2 user reviews,2,0,2
564890,True,0,No user reviews,0,0,0
564900,True,4,Mostly Negative,5,17,22
564910,True,0,3 user reviews,2,1,3
564920,True,0,2 user reviews,1,1,2
564940,True,7,Positive,27,6,33
564950,True,5,Mixed,10,10,20
564960,True,5,Mixed,19,15,34
564980,True,0,1 user reviews,1,0,1
564990,True,0,2 user reviews,1,1,2
565000,True,0,3 user reviews,2,1,3
565001,True,0,6 user reviews,2,4,6
565002,True,0,2 user reviews,1,1,2
565020,True,0,No user reviews,0,0,0
565030,True,7,Positive,16,2,18
565040,True,6,Mostly Positive,17,6,23
565050,True,0,4 user reviews,3,1,4
565060,True,0,No user reviews,0,0,0
565070,True,0,No user reviews,0,0,0
565080,True,0,No user reviews,0,0,0
565090,True,0,No user reviews,0,0,0
565100,True,0,2 user reviews,2,0,2
565110,True,0,3 user reviews,3,0,3
565120,True,8,Very Positive,309,66,375
565140,True,0,4 user reviews,4,0,4
565170,True,6,Mostly Positive,71,19,90
565180,True,7,Positive,23,1,24
565190,True,7,Positive,15,0,15
565200,True,0,2 user reviews,2,0,2
565210,True,7,Positive,10,0,10
565220,True,0,4 user reviews,4,0,4
565230,True,0,6 user reviews,6,0,6
565240,True,0,2 user reviews,2,0,2
565250,True,0,2 user reviews,2,0,2
565261,True,0,6 user reviews,6,0,6
565290,True,0,No user reviews,0,0,0
565300,True,0,No user reviews,0,0,0
565301,True,0,No user reviews,0,0,0
565302,True,0,No user reviews,0,0,0
565303,True,0,No user reviews,0,0,0
565310,True,0,1 user reviews,1,0,1
565320,True,0,1 user reviews,1,0,1
565321,True,0,1 user reviews,1,0,1
565322,True,0,1 user reviews,1,0,1
565323,True,0,2 user reviews,2,0,2
565324,True,0,1 user reviews,0,1,1
565330,True,0,2 user reviews,0,2,2
565360,True,0,No user reviews,0,0,0
565370,True,0,No user reviews,0,0,0
565380,True,0,7 user reviews,3,4,7
565390,True,7,Positive,21,4,25
565410,True,5,Mixed,70,56,126
565420,True,0,1 user reviews,1,0,1
565440,True,0,No user reviews,0,0,0
565450,True,0,No user reviews,0,0,0
565460,True,0,No user reviews,0,0,0
565470,True,0,No user reviews,0,0,0
565480,True,0,No user reviews,0,0,0
565490,True,0,1 user reviews,0,1,1
565500,True,0,No user reviews,0,0,0
565510,True,0,1 user reviews,1,0,1
565520,True,0,8 user reviews,7,1,8
565530,True,0,No user reviews,0,0,0
565540,True,0,1 user reviews,1,0,1
565550,True,5,Mixed,36,18,54
565560,True,0,1 user reviews,1,0,1
565570,True,0,1 user reviews,1,0,1
565580,True,0,1 user reviews,1,0,1
565590,True,0,1 user reviews,1,0,1
565600,True,7,Positive,19,2,21
565610,True,8,Very Positive,63,2,65
565620,True,5,Mixed,14,17,31
565621,True,5,Mixed,12,9,21
565622,True,6,Mostly Positive,11,3,14
565630,True,0,8 user reviews,8,0,8
565640,True,0,2 user reviews,1,1,2
565650,True,0,3 user reviews,3,0,3
565660,True,6,Mostly Positive,8,3,11
565670,True,0,8 user reviews,5,3,8
565690,True,0,7 user reviews,7,0,7
565720,True,8,Very Positive,61,8,69
565730,True,0,No user reviews,0,0,0
565760,True,0,No user reviews,0,0,0
565770,True,0,2 user reviews,2,0,2
565800,True,0,No user reviews,0,0,0
565810,True,0,1 user reviews,1,0,1
565820,True,0,1 user reviews,1,0,1
565830,True,0,1 user reviews,1,0,1
565840,True,8,Very Positive,87,10,97
565860,True,6,Mostly Positive,110,33,143
565910,True,0,5 user reviews,4,1,5
565930,True,0,No user reviews,0,0,0
565931,True,0,No user reviews,0,0,0
565932,True,0,No user reviews,0,0,0
565933,True,0,No user reviews,0,0,0
565934,True,0,No user reviews,0,0,0
565935,True,0,No user reviews,0,0,0
565936,True,0,No user reviews,0,0,0
565937,True,0,No user reviews,0,0,0
565938,True,0,No user reviews,0,0,0
565939,True,0,No user reviews,0,0,0
565940,True,0,No user reviews,0,0,0
565950,True,0,No user reviews,0,0,0
565951,True,0,No user reviews,0,0,0
565952,True,0,No user reviews,0,0,0
565953,True,0,No user reviews,0,0,0
565954,True,0,No user reviews,0,0,0
565955,True,0,No user reviews,0,0,0
565956,True,0,No user reviews,0,0,0
565957,True,0,No user reviews,0,0,0
565958,True,0,No user reviews,0,0,0
565959,True,0,No user reviews,0,0,0
565960,True,0,No user reviews,0,0,0
565961,True,0,No user reviews,0,0,0
565980,True,6,Mostly Positive,20,7,27
565990,True,0,No user reviews,0,0,0
566010,True,0,1 user reviews,1,0,1
566020,True,0,No user reviews,0,0,0
566040,True,0,No user reviews,0,0,0
566050,True,8,Very Positive,375,22,397
566090,True,5,Mixed,303,148,451
566130,True,0,No user reviews,0,0,0
566140,True,0,1 user reviews,1,0,1
566150,True,0,No user reviews,0,0,0
566160,True,8,Very Positive,382,32,414
566170,True,0,1 user reviews,0,1,1
566180,True,0,4 user reviews,1,3,4
566190,True,5,Mixed,48,26,74
566200,True,0,4 user reviews,3,1,4
566250,True,0,2 user reviews,1,1,2
566260,True,0,2 user reviews,2,0,2
566270,True,5,Mixed,6,4,10
566280,True,0,1 user reviews,1,0,1
566320,True,0,4 user reviews,3,1,4
566330,True,0,No user reviews,0,0,0
566340,True,0,No user reviews,0,0,0
566350,True,0,3 user reviews,3,0,3
566380,True,0,1 user reviews,1,0,1
566390,True,0,No user reviews,0,0,0
566410,True,0,No user reviews,0,0,0
566420,True,0,6 user reviews,3,3,6
566430,True,5,Mixed,6,8,14
566440,True,5,Mixed,750,486,1236
566450,True,0,No user reviews,0,0,0
566460,True,0,No user reviews,0,0,0
566470,True,0,No user reviews,0,0,0
566480,True,0,No user reviews,0,0,0
566490,True,7,Positive,14,0,14
566510,True,0,No user reviews,0,0,0
566530,True,6,Mostly Positive,151,44,195
566540,True,8,Very Positive,157,36,193
566550,True,5,Mixed,20,28,48
566560,True,0,2 user reviews,1,1,2
566570,True,5,Mixed,14,12,26
566580,True,0,5 user reviews,3,2,5
566590,True,0,No user reviews,0,0,0
566640,True,0,No user reviews,0,0,0
566670,True,7,Positive,17,1,18
566680,True,0,No user reviews,0,0,0
566690,True,0,1 user reviews,1,0,1
566700,True,7,Positive,42,1,43
566710,True,0,1 user reviews,1,0,1
566720,True,0,No user reviews,0,0,0
566730,True,0,No user reviews,0,0,0
566750,True,0,7 user reviews,5,2,7
566760,True,0,No user reviews,0,0,0
566770,True,0,No user reviews,0,0,0
566780,True,6,Mostly Positive,24,8,32
566790,True,0,No user reviews,0,0,0
566800,True,0,No user reviews,0,0,0
566810,True,0,No user reviews,0,0,0
566840,True,0,No user reviews,0,0,0
566860,True,8,Very Positive,692,114,806
566870,True,6,Mostly Positive,12,5,17
566880,True,7,Positive,14,2,16
566890,True,7,Positive,15,1,16
566900,True,7,Positive,10,0,10
566910,True,0,1 user reviews,0,1,1
566930,True,0,5 user reviews,4,1,5
566940,True,0,7 user reviews,6,1,7
566970,True,6,Mostly Positive,12,5,17
566980,True,0,8 user reviews,8,0,8
567010,True,0,8 user reviews,7,1,8
567020,True,0,5 user reviews,2,3,5
567030,True,8,Very Positive,148,2,150
567040,True,4,Mostly Negative,6,13,19
567050,True,0,No user reviews,0,0,0
567060,True,8,Very Positive,76,19,95
567070,True,0,No user reviews,0,0,0
567080,True,8,Very Positive,52,7,59
567090,True,0,No user reviews,0,0,0
567110,True,0,No user reviews,0,0,0
567130,True,8,Very Positive,70,13,83
567140,True,7,Positive,13,3,16
567150,True,6,Mostly Positive,14,4,18
567160,True,7,Positive,34,3,37
567180,True,0,No user reviews,0,0,0
567200,True,5,Mixed,12,6,18
567210,True,0,8 user reviews,8,0,8
567220,True,5,Mixed,5,6,11
567230,True,0,No user reviews,0,0,0
567240,True,7,Positive,11,2,13
567260,True,5,Mixed,6,6,12
567280,True,8,Very Positive,158,29,187
567290,True,8,Very Positive,221,24,245
567320,True,4,Mostly Negative,17,26,43
567330,True,0,No user reviews,0,0,0
567340,True,7,Positive,31,1,32
567360,True,0,2 user reviews,1,1,2
567370,True,8,Very Positive,60,1,61
567380,True,9,Overwhelmingly Positive,516,22,538
567390,True,0,No user reviews,0,0,0
567391,True,0,No user reviews,0,0,0
567400,True,0,No user reviews,0,0,0
567410,True,0,No user reviews,0,0,0
567420,True,0,No user reviews,0,0,0
567421,True,0,No user reviews,0,0,0
567422,True,0,No user reviews,0,0,0
567430,True,0,No user reviews,0,0,0
567480,True,0,3 user reviews,2,1,3
567560,True,0,No user reviews,0,0,0
567580,True,6,Mostly Positive,68,25,93
567590,True,0,No user reviews,0,0,0
567600,True,0,9 user reviews,4,5,9
567610,True,0,4 user reviews,2,2,4
567620,True,0,No user reviews,0,0,0
567630,True,0,1 user reviews,0,1,1
567640,True,8,Very Positive,3558,398,3956
567660,True,0,4 user reviews,4,0,4
567670,True,8,Very Positive,193,22,215
567680,True,4,Mostly Negative,9,18,27
567690,True,0,No user reviews,0,0,0
567700,True,0,No user reviews,0,0,0
567730,True,7,Positive,30,4,34
567750,True,6,Mostly Positive,108,39,147
567780,True,5,Mixed,11,6,17
567800,True,8,Very Positive,61,12,73
567810,True,7,Positive,40,4,44
567820,True,0,No user reviews,0,0,0
567840,True,0,5 user reviews,3,2,5
567850,True,0,No user reviews,0,0,0
567860,True,0,2 user reviews,2,0,2
567890,True,5,Mixed,7,4,11
567900,True,0,No user reviews,0,0,0
567960,True,0,No user reviews,0,0,0
567970,True,0,No user reviews,0,0,0
567980,True,0,5 user reviews,5,0,5
567990,True,8,Very Positive,157,5,162
568010,True,7,Positive,12,1,13
568011,True,7,Positive,9,1,10
568012,True,0,3 user reviews,3,0,3
568013,True,0,2 user reviews,2,0,2
568020,True,7,Positive,45,2,47
568030,True,7,Positive,9,2,11
568040,True,8,Very Positive,101,15,116
568060,True,0,6 user reviews,6,0,6
568070,True,5,Mixed,10,6,16
568080,True,0,No user reviews,0,0,0
568090,True,8,Very Positive,1369,126,1495
568110,True,7,Positive,10,2,12
568120,True,0,No user reviews,0,0,0
568130,True,0,No user reviews,0,0,0
568150,True,0,2 user reviews,2,0,2
568160,True,0,6 user reviews,6,0,6
568170,True,0,No user reviews,0,0,0
568180,True,0,8 user reviews,8,0,8
568200,True,7,Positive,10,1,11
568210,True,0,No user reviews,0,0,0
568220,True,8,Very Positive,1331,221,1552
568240,True,0,1 user reviews,1,0,1
568250,True,0,6 user reviews,3,3,6
568290,True,0,7 user reviews,7,0,7
568300,True,0,No user reviews,0,0,0
568310,True,0,7 user reviews,7,0,7
568320,True,8,Very Positive,318,9,327
568330,True,0,2 user reviews,1,1,2
568370,True,7,Positive,18,2,20
568380,True,6,Mostly Positive,9,3,12
568400,True,0,6 user reviews,4,2,6
568420,True,0,No user reviews,0,0,0
568440,True,6,Mostly Positive,29,10,39
568460,True,7,Positive,11,1,12
568470,True,0,8 user reviews,4,4,8
568480,True,0,2 user reviews,2,0,2
568490,True,7,Positive,13,0,13
568500,True,0,8 user reviews,5,3,8
568540,True,0,No user reviews,0,0,0
568570,True,5,Mixed,785,370,1155
568580,True,5,Mixed,19,13,32
568590,True,0,No user reviews,0,0,0
568600,True,0,5 user reviews,5,0,5
568610,True,7,Positive,23,3,26
568620,True,0,No user reviews,0,0,0
568630,True,0,No user reviews,0,0,0
568640,True,0,4 user reviews,4,0,4
568660,True,0,No user reviews,0,0,0
568670,True,0,No user reviews,0,0,0
568690,True,0,1 user reviews,1,0,1
568700,True,0,No user reviews,0,0,0
568710,True,0,1 user reviews,0,1,1
568720,True,5,Mixed,16,21,37
568750,True,6,Mostly Positive,116,33,149
568760,True,0,No user reviews,0,0,0
568770,True,0,No user reviews,0,0,0
568780,True,6,Mostly Positive,8,3,11
568790,True,0,No user reviews,0,0,0
568800,True,0,2 user reviews,2,0,2
568830,True,7,Positive,10,1,11
568840,True,0,4 user reviews,4,0,4
568850,True,5,Mixed,12,6,18
568860,True,0,4 user reviews,1,3,4
568870,True,0,No user reviews,0,0,0
568880,True,0,No user reviews,0,0,0
568910,True,0,6 user reviews,3,3,6
568920,True,7,Positive,12,2,14
568930,True,6,Mostly Positive,94,32,126
568940,True,5,Mixed,18,10,28
568950,True,7,Positive,25,2,27
568960,True,5,Mixed,10,5,15
568970,True,5,Mixed,15,15,30
568980,True,0,9 user reviews,7,2,9
568990,True,0,9 user reviews,9,0,9
569000,True,0,6 user reviews,5,1,6
569010,True,0,1 user reviews,1,0,1
569030,True,0,1 user reviews,1,0,1
569050,True,0,3 user reviews,3,0,3
569080,True,0,No user reviews,0,0,0
569081,True,0,No user reviews,0,0,0
569082,True,0,No user reviews,0,0,0
569083,True,0,No user reviews,0,0,0
569084,True,0,No user reviews,0,0,0
569085,True,0,No user reviews,0,0,0
569086,True,0,No user reviews,0,0,0
569087,True,0,No user reviews,0,0,0
569088,True,0,No user reviews,0,0,0
569089,True,0,No user reviews,0,0,0
569090,True,0,No user reviews,0,0,0
569091,True,0,No user reviews,0,0,0
569092,True,0,No user reviews,0,0,0
569100,True,0,No user reviews,0,0,0
569110,True,0,No user reviews,0,0,0
569111,True,0,No user reviews,0,0,0
569112,True,0,No user reviews,0,0,0
569113,True,0,No user reviews,0,0,0
569114,True,0,No user reviews,0,0,0
569115,True,0,No user reviews,0,0,0
569116,True,0,No user reviews,0,0,0
569117,True,0,No user reviews,0,0,0
569118,True,0,No user reviews,0,0,0
569119,True,0,No user reviews,0,0,0
569120,True,0,No user reviews,0,0,0
569121,True,0,No user reviews,0,0,0
569122,True,0,No user reviews,0,0,0
569130,True,0,1 user reviews,1,0,1
569140,True,0,4 user reviews,4,0,4
569150,True,0,4 user reviews,4,0,4
569160,True,0,1 user reviews,1,0,1
569170,True,0,No user reviews,0,0,0
569180,True,4,Mostly Negative,3,7,10
569190,True,0,1 user reviews,1,0,1
569200,True,0,3 user reviews,3,0,3
569210,True,0,7 user reviews,4,3,7
569220,True,7,Positive,11,1,12
569240,True,0,No user reviews,0,0,0
569241,True,0,2 user reviews,1,1,2
569242,True,0,No user reviews,0,0,0
569243,True,0,3 user reviews,2,1,3
569244,True,0,No user reviews,0,0,0
569245,True,0,1 user reviews,1,0,1
569246,True,0,No user reviews,0,0,0
569247,True,0,No user reviews,0,0,0
569248,True,0,No user reviews,0,0,0
569249,True,0,No user reviews,0,0,0
569270,True,0,4 user reviews,4,0,4
569290,True,7,Positive,16,4,20
569310,True,0,No user reviews,0,0,0
569340,True,6,Mostly Positive,45,14,59
569350,True,0,5 user reviews,2,3,5
569360,True,7,Positive,15,1,16
569370,True,0,No user reviews,0,0,0
569380,True,7,Positive,12,2,14
569390,True,0,3 user reviews,0,3,3
569400,True,0,No user reviews,0,0,0
569410,True,0,1 user reviews,1,0,1
569420,True,0,7 user reviews,7,0,7
569430,True,5,Mixed,13,8,21
569470,True,0,No user reviews,0,0,0
569480,True,8,Very Positive,8051,835,8886
569500,True,0,2 user reviews,2,0,2
569510,True,0,No user reviews,0,0,0
569520,True,0,2 user reviews,2,0,2
569530,True,8,Very Positive,139,34,173
569570,True,6,Mostly Positive,8,3,11
569580,True,0,No user reviews,0,0,0
569590,True,0,4 user reviews,2,2,4
569600,True,0,No user reviews,0,0,0
569610,True,6,Mostly Positive,49,20,69
569620,True,0,No user reviews,0,0,0
569630,True,6,Mostly Positive,48,20,68
569640,True,5,Mixed,11,13,24
569650,True,0,No user reviews,0,0,0
569670,True,0,No user reviews,0,0,0
569680,True,0,No user reviews,0,0,0
569681,True,0,No user reviews,0,0,0
569682,True,0,No user reviews,0,0,0
569683,True,0,No user reviews,0,0,0
569684,True,0,No user reviews,0,0,0
569685,True,0,4 user reviews,3,1,4
569686,True,0,4 user reviews,3,1,4
569687,True,0,6 user reviews,5,1,6
569688,True,0,1 user reviews,1,0,1
569689,True,0,No user reviews,0,0,0
569690,True,0,No user reviews,0,0,0
569691,True,0,No user reviews,0,0,0
569692,True,0,No user reviews,0,0,0
569700,True,7,Positive,17,3,20
569710,True,0,5 user reviews,5,0,5
569711,True,0,1 user reviews,0,1,1
569712,True,0,5 user reviews,4,1,5
569713,True,0,1 user reviews,0,1,1
569714,True,0,2 user reviews,1,1,2
569715,True,0,1 user reviews,0,1,1
569716,True,0,9 user reviews,8,1,9
569717,True,0,4 user reviews,4,0,4
569720,True,0,1 user reviews,1,0,1
569740,True,0,No user reviews,0,0,0
569770,True,5,Mixed,45,33,78
569800,True,8,Very Positive,87,21,108
569810,True,8,Very Positive,47,5,52
569820,True,0,1 user reviews,1,0,1
569850,True,0,2 user reviews,2,0,2
569860,True,8,Very Positive,1307,108,1415
569870,True,0,5 user reviews,1,4,5
569880,True,0,No user reviews,0,0,0
569890,True,0,No user reviews,0,0,0
569900,True,0,No user reviews,0,0,0
569910,True,0,No user reviews,0,0,0
569911,True,0,No user reviews,0,0,0
569912,True,0,No user reviews,0,0,0
569913,True,0,No user reviews,0,0,0
569914,True,0,No user reviews,0,0,0
569915,True,0,No user reviews,0,0,0
569920,True,0,No user reviews,0,0,0
569930,True,0,No user reviews,0,0,0
569940,True,0,6 user reviews,5,1,6
569950,True,0,No user reviews,0,0,0
569970,True,5,Mixed,38,35,73
569980,True,0,No user reviews,0,0,0
570000,True,8,Very Positive,108,8,116
570010,True,0,No user reviews,0,0,0
570020,True,0,No user reviews,0,0,0
570030,True,0,No user reviews,0,0,0
570050,True,6,Mostly Positive,39,13,52
570060,True,0,2 user reviews,1,1,2
570080,True,0,No user reviews,0,0,0
570090,True,7,Positive,27,5,32
570120,True,0,2 user reviews,2,0,2
570150,True,7,Positive,9,2,11
570160,True,0,No user reviews,0,0,0
570170,True,0,1 user reviews,0,1,1
570180,True,0,1 user reviews,1,0,1
570181,True,0,3 user reviews,3,0,3
570190,True,0,2 user reviews,2,0,2
570200,True,0,2 user reviews,1,1,2
570210,True,0,5 user reviews,3,2,5
570220,True,6,Mostly Positive,26,9,35
570230,True,6,Mostly Positive,7,3,10
570240,True,0,No user reviews,0,0,0
570250,True,0,No user reviews,0,0,0
570260,True,0,1 user reviews,1,0,1
570270,True,0,No user reviews,0,0,0
570280,True,0,No user reviews,0,0,0
570290,True,0,2 user reviews,2,0,2
570310,True,7,Positive,21,2,23
570320,True,0,1 user reviews,0,1,1
570340,True,0,No user reviews,0,0,0
570350,True,5,Mixed,14,7,21
570360,True,0,6 user reviews,6,0,6
570361,True,0,6 user reviews,6,0,6
570362,True,0,5 user reviews,2,3,5
570363,True,0,2 user reviews,2,0,2
570370,True,0,4 user reviews,4,0,4
570380,True,0,7 user reviews,1,6,7
570420,True,6,Mostly Positive,71,30,101
570430,True,0,No user reviews,0,0,0
570450,True,0,No user reviews,0,0,0
570460,True,8,Very Positive,494,99,593
570470,True,5,Mixed,6,5,11
570480,True,0,No user reviews,0,0,0
570481,True,0,No user reviews,0,0,0
570490,True,8,Very Positive,79,2,81
570500,True,0,4 user reviews,1,3,4
570510,True,0,No user reviews,0,0,0
570520,True,0,1 user reviews,1,0,1
570530,True,0,4 user reviews,4,0,4
570540,True,0,8 user reviews,5,3,8
570560,True,0,No user reviews,0,0,0
570570,True,0,No user reviews,0,0,0
570571,True,0,1 user reviews,1,0,1
570572,True,0,No user reviews,0,0,0
570573,True,0,No user reviews,0,0,0
570574,True,0,No user reviews,0,0,0
570575,True,0,No user reviews,0,0,0
570580,True,7,Positive,28,3,31
570590,True,7,Positive,9,2,11
570600,True,0,2 user reviews,2,0,2
570620,True,0,No user reviews,0,0,0
570621,True,0,No user reviews,0,0,0
570622,True,0,No user reviews,0,0,0
570623,True,0,No user reviews,0,0,0
570624,True,0,No user reviews,0,0,0
570625,True,0,No user reviews,0,0,0
570626,True,0,No user reviews,0,0,0
570627,True,0,No user reviews,0,0,0
570628,True,0,No user reviews,0,0,0
570629,True,0,No user reviews,0,0,0
570630,True,0,No user reviews,0,0,0
570631,True,0,No user reviews,0,0,0
570632,True,0,No user reviews,0,0,0
570633,True,0,No user reviews,0,0,0
570634,True,0,No user reviews,0,0,0
570635,True,0,No user reviews,0,0,0
570636,True,0,No user reviews,0,0,0
570637,True,0,No user reviews,0,0,0
570638,True,0,No user reviews,0,0,0
570639,True,0,No user reviews,0,0,0
570640,True,0,No user reviews,0,0,0
570641,True,0,No user reviews,0,0,0
570660,True,5,Mixed,1303,768,2071
570670,True,0,No user reviews,0,0,0
570680,True,7,Positive,27,2,29
570690,True,3,Negative,0,13,13
570710,True,5,Mixed,17,25,42
570720,True,0,No user reviews,0,0,0
570750,True,0,No user reviews,0,0,0
570770,True,7,Positive,30,6,36
570780,True,6,Mostly Positive,38,12,50
570790,True,0,6 user reviews,2,4,6
570800,True,0,No user reviews,0,0,0
570810,True,0,8 user reviews,8,0,8
570820,True,0,2 user reviews,2,0,2
570830,True,0,No user reviews,0,0,0
570840,True,0,6 user reviews,6,0,6
570850,True,0,6 user reviews,4,2,6
570860,True,7,Positive,24,4,28
570890,True,0,3 user reviews,2,1,3
570900,True,7,Positive,36,0,36
570920,True,0,No user reviews,0,0,0
570930,True,7,Positive,19,0,19
570940,True,8,Very Positive,10314,2121,12435
570950,True,0,No user reviews,0,0,0
570960,True,5,Mixed,23,12,35
570970,True,5,Mixed,47,23,70
570980,True,0,6 user reviews,4,2,6
571010,True,7,Positive,18,3,21
571020,True,5,Mixed,14,11,25
571030,True,0,No user reviews,0,0,0
571031,True,0,No user reviews,0,0,0
571040,True,0,6 user reviews,3,3,6
571050,True,0,3 user reviews,1,2,3
571060,True,7,Positive,13,2,15
571080,True,0,1 user reviews,1,0,1
571090,True,0,No user reviews,0,0,0
571100,True,5,Mixed,10,8,18
571120,True,0,2 user reviews,2,0,2
571160,True,0,No user reviews,0,0,0
571170,True,0,No user reviews,0,0,0
571180,True,0,No user reviews,0,0,0
571210,True,7,Positive,40,0,40
571220,True,0,1 user reviews,1,0,1
571230,True,0,4 user reviews,4,0,4
571250,True,0,No user reviews,0,0,0
571260,True,8,Very Positive,352,62,414
571270,True,0,No user reviews,0,0,0
571290,True,0,No user reviews,0,0,0
571310,True,9,Overwhelmingly Positive,1171,50,1221
571330,True,0,1 user reviews,1,0,1
571340,True,5,Mixed,19,12,31
571350,True,7,Positive,24,4,28
571410,True,7,Positive,13,1,14
571430,True,7,Positive,33,3,36
571440,True,0,No user reviews,0,0,0
571470,True,0,No user reviews,0,0,0
571480,True,0,No user reviews,0,0,0
571490,True,0,No user reviews,0,0,0
571500,True,0,2 user reviews,2,0,2
571520,True,6,Mostly Positive,11,3,14
571530,True,8,Very Positive,216,16,232
571550,True,0,4 user reviews,2,2,4
571570,True,0,6 user reviews,4,2,6
571580,True,0,No user reviews,0,0,0
571600,True,7,Positive,33,2,35
571610,True,0,2 user reviews,2,0,2
571630,True,5,Mixed,9,4,13
571640,True,0,No user reviews,0,0,0
571660,True,0,4 user reviews,4,0,4
571670,True,0,1 user reviews,1,0,1
571680,True,0,4 user reviews,4,0,4
571690,True,0,3 user reviews,0,3,3
571700,True,0,No user reviews,0,0,0
571710,True,8,Very Positive,373,26,399
571720,True,6,Mostly Positive,40,17,57
571730,True,0,No user reviews,0,0,0
571740,True,8,Very Positive,4046,609,4655
571750,True,0,No user reviews,0,0,0
571760,True,6,Mostly Positive,9,3,12
571761,True,0,6 user reviews,5,1,6
571810,True,0,1 user reviews,0,1,1
571820,True,0,No user reviews,0,0,0
571850,True,0,1 user reviews,1,0,1
571860,True,5,Mixed,7,4,11
571870,True,5,Mixed,7,8,15
571880,True,9,Overwhelmingly Positive,820,17,837
571890,True,5,Mixed,19,10,29
571900,True,0,No user reviews,0,0,0
571920,True,0,No user reviews,0,0,0
571930,True,0,No user reviews,0,0,0
571940,True,0,No user reviews,0,0,0
571950,True,0,No user reviews,0,0,0
571960,True,0,3 user reviews,2,1,3
571970,True,0,No user reviews,0,0,0
571971,True,0,No user reviews,0,0,0
571980,True,0,No user reviews,0,0,0
571981,True,0,No user reviews,0,0,0
571990,True,0,1 user reviews,1,0,1
572000,True,0,3 user reviews,3,0,3
572010,True,4,Mostly Negative,5,16,21
572020,True,7,Positive,25,2,27
572030,True,0,No user reviews,0,0,0
572040,True,5,Mixed,5,6,11
572050,True,5,Mixed,16,14,30
572060,True,0,No user reviews,0,0,0
572070,True,0,No user reviews,0,0,0
572080,True,0,No user reviews,0,0,0
572090,True,0,No user reviews,0,0,0
572091,True,0,No user reviews,0,0,0
572092,True,0,No user reviews,0,0,0
572093,True,0,No user reviews,0,0,0
572094,True,0,No user reviews,0,0,0
572095,True,0,No user reviews,0,0,0
572096,True,0,No user reviews,0,0,0
572097,True,0,No user reviews,0,0,0
572098,True,0,No user reviews,0,0,0
572099,True,0,No user reviews,0,0,0
572100,True,0,No user reviews,0,0,0
572101,True,0,No user reviews,0,0,0
572102,True,0,No user reviews,0,0,0
572103,True,0,No user reviews,0,0,0
572104,True,0,No user reviews,0,0,0
572105,True,0,No user reviews,0,0,0
572106,True,0,No user reviews,0,0,0
572107,True,0,No user reviews,0,0,0
572108,True,0,No user reviews,0,0,0
572109,True,0,No user reviews,0,0,0
572110,True,0,No user reviews,0,0,0
572111,True,0,No user reviews,0,0,0
572120,True,0,No user reviews,0,0,0
572130,True,0,4 user reviews,4,0,4
572140,True,0,No user reviews,0,0,0
572150,True,0,No user reviews,0,0,0
572160,True,7,Positive,37,8,45
572170,True,0,2 user reviews,1,1,2
572180,True,0,7 user reviews,7,0,7
572190,True,0,No user reviews,0,0,0
572200,True,0,No user reviews,0,0,0
572210,True,0,2 user reviews,2,0,2
572220,True,8,Very Positive,119,9,128
572230,True,0,7 user reviews,1,6,7
572240,True,0,3 user reviews,2,1,3
572280,True,0,No user reviews,0,0,0
572290,True,0,2 user reviews,1,1,2
572300,True,6,Mostly Positive,38,14,52
572310,True,0,1 user reviews,1,0,1
572311,True,0,1 user reviews,1,0,1
572330,True,5,Mixed,27,13,40
572340,True,0,No user reviews,0,0,0
572350,True,0,3 user reviews,2,1,3
572370,True,0,No user reviews,0,0,0
572380,True,0,No user reviews,0,0,0
572381,True,0,1 user reviews,1,0,1
572382,True,0,No user reviews,0,0,0
572390,True,0,No user reviews,0,0,0
572400,True,0,No user reviews,0,0,0
572410,True,6,Mostly Positive,1636,618,2254
572420,True,0,No user reviews,0,0,0
572430,True,6,Mostly Positive,220,80,300
572460,True,0,No user reviews,0,0,0
572470,True,0,No user reviews,0,0,0
572480,True,0,1 user reviews,1,0,1
572490,True,0,No user reviews,0,0,0
572500,True,0,No user reviews,0,0,0
572520,True,6,Mostly Positive,51,18,69
572530,True,0,No user reviews,0,0,0
572540,True,7,Positive,23,2,25
572570,True,0,5 user reviews,5,0,5
572580,True,6,Mostly Positive,10,4,14
572600,True,5,Mixed,4120,2121,6241
572620,True,5,Mixed,26,13,39
572630,True,7,Positive,14,1,15
572640,True,0,7 user reviews,6,1,7
572660,True,0,5 user reviews,2,3,5
572700,True,8,Very Positive,51,5,56
572710,True,6,Mostly Positive,14,4,18
572720,True,5,Mixed,6,8,14
572730,True,7,Positive,37,2,39
572740,True,7,Positive,33,4,37
572750,True,0,No user reviews,0,0,0
572760,True,0,8 user reviews,8,0,8
572770,True,0,No user reviews,0,0,0
572780,True,0,No user reviews,0,0,0
572790,True,0,No user reviews,0,0,0
572800,True,0,No user reviews,0,0,0
572810,True,0,No user reviews,0,0,0
572820,True,0,No user reviews,0,0,0
572830,True,0,No user reviews,0,0,0
572840,True,0,No user reviews,0,0,0
572890,True,8,Very Positive,800,56,856
572910,True,0,5 user reviews,5,0,5
572930,True,0,No user reviews,0,0,0
572940,True,0,No user reviews,0,0,0
572941,True,0,No user reviews,0,0,0
572942,True,0,1 user reviews,1,0,1
572943,True,0,No user reviews,0,0,0
572944,True,0,No user reviews,0,0,0
572945,True,0,No user reviews,0,0,0
572946,True,0,No user reviews,0,0,0
572947,True,0,No user reviews,0,0,0
572948,True,0,No user reviews,0,0,0
572949,True,0,No user reviews,0,0,0
572950,True,0,No user reviews,0,0,0
572951,True,0,No user reviews,0,0,0
572960,True,0,3 user reviews,3,0,3
572961,True,0,No user reviews,0,0,0
572962,True,0,No user reviews,0,0,0
572963,True,0,No user reviews,0,0,0
572964,True,0,No user reviews,0,0,0
572965,True,0,1 user reviews,1,0,1
572966,True,0,No user reviews,0,0,0
572967,True,0,No user reviews,0,0,0
572968,True,0,No user reviews,0,0,0
572969,True,0,No user reviews,0,0,0
572970,True,0,No user reviews,0,0,0
572971,True,0,No user reviews,0,0,0
572972,True,0,1 user reviews,1,0,1
572980,True,0,5 user reviews,0,5,5
572990,True,0,2 user reviews,1,1,2
572991,True,0,No user reviews,0,0,0
572992,True,0,No user reviews,0,0,0
572993,True,0,No user reviews,0,0,0
572994,True,0,No user reviews,0,0,0
572995,True,0,No user reviews,0,0,0
572996,True,0,No user reviews,0,0,0
572997,True,0,No user reviews,0,0,0
572998,True,0,No user reviews,0,0,0
572999,True,0,No user reviews,0,0,0
573000,True,0,No user reviews,0,0,0
573001,True,0,No user reviews,0,0,0
573010,True,0,No user reviews,0,0,0
573020,True,0,2 user reviews,2,0,2
573021,True,0,No user reviews,0,0,0
573022,True,0,2 user reviews,2,0,2
573023,True,0,No user reviews,0,0,0
573024,True,0,No user reviews,0,0,0
573025,True,0,No user reviews,0,0,0
573026,True,0,No user reviews,0,0,0
573027,True,0,No user reviews,0,0,0
573028,True,0,No user reviews,0,0,0
573029,True,0,No user reviews,0,0,0
573030,True,0,No user reviews,0,0,0
573031,True,0,1 user reviews,1,0,1
573040,True,7,Positive,14,2,16
573050,True,7,Positive,14,1,15
573060,True,6,Mostly Positive,117,34,151
573070,True,5,Mixed,10,5,15
573080,True,6,Mostly Positive,30,12,42
573090,True,8,Very Positive,7617,584,8201
573100,True,6,Mostly Positive,2142,565,2707
573110,True,5,Mixed,13,7,20
573120,True,6,Mostly Positive,264,71,335
573130,True,8,Very Positive,142,29,171
573140,True,0,No user reviews,0,0,0
573150,True,0,No user reviews,0,0,0
573160,True,8,Very Positive,89,11,100
573170,True,8,Very Positive,193,8,201
573180,True,7,Positive,22,1,23
573190,True,0,1 user reviews,1,0,1
573210,True,5,Mixed,6,8,14
573220,True,0,No user reviews,0,0,0
573230,True,0,No user reviews,0,0,0
573250,True,0,No user reviews,0,0,0
573260,True,0,7 user reviews,3,4,7
573270,True,7,Positive,18,4,22
573280,True,0,No user reviews,0,0,0
573290,True,7,Positive,14,0,14
573300,True,7,Positive,17,3,20
573310,True,0,No user reviews,0,0,0
573320,True,8,Very Positive,341,26,367
573330,True,0,4 user reviews,1,3,4
573340,True,0,No user reviews,0,0,0
573350,True,0,2 user reviews,2,0,2
573360,True,7,Positive,11,0,11
573370,True,5,Mixed,9,5,14
573410,True,8,Very Positive,523,53,576
573460,True,0,5 user reviews,3,2,5
573470,True,0,1 user reviews,0,1,1
573480,True,0,No user reviews,0,0,0
573490,True,6,Mostly Positive,187,55,242
573500,True,0,No user reviews,0,0,0
573510,True,0,No user reviews,0,0,0
573511,True,0,1 user reviews,0,1,1
573512,True,0,1 user reviews,0,1,1
573513,True,0,No user reviews,0,0,0
573520,True,7,Positive,39,2,41
573530,True,0,5 user reviews,3,2,5
573540,True,0,No user reviews,0,0,0
573541,True,0,2 user reviews,2,0,2
573542,True,0,1 user reviews,1,0,1
573543,True,0,1 user reviews,1,0,1
573544,True,0,1 user reviews,1,0,1
573545,True,0,1 user reviews,1,0,1
573546,True,0,No user reviews,0,0,0
573548,True,0,2 user reviews,2,0,2
573550,True,7,Positive,13,1,14
573560,True,0,No user reviews,0,0,0
573570,True,0,3 user reviews,1,2,3
573580,True,0,3 user reviews,2,1,3
573600,True,5,Mixed,37,21,58
573610,True,0,1 user reviews,1,0,1
573620,True,0,1 user reviews,1,0,1
573630,True,0,No user reviews,0,0,0
573640,True,0,1 user reviews,0,1,1
573650,True,0,1 user reviews,0,1,1
573660,True,0,8 user reviews,0,8,8
573670,True,0,4 user reviews,4,0,4
573680,True,5,Mixed,22,25,47
573690,True,0,2 user reviews,2,0,2
573700,True,0,2 user reviews,2,0,2
573710,True,0,1 user reviews,1,0,1
573720,True,0,3 user reviews,3,0,3
573730,True,0,1 user reviews,1,0,1
573740,True,0,No user reviews,0,0,0
573750,True,0,1 user reviews,0,1,1
573760,True,0,5 user reviews,5,0,5
573770,True,7,Positive,13,1,14
573780,True,5,Mixed,38,19,57
573790,True,7,Positive,30,2,32
573800,True,0,No user reviews,0,0,0
573820,True,0,No user reviews,0,0,0
573821,True,0,No user reviews,0,0,0
573830,True,4,Mostly Negative,29,88,117
573832,True,5,Mixed,49,29,78
573850,True,0,No user reviews,0,0,0
573860,True,0,No user reviews,0,0,0
573870,True,0,No user reviews,0,0,0
573880,True,0,No user reviews,0,0,0
573890,True,0,No user reviews,0,0,0
573900,True,0,8 user reviews,8,0,8
573920,True,0,No user reviews,0,0,0
573960,True,0,5 user reviews,1,4,5
573980,True,0,No user reviews,0,0,0
573990,True,0,No user reviews,0,0,0
574010,True,6,Mostly Positive,12,4,16
574020,True,0,No user reviews,0,0,0
574030,True,5,Mixed,17,22,39
574040,True,0,2 user reviews,1,1,2
574050,True,5,Mixed,223,105,328
574070,True,0,No user reviews,0,0,0
574080,True,5,Mixed,123,128,251
574090,True,8,Very Positive,518,117,635
574110,True,0,No user reviews,0,0,0
574120,True,5,Mixed,12,7,19
574130,True,0,No user reviews,0,0,0
574140,True,6,Mostly Positive,39,15,54
574150,True,0,2 user reviews,2,0,2
574160,True,7,Positive,13,1,14
574170,True,0,3 user reviews,2,1,3
574180,True,0,No user reviews,0,0,0
574190,True,0,1 user reviews,1,0,1
574200,True,5,Mixed,30,15,45
574220,True,0,2 user reviews,2,0,2
574260,True,7,Positive,28,7,35
574270,True,7,Positive,21,5,26
574280,True,0,4 user reviews,3,1,4
574300,True,0,No user reviews,0,0,0
574310,True,8,Very Positive,94,20,114
574320,True,0,No user reviews,0,0,0
574330,True,0,2 user reviews,2,0,2
574340,True,0,No user reviews,0,0,0
574380,True,0,2 user reviews,2,0,2
574390,True,0,No user reviews,0,0,0
574400,True,0,1 user reviews,1,0,1
574410,True,0,1 user reviews,1,0,1
574420,True,0,6 user reviews,5,1,6
574440,True,0,No user reviews,0,0,0
574450,True,0,No user reviews,0,0,0
574460,True,0,No user reviews,0,0,0
574490,True,0,No user reviews,0,0,0
574500,True,0,9 user reviews,8,1,9
574520,True,0,2 user reviews,1,1,2
574530,True,0,No user reviews,0,0,0
574560,True,8,Very Positive,459,110,569
574570,True,6,Mostly Positive,12,5,17
574580,True,6,Mostly Positive,11,4,15
574590,True,0,5 user reviews,5,0,5
574640,True,6,Mostly Positive,30,11,41
574670,True,0,1 user reviews,0,1,1
574671,True,0,No user reviews,0,0,0
574672,True,0,No user reviews,0,0,0
574673,True,0,No user reviews,0,0,0
574674,True,0,No user reviews,0,0,0
574675,True,0,No user reviews,0,0,0
574676,True,0,No user reviews,0,0,0
574677,True,0,1 user reviews,0,1,1
574690,True,0,6 user reviews,5,1,6
574710,True,0,4 user reviews,1,3,4
574720,True,8,Very Positive,454,69,523
574730,True,0,No user reviews,0,0,0
574740,True,0,No user reviews,0,0,0
574750,True,0,No user reviews,0,0,0
574760,True,5,Mixed,349,329,678
574770,True,0,No user reviews,0,0,0
574780,True,0,No user reviews,0,0,0
574790,True,0,No user reviews,0,0,0
574820,True,8,Very Positive,65,7,72
574860,True,0,9 user reviews,3,6,9
574880,True,0,No user reviews,0,0,0
574890,True,7,Positive,16,3,19
574910,True,0,2 user reviews,2,0,2
574920,True,0,4 user reviews,3,1,4
574940,True,8,Very Positive,54,8,62
574950,True,0,No user reviews,0,0,0
574960,True,0,No user reviews,0,0,0
574961,True,0,1 user reviews,1,0,1
574962,True,0,No user reviews,0,0,0
574963,True,0,No user reviews,0,0,0
574964,True,0,No user reviews,0,0,0
574965,True,0,No user reviews,0,0,0
574966,True,0,No user reviews,0,0,0
574967,True,0,2 user reviews,2,0,2
574968,True,0,No user reviews,0,0,0
574970,True,0,No user reviews,0,0,0
574971,True,0,No user reviews,0,0,0
574972,True,0,No user reviews,0,0,0
574980,True,8,Very Positive,1056,86,1142
574990,True,0,1 user reviews,0,1,1
575000,True,0,No user reviews,0,0,0
575010,True,6,Mostly Positive,63,19,82
575030,True,0,1 user reviews,0,1,1
575040,True,0,No user reviews,0,0,0
575050,True,0,5 user reviews,5,0,5
575060,True,0,No user reviews,0,0,0
575080,True,0,1 user reviews,0,1,1
575090,True,0,9 user reviews,5,4,9
575100,True,0,2 user reviews,1,1,2
575110,True,0,9 user reviews,8,1,9
575160,True,4,Mostly Negative,5,11,16
575170,True,0,No user reviews,0,0,0
575180,True,0,1 user reviews,1,0,1
575190,True,0,No user reviews,0,0,0
575210,True,7,Positive,16,4,20
575220,True,0,No user reviews,0,0,0
575230,True,0,No user reviews,0,0,0
575240,True,0,No user reviews,0,0,0
575250,True,0,No user reviews,0,0,0
575260,True,0,No user reviews,0,0,0
575270,True,0,6 user reviews,4,2,6
575280,True,0,No user reviews,0,0,0
575290,True,6,Mostly Positive,8,3,11
575291,True,7,Positive,12,1,13
575300,True,7,Positive,9,2,11
575301,True,0,7 user reviews,3,4,7
575302,True,0,No user reviews,0,0,0
575330,True,8,Very Positive,151,20,171
575340,True,5,Mixed,22,11,33
575360,True,0,3 user reviews,2,1,3
575400,True,7,Positive,30,6,36
575420,True,7,Positive,21,3,24
575430,True,5,Mixed,14,7,21
575450,True,6,Mostly Positive,17,5,22
575480,True,8,Very Positive,68,4,72
575490,True,0,6 user reviews,4,2,6
575500,True,0,2 user reviews,0,2,2
575501,True,0,1 user reviews,0,1,1
575510,True,6,Mostly Positive,41,13,54
575540,True,5,Mixed,8,7,15
575550,True,8,Very Positive,655,126,781
575560,True,0,4 user reviews,2,2,4
575570,True,5,Mixed,26,16,42
575580,True,5,Mixed,13,6,19
575590,True,7,Positive,14,0,14
575600,True,5,Mixed,36,26,62
575610,True,0,No user reviews,0,0,0
575630,True,5,Mixed,6,4,10
575640,True,8,Very Positive,1110,126,1236
575650,True,8,Very Positive,109,16,125
575660,True,0,No user reviews,0,0,0
575670,True,7,Positive,9,2,11
575680,True,0,1 user reviews,1,0,1
575690,True,0,5 user reviews,5,0,5
575700,True,5,Mixed,18,13,31
575710,True,0,5 user reviews,5,0,5
575720,True,0,No user reviews,0,0,0
575750,True,0,4 user reviews,2,2,4
575760,True,0,3 user reviews,2,1,3
575770,True,0,No user reviews,0,0,0
575780,True,0,5 user reviews,3,2,5
575800,True,0,4 user reviews,3,1,4
575810,True,0,1 user reviews,1,0,1
575820,True,6,Mostly Positive,64,20,84
575830,True,5,Mixed,11,14,25
575840,True,0,6 user reviews,5,1,6
575850,True,5,Mixed,13,11,24
575860,True,0,9 user reviews,3,6,9
575880,True,0,3 user reviews,2,1,3
575890,True,5,Mixed,11,6,17
575900,True,7,Positive,16,3,19
575920,True,0,3 user reviews,2,1,3
575930,True,0,No user reviews,0,0,0
575940,True,8,Very Positive,55,8,63
575950,True,5,Mixed,89,55,144
575960,True,5,Mixed,18,18,36
575970,True,8,Very Positive,52,7,59
575990,True,0,9 user reviews,7,2,9
576020,True,0,5 user reviews,1,4,5
576030,True,8,Very Positive,160,19,179
576050,True,4,Mostly Negative,6,10,16
576060,True,0,6 user reviews,2,4,6
576090,True,0,No user reviews,0,0,0
576100,True,6,Mostly Positive,14,5,19
576110,True,0,4 user reviews,1,3,4
576120,True,0,7 user reviews,2,5,7
576130,True,8,Very Positive,45,7,52
576160,True,7,Positive,11,1,12
576180,True,0,No user reviews,0,0,0
576200,True,0,No user reviews,0,0,0
576210,True,0,No user reviews,0,0,0
576220,True,0,No user reviews,0,0,0
576230,True,0,No user reviews,0,0,0
576250,True,0,No user reviews,0,0,0
576260,True,5,Mixed,57,33,90
576270,True,0,No user reviews,0,0,0
576280,True,6,Mostly Positive,10,3,13
576290,True,0,2 user reviews,1,1,2
576300,True,0,7 user reviews,7,0,7
576310,True,5,Mixed,69,54,123
576320,True,5,Mixed,12,16,28
576330,True,0,1 user reviews,0,1,1
576370,True,0,5 user reviews,3,2,5
576380,True,0,3 user reviews,2,1,3
576390,True,0,9 user reviews,3,6,9
576400,True,5,Mixed,29,14,43
576410,True,6,Mostly Positive,23,6,29
576420,True,7,Positive,41,0,41
576440,True,2,Very Negative,9,42,51
576470,True,7,Positive,19,4,23
576480,True,0,9 user reviews,4,5,9
576500,True,7,Positive,42,0,42
576520,True,0,1 user reviews,0,1,1
576530,True,0,1 user reviews,0,1,1
576540,True,0,9 user reviews,4,5,9
576570,True,0,No user reviews,0,0,0
576580,True,0,No user reviews,0,0,0
576590,True,4,Mostly Negative,6,10,16
576610,True,0,1 user reviews,1,0,1
576611,True,0,No user reviews,0,0,0
576612,True,0,No user reviews,0,0,0
576613,True,0,No user reviews,0,0,0
576614,True,0,No user reviews,0,0,0
576615,True,0,1 user reviews,1,0,1
576616,True,0,No user reviews,0,0,0
576617,True,0,No user reviews,0,0,0
576620,True,6,Mostly Positive,28,9,37
576640,True,0,No user reviews,0,0,0
576650,True,0,6 user reviews,6,0,6
576660,True,0,2 user reviews,2,0,2
576670,True,0,1 user reviews,1,0,1
576680,True,0,No user reviews,0,0,0
576690,True,0,4 user reviews,1,3,4
576700,True,0,3 user reviews,0,3,3
576720,True,7,Positive,10,2,12
576730,True,6,Mostly Positive,7,3,10
576740,True,0,7 user reviews,7,0,7
576750,True,6,Mostly Positive,15,4,19
576770,True,8,Very Positive,510,39,549
576790,True,0,5 user reviews,4,1,5
576800,True,0,4 user reviews,2,2,4
576810,True,6,Mostly Positive,38,13,51
576820,True,0,3 user reviews,3,0,3
576840,True,7,Positive,11,1,12
576860,True,0,2 user reviews,2,0,2
576900,True,0,No user reviews,0,0,0
576910,True,0,No user reviews,0,0,0
576920,True,0,1 user reviews,1,0,1
576930,True,0,No user reviews,0,0,0
576940,True,0,No user reviews,0,0,0
576950,True,5,Mixed,21,11,32
576960,True,5,Mixed,18,8,26
576970,True,0,1 user reviews,1,0,1
576980,True,7,Positive,23,2,25
576990,True,0,No user reviews,0,0,0
577000,True,0,1 user reviews,1,0,1
577010,True,0,No user reviews,0,0,0
577020,True,0,4 user reviews,4,0,4
577030,True,0,2 user reviews,2,0,2
577080,True,5,Mixed,83,38,121
577100,True,0,1 user reviews,1,0,1
577110,True,0,No user reviews,0,0,0
577120,True,0,2 user reviews,1,1,2
577130,True,0,1 user reviews,1,0,1
577131,True,0,3 user reviews,3,0,3
577150,True,0,3 user reviews,3,0,3
577160,True,0,1 user reviews,1,0,1
577180,True,0,No user reviews,0,0,0
577200,True,0,No user reviews,0,0,0
577210,True,0,4 user reviews,3,1,4
577220,True,0,No user reviews,0,0,0
577230,True,6,Mostly Positive,132,54,186
577240,True,0,No user reviews,0,0,0
577260,True,0,No user reviews,0,0,0
577270,True,0,8 user reviews,8,0,8
577280,True,5,Mixed,6,5,11
577290,True,7,Positive,15,3,18
577310,True,0,2 user reviews,2,0,2
577311,True,0,1 user reviews,1,0,1
577312,True,0,1 user reviews,0,1,1
577320,True,0,2 user reviews,2,0,2
577330,True,0,7 user reviews,2,5,7
577350,True,6,Mostly Positive,106,45,151
577351,True,6,Mostly Positive,27,10,37
577352,True,7,Positive,20,0,20
577353,True,7,Positive,43,6,49
577354,True,6,Mostly Positive,49,21,70
577355,True,8,Very Positive,55,9,64
577356,True,6,Mostly Positive,46,16,62
577357,True,4,Mostly Negative,35,64,99
577358,True,5,Mixed,35,28,63
577359,True,5,Mixed,21,12,33
577360,True,6,Mostly Positive,10,3,13
577370,True,0,1 user reviews,1,0,1
577380,True,0,No user reviews,0,0,0
577390,True,0,No user reviews,0,0,0
577400,True,0,1 user reviews,1,0,1
577401,True,0,2 user reviews,0,2,2
577402,True,0,2 user reviews,2,0,2
577403,True,0,1 user reviews,1,0,1
577404,True,0,2 user reviews,1,1,2
577405,True,0,1 user reviews,1,0,1
577410,True,5,Mixed,110,50,160
577420,True,0,No user reviews,0,0,0
577421,True,0,No user reviews,0,0,0
577422,True,0,No user reviews,0,0,0
577423,True,0,No user reviews,0,0,0
577424,True,0,No user reviews,0,0,0
577425,True,0,No user reviews,0,0,0
577426,True,0,No user reviews,0,0,0
577427,True,0,No user reviews,0,0,0
577428,True,0,No user reviews,0,0,0
577429,True,0,No user reviews,0,0,0
577430,True,0,No user reviews,0,0,0
577431,True,0,No user reviews,0,0,0
577432,True,0,No user reviews,0,0,0
577433,True,0,No user reviews,0,0,0
577434,True,0,No user reviews,0,0,0
577440,True,7,Positive,18,3,21
577450,True,7,Positive,11,0,11
577460,True,5,Mixed,34,44,78
577470,True,6,Mostly Positive,12,5,17
577480,True,8,Very Positive,121,2,123
577490,True,7,Positive,17,1,18
577510,True,0,No user reviews,0,0,0
577511,True,0,No user reviews,0,0,0
577512,True,0,No user reviews,0,0,0
577513,True,0,No user reviews,0,0,0
577514,True,0,No user reviews,0,0,0
577515,True,0,No user reviews,0,0,0
577516,True,0,No user reviews,0,0,0
577517,True,0,No user reviews,0,0,0
577518,True,0,No user reviews,0,0,0
577519,True,0,No user reviews,0,0,0
577520,True,0,No user reviews,0,0,0
577521,True,0,No user reviews,0,0,0
577522,True,0,No user reviews,0,0,0
577530,True,8,Very Positive,81,13,94
577540,True,0,No user reviews,0,0,0
577560,True,0,2 user reviews,2,0,2
577570,True,0,1 user reviews,0,1,1
577580,True,6,Mostly Positive,11,4,15
577590,True,0,No user reviews,0,0,0
577600,True,0,4 user reviews,4,0,4
577610,True,0,No user reviews,0,0,0
577620,True,0,No user reviews,0,0,0
577630,True,0,No user reviews,0,0,0
577640,True,0,1 user reviews,0,1,1
577650,True,0,No user reviews,0,0,0
577670,True,5,Mixed,163,76,239
577690,True,8,Very Positive,521,31,552
577700,True,7,Positive,30,4,34
577710,True,0,No user reviews,0,0,0
577720,True,0,No user reviews,0,0,0
577730,True,6,Mostly Positive,74,24,98
577740,True,5,Mixed,17,12,29
577760,True,0,9 user reviews,9,0,9
577780,True,0,4 user reviews,3,1,4
577800,True,4,Mostly Negative,965,1907,2872
577810,True,0,1 user reviews,1,0,1
577850,True,7,Positive,19,3,22
577890,True,0,6 user reviews,0,6,6
577901,True,8,Very Positive,127,25,152
577910,True,7,Positive,20,0,20
577930,True,0,No user reviews,0,0,0
577940,True,8,Very Positive,1062,97,1159
577970,True,8,Very Positive,69,2,71
577980,True,5,Mixed,5,7,12
577990,True,7,Positive,41,6,47
578000,True,0,No user reviews,0,0,0
578010,True,4,Mostly Negative,3,7,10
578020,True,0,1 user reviews,1,0,1
578030,True,7,Positive,9,2,11
578050,True,0,No user reviews,0,0,0
578060,True,7,Positive,14,0,14
578070,True,0,No user reviews,0,0,0
578080,True,5,Mixed,144242,93342,237584
578110,True,0,No user reviews,0,0,0
578130,True,0,No user reviews,0,0,0
578140,True,0,4 user reviews,0,4,4
578190,True,0,4 user reviews,4,0,4
578210,True,6,Mostly Positive,206,79,285
578240,True,0,No user reviews,0,0,0
578270,True,0,No user reviews,0,0,0
578290,True,0,No user reviews,0,0,0
578300,True,7,Positive,21,0,21
578310,True,6,Mostly Positive,95,38,133
578320,True,7,Positive,10,0,10
578330,True,6,Mostly Positive,466,127,593
578340,True,0,5 user reviews,5,0,5
578350,True,7,Positive,26,6,32
578360,True,0,5 user reviews,3,2,5
578380,True,0,3 user reviews,3,0,3
578390,True,0,6 user reviews,2,4,6
578400,True,0,No user reviews,0,0,0
578410,True,0,No user reviews,0,0,0
578411,True,0,No user reviews,0,0,0
578412,True,0,No user reviews,0,0,0
578413,True,0,No user reviews,0,0,0
578414,True,0,No user reviews,0,0,0
578415,True,0,No user reviews,0,0,0
578420,True,7,Positive,12,0,12
578430,True,7,Positive,38,3,41
578440,True,0,No user reviews,0,0,0
578470,True,0,4 user reviews,4,0,4
578480,True,0,No user reviews,0,0,0
578500,True,0,No user reviews,0,0,0
578510,True,0,No user reviews,0,0,0
578540,True,0,No user reviews,0,0,0
578550,True,0,No user reviews,0,0,0
578560,True,0,3 user reviews,1,2,3
578570,True,0,No user reviews,0,0,0
578590,True,0,5 user reviews,0,5,5
578600,True,0,No user reviews,0,0,0
578610,True,0,7 user reviews,6,1,7
578620,True,9,Overwhelmingly Positive,4669,226,4895
578630,True,0,No user reviews,0,0,0
578650,True,8,Very Positive,1062,228,1290
578660,True,7,Positive,8,2,10
578670,True,0,1 user reviews,1,0,1
578680,True,0,No user reviews,0,0,0
578690,True,7,Positive,9,1,10
578710,True,0,No user reviews,0,0,0
578720,True,5,Mixed,256,125,381
578740,True,0,3 user reviews,1,2,3
578760,True,0,No user reviews,0,0,0
578770,True,0,3 user reviews,3,0,3
578800,True,5,Mixed,7,5,12
578820,True,0,No user reviews,0,0,0
578830,True,5,Mixed,17,11,28
578840,True,0,No user reviews,0,0,0
578850,True,8,Very Positive,186,16,202
578870,True,7,Positive,14,3,17
578880,True,0,5 user reviews,3,2,5
578890,True,0,7 user reviews,7,0,7
578900,True,8,Very Positive,268,11,279
578920,True,0,No user reviews,0,0,0
578930,True,8,Very Positive,97,3,100
578940,True,0,No user reviews,0,0,0
578970,True,0,3 user reviews,2,1,3
578980,True,0,1 user reviews,1,0,1
578990,True,0,6 user reviews,0,6,6
579020,True,5,Mixed,158,68,226
579030,True,0,No user reviews,0,0,0
579040,True,0,No user reviews,0,0,0
579050,True,0,8 user reviews,6,2,8
579080,True,0,1 user reviews,1,0,1
579090,True,0,No user reviews,0,0,0
579100,True,0,1 user reviews,0,1,1
579110,True,8,Very Positive,111,11,122
579120,True,5,Mixed,19,24,43
579130,True,0,8 user reviews,4,4,8
579140,True,0,No user reviews,0,0,0
579150,True,5,Mixed,9,5,14
579160,True,0,2 user reviews,1,1,2
579180,True,8,Very Positive,670,90,760
579210,True,0,8 user reviews,3,5,8
579230,True,7,Positive,31,4,35
579270,True,0,2 user reviews,2,0,2
579320,True,0,7 user reviews,6,1,7
579330,True,0,8 user reviews,1,7,8
579340,True,0,No user reviews,0,0,0
579341,True,0,No user reviews,0,0,0
579350,True,0,No user reviews,0,0,0
579351,True,0,No user reviews,0,0,0
579352,True,0,No user reviews,0,0,0
579353,True,0,No user reviews,0,0,0
579354,True,0,No user reviews,0,0,0
579355,True,0,No user reviews,0,0,0
579356,True,0,No user reviews,0,0,0
579357,True,0,No user reviews,0,0,0
579358,True,0,No user reviews,0,0,0
579359,True,0,No user reviews,0,0,0
579360,True,0,No user reviews,0,0,0
579361,True,0,No user reviews,0,0,0
579370,True,0,No user reviews,0,0,0
579371,True,0,No user reviews,0,0,0
579372,True,0,No user reviews,0,0,0
579373,True,0,No user reviews,0,0,0
579374,True,0,No user reviews,0,0,0
579375,True,0,No user reviews,0,0,0
579380,True,0,No user reviews,0,0,0
579381,True,0,No user reviews,0,0,0
579390,True,0,No user reviews,0,0,0
579391,True,0,No user reviews,0,0,0
579410,True,0,2 user reviews,2,0,2
579420,True,0,No user reviews,0,0,0
579421,True,0,No user reviews,0,0,0
579422,True,0,No user reviews,0,0,0
579423,True,0,No user reviews,0,0,0
579424,True,0,No user reviews,0,0,0
579425,True,0,No user reviews,0,0,0
579426,True,0,No user reviews,0,0,0
579427,True,0,No user reviews,0,0,0
579428,True,0,No user reviews,0,0,0
579429,True,0,No user reviews,0,0,0
579430,True,0,No user reviews,0,0,0
579431,True,0,No user reviews,0,0,0
579432,True,0,No user reviews,0,0,0
579440,True,0,No user reviews,0,0,0
579441,True,0,No user reviews,0,0,0
579442,True,0,No user reviews,0,0,0
579443,True,0,No user reviews,0,0,0
579444,True,0,No user reviews,0,0,0
579445,True,0,No user reviews,0,0,0
579446,True,0,No user reviews,0,0,0
579447,True,0,No user reviews,0,0,0
579448,True,0,No user reviews,0,0,0
579449,True,0,No user reviews,0,0,0
579450,True,0,No user reviews,0,0,0
579451,True,0,No user reviews,0,0,0
579452,True,0,No user reviews,0,0,0
579460,True,0,No user reviews,0,0,0
579470,True,0,No user reviews,0,0,0
579471,True,0,No user reviews,0,0,0
579472,True,0,No user reviews,0,0,0
579473,True,0,No user reviews,0,0,0
579474,True,0,No user reviews,0,0,0
579475,True,0,No user reviews,0,0,0
579480,True,0,No user reviews,0,0,0
579481,True,0,No user reviews,0,0,0
579482,True,0,No user reviews,0,0,0
579483,True,0,No user reviews,0,0,0
579484,True,0,No user reviews,0,0,0
579485,True,0,No user reviews,0,0,0
579490,True,7,Positive,17,4,21
579504,True,0,No user reviews,0,0,0
579505,True,0,No user reviews,0,0,0
579506,True,0,No user reviews,0,0,0
579507,True,0,No user reviews,0,0,0
579508,True,0,No user reviews,0,0,0
579510,True,0,2 user reviews,2,0,2
579520,True,0,No user reviews,0,0,0
579521,True,0,No user reviews,0,0,0
579522,True,0,No user reviews,0,0,0
579523,True,0,No user reviews,0,0,0
579530,True,0,No user reviews,0,0,0
579531,True,0,1 user reviews,1,0,1
579532,True,0,No user reviews,0,0,0
579533,True,0,No user reviews,0,0,0
579534,True,0,No user reviews,0,0,0
579535,True,0,No user reviews,0,0,0
579536,True,0,No user reviews,0,0,0
579537,True,0,No user reviews,0,0,0
579538,True,0,1 user reviews,0,1,1
579539,True,0,No user reviews,0,0,0
579540,True,0,No user reviews,0,0,0
579541,True,0,No user reviews,0,0,0
579550,True,0,No user reviews,0,0,0
579560,True,0,No user reviews,0,0,0
579580,True,0,1 user reviews,0,1,1
579600,True,0,No user reviews,0,0,0
579610,True,0,No user reviews,0,0,0
579620,True,0,No user reviews,0,0,0
579630,True,0,No user reviews,0,0,0
579640,True,0,2 user reviews,2,0,2
579650,True,0,No user reviews,0,0,0
579660,True,0,No user reviews,0,0,0
579680,True,0,No user reviews,0,0,0
579700,True,0,No user reviews,0,0,0
579720,True,6,Mostly Positive,10,4,14
579730,True,0,No user reviews,0,0,0
579740,True,0,No user reviews,0,0,0
579750,True,0,1 user reviews,0,1,1
579760,True,8,Very Positive,164,20,184
579780,True,6,Mostly Positive,15,6,21
579790,True,0,No user reviews,0,0,0
579800,True,0,2 user reviews,0,2,2
579820,True,5,Mixed,87,78,165
579840,True,6,Mostly Positive,103,30,133
579860,True,0,No user reviews,0,0,0
579870,True,0,2 user reviews,0,2,2
579890,True,0,1 user reviews,1,0,1
579920,True,7,Positive,26,4,30
579930,True,4,Mostly Negative,4,10,14
579940,True,8,Very Positive,140,21,161
579950,True,8,Very Positive,619,112,731
579960,True,0,1 user reviews,0,1,1
579970,True,0,No user reviews,0,0,0
579980,True,7,Positive,26,3,29
580010,True,7,Positive,12,2,14
580020,True,4,Mostly Negative,58,141,199
580040,True,5,Mixed,226,131,357
580050,True,0,6 user reviews,2,4,6
580051,True,0,8 user reviews,7,1,8
580060,True,0,No user reviews,0,0,0
580070,True,0,No user reviews,0,0,0
580080,True,0,No user reviews,0,0,0
580081,True,0,8 user reviews,4,4,8
580090,True,0,No user reviews,0,0,0
580100,True,5,Mixed,417,217,634
580110,True,0,No user reviews,0,0,0
580120,True,0,1 user reviews,1,0,1
580160,True,0,2 user reviews,2,0,2
580170,True,8,Very Positive,190,41,231
580180,True,0,9 user reviews,9,0,9
580200,True,8,Very Positive,975,227,1202
580210,True,0,No user reviews,0,0,0
580240,True,0,No user reviews,0,0,0
580250,True,0,No user reviews,0,0,0
580280,True,0,No user reviews,0,0,0
580290,True,0,No user reviews,0,0,0
580300,True,7,Positive,12,1,13
580310,True,0,5 user reviews,5,0,5
580320,True,5,Mixed,6,5,11
580410,True,5,Mixed,6,6,12
580420,True,7,Positive,13,2,15
580430,True,0,No user reviews,0,0,0
580440,True,0,No user reviews,0,0,0
580450,True,0,No user reviews,0,0,0
580460,True,0,No user reviews,0,0,0
580470,True,0,No user reviews,0,0,0
580480,True,0,2 user reviews,2,0,2
580500,True,0,No user reviews,0,0,0
580510,True,0,1 user reviews,1,0,1
580520,True,5,Mixed,14,7,21
580530,True,0,1 user reviews,0,1,1
580540,True,0,1 user reviews,0,1,1
580550,True,0,No user reviews,0,0,0
580560,True,0,2 user reviews,1,1,2
580570,True,0,8 user reviews,5,3,8
580590,True,0,3 user reviews,3,0,3
580600,True,6,Mostly Positive,257,84,341
580610,True,0,No user reviews,0,0,0
580620,True,6,Mostly Positive,23,6,29
580630,True,0,4 user reviews,4,0,4
580640,True,0,No user reviews,0,0,0
580660,True,0,No user reviews,0,0,0
580661,True,0,No user reviews,0,0,0
580680,True,5,Mixed,6,5,11
580700,True,0,1 user reviews,1,0,1
580710,True,6,Mostly Positive,144,56,200
580720,True,8,Very Positive,361,58,419
580730,True,5,Mixed,34,15,49
580731,True,7,Positive,34,3,37
580740,True,0,No user reviews,0,0,0
580760,True,0,No user reviews,0,0,0
580780,True,0,1 user reviews,1,0,1
580790,True,0,No user reviews,0,0,0
580800,True,0,No user reviews,0,0,0
580810,True,0,No user reviews,0,0,0
580820,True,5,Mixed,20,9,29
580830,True,0,3 user reviews,3,0,3
580831,True,0,2 user reviews,2,0,2
580832,True,0,3 user reviews,3,0,3
580833,True,7,Positive,11,0,11
580840,True,0,No user reviews,0,0,0
580850,True,0,No user reviews,0,0,0
580851,True,0,No user reviews,0,0,0
580852,True,0,No user reviews,0,0,0
580853,True,0,No user reviews,0,0,0
580854,True,0,No user reviews,0,0,0
580855,True,0,No user reviews,0,0,0
580856,True,0,No user reviews,0,0,0
580857,True,0,No user reviews,0,0,0
580858,True,0,No user reviews,0,0,0
580859,True,0,No user reviews,0,0,0
580860,True,0,No user reviews,0,0,0
580861,True,0,No user reviews,0,0,0
580870,True,0,8 user reviews,6,2,8
580880,True,0,5 user reviews,2,3,5
580890,True,7,Positive,18,4,22
580900,True,0,No user reviews,0,0,0
580910,True,0,8 user reviews,2,6,8
580920,True,0,No user reviews,0,0,0
580930,True,0,9 user reviews,4,5,9
580940,True,7,Positive,8,2,10
580950,True,0,8 user reviews,1,7,8
581030,True,5,Mixed,24,27,51
581060,True,0,2 user reviews,2,0,2
581080,True,0,No user reviews,0,0,0
581100,True,0,4 user reviews,3,1,4
581120,True,0,No user reviews,0,0,0
581130,True,0,No user reviews,0,0,0
581150,True,0,No user reviews,0,0,0
581200,True,5,Mixed,12,9,21
581210,True,0,3 user reviews,2,1,3
581220,True,4,Mostly Negative,18,41,59
581230,True,5,Mixed,15,10,25
581270,True,8,Very Positive,412,55,467
581300,True,5,Mixed,35,45,80
581310,True,5,Mixed,7,10,17
581320,True,8,Very Positive,24273,4112,28385
581330,True,0,No user reviews,0,0,0
581340,True,0,7 user reviews,4,3,7
581360,True,8,Very Positive,89,6,95
581370,True,5,Mixed,43,26,69
581380,True,0,8 user reviews,5,3,8
581390,True,0,No user reviews,0,0,0
581400,True,0,5 user reviews,5,0,5
581410,True,0,No user reviews,0,0,0
581420,True,0,No user reviews,0,0,0
581450,True,8,Very Positive,724,83,807
581460,True,0,7 user reviews,6,1,7
581490,True,0,No user reviews,0,0,0
581500,True,0,No user reviews,0,0,0
581510,True,0,2 user reviews,2,0,2
581520,True,6,Mostly Positive,42,15,57
581530,True,0,No user reviews,0,0,0
581590,True,6,Mostly Positive,8,3,11
581600,True,0,8 user reviews,4,4,8
581630,True,8,Very Positive,2647,499,3146
581650,True,0,9 user reviews,7,2,9
581660,True,0,No user reviews,0,0,0
581670,True,0,3 user reviews,2,1,3
581710,True,5,Mixed,5,5,10
581730,True,5,Mixed,17,8,25
581740,True,0,3 user reviews,0,3,3
581750,True,0,No user reviews,0,0,0
581760,True,8,Very Positive,71,6,77
581770,True,0,No user reviews,0,0,0
581771,True,0,No user reviews,0,0,0
581772,True,0,No user reviews,0,0,0
581773,True,0,No user reviews,0,0,0
581800,True,7,Positive,10,2,12
581810,True,0,6 user reviews,2,4,6
581820,True,6,Mostly Positive,13,4,17
581830,True,0,No user reviews,0,0,0
581831,True,0,No user reviews,0,0,0
581840,True,0,8 user reviews,8,0,8
581880,True,0,No user reviews,0,0,0
581910,True,6,Mostly Positive,10,3,13
581920,True,0,6 user reviews,2,4,6
581930,True,0,2 user reviews,0,2,2
581940,True,0,No user reviews,0,0,0
581950,True,0,1 user reviews,1,0,1
581951,True,0,No user reviews,0,0,0
581960,True,0,5 user reviews,4,1,5
581970,True,6,Mostly Positive,24,10,34
581980,True,4,Mostly Negative,5,16,21
581990,True,0,1 user reviews,1,0,1
582000,True,0,No user reviews,0,0,0
582010,True,8,Very Positive,52814,6194,59008
582030,True,0,1 user reviews,1,0,1
582040,True,7,Positive,16,1,17
582050,True,5,Mixed,7,6,13
582090,True,0,No user reviews,0,0,0
582100,True,0,No user reviews,0,0,0
582110,True,0,No user reviews,0,0,0
582120,True,0,No user reviews,0,0,0
582130,True,0,No user reviews,0,0,0
582140,True,0,No user reviews,0,0,0
582150,True,0,7 user reviews,4,3,7
582160,True,8,Very Positive,12860,2662,15522
582170,True,0,4 user reviews,3,1,4
582171,True,0,2 user reviews,2,0,2
582172,True,0,2 user reviews,2,0,2
582180,True,0,No user reviews,0,0,0
582200,True,0,4 user reviews,3,1,4
582210,True,7,Positive,17,2,19
582220,True,0,4 user reviews,2,2,4
582230,True,0,1 user reviews,1,0,1
582240,True,0,No user reviews,0,0,0
582260,True,5,Mixed,21,17,38
582270,True,8,Very Positive,1410,268,1678
582280,True,0,9 user reviews,7,2,9
582290,True,0,5 user reviews,1,4,5
582320,True,0,No user reviews,0,0,0
582330,True,8,Very Positive,128,15,143
582350,True,0,4 user reviews,4,0,4
582360,True,0,2 user reviews,2,0,2
582370,True,0,9 user reviews,8,1,9
582380,True,6,Mostly Positive,198,55,253
582390,True,0,3 user reviews,2,1,3
582400,True,0,No user reviews,0,0,0
582420,True,0,No user reviews,0,0,0
582440,True,0,1 user reviews,0,1,1
582450,True,0,No user reviews,0,0,0
582460,True,0,No user reviews,0,0,0
582490,True,0,No user reviews,0,0,0
582500,True,8,Very Positive,806,82,888
582510,True,0,4 user reviews,3,1,4
582520,True,0,No user reviews,0,0,0
582530,True,0,7 user reviews,7,0,7
582540,True,7,Positive,12,1,13
582550,True,8,Very Positive,1189,260,1449
582560,True,8,Very Positive,173,9,182
582570,True,7,Positive,10,2,12
582571,True,7,Positive,13,1,14
582572,True,0,6 user reviews,6,0,6
582573,True,7,Positive,9,2,11
582574,True,0,8 user reviews,5,3,8
582575,True,0,4 user reviews,2,2,4
582576,True,0,1 user reviews,1,0,1
582577,True,4,Mostly Negative,7,17,24
582578,True,0,4 user reviews,3,1,4
582600,True,8,Very Positive,387,53,440
582610,True,0,7 user reviews,3,4,7
582620,True,6,Mostly Positive,39,10,49
582640,True,0,No user reviews,0,0,0
582650,True,0,No user reviews,0,0,0
582660,True,6,Mostly Positive,13341,5203,18544
582670,True,0,No user reviews,0,0,0
582671,True,0,No user reviews,0,0,0
582672,True,0,No user reviews,0,0,0
582673,True,0,No user reviews,0,0,0
582674,True,0,No user reviews,0,0,0
582675,True,0,No user reviews,0,0,0
582676,True,0,No user reviews,0,0,0
582677,True,0,No user reviews,0,0,0
582678,True,0,No user reviews,0,0,0
582679,True,0,No user reviews,0,0,0
582680,True,0,No user reviews,0,0,0
582681,True,0,No user reviews,0,0,0
582700,True,0,No user reviews,0,0,0
582710,True,0,No user reviews,0,0,0
582720,True,0,No user reviews,0,0,0
582740,True,0,1 user reviews,1,0,1
582750,True,0,1 user reviews,0,1,1
582760,True,0,No user reviews,0,0,0
582770,True,0,No user reviews,0,0,0
582780,True,0,No user reviews,0,0,0
582790,True,0,No user reviews,0,0,0
582800,True,0,2 user reviews,2,0,2
582810,True,5,Mixed,44,30,74
582820,True,0,5 user reviews,4,1,5
582830,True,0,No user reviews,0,0,0
582840,True,0,6 user reviews,3,3,6
582860,True,0,No user reviews,0,0,0
582880,True,7,Positive,17,4,21
582890,True,6,Mostly Positive,15,5,20
582900,True,0,No user reviews,0,0,0
582901,True,0,No user reviews,0,0,0
582902,True,0,No user reviews,0,0,0
582903,True,0,No user reviews,0,0,0
582904,True,0,No user reviews,0,0,0
582905,True,0,No user reviews,0,0,0
582906,True,0,No user reviews,0,0,0
582907,True,0,No user reviews,0,0,0
582908,True,0,No user reviews,0,0,0
582909,True,0,No user reviews,0,0,0
582910,True,0,No user reviews,0,0,0
582911,True,0,No user reviews,0,0,0
582912,True,0,No user reviews,0,0,0
582913,True,0,No user reviews,0,0,0
582914,True,0,No user reviews,0,0,0
582915,True,0,No user reviews,0,0,0
582916,True,0,No user reviews,0,0,0
582917,True,0,No user reviews,0,0,0
582920,True,0,5 user reviews,2,3,5
582930,True,0,No user reviews,0,0,0
582960,True,0,6 user reviews,5,1,6
582980,True,7,Positive,12,1,13
582990,True,5,Mixed,12,6,18
583000,True,0,No user reviews,0,0,0
583010,True,8,Very Positive,312,12,324
583020,True,0,No user reviews,0,0,0
583030,True,0,3 user reviews,2,1,3
583040,True,6,Mostly Positive,41,17,58
583050,True,0,No user reviews,0,0,0
583060,True,5,Mixed,5,6,11
583070,True,0,1 user reviews,1,0,1
583090,True,7,Positive,35,4,39
583140,True,7,Positive,21,0,21
583150,True,6,Mostly Positive,14,5,19
583190,True,7,Positive,16,1,17
583200,True,0,6 user reviews,5,1,6
583220,True,0,No user reviews,0,0,0
583230,True,0,No user reviews,0,0,0
583240,True,0,8 user reviews,8,0,8
583260,True,0,No user reviews,0,0,0
583270,True,8,Very Positive,133,9,142
583360,True,0,1 user reviews,1,0,1
583370,True,0,No user reviews,0,0,0
583371,True,0,No user reviews,0,0,0
583372,True,0,No user reviews,0,0,0
583373,True,0,No user reviews,0,0,0
583374,True,0,No user reviews,0,0,0
583375,True,0,No user reviews,0,0,0
583376,True,0,No user reviews,0,0,0
583377,True,0,No user reviews,0,0,0
583378,True,0,No user reviews,0,0,0
583379,True,0,No user reviews,0,0,0
583380,True,0,No user reviews,0,0,0
583381,True,0,No user reviews,0,0,0
583390,True,0,No user reviews,0,0,0
583391,True,0,No user reviews,0,0,0
583392,True,0,No user reviews,0,0,0
583393,True,0,No user reviews,0,0,0
583394,True,0,No user reviews,0,0,0
583395,True,0,No user reviews,0,0,0
583396,True,0,No user reviews,0,0,0
583397,True,0,No user reviews,0,0,0
583398,True,0,No user reviews,0,0,0
583399,True,0,No user reviews,0,0,0
583400,True,0,No user reviews,0,0,0
583401,True,0,No user reviews,0,0,0
583410,True,0,No user reviews,0,0,0
583411,True,0,No user reviews,0,0,0
583412,True,0,No user reviews,0,0,0
583413,True,0,No user reviews,0,0,0
583414,True,0,No user reviews,0,0,0
583415,True,0,No user reviews,0,0,0
583416,True,0,No user reviews,0,0,0
583417,True,0,No user reviews,0,0,0
583418,True,0,No user reviews,0,0,0
583419,True,0,No user reviews,0,0,0
583420,True,0,No user reviews,0,0,0
583421,True,0,No user reviews,0,0,0
583430,True,0,No user reviews,0,0,0
583431,True,0,No user reviews,0,0,0
583434,True,0,No user reviews,0,0,0
583435,True,0,No user reviews,0,0,0
583436,True,0,No user reviews,0,0,0
583437,True,0,No user reviews,0,0,0
583438,True,0,No user reviews,0,0,0
583439,True,0,No user reviews,0,0,0
583440,True,0,No user reviews,0,0,0
583441,True,0,No user reviews,0,0,0
583442,True,0,No user reviews,0,0,0
583443,True,0,No user reviews,0,0,0
583444,True,0,No user reviews,0,0,0
583445,True,0,No user reviews,0,0,0
583446,True,0,No user reviews,0,0,0
583460,True,0,No user reviews,0,0,0
583470,True,8,Very Positive,1034,99,1133
583490,True,5,Mixed,15,8,23
583500,True,0,9 user reviews,7,2,9
583510,True,0,2 user reviews,1,1,2
583520,True,0,No user reviews,0,0,0
583530,True,7,Positive,10,1,11
583570,True,0,1 user reviews,0,1,1
583580,True,0,1 user reviews,0,1,1
583590,True,5,Mixed,22,18,40
583620,True,5,Mixed,17,8,25
583630,True,0,1 user reviews,1,0,1
583631,True,0,No user reviews,0,0,0
583632,True,0,No user reviews,0,0,0
583633,True,0,No user reviews,0,0,0
583634,True,0,No user reviews,0,0,0
583635,True,0,No user reviews,0,0,0
583640,True,7,Positive,38,0,38
583670,True,0,No user reviews,0,0,0
583680,True,0,8 user reviews,7,1,8
583681,True,0,1 user reviews,1,0,1
583690,True,0,3 user reviews,0,3,3
583691,True,0,1 user reviews,1,0,1
583700,True,0,No user reviews,0,0,0
583710,True,0,2 user reviews,2,0,2
583720,True,0,No user reviews,0,0,0
583730,True,6,Mostly Positive,8,3,11
583740,True,0,No user reviews,0,0,0
583760,True,8,Very Positive,230,22,252
583800,True,0,No user reviews,0,0,0
583810,True,7,Positive,15,0,15
583820,True,0,3 user reviews,2,1,3
583821,True,0,1 user reviews,1,0,1
583822,True,0,No user reviews,0,0,0
583823,True,0,No user reviews,0,0,0
583824,True,0,No user reviews,0,0,0
583825,True,0,No user reviews,0,0,0
583826,True,0,No user reviews,0,0,0
583827,True,0,No user reviews,0,0,0
583828,True,0,No user reviews,0,0,0
583829,True,0,No user reviews,0,0,0
583830,True,0,No user reviews,0,0,0
583831,True,0,No user reviews,0,0,0
583832,True,0,No user reviews,0,0,0
583833,True,0,No user reviews,0,0,0
583834,True,0,No user reviews,0,0,0
583835,True,0,No user reviews,0,0,0
583836,True,0,No user reviews,0,0,0
583837,True,0,No user reviews,0,0,0
583838,True,0,No user reviews,0,0,0
583839,True,0,No user reviews,0,0,0
583840,True,0,No user reviews,0,0,0
583841,True,0,No user reviews,0,0,0
583842,True,0,No user reviews,0,0,0
583843,True,0,No user reviews,0,0,0
583844,True,0,No user reviews,0,0,0
583845,True,0,No user reviews,0,0,0
583850,True,5,Mixed,10,5,15
583860,True,0,6 user reviews,5,1,6
583870,True,0,2 user reviews,1,1,2
583890,True,5,Mixed,7,4,11
583930,True,8,Very Positive,131,22,153
583940,True,0,No user reviews,0,0,0
583950,True,5,Mixed,4815,3408,8223
583990,True,0,No user reviews,0,0,0
583991,True,0,No user reviews,0,0,0
583992,True,0,No user reviews,0,0,0
583993,True,0,No user reviews,0,0,0
583994,True,0,No user reviews,0,0,0
584000,True,0,1 user reviews,1,0,1
584001,True,0,No user reviews,0,0,0
584002,True,0,No user reviews,0,0,0
584003,True,0,No user reviews,0,0,0
584004,True,0,No user reviews,0,0,0
584005,True,0,No user reviews,0,0,0
584006,True,0,No user reviews,0,0,0
584007,True,0,No user reviews,0,0,0
584008,True,0,No user reviews,0,0,0
584009,True,0,No user reviews,0,0,0
584010,True,0,No user reviews,0,0,0
584011,True,0,No user reviews,0,0,0
584012,True,0,No user reviews,0,0,0
584013,True,0,No user reviews,0,0,0
584014,True,0,No user reviews,0,0,0
584015,True,0,No user reviews,0,0,0
584016,True,0,No user reviews,0,0,0
584017,True,0,No user reviews,0,0,0
584018,True,0,No user reviews,0,0,0
584019,True,0,No user reviews,0,0,0
584020,True,0,No user reviews,0,0,0
584021,True,0,No user reviews,0,0,0
584022,True,0,No user reviews,0,0,0
584023,True,0,No user reviews,0,0,0
584024,True,0,No user reviews,0,0,0
584025,True,0,No user reviews,0,0,0
584030,True,0,No user reviews,0,0,0
584040,True,0,No user reviews,0,0,0
584050,True,0,1 user reviews,1,0,1
584060,True,0,No user reviews,0,0,0
584070,True,0,No user reviews,0,0,0
584080,True,0,No user reviews,0,0,0
584095,True,5,Mixed,68,40,108
584096,True,6,Mostly Positive,55,21,76
584097,True,8,Very Positive,58,12,70
584100,True,4,Mostly Negative,5,9,14
584120,True,0,No user reviews,0,0,0
584140,True,5,Mixed,289,307,596
584141,True,8,Very Positive,76,5,81
584150,True,5,Mixed,14,8,22
584170,True,0,No user reviews,0,0,0
584180,True,0,1 user reviews,1,0,1
584190,True,0,No user reviews,0,0,0
584191,True,0,1 user reviews,1,0,1
584192,True,0,No user reviews,0,0,0
584200,True,6,Mostly Positive,7,3,10
584210,True,5,Mixed,992,1122,2114
584220,True,0,4 user reviews,4,0,4
584240,True,7,Positive,10,0,10
584250,True,0,No user reviews,0,0,0
584260,True,0,2 user reviews,2,0,2
584270,True,0,No user reviews,0,0,0
584280,True,3,Negative,6,36,42
584310,True,0,No user reviews,0,0,0
584320,True,0,3 user reviews,3,0,3
584330,True,0,No user reviews,0,0,0
584331,True,0,No user reviews,0,0,0
584340,True,0,No user reviews,0,0,0
584341,True,0,No user reviews,0,0,0
584350,True,0,No user reviews,0,0,0
584351,True,0,No user reviews,0,0,0
584352,True,0,No user reviews,0,0,0
584360,True,0,No user reviews,0,0,0
584370,True,5,Mixed,41,20,61
584380,True,0,6 user reviews,6,0,6
584381,True,0,5 user reviews,5,0,5
584382,True,0,2 user reviews,2,0,2
584383,True,0,8 user reviews,8,0,8
584390,True,0,No user reviews,0,0,0
584400,True,8,Very Positive,6548,651,7199
584430,True,0,No user reviews,0,0,0
584431,True,0,No user reviews,0,0,0
584432,True,0,No user reviews,0,0,0
584433,True,0,No user reviews,0,0,0
584434,True,0,No user reviews,0,0,0
584435,True,0,No user reviews,0,0,0
584440,True,0,No user reviews,0,0,0
584441,True,0,No user reviews,0,0,0
584442,True,0,No user reviews,0,0,0
584443,True,0,No user reviews,0,0,0
584444,True,0,No user reviews,0,0,0
584445,True,0,No user reviews,0,0,0
584446,True,0,No user reviews,0,0,0
584447,True,0,No user reviews,0,0,0
584448,True,0,No user reviews,0,0,0
584449,True,0,No user reviews,0,0,0
584450,True,0,No user reviews,0,0,0
584451,True,0,No user reviews,0,0,0
584452,True,0,No user reviews,0,0,0
584460,True,0,No user reviews,0,0,0
584461,True,0,No user reviews,0,0,0
584462,True,0,No user reviews,0,0,0
584463,True,0,No user reviews,0,0,0
584464,True,0,No user reviews,0,0,0
584465,True,0,No user reviews,0,0,0
584466,True,0,No user reviews,0,0,0
584467,True,0,No user reviews,0,0,0
584468,True,0,No user reviews,0,0,0
584469,True,0,No user reviews,0,0,0
584470,True,0,No user reviews,0,0,0
584471,True,0,No user reviews,0,0,0
584472,True,0,No user reviews,0,0,0
584473,True,0,No user reviews,0,0,0
584474,True,0,No user reviews,0,0,0
584475,True,0,No user reviews,0,0,0
584480,True,0,No user reviews,0,0,0
584481,True,0,No user reviews,0,0,0
584482,True,0,No user reviews,0,0,0
584483,True,0,No user reviews,0,0,0
584484,True,0,No user reviews,0,0,0
584485,True,0,No user reviews,0,0,0
584486,True,0,No user reviews,0,0,0
584487,True,0,No user reviews,0,0,0
584488,True,0,No user reviews,0,0,0
584489,True,0,No user reviews,0,0,0
584490,True,0,No user reviews,0,0,0
584491,True,0,No user reviews,0,0,0
584492,True,0,No user reviews,0,0,0
584493,True,0,No user reviews,0,0,0
584494,True,0,No user reviews,0,0,0
584495,True,0,No user reviews,0,0,0
584500,True,0,No user reviews,0,0,0
584501,True,0,No user reviews,0,0,0
584502,True,0,No user reviews,0,0,0
584503,True,0,No user reviews,0,0,0
584504,True,0,No user reviews,0,0,0
584505,True,0,No user reviews,0,0,0
584506,True,0,No user reviews,0,0,0
584507,True,0,1 user reviews,1,0,1
584508,True,0,No user reviews,0,0,0
584509,True,0,No user reviews,0,0,0
584510,True,0,No user reviews,0,0,0
584511,True,0,No user reviews,0,0,0
584512,True,0,No user reviews,0,0,0
584513,True,0,No user reviews,0,0,0
584514,True,0,No user reviews,0,0,0
584515,True,0,No user reviews,0,0,0
584520,True,0,No user reviews,0,0,0
584521,True,0,No user reviews,0,0,0
584522,True,0,No user reviews,0,0,0
584523,True,0,No user reviews,0,0,0
584524,True,0,No user reviews,0,0,0
584525,True,0,No user reviews,0,0,0
584526,True,0,No user reviews,0,0,0
584527,True,0,No user reviews,0,0,0
584528,True,0,No user reviews,0,0,0
584529,True,0,No user reviews,0,0,0
584530,True,0,No user reviews,0,0,0
584531,True,0,No user reviews,0,0,0
584532,True,0,No user reviews,0,0,0
584533,True,0,No user reviews,0,0,0
584534,True,0,No user reviews,0,0,0
584535,True,0,No user reviews,0,0,0
584540,True,0,No user reviews,0,0,0
584541,True,0,No user reviews,0,0,0
584542,True,0,No user reviews,0,0,0
584543,True,0,No user reviews,0,0,0
584544,True,0,No user reviews,0,0,0
584545,True,0,No user reviews,0,0,0
584546,True,0,No user reviews,0,0,0
584547,True,0,No user reviews,0,0,0
584548,True,0,No user reviews,0,0,0
584549,True,0,No user reviews,0,0,0
584550,True,0,No user reviews,0,0,0
584551,True,0,No user reviews,0,0,0
584552,True,0,No user reviews,0,0,0
584553,True,0,No user reviews,0,0,0
584554,True,0,No user reviews,0,0,0
584555,True,0,No user reviews,0,0,0
584570,True,0,1 user reviews,0,1,1
584571,True,0,No user reviews,0,0,0
584572,True,0,No user reviews,0,0,0
584573,True,0,No user reviews,0,0,0
584574,True,0,No user reviews,0,0,0
584575,True,0,No user reviews,0,0,0
584576,True,0,No user reviews,0,0,0
584577,True,0,No user reviews,0,0,0
584578,True,0,No user reviews,0,0,0
584579,True,0,No user reviews,0,0,0
584580,True,0,No user reviews,0,0,0
584581,True,0,No user reviews,0,0,0
584582,True,0,No user reviews,0,0,0
584583,True,0,No user reviews,0,0,0
584584,True,0,No user reviews,0,0,0
584585,True,0,No user reviews,0,0,0
584586,True,0,No user reviews,0,0,0
584587,True,0,No user reviews,0,0,0
584588,True,0,No user reviews,0,0,0
584589,True,0,No user reviews,0,0,0
584590,True,0,1 user reviews,1,0,1
584600,True,0,6 user reviews,4,2,6
584610,True,0,No user reviews,0,0,0
584620,True,0,No user reviews,0,0,0
584630,True,0,1 user reviews,1,0,1
584690,True,0,No user reviews,0,0,0
584700,True,0,No user reviews,0,0,0
584760,True,0,2 user reviews,1,1,2
584770,True,0,4 user reviews,4,0,4
584780,True,3,Negative,1,14,15
584790,True,0,No user reviews,0,0,0
584800,True,6,Mostly Positive,27,9,36
584820,True,0,2 user reviews,0,2,2
584850,True,0,7 user reviews,6,1,7
584860,True,0,2 user reviews,2,0,2
584870,True,0,No user reviews,0,0,0
584880,True,7,Positive,12,0,12
584890,True,5,Mixed,33,20,53
584930,True,8,Very Positive,158,6,164
584940,True,5,Mixed,19,9,28
584950,True,0,No user reviews,0,0,0
584970,True,7,Positive,17,2,19
584980,True,8,Very Positive,934,146,1080
584990,True,8,Very Positive,88,20,108
585000,True,0,No user reviews,0,0,0
585020,True,0,No user reviews,0,0,0
585030,True,0,No user reviews,0,0,0
585040,True,5,Mixed,18,8,26
585060,True,0,No user reviews,0,0,0
585070,True,0,No user reviews,0,0,0
585080,True,5,Mixed,25,30,55
585090,True,4,Mostly Negative,5,8,13
585110,True,0,No user reviews,0,0,0
585120,True,0,No user reviews,0,0,0
585130,True,0,No user reviews,0,0,0
585160,True,0,No user reviews,0,0,0
585170,True,0,No user reviews,0,0,0
585180,True,8,Very Positive,216,2,218
585190,True,8,Very Positive,51,9,60
585210,True,0,No user reviews,0,0,0
585220,True,5,Mixed,6,4,10
585230,True,0,No user reviews,0,0,0
585240,True,7,Positive,21,2,23
585260,True,7,Positive,24,1,25
585270,True,0,No user reviews,0,0,0
585280,True,0,No user reviews,0,0,0
585281,True,0,No user reviews,0,0,0
585282,True,0,No user reviews,0,0,0
585283,True,0,No user reviews,0,0,0
585290,True,5,Mixed,20,14,34
585300,True,0,2 user reviews,2,0,2
585310,True,0,2 user reviews,1,1,2
585320,True,0,No user reviews,0,0,0
585340,True,0,1 user reviews,1,0,1
585360,True,4,Mostly Negative,5,8,13
585380,True,0,No user reviews,0,0,0
585400,True,0,No user reviews,0,0,0
585410,True,8,Very Positive,366,59,425
585420,True,8,Very Positive,2327,234,2561
585430,True,0,9 user reviews,5,4,9
585440,True,0,1 user reviews,1,0,1
585450,True,8,Very Positive,443,96,539
585460,True,0,No user reviews,0,0,0
585472,True,0,No user reviews,0,0,0
585480,True,0,7 user reviews,6,1,7
585481,True,0,4 user reviews,2,2,4
585482,True,0,7 user reviews,6,1,7
585500,True,7,Positive,15,1,16
585530,True,0,No user reviews,0,0,0
585540,True,0,1 user reviews,1,0,1
585550,True,8,Very Positive,549,110,659
585560,True,0,2 user reviews,1,1,2
585590,True,0,No user reviews,0,0,0
585600,True,0,4 user reviews,3,1,4
585610,True,0,2 user reviews,1,1,2
585620,True,5,Mixed,15,7,22
585640,True,0,No user reviews,0,0,0
585650,True,0,No user reviews,0,0,0
585690,True,5,Mixed,153,108,261
585700,True,0,No user reviews,0,0,0
585710,True,8,Very Positive,228,46,274
585730,True,0,No user reviews,0,0,0
585740,True,0,5 user reviews,1,4,5
585750,True,0,2 user reviews,1,1,2
585770,True,0,4 user reviews,3,1,4
585800,True,0,No user reviews,0,0,0
585820,True,0,7 user reviews,2,5,7
585830,True,5,Mixed,32,30,62
585840,True,8,Very Positive,275,66,341
585860,True,3,Negative,0,15,15
585870,True,0,No user reviews,0,0,0
585880,True,7,Positive,15,0,15
585890,True,8,Very Positive,258,16,274
585900,True,6,Mostly Positive,429,137,566
585910,True,8,Very Positive,93,17,110
585920,True,0,7 user reviews,6,1,7
585930,True,0,No user reviews,0,0,0
585940,True,0,2 user reviews,2,0,2
585950,True,8,Very Positive,48,5,53
585970,True,0,1 user reviews,1,0,1
585980,True,0,No user reviews,0,0,0
585990,True,0,7 user reviews,6,1,7
586010,True,0,4 user reviews,3,1,4
586020,True,7,Positive,22,3,25
586030,True,0,2 user reviews,1,1,2
586060,True,5,Mixed,12,6,18
586070,True,0,1 user reviews,1,0,1
586080,True,4,Mostly Negative,6,11,17
586100,True,0,5 user reviews,0,5,5
586110,True,0,No user reviews,0,0,0
586130,True,0,8 user reviews,3,5,8
586140,True,8,Very Positive,1131,77,1208
586150,True,0,8 user reviews,2,6,8
586160,True,0,No user reviews,0,0,0
586170,True,0,4 user reviews,3,1,4
586200,True,5,Mixed,336,166,502
586210,True,5,Mixed,259,113,372
586220,True,0,No user reviews,0,0,0
586230,True,0,9 user reviews,9,0,9
586240,True,8,Very Positive,65,10,75
586300,True,0,No user reviews,0,0,0
586310,True,8,Very Positive,44,11,55
586320,True,7,Positive,14,0,14
586340,True,0,6 user reviews,5,1,6
586350,True,8,Very Positive,84,6,90
586360,True,5,Mixed,13,8,21
586370,True,0,No user reviews,0,0,0
586380,True,0,6 user reviews,3,3,6
586390,True,7,Positive,33,1,34
586410,True,0,2 user reviews,2,0,2
586420,True,0,5 user reviews,5,0,5
586430,True,0,3 user reviews,2,1,3
586450,True,0,9 user reviews,9,0,9
586460,True,0,8 user reviews,4,4,8
586490,True,0,1 user reviews,1,0,1
586500,True,0,No user reviews,0,0,0
586510,True,0,No user reviews,0,0,0
586560,True,0,2 user reviews,2,0,2
586570,True,0,3 user reviews,2,1,3
586600,True,0,8 user reviews,1,7,8
586620,True,0,9 user reviews,3,6,9
586660,True,7,Positive,19,1,20
586670,True,0,8 user reviews,7,1,8
586680,True,0,6 user reviews,1,5,6
586690,True,0,3 user reviews,3,0,3
586700,True,0,2 user reviews,1,1,2
586710,True,0,5 user reviews,3,2,5
586720,True,0,1 user reviews,1,0,1
586730,True,0,No user reviews,0,0,0
586731,True,0,No user reviews,0,0,0
586732,True,0,No user reviews,0,0,0
586740,True,0,2 user reviews,2,0,2
586750,True,5,Mixed,136,82,218
586760,True,0,No user reviews,0,0,0
586770,True,7,Positive,9,2,11
586780,True,0,No user reviews,0,0,0
586790,True,0,9 user reviews,1,8,9
586830,True,6,Mostly Positive,10,4,14
586870,True,0,No user reviews,0,0,0
586880,True,8,Very Positive,123,7,130
586890,True,0,1 user reviews,0,1,1
586900,True,0,No user reviews,0,0,0
586910,True,5,Mixed,9,7,16
586920,True,6,Mostly Positive,7,3,10
586930,True,0,5 user reviews,2,3,5
586940,True,0,1 user reviews,0,1,1
586950,True,6,Mostly Positive,170,51,221
586960,True,8,Very Positive,99,24,123
586970,True,5,Mixed,34,18,52
586980,True,5,Mixed,7,10,17
586990,True,0,5 user reviews,5,0,5
587000,True,8,Very Positive,220,48,268
587010,True,0,2 user reviews,0,2,2
587020,True,0,No user reviews,0,0,0
587030,True,0,No user reviews,0,0,0
587060,True,0,No user reviews,0,0,0
587070,True,0,6 user reviews,4,2,6
587080,True,0,No user reviews,0,0,0
587100,True,8,Very Positive,170,16,186
587110,True,8,Very Positive,178,12,190
587120,True,0,No user reviews,0,0,0
587150,True,0,No user reviews,0,0,0
587160,True,0,No user reviews,0,0,0
587170,True,0,1 user reviews,1,0,1
587180,True,7,Positive,30,7,37
587200,True,0,2 user reviews,2,0,2
587210,True,0,9 user reviews,5,4,9
587220,True,9,Overwhelmingly Positive,896,37,933
587230,True,0,No user reviews,0,0,0
587260,True,8,Very Positive,418,48,466
587270,True,0,No user reviews,0,0,0
587290,True,7,Positive,9,1,10
587310,True,7,Positive,21,0,21
587330,True,0,4 user reviews,1,3,4
587340,True,0,No user reviews,0,0,0
587390,True,0,2 user reviews,1,1,2
587400,True,6,Mostly Positive,12,4,16
587410,True,0,5 user reviews,3,2,5
587411,True,0,No user reviews,0,0,0
587412,True,0,No user reviews,0,0,0
587413,True,0,No user reviews,0,0,0
587414,True,0,1 user reviews,1,0,1
587420,True,5,Mixed,83,40,123
587430,True,8,Very Positive,901,50,951
587440,True,7,Positive,11,2,13
587450,True,5,Mixed,422,282,704
587460,True,0,No user reviews,0,0,0
587470,True,8,Very Positive,195,7,202
587480,True,0,No user reviews,0,0,0
587490,True,5,Mixed,8,6,14
587500,True,0,3 user reviews,2,1,3
587510,True,0,No user reviews,0,0,0
587540,True,0,No user reviews,0,0,0
587550,True,0,No user reviews,0,0,0
587560,True,0,7 user reviews,6,1,7
587570,True,0,No user reviews,0,0,0
587580,True,8,Very Positive,148,21,169
587600,True,0,No user reviews,0,0,0
587610,True,0,No user reviews,0,0,0
587620,True,8,Very Positive,2166,145,2311
587640,True,0,No user reviews,0,0,0
587650,True,0,No user reviews,0,0,0
587660,True,0,1 user reviews,1,0,1
587670,True,0,No user reviews,0,0,0
587690,True,0,4 user reviews,2,2,4
587700,True,0,No user reviews,0,0,0
587710,True,0,1 user reviews,1,0,1
587730,True,0,7 user reviews,6,1,7
587740,True,0,No user reviews,0,0,0
587780,True,0,1 user reviews,1,0,1
587790,True,0,2 user reviews,0,2,2
587800,True,0,No user reviews,0,0,0
587810,True,4,Mostly Negative,9,21,30
587820,True,0,1 user reviews,1,0,1
587840,True,6,Mostly Positive,12,4,16
587860,True,8,Very Positive,43,7,50
587880,True,0,No user reviews,0,0,0
587881,True,0,No user reviews,0,0,0
587882,True,0,No user reviews,0,0,0
587890,True,0,No user reviews,0,0,0
587891,True,0,No user reviews,0,0,0
587910,True,0,No user reviews,0,0,0
587920,True,6,Mostly Positive,20,8,28
587930,True,6,Mostly Positive,19,6,25
587970,True,0,8 user reviews,6,2,8
587980,True,0,No user reviews,0,0,0
587990,True,0,No user reviews,0,0,0
588010,True,0,5 user reviews,5,0,5
588030,True,8,Very Positive,859,63,922
588040,True,8,Very Positive,161,25,186
588050,True,0,2 user reviews,1,1,2
588070,True,0,7 user reviews,2,5,7
588080,True,0,4 user reviews,2,2,4
588110,True,6,Mostly Positive,85,22,107
588120,True,6,Mostly Positive,19,8,27
588130,True,0,No user reviews,0,0,0
588140,True,0,1 user reviews,0,1,1
588150,True,0,1 user reviews,1,0,1
588160,True,5,Mixed,51,58,109
588180,True,7,Positive,17,0,17
588190,True,5,Mixed,258,133,391
588200,True,0,4 user reviews,4,0,4
588220,True,0,No user reviews,0,0,0
588230,True,6,Mostly Positive,31,8,39
588240,True,8,Very Positive,81,16,97
588260,True,0,2 user reviews,2,0,2
588261,True,0,No user reviews,0,0,0
588262,True,0,No user reviews,0,0,0
588263,True,0,1 user reviews,1,0,1
588270,True,0,8 user reviews,3,5,8
588280,True,0,1 user reviews,1,0,1
588290,True,7,Positive,28,1,29
588300,True,0,5 user reviews,4,1,5
588301,True,0,No user reviews,0,0,0
588310,True,7,Positive,25,2,27
588340,True,5,Mixed,16,13,29
588350,True,0,2 user reviews,1,1,2
588390,True,0,No user reviews,0,0,0
588410,True,5,Mixed,19,11,30
588430,True,0,No user reviews,0,0,0
588440,True,5,Mixed,21,10,31
588480,True,0,No user reviews,0,0,0
588490,True,7,Positive,9,1,10
588510,True,0,No user reviews,0,0,0
588530,True,0,1 user reviews,1,0,1
588540,True,7,Positive,9,1,10
588550,True,0,3 user reviews,1,2,3
588560,True,5,Mixed,21,16,37
588570,True,0,3 user reviews,1,2,3
588580,True,0,No user reviews,0,0,0
588600,True,7,Positive,14,0,14
588620,True,7,Positive,13,1,14
588630,True,6,Mostly Positive,11,4,15
588650,True,9,Overwhelmingly Positive,17023,674,17697
588660,True,8,Very Positive,120,2,122
588670,True,0,No user reviews,0,0,0
588690,True,8,Very Positive,192,23,215
588710,True,5,Mixed,8,7,15
588720,True,0,1 user reviews,0,1,1
588730,True,8,Very Positive,189,11,200
588740,True,0,No user reviews,0,0,0
588750,True,5,Mixed,5,6,11
588780,True,0,No user reviews,0,0,0
588790,True,0,1 user reviews,1,0,1
588800,True,0,6 user reviews,3,3,6
588810,True,0,No user reviews,0,0,0
588830,True,0,2 user reviews,2,0,2
588840,True,0,1 user reviews,1,0,1
588870,True,0,No user reviews,0,0,0
588880,True,0,5 user reviews,4,1,5
588890,True,5,Mixed,7,4,11
588920,True,5,Mixed,13,12,25
588930,True,0,No user reviews,0,0,0
588950,True,8,Very Positive,615,72,687
588960,True,0,9 user reviews,9,0,9
588961,True,0,1 user reviews,1,0,1
588962,True,0,5 user reviews,4,1,5
588963,True,7,Positive,21,2,23
588964,True,0,1 user reviews,1,0,1
588970,True,8,Very Positive,192,25,217
588980,True,0,5 user reviews,4,1,5
588990,True,6,Mostly Positive,9,3,12
589010,True,0,No user reviews,0,0,0
589021,True,0,2 user reviews,2,0,2
589040,True,7,Positive,42,4,46
589060,True,7,Positive,13,1,14
589080,True,0,3 user reviews,2,1,3
589090,True,0,No user reviews,0,0,0
589100,True,7,Positive,11,2,13
589110,True,5,Mixed,7,7,14
589120,True,0,No user reviews,0,0,0
589130,True,0,No user reviews,0,0,0
589140,True,0,1 user reviews,1,0,1
589141,True,0,1 user reviews,1,0,1
589142,True,0,1 user reviews,1,0,1
589150,True,0,9 user reviews,5,4,9
589160,True,0,5 user reviews,3,2,5
589170,True,0,4 user reviews,2,2,4
589190,True,7,Positive,9,1,10
589200,True,8,Very Positive,173,8,181
589220,True,0,9 user reviews,8,1,9
589230,True,0,No user reviews,0,0,0
589250,True,5,Mixed,26,12,38
589260,True,0,4 user reviews,1,3,4
589270,True,0,4 user reviews,4,0,4
589280,True,7,Positive,25,0,25
589290,True,8,Very Positive,5885,732,6617
589300,True,0,8 user reviews,3,5,8
589310,True,0,No user reviews,0,0,0
589320,True,6,Mostly Positive,31,13,44
589330,True,0,No user reviews,0,0,0
589360,True,8,Very Positive,2251,446,2697
589380,True,0,6 user reviews,4,2,6
589410,True,0,6 user reviews,4,2,6
589420,True,8,Very Positive,56,8,64
589430,True,0,6 user reviews,1,5,6
589450,True,0,No user reviews,0,0,0
589460,True,0,No user reviews,0,0,0
589470,True,7,Positive,13,3,16
589480,True,7,Positive,28,3,31
589500,True,8,Very Positive,94,6,100
589510,True,8,Very Positive,134,12,146
589530,True,8,Very Positive,263,37,300
589590,True,8,Very Positive,2417,129,2546
589600,True,0,No user reviews,0,0,0
589610,True,0,No user reviews,0,0,0
589620,True,6,Mostly Positive,11,4,15
589640,True,7,Positive,27,6,33
589650,True,0,1 user reviews,1,0,1
589651,True,0,1 user reviews,1,0,1
589670,True,7,Positive,19,4,23
589680,True,0,4 user reviews,4,0,4
589690,True,6,Mostly Positive,13,5,18
589700,True,0,No user reviews,0,0,0
589730,True,5,Mixed,8,6,14
589740,True,5,Mixed,9,12,21
589760,True,8,Very Positive,165,39,204
589770,True,7,Positive,10,1,11
589780,True,8,Very Positive,1609,166,1775
589790,True,0,No user reviews,0,0,0
589840,True,0,No user reviews,0,0,0
589850,True,0,6 user reviews,6,0,6
589860,True,8,Very Positive,70,4,74
589870,True,0,No user reviews,0,0,0
589880,True,6,Mostly Positive,42,13,55
589890,True,0,No user reviews,0,0,0
589900,True,5,Mixed,6,4,10
589910,True,0,2 user reviews,1,1,2
589920,True,0,9 user reviews,3,6,9
589930,True,0,6 user reviews,4,2,6
589940,True,0,No user reviews,0,0,0
589950,True,0,No user reviews,0,0,0
590160,True,0,No user reviews,0,0,0
590161,True,0,No user reviews,0,0,0
590162,True,0,No user reviews,0,0,0
590170,True,0,1 user reviews,1,0,1
590171,True,0,No user reviews,0,0,0
590172,True,0,1 user reviews,1,0,1
590173,True,0,No user reviews,0,0,0
590174,True,0,No user reviews,0,0,0
590175,True,0,1 user reviews,1,0,1
590176,True,0,No user reviews,0,0,0
590177,True,0,No user reviews,0,0,0
590178,True,0,No user reviews,0,0,0
590179,True,0,No user reviews,0,0,0
590180,True,0,No user reviews,0,0,0
590181,True,0,No user reviews,0,0,0
590182,True,0,No user reviews,0,0,0
590183,True,0,No user reviews,0,0,0
590184,True,0,No user reviews,0,0,0
590185,True,0,No user reviews,0,0,0
590186,True,0,No user reviews,0,0,0
590187,True,0,No user reviews,0,0,0
590188,True,0,1 user reviews,0,1,1
590189,True,0,No user reviews,0,0,0
590190,True,0,No user reviews,0,0,0
590191,True,0,No user reviews,0,0,0
590192,True,0,1 user reviews,1,0,1
590193,True,0,No user reviews,0,0,0
590194,True,0,No user reviews,0,0,0
590195,True,0,No user reviews,0,0,0
590196,True,0,No user reviews,0,0,0
590197,True,0,No user reviews,0,0,0
590198,True,0,No user reviews,0,0,0
590199,True,0,No user reviews,0,0,0
590200,True,0,No user reviews,0,0,0
590201,True,0,2 user reviews,0,2,2
590202,True,0,No user reviews,0,0,0
590203,True,0,No user reviews,0,0,0
590204,True,0,No user reviews,0,0,0
590205,True,0,3 user reviews,2,1,3
590206,True,0,No user reviews,0,0,0
590207,True,0,No user reviews,0,0,0
590208,True,0,No user reviews,0,0,0
590209,True,0,1 user reviews,0,1,1
590210,True,0,No user reviews,0,0,0
590211,True,0,No user reviews,0,0,0
590212,True,0,No user reviews,0,0,0
590213,True,0,No user reviews,0,0,0
590214,True,0,No user reviews,0,0,0
590215,True,0,1 user reviews,1,0,1
590216,True,0,1 user reviews,1,0,1
590217,True,0,No user reviews,0,0,0
590218,True,0,1 user reviews,0,1,1
590219,True,0,No user reviews,0,0,0
590220,True,0,No user reviews,0,0,0
590221,True,0,No user reviews,0,0,0
590222,True,0,2 user reviews,2,0,2
590223,True,0,No user reviews,0,0,0
590224,True,0,No user reviews,0,0,0
590225,True,0,No user reviews,0,0,0
590226,True,0,No user reviews,0,0,0
590227,True,0,No user reviews,0,0,0
590228,True,0,No user reviews,0,0,0
590229,True,0,No user reviews,0,0,0
590230,True,0,No user reviews,0,0,0
590231,True,0,No user reviews,0,0,0
590232,True,0,No user reviews,0,0,0
590233,True,0,No user reviews,0,0,0
590234,True,0,No user reviews,0,0,0
590235,True,0,No user reviews,0,0,0
590236,True,0,No user reviews,0,0,0
590237,True,0,No user reviews,0,0,0
590238,True,0,No user reviews,0,0,0
590239,True,0,1 user reviews,0,1,1
590240,True,0,No user reviews,0,0,0
590241,True,0,No user reviews,0,0,0
590242,True,0,1 user reviews,1,0,1
590243,True,0,No user reviews,0,0,0
590244,True,0,No user reviews,0,0,0
590245,True,0,1 user reviews,1,0,1
590246,True,0,No user reviews,0,0,0
590247,True,0,No user reviews,0,0,0
590248,True,0,No user reviews,0,0,0
590249,True,0,No user reviews,0,0,0
590250,True,4,Mostly Negative,4,8,12
590260,True,0,No user reviews,0,0,0
590270,True,0,5 user reviews,2,3,5
590280,True,7,Positive,13,0,13
590290,True,0,1 user reviews,1,0,1
590350,True,0,No user reviews,0,0,0
590360,True,0,1 user reviews,0,1,1
590361,True,0,No user reviews,0,0,0
590370,True,0,7 user reviews,4,3,7
590380,True,8,Very Positive,5893,407,6300
590390,True,7,Positive,17,0,17
590391,True,0,8 user reviews,7,1,8
590400,True,0,No user reviews,0,0,0
590410,True,0,No user reviews,0,0,0
590430,True,0,4 user reviews,2,2,4
590440,True,0,No user reviews,0,0,0
590460,True,0,6 user reviews,6,0,6
590470,True,0,1 user reviews,1,0,1
590480,True,0,No user reviews,0,0,0
590490,True,0,1 user reviews,1,0,1
590500,True,0,No user reviews,0,0,0
590510,True,8,Very Positive,53,13,66
590530,True,6,Mostly Positive,9,3,12
590540,True,0,No user reviews,0,0,0
590560,True,0,No user reviews,0,0,0
590570,True,0,1 user reviews,0,1,1
590580,True,4,Mostly Negative,4,7,11
590590,True,8,Very Positive,149,7,156
590600,True,0,No user reviews,0,0,0
590610,True,7,Positive,17,0,17
590630,True,0,No user reviews,0,0,0
590640,True,0,No user reviews,0,0,0
590650,True,0,No user reviews,0,0,0
590660,True,0,5 user reviews,3,2,5
590670,True,0,No user reviews,0,0,0
590690,True,8,Very Positive,372,58,430
590720,True,7,Positive,29,5,34
590740,True,0,No user reviews,0,0,0
590750,True,0,8 user reviews,6,2,8
590760,True,0,No user reviews,0,0,0
590770,True,0,1 user reviews,0,1,1
590780,True,7,Positive,15,1,16
590790,True,0,No user reviews,0,0,0
590800,True,0,No user reviews,0,0,0
590810,True,0,No user reviews,0,0,0
590820,True,0,4 user reviews,3,1,4
590840,True,0,7 user reviews,6,1,7
590850,True,7,Positive,13,3,16
590860,True,0,8 user reviews,6,2,8
590870,True,4,Mostly Negative,4,9,13
590880,True,0,No user reviews,0,0,0
590881,True,0,No user reviews,0,0,0
590882,True,0,No user reviews,0,0,0
590883,True,0,No user reviews,0,0,0
590884,True,0,No user reviews,0,0,0
590910,True,0,No user reviews,0,0,0
590940,True,6,Mostly Positive,12,4,16
590950,True,7,Positive,33,0,33
590970,True,4,Mostly Negative,23,49,72
591000,True,8,Very Positive,49,8,57
591020,True,0,No user reviews,0,0,0
591030,True,0,No user reviews,0,0,0
591040,True,0,No user reviews,0,0,0
591050,True,0,No user reviews,0,0,0
591060,True,0,No user reviews,0,0,0
591061,True,0,No user reviews,0,0,0
591062,True,0,No user reviews,0,0,0
591063,True,0,No user reviews,0,0,0
591070,True,0,No user reviews,0,0,0
591090,True,0,2 user reviews,2,0,2
591121,True,0,No user reviews,0,0,0
591130,True,0,4 user reviews,2,2,4
591140,True,0,No user reviews,0,0,0
591150,True,0,No user reviews,0,0,0
591160,True,0,No user reviews,0,0,0
591170,True,0,No user reviews,0,0,0
591171,True,0,No user reviews,0,0,0
591172,True,0,No user reviews,0,0,0
591180,True,0,No user reviews,0,0,0
591181,True,0,No user reviews,0,0,0
591190,True,0,No user reviews,0,0,0
591191,True,0,No user reviews,0,0,0
591192,True,0,No user reviews,0,0,0
591193,True,0,No user reviews,0,0,0
591194,True,0,No user reviews,0,0,0
591195,True,0,No user reviews,0,0,0
591196,True,0,No user reviews,0,0,0
591197,True,0,No user reviews,0,0,0
591198,True,0,No user reviews,0,0,0
591199,True,0,No user reviews,0,0,0
591200,True,0,No user reviews,0,0,0
591201,True,0,No user reviews,0,0,0
591202,True,0,No user reviews,0,0,0
591203,True,0,No user reviews,0,0,0
591204,True,0,No user reviews,0,0,0
591205,True,0,No user reviews,0,0,0
591206,True,0,No user reviews,0,0,0
591207,True,0,No user reviews,0,0,0
591208,True,0,No user reviews,0,0,0
591209,True,0,No user reviews,0,0,0
591210,True,0,No user reviews,0,0,0
591211,True,0,No user reviews,0,0,0
591212,True,0,No user reviews,0,0,0
591213,True,0,No user reviews,0,0,0
591214,True,0,No user reviews,0,0,0
591215,True,0,No user reviews,0,0,0
591216,True,0,No user reviews,0,0,0
591217,True,0,No user reviews,0,0,0
591218,True,0,No user reviews,0,0,0
591219,True,0,No user reviews,0,0,0
591220,True,0,No user reviews,0,0,0
591221,True,0,No user reviews,0,0,0
591222,True,0,No user reviews,0,0,0
591223,True,0,No user reviews,0,0,0
591224,True,0,No user reviews,0,0,0
591225,True,0,No user reviews,0,0,0
591226,True,0,No user reviews,0,0,0
591227,True,0,No user reviews,0,0,0
591228,True,0,No user reviews,0,0,0
591229,True,0,No user reviews,0,0,0
591230,True,0,No user reviews,0,0,0
591231,True,0,No user reviews,0,0,0
591240,True,0,No user reviews,0,0,0
591241,True,0,No user reviews,0,0,0
591242,True,0,No user reviews,0,0,0
591243,True,0,No user reviews,0,0,0
591244,True,0,No user reviews,0,0,0
591245,True,0,No user reviews,0,0,0
591246,True,0,No user reviews,0,0,0
591247,True,0,No user reviews,0,0,0
591248,True,0,No user reviews,0,0,0
591249,True,0,No user reviews,0,0,0
591250,True,0,No user reviews,0,0,0
591251,True,0,No user reviews,0,0,0
591252,True,0,No user reviews,0,0,0
591253,True,0,No user reviews,0,0,0
591254,True,0,No user reviews,0,0,0
591255,True,0,No user reviews,0,0,0
591256,True,0,No user reviews,0,0,0
591257,True,0,No user reviews,0,0,0
591258,True,0,No user reviews,0,0,0
591259,True,0,No user reviews,0,0,0
591260,True,0,No user reviews,0,0,0
591280,True,0,No user reviews,0,0,0
591281,True,0,No user reviews,0,0,0
591282,True,0,No user reviews,0,0,0
591283,True,0,No user reviews,0,0,0
591284,True,0,No user reviews,0,0,0
591285,True,0,No user reviews,0,0,0
591286,True,0,No user reviews,0,0,0
591287,True,0,No user reviews,0,0,0
591288,True,0,No user reviews,0,0,0
591289,True,0,No user reviews,0,0,0
591290,True,0,No user reviews,0,0,0
591291,True,0,No user reviews,0,0,0
591292,True,0,No user reviews,0,0,0
591293,True,0,No user reviews,0,0,0
591294,True,0,No user reviews,0,0,0
591295,True,0,No user reviews,0,0,0
591296,True,0,No user reviews,0,0,0
591297,True,0,No user reviews,0,0,0
591298,True,0,No user reviews,0,0,0
591299,True,0,No user reviews,0,0,0
591300,True,0,No user reviews,0,0,0
591301,True,0,No user reviews,0,0,0
591302,True,0,No user reviews,0,0,0
591303,True,0,No user reviews,0,0,0
591304,True,0,No user reviews,0,0,0
591305,True,0,No user reviews,0,0,0
591306,True,0,No user reviews,0,0,0
591307,True,0,No user reviews,0,0,0
591308,True,0,No user reviews,0,0,0
591309,True,0,No user reviews,0,0,0
591310,True,0,No user reviews,0,0,0
591311,True,0,No user reviews,0,0,0
591312,True,0,No user reviews,0,0,0
591313,True,0,No user reviews,0,0,0
591314,True,0,No user reviews,0,0,0
591315,True,0,No user reviews,0,0,0
591316,True,0,No user reviews,0,0,0
591317,True,0,No user reviews,0,0,0
591320,True,0,No user reviews,0,0,0
591330,True,0,No user reviews,0,0,0
591331,True,0,No user reviews,0,0,0
591332,True,0,No user reviews,0,0,0
591333,True,0,No user reviews,0,0,0
591334,True,0,No user reviews,0,0,0
591335,True,0,No user reviews,0,0,0
591336,True,0,No user reviews,0,0,0
591337,True,0,No user reviews,0,0,0
591338,True,0,No user reviews,0,0,0
591339,True,0,No user reviews,0,0,0
591340,True,0,No user reviews,0,0,0
591350,True,7,Positive,17,1,18
591360,True,0,No user reviews,0,0,0
591370,True,8,Very Positive,1356,224,1580
591380,True,8,Very Positive,238,39,277
591390,True,0,No user reviews,0,0,0
591420,True,8,Very Positive,529,56,585
591430,True,0,No user reviews,0,0,0
591460,True,9,Overwhelmingly Positive,945,42,987
591470,True,0,3 user reviews,2,1,3
591480,True,0,2 user reviews,0,2,2
591490,True,0,1 user reviews,0,1,1
591491,True,0,1 user reviews,1,0,1
591492,True,0,1 user reviews,1,0,1
591493,True,0,1 user reviews,0,1,1
591494,True,0,1 user reviews,1,0,1
591495,True,0,1 user reviews,1,0,1
591496,True,0,1 user reviews,1,0,1
591497,True,0,1 user reviews,1,0,1
591498,True,0,1 user reviews,1,0,1
591499,True,0,2 user reviews,0,2,2
591500,True,0,1 user reviews,0,1,1
591501,True,0,2 user reviews,2,0,2
591502,True,0,1 user reviews,1,0,1
591503,True,0,2 user reviews,2,0,2
591504,True,0,No user reviews,0,0,0
591505,True,0,No user reviews,0,0,0
591506,True,0,No user reviews,0,0,0
591507,True,0,No user reviews,0,0,0
591508,True,0,No user reviews,0,0,0
591509,True,0,2 user reviews,2,0,2
591510,True,0,No user reviews,0,0,0
591511,True,0,No user reviews,0,0,0
591512,True,0,No user reviews,0,0,0
591513,True,0,No user reviews,0,0,0
591514,True,0,No user reviews,0,0,0
591520,True,0,No user reviews,0,0,0
591530,True,5,Mixed,159,72,231
591560,True,7,Positive,22,4,26
591580,True,0,5 user reviews,2,3,5
591590,True,0,No user reviews,0,0,0
591600,True,0,No user reviews,0,0,0
591610,True,0,2 user reviews,1,1,2
591620,True,0,3 user reviews,3,0,3
591630,True,8,Very Positive,54,7,61
591640,True,0,1 user reviews,1,0,1
591660,True,0,6 user reviews,3,3,6
591680,True,0,No user reviews,0,0,0
591690,True,0,No user reviews,0,0,0
591710,True,5,Mixed,90,39,129
591720,True,0,No user reviews,0,0,0
591730,True,0,No user reviews,0,0,0
591740,True,0,No user reviews,0,0,0
591750,True,7,Positive,21,2,23
591760,True,7,Positive,19,1,20
591770,True,0,No user reviews,0,0,0
591771,True,0,No user reviews,0,0,0
591772,True,0,No user reviews,0,0,0
591773,True,0,No user reviews,0,0,0
591774,True,0,No user reviews,0,0,0
591775,True,0,No user reviews,0,0,0
591776,True,0,No user reviews,0,0,0
591777,True,0,No user reviews,0,0,0
591778,True,0,No user reviews,0,0,0
591779,True,0,No user reviews,0,0,0
591780,True,0,No user reviews,0,0,0
591781,True,0,No user reviews,0,0,0
591790,True,5,Mixed,68,62,130
591800,True,5,Mixed,74,87,161
591810,True,0,7 user reviews,3,4,7
591811,True,0,No user reviews,0,0,0
591812,True,0,4 user reviews,4,0,4
591813,True,0,4 user reviews,4,0,4
591820,True,0,No user reviews,0,0,0
591870,True,0,No user reviews,0,0,0
591871,True,0,No user reviews,0,0,0
591872,True,0,No user reviews,0,0,0
591880,True,0,No user reviews,0,0,0
591890,True,0,No user reviews,0,0,0
591900,True,0,No user reviews,0,0,0
591910,True,5,Mixed,10,8,18
591920,True,0,5 user reviews,4,1,5
591930,True,5,Mixed,12,7,19
591940,True,0,No user reviews,0,0,0
591960,True,0,No user reviews,0,0,0
591970,True,0,7 user reviews,6,1,7
591971,True,0,1 user reviews,1,0,1
591980,True,0,3 user reviews,3,0,3
591981,True,0,1 user reviews,0,1,1
591982,True,0,1 user reviews,0,1,1
591983,True,0,1 user reviews,1,0,1
591984,True,0,7 user reviews,6,1,7
591985,True,0,4 user reviews,3,1,4
591986,True,0,6 user reviews,4,2,6
591987,True,0,No user reviews,0,0,0
591990,True,0,9 user reviews,5,4,9
592020,True,0,9 user reviews,8,1,9
592030,True,6,Mostly Positive,95,25,120
592040,True,0,3 user reviews,3,0,3
592060,True,0,7 user reviews,1,6,7
592100,True,7,Positive,16,3,19
592110,True,0,No user reviews,0,0,0
592120,True,0,7 user reviews,5,2,7
592130,True,0,1 user reviews,1,0,1
592200,True,0,7 user reviews,6,1,7
592210,True,0,No user reviews,0,0,0
592240,True,7,Positive,9,1,10
592260,True,8,Very Positive,1118,160,1278
592270,True,7,Positive,12,0,12
592290,True,0,4 user reviews,3,1,4
592291,True,0,2 user reviews,2,0,2
592292,True,0,3 user reviews,2,1,3
592300,True,7,Positive,27,2,29
592310,True,6,Mostly Positive,9,3,12
592320,True,5,Mixed,5,7,12
592330,True,0,8 user reviews,5,3,8
592340,True,5,Mixed,15,21,36
592350,True,7,Positive,10,0,10
592360,True,0,1 user reviews,0,1,1
592372,True,4,Mostly Negative,40,81,121
592373,True,8,Very Positive,75,7,82
592374,True,6,Mostly Positive,71,24,95
592380,True,0,No user reviews,0,0,0
592390,True,5,Mixed,21,15,36
592400,True,0,8 user reviews,8,0,8
592410,True,5,Mixed,13,10,23
592420,True,0,No user reviews,0,0,0
592421,True,0,No user reviews,0,0,0
592422,True,0,No user reviews,0,0,0
592423,True,0,No user reviews,0,0,0
592450,True,0,1 user reviews,1,0,1
592460,True,8,Very Positive,62,3,65
592461,True,7,Positive,16,0,16
592480,True,8,Very Positive,108,4,112
592531,True,0,No user reviews,0,0,0
592550,True,5,Mixed,13,11,24
592560,True,0,2 user reviews,1,1,2
592570,True,0,4 user reviews,2,2,4
592580,True,5,Mixed,230,160,390
592600,True,0,No user reviews,0,0,0
592620,True,0,9 user reviews,3,6,9
592640,True,0,No user reviews,0,0,0
592660,True,5,Mixed,10,7,17
592700,True,0,4 user reviews,0,4,4
592720,True,0,4 user reviews,3,1,4
592730,True,5,Mixed,17,8,25
592740,True,0,3 user reviews,1,2,3
592750,True,7,Positive,13,0,13
592780,True,0,No user reviews,0,0,0
592790,True,0,No user reviews,0,0,0
592800,True,5,Mixed,30,17,47
592810,True,0,No user reviews,0,0,0
592811,True,0,No user reviews,0,0,0
592812,True,0,No user reviews,0,0,0
592813,True,0,No user reviews,0,0,0
592814,True,0,No user reviews,0,0,0
592815,True,0,No user reviews,0,0,0
592816,True,0,No user reviews,0,0,0
592820,True,0,2 user reviews,2,0,2
592830,True,0,No user reviews,0,0,0
592840,True,0,No user reviews,0,0,0
592850,True,0,No user reviews,0,0,0
592860,True,0,No user reviews,0,0,0
592870,True,0,No user reviews,0,0,0
592880,True,0,No user reviews,0,0,0
592890,True,0,1 user reviews,0,1,1
592900,True,0,No user reviews,0,0,0
592920,True,0,3 user reviews,2,1,3
592930,True,0,No user reviews,0,0,0
592950,True,0,No user reviews,0,0,0
592990,True,0,3 user reviews,1,2,3
593000,True,0,No user reviews,0,0,0
593020,True,0,No user reviews,0,0,0
593030,True,8,Very Positive,76,13,89
593040,True,0,No user reviews,0,0,0
593050,True,0,No user reviews,0,0,0
593051,True,4,Mostly Negative,5,8,13
593052,True,0,1 user reviews,1,0,1
593053,True,0,No user reviews,0,0,0
593054,True,0,No user reviews,0,0,0
593055,True,0,3 user reviews,1,2,3
593056,True,0,No user reviews,0,0,0
593057,True,0,No user reviews,0,0,0
593060,True,0,2 user reviews,2,0,2
593070,True,7,Positive,18,2,20
593090,True,0,No user reviews,0,0,0
593100,True,0,4 user reviews,3,1,4
593130,True,0,No user reviews,0,0,0
593140,True,0,No user reviews,0,0,0
593150,True,0,No user reviews,0,0,0
593190,True,0,No user reviews,0,0,0
593200,True,7,Positive,26,2,28
593210,True,7,Positive,25,3,28
593240,True,5,Mixed,30,20,50
593250,True,0,2 user reviews,2,0,2
593260,True,0,4 user reviews,2,2,4
593270,True,6,Mostly Positive,8,3,11
593271,True,0,1 user reviews,1,0,1
593272,True,0,2 user reviews,1,1,2
593273,True,0,1 user reviews,1,0,1
593280,True,9,Overwhelmingly Positive,1592,74,1666
593330,True,4,Mostly Negative,9,30,39
593340,True,7,Positive,13,3,16
593350,True,0,No user reviews,0,0,0
593360,True,0,1 user reviews,1,0,1
593370,True,0,No user reviews,0,0,0
593380,True,8,Very Positive,1468,287,1755
593390,True,0,No user reviews,0,0,0
593400,True,0,No user reviews,0,0,0
593410,True,7,Positive,13,2,15
593420,True,0,No user reviews,0,0,0
593430,True,0,1 user reviews,1,0,1
593431,True,0,No user reviews,0,0,0
593450,True,0,No user reviews,0,0,0
593460,True,0,No user reviews,0,0,0
593470,True,0,No user reviews,0,0,0
593490,True,6,Mostly Positive,76,31,107
593500,True,0,No user reviews,0,0,0
593501,True,0,No user reviews,0,0,0
593502,True,0,No user reviews,0,0,0
593503,True,0,No user reviews,0,0,0
593520,True,0,No user reviews,0,0,0
593530,True,4,Mostly Negative,20,36,56
593540,True,5,Mixed,6,4,10
593560,True,4,Mostly Negative,5,8,13
593600,True,5,Mixed,1415,696,2111
593620,True,0,No user reviews,0,0,0
593640,True,0,No user reviews,0,0,0
593670,True,0,3 user reviews,3,0,3
593680,True,0,9 user reviews,9,0,9
593700,True,7,Positive,29,4,33
593720,True,0,No user reviews,0,0,0
593730,True,0,5 user reviews,2,3,5
593740,True,7,Positive,8,2,10
593750,True,0,No user reviews,0,0,0
593751,True,0,No user reviews,0,0,0
593752,True,0,No user reviews,0,0,0
593753,True,0,No user reviews,0,0,0
593754,True,0,No user reviews,0,0,0
593755,True,0,No user reviews,0,0,0
593756,True,0,No user reviews,0,0,0
593757,True,0,No user reviews,0,0,0
593758,True,0,No user reviews,0,0,0
593759,True,0,No user reviews,0,0,0
593760,True,0,No user reviews,0,0,0
593770,True,0,No user reviews,0,0,0
593771,True,0,No user reviews,0,0,0
593772,True,0,No user reviews,0,0,0
593773,True,0,No user reviews,0,0,0
593774,True,0,No user reviews,0,0,0
593775,True,0,No user reviews,0,0,0
593776,True,0,No user reviews,0,0,0
593777,True,0,No user reviews,0,0,0
593778,True,0,No user reviews,0,0,0
593779,True,0,No user reviews,0,0,0
593780,True,0,No user reviews,0,0,0
593790,True,0,No user reviews,0,0,0
593791,True,0,No user reviews,0,0,0
593792,True,0,No user reviews,0,0,0
593793,True,0,No user reviews,0,0,0
593794,True,0,No user reviews,0,0,0
593795,True,0,No user reviews,0,0,0
593796,True,0,No user reviews,0,0,0
593797,True,0,No user reviews,0,0,0
593798,True,0,No user reviews,0,0,0
593799,True,0,No user reviews,0,0,0
593800,True,0,No user reviews,0,0,0
593801,True,0,No user reviews,0,0,0
593810,True,0,No user reviews,0,0,0
593811,True,0,No user reviews,0,0,0
593812,True,0,No user reviews,0,0,0
593813,True,0,No user reviews,0,0,0
593814,True,0,No user reviews,0,0,0
593815,True,0,No user reviews,0,0,0
593816,True,0,No user reviews,0,0,0
593817,True,0,No user reviews,0,0,0
593818,True,0,No user reviews,0,0,0
593819,True,0,No user reviews,0,0,0
593820,True,0,No user reviews,0,0,0
593821,True,0,No user reviews,0,0,0
593822,True,0,No user reviews,0,0,0
593823,True,0,No user reviews,0,0,0
593830,True,0,No user reviews,0,0,0
593831,True,0,No user reviews,0,0,0
593832,True,0,No user reviews,0,0,0
593833,True,0,No user reviews,0,0,0
593834,True,0,No user reviews,0,0,0
593835,True,0,No user reviews,0,0,0
593836,True,0,No user reviews,0,0,0
593837,True,0,No user reviews,0,0,0
593838,True,0,No user reviews,0,0,0
593839,True,0,No user reviews,0,0,0
593840,True,0,No user reviews,0,0,0
593841,True,0,No user reviews,0,0,0
593850,True,5,Mixed,13,10,23
593860,True,0,No user reviews,0,0,0
593861,True,0,No user reviews,0,0,0
593862,True,0,No user reviews,0,0,0
593863,True,0,No user reviews,0,0,0
593864,True,0,No user reviews,0,0,0
593865,True,0,No user reviews,0,0,0
593866,True,0,No user reviews,0,0,0
593867,True,0,No user reviews,0,0,0
593868,True,0,No user reviews,0,0,0
593869,True,0,No user reviews,0,0,0
593870,True,0,No user reviews,0,0,0
593871,True,0,No user reviews,0,0,0
593880,True,0,No user reviews,0,0,0
593900,True,8,Very Positive,56,13,69
593920,True,0,1 user reviews,0,1,1
593930,True,0,No user reviews,0,0,0
593931,True,0,No user reviews,0,0,0
593932,True,0,No user reviews,0,0,0
593950,True,0,2 user reviews,2,0,2
593960,True,8,Very Positive,291,41,332
593970,True,0,3 user reviews,3,0,3
593980,True,0,3 user reviews,1,2,3
593990,True,0,No user reviews,0,0,0
594000,True,0,9 user reviews,7,2,9
594040,True,5,Mixed,48,46,94
594050,True,6,Mostly Positive,69,18,87
594060,True,0,1 user reviews,1,0,1
594080,True,0,No user reviews,0,0,0
594100,True,0,No user reviews,0,0,0
594120,True,0,3 user reviews,0,3,3
594130,True,8,Very Positive,248,8,256
594150,True,0,2 user reviews,2,0,2
594160,True,3,Negative,2,9,11
594184,True,7,Positive,14,0,14
594200,True,7,Positive,10,0,10
594220,True,0,No user reviews,0,0,0
594230,True,0,No user reviews,0,0,0
594270,True,0,No user reviews,0,0,0
594300,True,0,No user reviews,0,0,0
594310,True,0,No user reviews,0,0,0
594320,True,7,Positive,10,0,10
594330,True,8,Very Positive,1344,182,1526
594350,True,8,Very Positive,49,9,58
594360,True,0,9 user reviews,8,1,9
594370,True,5,Mixed,35,24,59
594380,True,0,No user reviews,0,0,0
594390,True,0,No user reviews,0,0,0
594410,True,0,5 user reviews,4,1,5
594420,True,0,No user reviews,0,0,0
594430,True,0,No user reviews,0,0,0
594431,True,0,No user reviews,0,0,0
594432,True,0,No user reviews,0,0,0
594433,True,0,No user reviews,0,0,0
594440,True,0,No user reviews,0,0,0
594450,True,0,No user reviews,0,0,0
594451,True,0,No user reviews,0,0,0
594452,True,0,No user reviews,0,0,0
594453,True,0,No user reviews,0,0,0
594454,True,0,No user reviews,0,0,0
594460,True,0,No user reviews,0,0,0
594461,True,0,No user reviews,0,0,0
594462,True,0,No user reviews,0,0,0
594463,True,0,No user reviews,0,0,0
594464,True,0,No user reviews,0,0,0
594470,True,0,No user reviews,0,0,0
594480,True,0,No user reviews,0,0,0
594490,True,0,1 user reviews,1,0,1
594520,True,0,No user reviews,0,0,0
594540,True,0,No user reviews,0,0,0
594550,True,6,Mostly Positive,42,11,53
594560,True,0,No user reviews,0,0,0
594561,True,0,No user reviews,0,0,0
594570,True,8,Very Positive,29147,2011,31158
594590,True,0,No user reviews,0,0,0
594591,True,5,Mixed,216,300,516
594592,True,0,No user reviews,0,0,0
594593,True,0,No user reviews,0,0,0
594594,True,0,No user reviews,0,0,0
594595,True,0,No user reviews,0,0,0
594596,True,0,No user reviews,0,0,0
594597,True,0,No user reviews,0,0,0
594598,True,0,No user reviews,0,0,0
594599,True,0,No user reviews,0,0,0
594600,True,0,No user reviews,0,0,0
594601,True,0,No user reviews,0,0,0
594602,True,0,No user reviews,0,0,0
594603,True,0,No user reviews,0,0,0
594610,True,0,No user reviews,0,0,0
594620,True,0,No user reviews,0,0,0
594630,True,7,Positive,14,2,16
594640,True,4,Mostly Negative,8,23,31
594650,True,8,Very Positive,22323,4944,27267
594660,True,7,Positive,36,9,45
594670,True,0,No user reviews,0,0,0
594680,True,7,Positive,42,4,46
594700,True,7,Positive,10,0,10
594720,True,5,Mixed,22,16,38
594750,True,5,Mixed,8,5,13
594760,True,0,No user reviews,0,0,0
594770,True,5,Mixed,184,144,328
594800,True,0,4 user reviews,3,1,4
594810,True,0,6 user reviews,6,0,6
594820,True,0,3 user reviews,3,0,3
594860,True,0,No user reviews,0,0,0
594870,True,0,No user reviews,0,0,0
594880,True,0,No user reviews,0,0,0
594890,True,0,No user reviews,0,0,0
594950,True,7,Positive,29,0,29
594970,True,5,Mixed,9,9,18
594980,True,7,Positive,23,2,25
595000,True,4,Mostly Negative,7,11,18
595010,True,5,Mixed,8,4,12
595020,True,0,1 user reviews,1,0,1
595030,True,0,8 user reviews,2,6,8
595050,True,0,No user reviews,0,0,0
595060,True,7,Positive,22,4,26
595070,True,0,5 user reviews,3,2,5
595080,True,7,Positive,14,2,16
595090,True,5,Mixed,23,12,35
595100,True,6,Mostly Positive,32,10,42
595110,True,6,Mostly Positive,142,46,188
595120,True,5,Mixed,52,27,79
595130,True,0,8 user reviews,8,0,8
595140,True,8,Very Positive,780,69,849
595150,True,0,2 user reviews,1,1,2
595160,True,0,7 user reviews,1,6,7
595200,True,7,Positive,23,4,27
595210,True,0,No user reviews,0,0,0
595220,True,0,No user reviews,0,0,0
595230,True,7,Positive,20,0,20
595260,True,5,Mixed,7,4,11
595270,True,7,Positive,10,0,10
595280,True,8,Very Positive,1413,312,1725
595290,True,7,Positive,40,7,47
595300,True,5,Mixed,9,5,14
595320,True,2,Very Negative,9,58,67
595330,True,0,6 user reviews,6,0,6
595331,True,0,4 user reviews,4,0,4
595332,True,0,7 user reviews,7,0,7
595333,True,0,7 user reviews,7,0,7
595350,True,0,No user reviews,0,0,0
595360,True,5,Mixed,13,10,23
595370,True,0,1 user reviews,1,0,1
595371,True,0,No user reviews,0,0,0
595372,True,0,No user reviews,0,0,0
595373,True,0,No user reviews,0,0,0
595374,True,0,No user reviews,0,0,0
595375,True,0,No user reviews,0,0,0
595376,True,0,No user reviews,0,0,0
595377,True,0,No user reviews,0,0,0
595378,True,0,No user reviews,0,0,0
595379,True,0,No user reviews,0,0,0
595380,True,0,No user reviews,0,0,0
595381,True,0,No user reviews,0,0,0
595382,True,0,No user reviews,0,0,0
595383,True,0,No user reviews,0,0,0
595384,True,0,No user reviews,0,0,0
595385,True,0,No user reviews,0,0,0
595386,True,0,No user reviews,0,0,0
595387,True,0,No user reviews,0,0,0
595388,True,0,No user reviews,0,0,0
595389,True,0,No user reviews,0,0,0
595390,True,0,No user reviews,0,0,0
595391,True,0,No user reviews,0,0,0
595392,True,0,No user reviews,0,0,0
595393,True,0,No user reviews,0,0,0
595394,True,0,No user reviews,0,0,0
595395,True,0,No user reviews,0,0,0
595396,True,0,No user reviews,0,0,0
595397,True,0,No user reviews,0,0,0
595398,True,0,No user reviews,0,0,0
595399,True,0,No user reviews,0,0,0
595400,True,0,No user reviews,0,0,0
595401,True,0,No user reviews,0,0,0
595402,True,0,No user reviews,0,0,0
595403,True,0,No user reviews,0,0,0
595404,True,0,No user reviews,0,0,0
595405,True,0,No user reviews,0,0,0
595406,True,0,No user reviews,0,0,0
595407,True,0,No user reviews,0,0,0
595408,True,0,No user reviews,0,0,0
595409,True,0,No user reviews,0,0,0
595410,True,0,No user reviews,0,0,0
595411,True,0,No user reviews,0,0,0
595412,True,0,No user reviews,0,0,0
595413,True,0,No user reviews,0,0,0
595414,True,0,No user reviews,0,0,0
595415,True,0,No user reviews,0,0,0
595416,True,0,No user reviews,0,0,0
595417,True,0,No user reviews,0,0,0
595418,True,0,No user reviews,0,0,0
595420,True,5,Mixed,70,45,115
595430,True,8,Very Positive,227,10,237
595440,True,8,Very Positive,92,15,107
595450,True,0,No user reviews,0,0,0
595460,True,8,Very Positive,111,26,137
595470,True,0,1 user reviews,0,1,1
595490,True,0,No user reviews,0,0,0
595500,True,0,No user reviews,0,0,0
595510,True,0,No user reviews,0,0,0
595520,True,8,Very Positive,1834,233,2067
595540,True,0,No user reviews,0,0,0
595550,True,5,Mixed,23,14,37
595560,True,7,Positive,36,1,37
595570,True,0,No user reviews,0,0,0
595571,True,0,No user reviews,0,0,0
595572,True,0,No user reviews,0,0,0
595573,True,0,No user reviews,0,0,0
595574,True,0,No user reviews,0,0,0
595575,True,0,No user reviews,0,0,0
595576,True,0,No user reviews,0,0,0
595577,True,0,No user reviews,0,0,0
595578,True,0,No user reviews,0,0,0
595579,True,0,No user reviews,0,0,0
595580,True,0,No user reviews,0,0,0
595581,True,0,No user reviews,0,0,0
595582,True,0,No user reviews,0,0,0
595583,True,0,No user reviews,0,0,0
595584,True,0,No user reviews,0,0,0
595585,True,0,No user reviews,0,0,0
595586,True,0,No user reviews,0,0,0
595587,True,0,No user reviews,0,0,0
595588,True,0,No user reviews,0,0,0
595589,True,0,No user reviews,0,0,0
595590,True,0,No user reviews,0,0,0
595591,True,0,No user reviews,0,0,0
595592,True,0,No user reviews,0,0,0
595593,True,0,No user reviews,0,0,0
595594,True,0,No user reviews,0,0,0
595595,True,0,No user reviews,0,0,0
595596,True,0,No user reviews,0,0,0
595597,True,0,No user reviews,0,0,0
595598,True,0,No user reviews,0,0,0
595599,True,0,No user reviews,0,0,0
595600,True,0,No user reviews,0,0,0
595601,True,0,No user reviews,0,0,0
595602,True,0,No user reviews,0,0,0
595603,True,0,No user reviews,0,0,0
595604,True,0,No user reviews,0,0,0
595605,True,0,No user reviews,0,0,0
595606,True,0,No user reviews,0,0,0
595607,True,0,No user reviews,0,0,0
595608,True,0,No user reviews,0,0,0
595609,True,0,No user reviews,0,0,0
595610,True,0,No user reviews,0,0,0
595611,True,0,No user reviews,0,0,0
595612,True,0,No user reviews,0,0,0
595613,True,0,No user reviews,0,0,0
595614,True,0,No user reviews,0,0,0
595615,True,0,No user reviews,0,0,0
595616,True,0,No user reviews,0,0,0
595617,True,0,No user reviews,0,0,0
595620,True,0,No user reviews,0,0,0
595630,True,0,1 user reviews,0,1,1
595640,True,0,7 user reviews,5,2,7
595650,True,0,No user reviews,0,0,0
595660,True,6,Mostly Positive,16,6,22
595680,True,0,1 user reviews,1,0,1
595690,True,6,Mostly Positive,1035,309,1344
595700,True,0,No user reviews,0,0,0
595730,True,8,Very Positive,58,8,66
595740,True,8,Very Positive,76,17,93
595750,True,0,No user reviews,0,0,0
595751,True,0,No user reviews,0,0,0
595752,True,0,No user reviews,0,0,0
595753,True,0,No user reviews,0,0,0
595754,True,0,No user reviews,0,0,0
595755,True,0,No user reviews,0,0,0
595756,True,0,No user reviews,0,0,0
595757,True,0,No user reviews,0,0,0
595760,True,0,No user reviews,0,0,0
595770,True,5,Mixed,58,32,90
595780,True,0,2 user reviews,1,1,2
595790,True,8,Very Positive,97,7,104
595830,True,0,1 user reviews,1,0,1
595900,True,0,No user reviews,0,0,0
595920,True,0,9 user reviews,5,4,9
595930,True,6,Mostly Positive,26,11,37
595940,True,0,5 user reviews,4,1,5
595960,True,8,Very Positive,69,13,82
595970,True,0,1 user reviews,0,1,1
595980,True,0,No user reviews,0,0,0
595990,True,0,3 user reviews,2,1,3
596000,True,7,Positive,37,6,43
596010,True,0,2 user reviews,2,0,2
596020,True,3,Negative,3,15,18
596030,True,0,No user reviews,0,0,0
596040,True,0,No user reviews,0,0,0
596050,True,0,No user reviews,0,0,0
596060,True,0,No user reviews,0,0,0
596070,True,0,5 user reviews,1,4,5
596080,True,7,Positive,10,2,12
596110,True,0,No user reviews,0,0,0
596120,True,0,No user reviews,0,0,0
596130,True,0,No user reviews,0,0,0
596140,True,5,Mixed,9,4,13
596150,True,0,No user reviews,0,0,0
596160,True,0,No user reviews,0,0,0
596190,True,4,Mostly Negative,18,63,81
596200,True,7,Positive,13,3,16
596230,True,0,No user reviews,0,0,0
596231,True,0,1 user reviews,1,0,1
596240,True,5,Mixed,35,40,75
596260,True,0,2 user reviews,2,0,2
596270,True,0,3 user reviews,2,1,3
596280,True,4,Mostly Negative,5,20,25
596290,True,0,1 user reviews,1,0,1
596291,True,0,No user reviews,0,0,0
596292,True,0,No user reviews,0,0,0
596293,True,0,No user reviews,0,0,0
596294,True,0,No user reviews,0,0,0
596295,True,0,No user reviews,0,0,0
596296,True,0,No user reviews,0,0,0
596297,True,0,No user reviews,0,0,0
596298,True,0,No user reviews,0,0,0
596299,True,0,No user reviews,0,0,0
596300,True,0,No user reviews,0,0,0
596301,True,0,No user reviews,0,0,0
596302,True,0,No user reviews,0,0,0
596303,True,0,No user reviews,0,0,0
596304,True,0,No user reviews,0,0,0
596305,True,0,No user reviews,0,0,0
596306,True,0,No user reviews,0,0,0
596307,True,0,No user reviews,0,0,0
596308,True,0,No user reviews,0,0,0
596309,True,0,No user reviews,0,0,0
596310,True,0,No user reviews,0,0,0
596311,True,0,No user reviews,0,0,0
596312,True,0,No user reviews,0,0,0
596313,True,0,No user reviews,0,0,0
596314,True,0,No user reviews,0,0,0
596315,True,0,No user reviews,0,0,0
596316,True,0,No user reviews,0,0,0
596317,True,0,No user reviews,0,0,0
596318,True,0,No user reviews,0,0,0
596319,True,0,No user reviews,0,0,0
596320,True,0,No user reviews,0,0,0
596321,True,0,No user reviews,0,0,0
596322,True,0,No user reviews,0,0,0
596323,True,0,No user reviews,0,0,0
596324,True,0,No user reviews,0,0,0
596325,True,0,No user reviews,0,0,0
596326,True,0,No user reviews,0,0,0
596327,True,0,No user reviews,0,0,0
596328,True,0,No user reviews,0,0,0
596329,True,0,No user reviews,0,0,0
596330,True,0,No user reviews,0,0,0
596331,True,0,No user reviews,0,0,0
596332,True,0,No user reviews,0,0,0
596333,True,0,No user reviews,0,0,0
596334,True,0,No user reviews,0,0,0
596335,True,0,No user reviews,0,0,0
596336,True,0,No user reviews,0,0,0
596337,True,0,No user reviews,0,0,0
596338,True,0,No user reviews,0,0,0
596339,True,0,No user reviews,0,0,0
596340,True,0,No user reviews,0,0,0
596341,True,0,No user reviews,0,0,0
596350,True,0,No user reviews,0,0,0
596370,True,0,8 user reviews,8,0,8
596380,True,5,Mixed,16,13,29
596390,True,0,9 user reviews,9,0,9
596400,True,0,2 user reviews,2,0,2
596420,True,0,No user reviews,0,0,0
596450,True,0,No user reviews,0,0,0
596460,True,0,1 user reviews,0,1,1
596470,True,0,8 user reviews,7,1,8
596510,True,0,No user reviews,0,0,0
596520,True,0,1 user reviews,1,0,1
596530,True,0,3 user reviews,3,0,3
596540,True,5,Mixed,16,12,28
596550,True,0,No user reviews,0,0,0
596560,True,6,Mostly Positive,17,6,23
596570,True,0,No user reviews,0,0,0
596580,True,0,No user reviews,0,0,0
596590,True,0,3 user reviews,3,0,3
596620,True,7,Positive,20,3,23
596630,True,7,Positive,13,1,14
596640,True,5,Mixed,11,9,20
596650,True,0,No user reviews,0,0,0
596700,True,0,No user reviews,0,0,0
596710,True,0,1 user reviews,1,0,1
596730,True,0,1 user reviews,0,1,1
596740,True,5,Mixed,10,7,17
596750,True,0,No user reviews,0,0,0
596760,True,0,3 user reviews,0,3,3
596790,True,0,No user reviews,0,0,0
596810,True,0,9 user reviews,9,0,9
596820,True,0,No user reviews,0,0,0
596821,True,0,No user reviews,0,0,0
596822,True,0,No user reviews,0,0,0
596823,True,0,No user reviews,0,0,0
596860,True,0,No user reviews,0,0,0
596870,True,6,Mostly Positive,16,6,22
596890,True,7,Positive,21,2,23
596900,True,0,No user reviews,0,0,0
596910,True,7,Positive,34,5,39
596920,True,0,No user reviews,0,0,0
596930,True,0,No user reviews,0,0,0
596940,True,0,No user reviews,0,0,0
596950,True,6,Mostly Positive,21,7,28
596960,True,0,8 user reviews,5,3,8
596970,True,8,Very Positive,1118,207,1325
596990,True,0,3 user reviews,2,1,3
597020,True,0,4 user reviews,4,0,4
597030,True,8,Very Positive,84,14,98
597040,True,5,Mixed,5,7,12
597070,True,0,No user reviews,0,0,0
597071,True,0,1 user reviews,1,0,1
597072,True,0,No user reviews,0,0,0
597073,True,0,No user reviews,0,0,0
597074,True,0,4 user reviews,1,3,4
597075,True,0,5 user reviews,4,1,5
597076,True,0,1 user reviews,1,0,1
597080,True,0,No user reviews,0,0,0
597090,True,0,2 user reviews,1,1,2
597120,True,7,Positive,12,0,12
597130,True,0,No user reviews,0,0,0
597150,True,8,Very Positive,183,18,201
597170,True,9,Overwhelmingly Positive,4389,111,4500
597190,True,0,6 user reviews,5,1,6
597200,True,6,Mostly Positive,12,4,16
597210,True,4,Mostly Negative,9,15,24
597220,True,9,Overwhelmingly Positive,4301,92,4393
597230,True,8,Very Positive,174,10,184
597240,True,0,7 user reviews,3,4,7
597260,True,0,No user reviews,0,0,0
597270,True,0,No user reviews,0,0,0
597280,True,0,1 user reviews,1,0,1
597290,True,0,1 user reviews,0,1,1
597300,True,0,No user reviews,0,0,0
597310,True,0,2 user reviews,2,0,2
597320,True,0,No user reviews,0,0,0
597321,True,0,No user reviews,0,0,0
597322,True,0,No user reviews,0,0,0
597323,True,0,No user reviews,0,0,0
597324,True,0,No user reviews,0,0,0
597325,True,0,No user reviews,0,0,0
597326,True,0,No user reviews,0,0,0
597327,True,0,No user reviews,0,0,0
597328,True,0,No user reviews,0,0,0
597329,True,0,No user reviews,0,0,0
597330,True,0,No user reviews,0,0,0
597331,True,0,No user reviews,0,0,0
597340,True,0,No user reviews,0,0,0
597341,True,0,No user reviews,0,0,0
597342,True,0,No user reviews,0,0,0
597343,True,0,No user reviews,0,0,0
597344,True,0,No user reviews,0,0,0
597345,True,0,No user reviews,0,0,0
597346,True,0,No user reviews,0,0,0
597347,True,0,No user reviews,0,0,0
597348,True,0,No user reviews,0,0,0
597349,True,0,No user reviews,0,0,0
597350,True,0,No user reviews,0,0,0
597351,True,0,No user reviews,0,0,0
597352,True,0,No user reviews,0,0,0
597360,True,0,No user reviews,0,0,0
597370,True,0,No user reviews,0,0,0
597380,True,0,No user reviews,0,0,0
597381,True,0,No user reviews,0,0,0
597382,True,0,No user reviews,0,0,0
597383,True,0,No user reviews,0,0,0
597384,True,0,No user reviews,0,0,0
597385,True,0,No user reviews,0,0,0
597386,True,0,No user reviews,0,0,0
597387,True,0,No user reviews,0,0,0
597388,True,0,No user reviews,0,0,0
597389,True,0,No user reviews,0,0,0
597390,True,0,No user reviews,0,0,0
597391,True,0,No user reviews,0,0,0
597392,True,0,No user reviews,0,0,0
597400,True,0,No user reviews,0,0,0
597401,True,0,No user reviews,0,0,0
597402,True,0,No user reviews,0,0,0
597403,True,0,No user reviews,0,0,0
597404,True,0,No user reviews,0,0,0
597405,True,0,No user reviews,0,0,0
597406,True,0,No user reviews,0,0,0
597407,True,0,No user reviews,0,0,0
597408,True,0,No user reviews,0,0,0
597409,True,0,No user reviews,0,0,0
597410,True,0,No user reviews,0,0,0
597411,True,0,No user reviews,0,0,0
597420,True,0,No user reviews,0,0,0
597440,True,0,No user reviews,0,0,0
597450,True,0,No user reviews,0,0,0
597460,True,0,No user reviews,0,0,0
597470,True,0,No user reviews,0,0,0
597480,True,0,No user reviews,0,0,0
597490,True,0,No user reviews,0,0,0
597500,True,0,No user reviews,0,0,0
597510,True,0,No user reviews,0,0,0
597520,True,0,No user reviews,0,0,0
597530,True,0,No user reviews,0,0,0
597540,True,0,No user reviews,0,0,0
597590,True,7,Positive,17,2,19
597600,True,0,No user reviews,0,0,0
597610,True,0,No user reviews,0,0,0
597640,True,0,No user reviews,0,0,0
597660,True,0,No user reviews,0,0,0
597670,True,0,2 user reviews,2,0,2
597690,True,0,No user reviews,0,0,0
597700,True,8,Very Positive,121,11,132
597720,True,5,Mixed,6,4,10
597730,True,0,9 user reviews,8,1,9
597760,True,9,Overwhelmingly Positive,529,25,554
597770,True,5,Mixed,30,20,50
597800,True,0,No user reviews,0,0,0
597810,True,7,Positive,9,1,10
597820,True,0,No user reviews,0,0,0
597830,True,0,No user reviews,0,0,0
597840,True,6,Mostly Positive,83,35,118
597860,True,5,Mixed,9,5,14
597880,True,0,No user reviews,0,0,0
597890,True,0,No user reviews,0,0,0
597900,True,0,7 user reviews,5,2,7
597910,True,0,5 user reviews,4,1,5
597920,True,5,Mixed,6,9,15
597930,True,0,No user reviews,0,0,0
597940,True,0,No user reviews,0,0,0
597950,True,0,No user reviews,0,0,0
597970,True,8,Very Positive,124,21,145
597990,True,0,2 user reviews,1,1,2
598010,True,0,No user reviews,0,0,0
598030,True,0,7 user reviews,1,6,7
598050,True,0,1 user reviews,1,0,1
598060,True,8,Very Positive,86,11,97
598070,True,7,Positive,17,0,17
598090,True,0,5 user reviews,2,3,5
598100,True,0,No user reviews,0,0,0
598110,True,0,No user reviews,0,0,0
598120,True,0,No user reviews,0,0,0
598150,True,0,No user reviews,0,0,0
598160,True,0,No user reviews,0,0,0
598170,True,0,No user reviews,0,0,0
598180,True,5,Mixed,19,16,35
598190,True,8,Very Positive,63,2,65
598210,True,0,No user reviews,0,0,0
598230,True,0,No user reviews,0,0,0
598240,True,5,Mixed,10,11,21
598250,True,0,No user reviews,0,0,0
598290,True,0,No user reviews,0,0,0
598330,True,8,Very Positive,1400,343,1743
598340,True,7,Positive,9,2,11
598350,True,7,Positive,16,2,18
598380,True,0,2 user reviews,2,0,2
598390,True,0,No user reviews,0,0,0
598400,True,5,Mixed,16,9,25
598420,True,0,No user reviews,0,0,0
598430,True,0,No user reviews,0,0,0
598440,True,5,Mixed,37,19,56
598450,True,5,Mixed,90,55,145
598480,True,4,Mostly Negative,5,11,16
598490,True,8,Very Positive,70,9,79
598500,True,0,7 user reviews,3,4,7
598530,True,0,No user reviews,0,0,0
598540,True,0,No user reviews,0,0,0
598550,True,0,No user reviews,0,0,0
598590,True,0,1 user reviews,1,0,1
598600,True,5,Mixed,5,6,11
598610,True,5,Mixed,9,5,14
598620,True,0,6 user reviews,3,3,6
598640,True,7,Positive,24,2,26
598650,True,0,No user reviews,0,0,0
598660,True,5,Mixed,17,10,27
598670,True,7,Positive,19,1,20
598690,True,5,Mixed,44,25,69
598700,True,8,Very Positive,894,96,990
598710,True,0,4 user reviews,4,0,4
598720,True,5,Mixed,7,5,12
598730,True,7,Positive,32,4,36
598740,True,7,Positive,10,2,12
598750,True,0,No user reviews,0,0,0
598770,True,0,No user reviews,0,0,0
598780,True,0,No user reviews,0,0,0
598810,True,6,Mostly Positive,299,99,398
598820,True,0,No user reviews,0,0,0
598830,True,0,No user reviews,0,0,0
598840,True,0,7 user reviews,7,0,7
598850,True,0,No user reviews,0,0,0
598860,True,6,Mostly Positive,9,3,12
598870,True,0,No user reviews,0,0,0
598880,True,0,7 user reviews,7,0,7
598890,True,0,No user reviews,0,0,0
598900,True,0,No user reviews,0,0,0
598910,True,0,No user reviews,0,0,0
598930,True,0,No user reviews,0,0,0
598940,True,5,Mixed,12,6,18
598950,True,0,No user reviews,0,0,0
598960,True,8,Very Positive,519,87,606
598980,True,9,Overwhelmingly Positive,1590,51,1641
598990,True,7,Positive,12,0,12
599000,True,5,Mixed,21,14,35
599020,True,0,No user reviews,0,0,0
599021,True,0,No user reviews,0,0,0
599022,True,0,No user reviews,0,0,0
599023,True,0,No user reviews,0,0,0
599030,True,0,No user reviews,0,0,0
599040,True,5,Mixed,6,6,12
599050,True,7,Positive,10,0,10
599060,True,0,No user reviews,0,0,0
599070,True,0,2 user reviews,2,0,2
599080,True,8,Very Positive,939,162,1101
599110,True,0,No user reviews,0,0,0
599140,True,8,Very Positive,4918,1082,6000
599150,True,0,No user reviews,0,0,0
599160,True,7,Positive,17,3,20
599180,True,0,3 user reviews,2,1,3
599190,True,0,No user reviews,0,0,0
599210,True,0,No user reviews,0,0,0
599230,True,0,No user reviews,0,0,0
599250,True,0,No user reviews,0,0,0
599270,True,0,No user reviews,0,0,0
599290,True,0,No user reviews,0,0,0
599310,True,0,No user reviews,0,0,0
599350,True,0,No user reviews,0,0,0
599390,True,0,No user reviews,0,0,0
599400,True,0,No user reviews,0,0,0
599420,True,0,1 user reviews,1,0,1
599430,True,0,2 user reviews,2,0,2
599440,True,0,6 user reviews,4,2,6
599441,True,0,7 user reviews,6,1,7
599460,True,6,Mostly Positive,169,45,214
599480,True,7,Positive,9,1,10
599490,True,0,No user reviews,0,0,0
599500,True,0,No user reviews,0,0,0
599510,True,0,5 user reviews,2,3,5
599520,True,0,No user reviews,0,0,0
599540,True,0,No user reviews,0,0,0
599560,True,5,Mixed,30,14,44
599580,True,0,No user reviews,0,0,0
599590,True,7,Positive,40,1,41
599600,True,6,Mostly Positive,11,4,15
599630,True,0,6 user reviews,4,2,6
599640,True,0,No user reviews,0,0,0
599660,True,0,No user reviews,0,0,0
599670,True,0,5 user reviews,3,2,5
599680,True,0,No user reviews,0,0,0
599690,True,0,1 user reviews,1,0,1
599740,True,0,No user reviews,0,0,0
599750,True,6,Mostly Positive,254,91,345
599760,True,0,No user reviews,0,0,0
599780,True,0,No user reviews,0,0,0
599800,True,0,1 user reviews,1,0,1
599810,True,0,4 user reviews,3,1,4
599840,True,7,Positive,26,0,26
599860,True,0,No user reviews,0,0,0
599880,True,0,6 user reviews,2,4,6
599890,True,0,1 user reviews,1,0,1
599900,True,5,Mixed,13,8,21
599910,True,0,No user reviews,0,0,0
599920,True,0,No user reviews,0,0,0
599960,True,6,Mostly Positive,107,42,149
599970,True,0,No user reviews,0,0,0
599980,True,0,No user reviews,0,0,0
599990,True,0,8 user reviews,3,5,8
600000,True,0,5 user reviews,4,1,5
600010,True,0,No user reviews,0,0,0
600020,True,0,No user reviews,0,0,0
600021,True,0,No user reviews,0,0,0
600030,True,0,1 user reviews,1,0,1
600050,True,0,No user reviews,0,0,0
600051,True,0,No user reviews,0,0,0
600052,True,0,No user reviews,0,0,0
600053,True,0,No user reviews,0,0,0
600054,True,0,No user reviews,0,0,0
600055,True,0,No user reviews,0,0,0
600060,True,0,No user reviews,0,0,0
600070,True,0,No user reviews,0,0,0
600080,True,0,No user reviews,0,0,0
600090,True,8,Very Positive,63,13,76
600100,True,0,6 user reviews,3,3,6
600120,True,0,No user reviews,0,0,0
600130,True,8,Very Positive,328,24,352
600140,True,0,No user reviews,0,0,0
600150,True,5,Mixed,13,6,19
600160,True,0,No user reviews,0,0,0
600170,True,0,6 user reviews,6,0,6
600180,True,0,No user reviews,0,0,0
600190,True,0,6 user reviews,3,3,6
600200,True,0,No user reviews,0,0,0
600210,True,0,7 user reviews,4,3,7
600220,True,0,No user reviews,0,0,0
600230,True,0,No user reviews,0,0,0
600240,True,0,No user reviews,0,0,0
600250,True,0,8 user reviews,7,1,8
600260,True,0,No user reviews,0,0,0
600280,True,5,Mixed,32,18,50
600290,True,0,No user reviews,0,0,0
600300,True,0,No user reviews,0,0,0
600310,True,0,2 user reviews,2,0,2
600320,True,0,1 user reviews,1,0,1
600330,True,0,7 user reviews,6,1,7
600350,True,0,3 user reviews,1,2,3
600360,True,0,No user reviews,0,0,0
600370,True,9,Overwhelmingly Positive,591,16,607
600400,True,0,No user reviews,0,0,0
600410,True,0,No user reviews,0,0,0
600420,True,7,Positive,24,4,28
600430,True,0,5 user reviews,4,1,5
600440,True,0,No user reviews,0,0,0
600460,True,6,Mostly Positive,129,40,169
600470,True,0,No user reviews,0,0,0
600480,True,8,Very Positive,929,65,994
600500,True,0,1 user reviews,1,0,1
600520,True,0,4 user reviews,4,0,4
600530,True,0,6 user reviews,4,2,6
600540,True,0,No user reviews,0,0,0
600550,True,4,Mostly Negative,5,10,15
600560,True,0,No user reviews,0,0,0
600580,True,0,1 user reviews,1,0,1
600600,True,6,Mostly Positive,10,3,13
600610,True,0,No user reviews,0,0,0
600620,True,0,No user reviews,0,0,0
600630,True,5,Mixed,13,14,27
600640,True,0,3 user reviews,3,0,3
600650,True,7,Positive,16,1,17
600660,True,7,Positive,16,0,16
600670,True,0,4 user reviews,2,2,4
600690,True,0,2 user reviews,2,0,2
600720,True,5,Mixed,68,37,105
600730,True,0,No user reviews,0,0,0
600740,True,5,Mixed,10,9,19
600750,True,0,2 user reviews,1,1,2
600760,True,0,No user reviews,0,0,0
600820,True,0,No user reviews,0,0,0
600830,True,0,No user reviews,0,0,0
600840,True,0,No user reviews,0,0,0
600850,True,0,No user reviews,0,0,0
600860,True,0,No user reviews,0,0,0
600870,True,0,No user reviews,0,0,0
600880,True,0,No user reviews,0,0,0
600890,True,0,No user reviews,0,0,0
600900,True,0,No user reviews,0,0,0
600910,True,0,No user reviews,0,0,0
600920,True,0,No user reviews,0,0,0
600930,True,0,No user reviews,0,0,0
600940,True,0,No user reviews,0,0,0
600950,True,0,No user reviews,0,0,0
600960,True,0,No user reviews,0,0,0
600970,True,0,No user reviews,0,0,0
600980,True,0,4 user reviews,2,2,4
600990,True,8,Very Positive,446,33,479
601010,True,5,Mixed,34,22,56
601020,True,4,Mostly Negative,4,7,11
601050,True,8,Very Positive,595,79,674
601070,True,0,No user reviews,0,0,0
601080,True,0,No user reviews,0,0,0
601090,True,0,No user reviews,0,0,0
601110,True,0,3 user reviews,1,2,3
601120,True,0,4 user reviews,4,0,4
601130,True,0,3 user reviews,3,0,3
601150,True,8,Very Positive,8114,739,8853
601170,True,0,9 user reviews,5,4,9
601180,True,0,8 user reviews,5,3,8
601190,True,0,No user reviews,0,0,0
601200,True,0,2 user reviews,1,1,2
601210,True,0,No user reviews,0,0,0
601220,True,8,Very Positive,217,8,225
601240,True,0,5 user reviews,4,1,5
601250,True,0,4 user reviews,4,0,4
601270,True,7,Positive,21,2,23
601290,True,0,No user reviews,0,0,0
601291,True,0,No user reviews,0,0,0
601292,True,0,No user reviews,0,0,0
601293,True,0,No user reviews,0,0,0
601294,True,0,No user reviews,0,0,0
601295,True,0,No user reviews,0,0,0
601296,True,0,No user reviews,0,0,0
601297,True,0,No user reviews,0,0,0
601298,True,0,No user reviews,0,0,0
601300,True,0,No user reviews,0,0,0
601301,True,0,No user reviews,0,0,0
601302,True,0,No user reviews,0,0,0
601303,True,0,No user reviews,0,0,0
601310,True,0,No user reviews,0,0,0
601320,True,0,3 user reviews,2,1,3
601330,True,0,No user reviews,0,0,0
601340,True,0,5 user reviews,1,4,5
601350,True,0,No user reviews,0,0,0
601360,True,0,No user reviews,0,0,0
601370,True,0,No user reviews,0,0,0
601380,True,3,Negative,6,26,32
601390,True,0,1 user reviews,1,0,1
601400,True,6,Mostly Positive,13,4,17
601420,True,0,6 user reviews,5,1,6
601430,True,8,Very Positive,2560,278,2838
601490,True,5,Mixed,7,6,13
601500,True,0,9 user reviews,6,3,9
601510,True,0,No user reviews,0,0,0
601520,True,0,No user reviews,0,0,0
601530,True,8,Very Positive,186,23,209
601540,True,5,Mixed,178,121,299
601550,True,0,3 user reviews,0,3,3
601570,True,6,Mostly Positive,8,3,11
601590,True,0,6 user reviews,4,2,6
601610,True,0,No user reviews,0,0,0
601620,True,0,6 user reviews,1,5,6
601640,True,0,9 user reviews,4,5,9
601670,True,5,Mixed,209,108,317
601690,True,0,6 user reviews,4,2,6
601700,True,0,No user reviews,0,0,0
601710,True,7,Positive,14,0,14
601720,True,0,No user reviews,0,0,0
601730,True,0,No user reviews,0,0,0
601750,True,5,Mixed,10,10,20
601760,True,0,1 user reviews,0,1,1
601770,True,8,Very Positive,221,42,263
601780,True,6,Mostly Positive,13,5,18
601790,True,5,Mixed,8,5,13
601810,True,8,Very Positive,292,24,316
601840,True,9,Overwhelmingly Positive,1547,55,1602
601850,True,0,1 user reviews,1,0,1
601860,True,0,No user reviews,0,0,0
601870,True,6,Mostly Positive,7,3,10
601880,True,0,No user reviews,0,0,0
601890,True,0,9 user reviews,8,1,9
601920,True,7,Positive,8,2,10
601930,True,0,6 user reviews,6,0,6
601940,True,0,1 user reviews,1,0,1
601990,True,0,No user reviews,0,0,0
602010,True,7,Positive,22,4,26
602040,True,0,No user reviews,0,0,0
602060,True,0,No user reviews,0,0,0
602070,True,0,2 user reviews,2,0,2
602080,True,7,Positive,14,0,14
602090,True,0,No user reviews,0,0,0
602120,True,7,Positive,14,0,14
602130,True,0,8 user reviews,5,3,8
602140,True,0,No user reviews,0,0,0
602150,True,0,1 user reviews,0,1,1
602160,True,0,5 user reviews,4,1,5
602180,True,0,2 user reviews,0,2,2
602200,True,0,5 user reviews,4,1,5
602210,True,0,No user reviews,0,0,0
602250,True,0,No user reviews,0,0,0
602260,True,0,No user reviews,0,0,0
602270,True,0,2 user reviews,1,1,2
602280,True,0,No user reviews,0,0,0
602290,True,0,1 user reviews,0,1,1
602300,True,0,7 user reviews,7,0,7
602310,True,0,No user reviews,0,0,0
602320,True,8,Very Positive,539,51,590
602330,True,0,No user reviews,0,0,0
602340,True,0,No user reviews,0,0,0
602350,True,0,1 user reviews,0,1,1
602370,True,0,No user reviews,0,0,0
602380,True,0,No user reviews,0,0,0
602390,True,0,No user reviews,0,0,0
602400,True,0,No user reviews,0,0,0
602410,True,0,No user reviews,0,0,0
602420,True,0,No user reviews,0,0,0
602430,True,7,Positive,37,5,42
602440,True,0,3 user reviews,3,0,3
602441,True,0,2 user reviews,2,0,2
602450,True,7,Positive,10,2,12
602451,True,0,No user reviews,0,0,0
602460,True,0,4 user reviews,4,0,4
602461,True,0,5 user reviews,3,2,5
602470,True,0,2 user reviews,2,0,2
602471,True,5,Mixed,8,4,12
602472,True,0,6 user reviews,6,0,6
602480,True,7,Positive,34,7,41
602510,True,5,Mixed,27,16,43
602520,True,9,Overwhelmingly Positive,1579,37,1616
602540,True,0,5 user reviews,2,3,5
602550,True,0,3 user reviews,3,0,3
602580,True,0,1 user reviews,1,0,1
602581,True,0,1 user reviews,1,0,1
602582,True,0,1 user reviews,0,1,1
602583,True,0,No user reviews,0,0,0
602584,True,0,5 user reviews,3,2,5
602590,True,7,Positive,8,2,10
602600,True,0,No user reviews,0,0,0
602620,True,0,4 user reviews,3,1,4
602621,True,0,2 user reviews,1,1,2
602622,True,0,6 user reviews,4,2,6
602623,True,7,Positive,12,1,13
602630,True,7,Positive,15,1,16
602660,True,0,No user reviews,0,0,0
602670,True,0,No user reviews,0,0,0
602700,True,8,Very Positive,280,26,306
602720,True,0,3 user reviews,3,0,3
602730,True,0,7 user reviews,6,1,7
602740,True,0,No user reviews,0,0,0
602750,True,0,No user reviews,0,0,0
602770,True,6,Mostly Positive,111,33,144
602780,True,0,No user reviews,0,0,0
602790,True,0,3 user reviews,2,1,3
602800,True,0,3 user reviews,1,2,3
602801,True,0,4 user reviews,3,1,4
602810,True,0,4 user reviews,2,2,4
602811,True,0,2 user reviews,2,0,2
602812,True,0,3 user reviews,1,2,3
602813,True,0,2 user reviews,2,0,2
602814,True,0,No user reviews,0,0,0
602815,True,0,No user reviews,0,0,0
602816,True,0,1 user reviews,1,0,1
602817,True,0,No user reviews,0,0,0
602818,True,0,5 user reviews,3,2,5
602819,True,0,5 user reviews,4,1,5
602820,True,0,No user reviews,0,0,0
602830,True,5,Mixed,7,5,12
602860,True,7,Positive,13,0,13
602870,True,0,No user reviews,0,0,0
602880,True,0,3 user reviews,3,0,3
602890,True,5,Mixed,43,48,91
602900,True,0,No user reviews,0,0,0
602910,True,5,Mixed,9,6,15
602920,True,0,1 user reviews,1,0,1
602930,True,5,Mixed,4,6,10
602950,True,0,No user reviews,0,0,0
602960,True,8,Very Positive,3104,318,3422
602970,True,0,1 user reviews,1,0,1
603000,True,0,1 user reviews,1,0,1
603010,True,7,Positive,18,3,21
603020,True,6,Mostly Positive,111,34,145
603030,True,5,Mixed,13,8,21
603060,True,7,Positive,10,2,12
603090,True,0,9 user reviews,5,4,9
603100,True,6,Mostly Positive,47,18,65
603110,True,0,7 user reviews,6,1,7
603120,True,5,Mixed,21,29,50
603130,True,6,Mostly Positive,37,10,47
603140,True,0,No user reviews,0,0,0
603150,True,4,Mostly Negative,6,12,18
603170,True,0,No user reviews,0,0,0
603190,True,6,Mostly Positive,49,17,66
603210,True,0,5 user reviews,2,3,5
603220,True,0,3 user reviews,3,0,3
603230,True,7,Positive,14,1,15
603240,True,0,No user reviews,0,0,0
603250,True,0,7 user reviews,3,4,7
603260,True,8,Very Positive,252,30,282
603280,True,7,Positive,11,1,12
603300,True,0,No user reviews,0,0,0
603301,True,0,No user reviews,0,0,0
603302,True,0,No user reviews,0,0,0
603303,True,0,No user reviews,0,0,0
603305,True,0,No user reviews,0,0,0
603306,True,0,No user reviews,0,0,0
603307,True,0,No user reviews,0,0,0
603308,True,0,No user reviews,0,0,0
603310,True,0,No user reviews,0,0,0
603320,True,6,Mostly Positive,77,27,104
603330,True,7,Positive,31,4,35
603340,True,0,1 user reviews,1,0,1
603350,True,6,Mostly Positive,51,16,67
603360,True,4,Mostly Negative,5,17,22
603380,True,5,Mixed,12,6,18
603390,True,8,Very Positive,104,6,110
603400,True,5,Mixed,29,17,46
603420,True,5,Mixed,7,5,12
603440,True,0,No user reviews,0,0,0
603450,True,0,1 user reviews,1,0,1
603460,True,0,4 user reviews,3,1,4
603490,True,0,2 user reviews,0,2,2
603510,True,7,Positive,9,1,10
603520,True,0,No user reviews,0,0,0
603530,True,8,Very Positive,374,40,414
603540,True,0,No user reviews,0,0,0
603550,True,0,3 user reviews,1,2,3
603560,True,0,No user reviews,0,0,0
603590,True,0,No user reviews,0,0,0
603600,True,0,No user reviews,0,0,0
603610,True,0,1 user reviews,1,0,1
603630,True,0,No user reviews,0,0,0
603680,True,0,No user reviews,0,0,0
603690,True,0,No user reviews,0,0,0
603700,True,6,Mostly Positive,60,18,78
603720,True,0,No user reviews,0,0,0
603730,True,5,Mixed,29,14,43
603750,True,3,Negative,5,25,30
603760,True,0,7 user reviews,7,0,7
603790,True,5,Mixed,10,6,16
603800,True,8,Very Positive,55,10,65
603810,True,8,Very Positive,48,11,59
603840,True,0,2 user reviews,2,0,2
603850,True,8,Very Positive,2346,566,2912
603870,True,7,Positive,14,1,15
603880,True,0,No user reviews,0,0,0
603910,True,0,2 user reviews,1,1,2
603930,True,5,Mixed,22,10,32
603940,True,8,Very Positive,98,23,121
603960,True,9,Overwhelmingly Positive,820,11,831
603970,True,0,1 user reviews,0,1,1
603980,True,0,No user reviews,0,0,0
603990,True,0,2 user reviews,1,1,2
604000,True,7,Positive,38,3,41
604010,True,7,Positive,17,3,20
604020,True,0,No user reviews,0,0,0
604030,True,0,No user reviews,0,0,0
604040,True,0,5 user reviews,2,3,5
604060,True,0,3 user reviews,2,1,3
604070,True,5,Mixed,6,4,10
604080,True,0,No user reviews,0,0,0
604090,True,0,1 user reviews,0,1,1
604091,True,0,No user reviews,0,0,0
604100,True,0,No user reviews,0,0,0
604110,True,0,6 user reviews,4,2,6
604140,True,5,Mixed,7,4,11
604150,True,0,3 user reviews,2,1,3
604170,True,7,Positive,13,2,15
604180,True,0,No user reviews,0,0,0
604190,True,0,No user reviews,0,0,0
604200,True,0,7 user reviews,3,4,7
604210,True,0,No user reviews,0,0,0
604230,True,0,No user reviews,0,0,0
604240,True,9,Overwhelmingly Positive,4397,182,4579
604280,True,0,1 user reviews,1,0,1
604290,True,0,3 user reviews,3,0,3
604300,True,7,Positive,18,3,21
604310,True,0,No user reviews,0,0,0
604320,True,0,No user reviews,0,0,0
604330,True,8,Very Positive,227,7,234
604340,True,0,2 user reviews,2,0,2
604350,True,0,No user reviews,0,0,0
604360,True,0,No user reviews,0,0,0
604380,True,0,1 user reviews,1,0,1
604390,True,0,No user reviews,0,0,0
604400,True,0,No user reviews,0,0,0
604401,True,0,No user reviews,0,0,0
604410,True,0,No user reviews,0,0,0
604411,True,0,No user reviews,0,0,0
604420,True,0,No user reviews,0,0,0
604421,True,0,No user reviews,0,0,0
604430,True,0,No user reviews,0,0,0
604440,True,0,No user reviews,0,0,0
604450,True,8,Very Positive,198,32,230
604470,True,0,No user reviews,0,0,0
604480,True,0,No user reviews,0,0,0
604490,True,6,Mostly Positive,388,134,522
604500,True,0,No user reviews,0,0,0
604510,True,7,Positive,29,1,30
604520,True,0,No user reviews,0,0,0
604530,True,0,No user reviews,0,0,0
604540,True,0,No user reviews,0,0,0
604550,True,0,1 user reviews,0,1,1
604580,True,0,No user reviews,0,0,0
604600,True,0,1 user reviews,0,1,1
604601,True,0,1 user reviews,0,1,1
604602,True,0,1 user reviews,0,1,1
604610,True,0,1 user reviews,0,1,1
604630,True,0,4 user reviews,3,1,4
604640,True,0,2 user reviews,1,1,2
604650,True,0,No user reviews,0,0,0
604660,True,0,No user reviews,0,0,0
604661,True,0,No user reviews,0,0,0
604662,True,0,No user reviews,0,0,0
604663,True,0,No user reviews,0,0,0
604664,True,0,No user reviews,0,0,0
604665,True,0,No user reviews,0,0,0
604666,True,0,No user reviews,0,0,0
604667,True,0,No user reviews,0,0,0
604668,True,0,No user reviews,0,0,0
604669,True,0,No user reviews,0,0,0
604670,True,0,No user reviews,0,0,0
604671,True,0,No user reviews,0,0,0
604672,True,0,No user reviews,0,0,0
604673,True,0,No user reviews,0,0,0
604674,True,0,No user reviews,0,0,0
604675,True,0,No user reviews,0,0,0
604676,True,0,No user reviews,0,0,0
604677,True,0,No user reviews,0,0,0
604678,True,0,No user reviews,0,0,0
604679,True,0,No user reviews,0,0,0
604680,True,0,No user reviews,0,0,0
604681,True,0,No user reviews,0,0,0
604682,True,0,No user reviews,0,0,0
604683,True,0,No user reviews,0,0,0
604684,True,0,No user reviews,0,0,0
604685,True,0,No user reviews,0,0,0
604686,True,0,No user reviews,0,0,0
604687,True,0,No user reviews,0,0,0
604688,True,0,No user reviews,0,0,0
604689,True,0,No user reviews,0,0,0
604690,True,0,No user reviews,0,0,0
604691,True,0,No user reviews,0,0,0
604692,True,0,No user reviews,0,0,0
604693,True,0,No user reviews,0,0,0
604694,True,0,No user reviews,0,0,0
604695,True,0,No user reviews,0,0,0
604696,True,0,No user reviews,0,0,0
604697,True,0,No user reviews,0,0,0
604698,True,0,No user reviews,0,0,0
604699,True,0,No user reviews,0,0,0
604700,True,0,No user reviews,0,0,0
604701,True,0,No user reviews,0,0,0
604702,True,0,No user reviews,0,0,0
604703,True,0,No user reviews,0,0,0
604704,True,0,No user reviews,0,0,0
604705,True,0,No user reviews,0,0,0
604706,True,0,No user reviews,0,0,0
604707,True,0,No user reviews,0,0,0
604708,True,0,No user reviews,0,0,0
604709,True,0,No user reviews,0,0,0
604710,True,0,No user reviews,0,0,0
604711,True,0,No user reviews,0,0,0
604712,True,0,No user reviews,0,0,0
604713,True,0,No user reviews,0,0,0
604714,True,0,No user reviews,0,0,0
604715,True,0,No user reviews,0,0,0
604716,True,0,No user reviews,0,0,0
604717,True,0,No user reviews,0,0,0
604718,True,0,No user reviews,0,0,0
604719,True,0,No user reviews,0,0,0
604720,True,0,No user reviews,0,0,0
604721,True,0,No user reviews,0,0,0
604722,True,0,No user reviews,0,0,0
604723,True,0,No user reviews,0,0,0
604730,True,0,No user reviews,0,0,0
604740,True,5,Mixed,80,37,117
604770,True,0,7 user reviews,7,0,7
604780,True,6,Mostly Positive,120,35,155
604800,True,0,No user reviews,0,0,0
604830,True,0,8 user reviews,4,4,8
604840,True,0,No user reviews,0,0,0
604860,True,0,No user reviews,0,0,0
604870,True,0,No user reviews,0,0,0
604890,True,0,No user reviews,0,0,0
604900,True,0,6 user reviews,6,0,6
604920,True,0,9 user reviews,9,0,9
604930,True,0,No user reviews,0,0,0
604940,True,0,No user reviews,0,0,0
604950,True,0,No user reviews,0,0,0
604980,True,0,5 user reviews,5,0,5
604990,True,0,1 user reviews,1,0,1
605010,True,0,No user reviews,0,0,0
605020,True,0,No user reviews,0,0,0
605030,True,0,No user reviews,0,0,0
605040,True,0,1 user reviews,0,1,1
605050,True,0,No user reviews,0,0,0
605060,True,0,No user reviews,0,0,0
605070,True,0,No user reviews,0,0,0
605100,True,5,Mixed,8,9,17
605110,True,0,4 user reviews,1,3,4
605140,True,5,Mixed,13,11,24
605160,True,0,5 user reviews,2,3,5
605170,True,0,No user reviews,0,0,0
605180,True,5,Mixed,21,11,32
605190,True,7,Positive,16,2,18
605200,True,0,9 user reviews,6,3,9
605210,True,0,4 user reviews,3,1,4
605230,True,8,Very Positive,265,42,307
605250,True,7,Positive,19,1,20
605270,True,0,3 user reviews,3,0,3
605280,True,0,1 user reviews,1,0,1
605300,True,0,No user reviews,0,0,0
605310,True,5,Mixed,15,9,24
605320,True,0,No user reviews,0,0,0
605321,True,0,No user reviews,0,0,0
605322,True,0,No user reviews,0,0,0
605323,True,0,No user reviews,0,0,0
605324,True,0,No user reviews,0,0,0
605325,True,0,1 user reviews,1,0,1
605326,True,0,No user reviews,0,0,0
605327,True,0,No user reviews,0,0,0
605328,True,0,1 user reviews,1,0,1
605330,True,0,No user reviews,0,0,0
605331,True,0,No user reviews,0,0,0
605332,True,0,No user reviews,0,0,0
605333,True,0,No user reviews,0,0,0
605334,True,0,1 user reviews,0,1,1
605335,True,0,No user reviews,0,0,0
605350,True,0,No user reviews,0,0,0
605351,True,0,No user reviews,0,0,0
605352,True,0,No user reviews,0,0,0
605353,True,0,No user reviews,0,0,0
605354,True,0,No user reviews,0,0,0
605360,True,0,No user reviews,0,0,0
605361,True,0,No user reviews,0,0,0
605410,True,0,3 user reviews,1,2,3
605420,True,0,No user reviews,0,0,0
605430,True,0,1 user reviews,1,0,1
605440,True,0,No user reviews,0,0,0
605450,True,8,Very Positive,529,66,595
605480,True,0,No user reviews,0,0,0
605490,True,0,2 user reviews,1,1,2
605540,True,0,3 user reviews,1,2,3
605550,True,8,Very Positive,50,8,58
605560,True,4,Mostly Negative,3,7,10
605570,True,0,No user reviews,0,0,0
605580,True,0,No user reviews,0,0,0
605581,True,0,No user reviews,0,0,0
605582,True,0,No user reviews,0,0,0
605583,True,0,No user reviews,0,0,0
605584,True,0,No user reviews,0,0,0
605585,True,0,No user reviews,0,0,0
605586,True,0,No user reviews,0,0,0
605587,True,0,No user reviews,0,0,0
605588,True,0,No user reviews,0,0,0
605590,True,0,No user reviews,0,0,0
605600,True,0,No user reviews,0,0,0
605601,True,0,No user reviews,0,0,0
605602,True,0,No user reviews,0,0,0
605603,True,0,No user reviews,0,0,0
605604,True,0,No user reviews,0,0,0
605610,True,0,No user reviews,0,0,0
605660,True,0,No user reviews,0,0,0
605670,True,0,No user reviews,0,0,0
605690,True,0,No user reviews,0,0,0
605700,True,0,No user reviews,0,0,0
605730,True,0,No user reviews,0,0,0
605740,True,8,Very Positive,3569,567,4136
605750,True,0,No user reviews,0,0,0
605751,True,0,No user reviews,0,0,0
605752,True,0,No user reviews,0,0,0
605753,True,0,No user reviews,0,0,0
605760,True,5,Mixed,17,22,39
605770,True,7,Positive,44,4,48
605780,True,0,2 user reviews,0,2,2
605790,True,0,4 user reviews,4,0,4
605800,True,5,Mixed,15,8,23
605810,True,0,No user reviews,0,0,0
605830,True,8,Very Positive,130,16,146
605850,True,0,No user reviews,0,0,0
605860,True,0,3 user reviews,0,3,3
605880,True,0,No user reviews,0,0,0
605890,True,0,No user reviews,0,0,0
605920,True,7,Positive,27,6,33
605930,True,0,2 user reviews,2,0,2
605951,True,0,No user reviews,0,0,0
605953,True,0,No user reviews,0,0,0
605954,True,0,No user reviews,0,0,0
605955,True,0,No user reviews,0,0,0
605956,True,0,No user reviews,0,0,0
605957,True,0,No user reviews,0,0,0
605958,True,0,No user reviews,0,0,0
605959,True,0,No user reviews,0,0,0
605960,True,0,No user reviews,0,0,0
605961,True,0,No user reviews,0,0,0
605980,True,0,No user reviews,0,0,0
605990,True,8,Very Positive,72,1,73
606000,True,6,Mostly Positive,17,5,22
606010,True,0,No user reviews,0,0,0
606030,True,0,4 user reviews,2,2,4
606060,True,0,5 user reviews,1,4,5
606080,True,5,Mixed,9,6,15
606090,True,0,No user reviews,0,0,0
606100,True,0,1 user reviews,1,0,1
606140,True,0,1 user reviews,0,1,1
606150,True,8,Very Positive,2677,555,3232
606170,True,0,No user reviews,0,0,0
606180,True,0,No user reviews,0,0,0
606190,True,0,6 user reviews,5,1,6
606210,True,0,No user reviews,0,0,0
606220,True,0,No user reviews,0,0,0
606230,True,6,Mostly Positive,605,168,773
606270,True,0,3 user reviews,1,2,3
606280,True,6,Mostly Positive,2051,618,2669
606290,True,0,No user reviews,0,0,0
606300,True,0,3 user reviews,2,1,3
606320,True,0,1 user reviews,0,1,1
606321,True,0,2 user reviews,1,1,2
606330,True,8,Very Positive,47,8,55
606350,True,0,No user reviews,0,0,0
606360,True,0,7 user reviews,5,2,7
606370,True,6,Mostly Positive,47,14,61
606390,True,0,No user reviews,0,0,0
606400,True,0,1 user reviews,1,0,1
606401,True,0,No user reviews,0,0,0
606402,True,0,No user reviews,0,0,0
606403,True,0,No user reviews,0,0,0
606404,True,0,No user reviews,0,0,0
606405,True,0,No user reviews,0,0,0
606406,True,0,No user reviews,0,0,0
606407,True,0,No user reviews,0,0,0
606408,True,0,No user reviews,0,0,0
606409,True,0,No user reviews,0,0,0
606410,True,0,No user reviews,0,0,0
606411,True,0,No user reviews,0,0,0
606420,True,0,No user reviews,0,0,0
606440,True,0,5 user reviews,3,2,5
606441,True,0,1 user reviews,1,0,1
606442,True,0,No user reviews,0,0,0
606443,True,0,No user reviews,0,0,0
606444,True,0,No user reviews,0,0,0
606445,True,0,No user reviews,0,0,0
606446,True,0,No user reviews,0,0,0
606447,True,0,No user reviews,0,0,0
606448,True,0,No user reviews,0,0,0
606449,True,0,No user reviews,0,0,0
606450,True,0,No user reviews,0,0,0
606451,True,0,No user reviews,0,0,0
606460,True,0,2 user reviews,2,0,2
606461,True,0,No user reviews,0,0,0
606462,True,0,No user reviews,0,0,0
606463,True,0,No user reviews,0,0,0
606464,True,0,No user reviews,0,0,0
606465,True,0,No user reviews,0,0,0
606466,True,0,No user reviews,0,0,0
606467,True,0,No user reviews,0,0,0
606468,True,0,No user reviews,0,0,0
606469,True,0,No user reviews,0,0,0
606470,True,0,No user reviews,0,0,0
606471,True,0,No user reviews,0,0,0
606480,True,7,Positive,37,5,42
606490,True,7,Positive,29,6,35
606500,True,6,Mostly Positive,463,116,579
606510,True,8,Very Positive,51,10,61
606520,True,7,Positive,11,1,12
606530,True,0,No user reviews,0,0,0
606540,True,0,1 user reviews,1,0,1
606541,True,0,No user reviews,0,0,0
606542,True,0,No user reviews,0,0,0
606543,True,0,No user reviews,0,0,0
606544,True,0,No user reviews,0,0,0
606545,True,0,No user reviews,0,0,0
606546,True,0,No user reviews,0,0,0
606547,True,0,No user reviews,0,0,0
606548,True,0,No user reviews,0,0,0
606549,True,0,No user reviews,0,0,0
606550,True,0,No user reviews,0,0,0
606551,True,0,No user reviews,0,0,0
606560,True,0,No user reviews,0,0,0
606561,True,0,No user reviews,0,0,0
606562,True,0,No user reviews,0,0,0
606563,True,0,No user reviews,0,0,0
606564,True,0,No user reviews,0,0,0
606565,True,0,No user reviews,0,0,0
606566,True,0,No user reviews,0,0,0
606567,True,0,No user reviews,0,0,0
606568,True,0,No user reviews,0,0,0
606569,True,0,No user reviews,0,0,0
606570,True,0,No user reviews,0,0,0
606571,True,0,No user reviews,0,0,0
606572,True,0,No user reviews,0,0,0
606580,True,0,1 user reviews,1,0,1
606581,True,0,No user reviews,0,0,0
606582,True,0,No user reviews,0,0,0
606583,True,0,No user reviews,0,0,0
606584,True,0,No user reviews,0,0,0
606585,True,0,No user reviews,0,0,0
606586,True,0,No user reviews,0,0,0
606587,True,0,No user reviews,0,0,0
606588,True,0,No user reviews,0,0,0
606589,True,0,No user reviews,0,0,0
606590,True,0,No user reviews,0,0,0
606591,True,0,No user reviews,0,0,0
606592,True,0,No user reviews,0,0,0
606600,True,0,1 user reviews,0,1,1
606601,True,0,No user reviews,0,0,0
606602,True,0,No user reviews,0,0,0
606603,True,0,No user reviews,0,0,0
606604,True,0,No user reviews,0,0,0
606605,True,0,No user reviews,0,0,0
606606,True,0,No user reviews,0,0,0
606607,True,0,No user reviews,0,0,0
606608,True,0,No user reviews,0,0,0
606609,True,0,No user reviews,0,0,0
606610,True,0,No user reviews,0,0,0
606611,True,0,No user reviews,0,0,0
606612,True,0,No user reviews,0,0,0
606613,True,0,No user reviews,0,0,0
606614,True,0,No user reviews,0,0,0
606615,True,0,No user reviews,0,0,0
606616,True,0,No user reviews,0,0,0
606617,True,0,No user reviews,0,0,0
606618,True,0,No user reviews,0,0,0
606619,True,0,No user reviews,0,0,0
606620,True,0,No user reviews,0,0,0
606621,True,0,No user reviews,0,0,0
606622,True,0,No user reviews,0,0,0
606623,True,0,No user reviews,0,0,0
606624,True,0,No user reviews,0,0,0
606625,True,0,No user reviews,0,0,0
606626,True,0,No user reviews,0,0,0
606627,True,0,No user reviews,0,0,0
606628,True,0,No user reviews,0,0,0
606629,True,0,No user reviews,0,0,0
606630,True,0,No user reviews,0,0,0
606631,True,0,No user reviews,0,0,0
606632,True,0,No user reviews,0,0,0
606633,True,0,No user reviews,0,0,0
606634,True,0,No user reviews,0,0,0
606635,True,0,No user reviews,0,0,0
606636,True,0,No user reviews,0,0,0
606637,True,0,No user reviews,0,0,0
606638,True,0,No user reviews,0,0,0
606639,True,0,No user reviews,0,0,0
606640,True,0,No user reviews,0,0,0
606641,True,0,No user reviews,0,0,0
606642,True,0,No user reviews,0,0,0
606643,True,0,No user reviews,0,0,0
606644,True,0,No user reviews,0,0,0
606645,True,0,No user reviews,0,0,0
606646,True,0,No user reviews,0,0,0
606647,True,0,No user reviews,0,0,0
606648,True,0,No user reviews,0,0,0
606649,True,0,2 user reviews,1,1,2
606650,True,0,No user reviews,0,0,0
606651,True,0,No user reviews,0,0,0
606652,True,0,No user reviews,0,0,0
606653,True,0,No user reviews,0,0,0
606654,True,0,No user reviews,0,0,0
606655,True,0,No user reviews,0,0,0
606656,True,0,No user reviews,0,0,0
606657,True,0,No user reviews,0,0,0
606658,True,0,No user reviews,0,0,0
606659,True,0,No user reviews,0,0,0
606660,True,0,No user reviews,0,0,0
606661,True,0,No user reviews,0,0,0
606670,True,0,No user reviews,0,0,0
606680,True,8,Very Positive,130,7,137
606690,True,7,Positive,19,3,22
606710,True,8,Very Positive,213,18,231
606720,True,0,1 user reviews,1,0,1
606730,True,5,Mixed,59,38,97
606740,True,0,No user reviews,0,0,0
606790,True,0,4 user reviews,3,1,4
606800,True,6,Mostly Positive,1547,387,1934
606820,True,0,No user reviews,0,0,0
606850,True,0,2 user reviews,2,0,2
606860,True,5,Mixed,77,48,125
606870,True,7,Positive,12,2,14
606880,True,6,Mostly Positive,4468,1120,5588
606890,True,6,Mostly Positive,47,15,62
606920,True,8,Very Positive,65,1,66
606940,True,7,Positive,13,2,15
606950,True,0,9 user reviews,5,4,9
606960,True,5,Mixed,36,42,78
606970,True,0,No user reviews,0,0,0
606971,True,7,Positive,18,2,20
606980,True,0,No user reviews,0,0,0
607020,True,0,6 user reviews,4,2,6
607030,True,0,7 user reviews,3,4,7
607040,True,5,Mixed,6,5,11
607050,True,8,Very Positive,1464,254,1718
607070,True,0,No user reviews,0,0,0
607080,True,0,No user reviews,0,0,0
607090,True,0,3 user reviews,3,0,3
607100,True,0,No user reviews,0,0,0
607120,True,5,Mixed,23,11,34
607143,True,0,No user reviews,0,0,0
607160,True,0,2 user reviews,2,0,2
607190,True,0,2 user reviews,1,1,2
607200,True,0,1 user reviews,1,0,1
607210,True,5,Mixed,6,6,12
607220,True,0,No user reviews,0,0,0
607230,True,0,No user reviews,0,0,0
607250,True,0,2 user reviews,1,1,2
607260,True,0,No user reviews,0,0,0
607270,True,0,6 user reviews,4,2,6
607330,True,7,Positive,13,0,13
607340,True,0,No user reviews,0,0,0
607350,True,0,2 user reviews,0,2,2
607360,True,0,5 user reviews,4,1,5
607380,True,8,Very Positive,48,3,51
607400,True,8,Very Positive,72,6,78
607440,True,0,3 user reviews,1,2,3
607450,True,0,No user reviews,0,0,0
607460,True,0,No user reviews,0,0,0
607480,True,0,No user reviews,0,0,0
607490,True,0,7 user reviews,7,0,7
607500,True,0,No user reviews,0,0,0
607510,True,0,No user reviews,0,0,0
607540,True,0,No user reviews,0,0,0
607550,True,0,No user reviews,0,0,0
607560,True,0,9 user reviews,9,0,9
607570,True,0,No user reviews,0,0,0
607580,True,0,No user reviews,0,0,0
607590,True,0,7 user reviews,6,1,7
607600,True,0,2 user reviews,2,0,2
607601,True,0,No user reviews,0,0,0
607602,True,0,No user reviews,0,0,0
607603,True,0,No user reviews,0,0,0
607604,True,0,No user reviews,0,0,0
607605,True,0,No user reviews,0,0,0
607606,True,0,No user reviews,0,0,0
607607,True,0,No user reviews,0,0,0
607608,True,0,No user reviews,0,0,0
607609,True,0,No user reviews,0,0,0
607610,True,0,No user reviews,0,0,0
607611,True,0,No user reviews,0,0,0
607612,True,0,No user reviews,0,0,0
607613,True,0,No user reviews,0,0,0
607614,True,0,No user reviews,0,0,0
607615,True,0,No user reviews,0,0,0
607616,True,0,No user reviews,0,0,0
607617,True,0,No user reviews,0,0,0
607618,True,0,No user reviews,0,0,0
607619,True,0,No user reviews,0,0,0
607620,True,0,No user reviews,0,0,0
607621,True,0,No user reviews,0,0,0
607622,True,0,No user reviews,0,0,0
607623,True,0,No user reviews,0,0,0
607650,True,0,No user reviews,0,0,0
607660,True,5,Mixed,14,8,22
607670,True,0,5 user reviews,3,2,5
607680,True,0,5 user reviews,3,2,5
607690,True,0,4 user reviews,0,4,4
607710,True,0,No user reviews,0,0,0
607720,True,0,6 user reviews,4,2,6
607730,True,0,No user reviews,0,0,0
607760,True,0,9 user reviews,8,1,9
607770,True,0,2 user reviews,2,0,2
607780,True,0,3 user reviews,3,0,3
607820,True,8,Very Positive,49,5,54
607830,True,0,3 user reviews,2,1,3
607840,True,0,3 user reviews,3,0,3
607860,True,0,No user reviews,0,0,0
607880,True,6,Mostly Positive,168,57,225
607890,True,6,Mostly Positive,759,268,1027
607900,True,0,No user reviews,0,0,0
607901,True,0,No user reviews,0,0,0
607902,True,0,No user reviews,0,0,0
607903,True,0,No user reviews,0,0,0
607904,True,0,No user reviews,0,0,0
607905,True,0,No user reviews,0,0,0
607906,True,0,No user reviews,0,0,0
607907,True,0,No user reviews,0,0,0
607908,True,0,No user reviews,0,0,0
607909,True,0,No user reviews,0,0,0
607910,True,0,No user reviews,0,0,0
607911,True,0,No user reviews,0,0,0
607912,True,0,No user reviews,0,0,0
607913,True,0,No user reviews,0,0,0
607914,True,0,No user reviews,0,0,0
607915,True,0,No user reviews,0,0,0
607916,True,0,No user reviews,0,0,0
607917,True,0,No user reviews,0,0,0
607918,True,0,No user reviews,0,0,0
607919,True,0,No user reviews,0,0,0
607920,True,0,No user reviews,0,0,0
607921,True,0,No user reviews,0,0,0
607922,True,0,No user reviews,0,0,0
607923,True,0,No user reviews,0,0,0
607924,True,0,No user reviews,0,0,0
607925,True,0,No user reviews,0,0,0
607926,True,0,No user reviews,0,0,0
607927,True,0,No user reviews,0,0,0
607928,True,0,No user reviews,0,0,0
607929,True,0,No user reviews,0,0,0
607930,True,0,No user reviews,0,0,0
607931,True,0,No user reviews,0,0,0
607932,True,0,No user reviews,0,0,0
607933,True,0,No user reviews,0,0,0
607934,True,0,No user reviews,0,0,0
607935,True,0,No user reviews,0,0,0
607936,True,0,No user reviews,0,0,0
607937,True,0,No user reviews,0,0,0
607938,True,0,No user reviews,0,0,0
607939,True,0,No user reviews,0,0,0
607940,True,0,No user reviews,0,0,0
607941,True,0,No user reviews,0,0,0
607942,True,0,No user reviews,0,0,0
607943,True,0,No user reviews,0,0,0
607944,True,0,No user reviews,0,0,0
607945,True,0,No user reviews,0,0,0
607946,True,0,No user reviews,0,0,0
607947,True,0,No user reviews,0,0,0
607948,True,0,No user reviews,0,0,0
607949,True,0,No user reviews,0,0,0
607950,True,0,No user reviews,0,0,0
607951,True,0,No user reviews,0,0,0
607952,True,0,No user reviews,0,0,0
607953,True,0,No user reviews,0,0,0
607954,True,0,No user reviews,0,0,0
607955,True,0,No user reviews,0,0,0
607956,True,0,No user reviews,0,0,0
607957,True,0,No user reviews,0,0,0
607958,True,0,No user reviews,0,0,0
607960,True,0,No user reviews,0,0,0
607980,True,0,1 user reviews,1,0,1
607990,True,0,No user reviews,0,0,0
608000,True,0,No user reviews,0,0,0
608020,True,0,No user reviews,0,0,0
608031,True,0,No user reviews,0,0,0
608040,True,0,No user reviews,0,0,0
608050,True,0,No user reviews,0,0,0
608051,True,0,No user reviews,0,0,0
608052,True,0,No user reviews,0,0,0
608053,True,0,No user reviews,0,0,0
608060,True,0,No user reviews,0,0,0
608070,True,0,No user reviews,0,0,0
608071,True,0,No user reviews,0,0,0
608072,True,0,No user reviews,0,0,0
608073,True,0,No user reviews,0,0,0
608074,True,0,No user reviews,0,0,0
608075,True,0,No user reviews,0,0,0
608076,True,0,No user reviews,0,0,0
608077,True,0,No user reviews,0,0,0
608078,True,0,No user reviews,0,0,0
608079,True,0,No user reviews,0,0,0
608080,True,0,No user reviews,0,0,0
608081,True,0,No user reviews,0,0,0
608090,True,0,No user reviews,0,0,0
608100,True,0,No user reviews,0,0,0
608110,True,7,Positive,14,0,14
608120,True,8,Very Positive,102,13,115
608140,True,0,No user reviews,0,0,0
608150,True,0,No user reviews,0,0,0
608160,True,0,6 user reviews,6,0,6
608170,True,0,2 user reviews,2,0,2
608180,True,0,4 user reviews,4,0,4
608190,True,5,Mixed,5,5,10
608200,True,0,No user reviews,0,0,0
608210,True,0,No user reviews,0,0,0
608220,True,0,No user reviews,0,0,0
608230,True,0,1 user reviews,1,0,1
608231,True,0,No user reviews,0,0,0
608232,True,0,No user reviews,0,0,0
608233,True,0,No user reviews,0,0,0
608234,True,0,No user reviews,0,0,0
608235,True,0,No user reviews,0,0,0
608236,True,0,No user reviews,0,0,0
608237,True,0,No user reviews,0,0,0
608238,True,0,No user reviews,0,0,0
608239,True,0,No user reviews,0,0,0
608240,True,0,No user reviews,0,0,0
608241,True,0,1 user reviews,0,1,1
608250,True,0,3 user reviews,3,0,3
608251,True,0,No user reviews,0,0,0
608252,True,0,No user reviews,0,0,0
608253,True,0,No user reviews,0,0,0
608254,True,0,No user reviews,0,0,0
608255,True,0,1 user reviews,1,0,1
608256,True,0,No user reviews,0,0,0
608257,True,0,No user reviews,0,0,0
608258,True,0,No user reviews,0,0,0
608259,True,0,No user reviews,0,0,0
608260,True,0,No user reviews,0,0,0
608261,True,0,2 user reviews,2,0,2
608270,True,0,6 user reviews,5,1,6
608271,True,0,1 user reviews,1,0,1
608272,True,0,No user reviews,0,0,0
608273,True,0,No user reviews,0,0,0
608274,True,0,No user reviews,0,0,0
608275,True,0,No user reviews,0,0,0
608276,True,0,No user reviews,0,0,0
608277,True,0,No user reviews,0,0,0
608278,True,0,No user reviews,0,0,0
608279,True,0,No user reviews,0,0,0
608280,True,0,1 user reviews,1,0,1
608281,True,0,No user reviews,0,0,0
608282,True,0,No user reviews,0,0,0
608283,True,0,No user reviews,0,0,0
608284,True,0,No user reviews,0,0,0
608285,True,0,No user reviews,0,0,0
608286,True,0,No user reviews,0,0,0
608287,True,0,3 user reviews,3,0,3
608288,True,0,No user reviews,0,0,0
608289,True,0,No user reviews,0,0,0
608290,True,0,No user reviews,0,0,0
608291,True,0,No user reviews,0,0,0
608292,True,0,No user reviews,0,0,0
608293,True,0,No user reviews,0,0,0
608294,True,0,3 user reviews,2,1,3
608300,True,0,1 user reviews,1,0,1
608301,True,0,No user reviews,0,0,0
608302,True,0,No user reviews,0,0,0
608303,True,0,No user reviews,0,0,0
608304,True,0,No user reviews,0,0,0
608305,True,0,No user reviews,0,0,0
608306,True,0,No user reviews,0,0,0
608307,True,0,No user reviews,0,0,0
608308,True,0,No user reviews,0,0,0
608309,True,0,No user reviews,0,0,0
608310,True,0,No user reviews,0,0,0
608311,True,0,No user reviews,0,0,0
608312,True,0,No user reviews,0,0,0
608330,True,0,1 user reviews,1,0,1
608331,True,0,No user reviews,0,0,0
608332,True,0,No user reviews,0,0,0
608333,True,0,No user reviews,0,0,0
608334,True,0,No user reviews,0,0,0
608335,True,0,No user reviews,0,0,0
608336,True,0,No user reviews,0,0,0
608337,True,0,No user reviews,0,0,0
608338,True,0,No user reviews,0,0,0
608339,True,0,No user reviews,0,0,0
608340,True,0,No user reviews,0,0,0
608341,True,0,No user reviews,0,0,0
608350,True,0,No user reviews,0,0,0
608351,True,0,No user reviews,0,0,0
608352,True,0,No user reviews,0,0,0
608353,True,0,No user reviews,0,0,0
608354,True,0,No user reviews,0,0,0
608355,True,0,No user reviews,0,0,0
608356,True,0,No user reviews,0,0,0
608357,True,0,No user reviews,0,0,0
608358,True,0,No user reviews,0,0,0
608359,True,0,No user reviews,0,0,0
608370,True,6,Mostly Positive,28,12,40
608420,True,0,3 user reviews,3,0,3
608440,True,0,No user reviews,0,0,0
608450,True,0,2 user reviews,2,0,2
608460,True,7,Positive,11,2,13
608470,True,0,No user reviews,0,0,0
608480,True,0,No user reviews,0,0,0
608510,True,0,No user reviews,0,0,0
608530,True,5,Mixed,41,60,101
608540,True,0,5 user reviews,2,3,5
608580,True,5,Mixed,5,7,12
608590,True,0,No user reviews,0,0,0
608600,True,0,No user reviews,0,0,0
608610,True,0,No user reviews,0,0,0
608620,True,0,No user reviews,0,0,0
608630,True,0,1 user reviews,1,0,1
608650,True,0,No user reviews,0,0,0
608660,True,7,Positive,26,4,30
608670,True,7,Positive,10,0,10
608680,True,5,Mixed,17,22,39
608720,True,0,2 user reviews,2,0,2
608730,True,0,1 user reviews,0,1,1
608740,True,0,No user reviews,0,0,0
608760,True,7,Positive,18,2,20
608800,True,6,Mostly Positive,275,76,351
608810,True,0,No user reviews,0,0,0
608830,True,3,Negative,3,13,16
608840,True,0,No user reviews,0,0,0
608850,True,0,No user reviews,0,0,0
608870,True,7,Positive,24,3,27
608880,True,0,3 user reviews,3,0,3
608890,True,0,4 user reviews,4,0,4
608891,True,0,1 user reviews,1,0,1
608892,True,0,1 user reviews,1,0,1
608893,True,0,1 user reviews,1,0,1
608894,True,0,2 user reviews,2,0,2
608895,True,0,1 user reviews,1,0,1
608896,True,0,No user reviews,0,0,0
608897,True,0,No user reviews,0,0,0
608898,True,0,No user reviews,0,0,0
608899,True,0,No user reviews,0,0,0
608900,True,0,No user reviews,0,0,0
608901,True,0,1 user reviews,1,0,1
608910,True,0,No user reviews,0,0,0
608911,True,0,No user reviews,0,0,0
608912,True,0,No user reviews,0,0,0
608913,True,0,No user reviews,0,0,0
608914,True,0,No user reviews,0,0,0
608915,True,0,No user reviews,0,0,0
608916,True,0,No user reviews,0,0,0
608917,True,0,No user reviews,0,0,0
608918,True,0,No user reviews,0,0,0
608919,True,0,No user reviews,0,0,0
608920,True,0,No user reviews,0,0,0
608921,True,0,No user reviews,0,0,0
608922,True,0,No user reviews,0,0,0
608923,True,0,No user reviews,0,0,0
608924,True,0,No user reviews,0,0,0
608925,True,0,No user reviews,0,0,0
608926,True,0,No user reviews,0,0,0
608927,True,0,No user reviews,0,0,0
608928,True,0,No user reviews,0,0,0
608929,True,0,No user reviews,0,0,0
608930,True,0,No user reviews,0,0,0
608931,True,0,No user reviews,0,0,0
608932,True,0,No user reviews,0,0,0
608933,True,0,No user reviews,0,0,0
608934,True,0,No user reviews,0,0,0
608935,True,0,No user reviews,0,0,0
608936,True,0,No user reviews,0,0,0
608937,True,0,No user reviews,0,0,0
608938,True,0,No user reviews,0,0,0
608939,True,0,No user reviews,0,0,0
608940,True,0,No user reviews,0,0,0
608941,True,0,No user reviews,0,0,0
608942,True,0,No user reviews,0,0,0
608943,True,0,No user reviews,0,0,0
608944,True,0,No user reviews,0,0,0
608945,True,0,No user reviews,0,0,0
608946,True,0,No user reviews,0,0,0
608947,True,0,No user reviews,0,0,0
608948,True,0,No user reviews,0,0,0
608949,True,0,No user reviews,0,0,0
608950,True,0,No user reviews,0,0,0
608951,True,0,No user reviews,0,0,0
608952,True,0,No user reviews,0,0,0
608953,True,0,No user reviews,0,0,0
608954,True,0,No user reviews,0,0,0
608955,True,0,No user reviews,0,0,0
608956,True,0,No user reviews,0,0,0
608957,True,0,No user reviews,0,0,0
608958,True,0,No user reviews,0,0,0
608960,True,0,No user reviews,0,0,0
608961,True,0,No user reviews,0,0,0
608962,True,0,No user reviews,0,0,0
608963,True,0,No user reviews,0,0,0
608964,True,0,No user reviews,0,0,0
608965,True,0,No user reviews,0,0,0
608966,True,0,No user reviews,0,0,0
608967,True,0,No user reviews,0,0,0
608968,True,0,No user reviews,0,0,0
608969,True,0,No user reviews,0,0,0
608970,True,0,No user reviews,0,0,0
608971,True,0,No user reviews,0,0,0
608980,True,0,No user reviews,0,0,0
608990,True,5,Mixed,100,87,187
609010,True,7,Positive,8,2,10
609020,True,0,3 user reviews,2,1,3
609021,True,0,No user reviews,0,0,0
609022,True,0,No user reviews,0,0,0
609023,True,0,No user reviews,0,0,0
609024,True,0,No user reviews,0,0,0
609025,True,0,No user reviews,0,0,0
609026,True,0,No user reviews,0,0,0
609027,True,0,No user reviews,0,0,0
609028,True,0,No user reviews,0,0,0
609029,True,0,No user reviews,0,0,0
609030,True,0,No user reviews,0,0,0
609031,True,0,No user reviews,0,0,0
609032,True,0,No user reviews,0,0,0
609033,True,0,No user reviews,0,0,0
609034,True,0,No user reviews,0,0,0
609035,True,0,No user reviews,0,0,0
609036,True,0,No user reviews,0,0,0
609037,True,0,No user reviews,0,0,0
609038,True,0,No user reviews,0,0,0
609039,True,0,No user reviews,0,0,0
609040,True,0,No user reviews,0,0,0
609041,True,0,No user reviews,0,0,0
609042,True,0,No user reviews,0,0,0
609043,True,0,No user reviews,0,0,0
609044,True,0,No user reviews,0,0,0
609045,True,0,No user reviews,0,0,0
609046,True,0,No user reviews,0,0,0
609047,True,0,No user reviews,0,0,0
609048,True,0,No user reviews,0,0,0
609049,True,0,No user reviews,0,0,0
609050,True,0,No user reviews,0,0,0
609051,True,0,No user reviews,0,0,0
609052,True,0,No user reviews,0,0,0
609053,True,0,No user reviews,0,0,0
609054,True,0,No user reviews,0,0,0
609055,True,0,No user reviews,0,0,0
609056,True,0,No user reviews,0,0,0
609057,True,0,No user reviews,0,0,0
609058,True,0,No user reviews,0,0,0
609059,True,0,No user reviews,0,0,0
609060,True,0,No user reviews,0,0,0
609061,True,0,No user reviews,0,0,0
609062,True,0,No user reviews,0,0,0
609063,True,0,No user reviews,0,0,0
609064,True,0,No user reviews,0,0,0
609065,True,0,No user reviews,0,0,0
609066,True,0,No user reviews,0,0,0
609067,True,0,No user reviews,0,0,0
609068,True,0,No user reviews,0,0,0
609069,True,0,No user reviews,0,0,0
609070,True,0,No user reviews,0,0,0
609100,True,0,6 user reviews,2,4,6
609110,True,8,Very Positive,209,19,228
609120,True,0,3 user reviews,3,0,3
609150,True,6,Mostly Positive,379,162,541
609170,True,5,Mixed,9,9,18
609200,True,0,1 user reviews,1,0,1
609220,True,0,No user reviews,0,0,0
609240,True,0,No user reviews,0,0,0
609250,True,0,No user reviews,0,0,0
609260,True,0,1 user reviews,1,0,1
609270,True,0,No user reviews,0,0,0
609280,True,0,No user reviews,0,0,0
609290,True,0,No user reviews,0,0,0
609300,True,0,No user reviews,0,0,0
609320,True,8,Very Positive,3053,245,3298
609340,True,0,1 user reviews,1,0,1
609360,True,0,No user reviews,0,0,0
609370,True,0,No user reviews,0,0,0
609380,True,0,No user reviews,0,0,0
609400,True,0,No user reviews,0,0,0
609410,True,6,Mostly Positive,22,8,30
609420,True,7,Positive,32,1,33
609430,True,0,No user reviews,0,0,0
609440,True,0,5 user reviews,5,0,5
609460,True,0,No user reviews,0,0,0
609470,True,0,No user reviews,0,0,0
609480,True,0,No user reviews,0,0,0
609490,True,8,Very Positive,537,46,583
609500,True,0,No user reviews,0,0,0
609510,True,0,No user reviews,0,0,0
609511,True,0,No user reviews,0,0,0
609512,True,0,No user reviews,0,0,0
609513,True,0,No user reviews,0,0,0
609514,True,0,No user reviews,0,0,0
609515,True,0,No user reviews,0,0,0
609520,True,0,No user reviews,0,0,0
609521,True,0,No user reviews,0,0,0
609522,True,0,No user reviews,0,0,0
609523,True,0,No user reviews,0,0,0
609524,True,0,No user reviews,0,0,0
609525,True,0,No user reviews,0,0,0
609530,True,0,No user reviews,0,0,0
609531,True,0,No user reviews,0,0,0
609532,True,0,No user reviews,0,0,0
609533,True,0,No user reviews,0,0,0
609534,True,0,No user reviews,0,0,0
609535,True,0,No user reviews,0,0,0
609540,True,0,No user reviews,0,0,0
609541,True,0,No user reviews,0,0,0
609542,True,0,No user reviews,0,0,0
609543,True,0,No user reviews,0,0,0
609544,True,0,No user reviews,0,0,0
609545,True,0,No user reviews,0,0,0
609546,True,0,No user reviews,0,0,0
609547,True,0,No user reviews,0,0,0
609548,True,0,No user reviews,0,0,0
609549,True,0,No user reviews,0,0,0
609550,True,0,No user reviews,0,0,0
609551,True,0,No user reviews,0,0,0
609560,True,0,No user reviews,0,0,0
609561,True,0,No user reviews,0,0,0
609562,True,0,No user reviews,0,0,0
609563,True,0,No user reviews,0,0,0
609564,True,0,No user reviews,0,0,0
609565,True,0,No user reviews,0,0,0
609566,True,0,No user reviews,0,0,0
609567,True,0,No user reviews,0,0,0
609568,True,0,No user reviews,0,0,0
609569,True,0,No user reviews,0,0,0
609570,True,0,No user reviews,0,0,0
609571,True,0,No user reviews,0,0,0
609580,True,0,No user reviews,0,0,0
609581,True,0,No user reviews,0,0,0
609582,True,0,No user reviews,0,0,0
609583,True,0,No user reviews,0,0,0
609584,True,0,No user reviews,0,0,0
609585,True,0,No user reviews,0,0,0
609586,True,0,No user reviews,0,0,0
609587,True,0,No user reviews,0,0,0
609588,True,0,No user reviews,0,0,0
609589,True,0,No user reviews,0,0,0
609590,True,0,No user reviews,0,0,0
609591,True,0,No user reviews,0,0,0
609600,True,0,No user reviews,0,0,0
609601,True,0,No user reviews,0,0,0
609602,True,0,No user reviews,0,0,0
609603,True,0,No user reviews,0,0,0
609604,True,0,No user reviews,0,0,0
609605,True,0,No user reviews,0,0,0
609606,True,0,No user reviews,0,0,0
609607,True,0,No user reviews,0,0,0
609608,True,0,No user reviews,0,0,0
609609,True,0,No user reviews,0,0,0
609610,True,0,No user reviews,0,0,0
609611,True,0,No user reviews,0,0,0
609612,True,0,No user reviews,0,0,0
609620,True,0,No user reviews,0,0,0
609621,True,0,No user reviews,0,0,0
609622,True,0,No user reviews,0,0,0
609623,True,0,No user reviews,0,0,0
609624,True,0,No user reviews,0,0,0
609625,True,0,No user reviews,0,0,0
609626,True,0,No user reviews,0,0,0
609627,True,0,No user reviews,0,0,0
609628,True,0,No user reviews,0,0,0
609629,True,0,No user reviews,0,0,0
609630,True,0,No user reviews,0,0,0
609631,True,0,No user reviews,0,0,0
609632,True,0,No user reviews,0,0,0
609640,True,0,No user reviews,0,0,0
609641,True,0,No user reviews,0,0,0
609642,True,0,No user reviews,0,0,0
609643,True,0,No user reviews,0,0,0
609644,True,0,No user reviews,0,0,0
609645,True,0,No user reviews,0,0,0
609646,True,0,No user reviews,0,0,0
609647,True,0,No user reviews,0,0,0
609648,True,0,No user reviews,0,0,0
609649,True,0,No user reviews,0,0,0
609650,True,0,No user reviews,0,0,0
609651,True,0,No user reviews,0,0,0
609652,True,0,No user reviews,0,0,0
609660,True,0,No user reviews,0,0,0
609661,True,0,No user reviews,0,0,0
609662,True,0,No user reviews,0,0,0
609663,True,0,No user reviews,0,0,0
609664,True,0,No user reviews,0,0,0
609665,True,0,No user reviews,0,0,0
609666,True,0,No user reviews,0,0,0
609667,True,0,No user reviews,0,0,0
609668,True,0,No user reviews,0,0,0
609669,True,0,No user reviews,0,0,0
609670,True,0,No user reviews,0,0,0
609671,True,0,No user reviews,0,0,0
609680,True,0,No user reviews,0,0,0
609681,True,0,No user reviews,0,0,0
609682,True,0,No user reviews,0,0,0
609683,True,0,No user reviews,0,0,0
609684,True,0,No user reviews,0,0,0
609685,True,0,No user reviews,0,0,0
609686,True,0,No user reviews,0,0,0
609687,True,0,No user reviews,0,0,0
609688,True,0,No user reviews,0,0,0
609689,True,0,No user reviews,0,0,0
609690,True,0,No user reviews,0,0,0
609691,True,0,No user reviews,0,0,0
609700,True,0,No user reviews,0,0,0
609720,True,0,3 user reviews,2,1,3
609730,True,0,No user reviews,0,0,0
609750,True,0,No user reviews,0,0,0
609760,True,7,Positive,21,3,24
609770,True,0,No user reviews,0,0,0
609800,True,4,Mostly Negative,11,22,33
609820,True,0,3 user reviews,2,1,3
609821,True,5,Mixed,16,17,33
609822,True,0,4 user reviews,4,0,4
609823,True,0,3 user reviews,0,3,3
609824,True,0,4 user reviews,3,1,4
609825,True,0,No user reviews,0,0,0
609826,True,5,Mixed,12,10,22
609827,True,0,5 user reviews,3,2,5
609828,True,0,4 user reviews,2,2,4
609829,True,0,4 user reviews,3,1,4
609830,True,0,No user reviews,0,0,0
609850,True,7,Positive,12,1,13
609870,True,0,No user reviews,0,0,0
609880,True,0,7 user reviews,6,1,7
609920,True,6,Mostly Positive,147,48,195
609940,True,0,No user reviews,0,0,0
609970,True,7,Positive,21,4,25
609980,True,0,No user reviews,0,0,0
609990,True,0,6 user reviews,6,0,6
610010,True,0,2 user reviews,1,1,2
610040,True,0,No user reviews,0,0,0
610050,True,0,No user reviews,0,0,0
610051,True,0,No user reviews,0,0,0
610060,True,0,No user reviews,0,0,0
610070,True,0,6 user reviews,5,1,6
610080,True,0,No user reviews,0,0,0
610090,True,0,5 user reviews,5,0,5
610100,True,0,No user reviews,0,0,0
610110,True,0,2 user reviews,2,0,2
610120,True,5,Mixed,6,5,11
610130,True,6,Mostly Positive,31,12,43
610150,True,0,No user reviews,0,0,0
610160,True,5,Mixed,40,32,72
610180,True,8,Very Positive,684,59,743
610190,True,8,Very Positive,107,25,132
610210,True,5,Mixed,7,10,17
610220,True,7,Positive,17,0,17
610221,True,0,2 user reviews,2,0,2
610222,True,0,5 user reviews,5,0,5
610250,True,7,Positive,14,0,14
610260,True,0,2 user reviews,0,2,2
610270,True,0,1 user reviews,1,0,1
610280,True,0,5 user reviews,5,0,5
610290,True,0,4 user reviews,2,2,4
610310,True,7,Positive,23,3,26
610330,True,0,No user reviews,0,0,0
610340,True,0,6 user reviews,4,2,6
610350,True,4,Mostly Negative,7,13,20
610360,True,8,Very Positive,401,33,434
610370,True,9,Overwhelmingly Positive,1163,36,1199
610380,True,5,Mixed,33,40,73
610400,True,7,Positive,39,4,43
610410,True,7,Positive,19,1,20
610420,True,0,No user reviews,0,0,0
610460,True,0,1 user reviews,1,0,1
610470,True,0,No user reviews,0,0,0
610480,True,0,No user reviews,0,0,0
610490,True,0,4 user reviews,3,1,4
610500,True,5,Mixed,58,28,86
610510,True,0,No user reviews,0,0,0
610520,True,7,Positive,10,1,11
610530,True,0,1 user reviews,1,0,1
610550,True,0,1 user reviews,1,0,1
610560,True,0,3 user reviews,2,1,3
610570,True,5,Mixed,11,12,23
610610,True,7,Positive,16,2,18
610620,True,0,No user reviews,0,0,0
610630,True,0,No user reviews,0,0,0
610640,True,0,1 user reviews,1,0,1
610650,True,0,No user reviews,0,0,0
610660,True,7,Positive,10,2,12
610670,True,4,Mostly Negative,6,19,25
610680,True,5,Mixed,25,27,52
610690,True,0,2 user reviews,2,0,2
610691,True,0,No user reviews,0,0,0
610692,True,0,4 user reviews,4,0,4
610693,True,7,Positive,12,1,13
610694,True,0,1 user reviews,1,0,1
610695,True,0,5 user reviews,3,2,5
610696,True,0,No user reviews,0,0,0
610697,True,0,1 user reviews,0,1,1
610698,True,0,4 user reviews,4,0,4
610699,True,0,8 user reviews,6,2,8
610700,True,0,9 user reviews,5,4,9
610701,True,0,7 user reviews,4,3,7
610702,True,0,2 user reviews,2,0,2
610703,True,5,Mixed,16,10,26
610704,True,5,Mixed,6,5,11
610705,True,0,7 user reviews,6,1,7
610720,True,0,No user reviews,0,0,0
610730,True,0,7 user reviews,5,2,7
610740,True,5,Mixed,9,4,13
610750,True,6,Mostly Positive,66,21,87
610760,True,0,No user reviews,0,0,0
610780,True,0,7 user reviews,2,5,7
610790,True,0,No user reviews,0,0,0
610810,True,5,Mixed,134,72,206
610820,True,0,No user reviews,0,0,0
610830,True,0,No user reviews,0,0,0
610840,True,6,Mostly Positive,25,8,33
610850,True,0,No user reviews,0,0,0
610860,True,5,Mixed,29,26,55
610870,True,0,No user reviews,0,0,0
610900,True,7,Positive,48,0,48
610910,True,0,2 user reviews,2,0,2
610940,True,0,No user reviews,0,0,0
610960,True,7,Positive,17,1,18
610970,True,0,3 user reviews,3,0,3
610980,True,0,7 user reviews,7,0,7
610990,True,0,No user reviews,0,0,0
611020,True,0,No user reviews,0,0,0
611040,True,6,Mostly Positive,149,62,211
611050,True,0,4 user reviews,2,2,4
611060,True,6,Mostly Positive,9,3,12
611080,True,0,No user reviews,0,0,0
611090,True,0,No user reviews,0,0,0
611110,True,5,Mixed,5,6,11
611120,True,0,No user reviews,0,0,0
611140,True,0,8 user reviews,4,4,8
611160,True,8,Very Positive,380,43,423
611170,True,0,No user reviews,0,0,0
611180,True,5,Mixed,36,37,73
611190,True,0,No user reviews,0,0,0
611200,True,0,No user reviews,0,0,0
611210,True,0,No user reviews,0,0,0
611220,True,0,No user reviews,0,0,0
611230,True,7,Positive,33,8,41
611250,True,0,No user reviews,0,0,0
611260,True,0,1 user reviews,1,0,1
611270,True,0,No user reviews,0,0,0
611300,True,0,No user reviews,0,0,0
611310,True,0,No user reviews,0,0,0
611320,True,7,Positive,14,3,17
611350,True,5,Mixed,30,19,49
611370,True,7,Positive,13,1,14
611390,True,0,6 user reviews,6,0,6
611400,True,7,Positive,12,3,15
611420,True,5,Mixed,9,5,14
611421,True,7,Positive,27,6,33
611430,True,0,1 user reviews,1,0,1
611431,True,0,No user reviews,0,0,0
611432,True,0,No user reviews,0,0,0
611440,True,0,No user reviews,0,0,0
611441,True,0,No user reviews,0,0,0
611442,True,0,No user reviews,0,0,0
611443,True,0,No user reviews,0,0,0
611444,True,0,No user reviews,0,0,0
611445,True,0,No user reviews,0,0,0
611446,True,0,No user reviews,0,0,0
611447,True,0,No user reviews,0,0,0
611448,True,0,No user reviews,0,0,0
611449,True,0,No user reviews,0,0,0
611450,True,0,No user reviews,0,0,0
611451,True,0,No user reviews,0,0,0
611452,True,0,No user reviews,0,0,0
611460,True,0,No user reviews,0,0,0
611470,True,0,No user reviews,0,0,0
611480,True,0,No user reviews,0,0,0
611481,True,0,No user reviews,0,0,0
611482,True,0,No user reviews,0,0,0
611483,True,0,No user reviews,0,0,0
611484,True,0,No user reviews,0,0,0
611485,True,0,No user reviews,0,0,0
611486,True,0,No user reviews,0,0,0
611487,True,0,No user reviews,0,0,0
611488,True,0,No user reviews,0,0,0
611489,True,0,No user reviews,0,0,0
611490,True,0,No user reviews,0,0,0
611491,True,0,No user reviews,0,0,0
611492,True,0,No user reviews,0,0,0
611493,True,0,No user reviews,0,0,0
611494,True,0,No user reviews,0,0,0
611495,True,0,No user reviews,0,0,0
611496,True,0,No user reviews,0,0,0
611497,True,0,No user reviews,0,0,0
611498,True,0,No user reviews,0,0,0
611500,True,6,Mostly Positive,2584,943,3527
611510,True,0,No user reviews,0,0,0
611511,True,0,No user reviews,0,0,0
611512,True,0,No user reviews,0,0,0
611513,True,0,No user reviews,0,0,0
611514,True,0,No user reviews,0,0,0
611520,True,0,No user reviews,0,0,0
611521,True,0,No user reviews,0,0,0
611522,True,0,No user reviews,0,0,0
611523,True,0,No user reviews,0,0,0
611524,True,0,No user reviews,0,0,0
611525,True,0,No user reviews,0,0,0
611526,True,0,No user reviews,0,0,0
611527,True,0,No user reviews,0,0,0
611528,True,0,No user reviews,0,0,0
611540,True,0,No user reviews,0,0,0
611541,True,0,No user reviews,0,0,0
611542,True,0,No user reviews,0,0,0
611543,True,0,No user reviews,0,0,0
611544,True,0,No user reviews,0,0,0
611545,True,0,No user reviews,0,0,0
611546,True,0,No user reviews,0,0,0
611547,True,0,No user reviews,0,0,0
611548,True,0,No user reviews,0,0,0
611549,True,0,No user reviews,0,0,0
611550,True,0,2 user reviews,2,0,2
611590,True,0,No user reviews,0,0,0
611620,True,5,Mixed,7,5,12
611630,True,7,Positive,16,3,19
611640,True,7,Positive,21,3,24
611650,True,0,No user reviews,0,0,0
611660,True,5,Mixed,1742,864,2606
611670,True,6,Mostly Positive,2422,724,3146
611690,True,0,6 user reviews,2,4,6
611710,True,7,Positive,14,0,14
611720,True,7,Positive,20,3,23
611730,True,0,3 user reviews,2,1,3
611740,True,0,5 user reviews,5,0,5
611750,True,5,Mixed,56,50,106
611760,True,9,Overwhelmingly Positive,568,6,574
611770,True,7,Positive,15,3,18
611780,True,5,Mixed,14,9,23
611790,True,8,Very Positive,2684,358,3042
611800,True,5,Mixed,113,76,189
611810,True,0,6 user reviews,2,4,6
611820,True,0,No user reviews,0,0,0
611830,True,7,Positive,36,4,40
611850,True,7,Positive,12,1,13
611860,True,6,Mostly Positive,10,4,14
611890,True,0,No user reviews,0,0,0
611950,True,0,No user reviews,0,0,0
611960,True,0,7 user reviews,5,2,7
611970,True,0,2 user reviews,0,2,2
611980,True,8,Very Positive,124,17,141
611990,True,0,No user reviews,0,0,0
612000,True,0,No user reviews,0,0,0
612010,True,0,3 user reviews,1,2,3
612020,True,0,No user reviews,0,0,0
612030,True,0,8 user reviews,5,3,8
612040,True,0,No user reviews,0,0,0
612050,True,0,No user reviews,0,0,0
612060,True,0,5 user reviews,4,1,5
612070,True,6,Mostly Positive,267,97,364
612100,True,8,Very Positive,67,8,75
612110,True,6,Mostly Positive,84,33,117
612120,True,5,Mixed,7,5,12
612130,True,0,No user reviews,0,0,0
612140,True,7,Positive,12,1,13
612150,True,0,6 user reviews,3,3,6
612160,True,0,5 user reviews,5,0,5
612170,True,0,9 user reviews,5,4,9
612180,True,0,No user reviews,0,0,0
612190,True,0,9 user reviews,5,4,9
612200,True,0,No user reviews,0,0,0
612210,True,0,8 user reviews,8,0,8
612220,True,0,5 user reviews,1,4,5
612240,True,0,No user reviews,0,0,0
612250,True,0,8 user reviews,2,6,8
612260,True,0,1 user reviews,1,0,1
612261,True,5,Mixed,7,4,11
612280,True,0,No user reviews,0,0,0
612300,True,8,Very Positive,49,11,60
612310,True,0,8 user reviews,7,1,8
612320,True,0,2 user reviews,1,1,2
612330,True,0,1 user reviews,1,0,1
612360,True,0,No user reviews,0,0,0
612370,True,8,Very Positive,169,8,177
612380,True,0,2 user reviews,1,1,2
612390,True,8,Very Positive,149,29,178
612400,True,0,No user reviews,0,0,0
612420,True,0,No user reviews,0,0,0
612430,True,0,No user reviews,0,0,0
612440,True,0,No user reviews,0,0,0
612470,True,8,Very Positive,426,72,498
612480,True,7,Positive,31,1,32
612490,True,0,No user reviews,0,0,0
612491,True,0,3 user reviews,3,0,3
612500,True,0,No user reviews,0,0,0
612510,True,0,5 user reviews,1,4,5
612520,True,7,Positive,40,7,47
612540,True,5,Mixed,24,12,36
612550,True,0,No user reviews,0,0,0
612570,True,6,Mostly Positive,189,55,244
612580,True,0,No user reviews,0,0,0
612590,True,0,No user reviews,0,0,0
612600,True,7,Positive,12,0,12
612610,True,0,No user reviews,0,0,0
612620,True,0,No user reviews,0,0,0
612630,True,0,9 user reviews,4,5,9
612631,True,0,6 user reviews,4,2,6
612640,True,7,Positive,18,1,19
612650,True,0,1 user reviews,1,0,1
612660,True,0,No user reviews,0,0,0
612670,True,7,Positive,14,0,14
612720,True,6,Mostly Positive,274,79,353
612730,True,0,No user reviews,0,0,0
612740,True,6,Mostly Positive,35,14,49
612750,True,0,No user reviews,0,0,0
612790,True,0,No user reviews,0,0,0
612810,True,5,Mixed,8,9,17
612820,True,7,Positive,16,4,20
612830,True,0,No user reviews,0,0,0
612840,True,0,9 user reviews,8,1,9
612850,True,0,No user reviews,0,0,0
612870,True,0,1 user reviews,1,0,1
612880,True,6,Mostly Positive,5965,2330,8295
612890,True,0,6 user reviews,6,0,6
612900,True,6,Mostly Positive,115,38,153
612930,True,8,Very Positive,255,48,303
612940,True,0,No user reviews,0,0,0
612950,True,0,No user reviews,0,0,0
612960,True,5,Mixed,10,12,22
612970,True,0,No user reviews,0,0,0
612980,True,0,No user reviews,0,0,0
613000,True,0,No user reviews,0,0,0
613010,True,0,6 user reviews,4,2,6
613020,True,0,3 user reviews,3,0,3
613040,True,0,5 user reviews,3,2,5
613050,True,0,No user reviews,0,0,0
613070,True,0,No user reviews,0,0,0
613080,True,0,No user reviews,0,0,0
613090,True,0,No user reviews,0,0,0
613091,True,0,No user reviews,0,0,0
613092,True,0,No user reviews,0,0,0
613093,True,0,No user reviews,0,0,0
613094,True,0,No user reviews,0,0,0
613095,True,0,No user reviews,0,0,0
613096,True,0,No user reviews,0,0,0
613100,True,8,Very Positive,13469,1541,15010
613120,True,0,6 user reviews,5,1,6
613130,True,7,Positive,12,0,12
613140,True,0,4 user reviews,3,1,4
613150,True,0,No user reviews,0,0,0
613160,True,0,No user reviews,0,0,0
613170,True,0,4 user reviews,3,1,4
613190,True,8,Very Positive,178,38,216
613200,True,7,Positive,9,1,10
613210,True,0,3 user reviews,3,0,3
613220,True,0,No user reviews,0,0,0
613230,True,0,5 user reviews,2,3,5
613240,True,7,Positive,35,0,35
613250,True,0,2 user reviews,1,1,2
613260,True,7,Positive,14,2,16
613270,True,5,Mixed,49,45,94
613290,True,0,No user reviews,0,0,0
613291,True,0,No user reviews,0,0,0
613292,True,0,No user reviews,0,0,0
613293,True,0,No user reviews,0,0,0
613294,True,0,No user reviews,0,0,0
613295,True,0,No user reviews,0,0,0
613296,True,0,No user reviews,0,0,0
613297,True,0,No user reviews,0,0,0
613298,True,0,No user reviews,0,0,0
613299,True,0,No user reviews,0,0,0
613310,True,0,No user reviews,0,0,0
613320,True,0,No user reviews,0,0,0
613321,True,0,No user reviews,0,0,0
613322,True,0,No user reviews,0,0,0
613323,True,0,No user reviews,0,0,0
613324,True,0,No user reviews,0,0,0
613330,True,5,Mixed,4,6,10
613340,True,0,No user reviews,0,0,0
613350,True,0,1 user reviews,1,0,1
613370,True,0,No user reviews,0,0,0
613380,True,0,No user reviews,0,0,0
613390,True,8,Very Positive,123,10,133
613400,True,0,3 user reviews,2,1,3
613410,True,4,Mostly Negative,3,7,10
613420,True,7,Positive,11,1,12
613430,True,0,2 user reviews,1,1,2
613450,True,8,Very Positive,84,6,90
613470,True,8,Very Positive,70,7,77
613520,True,0,2 user reviews,2,0,2
613550,True,0,No user reviews,0,0,0
613580,True,0,4 user reviews,2,2,4
613590,True,0,2 user reviews,2,0,2
613610,True,0,3 user reviews,3,0,3
613620,True,0,2 user reviews,2,0,2
613660,True,0,1 user reviews,1,0,1
613670,True,0,2 user reviews,1,1,2
613680,True,0,No user reviews,0,0,0
613690,True,0,No user reviews,0,0,0
613700,True,0,No user reviews,0,0,0
613710,True,0,No user reviews,0,0,0
613730,True,6,Mostly Positive,116,49,165
613790,True,7,Positive,15,3,18
613830,True,8,Very Positive,1578,323,1901
613850,True,0,5 user reviews,2,3,5
613860,True,5,Mixed,11,11,22
613870,True,0,No user reviews,0,0,0
613880,True,5,Mixed,178,164,342
613900,True,7,Positive,35,1,36
613920,True,0,No user reviews,0,0,0
613950,True,0,No user reviews,0,0,0
613960,True,0,No user reviews,0,0,0
613970,True,0,6 user reviews,0,6,6
613980,True,0,5 user reviews,4,1,5
613990,True,0,No user reviews,0,0,0
614000,True,0,No user reviews,0,0,0
614001,True,0,1 user reviews,1,0,1
614002,True,0,1 user reviews,1,0,1
614003,True,0,1 user reviews,1,0,1
614004,True,5,Mixed,11,15,26
614005,True,4,Mostly Negative,3,11,14
614006,True,0,5 user reviews,3,2,5
614007,True,0,9 user reviews,4,5,9
614008,True,0,No user reviews,0,0,0
614009,True,0,No user reviews,0,0,0
614010,True,0,No user reviews,0,0,0
614020,True,0,1 user reviews,1,0,1
614030,True,5,Mixed,34,17,51
614050,True,0,4 user reviews,0,4,4
614080,True,0,1 user reviews,1,0,1
614090,True,0,4 user reviews,3,1,4
614100,True,0,No user reviews,0,0,0
614130,True,7,Positive,15,2,17
614140,True,0,7 user reviews,4,3,7
614150,True,0,5 user reviews,5,0,5
614160,True,0,2 user reviews,1,1,2
614170,True,0,No user reviews,0,0,0
614180,True,0,3 user reviews,3,0,3
614190,True,0,No user reviews,0,0,0
614200,True,0,1 user reviews,1,0,1
614210,True,0,No user reviews,0,0,0
614211,True,0,No user reviews,0,0,0
614212,True,0,No user reviews,0,0,0
614213,True,0,No user reviews,0,0,0
614214,True,0,No user reviews,0,0,0
614220,True,0,No user reviews,0,0,0
614221,True,0,No user reviews,0,0,0
614230,True,0,No user reviews,0,0,0
614240,True,0,No user reviews,0,0,0
614250,True,0,No user reviews,0,0,0
614260,True,5,Mixed,21,15,36
614270,True,0,No user reviews,0,0,0
614280,True,0,No user reviews,0,0,0
614290,True,0,No user reviews,0,0,0
614300,True,0,No user reviews,0,0,0
614330,True,0,No user reviews,0,0,0
614340,True,0,No user reviews,0,0,0
614350,True,0,No user reviews,0,0,0
614360,True,0,No user reviews,0,0,0
614370,True,0,No user reviews,0,0,0
614380,True,0,1 user reviews,0,1,1
614390,True,0,No user reviews,0,0,0
614410,True,0,No user reviews,0,0,0
614420,True,0,No user reviews,0,0,0
614450,True,0,7 user reviews,2,5,7
614460,True,0,1 user reviews,1,0,1
614500,True,0,No user reviews,0,0,0
614510,True,0,No user reviews,0,0,0
614520,True,0,No user reviews,0,0,0
614530,True,0,5 user reviews,2,3,5
614550,True,0,1 user reviews,1,0,1
614560,True,0,9 user reviews,3,6,9
614570,True,8,Very Positive,1705,320,2025
614580,True,6,Mostly Positive,113,38,151
614581,True,5,Mixed,55,48,103
614582,True,6,Mostly Positive,26,8,34
614590,True,0,No user reviews,0,0,0
614610,True,0,No user reviews,0,0,0
614620,True,0,No user reviews,0,0,0
614630,True,6,Mostly Positive,129,53,182
614650,True,0,1 user reviews,1,0,1
614660,True,0,9 user reviews,5,4,9
614680,True,0,No user reviews,0,0,0
614700,True,0,3 user reviews,3,0,3
614710,True,0,No user reviews,0,0,0
614720,True,0,No user reviews,0,0,0
614730,True,0,No user reviews,0,0,0
614750,True,0,No user reviews,0,0,0
614760,True,0,No user reviews,0,0,0
614770,True,4,Mostly Negative,3,10,13
614780,True,0,No user reviews,0,0,0
614820,True,0,No user reviews,0,0,0
614830,True,7,Positive,20,1,21
614850,True,0,2 user reviews,0,2,2
614860,True,6,Mostly Positive,28,11,39
614870,True,0,No user reviews,0,0,0
614880,True,0,2 user reviews,0,2,2
614890,True,6,Mostly Positive,13,4,17
614900,True,6,Mostly Positive,10,4,14
614910,True,8,Very Positive,118,23,141
614940,True,0,No user reviews,0,0,0
614950,True,8,Very Positive,59,12,71
614960,True,0,9 user reviews,7,2,9
614970,True,5,Mixed,20,16,36
614980,True,0,No user reviews,0,0,0
615010,True,8,Very Positive,62,8,70
615020,True,7,Positive,23,3,26
615030,True,0,No user reviews,0,0,0
615050,True,0,No user reviews,0,0,0
615070,True,0,2 user reviews,1,1,2
615080,True,0,4 user reviews,4,0,4
615090,True,7,Positive,20,3,23
615100,True,0,No user reviews,0,0,0
615120,True,9,Overwhelmingly Positive,501,13,514
615130,True,0,No user reviews,0,0,0
615140,True,0,No user reviews,0,0,0
615150,True,0,9 user reviews,8,1,9
615160,True,0,2 user reviews,1,1,2
615170,True,0,No user reviews,0,0,0
615180,True,5,Mixed,27,13,40
615190,True,0,No user reviews,0,0,0
615200,True,0,1 user reviews,1,0,1
615210,True,0,No user reviews,0,0,0
615250,True,7,Positive,30,2,32
615260,True,0,No user reviews,0,0,0
615270,True,7,Positive,9,1,10
615300,True,0,No user reviews,0,0,0
615320,True,0,No user reviews,0,0,0
615330,True,7,Positive,16,2,18
615340,True,0,No user reviews,0,0,0
615350,True,8,Very Positive,52,7,59
615360,True,0,No user reviews,0,0,0
615380,True,7,Positive,16,3,19
615390,True,0,2 user reviews,0,2,2
615400,True,0,No user reviews,0,0,0
615410,True,0,No user reviews,0,0,0
615420,True,0,2 user reviews,2,0,2
615430,True,0,No user reviews,0,0,0
615440,True,0,No user reviews,0,0,0
615460,True,0,No user reviews,0,0,0
615490,True,0,6 user reviews,4,2,6
615500,True,0,No user reviews,0,0,0
615530,True,0,No user reviews,0,0,0
615540,True,0,9 user reviews,9,0,9
615550,True,0,5 user reviews,4,1,5
615560,True,0,No user reviews,0,0,0
615561,True,0,No user reviews,0,0,0
615570,True,0,No user reviews,0,0,0
615571,True,0,No user reviews,0,0,0
615572,True,0,No user reviews,0,0,0
615573,True,0,No user reviews,0,0,0
615574,True,0,No user reviews,0,0,0
615575,True,0,No user reviews,0,0,0
615576,True,0,No user reviews,0,0,0
615577,True,0,No user reviews,0,0,0
615578,True,0,No user reviews,0,0,0
615579,True,0,No user reviews,0,0,0
615580,True,0,No user reviews,0,0,0
615581,True,0,No user reviews,0,0,0
615582,True,0,No user reviews,0,0,0
615583,True,0,No user reviews,0,0,0
615590,True,0,2 user reviews,2,0,2
615600,True,0,No user reviews,0,0,0
615601,True,0,No user reviews,0,0,0
615602,True,0,No user reviews,0,0,0
615603,True,0,No user reviews,0,0,0
615604,True,0,No user reviews,0,0,0
615610,True,9,Overwhelmingly Positive,1101,21,1122
615620,True,0,No user reviews,0,0,0
615630,True,5,Mixed,14,11,25
615650,True,0,No user reviews,0,0,0
615670,True,6,Mostly Positive,28,8,36
615680,True,0,7 user reviews,3,4,7
615690,True,0,1 user reviews,1,0,1
615700,True,0,3 user reviews,3,0,3
615710,True,0,No user reviews,0,0,0
615720,True,0,1 user reviews,1,0,1
615730,True,7,Positive,31,6,37
615770,True,6,Mostly Positive,36,12,48
615780,True,7,Positive,35,8,43
615910,True,6,Mostly Positive,34,14,48
615920,True,0,No user reviews,0,0,0
615930,True,0,4 user reviews,4,0,4
615960,True,0,No user reviews,0,0,0
615970,True,0,8 user reviews,5,3,8
615981,True,0,No user reviews,0,0,0
616000,True,8,Very Positive,46,5,51
616030,True,0,No user reviews,0,0,0
616040,True,0,3 user reviews,3,0,3
616050,True,0,No user reviews,0,0,0
616070,True,0,No user reviews,0,0,0
616090,True,0,No user reviews,0,0,0
616100,True,0,No user reviews,0,0,0
616110,True,8,Very Positive,1009,117,1126
616120,True,0,No user reviews,0,0,0
616130,True,0,4 user reviews,4,0,4
616150,True,0,2 user reviews,1,1,2
616160,True,0,2 user reviews,1,1,2
616170,True,5,Mixed,15,7,22
616180,True,0,4 user reviews,3,1,4
616190,True,7,Positive,13,2,15
616191,True,6,Mostly Positive,29,9,38
616200,True,6,Mostly Positive,55,16,71
616210,True,0,7 user reviews,3,4,7
616220,True,0,No user reviews,0,0,0
616240,True,5,Mixed,20,21,41
616250,True,9,Overwhelmingly Positive,889,40,929
616260,True,0,No user reviews,0,0,0
616280,True,0,No user reviews,0,0,0
616290,True,7,Positive,11,0,11
616300,True,0,No user reviews,0,0,0
616330,True,0,No user reviews,0,0,0
616340,True,0,No user reviews,0,0,0
616350,True,0,5 user reviews,2,3,5
616370,True,0,5 user reviews,5,0,5
616380,True,0,No user reviews,0,0,0
616410,True,0,No user reviews,0,0,0
616420,True,0,No user reviews,0,0,0
616430,True,0,No user reviews,0,0,0
616440,True,0,No user reviews,0,0,0
616480,True,0,No user reviews,0,0,0
616490,True,0,5 user reviews,2,3,5
616500,True,0,4 user reviews,3,1,4
616510,True,0,No user reviews,0,0,0
616520,True,7,Positive,27,1,28
616530,True,0,1 user reviews,1,0,1
616540,True,0,No user reviews,0,0,0
616550,True,0,1 user reviews,0,1,1
616560,True,6,Mostly Positive,2619,1101,3720
616570,True,0,No user reviews,0,0,0
616580,True,0,No user reviews,0,0,0
616590,True,0,No user reviews,0,0,0
616600,True,0,No user reviews,0,0,0
616610,True,0,No user reviews,0,0,0
616620,True,6,Mostly Positive,49,13,62
616640,True,0,3 user reviews,3,0,3
616650,True,0,1 user reviews,0,1,1
616660,True,0,9 user reviews,6,3,9
616680,True,0,2 user reviews,2,0,2
616690,True,7,Positive,13,3,16
616700,True,0,No user reviews,0,0,0
616720,True,8,Very Positive,106,13,119
616730,True,0,No user reviews,0,0,0
616740,True,0,2 user reviews,2,0,2
616750,True,0,9 user reviews,6,3,9
616780,True,0,No user reviews,0,0,0
616810,True,0,No user reviews,0,0,0
616820,True,0,No user reviews,0,0,0
616830,True,0,No user reviews,0,0,0
616840,True,0,6 user reviews,6,0,6
616850,True,6,Mostly Positive,62,19,81
616860,True,0,1 user reviews,0,1,1
616880,True,0,9 user reviews,8,1,9
616890,True,7,Positive,9,2,11
616901,True,0,No user reviews,0,0,0
616920,True,8,Very Positive,58,11,69
616940,True,0,No user reviews,0,0,0
616950,True,7,Positive,26,2,28
616960,True,0,2 user reviews,1,1,2
616970,True,0,1 user reviews,1,0,1
616980,True,0,2 user reviews,1,1,2
616990,True,0,2 user reviews,0,2,2
617000,True,0,1 user reviews,0,1,1
617001,True,0,1 user reviews,0,1,1
617010,True,0,No user reviews,0,0,0
617020,True,0,2 user reviews,0,2,2
617030,True,5,Mixed,73,64,137
617040,True,0,9 user reviews,9,0,9
617050,True,0,No user reviews,0,0,0
617060,True,0,6 user reviews,5,1,6
617070,True,0,No user reviews,0,0,0
617090,True,0,7 user reviews,4,3,7
617100,True,0,4 user reviews,2,2,4
617110,True,0,3 user reviews,2,1,3
617120,True,0,4 user reviews,3,1,4
617130,True,0,No user reviews,0,0,0
617140,True,0,6 user reviews,6,0,6
617150,True,0,No user reviews,0,0,0
617160,True,8,Very Positive,288,68,356
617190,True,0,3 user reviews,3,0,3
617200,True,0,No user reviews,0,0,0
617210,True,0,2 user reviews,1,1,2
617211,True,0,1 user reviews,1,0,1
617212,True,0,1 user reviews,1,0,1
617213,True,0,1 user reviews,1,0,1
617214,True,0,1 user reviews,1,0,1
617215,True,0,1 user reviews,1,0,1
617216,True,0,1 user reviews,1,0,1
617217,True,0,1 user reviews,1,0,1
617218,True,0,1 user reviews,1,0,1
617219,True,0,1 user reviews,1,0,1
617220,True,0,1 user reviews,1,0,1
617230,True,0,2 user reviews,1,1,2
617270,True,0,6 user reviews,6,0,6
617290,True,8,Very Positive,13567,1995,15562
617340,True,0,No user reviews,0,0,0
617350,True,0,No user reviews,0,0,0
617360,True,0,3 user reviews,3,0,3
617370,True,0,1 user reviews,0,1,1
617380,True,0,No user reviews,0,0,0
617400,True,0,No user reviews,0,0,0
617420,True,0,9 user reviews,5,4,9
617430,True,7,Positive,11,1,12
617440,True,8,Very Positive,47,3,50
617450,True,5,Mixed,18,9,27
617470,True,0,No user reviews,0,0,0
617480,True,8,Very Positive,808,131,939
617540,True,0,No user reviews,0,0,0
617550,True,0,4 user reviews,3,1,4
617560,True,0,1 user reviews,1,0,1
617570,True,0,6 user reviews,6,0,6
617580,True,0,4 user reviews,3,1,4
617590,True,5,Mixed,8,11,19
617600,True,0,No user reviews,0,0,0
617610,True,7,Positive,26,2,28
617620,True,7,Positive,10,0,10
617630,True,0,5 user reviews,3,2,5
617640,True,5,Mixed,51,24,75
617660,True,0,5 user reviews,3,2,5
617670,True,9,Overwhelmingly Positive,623,20,643
617680,True,0,9 user reviews,5,4,9
617690,True,0,1 user reviews,1,0,1
617700,True,8,Very Positive,294,55,349
617710,True,5,Mixed,15,9,24
617720,True,0,No user reviews,0,0,0
617730,True,0,No user reviews,0,0,0
617740,True,0,No user reviews,0,0,0
617750,True,0,2 user reviews,1,1,2
617780,True,0,No user reviews,0,0,0
617810,True,0,No user reviews,0,0,0
617820,True,0,3 user reviews,2,1,3
617830,True,8,Very Positive,2873,365,3238
617850,True,5,Mixed,29,15,44
617860,True,0,No user reviews,0,0,0
617870,True,8,Very Positive,827,95,922
617880,True,0,No user reviews,0,0,0
617890,True,0,No user reviews,0,0,0
617910,True,0,No user reviews,0,0,0
617930,True,0,No user reviews,0,0,0
617940,True,0,No user reviews,0,0,0
617950,True,0,No user reviews,0,0,0
617960,True,4,Mostly Negative,4,7,11
617961,True,0,1 user reviews,1,0,1
617962,True,0,7 user reviews,3,4,7
617970,True,5,Mixed,12,8,20
618010,True,0,8 user reviews,8,0,8
618050,True,5,Mixed,11,13,24
618060,True,0,No user reviews,0,0,0
618070,True,0,9 user reviews,8,1,9
618080,True,0,No user reviews,0,0,0
618090,True,0,No user reviews,0,0,0
618100,True,6,Mostly Positive,60,22,82
618110,True,0,No user reviews,0,0,0
618140,True,6,Mostly Positive,140,40,180
618180,True,0,3 user reviews,3,0,3
618190,True,0,3 user reviews,3,0,3
618200,True,0,7 user reviews,2,5,7
618210,True,0,7 user reviews,6,1,7
618260,True,0,1 user reviews,1,0,1
618270,True,5,Mixed,7,6,13
618280,True,0,2 user reviews,1,1,2
618310,True,0,2 user reviews,1,1,2
618320,True,0,No user reviews,0,0,0
618330,True,0,No user reviews,0,0,0
618350,True,7,Positive,21,1,22
618360,True,7,Positive,17,1,18
618370,True,7,Positive,12,3,15
618430,True,0,5 user reviews,3,2,5
618460,True,0,No user reviews,0,0,0
618470,True,7,Positive,24,2,26
618480,True,0,No user reviews,0,0,0
618490,True,0,5 user reviews,2,3,5
618500,True,6,Mostly Positive,9,3,12
618510,True,8,Very Positive,111,5,116
618520,True,0,1 user reviews,0,1,1
618550,True,8,Very Positive,47,6,53
618560,True,0,No user reviews,0,0,0
618570,True,0,8 user reviews,7,1,8
618580,True,0,No user reviews,0,0,0
618590,True,0,9 user reviews,8,1,9
618600,True,0,No user reviews,0,0,0
618610,True,5,Mixed,54,31,85
618620,True,0,No user reviews,0,0,0
618630,True,0,2 user reviews,2,0,2
618640,True,5,Mixed,10,7,17
618650,True,0,3 user reviews,2,1,3
618660,True,0,No user reviews,0,0,0
618661,True,0,3 user reviews,2,1,3
618662,True,0,4 user reviews,2,2,4
618663,True,0,No user reviews,0,0,0
618664,True,0,1 user reviews,1,0,1
618670,True,0,7 user reviews,3,4,7
618680,True,0,No user reviews,0,0,0
618681,True,0,1 user reviews,0,1,1
618682,True,0,2 user reviews,1,1,2
618690,True,7,Positive,17,1,18
618700,True,0,5 user reviews,4,1,5
618710,True,7,Positive,20,0,20
618720,True,8,Very Positive,294,21,315
618740,True,8,Very Positive,415,28,443
618750,True,6,Mostly Positive,20,7,27
618760,True,5,Mixed,7,4,11
618770,True,0,No user reviews,0,0,0
618771,True,0,No user reviews,0,0,0
618780,True,0,No user reviews,0,0,0
618790,True,0,No user reviews,0,0,0
618800,True,0,No user reviews,0,0,0
618810,True,0,No user reviews,0,0,0
618820,True,0,No user reviews,0,0,0
618830,True,0,No user reviews,0,0,0
618840,True,0,3 user reviews,0,3,3
618850,True,8,Very Positive,137,24,161
618920,True,8,Very Positive,82,15,97
618940,True,0,No user reviews,0,0,0
618950,True,8,Very Positive,65,6,71
618960,True,0,No user reviews,0,0,0
618970,True,8,Very Positive,154,34,188
618980,True,0,No user reviews,0,0,0
618990,True,0,5 user reviews,4,1,5
619000,True,0,1 user reviews,0,1,1
619010,True,5,Mixed,7,6,13
619050,True,0,No user reviews,0,0,0
619070,True,0,No user reviews,0,0,0
619080,True,4,Mostly Negative,293,806,1099
619100,True,0,1 user reviews,1,0,1
619120,True,0,No user reviews,0,0,0
619140,True,0,7 user reviews,1,6,7
619150,True,8,Very Positive,1731,199,1930
619160,True,0,No user reviews,0,0,0
619170,True,0,No user reviews,0,0,0
619190,True,0,No user reviews,0,0,0
619200,True,0,No user reviews,0,0,0
619210,True,8,Very Positive,79,11,90
619220,True,0,3 user reviews,3,0,3
619230,True,5,Mixed,8,4,12
619250,True,0,No user reviews,0,0,0
619270,True,0,2 user reviews,2,0,2
619280,True,8,Very Positive,192,35,227
619290,True,8,Very Positive,472,74,546
619310,True,0,No user reviews,0,0,0
619320,True,0,9 user reviews,7,2,9
619330,True,0,7 user reviews,4,3,7
619340,True,4,Mostly Negative,3,10,13
619350,True,5,Mixed,5,5,10
619380,True,0,No user reviews,0,0,0
619400,True,0,4 user reviews,1,3,4
619420,True,0,No user reviews,0,0,0
619430,True,5,Mixed,33,42,75
619440,True,0,No user reviews,0,0,0
619460,True,0,No user reviews,0,0,0
619470,True,0,5 user reviews,3,2,5
619480,True,0,1 user reviews,1,0,1
619490,True,5,Mixed,28,14,42
619500,True,8,Very Positive,173,16,189
619510,True,7,Positive,24,3,27
619550,True,0,No user reviews,0,0,0
619580,True,7,Positive,14,1,15
619582,True,0,No user reviews,0,0,0
619583,True,0,6 user reviews,6,0,6
619584,True,0,5 user reviews,4,1,5
619585,True,0,4 user reviews,3,1,4
619586,True,0,3 user reviews,2,1,3
619590,True,0,No user reviews,0,0,0
619600,True,0,No user reviews,0,0,0
619610,True,0,No user reviews,0,0,0
619620,True,0,2 user reviews,1,1,2
619630,True,0,2 user reviews,2,0,2
619670,True,0,No user reviews,0,0,0
619680,True,8,Very Positive,71,2,73
619690,True,0,1 user reviews,1,0,1
619700,True,5,Mixed,41,19,60
619710,True,0,2 user reviews,2,0,2
619711,True,0,1 user reviews,1,0,1
619720,True,0,4 user reviews,1,3,4
619740,True,3,Negative,2,9,11
619760,True,0,No user reviews,0,0,0
619780,True,5,Mixed,381,201,582
619790,True,0,No user reviews,0,0,0
619800,True,0,No user reviews,0,0,0
619801,True,0,No user reviews,0,0,0
619810,True,7,Positive,16,1,17
619870,True,8,Very Positive,49,4,53
619880,True,6,Mostly Positive,215,75,290
619890,True,0,6 user reviews,4,2,6
619910,True,0,No user reviews,0,0,0
619930,True,7,Positive,10,1,11
619940,True,7,Positive,12,0,12
619960,True,0,No user reviews,0,0,0
619980,True,0,No user reviews,0,0,0
620000,True,0,No user reviews,0,0,0
620010,True,0,No user reviews,0,0,0
620030,True,0,No user reviews,0,0,0
620040,True,0,9 user reviews,5,4,9
620050,True,5,Mixed,9,6,15
620070,True,0,1 user reviews,1,0,1
620080,True,7,Positive,12,2,14
620090,True,0,No user reviews,0,0,0
620110,True,0,No user reviews,0,0,0
620130,True,0,No user reviews,0,0,0
620140,True,0,3 user reviews,2,1,3
620150,True,5,Mixed,9,7,16
620160,True,0,No user reviews,0,0,0
620170,True,7,Positive,31,5,36
620180,True,0,No user reviews,0,0,0
620190,True,8,Very Positive,384,87,471
620210,True,8,Very Positive,128,1,129
620220,True,8,Very Positive,113,21,134
620250,True,0,No user reviews,0,0,0
620260,True,0,No user reviews,0,0,0
620270,True,0,No user reviews,0,0,0
620280,True,0,9 user reviews,8,1,9
620290,True,0,No user reviews,0,0,0
620300,True,0,No user reviews,0,0,0
620310,True,0,1 user reviews,0,1,1
620320,True,0,1 user reviews,1,0,1
620321,True,0,1 user reviews,1,0,1
620322,True,0,2 user reviews,2,0,2
620323,True,0,1 user reviews,1,0,1
620324,True,0,1 user reviews,1,0,1
620325,True,0,1 user reviews,1,0,1
620326,True,0,2 user reviews,2,0,2
620330,True,0,4 user reviews,4,0,4
620340,True,0,9 user reviews,9,0,9
620350,True,0,6 user reviews,5,1,6
620360,True,7,Positive,22,0,22
620370,True,7,Positive,18,0,18
620381,True,0,1 user reviews,0,1,1
620382,True,0,No user reviews,0,0,0
620400,True,0,No user reviews,0,0,0
620410,True,0,No user reviews,0,0,0
620440,True,0,No user reviews,0,0,0
620450,True,0,No user reviews,0,0,0
620460,True,0,No user reviews,0,0,0
620470,True,0,1 user reviews,1,0,1
620480,True,0,No user reviews,0,0,0
620490,True,0,1 user reviews,1,0,1
620500,True,0,No user reviews,0,0,0
620510,True,0,No user reviews,0,0,0
620520,True,0,No user reviews,0,0,0
620540,True,0,No user reviews,0,0,0
620560,True,0,No user reviews,0,0,0
620570,True,0,9 user reviews,3,6,9
620580,True,0,7 user reviews,5,2,7
620590,True,6,Mostly Positive,931,252,1183
620610,True,8,Very Positive,276,28,304
620630,True,0,2 user reviews,1,1,2
620640,True,0,2 user reviews,1,1,2
620650,True,7,Positive,37,7,44
620660,True,0,5 user reviews,5,0,5
620670,True,7,Positive,10,0,10
620680,True,0,5 user reviews,4,1,5
620700,True,5,Mixed,16,7,23
620710,True,7,Positive,14,2,16
620730,True,0,No user reviews,0,0,0
620740,True,0,No user reviews,0,0,0
620741,True,0,No user reviews,0,0,0
620742,True,0,No user reviews,0,0,0
620743,True,0,No user reviews,0,0,0
620744,True,0,No user reviews,0,0,0
620745,True,0,No user reviews,0,0,0
620746,True,0,7 user reviews,6,1,7
620780,True,0,No user reviews,0,0,0
620790,True,0,1 user reviews,1,0,1
620800,True,0,9 user reviews,9,0,9
620810,True,0,No user reviews,0,0,0
620820,True,0,No user reviews,0,0,0
620830,True,0,No user reviews,0,0,0
620850,True,0,No user reviews,0,0,0
620880,True,0,No user reviews,0,0,0
620900,True,7,Positive,41,2,43
620910,True,0,No user reviews,0,0,0
620920,True,0,No user reviews,0,0,0
620930,True,0,No user reviews,0,0,0
620940,True,7,Positive,15,1,16
620950,True,0,No user reviews,0,0,0
620970,True,0,No user reviews,0,0,0
620980,True,9,Overwhelmingly Positive,28675,1087,29762
620990,True,0,No user reviews,0,0,0
621000,True,6,Mostly Positive,17,6,23
621010,True,7,Positive,17,0,17
621020,True,6,Mostly Positive,39,16,55
621040,True,0,No user reviews,0,0,0
621050,True,4,Mostly Negative,5,14,19
621060,True,8,Very Positive,9371,560,9931
621070,True,6,Mostly Positive,301,124,425
621080,True,7,Positive,41,6,47
621090,True,0,3 user reviews,1,2,3
621100,True,0,No user reviews,0,0,0
621110,True,0,No user reviews,0,0,0
621140,True,0,1 user reviews,1,0,1
621150,True,0,2 user reviews,2,0,2
621160,True,0,No user reviews,0,0,0
621170,True,0,6 user reviews,6,0,6
621180,True,0,No user reviews,0,0,0
621190,True,0,No user reviews,0,0,0
621200,True,0,No user reviews,0,0,0
621210,True,0,1 user reviews,1,0,1
621220,True,6,Mostly Positive,309,103,412
621240,True,0,No user reviews,0,0,0
621290,True,0,3 user reviews,1,2,3
621300,True,0,4 user reviews,4,0,4
621320,True,0,No user reviews,0,0,0
621330,True,0,No user reviews,0,0,0
621331,True,0,No user reviews,0,0,0
621332,True,0,No user reviews,0,0,0
621333,True,0,No user reviews,0,0,0
621334,True,0,No user reviews,0,0,0
621335,True,0,No user reviews,0,0,0
621336,True,0,No user reviews,0,0,0
621337,True,0,No user reviews,0,0,0
621338,True,0,No user reviews,0,0,0
621339,True,0,No user reviews,0,0,0
621340,True,0,No user reviews,0,0,0
621341,True,0,No user reviews,0,0,0
621342,True,0,No user reviews,0,0,0
621350,True,0,No user reviews,0,0,0
621351,True,0,No user reviews,0,0,0
621352,True,0,No user reviews,0,0,0
621353,True,0,No user reviews,0,0,0
621354,True,0,No user reviews,0,0,0
621355,True,0,No user reviews,0,0,0
621356,True,0,No user reviews,0,0,0
621357,True,0,No user reviews,0,0,0
621358,True,0,No user reviews,0,0,0
621359,True,0,No user reviews,0,0,0
621360,True,0,No user reviews,0,0,0
621361,True,0,No user reviews,0,0,0
621362,True,0,No user reviews,0,0,0
621370,True,0,No user reviews,0,0,0
621371,True,0,No user reviews,0,0,0
621372,True,0,No user reviews,0,0,0
621373,True,0,No user reviews,0,0,0
621374,True,0,No user reviews,0,0,0
621375,True,0,No user reviews,0,0,0
621376,True,0,No user reviews,0,0,0
621377,True,0,No user reviews,0,0,0
621378,True,0,No user reviews,0,0,0
621379,True,0,No user reviews,0,0,0
621380,True,0,No user reviews,0,0,0
621381,True,0,No user reviews,0,0,0
621382,True,0,No user reviews,0,0,0
621390,True,0,No user reviews,0,0,0
621400,True,0,No user reviews,0,0,0
621420,True,0,2 user reviews,2,0,2
621430,True,0,No user reviews,0,0,0
621440,True,0,No user reviews,0,0,0
621450,True,0,No user reviews,0,0,0
621451,True,0,No user reviews,0,0,0
621452,True,0,No user reviews,0,0,0
621453,True,0,No user reviews,0,0,0
621480,True,0,No user reviews,0,0,0
621500,True,4,Mostly Negative,8,14,22
621520,True,0,No user reviews,0,0,0
621560,True,0,1 user reviews,1,0,1
621570,True,0,5 user reviews,5,0,5
621580,True,0,No user reviews,0,0,0
621590,True,0,No user reviews,0,0,0
621600,True,0,6 user reviews,6,0,6
621610,True,0,No user reviews,0,0,0
621620,True,0,No user reviews,0,0,0
621630,True,0,No user reviews,0,0,0
621640,True,0,4 user reviews,4,0,4
621650,True,0,No user reviews,0,0,0
621660,True,0,No user reviews,0,0,0
621670,True,0,No user reviews,0,0,0
621680,True,0,No user reviews,0,0,0
621690,True,0,No user reviews,0,0,0
621700,True,0,No user reviews,0,0,0
621710,True,0,No user reviews,0,0,0
621720,True,0,2 user reviews,1,1,2
621730,True,0,1 user reviews,1,0,1
621740,True,0,No user reviews,0,0,0
621750,True,0,No user reviews,0,0,0
621760,True,0,No user reviews,0,0,0
621780,True,5,Mixed,5,5,10
621810,True,8,Very Positive,97,15,112
621830,True,5,Mixed,340,185,525
621840,True,0,4 user reviews,2,2,4
621850,True,0,9 user reviews,6,3,9
621870,True,7,Positive,16,0,16
621880,True,0,No user reviews,0,0,0
621920,True,7,Positive,15,1,16
621921,True,5,Mixed,8,5,13
621922,True,0,9 user reviews,7,2,9
621923,True,6,Mostly Positive,11,3,14
621924,True,0,2 user reviews,2,0,2
621925,True,7,Positive,9,1,10
621926,True,0,6 user reviews,5,1,6
621927,True,0,3 user reviews,2,1,3
621930,True,8,Very Positive,115,20,135
621940,True,6,Mostly Positive,16,6,22
621960,True,0,No user reviews,0,0,0
621970,True,6,Mostly Positive,23,6,29
622010,True,5,Mixed,20,21,41
622020,True,0,7 user reviews,4,3,7
622030,True,0,3 user reviews,2,1,3
622040,True,5,Mixed,86,61,147
622060,True,0,5 user reviews,5,0,5
622070,True,0,No user reviews,0,0,0
622080,True,0,2 user reviews,1,1,2
622090,True,0,No user reviews,0,0,0
622110,True,0,No user reviews,0,0,0
622130,True,0,No user reviews,0,0,0
622150,True,0,2 user reviews,2,0,2
622160,True,0,No user reviews,0,0,0
622170,True,5,Mixed,35,18,53
622200,True,0,9 user reviews,9,0,9
622210,True,0,No user reviews,0,0,0
622220,True,9,Overwhelmingly Positive,736,36,772
622230,True,0,7 user reviews,7,0,7
622240,True,0,No user reviews,0,0,0
622260,True,0,No user reviews,0,0,0
622270,True,0,No user reviews,0,0,0
622280,True,0,No user reviews,0,0,0
622290,True,0,1 user reviews,1,0,1
622300,True,0,No user reviews,0,0,0
622310,True,0,No user reviews,0,0,0
622320,True,0,7 user reviews,2,5,7
622330,True,5,Mixed,11,5,16
622350,True,0,1 user reviews,0,1,1
622351,True,0,No user reviews,0,0,0
622352,True,0,3 user reviews,2,1,3
622353,True,0,5 user reviews,2,3,5
622354,True,0,6 user reviews,3,3,6
622355,True,0,1 user reviews,1,0,1
622356,True,0,No user reviews,0,0,0
622357,True,0,2 user reviews,2,0,2
622358,True,0,No user reviews,0,0,0
622360,True,0,7 user reviews,6,1,7
622370,True,5,Mixed,31,23,54
622380,True,0,No user reviews,0,0,0
622390,True,0,1 user reviews,1,0,1
622400,True,0,No user reviews,0,0,0
622420,True,5,Mixed,43,40,83
622440,True,5,Mixed,119,68,187
622450,True,5,Mixed,66,55,121
622460,True,6,Mostly Positive,97,29,126
622470,True,0,No user reviews,0,0,0
622480,True,0,5 user reviews,4,1,5
622500,True,0,No user reviews,0,0,0
622510,True,0,1 user reviews,1,0,1
622520,True,0,No user reviews,0,0,0
622530,True,5,Mixed,6,5,11
622540,True,0,2 user reviews,1,1,2
622550,True,0,2 user reviews,2,0,2
622570,True,0,No user reviews,0,0,0
622580,True,0,No user reviews,0,0,0
622610,True,0,5 user reviews,4,1,5
622620,True,0,8 user reviews,7,1,8
622650,True,8,Very Positive,2742,432,3174
622660,True,8,Very Positive,243,41,284
622661,True,8,Very Positive,351,51,402
622670,True,0,4 user reviews,4,0,4
622680,True,0,No user reviews,0,0,0
622690,True,0,No user reviews,0,0,0
622700,True,0,9 user reviews,5,4,9
622710,True,0,9 user reviews,9,0,9
622720,True,8,Very Positive,413,101,514
622730,True,0,No user reviews,0,0,0
622740,True,0,No user reviews,0,0,0
622750,True,0,No user reviews,0,0,0
622760,True,0,1 user reviews,1,0,1
622770,True,5,Mixed,64,34,98
622780,True,0,No user reviews,0,0,0
622810,True,0,5 user reviews,5,0,5
622830,True,7,Positive,20,2,22
622850,True,0,No user reviews,0,0,0
622851,True,0,2 user reviews,2,0,2
622860,True,0,No user reviews,0,0,0
622870,True,8,Very Positive,95,20,115
622880,True,0,7 user reviews,4,3,7
622890,True,0,7 user reviews,5,2,7
622900,True,0,No user reviews,0,0,0
622910,True,0,No user reviews,0,0,0
622920,True,5,Mixed,6,4,10
622930,True,0,4 user reviews,4,0,4
622940,True,0,No user reviews,0,0,0
622970,True,0,No user reviews,0,0,0
623040,True,0,4 user reviews,3,1,4
623050,True,0,1 user reviews,1,0,1
623070,True,6,Mostly Positive,15,6,21
623080,True,7,Positive,29,2,31
623090,True,6,Mostly Positive,80,25,105
623100,True,0,6 user reviews,3,3,6
623110,True,0,1 user reviews,1,0,1
623130,True,0,No user reviews,0,0,0
623131,True,0,No user reviews,0,0,0
623132,True,0,No user reviews,0,0,0
623133,True,0,No user reviews,0,0,0
623134,True,0,No user reviews,0,0,0
623140,True,0,6 user reviews,5,1,6
623150,True,5,Mixed,34,17,51
623160,True,6,Mostly Positive,16,5,21
623170,True,7,Positive,16,2,18
623180,True,6,Mostly Positive,11,3,14
623190,True,0,4 user reviews,4,0,4
623191,True,0,No user reviews,0,0,0
623192,True,0,No user reviews,0,0,0
623193,True,0,1 user reviews,1,0,1
623194,True,0,1 user reviews,1,0,1
623195,True,0,No user reviews,0,0,0
623196,True,0,2 user reviews,2,0,2
623197,True,0,No user reviews,0,0,0
623198,True,0,1 user reviews,1,0,1
623200,True,0,2 user reviews,2,0,2
623220,True,0,No user reviews,0,0,0
623230,True,0,No user reviews,0,0,0
623250,True,0,No user reviews,0,0,0
623260,True,0,No user reviews,0,0,0
623261,True,0,No user reviews,0,0,0
623262,True,0,1 user reviews,1,0,1
623263,True,0,1 user reviews,1,0,1
623264,True,0,2 user reviews,2,0,2
623265,True,0,1 user reviews,1,0,1
623266,True,0,4 user reviews,2,2,4
623267,True,0,1 user reviews,1,0,1
623268,True,0,No user reviews,0,0,0
623270,True,0,5 user reviews,5,0,5
623291,True,0,No user reviews,0,0,0
623310,True,5,Mixed,29,13,42
623320,True,0,3 user reviews,3,0,3
623340,True,5,Mixed,225,101,326
623360,True,0,7 user reviews,4,3,7
623370,True,0,2 user reviews,1,1,2
623380,True,7,Positive,36,9,45
623390,True,0,No user reviews,0,0,0
623391,True,0,No user reviews,0,0,0
623392,True,0,No user reviews,0,0,0
623393,True,0,No user reviews,0,0,0
623394,True,0,No user reviews,0,0,0
623395,True,0,No user reviews,0,0,0
623396,True,0,No user reviews,0,0,0
623397,True,0,No user reviews,0,0,0
623398,True,0,No user reviews,0,0,0
623399,True,0,No user reviews,0,0,0
623400,True,0,No user reviews,0,0,0
623401,True,0,No user reviews,0,0,0
623402,True,0,No user reviews,0,0,0
623410,True,0,No user reviews,0,0,0
623411,True,0,No user reviews,0,0,0
623412,True,0,No user reviews,0,0,0
623413,True,0,No user reviews,0,0,0
623414,True,0,No user reviews,0,0,0
623415,True,0,No user reviews,0,0,0
623416,True,0,No user reviews,0,0,0
623417,True,0,No user reviews,0,0,0
623418,True,0,No user reviews,0,0,0
623419,True,0,No user reviews,0,0,0
623420,True,0,No user reviews,0,0,0
623421,True,0,No user reviews,0,0,0
623422,True,0,No user reviews,0,0,0
623430,True,0,No user reviews,0,0,0
623431,True,0,No user reviews,0,0,0
623432,True,0,No user reviews,0,0,0
623433,True,0,No user reviews,0,0,0
623434,True,0,No user reviews,0,0,0
623435,True,0,No user reviews,0,0,0
623436,True,0,No user reviews,0,0,0
623437,True,0,No user reviews,0,0,0
623438,True,0,No user reviews,0,0,0
623439,True,0,No user reviews,0,0,0
623440,True,0,No user reviews,0,0,0
623441,True,0,No user reviews,0,0,0
623442,True,0,No user reviews,0,0,0
623460,True,0,2 user reviews,1,1,2
623470,True,0,2 user reviews,2,0,2
623480,True,0,No user reviews,0,0,0
623481,True,0,No user reviews,0,0,0
623482,True,0,No user reviews,0,0,0
623483,True,0,No user reviews,0,0,0
623484,True,0,No user reviews,0,0,0
623485,True,0,No user reviews,0,0,0
623486,True,0,No user reviews,0,0,0
623487,True,0,No user reviews,0,0,0
623490,True,0,No user reviews,0,0,0
623500,True,0,No user reviews,0,0,0
623501,True,0,No user reviews,0,0,0
623502,True,0,No user reviews,0,0,0
623503,True,0,No user reviews,0,0,0
623504,True,0,No user reviews,0,0,0
623505,True,0,No user reviews,0,0,0
623510,True,0,No user reviews,0,0,0
623511,True,0,No user reviews,0,0,0
623512,True,0,No user reviews,0,0,0
623513,True,0,No user reviews,0,0,0
623514,True,0,No user reviews,0,0,0
623515,True,0,No user reviews,0,0,0
623516,True,0,No user reviews,0,0,0
623517,True,0,No user reviews,0,0,0
623518,True,0,No user reviews,0,0,0
623519,True,0,No user reviews,0,0,0
623520,True,0,No user reviews,0,0,0
623521,True,0,No user reviews,0,0,0
623522,True,0,No user reviews,0,0,0
623523,True,0,No user reviews,0,0,0
623524,True,0,No user reviews,0,0,0
623530,True,4,Mostly Negative,4,7,11
623540,True,8,Very Positive,46,5,51
623550,True,5,Mixed,8,10,18
623560,True,0,No user reviews,0,0,0
623570,True,5,Mixed,8,5,13
623580,True,5,Mixed,6,5,11
623590,True,0,No user reviews,0,0,0
623611,True,0,3 user reviews,3,0,3
623613,True,0,2 user reviews,1,1,2
623616,True,0,3 user reviews,1,2,3
623619,True,0,5 user reviews,2,3,5
623620,True,0,No user reviews,0,0,0
623640,True,7,Positive,35,2,37
623650,True,0,No user reviews,0,0,0
623651,True,0,No user reviews,0,0,0
623652,True,0,No user reviews,0,0,0
623653,True,0,No user reviews,0,0,0
623654,True,0,No user reviews,0,0,0
623655,True,0,No user reviews,0,0,0
623656,True,0,No user reviews,0,0,0
623657,True,0,No user reviews,0,0,0
623660,True,0,No user reviews,0,0,0
623661,True,0,No user reviews,0,0,0
623662,True,0,No user reviews,0,0,0
623663,True,0,No user reviews,0,0,0
623665,True,0,No user reviews,0,0,0
623666,True,0,No user reviews,0,0,0
623667,True,0,No user reviews,0,0,0
623670,True,0,7 user reviews,5,2,7
623690,True,0,No user reviews,0,0,0
623700,True,8,Very Positive,104,11,115
623710,True,0,No user reviews,0,0,0
623720,True,0,No user reviews,0,0,0
623770,True,0,No user reviews,0,0,0
623790,True,0,1 user reviews,1,0,1
623800,True,7,Positive,11,0,11
623810,True,6,Mostly Positive,26,9,35
623820,True,0,4 user reviews,0,4,4
623840,True,0,No user reviews,0,0,0
623850,True,0,No user reviews,0,0,0
623860,True,0,5 user reviews,3,2,5
623870,True,0,No user reviews,0,0,0
623880,True,5,Mixed,118,58,176
623890,True,0,6 user reviews,6,0,6
623900,True,0,8 user reviews,4,4,8
623920,True,5,Mixed,11,12,23
623930,True,5,Mixed,9,12,21
623940,True,8,Very Positive,2267,122,2389
623980,True,0,No user reviews,0,0,0
623990,True,0,No user reviews,0,0,0
624020,True,0,No user reviews,0,0,0
624030,True,0,No user reviews,0,0,0
624040,True,0,No user reviews,0,0,0
624041,True,0,No user reviews,0,0,0
624042,True,0,No user reviews,0,0,0
624043,True,0,No user reviews,0,0,0
624050,True,0,5 user reviews,5,0,5
624060,True,0,2 user reviews,1,1,2
624070,True,0,9 user reviews,7,2,9
624080,True,0,8 user reviews,8,0,8
624090,True,5,Mixed,1094,606,1700
624110,True,0,No user reviews,0,0,0
624120,True,5,Mixed,34,26,60
624140,True,0,No user reviews,0,0,0
624150,True,0,No user reviews,0,0,0
624260,True,0,No user reviews,0,0,0
624270,True,8,Very Positive,780,106,886
624280,True,0,1 user reviews,1,0,1
624281,True,0,No user reviews,0,0,0
624282,True,0,No user reviews,0,0,0
624320,True,7,Positive,27,4,31
624330,True,0,3 user reviews,2,1,3
624360,True,0,No user reviews,0,0,0
624390,True,0,No user reviews,0,0,0
624410,True,0,1 user reviews,0,1,1
624430,True,5,Mixed,8,6,14
624460,True,0,No user reviews,0,0,0
624480,True,0,No user reviews,0,0,0
624510,True,0,No user reviews,0,0,0
624530,True,0,No user reviews,0,0,0
624531,True,0,No user reviews,0,0,0
624540,True,0,No user reviews,0,0,0
624550,True,6,Mostly Positive,7,3,10
624560,True,0,7 user reviews,1,6,7
624590,True,0,No user reviews,0,0,0
624610,True,0,3 user reviews,2,1,3
624620,True,4,Mostly Negative,27,47,74
624621,True,4,Mostly Negative,14,28,42
624622,True,4,Mostly Negative,14,22,36
624630,True,0,6 user reviews,1,5,6
624650,True,0,No user reviews,0,0,0
624660,True,0,No user reviews,0,0,0
624670,True,0,No user reviews,0,0,0
624680,True,7,Positive,10,2,12
624690,True,6,Mostly Positive,30,11,41
624700,True,0,1 user reviews,1,0,1
624710,True,0,9 user reviews,8,1,9
624720,True,0,No user reviews,0,0,0
624730,True,0,No user reviews,0,0,0
624760,True,0,No user reviews,0,0,0
624770,True,0,No user reviews,0,0,0
624771,True,0,No user reviews,0,0,0
624773,True,0,No user reviews,0,0,0
624780,True,0,2 user reviews,1,1,2
624790,True,0,No user reviews,0,0,0
624830,True,7,Positive,21,2,23
624840,True,0,2 user reviews,2,0,2
624850,True,0,No user reviews,0,0,0
624890,True,6,Mostly Positive,20,8,28
624900,True,0,No user reviews,0,0,0
624910,True,0,No user reviews,0,0,0
624920,True,0,No user reviews,0,0,0
624930,True,0,No user reviews,0,0,0
624940,True,0,2 user reviews,1,1,2
624960,True,0,No user reviews,0,0,0
624970,True,8,Very Positive,304,51,355
624990,True,0,6 user reviews,6,0,6
625000,True,7,Positive,12,0,12
625010,True,7,Positive,15,2,17
625020,True,0,No user reviews,0,0,0
625030,True,0,3 user reviews,2,1,3
625040,True,0,6 user reviews,3,3,6
625050,True,5,Mixed,60,81,141
625060,True,0,No user reviews,0,0,0
625080,True,0,No user reviews,0,0,0
625090,True,0,No user reviews,0,0,0
625100,True,0,1 user reviews,1,0,1
625110,True,0,No user reviews,0,0,0
625120,True,7,Positive,16,4,20
625140,True,0,No user reviews,0,0,0
625160,True,0,3 user reviews,2,1,3
625180,True,0,7 user reviews,1,6,7
625190,True,0,7 user reviews,4,3,7
625200,True,0,No user reviews,0,0,0
625210,True,0,No user reviews,0,0,0
625220,True,0,No user reviews,0,0,0
625230,True,0,No user reviews,0,0,0
625260,True,0,No user reviews,0,0,0
625290,True,0,No user reviews,0,0,0
625320,True,0,6 user reviews,4,2,6
625330,True,0,No user reviews,0,0,0
625340,True,5,Mixed,385,207,592
625350,True,0,3 user reviews,1,2,3
625370,True,5,Mixed,13,12,25
625390,True,0,No user reviews,0,0,0
625410,True,0,3 user reviews,3,0,3
625430,True,0,6 user reviews,3,3,6
625440,True,0,No user reviews,0,0,0
625450,True,0,No user reviews,0,0,0
625460,True,0,3 user reviews,3,0,3
625470,True,0,No user reviews,0,0,0
625480,True,0,4 user reviews,4,0,4
625490,True,0,No user reviews,0,0,0
625500,True,0,9 user reviews,8,1,9
625510,True,0,No user reviews,0,0,0
625560,True,0,6 user reviews,5,1,6
625570,True,0,No user reviews,0,0,0
625580,True,0,No user reviews,0,0,0
625610,True,0,No user reviews,0,0,0
625630,True,0,2 user reviews,2,0,2
625640,True,0,No user reviews,0,0,0
625660,True,0,No user reviews,0,0,0
625680,True,8,Very Positive,58,12,70
625690,True,0,3 user reviews,3,0,3
625700,True,5,Mixed,6,4,10
625710,True,0,No user reviews,0,0,0
625730,True,6,Mostly Positive,13,5,18
625740,True,8,Very Positive,71,1,72
625750,True,0,No user reviews,0,0,0
625770,True,7,Positive,14,0,14
625780,True,7,Positive,31,2,33
625790,True,0,No user reviews,0,0,0
625800,True,0,1 user reviews,1,0,1
625810,True,0,No user reviews,0,0,0
625820,True,7,Positive,15,2,17
625830,True,7,Positive,14,3,17
625860,True,0,No user reviews,0,0,0
625900,True,0,3 user reviews,3,0,3
625910,True,6,Mostly Positive,27,8,35
625920,True,0,No user reviews,0,0,0
625940,True,7,Positive,15,0,15
625960,True,6,Mostly Positive,3284,1109,4393
625970,True,0,1 user reviews,1,0,1
625980,True,8,Very Positive,70,4,74
625990,True,6,Mostly Positive,27,8,35
626000,True,0,No user reviews,0,0,0
626010,True,0,No user reviews,0,0,0
626020,True,0,6 user reviews,3,3,6
626130,True,0,2 user reviews,1,1,2
626160,True,0,5 user reviews,2,3,5
626170,True,0,8 user reviews,5,3,8
626180,True,0,6 user reviews,6,0,6
626200,True,4,Mostly Negative,12,28,40
626220,True,0,No user reviews,0,0,0
626230,True,0,No user reviews,0,0,0
626240,True,0,No user reviews,0,0,0
626250,True,5,Mixed,9,4,13
626270,True,0,No user reviews,0,0,0
626280,True,0,No user reviews,0,0,0
626290,True,0,No user reviews,0,0,0
626300,True,0,No user reviews,0,0,0
626310,True,0,No user reviews,0,0,0
626320,True,0,No user reviews,0,0,0
626330,True,0,No user reviews,0,0,0
626340,True,0,No user reviews,0,0,0
626350,True,0,No user reviews,0,0,0
626360,True,0,No user reviews,0,0,0
626370,True,0,No user reviews,0,0,0
626380,True,0,No user reviews,0,0,0
626390,True,0,No user reviews,0,0,0
626400,True,0,No user reviews,0,0,0
626410,True,0,No user reviews,0,0,0
626420,True,0,No user reviews,0,0,0
626430,True,0,No user reviews,0,0,0
626440,True,0,No user reviews,0,0,0
626450,True,7,Positive,28,2,30
626460,True,0,No user reviews,0,0,0
626470,True,5,Mixed,192,133,325
626480,True,0,No user reviews,0,0,0
626481,True,0,No user reviews,0,0,0
626482,True,0,No user reviews,0,0,0
626483,True,0,No user reviews,0,0,0
626484,True,0,No user reviews,0,0,0
626485,True,0,No user reviews,0,0,0
626486,True,0,No user reviews,0,0,0
626487,True,0,No user reviews,0,0,0
626488,True,0,No user reviews,0,0,0
626489,True,0,No user reviews,0,0,0
626491,True,0,2 user reviews,2,0,2
626510,True,8,Very Positive,45,10,55
626520,True,0,No user reviews,0,0,0
626521,True,0,5 user reviews,5,0,5
626522,True,0,No user reviews,0,0,0
626523,True,0,2 user reviews,2,0,2
626530,True,0,1 user reviews,1,0,1
626531,True,0,1 user reviews,1,0,1
626532,True,0,No user reviews,0,0,0
626533,True,0,No user reviews,0,0,0
626534,True,0,No user reviews,0,0,0
626535,True,0,1 user reviews,1,0,1
626536,True,0,3 user reviews,3,0,3
626540,True,0,2 user reviews,2,0,2
626541,True,0,No user reviews,0,0,0
626542,True,0,No user reviews,0,0,0
626543,True,0,1 user reviews,1,0,1
626544,True,0,No user reviews,0,0,0
626545,True,0,No user reviews,0,0,0
626546,True,0,No user reviews,0,0,0
626547,True,0,1 user reviews,1,0,1
626548,True,0,1 user reviews,1,0,1
626550,True,5,Mixed,24,32,56
626560,True,0,1 user reviews,1,0,1
626561,True,0,3 user reviews,3,0,3
626562,True,0,2 user reviews,2,0,2
626570,True,0,1 user reviews,1,0,1
626580,True,7,Positive,37,4,41
626590,True,0,No user reviews,0,0,0
626600,True,6,Mostly Positive,62,20,82
626610,True,6,Mostly Positive,252,101,353
626630,True,4,Mostly Negative,4,8,12
626640,True,7,Positive,29,2,31
626650,True,0,No user reviews,0,0,0
626660,True,8,Very Positive,50,5,55
626670,True,0,No user reviews,0,0,0
626680,True,0,No user reviews,0,0,0
626690,True,8,Very Positive,2908,582,3490
626700,True,0,No user reviews,0,0,0
626730,True,0,4 user reviews,2,2,4
626740,True,0,No user reviews,0,0,0
626760,True,4,Mostly Negative,3,7,10
626780,True,0,No user reviews,0,0,0
626790,True,7,Positive,11,2,13
626800,True,0,No user reviews,0,0,0
626810,True,0,No user reviews,0,0,0
626830,True,0,1 user reviews,0,1,1
626840,True,0,2 user reviews,2,0,2
626850,True,0,No user reviews,0,0,0
626860,True,0,No user reviews,0,0,0
626861,True,0,No user reviews,0,0,0
626862,True,0,No user reviews,0,0,0
626863,True,0,No user reviews,0,0,0
626864,True,0,1 user reviews,1,0,1
626865,True,0,No user reviews,0,0,0
626866,True,0,No user reviews,0,0,0
626867,True,0,No user reviews,0,0,0
626868,True,0,No user reviews,0,0,0
626869,True,0,No user reviews,0,0,0
626870,True,0,No user reviews,0,0,0
626871,True,0,No user reviews,0,0,0
626880,True,0,No user reviews,0,0,0
626881,True,0,No user reviews,0,0,0
626882,True,0,No user reviews,0,0,0
626883,True,0,No user reviews,0,0,0
626884,True,0,No user reviews,0,0,0
626885,True,0,No user reviews,0,0,0
626886,True,0,No user reviews,0,0,0
626887,True,0,No user reviews,0,0,0
626888,True,0,No user reviews,0,0,0
626889,True,0,No user reviews,0,0,0
626890,True,0,No user reviews,0,0,0
626891,True,0,No user reviews,0,0,0
626892,True,0,No user reviews,0,0,0
626900,True,0,No user reviews,0,0,0
626910,True,0,No user reviews,0,0,0
626911,True,0,No user reviews,0,0,0
626912,True,0,No user reviews,0,0,0
626913,True,0,No user reviews,0,0,0
626914,True,0,No user reviews,0,0,0
626915,True,0,No user reviews,0,0,0
626916,True,0,No user reviews,0,0,0
626917,True,0,No user reviews,0,0,0
626918,True,0,No user reviews,0,0,0
626919,True,0,No user reviews,0,0,0
626920,True,0,No user reviews,0,0,0
626921,True,0,No user reviews,0,0,0
626930,True,0,No user reviews,0,0,0
626940,True,0,No user reviews,0,0,0
626950,True,0,No user reviews,0,0,0
626960,True,0,No user reviews,0,0,0
626961,True,0,No user reviews,0,0,0
626962,True,0,No user reviews,0,0,0
626963,True,0,No user reviews,0,0,0
626964,True,0,No user reviews,0,0,0
626965,True,0,No user reviews,0,0,0
626966,True,0,No user reviews,0,0,0
626967,True,0,No user reviews,0,0,0
626968,True,0,No user reviews,0,0,0
626969,True,0,No user reviews,0,0,0
626970,True,0,No user reviews,0,0,0
626971,True,0,No user reviews,0,0,0
626972,True,0,No user reviews,0,0,0
626973,True,0,No user reviews,0,0,0
626990,True,0,No user reviews,0,0,0
626991,True,0,No user reviews,0,0,0
626992,True,0,No user reviews,0,0,0
626993,True,0,No user reviews,0,0,0
626994,True,0,No user reviews,0,0,0
626995,True,0,No user reviews,0,0,0
626996,True,0,No user reviews,0,0,0
626997,True,0,No user reviews,0,0,0
626998,True,0,No user reviews,0,0,0
626999,True,0,No user reviews,0,0,0
627000,True,0,No user reviews,0,0,0
627001,True,0,No user reviews,0,0,0
627010,True,0,1 user reviews,1,0,1
627011,True,0,No user reviews,0,0,0
627012,True,0,No user reviews,0,0,0
627013,True,0,1 user reviews,1,0,1
627030,True,0,No user reviews,0,0,0
627040,True,0,No user reviews,0,0,0
627050,True,0,1 user reviews,1,0,1
627051,True,0,No user reviews,0,0,0
627052,True,0,No user reviews,0,0,0
627053,True,0,No user reviews,0,0,0
627054,True,0,No user reviews,0,0,0
627055,True,0,No user reviews,0,0,0
627056,True,0,No user reviews,0,0,0
627057,True,0,No user reviews,0,0,0
627058,True,0,No user reviews,0,0,0
627059,True,0,No user reviews,0,0,0
627060,True,0,No user reviews,0,0,0
627061,True,0,No user reviews,0,0,0
627062,True,0,No user reviews,0,0,0
627070,True,7,Positive,26,1,27
627080,True,0,No user reviews,0,0,0
627081,True,0,No user reviews,0,0,0
627082,True,0,No user reviews,0,0,0
627083,True,0,No user reviews,0,0,0
627084,True,0,No user reviews,0,0,0
627090,True,0,No user reviews,0,0,0
627091,True,0,No user reviews,0,0,0
627092,True,0,No user reviews,0,0,0
627093,True,0,No user reviews,0,0,0
627094,True,0,No user reviews,0,0,0
627095,True,0,No user reviews,0,0,0
627096,True,0,No user reviews,0,0,0
627097,True,0,No user reviews,0,0,0
627098,True,0,No user reviews,0,0,0
627099,True,0,No user reviews,0,0,0
627100,True,0,No user reviews,0,0,0
627101,True,0,No user reviews,0,0,0
627110,True,0,No user reviews,0,0,0
627111,True,0,No user reviews,0,0,0
627112,True,0,No user reviews,0,0,0
627113,True,0,No user reviews,0,0,0
627114,True,0,No user reviews,0,0,0
627115,True,0,No user reviews,0,0,0
627116,True,0,No user reviews,0,0,0
627117,True,0,No user reviews,0,0,0
627118,True,0,No user reviews,0,0,0
627119,True,0,No user reviews,0,0,0
627120,True,0,No user reviews,0,0,0
627121,True,0,No user reviews,0,0,0
627122,True,0,No user reviews,0,0,0
627140,True,0,No user reviews,0,0,0
627150,True,0,No user reviews,0,0,0
627151,True,0,No user reviews,0,0,0
627152,True,0,No user reviews,0,0,0
627153,True,0,No user reviews,0,0,0
627154,True,0,No user reviews,0,0,0
627155,True,0,No user reviews,0,0,0
627156,True,0,No user reviews,0,0,0
627157,True,0,No user reviews,0,0,0
627158,True,0,No user reviews,0,0,0
627159,True,0,No user reviews,0,0,0
627160,True,0,No user reviews,0,0,0
627161,True,0,No user reviews,0,0,0
627162,True,0,No user reviews,0,0,0
627163,True,0,No user reviews,0,0,0
627164,True,0,No user reviews,0,0,0
627165,True,0,No user reviews,0,0,0
627166,True,0,No user reviews,0,0,0
627167,True,0,No user reviews,0,0,0
627168,True,0,No user reviews,0,0,0
627169,True,0,No user reviews,0,0,0
627170,True,0,No user reviews,0,0,0
627171,True,0,No user reviews,0,0,0
627180,True,0,No user reviews,0,0,0
627200,True,0,No user reviews,0,0,0
627201,True,0,No user reviews,0,0,0
627202,True,0,No user reviews,0,0,0
627203,True,0,No user reviews,0,0,0
627204,True,0,No user reviews,0,0,0
627205,True,0,No user reviews,0,0,0
627206,True,0,No user reviews,0,0,0
627207,True,0,No user reviews,0,0,0
627208,True,0,No user reviews,0,0,0
627209,True,0,No user reviews,0,0,0
627210,True,0,No user reviews,0,0,0
627211,True,0,No user reviews,0,0,0
627212,True,0,No user reviews,0,0,0
627213,True,0,No user reviews,0,0,0
627214,True,0,No user reviews,0,0,0
627215,True,0,No user reviews,0,0,0
627217,True,0,No user reviews,0,0,0
627220,True,5,Mixed,9,4,13
627230,True,0,No user reviews,0,0,0
627231,True,0,No user reviews,0,0,0
627232,True,0,No user reviews,0,0,0
627233,True,0,No user reviews,0,0,0
627234,True,0,No user reviews,0,0,0
627235,True,0,No user reviews,0,0,0
627236,True,0,No user reviews,0,0,0
627237,True,0,No user reviews,0,0,0
627238,True,0,No user reviews,0,0,0
627239,True,0,No user reviews,0,0,0
627240,True,0,No user reviews,0,0,0
627241,True,0,No user reviews,0,0,0
627242,True,0,No user reviews,0,0,0
627250,True,0,No user reviews,0,0,0
627260,True,0,No user reviews,0,0,0
627261,True,0,No user reviews,0,0,0
627270,True,8,Very Positive,1616,363,1979
627290,True,0,No user reviews,0,0,0
627300,True,0,No user reviews,0,0,0
627301,True,0,No user reviews,0,0,0
627302,True,0,No user reviews,0,0,0
627303,True,0,No user reviews,0,0,0
627310,True,0,4 user reviews,4,0,4
627320,True,0,No user reviews,0,0,0
627340,True,0,No user reviews,0,0,0
627350,True,7,Positive,36,6,42
627360,True,0,No user reviews,0,0,0
627370,True,0,1 user reviews,1,0,1
627380,True,0,No user reviews,0,0,0
627390,True,0,5 user reviews,4,1,5
627400,True,0,No user reviews,0,0,0
627410,True,0,5 user reviews,3,2,5
627420,True,0,1 user reviews,1,0,1
627430,True,7,Positive,20,4,24
627440,True,7,Positive,16,3,19
627450,True,5,Mixed,15,22,37
627460,True,0,3 user reviews,0,3,3
627470,True,0,No user reviews,0,0,0
627500,True,0,No user reviews,0,0,0
627510,True,8,Very Positive,197,18,215
627530,True,0,No user reviews,0,0,0
627540,True,0,No user reviews,0,0,0
627570,True,0,3 user reviews,3,0,3
627580,True,7,Positive,18,2,20
627581,True,0,No user reviews,0,0,0
627582,True,0,8 user reviews,7,1,8
627610,True,0,No user reviews,0,0,0
627620,True,5,Mixed,38,41,79
627630,True,0,No user reviews,0,0,0
627631,True,0,No user reviews,0,0,0
627632,True,0,No user reviews,0,0,0
627633,True,0,No user reviews,0,0,0
627634,True,0,No user reviews,0,0,0
627635,True,0,No user reviews,0,0,0
627636,True,0,No user reviews,0,0,0
627637,True,0,No user reviews,0,0,0
627638,True,0,No user reviews,0,0,0
627639,True,0,No user reviews,0,0,0
627640,True,0,No user reviews,0,0,0
627641,True,0,No user reviews,0,0,0
627650,True,0,No user reviews,0,0,0
627651,True,0,No user reviews,0,0,0
627652,True,0,No user reviews,0,0,0
627653,True,0,No user reviews,0,0,0
627654,True,0,No user reviews,0,0,0
627655,True,0,No user reviews,0,0,0
627656,True,0,No user reviews,0,0,0
627657,True,0,No user reviews,0,0,0
627658,True,0,No user reviews,0,0,0
627659,True,0,1 user reviews,1,0,1
627660,True,0,No user reviews,0,0,0
627661,True,0,No user reviews,0,0,0
627662,True,0,No user reviews,0,0,0
627670,True,0,8 user reviews,8,0,8
627680,True,0,No user reviews,0,0,0
627690,True,7,Positive,15,3,18
627710,True,0,No user reviews,0,0,0
627711,True,0,No user reviews,0,0,0
627712,True,0,No user reviews,0,0,0
627713,True,0,No user reviews,0,0,0
627714,True,0,No user reviews,0,0,0
627715,True,0,No user reviews,0,0,0
627716,True,0,No user reviews,0,0,0
627717,True,0,No user reviews,0,0,0
627718,True,0,No user reviews,0,0,0
627719,True,0,No user reviews,0,0,0
627720,True,0,No user reviews,0,0,0
627721,True,0,No user reviews,0,0,0
627730,True,0,No user reviews,0,0,0
627731,True,0,No user reviews,0,0,0
627732,True,0,No user reviews,0,0,0
627733,True,0,No user reviews,0,0,0
627734,True,0,No user reviews,0,0,0
627735,True,0,No user reviews,0,0,0
627736,True,0,No user reviews,0,0,0
627737,True,0,No user reviews,0,0,0
627738,True,0,No user reviews,0,0,0
627739,True,0,No user reviews,0,0,0
627740,True,0,No user reviews,0,0,0
627741,True,0,No user reviews,0,0,0
627742,True,0,No user reviews,0,0,0
627750,True,0,No user reviews,0,0,0
627751,True,0,No user reviews,0,0,0
627752,True,0,No user reviews,0,0,0
627753,True,0,No user reviews,0,0,0
627754,True,0,No user reviews,0,0,0
627755,True,0,No user reviews,0,0,0
627756,True,0,No user reviews,0,0,0
627757,True,0,No user reviews,0,0,0
627758,True,0,No user reviews,0,0,0
627759,True,0,No user reviews,0,0,0
627760,True,0,No user reviews,0,0,0
627761,True,0,No user reviews,0,0,0
627762,True,0,No user reviews,0,0,0
627763,True,0,No user reviews,0,0,0
627764,True,0,No user reviews,0,0,0
627765,True,0,No user reviews,0,0,0
627766,True,0,No user reviews,0,0,0
627767,True,0,No user reviews,0,0,0
627768,True,0,No user reviews,0,0,0
627769,True,0,No user reviews,0,0,0
627770,True,0,No user reviews,0,0,0
627771,True,0,1 user reviews,1,0,1
627780,True,0,No user reviews,0,0,0
627781,True,0,No user reviews,0,0,0
627782,True,0,No user reviews,0,0,0
627783,True,0,No user reviews,0,0,0
627784,True,0,No user reviews,0,0,0
627785,True,0,No user reviews,0,0,0
627786,True,0,No user reviews,0,0,0
627787,True,0,No user reviews,0,0,0
627790,True,0,No user reviews,0,0,0
627791,True,0,No user reviews,0,0,0
627792,True,0,No user reviews,0,0,0
627793,True,0,No user reviews,0,0,0
627794,True,0,No user reviews,0,0,0
627795,True,0,No user reviews,0,0,0
627796,True,0,No user reviews,0,0,0
627797,True,0,No user reviews,0,0,0
627798,True,0,No user reviews,0,0,0
627799,True,0,No user reviews,0,0,0
627800,True,0,No user reviews,0,0,0
627801,True,0,No user reviews,0,0,0
627802,True,0,No user reviews,0,0,0
627803,True,0,No user reviews,0,0,0
627804,True,0,No user reviews,0,0,0
627805,True,0,No user reviews,0,0,0
627806,True,0,No user reviews,0,0,0
627807,True,0,No user reviews,0,0,0
627808,True,0,No user reviews,0,0,0
627809,True,0,No user reviews,0,0,0
627810,True,0,No user reviews,0,0,0
627811,True,0,No user reviews,0,0,0
627820,True,5,Mixed,42,27,69
627830,True,0,No user reviews,0,0,0
627840,True,0,No user reviews,0,0,0
627841,True,0,No user reviews,0,0,0
627842,True,0,No user reviews,0,0,0
627843,True,0,No user reviews,0,0,0
627844,True,0,No user reviews,0,0,0
627845,True,0,No user reviews,0,0,0
627846,True,0,No user reviews,0,0,0
627847,True,0,No user reviews,0,0,0
627848,True,0,No user reviews,0,0,0
627849,True,0,No user reviews,0,0,0
627850,True,0,No user reviews,0,0,0
627851,True,0,No user reviews,0,0,0
627852,True,0,No user reviews,0,0,0
627853,True,0,No user reviews,0,0,0
627854,True,0,No user reviews,0,0,0
627855,True,0,No user reviews,0,0,0
627856,True,0,No user reviews,0,0,0
627857,True,0,No user reviews,0,0,0
627858,True,0,No user reviews,0,0,0
627859,True,0,No user reviews,0,0,0
627860,True,0,No user reviews,0,0,0
627861,True,0,No user reviews,0,0,0
627862,True,0,No user reviews,0,0,0
627863,True,0,No user reviews,0,0,0
627864,True,0,No user reviews,0,0,0
627865,True,0,No user reviews,0,0,0
627866,True,0,No user reviews,0,0,0
627867,True,0,No user reviews,0,0,0
627868,True,0,No user reviews,0,0,0
627869,True,0,No user reviews,0,0,0
627870,True,0,No user reviews,0,0,0
627871,True,0,No user reviews,0,0,0
627872,True,0,No user reviews,0,0,0
627873,True,0,No user reviews,0,0,0
627874,True,0,No user reviews,0,0,0
627875,True,0,No user reviews,0,0,0
627880,True,0,1 user reviews,0,1,1
627881,True,0,No user reviews,0,0,0
627882,True,0,No user reviews,0,0,0
627883,True,0,No user reviews,0,0,0
627884,True,0,No user reviews,0,0,0
627885,True,0,No user reviews,0,0,0
627886,True,0,No user reviews,0,0,0
627887,True,0,No user reviews,0,0,0
627888,True,0,No user reviews,0,0,0
627889,True,0,No user reviews,0,0,0
627890,True,7,Positive,9,1,10
627900,True,0,No user reviews,0,0,0
627901,True,0,No user reviews,0,0,0
627902,True,0,No user reviews,0,0,0
627903,True,0,No user reviews,0,0,0
627904,True,0,No user reviews,0,0,0
627905,True,0,No user reviews,0,0,0
627906,True,0,No user reviews,0,0,0
627907,True,0,No user reviews,0,0,0
627908,True,0,No user reviews,0,0,0
627909,True,0,No user reviews,0,0,0
627910,True,5,Mixed,68,45,113
627930,True,0,No user reviews,0,0,0
627931,True,0,No user reviews,0,0,0
627932,True,0,No user reviews,0,0,0
627933,True,0,No user reviews,0,0,0
627934,True,0,No user reviews,0,0,0
627935,True,0,No user reviews,0,0,0
627936,True,0,No user reviews,0,0,0
627937,True,0,No user reviews,0,0,0
627938,True,0,No user reviews,0,0,0
627939,True,0,No user reviews,0,0,0
627940,True,0,No user reviews,0,0,0
627941,True,0,No user reviews,0,0,0
627942,True,0,No user reviews,0,0,0
627950,True,0,3 user reviews,0,3,3
627960,True,0,No user reviews,0,0,0
627961,True,0,No user reviews,0,0,0
627962,True,0,No user reviews,0,0,0
627963,True,0,No user reviews,0,0,0
627964,True,0,No user reviews,0,0,0
627965,True,0,No user reviews,0,0,0
627966,True,0,No user reviews,0,0,0
627967,True,0,No user reviews,0,0,0
627968,True,0,No user reviews,0,0,0
627969,True,0,No user reviews,0,0,0
627970,True,0,No user reviews,0,0,0
627971,True,0,No user reviews,0,0,0
627980,True,0,1 user reviews,1,0,1
627990,True,0,No user reviews,0,0,0
628000,True,0,6 user reviews,5,1,6
628001,True,0,No user reviews,0,0,0
628002,True,0,No user reviews,0,0,0
628003,True,0,No user reviews,0,0,0
628004,True,0,No user reviews,0,0,0
628005,True,0,No user reviews,0,0,0
628006,True,0,No user reviews,0,0,0
628007,True,0,No user reviews,0,0,0
628008,True,0,No user reviews,0,0,0
628009,True,0,1 user reviews,1,0,1
628010,True,0,No user reviews,0,0,0
628011,True,0,No user reviews,0,0,0
628020,True,0,1 user reviews,1,0,1
628030,True,0,6 user reviews,2,4,6
628040,True,0,6 user reviews,2,4,6
628050,True,6,Mostly Positive,14,5,19
628060,True,5,Mixed,16,11,27
628070,True,6,Mostly Positive,71,22,93
628080,True,0,6 user reviews,2,4,6
628090,True,0,No user reviews,0,0,0
628100,True,0,No user reviews,0,0,0
628110,True,0,1 user reviews,1,0,1
628120,True,0,1 user reviews,0,1,1
628130,True,0,4 user reviews,2,2,4
628140,True,0,4 user reviews,1,3,4
628150,True,0,5 user reviews,4,1,5
628160,True,0,1 user reviews,0,1,1
628170,True,0,6 user reviews,5,1,6
628180,True,0,1 user reviews,1,0,1
628190,True,0,No user reviews,0,0,0
628200,True,0,No user reviews,0,0,0
628220,True,0,No user reviews,0,0,0
628240,True,0,No user reviews,0,0,0
628250,True,0,No user reviews,0,0,0
628260,True,0,No user reviews,0,0,0
628280,True,0,No user reviews,0,0,0
628290,True,6,Mostly Positive,72,30,102
628300,True,0,No user reviews,0,0,0
628310,True,0,No user reviews,0,0,0
628320,True,7,Positive,20,4,24
628330,True,4,Mostly Negative,7,11,18
628350,True,7,Positive,22,5,27
628410,True,0,No user reviews,0,0,0
628440,True,0,No user reviews,0,0,0
628450,True,0,4 user reviews,3,1,4
628460,True,7,Positive,38,2,40
628470,True,0,No user reviews,0,0,0
628471,True,0,No user reviews,0,0,0
628472,True,0,No user reviews,0,0,0
628473,True,0,1 user reviews,1,0,1
628474,True,0,No user reviews,0,0,0
628475,True,0,No user reviews,0,0,0
628476,True,0,No user reviews,0,0,0
628477,True,0,No user reviews,0,0,0
628478,True,0,No user reviews,0,0,0
628479,True,0,No user reviews,0,0,0
628480,True,0,No user reviews,0,0,0
628481,True,0,No user reviews,0,0,0
628530,True,0,No user reviews,0,0,0
628540,True,0,7 user reviews,7,0,7
628550,True,0,No user reviews,0,0,0
628560,True,0,No user reviews,0,0,0
628570,True,0,7 user reviews,5,2,7
628580,True,0,5 user reviews,5,0,5
628600,True,0,No user reviews,0,0,0
628610,True,0,No user reviews,0,0,0
628650,True,0,2 user reviews,0,2,2
628660,True,7,Positive,32,6,38
628670,True,8,Very Positive,631,132,763
628680,True,0,No user reviews,0,0,0
628700,True,0,No user reviews,0,0,0
628710,True,6,Mostly Positive,32,12,44
628720,True,7,Positive,19,4,23
628730,True,0,No user reviews,0,0,0
628750,True,8,Very Positive,118,28,146
628760,True,7,Positive,18,4,22
628770,True,8,Very Positive,374,45,419
628790,True,0,No user reviews,0,0,0
628800,True,8,Very Positive,66,3,69
628820,True,0,6 user reviews,2,4,6
628830,True,0,4 user reviews,4,0,4
628880,True,0,No user reviews,0,0,0
628890,True,5,Mixed,31,21,52
628900,True,5,Mixed,54,44,98
628920,True,8,Very Positive,98,12,110
628930,True,0,No user reviews,0,0,0
628940,True,0,1 user reviews,1,0,1
628950,True,5,Mixed,57,28,85
628960,True,0,5 user reviews,5,0,5
628970,True,0,No user reviews,0,0,0
628980,True,0,No user reviews,0,0,0
629000,True,8,Very Positive,157,14,171
629010,True,0,No user reviews,0,0,0
629020,True,0,5 user reviews,5,0,5
629021,True,0,4 user reviews,4,0,4
629030,True,4,Mostly Negative,14,55,69
629040,True,6,Mostly Positive,14,5,19
629070,True,0,No user reviews,0,0,0
629080,True,0,4 user reviews,4,0,4
629090,True,8,Very Positive,170,21,191
629100,True,0,8 user reviews,8,0,8
629110,True,7,Positive,17,1,18
629160,True,0,No user reviews,0,0,0
629170,True,0,No user reviews,0,0,0
629180,True,0,No user reviews,0,0,0
629190,True,0,No user reviews,0,0,0
629191,True,0,No user reviews,0,0,0
629210,True,0,5 user reviews,1,4,5
629220,True,6,Mostly Positive,162,49,211
629230,True,7,Positive,10,2,12
629240,True,6,Mostly Positive,7,3,10
629260,True,0,No user reviews,0,0,0
629270,True,0,No user reviews,0,0,0
629310,True,0,No user reviews,0,0,0
629330,True,8,Very Positive,238,4,242
629340,True,0,7 user reviews,7,0,7
629360,True,0,3 user reviews,1,2,3
629370,True,0,No user reviews,0,0,0
629380,True,0,1 user reviews,1,0,1
629390,True,0,No user reviews,0,0,0
629400,True,0,1 user reviews,1,0,1
629410,True,0,7 user reviews,6,1,7
629420,True,0,3 user reviews,3,0,3
629430,True,7,Positive,32,1,33
629440,True,8,Very Positive,61,0,61
629450,True,0,No user reviews,0,0,0
629470,True,0,No user reviews,0,0,0
629490,True,0,No user reviews,0,0,0
629500,True,0,No user reviews,0,0,0
629510,True,0,No user reviews,0,0,0
629520,True,9,Overwhelmingly Positive,4780,136,4916
629540,True,6,Mostly Positive,28,8,36
629550,True,0,1 user reviews,1,0,1
629580,True,0,7 user reviews,2,5,7
629610,True,0,No user reviews,0,0,0
629620,True,0,No user reviews,0,0,0
629630,True,0,No user reviews,0,0,0
629640,True,0,7 user reviews,2,5,7
629650,True,7,Positive,41,8,49
629680,True,0,No user reviews,0,0,0
629690,True,8,Very Positive,311,37,348
629700,True,7,Positive,14,0,14
629710,True,0,No user reviews,0,0,0
629720,True,0,No user reviews,0,0,0
629730,True,8,Very Positive,9605,592,10197
629751,True,0,6 user reviews,3,3,6
629760,True,8,Very Positive,36407,6756,43163
629770,True,8,Very Positive,100,7,107
629780,True,0,2 user reviews,1,1,2
629790,True,0,No user reviews,0,0,0
629791,True,0,No user reviews,0,0,0
629792,True,0,No user reviews,0,0,0
629793,True,0,No user reviews,0,0,0
629794,True,0,No user reviews,0,0,0
629795,True,0,No user reviews,0,0,0
629796,True,0,No user reviews,0,0,0
629800,True,0,No user reviews,0,0,0
629810,True,0,3 user reviews,3,0,3
629820,True,0,No user reviews,0,0,0
629830,True,0,3 user reviews,3,0,3
629840,True,5,Mixed,238,130,368
629860,True,7,Positive,20,4,24
629880,True,0,No user reviews,0,0,0
629890,True,0,No user reviews,0,0,0
629900,True,0,No user reviews,0,0,0
629910,True,5,Mixed,501,297,798
629920,True,0,No user reviews,0,0,0
629930,True,0,5 user reviews,4,1,5
629940,True,0,8 user reviews,8,0,8
629960,True,6,Mostly Positive,17,6,23
629970,True,0,8 user reviews,7,1,8
629990,True,5,Mixed,6,6,12
630010,True,6,Mostly Positive,39,12,51
630020,True,6,Mostly Positive,7,3,10
630030,True,6,Mostly Positive,85,30,115
630040,True,0,No user reviews,0,0,0
630050,True,6,Mostly Positive,13,5,18
630060,True,7,Positive,26,2,28
630070,True,0,7 user reviews,6,1,7
630080,True,0,8 user reviews,8,0,8
630100,True,0,No user reviews,0,0,0
630130,True,0,No user reviews,0,0,0
630140,True,0,No user reviews,0,0,0
630160,True,0,9 user reviews,8,1,9
630170,True,0,4 user reviews,3,1,4
630180,True,0,No user reviews,0,0,0
630190,True,0,3 user reviews,1,2,3
630200,True,0,No user reviews,0,0,0
630210,True,0,No user reviews,0,0,0
630230,True,0,No user reviews,0,0,0
630240,True,0,1 user reviews,1,0,1
630250,True,0,No user reviews,0,0,0
630260,True,0,6 user reviews,6,0,6
630270,True,0,No user reviews,0,0,0
630280,True,0,7 user reviews,7,0,7
630290,True,0,1 user reviews,1,0,1
630300,True,0,No user reviews,0,0,0
630310,True,6,Mostly Positive,146,38,184
630330,True,0,No user reviews,0,0,0
630340,True,0,No user reviews,0,0,0
630350,True,0,No user reviews,0,0,0
630360,True,5,Mixed,6,7,13
630380,True,0,No user reviews,0,0,0
630390,True,0,No user reviews,0,0,0
630400,True,0,8 user reviews,7,1,8
630420,True,0,No user reviews,0,0,0
630430,True,0,3 user reviews,2,1,3
630440,True,0,No user reviews,0,0,0
630460,True,7,Positive,26,0,26
630470,True,0,5 user reviews,4,1,5
630480,True,0,No user reviews,0,0,0
630490,True,4,Mostly Negative,14,27,41
630500,True,0,6 user reviews,6,0,6
630510,True,0,No user reviews,0,0,0
630530,True,0,No user reviews,0,0,0
630540,True,0,No user reviews,0,0,0
630541,True,0,No user reviews,0,0,0
630542,True,0,No user reviews,0,0,0
630543,True,0,No user reviews,0,0,0
630550,True,7,Positive,38,5,43
630580,True,0,No user reviews,0,0,0
630590,True,0,No user reviews,0,0,0
630610,True,8,Very Positive,120,17,137
630630,True,7,Positive,24,6,30
630640,True,7,Positive,47,0,47
630663,True,0,2 user reviews,1,1,2
630670,True,0,6 user reviews,3,3,6
630690,True,5,Mixed,5,6,11
630720,True,8,Very Positive,126,27,153
630730,True,0,No user reviews,0,0,0
630760,True,0,No user reviews,0,0,0
630780,True,0,No user reviews,0,0,0
630790,True,0,1 user reviews,1,0,1
630830,True,7,Positive,23,1,24
630840,True,0,No user reviews,0,0,0
630850,True,0,9 user reviews,2,7,9
630870,True,7,Positive,13,0,13
630880,True,0,No user reviews,0,0,0
630890,True,0,7 user reviews,4,3,7
630900,True,8,Very Positive,226,16,242
630910,True,6,Mostly Positive,11,3,14
630911,True,0,7 user reviews,7,0,7
630912,True,0,5 user reviews,3,2,5
630913,True,0,1 user reviews,1,0,1
630914,True,0,1 user reviews,0,1,1
630915,True,0,No user reviews,0,0,0
630916,True,0,8 user reviews,5,3,8
630917,True,0,7 user reviews,7,0,7
630918,True,0,9 user reviews,7,2,9
630919,True,0,1 user reviews,1,0,1
630920,True,0,No user reviews,0,0,0
630940,True,5,Mixed,148,124,272
630970,True,0,1 user reviews,0,1,1
630980,True,0,No user reviews,0,0,0
630990,True,0,No user reviews,0,0,0
631110,True,0,No user reviews,0,0,0
631120,True,0,4 user reviews,4,0,4
631130,True,0,No user reviews,0,0,0
631190,True,0,No user reviews,0,0,0
631220,True,0,No user reviews,0,0,0
631240,True,0,3 user reviews,1,2,3
631250,True,0,3 user reviews,2,1,3
631260,True,0,1 user reviews,1,0,1
631270,True,0,3 user reviews,1,2,3
631280,True,0,No user reviews,0,0,0
631290,True,0,No user reviews,0,0,0
631291,True,0,No user reviews,0,0,0
631292,True,0,No user reviews,0,0,0
631293,True,0,No user reviews,0,0,0
631300,True,0,No user reviews,0,0,0
631310,True,0,No user reviews,0,0,0
631320,True,0,No user reviews,0,0,0
631330,True,0,No user reviews,0,0,0
631331,True,0,No user reviews,0,0,0
631332,True,0,1 user reviews,0,1,1
631430,True,0,No user reviews,0,0,0
631440,True,0,No user reviews,0,0,0
631441,True,0,No user reviews,0,0,0
631442,True,0,No user reviews,0,0,0
631443,True,0,No user reviews,0,0,0
631444,True,0,No user reviews,0,0,0
631445,True,0,No user reviews,0,0,0
631446,True,0,No user reviews,0,0,0
631447,True,0,No user reviews,0,0,0
631450,True,0,No user reviews,0,0,0
631490,True,0,6 user reviews,5,1,6
631500,True,0,4 user reviews,4,0,4
631510,True,8,Very Positive,793,94,887
631540,True,4,Mostly Negative,25,42,67
631550,True,0,3 user reviews,3,0,3
631551,True,0,No user reviews,0,0,0
631552,True,0,No user reviews,0,0,0
631553,True,0,1 user reviews,0,1,1
631554,True,0,No user reviews,0,0,0
631560,True,8,Very Positive,73,2,75
631570,True,8,Very Positive,407,21,428
631580,True,0,No user reviews,0,0,0
631610,True,0,1 user reviews,1,0,1
631640,True,0,No user reviews,0,0,0
631650,True,0,No user reviews,0,0,0
631651,True,0,No user reviews,0,0,0
631652,True,0,No user reviews,0,0,0
631653,True,0,No user reviews,0,0,0
631654,True,0,No user reviews,0,0,0
631655,True,0,No user reviews,0,0,0
631660,True,0,No user reviews,0,0,0
631670,True,0,No user reviews,0,0,0
631690,True,0,4 user reviews,3,1,4
631700,True,0,No user reviews,0,0,0
631701,True,0,No user reviews,0,0,0
631702,True,0,No user reviews,0,0,0
631703,True,0,No user reviews,0,0,0
631710,True,0,No user reviews,0,0,0
631711,True,0,No user reviews,0,0,0
631712,True,0,No user reviews,0,0,0
631713,True,0,No user reviews,0,0,0
631714,True,0,No user reviews,0,0,0
631715,True,0,No user reviews,0,0,0
631716,True,0,No user reviews,0,0,0
631717,True,0,No user reviews,0,0,0
631718,True,0,No user reviews,0,0,0
631719,True,0,No user reviews,0,0,0
631720,True,0,No user reviews,0,0,0
631721,True,0,No user reviews,0,0,0
631740,True,0,No user reviews,0,0,0
631741,True,0,No user reviews,0,0,0
631742,True,0,No user reviews,0,0,0
631743,True,0,No user reviews,0,0,0
631744,True,0,No user reviews,0,0,0
631750,True,0,No user reviews,0,0,0
631751,True,0,No user reviews,0,0,0
631752,True,0,No user reviews,0,0,0
631753,True,0,No user reviews,0,0,0
631754,True,0,No user reviews,0,0,0
631755,True,0,No user reviews,0,0,0
631756,True,0,No user reviews,0,0,0
631757,True,0,No user reviews,0,0,0
631758,True,0,No user reviews,0,0,0
631759,True,0,No user reviews,0,0,0
631760,True,0,No user reviews,0,0,0
631761,True,0,No user reviews,0,0,0
631770,True,0,7 user reviews,7,0,7
631780,True,0,2 user reviews,2,0,2
631790,True,0,No user reviews,0,0,0
631791,True,0,1 user reviews,1,0,1
631792,True,0,No user reviews,0,0,0
631793,True,0,No user reviews,0,0,0
631794,True,0,No user reviews,0,0,0
631795,True,0,No user reviews,0,0,0
631796,True,0,No user reviews,0,0,0
631797,True,0,No user reviews,0,0,0
631798,True,0,No user reviews,0,0,0
631799,True,0,No user reviews,0,0,0
631810,True,7,Positive,11,2,13
631830,True,5,Mixed,24,11,35
631840,True,0,No user reviews,0,0,0
631841,True,0,No user reviews,0,0,0
631842,True,0,No user reviews,0,0,0
631843,True,0,No user reviews,0,0,0
631844,True,0,No user reviews,0,0,0
631845,True,0,No user reviews,0,0,0
631846,True,0,No user reviews,0,0,0
631847,True,0,No user reviews,0,0,0
631848,True,0,No user reviews,0,0,0
631849,True,0,No user reviews,0,0,0
631850,True,0,No user reviews,0,0,0
631851,True,0,No user reviews,0,0,0
631860,True,0,No user reviews,0,0,0
631870,True,0,No user reviews,0,0,0
631880,True,0,No user reviews,0,0,0
631890,True,0,No user reviews,0,0,0
631900,True,7,Positive,44,3,47
631910,True,0,3 user reviews,1,2,3
631920,True,0,6 user reviews,3,3,6
631940,True,0,No user reviews,0,0,0
631950,True,0,No user reviews,0,0,0
631960,True,0,No user reviews,0,0,0
631970,True,0,No user reviews,0,0,0
631980,True,8,Very Positive,91,15,106
631990,True,5,Mixed,16,8,24
632000,True,8,Very Positive,261,40,301
632020,True,7,Positive,18,3,21
632030,True,0,No user reviews,0,0,0
632040,True,0,7 user reviews,7,0,7
632050,True,0,2 user reviews,0,2,2
632060,True,0,No user reviews,0,0,0
632070,True,6,Mostly Positive,350,94,444
632080,True,0,No user reviews,0,0,0
632100,True,7,Positive,8,2,10
632110,True,0,8 user reviews,4,4,8
632120,True,0,1 user reviews,1,0,1
632140,True,0,No user reviews,0,0,0
632150,True,0,No user reviews,0,0,0
632160,True,0,No user reviews,0,0,0
632170,True,5,Mixed,17,9,26
632190,True,0,No user reviews,0,0,0
632200,True,0,5 user reviews,0,5,5
632210,True,0,No user reviews,0,0,0
632240,True,0,No user reviews,0,0,0
632250,True,7,Positive,18,3,21
632280,True,0,No user reviews,0,0,0
632290,True,5,Mixed,6,5,11
632300,True,6,Mostly Positive,291,119,410
632310,True,0,No user reviews,0,0,0
632320,True,0,No user reviews,0,0,0
632340,True,0,No user reviews,0,0,0
632350,True,8,Very Positive,882,165,1047
632360,True,9,Overwhelmingly Positive,52718,1411,54129
632370,True,0,No user reviews,0,0,0
632380,True,0,2 user reviews,1,1,2
632440,True,0,No user reviews,0,0,0
632470,True,8,Very Positive,13014,688,13702
632510,True,6,Mostly Positive,14,6,20
632520,True,5,Mixed,6,4,10
632590,True,7,Positive,14,0,14
632620,True,0,8 user reviews,4,4,8
632630,True,0,No user reviews,0,0,0
632650,True,0,No user reviews,0,0,0
632660,True,0,No user reviews,0,0,0
632670,True,0,No user reviews,0,0,0
632690,True,0,No user reviews,0,0,0
632710,True,7,Positive,31,3,34
632730,True,0,No user reviews,0,0,0
632740,True,0,No user reviews,0,0,0
632750,True,5,Mixed,8,4,12
632790,True,0,No user reviews,0,0,0
632800,True,8,Very Positive,65,9,74
632810,True,0,No user reviews,0,0,0
632820,True,0,3 user reviews,3,0,3
632830,True,0,No user reviews,0,0,0
632840,True,0,3 user reviews,2,1,3
632870,True,7,Positive,13,2,15
632880,True,7,Positive,16,0,16
632890,True,0,No user reviews,0,0,0
632900,True,7,Positive,31,5,36
632910,True,0,1 user reviews,1,0,1
632920,True,0,3 user reviews,3,0,3
632930,True,0,1 user reviews,1,0,1
632940,True,0,No user reviews,0,0,0
632950,True,0,No user reviews,0,0,0
633020,True,0,No user reviews,0,0,0
633030,True,0,No user reviews,0,0,0
633060,True,6,Mostly Positive,487,143,630
633070,True,0,No user reviews,0,0,0
633080,True,0,No user reviews,0,0,0
633090,True,0,No user reviews,0,0,0
633110,True,6,Mostly Positive,145,61,206
633140,True,0,No user reviews,0,0,0
633150,True,0,No user reviews,0,0,0
633160,True,0,No user reviews,0,0,0
633170,True,0,No user reviews,0,0,0
633190,True,0,No user reviews,0,0,0
633200,True,0,No user reviews,0,0,0
633210,True,0,No user reviews,0,0,0
633230,True,6,Mostly Positive,2090,788,2878
633251,True,0,No user reviews,0,0,0
633280,True,0,4 user reviews,2,2,4
633300,True,0,2 user reviews,0,2,2
633310,True,0,No user reviews,0,0,0
633320,True,0,No user reviews,0,0,0
633330,True,0,1 user reviews,1,0,1
633331,True,0,No user reviews,0,0,0
633340,True,0,No user reviews,0,0,0
633350,True,0,8 user reviews,5,3,8
633360,True,6,Mostly Positive,313,132,445
633380,True,0,No user reviews,0,0,0
633410,True,0,No user reviews,0,0,0
633430,True,0,No user reviews,0,0,0
633440,True,0,6 user reviews,3,3,6
633460,True,8,Very Positive,2401,361,2762
633470,True,0,No user reviews,0,0,0
633490,True,0,1 user reviews,1,0,1
633500,True,0,No user reviews,0,0,0
633501,True,0,No user reviews,0,0,0
633502,True,0,No user reviews,0,0,0
633503,True,0,No user reviews,0,0,0
633504,True,0,No user reviews,0,0,0
633505,True,0,No user reviews,0,0,0
633506,True,0,No user reviews,0,0,0
633507,True,0,No user reviews,0,0,0
633520,True,0,No user reviews,0,0,0
633521,True,0,No user reviews,0,0,0
633522,True,0,No user reviews,0,0,0
633523,True,0,No user reviews,0,0,0
633524,True,0,No user reviews,0,0,0
633525,True,0,No user reviews,0,0,0
633528,True,0,No user reviews,0,0,0
633529,True,0,No user reviews,0,0,0
633550,True,0,No user reviews,0,0,0
633551,True,0,No user reviews,0,0,0
633552,True,0,No user reviews,0,0,0
633553,True,0,No user reviews,0,0,0
633554,True,0,No user reviews,0,0,0
633556,True,0,No user reviews,0,0,0
633557,True,0,No user reviews,0,0,0
633558,True,0,No user reviews,0,0,0
633559,True,0,No user reviews,0,0,0
633580,True,5,Mixed,8,4,12
633590,True,0,No user reviews,0,0,0
633600,True,7,Positive,20,2,22
633610,True,0,No user reviews,0,0,0
633630,True,0,No user reviews,0,0,0
633631,True,0,No user reviews,0,0,0
633640,True,0,No user reviews,0,0,0
633660,True,0,3 user reviews,1,2,3
633690,True,0,No user reviews,0,0,0
633691,True,0,No user reviews,0,0,0
633693,True,0,No user reviews,0,0,0
633694,True,0,No user reviews,0,0,0
633695,True,0,No user reviews,0,0,0
633696,True,0,No user reviews,0,0,0
633697,True,0,No user reviews,0,0,0
633698,True,0,No user reviews,0,0,0
633699,True,0,No user reviews,0,0,0
633700,True,0,No user reviews,0,0,0
633701,True,0,No user reviews,0,0,0
633710,True,0,No user reviews,0,0,0
633730,True,0,No user reviews,0,0,0
633731,True,0,No user reviews,0,0,0
633732,True,0,No user reviews,0,0,0
633733,True,0,No user reviews,0,0,0
633734,True,0,No user reviews,0,0,0
633735,True,0,No user reviews,0,0,0
633736,True,0,No user reviews,0,0,0
633737,True,0,No user reviews,0,0,0
633738,True,0,No user reviews,0,0,0
633739,True,0,No user reviews,0,0,0
633770,True,0,No user reviews,0,0,0
633771,True,0,No user reviews,0,0,0
633772,True,0,No user reviews,0,0,0
633773,True,0,No user reviews,0,0,0
633774,True,0,No user reviews,0,0,0
633776,True,0,No user reviews,0,0,0
633777,True,0,No user reviews,0,0,0
633778,True,0,No user reviews,0,0,0
633779,True,0,No user reviews,0,0,0
633781,True,0,No user reviews,0,0,0
633782,True,0,No user reviews,0,0,0
633790,True,0,No user reviews,0,0,0
633791,True,0,No user reviews,0,0,0
633792,True,0,No user reviews,0,0,0
633793,True,0,No user reviews,0,0,0
633794,True,0,No user reviews,0,0,0
633795,True,0,No user reviews,0,0,0
633797,True,0,No user reviews,0,0,0
633798,True,0,No user reviews,0,0,0
633799,True,0,No user reviews,0,0,0
633800,True,0,No user reviews,0,0,0
633801,True,0,No user reviews,0,0,0
633803,True,0,No user reviews,0,0,0
633804,True,0,No user reviews,0,0,0
633805,True,0,No user reviews,0,0,0
633806,True,0,No user reviews,0,0,0
633807,True,0,No user reviews,0,0,0
633808,True,0,No user reviews,0,0,0
633809,True,0,No user reviews,0,0,0
633811,True,0,No user reviews,0,0,0
633830,True,0,No user reviews,0,0,0
633860,True,0,No user reviews,0,0,0
633870,True,0,No user reviews,0,0,0
633871,True,0,No user reviews,0,0,0
633910,True,0,No user reviews,0,0,0
633930,True,7,Positive,17,0,17
633940,True,0,8 user reviews,4,4,8
633950,True,5,Mixed,42,30,72
633960,True,0,2 user reviews,2,0,2
633961,True,0,1 user reviews,1,0,1
633963,True,0,No user reviews,0,0,0
633970,True,0,7 user reviews,1,6,7
633980,True,0,No user reviews,0,0,0
633981,True,0,No user reviews,0,0,0
634010,True,0,1 user reviews,1,0,1
634012,True,0,No user reviews,0,0,0
634014,True,0,1 user reviews,1,0,1
634016,True,0,No user reviews,0,0,0
634030,True,5,Mixed,9,5,14
634040,True,0,No user reviews,0,0,0
634060,True,0,No user reviews,0,0,0
634070,True,0,No user reviews,0,0,0
634090,True,0,1 user reviews,1,0,1
634120,True,5,Mixed,33,29,62
634150,True,0,5 user reviews,1,4,5
634160,True,9,Overwhelmingly Positive,853,34,887
634170,True,0,No user reviews,0,0,0
634180,True,6,Mostly Positive,26,8,34
634190,True,0,No user reviews,0,0,0
634191,True,0,No user reviews,0,0,0
634193,True,0,No user reviews,0,0,0
634194,True,0,No user reviews,0,0,0
634195,True,0,No user reviews,0,0,0
634196,True,0,No user reviews,0,0,0
634200,True,0,4 user reviews,3,1,4
634230,True,5,Mixed,8,12,20
634250,True,0,1 user reviews,1,0,1
634260,True,0,No user reviews,0,0,0
634270,True,0,No user reviews,0,0,0
634280,True,0,No user reviews,0,0,0
634300,True,0,No user reviews,0,0,0
634310,True,0,No user reviews,0,0,0
634320,True,0,No user reviews,0,0,0
634330,True,0,No user reviews,0,0,0
634340,True,6,Mostly Positive,27,8,35
634410,True,8,Very Positive,67,1,68
634420,True,0,1 user reviews,1,0,1
634421,True,0,No user reviews,0,0,0
634580,True,0,No user reviews,0,0,0
634590,True,0,No user reviews,0,0,0
634591,True,0,No user reviews,0,0,0
634592,True,0,No user reviews,0,0,0
634593,True,0,No user reviews,0,0,0
634594,True,0,No user reviews,0,0,0
634595,True,0,No user reviews,0,0,0
634596,True,0,No user reviews,0,0,0
634597,True,0,No user reviews,0,0,0
634598,True,0,No user reviews,0,0,0
634599,True,0,No user reviews,0,0,0
634610,True,0,No user reviews,0,0,0
634611,True,0,No user reviews,0,0,0
634612,True,0,No user reviews,0,0,0
634613,True,0,No user reviews,0,0,0
634614,True,0,No user reviews,0,0,0
634615,True,0,No user reviews,0,0,0
634616,True,0,No user reviews,0,0,0
634617,True,0,No user reviews,0,0,0
634618,True,0,No user reviews,0,0,0
634620,True,0,No user reviews,0,0,0
634621,True,0,No user reviews,0,0,0
634622,True,0,No user reviews,0,0,0
634623,True,0,No user reviews,0,0,0
634624,True,0,No user reviews,0,0,0
634625,True,0,No user reviews,0,0,0
634626,True,0,No user reviews,0,0,0
634627,True,0,No user reviews,0,0,0
634628,True,0,No user reviews,0,0,0
634630,True,0,No user reviews,0,0,0
634631,True,0,No user reviews,0,0,0
634634,True,0,No user reviews,0,0,0
634640,True,0,No user reviews,0,0,0
634641,True,0,No user reviews,0,0,0
634642,True,0,No user reviews,0,0,0
634643,True,0,No user reviews,0,0,0
634644,True,0,No user reviews,0,0,0
634645,True,0,No user reviews,0,0,0
634646,True,0,No user reviews,0,0,0
634647,True,0,No user reviews,0,0,0
634648,True,0,No user reviews,0,0,0
634649,True,0,No user reviews,0,0,0
634650,True,0,No user reviews,0,0,0
634651,True,0,No user reviews,0,0,0
634660,True,0,No user reviews,0,0,0
634661,True,0,No user reviews,0,0,0
634662,True,0,No user reviews,0,0,0
634663,True,0,No user reviews,0,0,0
634664,True,0,No user reviews,0,0,0
634665,True,0,No user reviews,0,0,0
634666,True,0,No user reviews,0,0,0
634667,True,0,No user reviews,0,0,0
634668,True,0,No user reviews,0,0,0
634669,True,0,No user reviews,0,0,0
634670,True,0,No user reviews,0,0,0
634671,True,0,No user reviews,0,0,0
634680,True,0,No user reviews,0,0,0
634681,True,0,No user reviews,0,0,0
634682,True,0,No user reviews,0,0,0
634683,True,0,No user reviews,0,0,0
634684,True,0,No user reviews,0,0,0
634685,True,0,No user reviews,0,0,0
634686,True,0,No user reviews,0,0,0
634687,True,0,No user reviews,0,0,0
634688,True,0,No user reviews,0,0,0
634689,True,0,No user reviews,0,0,0
634690,True,0,No user reviews,0,0,0
634691,True,0,No user reviews,0,0,0
634692,True,0,No user reviews,0,0,0
634693,True,0,No user reviews,0,0,0
634694,True,0,No user reviews,0,0,0
634695,True,0,No user reviews,0,0,0
634696,True,0,No user reviews,0,0,0
634697,True,0,No user reviews,0,0,0
634698,True,0,No user reviews,0,0,0
634699,True,0,No user reviews,0,0,0
634700,True,7,Positive,8,2,10
634710,True,0,No user reviews,0,0,0
634711,True,0,No user reviews,0,0,0
634712,True,0,No user reviews,0,0,0
634713,True,0,No user reviews,0,0,0
634714,True,0,No user reviews,0,0,0
634715,True,0,No user reviews,0,0,0
634716,True,0,No user reviews,0,0,0
634717,True,0,No user reviews,0,0,0
634719,True,0,No user reviews,0,0,0
634720,True,0,No user reviews,0,0,0
634721,True,0,No user reviews,0,0,0
634730,True,0,No user reviews,0,0,0
634731,True,0,No user reviews,0,0,0
634732,True,0,No user reviews,0,0,0
634733,True,0,No user reviews,0,0,0
634734,True,0,No user reviews,0,0,0
634735,True,0,No user reviews,0,0,0
634736,True,0,No user reviews,0,0,0
634737,True,0,No user reviews,0,0,0
634738,True,0,No user reviews,0,0,0
634739,True,0,No user reviews,0,0,0
634740,True,0,No user reviews,0,0,0
634741,True,0,No user reviews,0,0,0
634750,True,0,No user reviews,0,0,0
634751,True,0,No user reviews,0,0,0
634752,True,0,No user reviews,0,0,0
634753,True,0,No user reviews,0,0,0
634754,True,0,No user reviews,0,0,0
634755,True,0,No user reviews,0,0,0
634756,True,0,No user reviews,0,0,0
634757,True,0,No user reviews,0,0,0
634758,True,0,No user reviews,0,0,0
634759,True,0,No user reviews,0,0,0
634760,True,0,No user reviews,0,0,0
634761,True,0,No user reviews,0,0,0
634762,True,0,No user reviews,0,0,0
634770,True,0,No user reviews,0,0,0
634771,True,0,No user reviews,0,0,0
634772,True,0,No user reviews,0,0,0
634773,True,0,No user reviews,0,0,0
634774,True,0,No user reviews,0,0,0
634775,True,0,No user reviews,0,0,0
634776,True,0,No user reviews,0,0,0
634777,True,0,No user reviews,0,0,0
634778,True,0,No user reviews,0,0,0
634779,True,0,No user reviews,0,0,0
634780,True,0,No user reviews,0,0,0
634781,True,0,No user reviews,0,0,0
634782,True,0,No user reviews,0,0,0
634790,True,0,No user reviews,0,0,0
634791,True,0,No user reviews,0,0,0
634792,True,0,No user reviews,0,0,0
634793,True,0,No user reviews,0,0,0
634794,True,0,No user reviews,0,0,0
634795,True,0,No user reviews,0,0,0
634796,True,0,No user reviews,0,0,0
634797,True,0,No user reviews,0,0,0
634798,True,0,No user reviews,0,0,0
634799,True,0,No user reviews,0,0,0
634810,True,0,No user reviews,0,0,0
634820,True,0,No user reviews,0,0,0
634830,True,0,No user reviews,0,0,0
634831,True,0,No user reviews,0,0,0
634832,True,0,No user reviews,0,0,0
634833,True,0,No user reviews,0,0,0
634834,True,0,No user reviews,0,0,0
634835,True,0,No user reviews,0,0,0
634836,True,0,No user reviews,0,0,0
634837,True,0,No user reviews,0,0,0
634838,True,0,No user reviews,0,0,0
634839,True,0,No user reviews,0,0,0
634840,True,0,No user reviews,0,0,0
634860,True,0,No user reviews,0,0,0
634861,True,0,No user reviews,0,0,0
634862,True,0,No user reviews,0,0,0
634863,True,0,No user reviews,0,0,0
634864,True,0,No user reviews,0,0,0
634865,True,0,No user reviews,0,0,0
634866,True,0,No user reviews,0,0,0
634867,True,0,No user reviews,0,0,0
634868,True,0,No user reviews,0,0,0
634869,True,0,No user reviews,0,0,0
634890,True,0,No user reviews,0,0,0
634891,True,0,No user reviews,0,0,0
634892,True,0,No user reviews,0,0,0
634893,True,0,No user reviews,0,0,0
634894,True,0,No user reviews,0,0,0
634895,True,0,No user reviews,0,0,0
634896,True,0,No user reviews,0,0,0
634897,True,0,No user reviews,0,0,0
634898,True,0,No user reviews,0,0,0
634899,True,0,No user reviews,0,0,0
635000,True,0,7 user reviews,4,3,7
635010,True,0,1 user reviews,1,0,1
635020,True,0,1 user reviews,1,0,1
635030,True,7,Positive,29,5,34
635040,True,0,6 user reviews,5,1,6
635050,True,6,Mostly Positive,8,3,11
635060,True,5,Mixed,13,11,24
635110,True,0,No user reviews,0,0,0
635120,True,0,No user reviews,0,0,0
635130,True,0,2 user reviews,0,2,2
635140,True,0,No user reviews,0,0,0
635150,True,0,No user reviews,0,0,0
635160,True,0,No user reviews,0,0,0
635170,True,0,2 user reviews,2,0,2
635180,True,0,No user reviews,0,0,0
635190,True,0,8 user reviews,4,4,8
635200,True,5,Mixed,184,104,288
635220,True,5,Mixed,9,6,15
635240,True,0,No user reviews,0,0,0
635241,True,0,No user reviews,0,0,0
635242,True,0,No user reviews,0,0,0
635243,True,0,No user reviews,0,0,0
635250,True,6,Mostly Positive,32,11,43
635260,True,8,Very Positive,2741,362,3103
635270,True,0,2 user reviews,1,1,2
635290,True,0,9 user reviews,6,3,9
635300,True,0,No user reviews,0,0,0
635310,True,8,Very Positive,60,14,74
635320,True,8,Very Positive,432,92,524
635330,True,5,Mixed,42,28,70
635370,True,0,No user reviews,0,0,0
635380,True,0,No user reviews,0,0,0
635390,True,8,Very Positive,49,12,61
635410,True,0,6 user reviews,3,3,6
635430,True,0,6 user reviews,4,2,6
635510,True,0,No user reviews,0,0,0
635520,True,0,4 user reviews,4,0,4
635530,True,0,No user reviews,0,0,0
635540,True,0,No user reviews,0,0,0
635570,True,0,No user reviews,0,0,0
635580,True,0,2 user reviews,1,1,2
635590,True,0,1 user reviews,1,0,1
635640,True,0,No user reviews,0,0,0
635670,True,6,Mostly Positive,58,21,79
635680,True,0,No user reviews,0,0,0
635681,True,0,No user reviews,0,0,0
635682,True,0,No user reviews,0,0,0
635683,True,0,No user reviews,0,0,0
635684,True,0,No user reviews,0,0,0
635685,True,0,No user reviews,0,0,0
635686,True,0,No user reviews,0,0,0
635687,True,0,No user reviews,0,0,0
635688,True,0,No user reviews,0,0,0
635689,True,0,No user reviews,0,0,0
635690,True,0,No user reviews,0,0,0
635691,True,0,No user reviews,0,0,0
635710,True,0,1 user reviews,0,1,1
635730,True,6,Mostly Positive,529,140,669
635740,True,0,No user reviews,0,0,0
635750,True,0,1 user reviews,1,0,1
635751,True,0,1 user reviews,1,0,1
635760,True,0,No user reviews,0,0,0
635761,True,0,No user reviews,0,0,0
635762,True,0,No user reviews,0,0,0
635770,True,0,No user reviews,0,0,0
635771,True,0,No user reviews,0,0,0
635772,True,0,No user reviews,0,0,0
635780,True,0,1 user reviews,1,0,1
635790,True,7,Positive,11,1,12
635800,True,7,Positive,15,0,15
635810,True,0,No user reviews,0,0,0
635820,True,0,No user reviews,0,0,0
635830,True,0,7 user reviews,3,4,7
635840,True,0,No user reviews,0,0,0
635850,True,7,Positive,41,3,44
635870,True,0,No user reviews,0,0,0
635880,True,7,Positive,21,5,26
635890,True,0,No user reviews,0,0,0
635900,True,6,Mostly Positive,12,5,17
635930,True,0,2 user reviews,2,0,2
635940,True,8,Very Positive,257,6,263
635980,True,0,3 user reviews,3,0,3
636010,True,0,3 user reviews,1,2,3
636020,True,0,1 user reviews,1,0,1
636030,True,0,6 user reviews,6,0,6
636040,True,0,No user reviews,0,0,0
636050,True,0,8 user reviews,8,0,8
636060,True,0,No user reviews,0,0,0
636070,True,7,Positive,14,2,16
636080,True,0,No user reviews,0,0,0
636100,True,8,Very Positive,321,25,346
636130,True,0,7 user reviews,5,2,7
636131,True,0,4 user reviews,4,0,4
636132,True,0,3 user reviews,2,1,3
636133,True,0,5 user reviews,3,2,5
636134,True,0,1 user reviews,1,0,1
636150,True,8,Very Positive,152,30,182
636170,True,6,Mostly Positive,38,14,52
636200,True,0,7 user reviews,5,2,7
636210,True,0,No user reviews,0,0,0
636220,True,0,7 user reviews,7,0,7
636230,True,4,Mostly Negative,2,8,10
636240,True,0,No user reviews,0,0,0
636270,True,0,No user reviews,0,0,0
636280,True,0,No user reviews,0,0,0
636300,True,0,No user reviews,0,0,0
636310,True,0,6 user reviews,4,2,6
636320,True,6,Mostly Positive,74,30,104
636330,True,0,3 user reviews,3,0,3
636360,True,0,1 user reviews,0,1,1
636370,True,0,4 user reviews,3,1,4
636380,True,0,No user reviews,0,0,0
636390,True,7,Positive,35,4,39
636400,True,6,Mostly Positive,23,9,32
636410,True,0,9 user reviews,9,0,9
636430,True,0,4 user reviews,2,2,4
636440,True,0,3 user reviews,3,0,3
636450,True,8,Very Positive,514,48,562
636460,True,6,Mostly Positive,29,9,38
636470,True,4,Mostly Negative,9,14,23
636480,True,9,Overwhelmingly Positive,15973,608,16581
636490,True,3,Negative,1,9,10
636500,True,0,7 user reviews,6,1,7
636501,True,7,Positive,10,0,10
636502,True,0,7 user reviews,6,1,7
636520,True,5,Mixed,20,21,41
636530,True,0,No user reviews,0,0,0
636560,True,0,No user reviews,0,0,0
636570,True,7,Positive,41,6,47
636580,True,0,No user reviews,0,0,0
636590,True,0,5 user reviews,2,3,5
636600,True,0,No user reviews,0,0,0
636610,True,0,No user reviews,0,0,0
636620,True,7,Positive,15,3,18
636630,True,5,Mixed,27,32,59
636650,True,0,No user reviews,0,0,0
636670,True,0,No user reviews,0,0,0
636690,True,5,Mixed,49,32,81
636700,True,0,No user reviews,0,0,0
636710,True,0,5 user reviews,5,0,5
636720,True,5,Mixed,16,7,23
636740,True,0,3 user reviews,2,1,3
636770,True,0,No user reviews,0,0,0
636780,True,0,No user reviews,0,0,0
636790,True,0,No user reviews,0,0,0
636820,True,0,No user reviews,0,0,0
636821,True,0,No user reviews,0,0,0
636822,True,0,No user reviews,0,0,0
636823,True,0,No user reviews,0,0,0
636824,True,0,No user reviews,0,0,0
636825,True,0,No user reviews,0,0,0
636826,True,0,No user reviews,0,0,0
636827,True,0,No user reviews,0,0,0
636828,True,0,No user reviews,0,0,0
636829,True,0,No user reviews,0,0,0
636830,True,0,No user reviews,0,0,0
636860,True,0,No user reviews,0,0,0
636861,True,0,No user reviews,0,0,0
636862,True,0,No user reviews,0,0,0
636863,True,0,No user reviews,0,0,0
636864,True,0,No user reviews,0,0,0
636880,True,0,1 user reviews,1,0,1
636890,True,0,No user reviews,0,0,0
636900,True,0,9 user reviews,9,0,9
636910,True,0,6 user reviews,6,0,6
636920,True,0,No user reviews,0,0,0
636930,True,0,No user reviews,0,0,0
636950,True,0,9 user reviews,8,1,9
636960,True,6,Mostly Positive,14,4,18
636970,True,8,Very Positive,256,60,316
637000,True,0,3 user reviews,2,1,3
637001,True,0,2 user reviews,1,1,2
637030,True,0,2 user reviews,2,0,2
637040,True,4,Mostly Negative,3,9,12
637050,True,0,No user reviews,0,0,0
637060,True,6,Mostly Positive,23,8,31
637070,True,0,4 user reviews,2,2,4
637090,True,8,Very Positive,8830,1919,10749
637100,True,5,Mixed,1257,755,2012
637110,True,0,1 user reviews,1,0,1
637120,True,0,4 user reviews,3,1,4
637130,True,0,2 user reviews,2,0,2
637150,True,0,No user reviews,0,0,0
637160,True,0,No user reviews,0,0,0
637161,True,0,No user reviews,0,0,0
637162,True,0,No user reviews,0,0,0
637163,True,0,No user reviews,0,0,0
637164,True,0,No user reviews,0,0,0
637165,True,0,No user reviews,0,0,0
637180,True,0,No user reviews,0,0,0
637181,True,0,No user reviews,0,0,0
637182,True,0,No user reviews,0,0,0
637183,True,0,No user reviews,0,0,0
637184,True,0,No user reviews,0,0,0
637185,True,0,No user reviews,0,0,0
637186,True,0,No user reviews,0,0,0
637190,True,0,No user reviews,0,0,0
637191,True,0,No user reviews,0,0,0
637192,True,0,No user reviews,0,0,0
637193,True,0,No user reviews,0,0,0
637194,True,0,No user reviews,0,0,0
637195,True,0,No user reviews,0,0,0
637196,True,0,No user reviews,0,0,0
637197,True,0,No user reviews,0,0,0
637198,True,0,No user reviews,0,0,0
637199,True,0,No user reviews,0,0,0
637200,True,0,No user reviews,0,0,0
637201,True,0,No user reviews,0,0,0
637202,True,0,No user reviews,0,0,0
637210,True,0,No user reviews,0,0,0
637211,True,0,No user reviews,0,0,0
637212,True,0,No user reviews,0,0,0
637213,True,0,No user reviews,0,0,0
637214,True,0,No user reviews,0,0,0
637215,True,0,No user reviews,0,0,0
637216,True,0,No user reviews,0,0,0
637217,True,0,No user reviews,0,0,0
637218,True,0,No user reviews,0,0,0
637219,True,0,No user reviews,0,0,0
637220,True,0,No user reviews,0,0,0
637221,True,0,No user reviews,0,0,0
637222,True,0,No user reviews,0,0,0
637230,True,0,No user reviews,0,0,0
637231,True,0,No user reviews,0,0,0
637232,True,0,No user reviews,0,0,0
637233,True,0,No user reviews,0,0,0
637234,True,0,No user reviews,0,0,0
637235,True,0,No user reviews,0,0,0
637236,True,0,No user reviews,0,0,0
637237,True,0,No user reviews,0,0,0
637238,True,0,No user reviews,0,0,0
637239,True,0,No user reviews,0,0,0
637240,True,0,No user reviews,0,0,0
637241,True,0,No user reviews,0,0,0
637242,True,0,No user reviews,0,0,0
637250,True,0,No user reviews,0,0,0
637251,True,0,No user reviews,0,0,0
637252,True,0,No user reviews,0,0,0
637253,True,0,No user reviews,0,0,0
637254,True,0,No user reviews,0,0,0
637255,True,0,No user reviews,0,0,0
637256,True,0,No user reviews,0,0,0
637257,True,0,No user reviews,0,0,0
637258,True,0,No user reviews,0,0,0
637259,True,0,No user reviews,0,0,0
637260,True,0,No user reviews,0,0,0
637261,True,0,No user reviews,0,0,0
637262,True,0,No user reviews,0,0,0
637270,True,0,No user reviews,0,0,0
637271,True,0,No user reviews,0,0,0
637272,True,0,No user reviews,0,0,0
637273,True,0,No user reviews,0,0,0
637274,True,0,No user reviews,0,0,0
637275,True,0,No user reviews,0,0,0
637276,True,0,No user reviews,0,0,0
637277,True,0,No user reviews,0,0,0
637278,True,0,No user reviews,0,0,0
637279,True,0,No user reviews,0,0,0
637280,True,0,No user reviews,0,0,0
637281,True,0,No user reviews,0,0,0
637282,True,0,No user reviews,0,0,0
637290,True,0,No user reviews,0,0,0
637291,True,0,No user reviews,0,0,0
637292,True,0,No user reviews,0,0,0
637293,True,0,No user reviews,0,0,0
637294,True,0,No user reviews,0,0,0
637295,True,0,No user reviews,0,0,0
637296,True,0,No user reviews,0,0,0
637297,True,0,No user reviews,0,0,0
637298,True,0,No user reviews,0,0,0
637299,True,0,No user reviews,0,0,0
637300,True,0,No user reviews,0,0,0
637301,True,0,No user reviews,0,0,0
637302,True,0,No user reviews,0,0,0
637303,True,0,No user reviews,0,0,0
637310,True,0,9 user reviews,6,3,9
637330,True,0,1 user reviews,1,0,1
637340,True,0,No user reviews,0,0,0
637350,True,0,No user reviews,0,0,0
637360,True,0,No user reviews,0,0,0
637361,True,0,No user reviews,0,0,0
637362,True,0,No user reviews,0,0,0
637370,True,0,3 user reviews,2,1,3
637380,True,0,3 user reviews,1,2,3
637390,True,0,No user reviews,0,0,0
637391,True,0,No user reviews,0,0,0
637392,True,0,No user reviews,0,0,0
637393,True,0,No user reviews,0,0,0
637394,True,0,No user reviews,0,0,0
637395,True,0,No user reviews,0,0,0
637396,True,0,No user reviews,0,0,0
637397,True,0,No user reviews,0,0,0
637398,True,0,No user reviews,0,0,0
637399,True,0,No user reviews,0,0,0
637400,True,0,No user reviews,0,0,0
637401,True,0,No user reviews,0,0,0
637402,True,0,No user reviews,0,0,0
637403,True,0,No user reviews,0,0,0
637410,True,5,Mixed,36,22,58
637420,True,0,No user reviews,0,0,0
637430,True,0,No user reviews,0,0,0
637440,True,0,No user reviews,0,0,0
637441,True,0,No user reviews,0,0,0
637442,True,0,No user reviews,0,0,0
637450,True,0,No user reviews,0,0,0
637460,True,0,No user reviews,0,0,0
637461,True,0,No user reviews,0,0,0
637462,True,0,No user reviews,0,0,0
637463,True,0,No user reviews,0,0,0
637464,True,0,No user reviews,0,0,0
637465,True,0,No user reviews,0,0,0
637466,True,0,No user reviews,0,0,0
637467,True,0,No user reviews,0,0,0
637468,True,0,No user reviews,0,0,0
637469,True,0,No user reviews,0,0,0
637470,True,0,No user reviews,0,0,0
637471,True,0,No user reviews,0,0,0
637472,True,0,No user reviews,0,0,0
637473,True,0,No user reviews,0,0,0
637474,True,0,No user reviews,0,0,0
637475,True,0,No user reviews,0,0,0
637476,True,0,No user reviews,0,0,0
637477,True,0,No user reviews,0,0,0
637478,True,0,No user reviews,0,0,0
637480,True,0,No user reviews,0,0,0
637481,True,0,No user reviews,0,0,0
637482,True,0,No user reviews,0,0,0
637483,True,0,No user reviews,0,0,0
637484,True,0,No user reviews,0,0,0
637485,True,0,No user reviews,0,0,0
637486,True,0,No user reviews,0,0,0
637487,True,0,No user reviews,0,0,0
637488,True,0,No user reviews,0,0,0
637489,True,0,No user reviews,0,0,0
637490,True,0,No user reviews,0,0,0
637491,True,0,No user reviews,0,0,0
637492,True,0,No user reviews,0,0,0
637493,True,0,No user reviews,0,0,0
637494,True,0,No user reviews,0,0,0
637495,True,0,No user reviews,0,0,0
637496,True,0,No user reviews,0,0,0
637497,True,0,No user reviews,0,0,0
637498,True,0,No user reviews,0,0,0
637499,True,0,No user reviews,0,0,0
637500,True,0,No user reviews,0,0,0
637501,True,0,No user reviews,0,0,0
637510,True,0,No user reviews,0,0,0
637511,True,0,No user reviews,0,0,0
637512,True,0,No user reviews,0,0,0
637513,True,0,No user reviews,0,0,0
637514,True,0,No user reviews,0,0,0
637515,True,0,No user reviews,0,0,0
637516,True,0,No user reviews,0,0,0
637517,True,0,No user reviews,0,0,0
637518,True,0,No user reviews,0,0,0
637519,True,0,No user reviews,0,0,0
637520,True,0,No user reviews,0,0,0
637521,True,0,No user reviews,0,0,0
637522,True,0,No user reviews,0,0,0
637523,True,0,No user reviews,0,0,0
637524,True,0,No user reviews,0,0,0
637530,True,0,No user reviews,0,0,0
637531,True,0,No user reviews,0,0,0
637532,True,0,No user reviews,0,0,0
637533,True,0,No user reviews,0,0,0
637534,True,0,No user reviews,0,0,0
637535,True,0,No user reviews,0,0,0
637536,True,0,No user reviews,0,0,0
637537,True,0,No user reviews,0,0,0
637538,True,0,No user reviews,0,0,0
637539,True,0,No user reviews,0,0,0
637540,True,0,No user reviews,0,0,0
637541,True,0,No user reviews,0,0,0
637542,True,0,No user reviews,0,0,0
637550,True,0,No user reviews,0,0,0
637551,True,0,No user reviews,0,0,0
637552,True,0,No user reviews,0,0,0
637553,True,0,No user reviews,0,0,0
637554,True,0,No user reviews,0,0,0
637555,True,0,No user reviews,0,0,0
637556,True,0,No user reviews,0,0,0
637557,True,0,No user reviews,0,0,0
637558,True,0,No user reviews,0,0,0
637559,True,0,No user reviews,0,0,0
637560,True,0,No user reviews,0,0,0
637561,True,0,No user reviews,0,0,0
637562,True,0,No user reviews,0,0,0
637570,True,0,No user reviews,0,0,0
637571,True,0,No user reviews,0,0,0
637572,True,0,No user reviews,0,0,0
637573,True,0,No user reviews,0,0,0
637574,True,0,No user reviews,0,0,0
637575,True,0,No user reviews,0,0,0
637576,True,0,No user reviews,0,0,0
637577,True,0,No user reviews,0,0,0
637578,True,0,No user reviews,0,0,0
637579,True,0,No user reviews,0,0,0
637590,True,0,No user reviews,0,0,0
637591,True,0,No user reviews,0,0,0
637592,True,0,No user reviews,0,0,0
637600,True,0,No user reviews,0,0,0
637601,True,0,No user reviews,0,0,0
637602,True,0,No user reviews,0,0,0
637603,True,0,No user reviews,0,0,0
637604,True,0,No user reviews,0,0,0
637605,True,0,No user reviews,0,0,0
637606,True,0,No user reviews,0,0,0
637607,True,0,No user reviews,0,0,0
637608,True,0,No user reviews,0,0,0
637609,True,0,No user reviews,0,0,0
637610,True,0,No user reviews,0,0,0
637611,True,0,No user reviews,0,0,0
637612,True,0,No user reviews,0,0,0
637620,True,0,No user reviews,0,0,0
637621,True,0,No user reviews,0,0,0
637622,True,0,No user reviews,0,0,0
637623,True,0,No user reviews,0,0,0
637624,True,0,No user reviews,0,0,0
637625,True,0,No user reviews,0,0,0
637626,True,0,No user reviews,0,0,0
637627,True,0,No user reviews,0,0,0
637628,True,0,No user reviews,0,0,0
637629,True,0,No user reviews,0,0,0
637630,True,0,No user reviews,0,0,0
637631,True,0,No user reviews,0,0,0
637632,True,0,No user reviews,0,0,0
637640,True,0,3 user reviews,1,2,3
637650,True,6,Mostly Positive,7337,1883,9220
637670,True,5,Mixed,676,290,966
637690,True,0,No user reviews,0,0,0
637691,True,0,No user reviews,0,0,0
637692,True,0,2 user reviews,2,0,2
637693,True,0,No user reviews,0,0,0
637694,True,0,No user reviews,0,0,0
637695,True,0,No user reviews,0,0,0
637696,True,0,No user reviews,0,0,0
637697,True,0,No user reviews,0,0,0
637698,True,0,No user reviews,0,0,0
637699,True,0,No user reviews,0,0,0
637700,True,0,No user reviews,0,0,0
637701,True,0,No user reviews,0,0,0
637702,True,0,No user reviews,0,0,0
637703,True,0,1 user reviews,1,0,1
637704,True,0,No user reviews,0,0,0
637705,True,0,No user reviews,0,0,0
637706,True,0,No user reviews,0,0,0
637707,True,0,No user reviews,0,0,0
637708,True,0,No user reviews,0,0,0
637709,True,0,No user reviews,0,0,0
637710,True,0,No user reviews,0,0,0
637711,True,0,No user reviews,0,0,0
637712,True,0,1 user reviews,1,0,1
637713,True,0,No user reviews,0,0,0
637714,True,0,No user reviews,0,0,0
637715,True,0,2 user reviews,1,1,2
637716,True,0,No user reviews,0,0,0
637717,True,0,No user reviews,0,0,0
637718,True,0,No user reviews,0,0,0
637719,True,0,No user reviews,0,0,0
637720,True,0,3 user reviews,1,2,3
637721,True,0,No user reviews,0,0,0
637722,True,0,No user reviews,0,0,0
637723,True,0,No user reviews,0,0,0
637724,True,0,No user reviews,0,0,0
637725,True,0,No user reviews,0,0,0
637726,True,0,No user reviews,0,0,0
637727,True,0,No user reviews,0,0,0
637728,True,0,No user reviews,0,0,0
637729,True,0,No user reviews,0,0,0
637730,True,0,No user reviews,0,0,0
637731,True,0,No user reviews,0,0,0
637732,True,0,No user reviews,0,0,0
637733,True,0,No user reviews,0,0,0
637734,True,0,No user reviews,0,0,0
637735,True,0,No user reviews,0,0,0
637736,True,0,No user reviews,0,0,0
637737,True,0,No user reviews,0,0,0
637738,True,0,No user reviews,0,0,0
637739,True,0,No user reviews,0,0,0
637740,True,0,No user reviews,0,0,0
637741,True,0,No user reviews,0,0,0
637742,True,0,No user reviews,0,0,0
637743,True,0,No user reviews,0,0,0
637744,True,0,No user reviews,0,0,0
637745,True,0,No user reviews,0,0,0
637746,True,0,No user reviews,0,0,0
637747,True,0,No user reviews,0,0,0
637748,True,0,No user reviews,0,0,0
637749,True,0,No user reviews,0,0,0
637750,True,0,No user reviews,0,0,0
637751,True,0,No user reviews,0,0,0
637752,True,0,No user reviews,0,0,0
637753,True,0,No user reviews,0,0,0
637754,True,0,No user reviews,0,0,0
637755,True,0,No user reviews,0,0,0
637756,True,0,No user reviews,0,0,0
637757,True,0,No user reviews,0,0,0
637758,True,0,No user reviews,0,0,0
637759,True,0,No user reviews,0,0,0
637760,True,0,No user reviews,0,0,0
637761,True,0,No user reviews,0,0,0
637762,True,0,3 user reviews,3,0,3
637763,True,0,No user reviews,0,0,0
637764,True,0,No user reviews,0,0,0
637765,True,0,No user reviews,0,0,0
637766,True,0,4 user reviews,3,1,4
637767,True,0,1 user reviews,1,0,1
637768,True,0,No user reviews,0,0,0
637769,True,0,No user reviews,0,0,0
637770,True,0,1 user reviews,1,0,1
637771,True,0,No user reviews,0,0,0
637772,True,0,2 user reviews,2,0,2
637773,True,0,No user reviews,0,0,0
637774,True,0,No user reviews,0,0,0
637775,True,0,1 user reviews,1,0,1
637776,True,0,No user reviews,0,0,0
637777,True,0,No user reviews,0,0,0
637778,True,0,No user reviews,0,0,0
637779,True,0,No user reviews,0,0,0
637780,True,0,No user reviews,0,0,0
637781,True,0,No user reviews,0,0,0
637782,True,0,No user reviews,0,0,0
637783,True,0,No user reviews,0,0,0
637784,True,0,No user reviews,0,0,0
637785,True,0,No user reviews,0,0,0
637786,True,0,No user reviews,0,0,0
637787,True,0,2 user reviews,2,0,2
637788,True,0,1 user reviews,1,0,1
637789,True,0,No user reviews,0,0,0
637790,True,0,No user reviews,0,0,0
637791,True,0,No user reviews,0,0,0
637792,True,0,No user reviews,0,0,0
637793,True,0,No user reviews,0,0,0
637794,True,0,No user reviews,0,0,0
637795,True,0,No user reviews,0,0,0
637796,True,0,No user reviews,0,0,0
637797,True,0,No user reviews,0,0,0
637798,True,0,No user reviews,0,0,0
637799,True,0,No user reviews,0,0,0
637800,True,0,No user reviews,0,0,0
637801,True,0,No user reviews,0,0,0
637802,True,0,No user reviews,0,0,0
637803,True,0,No user reviews,0,0,0
637804,True,0,No user reviews,0,0,0
637805,True,0,1 user reviews,1,0,1
637806,True,0,No user reviews,0,0,0
637807,True,0,No user reviews,0,0,0
637808,True,0,No user reviews,0,0,0
637809,True,0,No user reviews,0,0,0
637810,True,0,No user reviews,0,0,0
637811,True,0,No user reviews,0,0,0
637812,True,0,No user reviews,0,0,0
637813,True,0,No user reviews,0,0,0
637814,True,0,No user reviews,0,0,0
637815,True,0,No user reviews,0,0,0
637816,True,0,No user reviews,0,0,0
637817,True,0,No user reviews,0,0,0
637818,True,0,No user reviews,0,0,0
637819,True,0,No user reviews,0,0,0
637820,True,0,No user reviews,0,0,0
637821,True,0,No user reviews,0,0,0
637822,True,0,No user reviews,0,0,0
637823,True,0,No user reviews,0,0,0
637824,True,0,No user reviews,0,0,0
637825,True,0,1 user reviews,1,0,1
637826,True,0,1 user reviews,1,0,1
637827,True,0,1 user reviews,1,0,1
637828,True,0,No user reviews,0,0,0
637829,True,0,No user reviews,0,0,0
637830,True,0,1 user reviews,1,0,1
637831,True,0,No user reviews,0,0,0
637832,True,0,No user reviews,0,0,0
637833,True,0,No user reviews,0,0,0
637834,True,0,No user reviews,0,0,0
637835,True,0,No user reviews,0,0,0
637836,True,0,No user reviews,0,0,0
637837,True,0,No user reviews,0,0,0
637838,True,0,No user reviews,0,0,0
637839,True,0,1 user reviews,1,0,1
637840,True,0,No user reviews,0,0,0
637841,True,0,No user reviews,0,0,0
637842,True,0,No user reviews,0,0,0
637843,True,0,No user reviews,0,0,0
637844,True,0,3 user reviews,3,0,3
637845,True,0,No user reviews,0,0,0
637846,True,0,No user reviews,0,0,0
637847,True,0,No user reviews,0,0,0
637848,True,0,No user reviews,0,0,0
637849,True,0,No user reviews,0,0,0
637850,True,0,No user reviews,0,0,0
637860,True,0,4 user reviews,2,2,4
637870,True,0,3 user reviews,2,1,3
637880,True,8,Very Positive,56,4,60
637910,True,0,1 user reviews,1,0,1
637920,True,0,4 user reviews,1,3,4
637930,True,0,2 user reviews,2,0,2
637940,True,0,3 user reviews,2,1,3
637960,True,0,No user reviews,0,0,0
637980,True,0,No user reviews,0,0,0
638000,True,8,Very Positive,164,19,183
638010,True,0,3 user reviews,1,2,3
638011,True,0,3 user reviews,3,0,3
638020,True,0,6 user reviews,1,5,6
638040,True,0,No user reviews,0,0,0
638060,True,0,2 user reviews,1,1,2
638070,True,5,Mixed,86,45,131
638090,True,0,No user reviews,0,0,0
638100,True,0,No user reviews,0,0,0
638110,True,0,No user reviews,0,0,0
638120,True,0,2 user reviews,0,2,2
638160,True,5,Mixed,90,46,136
638180,True,6,Mostly Positive,27,11,38
638190,True,0,No user reviews,0,0,0
638200,True,8,Very Positive,108,11,119
638230,True,8,Very Positive,2297,194,2491
638240,True,0,3 user reviews,0,3,3
638250,True,0,No user reviews,0,0,0
638260,True,0,3 user reviews,2,1,3
638270,True,0,2 user reviews,2,0,2
638280,True,7,Positive,19,1,20
638290,True,0,No user reviews,0,0,0
638310,True,0,3 user reviews,2,1,3
638330,True,0,No user reviews,0,0,0
638360,True,0,1 user reviews,1,0,1
638370,True,0,No user reviews,0,0,0
638460,True,0,7 user reviews,7,0,7
638470,True,0,5 user reviews,4,1,5
638490,True,0,No user reviews,0,0,0
638500,True,0,No user reviews,0,0,0
638510,True,0,No user reviews,0,0,0
638530,True,0,No user reviews,0,0,0
638531,True,0,No user reviews,0,0,0
638532,True,0,No user reviews,0,0,0
638533,True,0,No user reviews,0,0,0
638534,True,0,No user reviews,0,0,0
638550,True,0,1 user reviews,1,0,1
638570,True,0,No user reviews,0,0,0
638571,True,0,No user reviews,0,0,0
638572,True,0,No user reviews,0,0,0
638573,True,0,No user reviews,0,0,0
638610,True,0,2 user reviews,2,0,2
638620,True,0,No user reviews,0,0,0
638630,True,0,4 user reviews,4,0,4
638650,True,8,Very Positive,323,66,389
638720,True,7,Positive,16,2,18
638740,True,0,2 user reviews,1,1,2
638760,True,0,No user reviews,0,0,0
638780,True,0,4 user reviews,4,0,4
638790,True,0,No user reviews,0,0,0
638800,True,0,No user reviews,0,0,0
638810,True,0,No user reviews,0,0,0
638830,True,0,5 user reviews,4,1,5
638850,True,6,Mostly Positive,294,81,375
638860,True,0,No user reviews,0,0,0
638890,True,0,1 user reviews,0,1,1
638891,True,0,No user reviews,0,0,0
638900,True,0,No user reviews,0,0,0
638920,True,0,No user reviews,0,0,0
638930,True,7,Positive,38,6,44
638950,True,0,No user reviews,0,0,0
638970,True,9,Overwhelmingly Positive,11442,546,11988
638980,True,0,3 user reviews,3,0,3
638981,True,0,3 user reviews,3,0,3
638990,True,0,No user reviews,0,0,0
639000,True,0,No user reviews,0,0,0
639001,True,0,2 user reviews,2,0,2
639030,True,0,No user reviews,0,0,0
639050,True,0,No user reviews,0,0,0
639070,True,0,No user reviews,0,0,0
639080,True,0,1 user reviews,1,0,1
639090,True,0,No user reviews,0,0,0
639091,True,0,No user reviews,0,0,0
639092,True,0,No user reviews,0,0,0
639093,True,0,No user reviews,0,0,0
639094,True,0,No user reviews,0,0,0
639095,True,0,No user reviews,0,0,0
639096,True,0,No user reviews,0,0,0
639097,True,0,No user reviews,0,0,0
639098,True,0,No user reviews,0,0,0
639099,True,0,No user reviews,0,0,0
639100,True,0,No user reviews,0,0,0
639101,True,0,No user reviews,0,0,0
639102,True,0,No user reviews,0,0,0
639110,True,0,No user reviews,0,0,0
639111,True,0,No user reviews,0,0,0
639112,True,0,No user reviews,0,0,0
639113,True,0,No user reviews,0,0,0
639114,True,0,No user reviews,0,0,0
639115,True,0,No user reviews,0,0,0
639116,True,0,No user reviews,0,0,0
639117,True,0,No user reviews,0,0,0
639118,True,0,No user reviews,0,0,0
639119,True,0,No user reviews,0,0,0
639120,True,0,No user reviews,0,0,0
639121,True,0,No user reviews,0,0,0
639122,True,0,No user reviews,0,0,0
639123,True,0,No user reviews,0,0,0
639124,True,0,No user reviews,0,0,0
639125,True,0,No user reviews,0,0,0
639126,True,0,No user reviews,0,0,0
639127,True,0,No user reviews,0,0,0
639128,True,0,No user reviews,0,0,0
639129,True,0,No user reviews,0,0,0
639130,True,8,Very Positive,236,26,262
639150,True,0,4 user reviews,3,1,4
639170,True,8,Very Positive,472,50,522
639180,True,0,No user reviews,0,0,0
639190,True,0,No user reviews,0,0,0
639200,True,0,No user reviews,0,0,0
639210,True,0,No user reviews,0,0,0
639220,True,6,Mostly Positive,15,6,21
639230,True,0,No user reviews,0,0,0
639240,True,0,1 user reviews,0,1,1
639250,True,0,No user reviews,0,0,0
639260,True,0,No user reviews,0,0,0
639261,True,0,No user reviews,0,0,0
639262,True,0,No user reviews,0,0,0
639263,True,0,No user reviews,0,0,0
639264,True,0,No user reviews,0,0,0
639265,True,0,No user reviews,0,0,0
639266,True,0,No user reviews,0,0,0
639270,True,8,Very Positive,156,6,162
639280,True,0,8 user reviews,6,2,8
639300,True,6,Mostly Positive,41,16,57
639310,True,5,Mixed,34,21,55
639320,True,0,1 user reviews,1,0,1
639330,True,0,No user reviews,0,0,0
639331,True,0,No user reviews,0,0,0
639332,True,0,No user reviews,0,0,0
639333,True,0,No user reviews,0,0,0
639334,True,0,No user reviews,0,0,0
639335,True,0,No user reviews,0,0,0
639336,True,0,No user reviews,0,0,0
639337,True,0,No user reviews,0,0,0
639338,True,0,No user reviews,0,0,0
639339,True,0,No user reviews,0,0,0
639340,True,0,No user reviews,0,0,0
639341,True,0,No user reviews,0,0,0
639342,True,0,No user reviews,0,0,0
639350,True,0,No user reviews,0,0,0
639351,True,0,No user reviews,0,0,0
639352,True,0,No user reviews,0,0,0
639353,True,0,No user reviews,0,0,0
639354,True,0,No user reviews,0,0,0
639355,True,0,No user reviews,0,0,0
639356,True,0,No user reviews,0,0,0
639357,True,0,No user reviews,0,0,0
639358,True,0,No user reviews,0,0,0
639359,True,0,No user reviews,0,0,0
639360,True,0,No user reviews,0,0,0
639361,True,0,No user reviews,0,0,0
639362,True,0,No user reviews,0,0,0
639370,True,0,3 user reviews,3,0,3
639390,True,0,No user reviews,0,0,0
639391,True,0,No user reviews,0,0,0
639392,True,0,No user reviews,0,0,0
639393,True,0,No user reviews,0,0,0
639394,True,0,No user reviews,0,0,0
639395,True,0,No user reviews,0,0,0
639396,True,0,No user reviews,0,0,0
639397,True,0,No user reviews,0,0,0
639398,True,0,No user reviews,0,0,0
639399,True,0,No user reviews,0,0,0
639400,True,0,No user reviews,0,0,0
639401,True,0,No user reviews,0,0,0
639402,True,0,No user reviews,0,0,0
639410,True,0,No user reviews,0,0,0
639411,True,0,No user reviews,0,0,0
639412,True,0,No user reviews,0,0,0
639413,True,0,No user reviews,0,0,0
639414,True,0,No user reviews,0,0,0
639415,True,0,No user reviews,0,0,0
639416,True,0,No user reviews,0,0,0
639417,True,0,No user reviews,0,0,0
639418,True,0,No user reviews,0,0,0
639419,True,0,No user reviews,0,0,0
639420,True,0,No user reviews,0,0,0
639421,True,0,No user reviews,0,0,0
639430,True,7,Positive,11,0,11
639431,True,7,Positive,13,3,16
639432,True,0,4 user reviews,4,0,4
639433,True,0,1 user reviews,0,1,1
639434,True,7,Positive,11,0,11
639435,True,0,8 user reviews,8,0,8
639436,True,0,No user reviews,0,0,0
639437,True,0,1 user reviews,1,0,1
639438,True,7,Positive,10,1,11
639440,True,0,No user reviews,0,0,0
639460,True,6,Mostly Positive,47,16,63
639470,True,0,7 user reviews,6,1,7
639490,True,8,Very Positive,164,1,165
639510,True,0,No user reviews,0,0,0
639520,True,0,No user reviews,0,0,0
639521,True,0,No user reviews,0,0,0
639522,True,0,No user reviews,0,0,0
639523,True,0,1 user reviews,1,0,1
639524,True,0,No user reviews,0,0,0
639525,True,0,No user reviews,0,0,0
639530,True,0,No user reviews,0,0,0
639531,True,0,2 user reviews,1,1,2
639532,True,0,3 user reviews,2,1,3
639540,True,0,9 user reviews,7,2,9
639550,True,0,No user reviews,0,0,0
639560,True,6,Mostly Positive,28,8,36
639570,True,0,4 user reviews,4,0,4
639580,True,0,No user reviews,0,0,0
639600,True,8,Very Positive,276,26,302
639620,True,0,No user reviews,0,0,0
639650,True,0,No user reviews,0,0,0
639660,True,0,No user reviews,0,0,0
639680,True,7,Positive,10,0,10
639690,True,0,2 user reviews,2,0,2
639700,True,0,1 user reviews,1,0,1
639701,True,0,1 user reviews,1,0,1
639720,True,7,Positive,22,4,26
639730,True,0,6 user reviews,4,2,6
639760,True,0,No user reviews,0,0,0
639770,True,7,Positive,29,0,29
639780,True,9,Overwhelmingly Positive,930,48,978
639790,True,9,Overwhelmingly Positive,3542,142,3684
639810,True,0,No user reviews,0,0,0
639830,True,0,No user reviews,0,0,0
639840,True,0,6 user reviews,2,4,6
639850,True,0,No user reviews,0,0,0
639860,True,0,No user reviews,0,0,0
639870,True,0,No user reviews,0,0,0
639880,True,0,No user reviews,0,0,0
639890,True,0,1 user reviews,1,0,1
639891,True,0,No user reviews,0,0,0
639900,True,0,No user reviews,0,0,0
639920,True,0,2 user reviews,1,1,2
639940,True,0,No user reviews,0,0,0
639950,True,0,No user reviews,0,0,0
639960,True,0,No user reviews,0,0,0
640010,True,0,No user reviews,0,0,0
640020,True,0,No user reviews,0,0,0
640040,True,0,2 user reviews,2,0,2
640050,True,3,Negative,1,11,12
640070,True,0,7 user reviews,5,2,7
640080,True,0,No user reviews,0,0,0
640090,True,7,Positive,8,2,10
640120,True,8,Very Positive,68,1,69
640140,True,5,Mixed,84,40,124
640150,True,0,No user reviews,0,0,0
640190,True,0,No user reviews,0,0,0
640200,True,0,2 user reviews,1,1,2
640210,True,5,Mixed,23,18,41
640220,True,0,No user reviews,0,0,0
640221,True,0,No user reviews,0,0,0
640222,True,0,No user reviews,0,0,0
640230,True,0,No user reviews,0,0,0
640250,True,0,2 user reviews,2,0,2
640290,True,0,3 user reviews,3,0,3
640300,True,6,Mostly Positive,23,6,29
640310,True,4,Mostly Negative,22,36,58
640340,True,7,Positive,30,5,35
640380,True,8,Very Positive,118,5,123
640390,True,0,No user reviews,0,0,0
640400,True,0,No user reviews,0,0,0
640401,True,0,No user reviews,0,0,0
640410,True,0,No user reviews,0,0,0
640440,True,0,No user reviews,0,0,0
640450,True,0,No user reviews,0,0,0
640460,True,0,No user reviews,0,0,0
640490,True,0,No user reviews,0,0,0
640500,True,0,No user reviews,0,0,0
640510,True,0,No user reviews,0,0,0
640520,True,0,No user reviews,0,0,0
640530,True,0,No user reviews,0,0,0
640540,True,0,No user reviews,0,0,0
640550,True,0,No user reviews,0,0,0
640560,True,0,No user reviews,0,0,0
640570,True,0,No user reviews,0,0,0
640580,True,0,No user reviews,0,0,0
640590,True,8,Very Positive,131,23,154
640600,True,0,2 user reviews,0,2,2
640640,True,0,No user reviews,0,0,0
640641,True,0,No user reviews,0,0,0
640642,True,0,No user reviews,0,0,0
640643,True,0,No user reviews,0,0,0
640644,True,0,No user reviews,0,0,0
640645,True,0,No user reviews,0,0,0
640646,True,0,No user reviews,0,0,0
640647,True,0,No user reviews,0,0,0
640648,True,0,No user reviews,0,0,0
640649,True,0,No user reviews,0,0,0
640650,True,0,No user reviews,0,0,0
640651,True,0,No user reviews,0,0,0
640652,True,0,No user reviews,0,0,0
640653,True,0,No user reviews,0,0,0
640654,True,0,No user reviews,0,0,0
640655,True,0,No user reviews,0,0,0
640656,True,0,No user reviews,0,0,0
640657,True,0,No user reviews,0,0,0
640658,True,0,No user reviews,0,0,0
640659,True,0,No user reviews,0,0,0
640660,True,0,No user reviews,0,0,0
640661,True,0,No user reviews,0,0,0
640662,True,0,No user reviews,0,0,0
640663,True,0,No user reviews,0,0,0
640664,True,0,No user reviews,0,0,0
640670,True,0,2 user reviews,2,0,2
640680,True,0,No user reviews,0,0,0
640690,True,0,9 user reviews,6,3,9
640700,True,0,3 user reviews,3,0,3
640720,True,0,3 user reviews,1,2,3
640730,True,0,No user reviews,0,0,0
640740,True,0,4 user reviews,4,0,4
640741,True,0,No user reviews,0,0,0
640742,True,0,No user reviews,0,0,0
640743,True,0,No user reviews,0,0,0
640744,True,0,No user reviews,0,0,0
640745,True,0,No user reviews,0,0,0
640746,True,0,1 user reviews,1,0,1
640747,True,0,No user reviews,0,0,0
640748,True,0,No user reviews,0,0,0
640749,True,0,No user reviews,0,0,0
640750,True,0,No user reviews,0,0,0
640751,True,0,No user reviews,0,0,0
640752,True,0,No user reviews,0,0,0
640760,True,5,Mixed,9,6,15
640770,True,0,No user reviews,0,0,0
640780,True,0,No user reviews,0,0,0
640800,True,6,Mostly Positive,58,24,82
640820,True,6,Mostly Positive,7475,2226,9701
640840,True,0,No user reviews,0,0,0
640850,True,5,Mixed,40,28,68
640860,True,5,Mixed,27,13,40
640880,True,0,9 user reviews,8,1,9
640890,True,7,Positive,13,2,15
640900,True,7,Positive,16,1,17
640910,True,0,2 user reviews,2,0,2
640920,True,8,Very Positive,74,10,84
640940,True,0,No user reviews,0,0,0
640970,True,6,Mostly Positive,33,10,43
640990,True,8,Very Positive,128,21,149
641000,True,7,Positive,41,3,44
641010,True,0,No user reviews,0,0,0
641020,True,0,2 user reviews,2,0,2
641030,True,0,No user reviews,0,0,0
641050,True,0,1 user reviews,1,0,1
641080,True,5,Mixed,502,250,752
641280,True,0,No user reviews,0,0,0
641310,True,0,No user reviews,0,0,0
641320,True,8,Very Positive,2417,515,2932
641340,True,0,No user reviews,0,0,0
641350,True,0,No user reviews,0,0,0
641360,True,0,1 user reviews,1,0,1
641370,True,0,No user reviews,0,0,0
641380,True,0,7 user reviews,4,3,7
641382,True,0,2 user reviews,2,0,2
641383,True,0,No user reviews,0,0,0
641384,True,0,4 user reviews,3,1,4
641385,True,0,No user reviews,0,0,0
641390,True,7,Positive,18,0,18
641391,True,0,No user reviews,0,0,0
641392,True,0,No user reviews,0,0,0
641393,True,0,1 user reviews,1,0,1
641394,True,0,No user reviews,0,0,0
641395,True,0,No user reviews,0,0,0
641396,True,0,2 user reviews,1,1,2
641397,True,0,1 user reviews,1,0,1
641398,True,0,No user reviews,0,0,0
641399,True,0,1 user reviews,1,0,1
641400,True,0,No user reviews,0,0,0
641401,True,0,No user reviews,0,0,0
641402,True,0,No user reviews,0,0,0
641430,True,0,No user reviews,0,0,0
641440,True,0,No user reviews,0,0,0
641450,True,0,1 user reviews,1,0,1
641460,True,0,No user reviews,0,0,0
641470,True,0,No user reviews,0,0,0
641480,True,0,1 user reviews,1,0,1
641490,True,0,No user reviews,0,0,0
641491,True,0,No user reviews,0,0,0
641492,True,0,No user reviews,0,0,0
641493,True,0,No user reviews,0,0,0
641500,True,0,No user reviews,0,0,0
641501,True,0,No user reviews,0,0,0
641502,True,0,No user reviews,0,0,0
641503,True,0,No user reviews,0,0,0
641504,True,0,No user reviews,0,0,0
641505,True,0,No user reviews,0,0,0
641506,True,0,No user reviews,0,0,0
641507,True,0,No user reviews,0,0,0
641508,True,0,No user reviews,0,0,0
641509,True,0,No user reviews,0,0,0
641510,True,0,No user reviews,0,0,0
641520,True,0,1 user reviews,1,0,1
641540,True,0,No user reviews,0,0,0
641550,True,0,No user reviews,0,0,0
641560,True,0,No user reviews,0,0,0
641580,True,0,No user reviews,0,0,0
641590,True,0,3 user reviews,2,1,3
641670,True,0,No user reviews,0,0,0
641680,True,0,No user reviews,0,0,0
641690,True,0,No user reviews,0,0,0
641700,True,0,No user reviews,0,0,0
641710,True,0,No user reviews,0,0,0
641740,True,0,No user reviews,0,0,0
641750,True,0,No user reviews,0,0,0
641751,True,0,No user reviews,0,0,0
641752,True,0,1 user reviews,1,0,1
641753,True,0,No user reviews,0,0,0
641754,True,0,No user reviews,0,0,0
641755,True,0,No user reviews,0,0,0
641756,True,0,No user reviews,0,0,0
641757,True,0,No user reviews,0,0,0
641758,True,0,No user reviews,0,0,0
641759,True,0,No user reviews,0,0,0
641760,True,0,No user reviews,0,0,0
641761,True,0,No user reviews,0,0,0
641780,True,8,Very Positive,618,64,682
641790,True,0,No user reviews,0,0,0
641791,True,0,No user reviews,0,0,0
641792,True,0,No user reviews,0,0,0
641793,True,0,No user reviews,0,0,0
641794,True,0,No user reviews,0,0,0
641795,True,0,No user reviews,0,0,0
641800,True,0,No user reviews,0,0,0
641801,True,0,No user reviews,0,0,0
641810,True,0,No user reviews,0,0,0
641811,True,0,No user reviews,0,0,0
641812,True,0,No user reviews,0,0,0
641813,True,0,No user reviews,0,0,0
641814,True,0,No user reviews,0,0,0
641815,True,0,No user reviews,0,0,0
641816,True,0,No user reviews,0,0,0
641817,True,0,No user reviews,0,0,0
641820,True,0,No user reviews,0,0,0
641821,True,0,No user reviews,0,0,0
641822,True,0,No user reviews,0,0,0
641823,True,0,No user reviews,0,0,0
641824,True,0,No user reviews,0,0,0
641825,True,0,No user reviews,0,0,0
641826,True,0,No user reviews,0,0,0
641827,True,0,No user reviews,0,0,0
641828,True,0,No user reviews,0,0,0
641829,True,0,No user reviews,0,0,0
641830,True,0,No user reviews,0,0,0
641831,True,0,No user reviews,0,0,0
641832,True,0,No user reviews,0,0,0
641833,True,0,No user reviews,0,0,0
641834,True,0,No user reviews,0,0,0
641835,True,0,No user reviews,0,0,0
641836,True,0,No user reviews,0,0,0
641837,True,0,No user reviews,0,0,0
641838,True,0,No user reviews,0,0,0
641839,True,0,No user reviews,0,0,0
641860,True,0,No user reviews,0,0,0
641870,True,0,No user reviews,0,0,0
641880,True,0,No user reviews,0,0,0
641910,True,4,Mostly Negative,7,11,18
641940,True,0,No user reviews,0,0,0
641950,True,5,Mixed,9,5,14
641960,True,8,Very Positive,568,141,709
641970,True,0,3 user reviews,2,1,3
641980,True,7,Positive,22,5,27
641990,True,8,Very Positive,4162,540,4702
642000,True,0,No user reviews,0,0,0
642050,True,0,No user reviews,0,0,0
642051,True,0,No user reviews,0,0,0
642052,True,0,No user reviews,0,0,0
642053,True,0,No user reviews,0,0,0
642054,True,0,No user reviews,0,0,0
642055,True,0,No user reviews,0,0,0
642056,True,0,No user reviews,0,0,0
642057,True,0,No user reviews,0,0,0
642060,True,0,No user reviews,0,0,0
642061,True,0,No user reviews,0,0,0
642062,True,0,No user reviews,0,0,0
642063,True,0,No user reviews,0,0,0
642064,True,0,No user reviews,0,0,0
642065,True,0,No user reviews,0,0,0
642066,True,0,No user reviews,0,0,0
642067,True,0,No user reviews,0,0,0
642070,True,5,Mixed,7,6,13
642080,True,8,Very Positive,164,8,172
642090,True,8,Very Positive,428,20,448
642100,True,0,No user reviews,0,0,0
642101,True,0,No user reviews,0,0,0
642102,True,0,No user reviews,0,0,0
642103,True,0,No user reviews,0,0,0
642104,True,0,No user reviews,0,0,0
642105,True,0,No user reviews,0,0,0
642106,True,0,No user reviews,0,0,0
642107,True,0,No user reviews,0,0,0
642108,True,0,No user reviews,0,0,0
642109,True,0,No user reviews,0,0,0
642110,True,0,No user reviews,0,0,0
642111,True,0,No user reviews,0,0,0
642120,True,0,1 user reviews,1,0,1
642121,True,0,No user reviews,0,0,0
642122,True,0,No user reviews,0,0,0
642123,True,0,No user reviews,0,0,0
642124,True,0,No user reviews,0,0,0
642125,True,0,No user reviews,0,0,0
642126,True,0,No user reviews,0,0,0
642127,True,0,No user reviews,0,0,0
642128,True,0,No user reviews,0,0,0
642129,True,0,No user reviews,0,0,0
642130,True,0,No user reviews,0,0,0
642131,True,0,No user reviews,0,0,0
642140,True,0,No user reviews,0,0,0
642141,True,0,No user reviews,0,0,0
642142,True,0,No user reviews,0,0,0
642143,True,0,No user reviews,0,0,0
642144,True,0,No user reviews,0,0,0
642145,True,0,No user reviews,0,0,0
642146,True,0,No user reviews,0,0,0
642147,True,0,No user reviews,0,0,0
642148,True,0,No user reviews,0,0,0
642149,True,0,No user reviews,0,0,0
642150,True,0,No user reviews,0,0,0
642151,True,0,No user reviews,0,0,0
642160,True,0,No user reviews,0,0,0
642170,True,5,Mixed,14,8,22
642180,True,0,No user reviews,0,0,0
642190,True,5,Mixed,6,9,15
642200,True,7,Positive,10,0,10
642201,True,0,No user reviews,0,0,0
642210,True,0,No user reviews,0,0,0
642220,True,0,No user reviews,0,0,0
642221,True,0,No user reviews,0,0,0
642222,True,0,No user reviews,0,0,0
642223,True,0,No user reviews,0,0,0
642224,True,0,No user reviews,0,0,0
642225,True,0,No user reviews,0,0,0
642226,True,0,No user reviews,0,0,0
642227,True,0,No user reviews,0,0,0
642228,True,0,No user reviews,0,0,0
642229,True,0,No user reviews,0,0,0
642230,True,0,No user reviews,0,0,0
642231,True,0,No user reviews,0,0,0
642232,True,0,No user reviews,0,0,0
642233,True,0,No user reviews,0,0,0
642234,True,0,No user reviews,0,0,0
642240,True,7,Positive,12,0,12
642250,True,0,No user reviews,0,0,0
642260,True,0,No user reviews,0,0,0
642270,True,0,No user reviews,0,0,0
642280,True,8,Very Positive,595,56,651
642290,True,0,No user reviews,0,0,0
642291,True,0,No user reviews,0,0,0
642292,True,0,No user reviews,0,0,0
642293,True,0,No user reviews,0,0,0
642294,True,0,No user reviews,0,0,0
642295,True,0,No user reviews,0,0,0
642296,True,0,No user reviews,0,0,0
642297,True,0,No user reviews,0,0,0
642300,True,0,No user reviews,0,0,0
642301,True,0,No user reviews,0,0,0
642302,True,0,No user reviews,0,0,0
642303,True,0,No user reviews,0,0,0
642304,True,0,No user reviews,0,0,0
642305,True,0,No user reviews,0,0,0
642306,True,0,No user reviews,0,0,0
642307,True,0,No user reviews,0,0,0
642308,True,0,No user reviews,0,0,0
642309,True,0,No user reviews,0,0,0
642310,True,0,No user reviews,0,0,0
642311,True,0,No user reviews,0,0,0
642312,True,0,No user reviews,0,0,0
642313,True,0,No user reviews,0,0,0
642314,True,0,No user reviews,0,0,0
642315,True,0,No user reviews,0,0,0
642316,True,0,No user reviews,0,0,0
642317,True,0,No user reviews,0,0,0
642318,True,0,No user reviews,0,0,0
642319,True,0,No user reviews,0,0,0
642320,True,0,No user reviews,0,0,0
642321,True,0,No user reviews,0,0,0
642330,True,0,No user reviews,0,0,0
642331,True,0,No user reviews,0,0,0
642332,True,0,No user reviews,0,0,0
642333,True,0,No user reviews,0,0,0
642334,True,0,No user reviews,0,0,0
642335,True,0,No user reviews,0,0,0
642336,True,0,No user reviews,0,0,0
642337,True,0,No user reviews,0,0,0
642338,True,0,No user reviews,0,0,0
642339,True,0,No user reviews,0,0,0
642340,True,0,No user reviews,0,0,0
642341,True,0,No user reviews,0,0,0
642342,True,0,No user reviews,0,0,0
642343,True,0,No user reviews,0,0,0
642344,True,0,No user reviews,0,0,0
642345,True,0,No user reviews,0,0,0
642346,True,0,No user reviews,0,0,0
642347,True,0,No user reviews,0,0,0
642348,True,0,No user reviews,0,0,0
642349,True,0,No user reviews,0,0,0
642350,True,0,No user reviews,0,0,0
642351,True,0,No user reviews,0,0,0
642360,True,0,No user reviews,0,0,0
642361,True,0,No user reviews,0,0,0
642362,True,0,No user reviews,0,0,0
642363,True,0,No user reviews,0,0,0
642364,True,0,No user reviews,0,0,0
642365,True,0,No user reviews,0,0,0
642366,True,0,No user reviews,0,0,0
642367,True,0,No user reviews,0,0,0
642368,True,0,No user reviews,0,0,0
642369,True,0,No user reviews,0,0,0
642370,True,0,No user reviews,0,0,0
642371,True,0,No user reviews,0,0,0
642372,True,0,No user reviews,0,0,0
642373,True,0,No user reviews,0,0,0
642374,True,0,No user reviews,0,0,0
642375,True,0,No user reviews,0,0,0
642376,True,0,No user reviews,0,0,0
642377,True,0,No user reviews,0,0,0
642378,True,0,No user reviews,0,0,0
642379,True,0,No user reviews,0,0,0
642380,True,0,No user reviews,0,0,0
642381,True,0,No user reviews,0,0,0
642400,True,0,No user reviews,0,0,0
642401,True,0,No user reviews,0,0,0
642402,True,0,No user reviews,0,0,0
642403,True,0,No user reviews,0,0,0
642404,True,0,No user reviews,0,0,0
642405,True,0,No user reviews,0,0,0
642406,True,0,No user reviews,0,0,0
642407,True,0,No user reviews,0,0,0
642408,True,0,No user reviews,0,0,0
642409,True,0,No user reviews,0,0,0
642410,True,0,No user reviews,0,0,0
642411,True,0,No user reviews,0,0,0
642412,True,0,No user reviews,0,0,0
642413,True,0,No user reviews,0,0,0
642414,True,0,No user reviews,0,0,0
642415,True,0,No user reviews,0,0,0
642416,True,0,No user reviews,0,0,0
642417,True,0,No user reviews,0,0,0
642418,True,0,No user reviews,0,0,0
642419,True,0,No user reviews,0,0,0
642420,True,0,No user reviews,0,0,0
642421,True,0,No user reviews,0,0,0
642430,True,0,No user reviews,0,0,0
642431,True,0,No user reviews,0,0,0
642432,True,0,No user reviews,0,0,0
642433,True,0,No user reviews,0,0,0
642434,True,0,No user reviews,0,0,0
642435,True,0,No user reviews,0,0,0
642436,True,0,No user reviews,0,0,0
642437,True,0,No user reviews,0,0,0
642438,True,0,No user reviews,0,0,0
642439,True,0,No user reviews,0,0,0
642440,True,0,No user reviews,0,0,0
642441,True,0,No user reviews,0,0,0
642442,True,0,No user reviews,0,0,0
642443,True,0,No user reviews,0,0,0
642444,True,0,No user reviews,0,0,0
642445,True,0,No user reviews,0,0,0
642446,True,0,No user reviews,0,0,0
642447,True,0,No user reviews,0,0,0
642448,True,0,No user reviews,0,0,0
642449,True,0,No user reviews,0,0,0
642450,True,0,No user reviews,0,0,0
642451,True,0,No user reviews,0,0,0
642460,True,0,No user reviews,0,0,0
642461,True,0,1 user reviews,0,1,1
642462,True,0,No user reviews,0,0,0
642463,True,0,No user reviews,0,0,0
642464,True,0,No user reviews,0,0,0
642465,True,0,No user reviews,0,0,0
642466,True,0,No user reviews,0,0,0
642467,True,0,No user reviews,0,0,0
642468,True,0,No user reviews,0,0,0
642469,True,0,No user reviews,0,0,0
642470,True,0,No user reviews,0,0,0
642471,True,0,No user reviews,0,0,0
642472,True,0,No user reviews,0,0,0
642473,True,0,No user reviews,0,0,0
642474,True,0,No user reviews,0,0,0
642475,True,0,No user reviews,0,0,0
642476,True,0,No user reviews,0,0,0
642477,True,0,No user reviews,0,0,0
642478,True,0,No user reviews,0,0,0
642479,True,0,No user reviews,0,0,0
642480,True,0,No user reviews,0,0,0
642481,True,0,No user reviews,0,0,0
642500,True,0,No user reviews,0,0,0
642510,True,0,4 user reviews,2,2,4
642520,True,0,7 user reviews,2,5,7
642540,True,0,No user reviews,0,0,0
642550,True,0,No user reviews,0,0,0
642551,True,0,No user reviews,0,0,0
642552,True,0,No user reviews,0,0,0
642553,True,0,No user reviews,0,0,0
642554,True,0,No user reviews,0,0,0
642555,True,0,No user reviews,0,0,0
642560,True,8,Very Positive,173,9,182
642570,True,0,1 user reviews,0,1,1
642580,True,7,Positive,22,4,26
642590,True,0,No user reviews,0,0,0
642600,True,7,Positive,10,0,10
642610,True,8,Very Positive,49,7,56
642630,True,0,3 user reviews,3,0,3
642640,True,0,No user reviews,0,0,0
642650,True,8,Very Positive,52,2,54
642660,True,0,1 user reviews,0,1,1
642670,True,0,No user reviews,0,0,0
642690,True,0,No user reviews,0,0,0
642700,True,0,9 user reviews,3,6,9
642710,True,0,No user reviews,0,0,0
642720,True,0,1 user reviews,1,0,1
642730,True,7,Positive,21,3,24
642750,True,6,Mostly Positive,278,96,374
642770,True,8,Very Positive,71,4,75
642780,True,0,4 user reviews,3,1,4
642790,True,0,No user reviews,0,0,0
642800,True,0,2 user reviews,1,1,2
642802,True,0,5 user reviews,2,3,5
642803,True,0,8 user reviews,6,2,8
642804,True,7,Positive,25,2,27
642805,True,0,2 user reviews,2,0,2
642806,True,5,Mixed,9,4,13
642807,True,5,Mixed,9,11,20
642810,True,0,No user reviews,0,0,0
642830,True,5,Mixed,7,7,14
642840,True,0,No user reviews,0,0,0
642860,True,0,No user reviews,0,0,0
642890,True,0,No user reviews,0,0,0
642920,True,0,No user reviews,0,0,0
642930,True,0,No user reviews,0,0,0
642940,True,0,No user reviews,0,0,0
642941,True,0,No user reviews,0,0,0
642942,True,0,No user reviews,0,0,0
642943,True,0,No user reviews,0,0,0
642944,True,0,No user reviews,0,0,0
642945,True,0,No user reviews,0,0,0
642946,True,0,No user reviews,0,0,0
642947,True,0,No user reviews,0,0,0
642948,True,0,No user reviews,0,0,0
642949,True,0,No user reviews,0,0,0
642950,True,0,No user reviews,0,0,0
642951,True,0,No user reviews,0,0,0
642952,True,0,No user reviews,0,0,0
642953,True,0,No user reviews,0,0,0
642954,True,0,No user reviews,0,0,0
642955,True,0,No user reviews,0,0,0
642956,True,0,No user reviews,0,0,0
642957,True,0,No user reviews,0,0,0
642958,True,0,No user reviews,0,0,0
642959,True,0,No user reviews,0,0,0
642960,True,0,No user reviews,0,0,0
642961,True,0,No user reviews,0,0,0
642970,True,0,No user reviews,0,0,0
642971,True,0,No user reviews,0,0,0
642972,True,0,No user reviews,0,0,0
642973,True,0,No user reviews,0,0,0
642974,True,0,No user reviews,0,0,0
642975,True,0,No user reviews,0,0,0
642976,True,0,No user reviews,0,0,0
642977,True,0,No user reviews,0,0,0
642978,True,0,No user reviews,0,0,0
642979,True,0,No user reviews,0,0,0
642980,True,0,No user reviews,0,0,0
642981,True,0,No user reviews,0,0,0
642982,True,0,No user reviews,0,0,0
642983,True,0,No user reviews,0,0,0
642984,True,0,No user reviews,0,0,0
642985,True,0,No user reviews,0,0,0
642986,True,0,No user reviews,0,0,0
642987,True,0,No user reviews,0,0,0
642988,True,0,No user reviews,0,0,0
642989,True,0,No user reviews,0,0,0
642990,True,0,No user reviews,0,0,0
642991,True,0,No user reviews,0,0,0
643000,True,0,No user reviews,0,0,0
643010,True,0,No user reviews,0,0,0
643020,True,0,No user reviews,0,0,0
643021,True,0,No user reviews,0,0,0
643022,True,0,No user reviews,0,0,0
643023,True,0,No user reviews,0,0,0
643024,True,0,No user reviews,0,0,0
643025,True,0,No user reviews,0,0,0
643026,True,0,No user reviews,0,0,0
643027,True,0,No user reviews,0,0,0
643028,True,0,No user reviews,0,0,0
643029,True,0,No user reviews,0,0,0
643030,True,0,No user reviews,0,0,0
643031,True,0,No user reviews,0,0,0
643032,True,0,No user reviews,0,0,0
643033,True,0,No user reviews,0,0,0
643034,True,0,No user reviews,0,0,0
643035,True,0,No user reviews,0,0,0
643036,True,0,No user reviews,0,0,0
643037,True,0,No user reviews,0,0,0
643038,True,0,No user reviews,0,0,0
643039,True,0,No user reviews,0,0,0
643040,True,0,No user reviews,0,0,0
643041,True,0,No user reviews,0,0,0
643060,True,0,No user reviews,0,0,0
643061,True,0,No user reviews,0,0,0
643062,True,0,No user reviews,0,0,0
643063,True,0,No user reviews,0,0,0
643064,True,0,No user reviews,0,0,0
643065,True,0,No user reviews,0,0,0
643066,True,0,No user reviews,0,0,0
643067,True,0,No user reviews,0,0,0
643068,True,0,No user reviews,0,0,0
643069,True,0,No user reviews,0,0,0
643070,True,0,No user reviews,0,0,0
643071,True,0,No user reviews,0,0,0
643072,True,0,No user reviews,0,0,0
643073,True,0,No user reviews,0,0,0
643074,True,0,No user reviews,0,0,0
643075,True,0,No user reviews,0,0,0
643076,True,0,No user reviews,0,0,0
643077,True,0,No user reviews,0,0,0
643078,True,0,No user reviews,0,0,0
643079,True,0,No user reviews,0,0,0
643080,True,0,No user reviews,0,0,0
643081,True,0,No user reviews,0,0,0
643090,True,0,No user reviews,0,0,0
643100,True,0,No user reviews,0,0,0
643110,True,0,No user reviews,0,0,0
643120,True,0,No user reviews,0,0,0
643130,True,0,No user reviews,0,0,0
643140,True,0,No user reviews,0,0,0
643150,True,0,No user reviews,0,0,0
643160,True,0,No user reviews,0,0,0
643170,True,0,No user reviews,0,0,0
643180,True,0,1 user reviews,1,0,1
643190,True,0,No user reviews,0,0,0
643200,True,6,Mostly Positive,35,13,48
643220,True,0,No user reviews,0,0,0
643221,True,0,No user reviews,0,0,0
643222,True,0,No user reviews,0,0,0
643223,True,0,No user reviews,0,0,0
643224,True,0,No user reviews,0,0,0
643225,True,0,No user reviews,0,0,0
643226,True,0,No user reviews,0,0,0
643227,True,0,No user reviews,0,0,0
643228,True,0,No user reviews,0,0,0
643229,True,0,No user reviews,0,0,0
643230,True,0,No user reviews,0,0,0
643231,True,0,No user reviews,0,0,0
643260,True,0,4 user reviews,4,0,4
643270,True,0,1 user reviews,1,0,1
643280,True,0,No user reviews,0,0,0
643281,True,0,No user reviews,0,0,0
643282,True,0,No user reviews,0,0,0
643283,True,0,No user reviews,0,0,0
643284,True,0,No user reviews,0,0,0
643285,True,0,No user reviews,0,0,0
643286,True,0,No user reviews,0,0,0
643287,True,0,No user reviews,0,0,0
643288,True,0,No user reviews,0,0,0
643289,True,0,No user reviews,0,0,0
643290,True,0,No user reviews,0,0,0
643291,True,0,No user reviews,0,0,0
643292,True,0,No user reviews,0,0,0
643293,True,0,No user reviews,0,0,0
643294,True,0,No user reviews,0,0,0
643295,True,0,No user reviews,0,0,0
643296,True,0,No user reviews,0,0,0
643297,True,0,No user reviews,0,0,0
643298,True,0,No user reviews,0,0,0
643299,True,0,No user reviews,0,0,0
643300,True,0,No user reviews,0,0,0
643301,True,0,No user reviews,0,0,0
643310,True,0,No user reviews,0,0,0
643311,True,0,No user reviews,0,0,0
643312,True,0,No user reviews,0,0,0
643313,True,0,No user reviews,0,0,0
643314,True,0,No user reviews,0,0,0
643315,True,0,No user reviews,0,0,0
643316,True,0,No user reviews,0,0,0
643317,True,0,No user reviews,0,0,0
643318,True,0,No user reviews,0,0,0
643319,True,0,No user reviews,0,0,0
643320,True,0,No user reviews,0,0,0
643321,True,0,No user reviews,0,0,0
643322,True,0,No user reviews,0,0,0
643323,True,0,No user reviews,0,0,0
643324,True,0,No user reviews,0,0,0
643325,True,0,No user reviews,0,0,0
643326,True,0,No user reviews,0,0,0
643327,True,0,No user reviews,0,0,0
643328,True,0,No user reviews,0,0,0
643329,True,0,No user reviews,0,0,0
643330,True,0,No user reviews,0,0,0
643331,True,0,No user reviews,0,0,0
643340,True,0,No user reviews,0,0,0
643341,True,0,No user reviews,0,0,0
643342,True,0,No user reviews,0,0,0
643343,True,0,No user reviews,0,0,0
643344,True,0,No user reviews,0,0,0
643345,True,0,No user reviews,0,0,0
643346,True,0,No user reviews,0,0,0
643347,True,0,No user reviews,0,0,0
643348,True,0,No user reviews,0,0,0
643349,True,0,No user reviews,0,0,0
643350,True,0,No user reviews,0,0,0
643351,True,0,No user reviews,0,0,0
643352,True,0,No user reviews,0,0,0
643353,True,0,No user reviews,0,0,0
643354,True,0,No user reviews,0,0,0
643355,True,0,No user reviews,0,0,0
643356,True,0,No user reviews,0,0,0
643357,True,0,No user reviews,0,0,0
643358,True,0,No user reviews,0,0,0
643359,True,0,No user reviews,0,0,0
643360,True,0,No user reviews,0,0,0
643361,True,0,No user reviews,0,0,0
643390,True,7,Positive,31,0,31
643400,True,0,1 user reviews,1,0,1
643401,True,0,No user reviews,0,0,0
643402,True,0,No user reviews,0,0,0
643403,True,0,No user reviews,0,0,0
643404,True,0,No user reviews,0,0,0
643405,True,0,No user reviews,0,0,0
643406,True,0,No user reviews,0,0,0
643407,True,0,No user reviews,0,0,0
643408,True,0,No user reviews,0,0,0
643409,True,0,No user reviews,0,0,0
643410,True,0,No user reviews,0,0,0
643411,True,0,No user reviews,0,0,0
643420,True,0,8 user reviews,8,0,8
643440,True,0,1 user reviews,1,0,1
643441,True,0,No user reviews,0,0,0
643442,True,0,No user reviews,0,0,0
643443,True,0,No user reviews,0,0,0
643444,True,0,No user reviews,0,0,0
643445,True,0,No user reviews,0,0,0
643446,True,0,No user reviews,0,0,0
643447,True,0,No user reviews,0,0,0
643448,True,0,No user reviews,0,0,0
643449,True,0,No user reviews,0,0,0
643450,True,0,No user reviews,0,0,0
643451,True,0,No user reviews,0,0,0
643460,True,0,1 user reviews,0,1,1
643470,True,0,No user reviews,0,0,0
643471,True,0,No user reviews,0,0,0
643472,True,0,No user reviews,0,0,0
643473,True,0,No user reviews,0,0,0
643474,True,0,No user reviews,0,0,0
643475,True,0,No user reviews,0,0,0
643476,True,0,No user reviews,0,0,0
643477,True,0,No user reviews,0,0,0
643478,True,0,No user reviews,0,0,0
643479,True,0,No user reviews,0,0,0
643480,True,0,No user reviews,0,0,0
643481,True,0,No user reviews,0,0,0
643482,True,0,No user reviews,0,0,0
643483,True,0,No user reviews,0,0,0
643484,True,0,No user reviews,0,0,0
643485,True,0,No user reviews,0,0,0
643486,True,0,No user reviews,0,0,0
643487,True,0,No user reviews,0,0,0
643488,True,0,No user reviews,0,0,0
643489,True,0,No user reviews,0,0,0
643490,True,0,No user reviews,0,0,0
643491,True,0,No user reviews,0,0,0
643500,True,0,No user reviews,0,0,0
643501,True,0,No user reviews,0,0,0
643502,True,0,No user reviews,0,0,0
643503,True,0,No user reviews,0,0,0
643504,True,0,No user reviews,0,0,0
643505,True,0,No user reviews,0,0,0
643506,True,0,No user reviews,0,0,0
643507,True,0,No user reviews,0,0,0
643508,True,0,No user reviews,0,0,0
643509,True,0,No user reviews,0,0,0
643510,True,0,No user reviews,0,0,0
643511,True,0,No user reviews,0,0,0
643512,True,0,No user reviews,0,0,0
643513,True,0,No user reviews,0,0,0
643514,True,0,No user reviews,0,0,0
643515,True,0,No user reviews,0,0,0
643516,True,0,No user reviews,0,0,0
643517,True,0,No user reviews,0,0,0
643518,True,0,No user reviews,0,0,0
643519,True,0,No user reviews,0,0,0
643520,True,0,No user reviews,0,0,0
643521,True,0,No user reviews,0,0,0
643530,True,0,No user reviews,0,0,0
643540,True,0,No user reviews,0,0,0
643541,True,0,No user reviews,0,0,0
643542,True,0,No user reviews,0,0,0
643543,True,0,No user reviews,0,0,0
643544,True,0,No user reviews,0,0,0
643545,True,0,No user reviews,0,0,0
643546,True,0,No user reviews,0,0,0
643547,True,0,No user reviews,0,0,0
643548,True,0,No user reviews,0,0,0
643549,True,0,No user reviews,0,0,0
643550,True,0,No user reviews,0,0,0
643551,True,0,No user reviews,0,0,0
643552,True,0,No user reviews,0,0,0
643553,True,0,No user reviews,0,0,0
643554,True,0,No user reviews,0,0,0
643555,True,0,No user reviews,0,0,0
643556,True,0,No user reviews,0,0,0
643557,True,0,No user reviews,0,0,0
643558,True,0,No user reviews,0,0,0
643559,True,0,No user reviews,0,0,0
643560,True,0,No user reviews,0,0,0
643561,True,0,No user reviews,0,0,0
643570,True,7,Positive,18,0,18
643580,True,0,No user reviews,0,0,0
643590,True,5,Mixed,14,20,34
643610,True,6,Mostly Positive,21,8,29
643620,True,6,Mostly Positive,62,16,78
643650,True,0,2 user reviews,2,0,2
643670,True,0,1 user reviews,1,0,1
643671,True,0,1 user reviews,1,0,1
643680,True,0,No user reviews,0,0,0
643681,True,5,Mixed,14,14,28
643682,True,5,Mixed,5,7,12
643683,True,0,2 user reviews,0,2,2
643684,True,0,1 user reviews,1,0,1
643686,True,0,3 user reviews,2,1,3
643687,True,0,2 user reviews,1,1,2
643688,True,0,4 user reviews,3,1,4
643689,True,0,9 user reviews,6,3,9
643690,True,0,No user reviews,0,0,0
643692,True,0,1 user reviews,1,0,1
643693,True,0,1 user reviews,1,0,1
643694,True,0,No user reviews,0,0,0
643695,True,0,No user reviews,0,0,0
643696,True,0,No user reviews,0,0,0
643697,True,0,No user reviews,0,0,0
643698,True,0,2 user reviews,2,0,2
643699,True,0,No user reviews,0,0,0
643700,True,7,Positive,13,3,16
643710,True,0,No user reviews,0,0,0
643730,True,0,8 user reviews,7,1,8
643731,True,0,3 user reviews,3,0,3
643740,True,0,5 user reviews,2,3,5
643750,True,0,No user reviews,0,0,0
643760,True,0,No user reviews,0,0,0
643810,True,8,Very Positive,226,47,273
643820,True,5,Mixed,48,29,77
643830,True,6,Mostly Positive,14,4,18
643850,True,0,No user reviews,0,0,0
643851,True,0,No user reviews,0,0,0
643852,True,0,No user reviews,0,0,0
643853,True,0,No user reviews,0,0,0
643854,True,0,No user reviews,0,0,0
643855,True,0,No user reviews,0,0,0
643870,True,0,2 user reviews,2,0,2
643880,True,8,Very Positive,235,19,254
643900,True,8,Very Positive,59,5,64
643910,True,0,3 user reviews,3,0,3
643930,True,0,No user reviews,0,0,0
643940,True,0,3 user reviews,2,1,3
643950,True,0,7 user reviews,1,6,7
643960,True,8,Very Positive,132,30,162
643970,True,5,Mixed,8,4,12
643980,True,0,No user reviews,0,0,0
644000,True,5,Mixed,9,7,16
644010,True,5,Mixed,9,6,15
644020,True,0,No user reviews,0,0,0
644021,True,0,No user reviews,0,0,0
644022,True,0,No user reviews,0,0,0
644023,True,0,No user reviews,0,0,0
644024,True,0,No user reviews,0,0,0
644025,True,0,No user reviews,0,0,0
644026,True,0,No user reviews,0,0,0
644027,True,0,No user reviews,0,0,0
644028,True,0,No user reviews,0,0,0
644029,True,0,No user reviews,0,0,0
644030,True,0,No user reviews,0,0,0
644031,True,0,No user reviews,0,0,0
644032,True,0,No user reviews,0,0,0
644033,True,0,No user reviews,0,0,0
644034,True,0,No user reviews,0,0,0
644035,True,0,No user reviews,0,0,0
644036,True,0,No user reviews,0,0,0
644037,True,0,No user reviews,0,0,0
644038,True,0,No user reviews,0,0,0
644039,True,0,No user reviews,0,0,0
644040,True,0,No user reviews,0,0,0
644041,True,0,No user reviews,0,0,0
644050,True,0,No user reviews,0,0,0
644051,True,0,No user reviews,0,0,0
644052,True,0,No user reviews,0,0,0
644053,True,0,No user reviews,0,0,0
644054,True,0,No user reviews,0,0,0
644055,True,0,No user reviews,0,0,0
644056,True,0,No user reviews,0,0,0
644057,True,0,No user reviews,0,0,0
644058,True,0,No user reviews,0,0,0
644059,True,0,No user reviews,0,0,0
644060,True,0,No user reviews,0,0,0
644061,True,0,No user reviews,0,0,0
644062,True,0,No user reviews,0,0,0
644063,True,0,No user reviews,0,0,0
644064,True,0,No user reviews,0,0,0
644065,True,0,No user reviews,0,0,0
644066,True,0,No user reviews,0,0,0
644067,True,0,No user reviews,0,0,0
644068,True,0,No user reviews,0,0,0
644069,True,0,No user reviews,0,0,0
644070,True,0,No user reviews,0,0,0
644071,True,0,No user reviews,0,0,0
644080,True,8,Very Positive,47,8,55
644110,True,5,Mixed,8,6,14
644130,True,4,Mostly Negative,4,16,20
644150,True,0,3 user reviews,3,0,3
644160,True,0,6 user reviews,4,2,6
644170,True,0,No user reviews,0,0,0
644171,True,0,No user reviews,0,0,0
644172,True,0,No user reviews,0,0,0
644173,True,0,No user reviews,0,0,0
644174,True,0,No user reviews,0,0,0
644175,True,0,No user reviews,0,0,0
644176,True,0,No user reviews,0,0,0
644177,True,0,No user reviews,0,0,0
644178,True,0,No user reviews,0,0,0
644179,True,0,No user reviews,0,0,0
644180,True,0,No user reviews,0,0,0
644181,True,0,No user reviews,0,0,0
644200,True,7,Positive,19,3,22
644210,True,0,No user reviews,0,0,0
644220,True,0,No user reviews,0,0,0
644221,True,0,No user reviews,0,0,0
644222,True,0,No user reviews,0,0,0
644223,True,0,No user reviews,0,0,0
644224,True,0,No user reviews,0,0,0
644225,True,0,No user reviews,0,0,0
644226,True,0,No user reviews,0,0,0
644227,True,0,No user reviews,0,0,0
644228,True,0,No user reviews,0,0,0
644229,True,0,No user reviews,0,0,0
644230,True,0,No user reviews,0,0,0
644231,True,0,No user reviews,0,0,0
644232,True,0,No user reviews,0,0,0
644233,True,0,No user reviews,0,0,0
644234,True,0,No user reviews,0,0,0
644235,True,0,No user reviews,0,0,0
644236,True,0,No user reviews,0,0,0
644237,True,0,No user reviews,0,0,0
644238,True,0,No user reviews,0,0,0
644239,True,0,No user reviews,0,0,0
644240,True,0,No user reviews,0,0,0
644241,True,0,No user reviews,0,0,0
644242,True,0,No user reviews,0,0,0
644243,True,0,No user reviews,0,0,0
644280,True,0,No user reviews,0,0,0
644290,True,5,Mixed,256,129,385
644300,True,0,No user reviews,0,0,0
644320,True,0,No user reviews,0,0,0
644330,True,0,No user reviews,0,0,0
644340,True,0,No user reviews,0,0,0
644360,True,0,No user reviews,0,0,0
644370,True,7,Positive,19,1,20
644380,True,0,7 user reviews,3,4,7
644390,True,8,Very Positive,605,51,656
644400,True,0,3 user reviews,3,0,3
644420,True,5,Mixed,26,12,38
644440,True,0,No user reviews,0,0,0
644441,True,0,No user reviews,0,0,0
644442,True,0,No user reviews,0,0,0
644443,True,0,No user reviews,0,0,0
644444,True,0,No user reviews,0,0,0
644445,True,0,No user reviews,0,0,0
644446,True,0,No user reviews,0,0,0
644447,True,0,No user reviews,0,0,0
644448,True,0,No user reviews,0,0,0
644449,True,0,No user reviews,0,0,0
644450,True,0,No user reviews,0,0,0
644451,True,0,No user reviews,0,0,0
644460,True,0,No user reviews,0,0,0
644461,True,0,No user reviews,0,0,0
644462,True,0,No user reviews,0,0,0
644463,True,0,No user reviews,0,0,0
644464,True,0,No user reviews,0,0,0
644465,True,0,No user reviews,0,0,0
644466,True,0,No user reviews,0,0,0
644467,True,0,No user reviews,0,0,0
644468,True,0,No user reviews,0,0,0
644469,True,0,No user reviews,0,0,0
644470,True,0,No user reviews,0,0,0
644471,True,0,No user reviews,0,0,0
644480,True,5,Mixed,101,46,147
644520,True,0,No user reviews,0,0,0
644530,True,0,8 user reviews,4,4,8
644540,True,7,Positive,18,0,18
644550,True,0,9 user reviews,8,1,9
644560,True,8,Very Positive,4678,357,5035
644570,True,8,Very Positive,768,140,908
644580,True,0,5 user reviews,5,0,5
644610,True,0,8 user reviews,4,4,8
644640,True,5,Mixed,46,68,114
644660,True,0,No user reviews,0,0,0
644670,True,5,Mixed,65,39,104
644680,True,0,4 user reviews,4,0,4
644690,True,0,No user reviews,0,0,0
644700,True,0,No user reviews,0,0,0
644710,True,7,Positive,39,6,45
644730,True,0,No user reviews,0,0,0
644740,True,0,1 user reviews,1,0,1
644760,True,0,7 user reviews,4,3,7
644780,True,0,No user reviews,0,0,0
644800,True,0,No user reviews,0,0,0
644820,True,0,No user reviews,0,0,0
644830,True,8,Very Positive,1335,232,1567
644840,True,0,No user reviews,0,0,0
644860,True,0,No user reviews,0,0,0
644870,True,0,3 user reviews,2,1,3
644890,True,0,5 user reviews,2,3,5
644910,True,0,No user reviews,0,0,0
644920,True,0,No user reviews,0,0,0
644921,True,0,No user reviews,0,0,0
644922,True,0,No user reviews,0,0,0
644930,True,8,Very Positive,9908,2237,12145
644940,True,0,No user reviews,0,0,0
644960,True,0,1 user reviews,1,0,1
644961,True,0,1 user reviews,1,0,1
644962,True,0,2 user reviews,2,0,2
645040,True,0,No user reviews,0,0,0
645050,True,0,No user reviews,0,0,0
645090,True,8,Very Positive,444,47,491
645100,True,0,No user reviews,0,0,0
645130,True,0,No user reviews,0,0,0
645140,True,0,No user reviews,0,0,0
645150,True,0,4 user reviews,1,3,4
645170,True,0,2 user reviews,2,0,2
645171,True,0,No user reviews,0,0,0
645180,True,0,3 user reviews,3,0,3
645190,True,0,No user reviews,0,0,0
645200,True,0,No user reviews,0,0,0
645210,True,0,No user reviews,0,0,0
645220,True,0,1 user reviews,1,0,1
645230,True,0,No user reviews,0,0,0
645240,True,0,2 user reviews,2,0,2
645250,True,0,2 user reviews,2,0,2
645260,True,0,No user reviews,0,0,0
645270,True,6,Mostly Positive,11,3,14
645280,True,0,6 user reviews,5,1,6
645290,True,5,Mixed,14,10,24
645300,True,0,No user reviews,0,0,0
645310,True,0,4 user reviews,4,0,4
645320,True,0,No user reviews,0,0,0
645330,True,0,3 user reviews,0,3,3
645340,True,5,Mixed,7,6,13
645360,True,0,2 user reviews,1,1,2
645380,True,7,Positive,13,2,15
645400,True,5,Mixed,82,91,173
645401,True,5,Mixed,68,66,134
645402,True,5,Mixed,527,386,913
645410,True,5,Mixed,6,4,10
645420,True,0,7 user reviews,6,1,7
645430,True,0,6 user reviews,5,1,6
645440,True,0,6 user reviews,2,4,6
645450,True,5,Mixed,9,4,13
645460,True,6,Mostly Positive,19,8,27
645470,True,0,No user reviews,0,0,0
645480,True,0,No user reviews,0,0,0
645500,True,7,Positive,14,3,17
645510,True,0,2 user reviews,2,0,2
645511,True,0,No user reviews,0,0,0
645512,True,0,No user reviews,0,0,0
645513,True,0,No user reviews,0,0,0
645514,True,0,No user reviews,0,0,0
645515,True,0,No user reviews,0,0,0
645516,True,0,No user reviews,0,0,0
645517,True,0,No user reviews,0,0,0
645518,True,0,No user reviews,0,0,0
645519,True,0,No user reviews,0,0,0
645520,True,0,No user reviews,0,0,0
645521,True,0,No user reviews,0,0,0
645560,True,0,No user reviews,0,0,0
645610,True,0,3 user reviews,3,0,3
645620,True,0,No user reviews,0,0,0
645630,True,8,Very Positive,11470,1784,13254
645650,True,0,9 user reviews,6,3,9
645660,True,0,No user reviews,0,0,0
645670,True,0,6 user reviews,4,2,6
645671,True,0,6 user reviews,4,2,6
645690,True,7,Positive,10,0,10
645700,True,0,3 user reviews,2,1,3
645720,True,0,No user reviews,0,0,0
645730,True,8,Very Positive,244,39,283
645750,True,7,Positive,15,0,15
645770,True,0,No user reviews,0,0,0
645771,True,0,No user reviews,0,0,0
645780,True,0,1 user reviews,1,0,1
645790,True,5,Mixed,333,147,480
645820,True,6,Mostly Positive,20,6,26
645830,True,0,No user reviews,0,0,0
645840,True,0,No user reviews,0,0,0
645850,True,0,No user reviews,0,0,0
645860,True,0,6 user reviews,4,2,6
645880,True,0,No user reviews,0,0,0
645890,True,0,2 user reviews,2,0,2
645910,True,0,1 user reviews,1,0,1
645911,True,0,2 user reviews,2,0,2
645920,True,7,Positive,30,4,34
645930,True,5,Mixed,13,7,20
645940,True,0,1 user reviews,1,0,1
645950,True,0,No user reviews,0,0,0
645960,True,0,No user reviews,0,0,0
645970,True,0,6 user reviews,5,1,6
645980,True,0,No user reviews,0,0,0
645981,True,0,No user reviews,0,0,0
645982,True,0,No user reviews,0,0,0
645983,True,0,No user reviews,0,0,0
645984,True,0,No user reviews,0,0,0
645985,True,0,No user reviews,0,0,0
645986,True,0,No user reviews,0,0,0
645987,True,0,No user reviews,0,0,0
645988,True,0,No user reviews,0,0,0
645989,True,0,No user reviews,0,0,0
645990,True,0,No user reviews,0,0,0
646010,True,5,Mixed,7,5,12
646030,True,0,No user reviews,0,0,0
646050,True,5,Mixed,4,6,10
646060,True,0,No user reviews,0,0,0
646080,True,0,No user reviews,0,0,0
646100,True,0,9 user reviews,2,7,9
646110,True,0,No user reviews,0,0,0
646130,True,0,No user reviews,0,0,0
646140,True,0,No user reviews,0,0,0
646150,True,0,3 user reviews,2,1,3
646160,True,0,No user reviews,0,0,0
646161,True,0,No user reviews,0,0,0
646170,True,0,No user reviews,0,0,0
646171,True,0,No user reviews,0,0,0
646180,True,0,2 user reviews,1,1,2
646190,True,0,No user reviews,0,0,0
646200,True,8,Very Positive,574,122,696
646210,True,7,Positive,24,1,25
646240,True,0,No user reviews,0,0,0
646260,True,0,No user reviews,0,0,0
646270,True,8,Very Positive,314,56,370
646280,True,6,Mostly Positive,12,5,17
646290,True,0,No user reviews,0,0,0
646300,True,0,4 user reviews,2,2,4
646310,True,6,Mostly Positive,20,7,27
646320,True,0,No user reviews,0,0,0
646330,True,7,Positive,21,2,23
646340,True,0,No user reviews,0,0,0
646350,True,0,7 user reviews,3,4,7
646360,True,0,No user reviews,0,0,0
646370,True,0,3 user reviews,3,0,3
646380,True,0,8 user reviews,7,1,8
646400,True,0,No user reviews,0,0,0
646410,True,0,No user reviews,0,0,0
646420,True,0,3 user reviews,3,0,3
646430,True,0,2 user reviews,0,2,2
646440,True,0,1 user reviews,0,1,1
646460,True,0,5 user reviews,5,0,5
646470,True,6,Mostly Positive,23,6,29
646480,True,0,No user reviews,0,0,0
646490,True,0,1 user reviews,1,0,1
646500,True,8,Very Positive,201,37,238
646520,True,0,No user reviews,0,0,0
646530,True,7,Positive,16,3,19
646550,True,0,3 user reviews,3,0,3
646560,True,0,No user reviews,0,0,0
646570,True,9,Overwhelmingly Positive,31440,620,32060
646580,True,0,No user reviews,0,0,0
646590,True,0,No user reviews,0,0,0
646600,True,5,Mixed,40,19,59
646610,True,0,1 user reviews,1,0,1
646620,True,0,No user reviews,0,0,0
646630,True,0,No user reviews,0,0,0
646640,True,0,No user reviews,0,0,0
646660,True,0,2 user reviews,1,1,2
646661,True,0,1 user reviews,1,0,1
646662,True,0,5 user reviews,5,0,5
646663,True,0,2 user reviews,2,0,2
646664,True,0,1 user reviews,1,0,1
646665,True,0,2 user reviews,2,0,2
646666,True,0,3 user reviews,3,0,3
646667,True,0,2 user reviews,2,0,2
646668,True,6,Mostly Positive,18,5,23
646669,True,7,Positive,13,2,15
646670,True,7,Positive,13,0,13
646671,True,0,4 user reviews,4,0,4
646672,True,0,6 user reviews,4,2,6
646673,True,0,4 user reviews,4,0,4
646680,True,0,9 user reviews,8,1,9
646690,True,0,No user reviews,0,0,0
646700,True,0,No user reviews,0,0,0
646710,True,0,No user reviews,0,0,0
646730,True,7,Positive,23,4,27
646740,True,0,No user reviews,0,0,0
646750,True,0,No user reviews,0,0,0
646760,True,0,No user reviews,0,0,0
646770,True,0,No user reviews,0,0,0
646780,True,7,Positive,12,1,13
646790,True,0,No user reviews,0,0,0
646800,True,0,1 user reviews,1,0,1
646810,True,0,No user reviews,0,0,0
646820,True,0,No user reviews,0,0,0
646860,True,0,No user reviews,0,0,0
646870,True,0,No user reviews,0,0,0
646880,True,0,No user reviews,0,0,0
646890,True,0,2 user reviews,1,1,2
646900,True,0,No user reviews,0,0,0
646910,True,6,Mostly Positive,5459,1394,6853
646920,True,0,No user reviews,0,0,0
646921,True,0,No user reviews,0,0,0
646922,True,0,No user reviews,0,0,0
646930,True,0,2 user reviews,2,0,2
646950,True,0,No user reviews,0,0,0
646951,True,0,No user reviews,0,0,0
646952,True,0,No user reviews,0,0,0
646953,True,0,No user reviews,0,0,0
646960,True,0,No user reviews,0,0,0
646990,True,0,No user reviews,0,0,0
647000,True,0,No user reviews,0,0,0
647010,True,0,No user reviews,0,0,0
647020,True,0,7 user reviews,7,0,7
647030,True,0,No user reviews,0,0,0
647040,True,5,Mixed,19,9,28
647050,True,0,2 user reviews,0,2,2
647070,True,0,3 user reviews,3,0,3
647071,True,0,2 user reviews,2,0,2
647080,True,0,8 user reviews,8,0,8
647090,True,0,4 user reviews,4,0,4
647120,True,0,No user reviews,0,0,0
647130,True,0,No user reviews,0,0,0
647140,True,0,No user reviews,0,0,0
647150,True,0,1 user reviews,1,0,1
647160,True,0,No user reviews,0,0,0
647170,True,0,No user reviews,0,0,0
647171,True,0,No user reviews,0,0,0
647190,True,0,No user reviews,0,0,0
647200,True,0,1 user reviews,1,0,1
647210,True,0,No user reviews,0,0,0
647220,True,0,No user reviews,0,0,0
647230,True,0,No user reviews,0,0,0
647240,True,0,1 user reviews,1,0,1
647250,True,0,No user reviews,0,0,0
647260,True,0,1 user reviews,1,0,1
647280,True,0,6 user reviews,3,3,6
647290,True,0,1 user reviews,1,0,1
647300,True,0,No user reviews,0,0,0
647310,True,0,1 user reviews,1,0,1
647320,True,0,1 user reviews,1,0,1
647330,True,0,No user reviews,0,0,0
647340,True,0,No user reviews,0,0,0
647350,True,0,No user reviews,0,0,0
647370,True,0,No user reviews,0,0,0
647371,True,0,3 user reviews,2,1,3
647400,True,0,1 user reviews,1,0,1
647430,True,0,No user reviews,0,0,0
647450,True,0,No user reviews,0,0,0
647460,True,0,No user reviews,0,0,0
647470,True,0,No user reviews,0,0,0
647480,True,0,No user reviews,0,0,0
647490,True,0,No user reviews,0,0,0
647500,True,5,Mixed,11,8,19
647510,True,0,No user reviews,0,0,0
647520,True,0,No user reviews,0,0,0
647530,True,0,6 user reviews,2,4,6
647550,True,0,No user reviews,0,0,0
647560,True,5,Mixed,18,17,35
647570,True,6,Mostly Positive,95,28,123
647580,True,0,No user reviews,0,0,0
647620,True,0,No user reviews,0,0,0
647630,True,0,3 user reviews,0,3,3
647631,True,0,No user reviews,0,0,0
647632,True,0,1 user reviews,1,0,1
647633,True,0,No user reviews,0,0,0
647640,True,5,Mixed,6,4,10
647650,True,0,4 user reviews,2,2,4
647660,True,0,No user reviews,0,0,0
647670,True,0,No user reviews,0,0,0
647680,True,0,No user reviews,0,0,0
647690,True,0,No user reviews,0,0,0
647700,True,0,No user reviews,0,0,0
647710,True,0,No user reviews,0,0,0
647720,True,0,No user reviews,0,0,0
647730,True,0,No user reviews,0,0,0
647740,True,8,Very Positive,141,24,165
647770,True,0,No user reviews,0,0,0
647790,True,0,1 user reviews,1,0,1
647810,True,7,Positive,9,2,11
647820,True,4,Mostly Negative,4,13,17
647830,True,6,Mostly Positive,738,192,930
647840,True,0,8 user reviews,8,0,8
647850,True,0,3 user reviews,3,0,3
647860,True,5,Mixed,7,5,12
647890,True,0,4 user reviews,2,2,4
647900,True,0,2 user reviews,2,0,2
647910,True,0,3 user reviews,3,0,3
647920,True,0,No user reviews,0,0,0
647930,True,0,4 user reviews,3,1,4
647940,True,0,No user reviews,0,0,0
647950,True,0,No user reviews,0,0,0
647960,True,9,Overwhelmingly Positive,666,23,689
647980,True,4,Mostly Negative,7,11,18
647990,True,7,Positive,14,2,16
648020,True,5,Mixed,7,4,11
648030,True,0,No user reviews,0,0,0
648050,True,8,Very Positive,53,5,58
648060,True,0,5 user reviews,2,3,5
648070,True,0,6 user reviews,1,5,6
648080,True,0,No user reviews,0,0,0
648090,True,0,No user reviews,0,0,0
648100,True,8,Very Positive,96,8,104
648110,True,0,No user reviews,0,0,0
648111,True,0,No user reviews,0,0,0
648112,True,0,No user reviews,0,0,0
648113,True,0,1 user reviews,0,1,1
648120,True,7,Positive,22,5,27
648150,True,0,No user reviews,0,0,0
648190,True,0,3 user reviews,3,0,3
648200,True,0,1 user reviews,0,1,1
648220,True,0,No user reviews,0,0,0
648270,True,0,No user reviews,0,0,0
648290,True,7,Positive,20,4,24
648292,True,7,Positive,29,1,30
648293,True,6,Mostly Positive,16,6,22
648300,True,0,No user reviews,0,0,0
648301,True,5,Mixed,11,11,22
648310,True,0,No user reviews,0,0,0
648330,True,0,No user reviews,0,0,0
648350,True,8,Very Positive,11819,2644,14463
648380,True,0,No user reviews,0,0,0
648390,True,0,No user reviews,0,0,0
648400,True,7,Positive,9,2,11
648410,True,0,No user reviews,0,0,0
648420,True,7,Positive,10,1,11
648430,True,0,No user reviews,0,0,0
648440,True,0,5 user reviews,4,1,5
648450,True,0,No user reviews,0,0,0
648460,True,0,No user reviews,0,0,0
648470,True,0,No user reviews,0,0,0
648480,True,0,No user reviews,0,0,0
648491,True,0,No user reviews,0,0,0
648500,True,0,No user reviews,0,0,0
648510,True,0,8 user reviews,7,1,8
648520,True,0,No user reviews,0,0,0
648530,True,0,3 user reviews,1,2,3
648540,True,0,No user reviews,0,0,0
648550,True,0,6 user reviews,3,3,6
648570,True,0,5 user reviews,2,3,5
648580,True,8,Very Positive,243,9,252
648590,True,0,No user reviews,0,0,0
648600,True,0,No user reviews,0,0,0
648630,True,5,Mixed,8,9,17
648640,True,0,7 user reviews,5,2,7
648650,True,0,No user reviews,0,0,0
648660,True,0,6 user reviews,4,2,6
648670,True,0,No user reviews,0,0,0
648690,True,0,No user reviews,0,0,0
648710,True,0,5 user reviews,5,0,5
648730,True,0,3 user reviews,3,0,3
648750,True,5,Mixed,25,15,40
648780,True,6,Mostly Positive,48,14,62
648800,True,8,Very Positive,23131,2288,25419
648810,True,0,4 user reviews,2,2,4
648820,True,0,5 user reviews,5,0,5
648860,True,0,No user reviews,0,0,0
648870,True,0,No user reviews,0,0,0
648880,True,0,7 user reviews,7,0,7
648890,True,8,Very Positive,87,10,97
648930,True,7,Positive,23,0,23
648940,True,0,No user reviews,0,0,0
648960,True,0,No user reviews,0,0,0
648970,True,0,No user reviews,0,0,0
648980,True,7,Positive,28,0,28
649000,True,0,No user reviews,0,0,0
649020,True,0,No user reviews,0,0,0
649040,True,0,No user reviews,0,0,0
649070,True,0,No user reviews,0,0,0
649090,True,0,No user reviews,0,0,0
649120,True,0,6 user reviews,6,0,6
649150,True,0,6 user reviews,2,4,6
649160,True,0,2 user reviews,1,1,2
649170,True,0,4 user reviews,1,3,4
649190,True,5,Mixed,6,5,11
649240,True,6,Mostly Positive,11,4,15
649250,True,0,1 user reviews,1,0,1
649270,True,5,Mixed,23,11,34
649271,True,0,6 user reviews,4,2,6
649272,True,7,Positive,13,1,14
649280,True,7,Positive,9,2,11
649290,True,0,No user reviews,0,0,0
649300,True,0,3 user reviews,0,3,3
649310,True,0,6 user reviews,6,0,6
649320,True,0,No user reviews,0,0,0
649330,True,0,6 user reviews,5,1,6
649340,True,0,No user reviews,0,0,0
649360,True,0,1 user reviews,0,1,1
649370,True,0,No user reviews,0,0,0
649390,True,0,1 user reviews,1,0,1
649400,True,0,No user reviews,0,0,0
649401,True,0,No user reviews,0,0,0
649402,True,0,No user reviews,0,0,0
649403,True,0,No user reviews,0,0,0
649410,True,5,Mixed,71,49,120
649420,True,0,No user reviews,0,0,0
649430,True,0,No user reviews,0,0,0
649431,True,0,No user reviews,0,0,0
649450,True,7,Positive,19,4,23
649460,True,5,Mixed,6,5,11
649480,True,0,4 user reviews,4,0,4
649481,True,0,3 user reviews,3,0,3
649482,True,0,7 user reviews,7,0,7
649483,True,0,4 user reviews,3,1,4
649484,True,0,4 user reviews,1,3,4
649485,True,7,Positive,9,1,10
649486,True,6,Mostly Positive,13,4,17
649487,True,0,1 user reviews,1,0,1
649488,True,0,7 user reviews,5,2,7
649489,True,0,3 user reviews,3,0,3
649490,True,0,4 user reviews,4,0,4
649491,True,0,3 user reviews,3,0,3
649500,True,0,No user reviews,0,0,0
649510,True,0,4 user reviews,2,2,4
649540,True,0,No user reviews,0,0,0
649550,True,0,No user reviews,0,0,0
649570,True,0,2 user reviews,1,1,2
649580,True,6,Mostly Positive,36,12,48
649600,True,5,Mixed,94,44,138
649610,True,0,No user reviews,0,0,0
649611,True,0,No user reviews,0,0,0
649612,True,0,No user reviews,0,0,0
649613,True,0,No user reviews,0,0,0
649614,True,0,No user reviews,0,0,0
649615,True,0,No user reviews,0,0,0
649616,True,0,No user reviews,0,0,0
649617,True,0,No user reviews,0,0,0
649618,True,0,No user reviews,0,0,0
649619,True,0,No user reviews,0,0,0
649620,True,7,Positive,15,0,15
649630,True,0,2 user reviews,1,1,2
649640,True,8,Very Positive,251,59,310
649660,True,0,3 user reviews,1,2,3
649670,True,5,Mixed,7,7,14
649690,True,0,3 user reviews,2,1,3
649700,True,0,No user reviews,0,0,0
649720,True,0,No user reviews,0,0,0
649730,True,0,3 user reviews,1,2,3
649740,True,0,7 user reviews,2,5,7
649770,True,0,No user reviews,0,0,0
649790,True,5,Mixed,40,52,92
649810,True,5,Mixed,16,8,24
649820,True,0,No user reviews,0,0,0
649830,True,0,No user reviews,0,0,0
649870,True,5,Mixed,6,7,13
649880,True,5,Mixed,11,6,17
649890,True,0,No user reviews,0,0,0
649900,True,0,No user reviews,0,0,0
649920,True,0,No user reviews,0,0,0
649930,True,0,No user reviews,0,0,0
649940,True,0,6 user reviews,6,0,6
649950,True,6,Mostly Positive,291,124,415
649970,True,0,1 user reviews,1,0,1
649990,True,7,Positive,11,1,12
650000,True,5,Mixed,629,481,1110
650010,True,0,4 user reviews,2,2,4
650030,True,0,No user reviews,0,0,0
650031,True,0,No user reviews,0,0,0
650040,True,0,No user reviews,0,0,0
650041,True,0,No user reviews,0,0,0
650042,True,0,No user reviews,0,0,0
650043,True,0,No user reviews,0,0,0
650044,True,0,No user reviews,0,0,0
650045,True,0,No user reviews,0,0,0
650046,True,0,No user reviews,0,0,0
650047,True,0,No user reviews,0,0,0
650048,True,0,No user reviews,0,0,0
650049,True,0,No user reviews,0,0,0
650050,True,0,No user reviews,0,0,0
650060,True,0,No user reviews,0,0,0
650061,True,0,No user reviews,0,0,0
650062,True,0,No user reviews,0,0,0
650063,True,0,No user reviews,0,0,0
650064,True,0,No user reviews,0,0,0
650065,True,0,No user reviews,0,0,0
650070,True,5,Mixed,17,8,25
650090,True,0,No user reviews,0,0,0
650110,True,5,Mixed,46,30,76
650120,True,0,No user reviews,0,0,0
650140,True,0,No user reviews,0,0,0
650170,True,0,No user reviews,0,0,0
650190,True,0,No user reviews,0,0,0
650220,True,8,Very Positive,193,33,226
650230,True,0,3 user reviews,3,0,3
650231,True,0,2 user reviews,2,0,2
650232,True,0,1 user reviews,1,0,1
650233,True,0,1 user reviews,1,0,1
650234,True,0,1 user reviews,1,0,1
650235,True,0,1 user reviews,0,1,1
650236,True,0,1 user reviews,1,0,1
650237,True,0,1 user reviews,1,0,1
650238,True,0,1 user reviews,1,0,1
650239,True,0,1 user reviews,0,1,1
650240,True,0,1 user reviews,0,1,1
650241,True,0,2 user reviews,2,0,2
650242,True,0,1 user reviews,1,0,1
650243,True,0,2 user reviews,1,1,2
650250,True,0,No user reviews,0,0,0
650260,True,0,No user reviews,0,0,0
650261,True,0,No user reviews,0,0,0
650270,True,0,No user reviews,0,0,0
650280,True,0,No user reviews,0,0,0
650290,True,0,4 user reviews,2,2,4
650291,True,0,2 user reviews,0,2,2
650300,True,0,2 user reviews,2,0,2
650310,True,0,3 user reviews,0,3,3
650330,True,7,Positive,16,3,19
650340,True,0,1 user reviews,0,1,1
650350,True,5,Mixed,71,54,125
650360,True,0,3 user reviews,0,3,3
650370,True,0,No user reviews,0,0,0
650390,True,0,No user reviews,0,0,0
650410,True,4,Mostly Negative,26,49,75
650420,True,0,No user reviews,0,0,0
650421,True,0,No user reviews,0,0,0
650422,True,0,No user reviews,0,0,0
650423,True,0,No user reviews,0,0,0
650424,True,0,No user reviews,0,0,0
650425,True,0,No user reviews,0,0,0
650440,True,6,Mostly Positive,151,60,211
650460,True,0,No user reviews,0,0,0
650490,True,5,Mixed,17,25,42
650500,True,6,Mostly Positive,5967,2330,8297
650510,True,6,Mostly Positive,170,62,232
650520,True,0,No user reviews,0,0,0
650521,True,0,No user reviews,0,0,0
650522,True,0,No user reviews,0,0,0
650523,True,0,No user reviews,0,0,0
650524,True,4,Mostly Negative,26,49,75
650540,True,0,No user reviews,0,0,0
650560,True,0,No user reviews,0,0,0
650570,True,7,Positive,43,3,46
650580,True,0,3 user reviews,1,2,3
650600,True,0,3 user reviews,2,1,3
650610,True,7,Positive,9,1,10
650611,True,8,Very Positive,50,3,53
650620,True,0,No user reviews,0,0,0
650630,True,0,No user reviews,0,0,0
650640,True,0,No user reviews,0,0,0
650670,True,6,Mostly Positive,290,121,411
650680,True,7,Positive,13,1,14
650690,True,0,No user reviews,0,0,0
650700,True,0,No user reviews,0,0,0
650710,True,0,No user reviews,0,0,0
650720,True,0,1 user reviews,0,1,1
650730,True,0,9 user reviews,4,5,9
650740,True,0,No user reviews,0,0,0
650750,True,6,Mostly Positive,24,7,31
650760,True,6,Mostly Positive,75,22,97
650770,True,0,No user reviews,0,0,0
650780,True,6,Mostly Positive,15,5,20
650790,True,0,No user reviews,0,0,0
650810,True,0,8 user reviews,2,6,8
650820,True,0,3 user reviews,1,2,3
650840,True,0,4 user reviews,3,1,4
650860,True,5,Mixed,22,13,35
650880,True,0,2 user reviews,1,1,2
650900,True,0,No user reviews,0,0,0
650910,True,0,No user reviews,0,0,0
650920,True,0,No user reviews,0,0,0
650930,True,0,No user reviews,0,0,0
650940,True,8,Very Positive,154,31,185
650980,True,0,2 user reviews,1,1,2
650990,True,0,1 user reviews,0,1,1
651010,True,0,4 user reviews,3,1,4
651020,True,5,Mixed,5,6,11
651080,True,0,No user reviews,0,0,0
651090,True,0,No user reviews,0,0,0
651120,True,0,8 user reviews,4,4,8
651130,True,0,8 user reviews,8,0,8
651131,True,0,2 user reviews,2,0,2
651132,True,0,1 user reviews,1,0,1
651140,True,0,No user reviews,0,0,0
651150,True,8,Very Positive,380,79,459
651170,True,0,1 user reviews,0,1,1
651280,True,0,3 user reviews,3,0,3
651310,True,0,No user reviews,0,0,0
651320,True,0,No user reviews,0,0,0
651340,True,6,Mostly Positive,14,4,18
651360,True,0,5 user reviews,5,0,5
651370,True,0,No user reviews,0,0,0
651380,True,7,Positive,31,0,31
651400,True,0,No user reviews,0,0,0
651410,True,0,No user reviews,0,0,0
651430,True,0,No user reviews,0,0,0
651440,True,4,Mostly Negative,33,65,98
651450,True,0,No user reviews,0,0,0
651460,True,0,No user reviews,0,0,0
651470,True,0,1 user reviews,1,0,1
651480,True,0,1 user reviews,1,0,1
651481,True,0,2 user reviews,2,0,2
651490,True,0,No user reviews,0,0,0
651500,True,8,Very Positive,45,5,50
651510,True,0,1 user reviews,1,0,1
651520,True,0,3 user reviews,1,2,3
651530,True,0,No user reviews,0,0,0
651550,True,7,Positive,9,2,11
651560,True,0,No user reviews,0,0,0
651610,True,0,No user reviews,0,0,0
651630,True,0,No user reviews,0,0,0
651640,True,0,8 user reviews,8,0,8
651650,True,0,4 user reviews,2,2,4
651660,True,8,Very Positive,283,56,339
651670,True,8,Very Positive,393,75,468
651680,True,5,Mixed,11,6,17
651690,True,0,3 user reviews,2,1,3
651820,True,0,1 user reviews,1,0,1
651930,True,0,No user reviews,0,0,0
651940,True,0,No user reviews,0,0,0
651970,True,0,3 user reviews,2,1,3
651990,True,0,No user reviews,0,0,0
652000,True,0,4 user reviews,3,1,4
652030,True,0,No user reviews,0,0,0
652040,True,0,3 user reviews,3,0,3
652050,True,7,Positive,11,2,13
652060,True,0,1 user reviews,0,1,1
652070,True,0,1 user reviews,0,1,1
652090,True,0,3 user reviews,3,0,3
652120,True,0,4 user reviews,3,1,4
652130,True,0,3 user reviews,3,0,3
652140,True,0,No user reviews,0,0,0
652150,True,8,Very Positive,61,2,63
652160,True,0,No user reviews,0,0,0
652180,True,0,2 user reviews,0,2,2
652190,True,8,Very Positive,75,11,86
652200,True,0,3 user reviews,3,0,3
652220,True,0,No user reviews,0,0,0
652230,True,0,5 user reviews,1,4,5
652250,True,0,No user reviews,0,0,0
652270,True,0,No user reviews,0,0,0
652280,True,0,2 user reviews,0,2,2
652310,True,0,1 user reviews,1,0,1
652330,True,0,No user reviews,0,0,0
652340,True,7,Positive,28,0,28
652350,True,0,No user reviews,0,0,0
652360,True,7,Positive,12,2,14
652390,True,0,1 user reviews,0,1,1
652410,True,8,Very Positive,83,6,89
652440,True,0,No user reviews,0,0,0
652460,True,0,3 user reviews,2,1,3
652470,True,0,2 user reviews,1,1,2
652480,True,0,No user reviews,0,0,0
652490,True,0,1 user reviews,1,0,1
652491,True,0,1 user reviews,0,1,1
652510,True,0,7 user reviews,7,0,7
652520,True,0,No user reviews,0,0,0
652530,True,0,4 user reviews,4,0,4
652540,True,0,6 user reviews,3,3,6
652550,True,0,2 user reviews,0,2,2
652560,True,0,5 user reviews,3,2,5
652570,True,7,Positive,23,2,25
652600,True,5,Mixed,11,6,17
652610,True,0,3 user reviews,3,0,3
652620,True,0,No user reviews,0,0,0
652660,True,4,Mostly Negative,12,27,39
652700,True,7,Positive,10,0,10
652730,True,0,No user reviews,0,0,0
652750,True,0,7 user reviews,4,3,7
652760,True,0,5 user reviews,5,0,5
652770,True,0,No user reviews,0,0,0
652780,True,0,No user reviews,0,0,0
652800,True,7,Positive,18,1,19
652810,True,7,Positive,21,0,21
652830,True,0,9 user reviews,5,4,9
652840,True,0,No user reviews,0,0,0
652880,True,0,9 user reviews,8,1,9
652890,True,7,Positive,13,2,15
652900,True,0,No user reviews,0,0,0
652910,True,0,2 user reviews,2,0,2
652930,True,0,No user reviews,0,0,0
652931,True,0,No user reviews,0,0,0
652932,True,0,No user reviews,0,0,0
652940,True,0,No user reviews,0,0,0
652950,True,8,Very Positive,82,3,85
652960,True,8,Very Positive,143,19,162
652980,True,0,No user reviews,0,0,0
652990,True,0,No user reviews,0,0,0
653000,True,0,No user reviews,0,0,0
653050,True,0,6 user reviews,3,3,6
653080,True,0,5 user reviews,4,1,5
653090,True,0,No user reviews,0,0,0
653100,True,0,1 user reviews,1,0,1
653120,True,0,No user reviews,0,0,0
653130,True,0,No user reviews,0,0,0
653150,True,0,No user reviews,0,0,0
653170,True,0,No user reviews,0,0,0
653171,True,0,No user reviews,0,0,0
653172,True,0,No user reviews,0,0,0
653173,True,0,No user reviews,0,0,0
653190,True,7,Positive,10,2,12
653200,True,0,1 user reviews,1,0,1
653210,True,0,6 user reviews,3,3,6
653220,True,0,No user reviews,0,0,0
653230,True,0,4 user reviews,4,0,4
653240,True,0,No user reviews,0,0,0
653250,True,0,No user reviews,0,0,0
653260,True,0,No user reviews,0,0,0
653270,True,0,No user reviews,0,0,0
653280,True,0,No user reviews,0,0,0
653290,True,0,No user reviews,0,0,0
653300,True,0,No user reviews,0,0,0
653320,True,0,No user reviews,0,0,0
653330,True,0,No user reviews,0,0,0
653340,True,0,No user reviews,0,0,0
653350,True,0,No user reviews,0,0,0
653360,True,0,No user reviews,0,0,0
653380,True,0,No user reviews,0,0,0
653390,True,0,No user reviews,0,0,0
653400,True,0,No user reviews,0,0,0
653410,True,0,No user reviews,0,0,0
653420,True,0,No user reviews,0,0,0
653430,True,0,No user reviews,0,0,0
653440,True,0,No user reviews,0,0,0
653450,True,0,No user reviews,0,0,0
653460,True,0,No user reviews,0,0,0
653470,True,0,No user reviews,0,0,0
653480,True,0,No user reviews,0,0,0
653490,True,0,No user reviews,0,0,0
653500,True,0,No user reviews,0,0,0
653530,True,9,Overwhelmingly Positive,6195,215,6410
653550,True,0,No user reviews,0,0,0
653560,True,0,No user reviews,0,0,0
653570,True,0,No user reviews,0,0,0
653580,True,7,Positive,11,0,11
653720,True,0,3 user reviews,1,2,3
653721,True,0,1 user reviews,1,0,1
653722,True,0,2 user reviews,2,0,2
653723,True,0,1 user reviews,1,0,1
653724,True,0,5 user reviews,3,2,5
653725,True,0,2 user reviews,2,0,2
653726,True,0,2 user reviews,2,0,2
653727,True,0,1 user reviews,1,0,1
653728,True,0,8 user reviews,2,6,8
653730,True,0,No user reviews,0,0,0
653740,True,0,No user reviews,0,0,0
653750,True,0,No user reviews,0,0,0
653760,True,0,9 user reviews,4,5,9
653770,True,0,2 user reviews,2,0,2
653780,True,0,4 user reviews,2,2,4
653790,True,0,No user reviews,0,0,0
653840,True,0,No user reviews,0,0,0
653850,True,0,No user reviews,0,0,0
653860,True,0,No user reviews,0,0,0
653861,True,0,No user reviews,0,0,0
653870,True,0,1 user reviews,0,1,1
653890,True,0,2 user reviews,1,1,2
653891,True,0,No user reviews,0,0,0
653892,True,0,1 user reviews,1,0,1
653920,True,0,1 user reviews,1,0,1
653930,True,8,Very Positive,174,11,185
653940,True,6,Mostly Positive,56,19,75
653950,True,8,Very Positive,59,2,61
653960,True,0,1 user reviews,1,0,1
653970,True,0,5 user reviews,4,1,5
654000,True,0,4 user reviews,4,0,4
654010,True,0,3 user reviews,3,0,3
654020,True,0,8 user reviews,6,2,8
654050,True,8,Very Positive,187,25,212
654060,True,0,No user reviews,0,0,0
654070,True,0,9 user reviews,5,4,9
654080,True,0,1 user reviews,1,0,1
654090,True,6,Mostly Positive,24,8,32
654100,True,7,Positive,20,1,21
654110,True,0,No user reviews,0,0,0
654120,True,0,8 user reviews,5,3,8
654140,True,0,1 user reviews,1,0,1
654170,True,0,No user reviews,0,0,0
654171,True,0,No user reviews,0,0,0
654172,True,8,Very Positive,55,4,59
654174,True,0,No user reviews,0,0,0
654180,True,0,No user reviews,0,0,0
654181,True,7,Positive,14,2,16
654183,True,0,3 user reviews,3,0,3
654185,True,0,2 user reviews,2,0,2
654186,True,0,2 user reviews,2,0,2
654187,True,0,No user reviews,0,0,0
654188,True,0,1 user reviews,1,0,1
654189,True,0,No user reviews,0,0,0
654190,True,0,1 user reviews,1,0,1
654200,True,0,No user reviews,0,0,0
654220,True,8,Very Positive,55,9,64
654230,True,0,No user reviews,0,0,0
654240,True,0,2 user reviews,1,1,2
654250,True,5,Mixed,9,6,15
654260,True,0,5 user reviews,5,0,5
654270,True,0,No user reviews,0,0,0
654280,True,0,No user reviews,0,0,0
654300,True,4,Mostly Negative,12,20,32
654310,True,0,No user reviews,0,0,0
654330,True,0,No user reviews,0,0,0
654340,True,0,No user reviews,0,0,0
654350,True,4,Mostly Negative,10,16,26
654360,True,0,No user reviews,0,0,0
654390,True,0,1 user reviews,0,1,1
654400,True,7,Positive,18,1,19
654430,True,7,Positive,19,2,21
654440,True,6,Mostly Positive,45,14,59
654450,True,0,2 user reviews,0,2,2
654460,True,0,No user reviews,0,0,0
654470,True,5,Mixed,23,14,37
654500,True,7,Positive,21,0,21
654520,True,0,5 user reviews,5,0,5
654540,True,0,1 user reviews,1,0,1
654550,True,8,Very Positive,82,10,92
654570,True,0,7 user reviews,5,2,7
654580,True,7,Positive,14,0,14
654590,True,0,No user reviews,0,0,0
654600,True,0,9 user reviews,8,1,9
654610,True,5,Mixed,14,8,22
654630,True,0,No user reviews,0,0,0
654640,True,0,2 user reviews,2,0,2
654660,True,5,Mixed,6,7,13
654670,True,0,7 user reviews,7,0,7
654680,True,0,No user reviews,0,0,0
654690,True,5,Mixed,144,75,219
654700,True,0,4 user reviews,2,2,4
654710,True,5,Mixed,5,6,11
654740,True,0,8 user reviews,5,3,8
654750,True,0,4 user reviews,2,2,4
654770,True,7,Positive,17,0,17
654800,True,0,4 user reviews,2,2,4
654810,True,7,Positive,20,0,20
654820,True,0,1 user reviews,1,0,1
654840,True,0,1 user reviews,1,0,1
654850,True,6,Mostly Positive,107,43,150
654880,True,8,Very Positive,2965,312,3277
654890,True,6,Mostly Positive,269,84,353
654900,True,8,Very Positive,149,17,166
654910,True,7,Positive,25,0,25
654940,True,0,3 user reviews,0,3,3
654950,True,0,4 user reviews,0,4,4
654960,True,0,No user reviews,0,0,0
654970,True,0,3 user reviews,1,2,3
654980,True,0,1 user reviews,0,1,1
654990,True,5,Mixed,203,212,415
655000,True,5,Mixed,14,7,21
655020,True,5,Mixed,18,9,27
655030,True,0,5 user reviews,5,0,5
655040,True,0,5 user reviews,3,2,5
655060,True,0,No user reviews,0,0,0
655061,True,0,No user reviews,0,0,0
655062,True,0,No user reviews,0,0,0
655063,True,0,No user reviews,0,0,0
655064,True,0,No user reviews,0,0,0
655065,True,0,No user reviews,0,0,0
655066,True,0,No user reviews,0,0,0
655067,True,0,No user reviews,0,0,0
655068,True,0,No user reviews,0,0,0
655069,True,0,No user reviews,0,0,0
655070,True,0,No user reviews,0,0,0
655071,True,0,No user reviews,0,0,0
655080,True,8,Very Positive,56,12,68
655100,True,6,Mostly Positive,77,24,101
655110,True,0,No user reviews,0,0,0
655120,True,3,Negative,2,9,11
655160,True,0,No user reviews,0,0,0
655170,True,0,No user reviews,0,0,0
655180,True,0,3 user reviews,3,0,3
655200,True,0,3 user reviews,3,0,3
655220,True,0,1 user reviews,1,0,1
655250,True,0,1 user reviews,0,1,1
655270,True,6,Mostly Positive,22,9,31
655280,True,0,3 user reviews,3,0,3
655290,True,5,Mixed,117,74,191
655330,True,0,No user reviews,0,0,0
655340,True,0,No user reviews,0,0,0
655360,True,0,2 user reviews,2,0,2
655370,True,7,Positive,13,1,14
655380,True,7,Positive,30,4,34
655420,True,7,Positive,9,1,10
655430,True,0,7 user reviews,4,3,7
655440,True,0,2 user reviews,1,1,2
655460,True,5,Mixed,6,7,13
655480,True,8,Very Positive,168,6,174
655490,True,0,2 user reviews,2,0,2
655500,True,8,Very Positive,358,35,393
655520,True,0,No user reviews,0,0,0
655550,True,0,No user reviews,0,0,0
655560,True,0,1 user reviews,1,0,1
655561,True,0,No user reviews,0,0,0
655562,True,0,No user reviews,0,0,0
655563,True,0,No user reviews,0,0,0
655564,True,0,No user reviews,0,0,0
655565,True,0,No user reviews,0,0,0
655566,True,0,No user reviews,0,0,0
655567,True,0,No user reviews,0,0,0
655568,True,0,No user reviews,0,0,0
655569,True,0,No user reviews,0,0,0
655570,True,0,No user reviews,0,0,0
655571,True,0,1 user reviews,1,0,1
655580,True,0,3 user reviews,3,0,3
655600,True,0,No user reviews,0,0,0
655610,True,3,Negative,1,9,10
655620,True,0,1 user reviews,1,0,1
655630,True,0,1 user reviews,1,0,1
655640,True,0,No user reviews,0,0,0
655650,True,0,1 user reviews,1,0,1
655660,True,0,8 user reviews,6,2,8
655670,True,0,No user reviews,0,0,0
655680,True,0,No user reviews,0,0,0
655681,True,0,No user reviews,0,0,0
655682,True,0,No user reviews,0,0,0
655683,True,0,No user reviews,0,0,0
655684,True,0,No user reviews,0,0,0
655685,True,0,No user reviews,0,0,0
655686,True,0,No user reviews,0,0,0
655687,True,0,No user reviews,0,0,0
655688,True,0,No user reviews,0,0,0
655689,True,0,No user reviews,0,0,0
655690,True,0,No user reviews,0,0,0
655691,True,0,No user reviews,0,0,0
655700,True,0,No user reviews,0,0,0
655710,True,0,9 user reviews,2,7,9
655730,True,8,Very Positive,132,32,164
655740,True,0,No user reviews,0,0,0
655760,True,0,6 user reviews,5,1,6
655770,True,8,Very Positive,172,6,178
655780,True,5,Mixed,142,71,213
655790,True,5,Mixed,85,45,130
655800,True,0,3 user reviews,3,0,3
655801,True,0,1 user reviews,1,0,1
655802,True,0,No user reviews,0,0,0
655803,True,0,No user reviews,0,0,0
655804,True,0,No user reviews,0,0,0
655805,True,0,No user reviews,0,0,0
655806,True,0,No user reviews,0,0,0
655807,True,0,No user reviews,0,0,0
655808,True,0,No user reviews,0,0,0
655809,True,0,No user reviews,0,0,0
655810,True,0,No user reviews,0,0,0
655811,True,0,No user reviews,0,0,0
655840,True,0,No user reviews,0,0,0
655890,True,0,No user reviews,0,0,0
655891,True,0,No user reviews,0,0,0
655892,True,0,No user reviews,0,0,0
655893,True,0,No user reviews,0,0,0
655894,True,0,No user reviews,0,0,0
655895,True,0,No user reviews,0,0,0
655896,True,0,No user reviews,0,0,0
655897,True,0,No user reviews,0,0,0
655898,True,0,No user reviews,0,0,0
655899,True,0,No user reviews,0,0,0
655900,True,0,No user reviews,0,0,0
655901,True,0,No user reviews,0,0,0
655910,True,7,Positive,21,1,22
655920,True,0,No user reviews,0,0,0
655930,True,0,2 user reviews,1,1,2
655940,True,0,5 user reviews,3,2,5
655950,True,0,1 user reviews,1,0,1
655960,True,0,No user reviews,0,0,0
655961,True,0,No user reviews,0,0,0
655962,True,0,No user reviews,0,0,0
655963,True,0,No user reviews,0,0,0
655964,True,0,No user reviews,0,0,0
655965,True,0,No user reviews,0,0,0
655966,True,0,No user reviews,0,0,0
655967,True,0,No user reviews,0,0,0
655968,True,0,No user reviews,0,0,0
655969,True,0,No user reviews,0,0,0
655970,True,0,No user reviews,0,0,0
655971,True,0,No user reviews,0,0,0
655980,True,0,5 user reviews,2,3,5
656000,True,0,No user reviews,0,0,0
656001,True,0,No user reviews,0,0,0
656002,True,0,No user reviews,0,0,0
656003,True,0,No user reviews,0,0,0
656004,True,0,No user reviews,0,0,0
656005,True,0,No user reviews,0,0,0
656006,True,0,No user reviews,0,0,0
656007,True,0,No user reviews,0,0,0
656008,True,0,No user reviews,0,0,0
656009,True,0,No user reviews,0,0,0
656010,True,0,No user reviews,0,0,0
656011,True,0,No user reviews,0,0,0
656020,True,0,1 user reviews,1,0,1
656030,True,5,Mixed,42,22,64
656040,True,7,Positive,21,5,26
656060,True,0,4 user reviews,2,2,4
656070,True,0,No user reviews,0,0,0
656120,True,0,No user reviews,0,0,0
656130,True,0,No user reviews,0,0,0
656140,True,5,Mixed,14,7,21
656150,True,0,No user reviews,0,0,0
656151,True,0,No user reviews,0,0,0
656152,True,0,No user reviews,0,0,0
656153,True,0,No user reviews,0,0,0
656154,True,0,No user reviews,0,0,0
656155,True,0,No user reviews,0,0,0
656156,True,0,No user reviews,0,0,0
656157,True,0,No user reviews,0,0,0
656158,True,0,No user reviews,0,0,0
656159,True,0,No user reviews,0,0,0
656160,True,0,No user reviews,0,0,0
656161,True,0,No user reviews,0,0,0
656170,True,0,No user reviews,0,0,0
656190,True,0,6 user reviews,5,1,6
656200,True,5,Mixed,72,48,120
656210,True,5,Mixed,25,15,40
656220,True,0,3 user reviews,0,3,3
656240,True,5,Mixed,617,635,1252
656260,True,0,5 user reviews,4,1,5
656280,True,0,No user reviews,0,0,0
656300,True,0,2 user reviews,0,2,2
656320,True,0,1 user reviews,1,0,1
656330,True,0,No user reviews,0,0,0
656340,True,0,3 user reviews,1,2,3
656350,True,8,Very Positive,2229,165,2394
656360,True,0,4 user reviews,2,2,4
656380,True,0,No user reviews,0,0,0
656400,True,6,Mostly Positive,10,4,14
656420,True,0,No user reviews,0,0,0
656440,True,5,Mixed,5,5,10
656450,True,5,Mixed,9,6,15
656460,True,5,Mixed,30,20,50
656480,True,0,6 user reviews,4,2,6
656490,True,5,Mixed,14,9,23
656510,True,5,Mixed,26,22,48
656530,True,2,Very Negative,11,82,93
656540,True,0,No user reviews,0,0,0
656550,True,7,Positive,24,2,26
656560,True,5,Mixed,8,6,14
656570,True,6,Mostly Positive,9,3,12
656580,True,0,2 user reviews,1,1,2
656590,True,5,Mixed,27,13,40
656600,True,5,Mixed,78,37,115
656610,True,4,Mostly Negative,11,31,42
656620,True,0,No user reviews,0,0,0
656630,True,0,5 user reviews,4,1,5
656640,True,0,No user reviews,0,0,0
656660,True,0,4 user reviews,4,0,4
656670,True,0,No user reviews,0,0,0
656680,True,0,3 user reviews,2,1,3
656690,True,0,4 user reviews,3,1,4
656700,True,5,Mixed,122,56,178
656730,True,0,2 user reviews,0,2,2
656740,True,7,Positive,34,4,38
656760,True,0,No user reviews,0,0,0
656770,True,0,No user reviews,0,0,0
656780,True,0,2 user reviews,0,2,2
656810,True,0,5 user reviews,4,1,5
656820,True,0,No user reviews,0,0,0
656830,True,0,No user reviews,0,0,0
656840,True,0,No user reviews,0,0,0
656870,True,0,1 user reviews,0,1,1
656880,True,7,Positive,22,5,27
656890,True,0,1 user reviews,1,0,1
656900,True,7,Positive,20,3,23
656910,True,0,2 user reviews,1,1,2
656940,True,0,1 user reviews,0,1,1
656970,True,8,Very Positive,70,7,77
656990,True,0,No user reviews,0,0,0
657000,True,7,Positive,41,2,43
657010,True,0,No user reviews,0,0,0
657020,True,0,2 user reviews,2,0,2
657040,True,7,Positive,32,4,36
657050,True,0,No user reviews,0,0,0
657070,True,5,Mixed,13,8,21
657080,True,0,No user reviews,0,0,0
657090,True,5,Mixed,54,31,85
657110,True,0,2 user reviews,1,1,2
657120,True,7,Positive,22,5,27
657130,True,0,No user reviews,0,0,0
657140,True,0,No user reviews,0,0,0
657150,True,0,No user reviews,0,0,0
657160,True,0,No user reviews,0,0,0
657170,True,0,1 user reviews,1,0,1
657180,True,0,2 user reviews,2,0,2
657190,True,0,No user reviews,0,0,0
657200,True,8,Very Positive,5366,1118,6484
657210,True,0,No user reviews,0,0,0
657230,True,0,2 user reviews,1,1,2
657240,True,8,Very Positive,422,31,453
657250,True,0,No user reviews,0,0,0
657260,True,7,Positive,12,0,12
657270,True,0,No user reviews,0,0,0
657280,True,8,Very Positive,71,13,84
657290,True,7,Positive,25,6,31
657300,True,7,Positive,10,0,10
657320,True,0,1 user reviews,1,0,1
657350,True,7,Positive,12,0,12
657360,True,0,No user reviews,0,0,0
657361,True,0,No user reviews,0,0,0
657400,True,0,1 user reviews,1,0,1
657410,True,0,No user reviews,0,0,0
657420,True,0,No user reviews,0,0,0
657421,True,0,No user reviews,0,0,0
657422,True,0,6 user reviews,4,2,6
657423,True,0,4 user reviews,4,0,4
657424,True,0,8 user reviews,7,1,8
657430,True,7,Positive,12,1,13
657431,True,0,5 user reviews,5,0,5
657440,True,6,Mostly Positive,15,4,19
657450,True,0,No user reviews,0,0,0
657470,True,4,Mostly Negative,10,19,29
657480,True,0,No user reviews,0,0,0
657500,True,0,7 user reviews,4,3,7
657510,True,7,Positive,23,1,24
657530,True,5,Mixed,7,10,17
657550,True,0,5 user reviews,4,1,5
657560,True,0,2 user reviews,1,1,2
657580,True,0,No user reviews,0,0,0
657590,True,5,Mixed,8,10,18
657610,True,0,8 user reviews,8,0,8
657611,True,0,No user reviews,0,0,0
657612,True,0,2 user reviews,2,0,2
657613,True,0,No user reviews,0,0,0
657614,True,0,No user reviews,0,0,0
657615,True,0,No user reviews,0,0,0
657616,True,0,No user reviews,0,0,0
657617,True,0,No user reviews,0,0,0
657618,True,0,No user reviews,0,0,0
657619,True,0,1 user reviews,1,0,1
657620,True,0,No user reviews,0,0,0
657621,True,0,1 user reviews,1,0,1
657630,True,8,Very Positive,205,30,235
657660,True,0,No user reviews,0,0,0
657690,True,8,Very Positive,180,8,188
657700,True,5,Mixed,9,4,13
657730,True,7,Positive,42,6,48
657750,True,0,No user reviews,0,0,0
657751,True,0,No user reviews,0,0,0
657752,True,0,No user reviews,0,0,0
657753,True,0,No user reviews,0,0,0
657754,True,0,No user reviews,0,0,0
657755,True,0,No user reviews,0,0,0
657756,True,0,No user reviews,0,0,0
657757,True,0,No user reviews,0,0,0
657758,True,0,No user reviews,0,0,0
657759,True,0,No user reviews,0,0,0
657760,True,0,No user reviews,0,0,0
657761,True,0,No user reviews,0,0,0
657780,True,0,4 user reviews,2,2,4
657790,True,0,8 user reviews,3,5,8
657810,True,5,Mixed,15,7,22
657840,True,0,No user reviews,0,0,0
657841,True,0,No user reviews,0,0,0
657842,True,0,No user reviews,0,0,0
657843,True,0,No user reviews,0,0,0
657844,True,0,No user reviews,0,0,0
657845,True,0,No user reviews,0,0,0
657846,True,0,No user reviews,0,0,0
657847,True,0,No user reviews,0,0,0
657848,True,0,No user reviews,0,0,0
657849,True,0,No user reviews,0,0,0
657850,True,0,No user reviews,0,0,0
657851,True,0,No user reviews,0,0,0
657852,True,0,No user reviews,0,0,0
657860,True,0,No user reviews,0,0,0
657900,True,7,Positive,30,7,37
657910,True,0,No user reviews,0,0,0
657911,True,0,No user reviews,0,0,0
657912,True,0,No user reviews,0,0,0
657913,True,0,No user reviews,0,0,0
657914,True,0,No user reviews,0,0,0
657915,True,0,No user reviews,0,0,0
657916,True,0,No user reviews,0,0,0
657917,True,0,No user reviews,0,0,0
657918,True,0,No user reviews,0,0,0
657919,True,0,No user reviews,0,0,0
657920,True,0,No user reviews,0,0,0
657921,True,0,No user reviews,0,0,0
657930,True,7,Positive,25,1,26
657960,True,0,No user reviews,0,0,0
657970,True,0,No user reviews,0,0,0
657971,True,0,No user reviews,0,0,0
657972,True,0,No user reviews,0,0,0
657973,True,0,No user reviews,0,0,0
657974,True,0,No user reviews,0,0,0
657975,True,0,No user reviews,0,0,0
657976,True,0,No user reviews,0,0,0
657977,True,0,No user reviews,0,0,0
657978,True,0,No user reviews,0,0,0
657979,True,0,No user reviews,0,0,0
657980,True,0,No user reviews,0,0,0
657981,True,0,No user reviews,0,0,0
657982,True,0,No user reviews,0,0,0
657990,True,5,Mixed,36,37,73
658000,True,6,Mostly Positive,9,3,12
658001,True,0,8 user reviews,3,5,8
658010,True,0,No user reviews,0,0,0
658011,True,0,No user reviews,0,0,0
658012,True,0,No user reviews,0,0,0
658013,True,0,No user reviews,0,0,0
658014,True,0,No user reviews,0,0,0
658015,True,0,No user reviews,0,0,0
658016,True,0,No user reviews,0,0,0
658017,True,0,No user reviews,0,0,0
658018,True,0,No user reviews,0,0,0
658019,True,0,No user reviews,0,0,0
658020,True,0,No user reviews,0,0,0
658021,True,0,No user reviews,0,0,0
658022,True,0,No user reviews,0,0,0
658030,True,0,No user reviews,0,0,0
658031,True,0,No user reviews,0,0,0
658032,True,0,No user reviews,0,0,0
658033,True,0,No user reviews,0,0,0
658034,True,0,No user reviews,0,0,0
658035,True,0,No user reviews,0,0,0
658036,True,0,No user reviews,0,0,0
658037,True,0,No user reviews,0,0,0
658038,True,0,No user reviews,0,0,0
658039,True,0,No user reviews,0,0,0
658040,True,0,No user reviews,0,0,0
658041,True,0,No user reviews,0,0,0
658050,True,7,Positive,25,1,26
658060,True,5,Mixed,12,6,18
658090,True,0,3 user reviews,1,2,3
658110,True,0,No user reviews,0,0,0
658111,True,0,No user reviews,0,0,0
658112,True,0,No user reviews,0,0,0
658113,True,0,No user reviews,0,0,0
658114,True,0,No user reviews,0,0,0
658115,True,0,No user reviews,0,0,0
658116,True,0,No user reviews,0,0,0
658120,True,5,Mixed,7,8,15
658130,True,0,No user reviews,0,0,0
658131,True,0,No user reviews,0,0,0
658132,True,0,No user reviews,0,0,0
658133,True,0,No user reviews,0,0,0
658134,True,0,No user reviews,0,0,0
658135,True,0,No user reviews,0,0,0
658136,True,0,No user reviews,0,0,0
658137,True,0,No user reviews,0,0,0
658140,True,7,Positive,11,2,13
658150,True,7,Positive,42,1,43
658160,True,8,Very Positive,140,28,168
658210,True,0,3 user reviews,3,0,3
658230,True,7,Positive,9,1,10
658250,True,0,No user reviews,0,0,0
658260,True,8,Very Positive,169,35,204
658270,True,0,No user reviews,0,0,0
658271,True,0,No user reviews,0,0,0
658272,True,0,No user reviews,0,0,0
658273,True,0,No user reviews,0,0,0
658274,True,0,No user reviews,0,0,0
658275,True,0,No user reviews,0,0,0
658276,True,0,No user reviews,0,0,0
658277,True,0,1 user reviews,1,0,1
658278,True,0,No user reviews,0,0,0
658279,True,0,No user reviews,0,0,0
658280,True,0,No user reviews,0,0,0
658290,True,0,No user reviews,0,0,0
658291,True,0,No user reviews,0,0,0
658292,True,0,No user reviews,0,0,0
658293,True,0,No user reviews,0,0,0
658294,True,0,No user reviews,0,0,0
658295,True,0,No user reviews,0,0,0
658296,True,0,No user reviews,0,0,0
658297,True,0,No user reviews,0,0,0
658298,True,0,No user reviews,0,0,0
658299,True,0,No user reviews,0,0,0
658300,True,0,No user reviews,0,0,0
658301,True,0,No user reviews,0,0,0
658302,True,0,No user reviews,0,0,0
658303,True,0,No user reviews,0,0,0
658304,True,0,No user reviews,0,0,0
658305,True,0,No user reviews,0,0,0
658306,True,0,No user reviews,0,0,0
658320,True,0,No user reviews,0,0,0
658330,True,7,Positive,10,1,11
658340,True,0,No user reviews,0,0,0
658360,True,0,No user reviews,0,0,0
658390,True,0,1 user reviews,0,1,1
658400,True,0,6 user reviews,6,0,6
658410,True,0,No user reviews,0,0,0
658420,True,0,3 user reviews,2,1,3
658430,True,5,Mixed,6,7,13
658440,True,0,No user reviews,0,0,0
658450,True,0,4 user reviews,2,2,4
658460,True,0,No user reviews,0,0,0
658470,True,6,Mostly Positive,38,16,54
658480,True,0,No user reviews,0,0,0
658490,True,5,Mixed,28,13,41
658500,True,7,Positive,24,1,25
658510,True,0,No user reviews,0,0,0
658530,True,7,Positive,18,0,18
658550,True,8,Very Positive,116,11,127
658560,True,8,Very Positive,299,18,317
658570,True,6,Mostly Positive,354,109,463
658590,True,8,Very Positive,46,9,55
658600,True,8,Very Positive,112,14,126
658610,True,0,1 user reviews,0,1,1
658620,True,8,Very Positive,237,11,248
658630,True,0,5 user reviews,4,1,5
658640,True,0,No user reviews,0,0,0
658650,True,0,No user reviews,0,0,0
658660,True,6,Mostly Positive,8,3,11
658670,True,0,1 user reviews,0,1,1
658690,True,7,Positive,29,1,30
658700,True,5,Mixed,39,17,56
658710,True,0,No user reviews,0,0,0
658720,True,0,1 user reviews,1,0,1
658760,True,0,2 user reviews,2,0,2
658770,True,0,4 user reviews,3,1,4
658780,True,8,Very Positive,54,10,64
658790,True,0,9 user reviews,6,3,9
658800,True,0,9 user reviews,8,1,9
658810,True,0,5 user reviews,5,0,5
658820,True,0,No user reviews,0,0,0
658830,True,5,Mixed,18,11,29
658850,True,8,Very Positive,718,82,800
658860,True,0,No user reviews,0,0,0
658870,True,0,1 user reviews,1,0,1
658880,True,0,No user reviews,0,0,0
658900,True,0,2 user reviews,2,0,2
658910,True,0,5 user reviews,4,1,5
658960,True,0,No user reviews,0,0,0
658961,True,0,No user reviews,0,0,0
658962,True,0,No user reviews,0,0,0
658963,True,0,No user reviews,0,0,0
658964,True,0,No user reviews,0,0,0
658965,True,0,No user reviews,0,0,0
658966,True,0,No user reviews,0,0,0
658967,True,0,No user reviews,0,0,0
658968,True,0,No user reviews,0,0,0
658969,True,0,No user reviews,0,0,0
658970,True,0,No user reviews,0,0,0
658980,True,5,Mixed,166,148,314
658990,True,0,8 user reviews,8,0,8
659000,True,0,No user reviews,0,0,0
659040,True,0,9 user reviews,8,1,9
659060,True,0,2 user reviews,2,0,2
659110,True,6,Mostly Positive,24,7,31
659120,True,4,Mostly Negative,9,19,28
659130,True,5,Mixed,10,8,18
659140,True,0,No user reviews,0,0,0
659150,True,0,No user reviews,0,0,0
659160,True,0,2 user reviews,0,2,2
659170,True,0,1 user reviews,1,0,1
659180,True,0,4 user reviews,4,0,4
659190,True,5,Mixed,77,34,111
659220,True,0,4 user reviews,4,0,4
659230,True,0,No user reviews,0,0,0
659260,True,0,7 user reviews,7,0,7
659290,True,5,Mixed,7,6,13
659310,True,0,No user reviews,0,0,0
659320,True,0,No user reviews,0,0,0
659330,True,0,No user reviews,0,0,0
659360,True,0,No user reviews,0,0,0
659390,True,0,1 user reviews,1,0,1
659391,True,0,No user reviews,0,0,0
659392,True,0,No user reviews,0,0,0
659393,True,0,No user reviews,0,0,0
659394,True,0,No user reviews,0,0,0
659395,True,0,No user reviews,0,0,0
659396,True,0,No user reviews,0,0,0
659397,True,0,No user reviews,0,0,0
659398,True,0,No user reviews,0,0,0
659399,True,0,No user reviews,0,0,0
659400,True,0,No user reviews,0,0,0
659401,True,0,No user reviews,0,0,0
659420,True,0,No user reviews,0,0,0
659421,True,0,No user reviews,0,0,0
659422,True,0,No user reviews,0,0,0
659423,True,0,No user reviews,0,0,0
659424,True,0,No user reviews,0,0,0
659425,True,0,No user reviews,0,0,0
659426,True,0,No user reviews,0,0,0
659427,True,0,No user reviews,0,0,0
659428,True,0,No user reviews,0,0,0
659429,True,0,No user reviews,0,0,0
659430,True,0,No user reviews,0,0,0
659431,True,0,No user reviews,0,0,0
659432,True,0,No user reviews,0,0,0
659460,True,0,1 user reviews,1,0,1
659480,True,6,Mostly Positive,74,26,100
659490,True,0,7 user reviews,5,2,7
659500,True,0,No user reviews,0,0,0
659510,True,0,1 user reviews,1,0,1
659540,True,8,Very Positive,362,12,374
659560,True,0,1 user reviews,1,0,1
659570,True,0,1 user reviews,1,0,1
659580,True,0,No user reviews,0,0,0
659590,True,0,No user reviews,0,0,0
659600,True,0,No user reviews,0,0,0
659610,True,0,2 user reviews,0,2,2
659620,True,0,No user reviews,0,0,0
659630,True,0,No user reviews,0,0,0
659640,True,0,No user reviews,0,0,0
659650,True,0,1 user reviews,1,0,1
659660,True,0,No user reviews,0,0,0
659670,True,0,No user reviews,0,0,0
659680,True,0,1 user reviews,1,0,1
659690,True,0,No user reviews,0,0,0
659710,True,0,5 user reviews,5,0,5
659720,True,0,3 user reviews,3,0,3
659760,True,0,No user reviews,0,0,0
659780,True,0,No user reviews,0,0,0
659790,True,0,No user reviews,0,0,0
659800,True,0,No user reviews,0,0,0
659810,True,0,3 user reviews,1,2,3
659830,True,0,3 user reviews,3,0,3
659860,True,0,1 user reviews,1,0,1
659870,True,0,3 user reviews,2,1,3
659890,True,0,6 user reviews,6,0,6
659900,True,0,No user reviews,0,0,0
659910,True,0,1 user reviews,1,0,1
659920,True,5,Mixed,27,14,41
659930,True,7,Positive,9,2,11
659940,True,0,5 user reviews,4,1,5
659950,True,0,6 user reviews,4,2,6
659970,True,0,4 user reviews,4,0,4
659971,True,0,No user reviews,0,0,0
659990,True,0,1 user reviews,0,1,1
660000,True,0,No user reviews,0,0,0
660010,True,0,No user reviews,0,0,0
660030,True,0,4 user reviews,4,0,4
660040,True,0,4 user reviews,4,0,4
660050,True,0,No user reviews,0,0,0
660060,True,0,1 user reviews,1,0,1
660070,True,0,1 user reviews,1,0,1
660080,True,6,Mostly Positive,42,16,58
660090,True,0,No user reviews,0,0,0
660110,True,0,No user reviews,0,0,0
660120,True,0,6 user reviews,0,6,6
660130,True,0,No user reviews,0,0,0
660160,True,8,Very Positive,272,34,306
660170,True,0,2 user reviews,0,2,2
660180,True,4,Mostly Negative,8,25,33
660190,True,0,No user reviews,0,0,0
660220,True,0,No user reviews,0,0,0
660240,True,0,No user reviews,0,0,0
660250,True,0,1 user reviews,0,1,1
660270,True,0,3 user reviews,2,1,3
660280,True,0,1 user reviews,0,1,1
660290,True,0,9 user reviews,5,4,9
660320,True,0,8 user reviews,4,4,8
660330,True,0,No user reviews,0,0,0
660340,True,0,No user reviews,0,0,0
660360,True,0,No user reviews,0,0,0
660361,True,0,No user reviews,0,0,0
660362,True,0,No user reviews,0,0,0
660363,True,0,No user reviews,0,0,0
660364,True,0,No user reviews,0,0,0
660365,True,0,No user reviews,0,0,0
660366,True,0,No user reviews,0,0,0
660367,True,0,No user reviews,0,0,0
660368,True,0,No user reviews,0,0,0
660369,True,0,No user reviews,0,0,0
660370,True,0,No user reviews,0,0,0
660371,True,0,No user reviews,0,0,0
660390,True,0,No user reviews,0,0,0
660400,True,0,No user reviews,0,0,0
660420,True,0,No user reviews,0,0,0
660430,True,0,No user reviews,0,0,0
660431,True,0,No user reviews,0,0,0
660432,True,0,No user reviews,0,0,0
660433,True,0,No user reviews,0,0,0
660434,True,0,No user reviews,0,0,0
660435,True,0,No user reviews,0,0,0
660436,True,0,No user reviews,0,0,0
660437,True,0,No user reviews,0,0,0
660438,True,0,No user reviews,0,0,0
660439,True,0,No user reviews,0,0,0
660440,True,0,No user reviews,0,0,0
660441,True,0,No user reviews,0,0,0
660442,True,0,No user reviews,0,0,0
660450,True,0,No user reviews,0,0,0
660470,True,0,No user reviews,0,0,0
660490,True,0,No user reviews,0,0,0
660491,True,0,No user reviews,0,0,0
660492,True,0,No user reviews,0,0,0
660493,True,0,No user reviews,0,0,0
660494,True,0,No user reviews,0,0,0
660495,True,0,No user reviews,0,0,0
660496,True,0,No user reviews,0,0,0
660497,True,0,No user reviews,0,0,0
660498,True,0,No user reviews,0,0,0
660499,True,0,No user reviews,0,0,0
660500,True,0,No user reviews,0,0,0
660501,True,0,No user reviews,0,0,0
660502,True,0,No user reviews,0,0,0
660520,True,0,No user reviews,0,0,0
660540,True,0,No user reviews,0,0,0
660541,True,0,No user reviews,0,0,0
660542,True,0,No user reviews,0,0,0
660543,True,0,No user reviews,0,0,0
660544,True,0,No user reviews,0,0,0
660545,True,0,No user reviews,0,0,0
660546,True,0,No user reviews,0,0,0
660547,True,0,No user reviews,0,0,0
660548,True,0,No user reviews,0,0,0
660549,True,0,No user reviews,0,0,0
660550,True,0,No user reviews,0,0,0
660551,True,0,No user reviews,0,0,0
660552,True,0,No user reviews,0,0,0
660560,True,0,5 user reviews,3,2,5
660570,True,5,Mixed,8,4,12
660580,True,0,No user reviews,0,0,0
660581,True,0,No user reviews,0,0,0
660582,True,0,No user reviews,0,0,0
660583,True,0,No user reviews,0,0,0
660584,True,0,No user reviews,0,0,0
660585,True,0,No user reviews,0,0,0
660586,True,0,No user reviews,0,0,0
660587,True,0,No user reviews,0,0,0
660588,True,0,No user reviews,0,0,0
660589,True,0,No user reviews,0,0,0
660590,True,0,No user reviews,0,0,0
660591,True,0,No user reviews,0,0,0
660670,True,0,No user reviews,0,0,0
660671,True,0,No user reviews,0,0,0
660672,True,0,No user reviews,0,0,0
660673,True,0,No user reviews,0,0,0
660674,True,0,No user reviews,0,0,0
660675,True,0,No user reviews,0,0,0
660676,True,0,No user reviews,0,0,0
660677,True,0,No user reviews,0,0,0
660678,True,0,No user reviews,0,0,0
660679,True,0,No user reviews,0,0,0
660680,True,0,No user reviews,0,0,0
660681,True,0,No user reviews,0,0,0
660682,True,0,No user reviews,0,0,0
660683,True,0,No user reviews,0,0,0
660684,True,0,No user reviews,0,0,0
660685,True,0,No user reviews,0,0,0
660686,True,0,No user reviews,0,0,0
660687,True,0,No user reviews,0,0,0
660688,True,0,No user reviews,0,0,0
660689,True,0,No user reviews,0,0,0
660690,True,0,No user reviews,0,0,0
660691,True,0,No user reviews,0,0,0
660692,True,0,No user reviews,0,0,0
660693,True,0,No user reviews,0,0,0
660694,True,0,No user reviews,0,0,0
660695,True,0,No user reviews,0,0,0
660696,True,0,No user reviews,0,0,0
660697,True,0,No user reviews,0,0,0
660698,True,0,No user reviews,0,0,0
660699,True,0,No user reviews,0,0,0
660700,True,0,No user reviews,0,0,0
660701,True,0,No user reviews,0,0,0
660730,True,0,8 user reviews,5,3,8
660740,True,0,No user reviews,0,0,0
660760,True,0,1 user reviews,1,0,1
660770,True,0,No user reviews,0,0,0
660800,True,0,No user reviews,0,0,0
660820,True,0,1 user reviews,0,1,1
660830,True,0,No user reviews,0,0,0
660850,True,7,Positive,15,2,17
660860,True,0,No user reviews,0,0,0
660870,True,0,No user reviews,0,0,0
660880,True,0,No user reviews,0,0,0
660900,True,0,2 user reviews,0,2,2
660910,True,0,No user reviews,0,0,0
660920,True,5,Mixed,68,49,117
660930,True,0,2 user reviews,2,0,2
660940,True,0,1 user reviews,0,1,1
660970,True,0,No user reviews,0,0,0
660980,True,0,No user reviews,0,0,0
660990,True,4,Mostly Negative,5,15,20
661000,True,5,Mixed,15,12,27
661030,True,7,Positive,11,0,11
661040,True,5,Mixed,27,17,44
661050,True,0,2 user reviews,2,0,2
661070,True,0,1 user reviews,1,0,1
661100,True,0,1 user reviews,1,0,1
661110,True,0,2 user reviews,1,1,2
661120,True,7,Positive,26,0,26
661130,True,0,No user reviews,0,0,0
661140,True,0,3 user reviews,2,1,3
661141,True,0,No user reviews,0,0,0
661142,True,0,No user reviews,0,0,0
661180,True,0,1 user reviews,0,1,1
661190,True,0,1 user reviews,0,1,1
661200,True,0,6 user reviews,6,0,6
661220,True,0,9 user reviews,9,0,9
661230,True,7,Positive,23,2,25
661240,True,0,4 user reviews,4,0,4
661250,True,0,No user reviews,0,0,0
661260,True,0,No user reviews,0,0,0
661270,True,0,2 user reviews,2,0,2
661280,True,6,Mostly Positive,51,14,65
661290,True,6,Mostly Positive,83,30,113
661300,True,0,7 user reviews,6,1,7
661310,True,0,No user reviews,0,0,0
661311,True,0,No user reviews,0,0,0
661312,True,0,No user reviews,0,0,0
661313,True,0,1 user reviews,1,0,1
661330,True,0,3 user reviews,3,0,3
661340,True,0,3 user reviews,3,0,3
661360,True,0,5 user reviews,5,0,5
661380,True,0,2 user reviews,2,0,2
661410,True,0,1 user reviews,0,1,1
661420,True,0,No user reviews,0,0,0
661430,True,8,Very Positive,108,10,118
661440,True,0,2 user reviews,1,1,2
661450,True,7,Positive,10,0,10
661460,True,0,4 user reviews,3,1,4
661470,True,5,Mixed,10,5,15
661480,True,0,6 user reviews,5,1,6
661490,True,3,Negative,1,9,10
661500,True,7,Positive,14,2,16
661520,True,0,6 user reviews,1,5,6
661530,True,0,No user reviews,0,0,0
661550,True,0,1 user reviews,1,0,1
661560,True,0,2 user reviews,0,2,2
661610,True,0,1 user reviews,0,1,1
661650,True,0,2 user reviews,1,1,2
661660,True,7,Positive,8,2,10
661670,True,0,6 user reviews,3,3,6
661680,True,0,No user reviews,0,0,0
661690,True,0,No user reviews,0,0,0
661700,True,0,No user reviews,0,0,0
661710,True,0,No user reviews,0,0,0
661730,True,0,1 user reviews,1,0,1
661740,True,6,Mostly Positive,33,13,46
661750,True,0,No user reviews,0,0,0
661770,True,0,No user reviews,0,0,0
661790,True,8,Very Positive,615,75,690
661820,True,0,2 user reviews,2,0,2
661830,True,0,No user reviews,0,0,0
661850,True,0,No user reviews,0,0,0
661870,True,0,No user reviews,0,0,0
661890,True,0,No user reviews,0,0,0
661900,True,0,3 user reviews,2,1,3
661920,True,5,Mixed,67,38,105
661940,True,8,Very Positive,107,9,116
661950,True,0,No user reviews,0,0,0
661960,True,0,No user reviews,0,0,0
661970,True,0,7 user reviews,3,4,7
661980,True,0,No user reviews,0,0,0
661990,True,7,Positive,32,4,36
662140,True,0,No user reviews,0,0,0
662150,True,0,No user reviews,0,0,0
662160,True,0,No user reviews,0,0,0
662190,True,7,Positive,37,2,39
662200,True,0,9 user reviews,6,3,9
662210,True,8,Very Positive,199,6,205
662230,True,5,Mixed,24,11,35
662240,True,6,Mostly Positive,43,12,55
662250,True,0,4 user reviews,0,4,4
662260,True,0,1 user reviews,1,0,1
662290,True,0,8 user reviews,8,0,8
662320,True,5,Mixed,14,7,21
662340,True,0,No user reviews,0,0,0
662350,True,6,Mostly Positive,150,41,191
662352,True,5,Mixed,21,13,34
662353,True,4,Mostly Negative,37,69,106
662355,True,0,No user reviews,0,0,0
662356,True,0,No user reviews,0,0,0
662380,True,0,5 user reviews,1,4,5
662390,True,0,No user reviews,0,0,0
662400,True,0,2 user reviews,2,0,2
662410,True,7,Positive,12,0,12
662420,True,0,No user reviews,0,0,0
662440,True,0,No user reviews,0,0,0
662450,True,0,No user reviews,0,0,0
662470,True,0,No user reviews,0,0,0
662490,True,0,No user reviews,0,0,0
662500,True,0,4 user reviews,1,3,4
662540,True,8,Very Positive,67,11,78
662550,True,0,3 user reviews,3,0,3
662570,True,0,No user reviews,0,0,0
662600,True,0,2 user reviews,1,1,2
662610,True,0,No user reviews,0,0,0
662620,True,0,4 user reviews,3,1,4
662660,True,0,2 user reviews,2,0,2
662680,True,7,Positive,17,3,20
662690,True,0,5 user reviews,4,1,5
662700,True,0,No user reviews,0,0,0
662710,True,0,No user reviews,0,0,0
662740,True,0,1 user reviews,1,0,1
662741,True,0,No user reviews,0,0,0
662742,True,0,No user reviews,0,0,0
662743,True,0,No user reviews,0,0,0
662744,True,0,No user reviews,0,0,0
662745,True,0,No user reviews,0,0,0
662746,True,0,No user reviews,0,0,0
662747,True,0,No user reviews,0,0,0
662748,True,0,No user reviews,0,0,0
662749,True,0,No user reviews,0,0,0
662750,True,0,No user reviews,0,0,0
662751,True,0,No user reviews,0,0,0
662760,True,0,2 user reviews,2,0,2
662761,True,0,No user reviews,0,0,0
662762,True,0,No user reviews,0,0,0
662763,True,0,No user reviews,0,0,0
662764,True,0,No user reviews,0,0,0
662765,True,0,No user reviews,0,0,0
662766,True,0,No user reviews,0,0,0
662767,True,0,No user reviews,0,0,0
662768,True,0,No user reviews,0,0,0
662769,True,0,No user reviews,0,0,0
662770,True,0,No user reviews,0,0,0
662771,True,0,No user reviews,0,0,0
662772,True,0,1 user reviews,1,0,1
662780,True,0,1 user reviews,1,0,1
662810,True,0,No user reviews,0,0,0
662811,True,0,No user reviews,0,0,0
662812,True,0,No user reviews,0,0,0
662813,True,0,No user reviews,0,0,0
662814,True,0,No user reviews,0,0,0
662815,True,0,No user reviews,0,0,0
662816,True,0,No user reviews,0,0,0
662817,True,0,No user reviews,0,0,0
662818,True,0,No user reviews,0,0,0
662819,True,0,No user reviews,0,0,0
662820,True,0,No user reviews,0,0,0
662821,True,0,No user reviews,0,0,0
662822,True,0,No user reviews,0,0,0
662830,True,0,No user reviews,0,0,0
662840,True,6,Mostly Positive,17,6,23
662850,True,0,No user reviews,0,0,0
662860,True,0,2 user reviews,2,0,2
662861,True,0,No user reviews,0,0,0
662862,True,0,No user reviews,0,0,0
662863,True,0,No user reviews,0,0,0
662864,True,0,1 user reviews,0,1,1
662865,True,0,1 user reviews,0,1,1
662866,True,0,No user reviews,0,0,0
662870,True,0,No user reviews,0,0,0
662910,True,6,Mostly Positive,20,8,28
662920,True,7,Positive,20,3,23
662930,True,0,9 user reviews,9,0,9
662940,True,0,No user reviews,0,0,0
662950,True,3,Negative,0,13,13
662960,True,6,Mostly Positive,95,33,128
662970,True,5,Mixed,15,7,22
662990,True,0,1 user reviews,1,0,1
663000,True,0,No user reviews,0,0,0
663020,True,0,2 user reviews,0,2,2
663060,True,0,1 user reviews,0,1,1
663070,True,0,No user reviews,0,0,0
663080,True,0,No user reviews,0,0,0
663090,True,5,Mixed,14,16,30
663100,True,0,9 user reviews,8,1,9
663110,True,4,Mostly Negative,13,20,33
663120,True,0,1 user reviews,1,0,1
663130,True,7,Positive,12,2,14
663140,True,0,1 user reviews,1,0,1
663160,True,0,4 user reviews,1,3,4
663170,True,0,1 user reviews,1,0,1
663180,True,0,No user reviews,0,0,0
663190,True,5,Mixed,17,10,27
663200,True,5,Mixed,17,17,34
663210,True,7,Positive,32,3,35
663220,True,0,No user reviews,0,0,0
663230,True,0,1 user reviews,1,0,1
663240,True,8,Very Positive,61,11,72
663250,True,0,1 user reviews,0,1,1
663270,True,0,No user reviews,0,0,0
663280,True,0,3 user reviews,2,1,3
663290,True,0,7 user reviews,1,6,7
663300,True,5,Mixed,25,20,45
663310,True,0,No user reviews,0,0,0
663360,True,0,No user reviews,0,0,0
663370,True,7,Positive,22,2,24
663380,True,6,Mostly Positive,765,279,1044
663390,True,5,Mixed,110,52,162
663410,True,0,No user reviews,0,0,0
663420,True,0,No user reviews,0,0,0
663430,True,0,2 user reviews,1,1,2
663480,True,0,1 user reviews,1,0,1
663530,True,0,1 user reviews,0,1,1
663540,True,0,5 user reviews,5,0,5
663580,True,0,8 user reviews,5,3,8
663590,True,7,Positive,16,1,17
663600,True,0,No user reviews,0,0,0
663660,True,0,No user reviews,0,0,0
663670,True,8,Very Positive,288,25,313
663690,True,0,No user reviews,0,0,0
663700,True,0,No user reviews,0,0,0
663730,True,0,9 user reviews,6,3,9
663760,True,0,No user reviews,0,0,0
663790,True,0,No user reviews,0,0,0
663810,True,0,No user reviews,0,0,0
663820,True,0,3 user reviews,3,0,3
663830,True,6,Mostly Positive,23,8,31
663840,True,0,No user reviews,0,0,0
663850,True,0,No user reviews,0,0,0
663870,True,0,No user reviews,0,0,0
663890,True,0,No user reviews,0,0,0
663900,True,0,No user reviews,0,0,0
663910,True,0,No user reviews,0,0,0
663920,True,0,2 user reviews,2,0,2
663940,True,0,No user reviews,0,0,0
663970,True,0,No user reviews,0,0,0
664000,True,8,Very Positive,86,18,104
664030,True,0,No user reviews,0,0,0
664040,True,0,4 user reviews,4,0,4
664050,True,0,No user reviews,0,0,0
664060,True,0,6 user reviews,5,1,6
664070,True,0,No user reviews,0,0,0
664080,True,0,1 user reviews,0,1,1
664090,True,8,Very Positive,112,28,140
664110,True,0,1 user reviews,1,0,1
664120,True,0,7 user reviews,1,6,7
664140,True,0,4 user reviews,4,0,4
664160,True,0,3 user reviews,3,0,3
664180,True,8,Very Positive,52,2,54
664190,True,0,3 user reviews,3,0,3
664210,True,0,1 user reviews,1,0,1
664240,True,0,8 user reviews,8,0,8
664250,True,0,7 user reviews,4,3,7
664260,True,0,No user reviews,0,0,0
664270,True,0,No user reviews,0,0,0
664280,True,0,No user reviews,0,0,0
664290,True,5,Mixed,14,13,27
664320,True,5,Mixed,22,20,42
664330,True,0,1 user reviews,1,0,1
664340,True,0,2 user reviews,0,2,2
664350,True,5,Mixed,6,9,15
664360,True,0,1 user reviews,1,0,1
664390,True,0,No user reviews,0,0,0
664400,True,0,No user reviews,0,0,0
664420,True,0,1 user reviews,1,0,1
664430,True,5,Mixed,376,417,793
664440,True,0,No user reviews,0,0,0
664450,True,7,Positive,32,5,37
664460,True,0,No user reviews,0,0,0
664490,True,0,No user reviews,0,0,0
664510,True,0,8 user reviews,6,2,8
664530,True,6,Mostly Positive,13,4,17
664540,True,0,No user reviews,0,0,0
664560,True,0,3 user reviews,2,1,3
664570,True,0,No user reviews,0,0,0
664580,True,0,No user reviews,0,0,0
664590,True,0,1 user reviews,1,0,1
664600,True,0,1 user reviews,0,1,1
664610,True,7,Positive,8,2,10
664620,True,5,Mixed,9,7,16
664630,True,0,2 user reviews,1,1,2
664640,True,0,No user reviews,0,0,0
664650,True,5,Mixed,12,9,21
664660,True,0,1 user reviews,1,0,1
664670,True,0,No user reviews,0,0,0
664680,True,0,No user reviews,0,0,0
664690,True,0,No user reviews,0,0,0
664710,True,0,1 user reviews,1,0,1
664720,True,0,2 user reviews,0,2,2
664730,True,0,No user reviews,0,0,0
664750,True,8,Very Positive,215,13,228
664760,True,0,No user reviews,0,0,0
664780,True,5,Mixed,20,10,30
664800,True,0,No user reviews,0,0,0
664820,True,0,6 user reviews,6,0,6
664830,True,8,Very Positive,298,39,337
664840,True,0,No user reviews,0,0,0
664850,True,7,Positive,20,0,20
664870,True,0,2 user reviews,1,1,2
664880,True,0,No user reviews,0,0,0
664890,True,0,4 user reviews,2,2,4
664910,True,0,No user reviews,0,0,0
664920,True,0,No user reviews,0,0,0
664930,True,0,No user reviews,0,0,0
664950,True,7,Positive,17,3,20
664970,True,0,No user reviews,0,0,0
664980,True,0,No user reviews,0,0,0
664990,True,0,No user reviews,0,0,0
665000,True,0,No user reviews,0,0,0
665010,True,0,No user reviews,0,0,0
665030,True,6,Mostly Positive,28,10,38
665040,True,0,1 user reviews,1,0,1
665050,True,0,No user reviews,0,0,0
665060,True,0,1 user reviews,0,1,1
665070,True,0,1 user reviews,1,0,1
665080,True,0,9 user reviews,6,3,9
665090,True,5,Mixed,111,53,164
665100,True,7,Positive,15,1,16
665110,True,0,No user reviews,0,0,0
665120,True,6,Mostly Positive,28,8,36
665140,True,5,Mixed,5,7,12
665160,True,0,No user reviews,0,0,0
665170,True,0,No user reviews,0,0,0
665180,True,6,Mostly Positive,331,117,448
665200,True,0,No user reviews,0,0,0
665210,True,0,3 user reviews,3,0,3
665220,True,0,No user reviews,0,0,0
665240,True,0,4 user reviews,2,2,4
665270,True,7,Positive,20,1,21
665300,True,8,Very Positive,225,11,236
665310,True,0,6 user reviews,6,0,6
665330,True,8,Very Positive,178,29,207
665340,True,0,6 user reviews,4,2,6
665350,True,0,5 user reviews,5,0,5
665360,True,6,Mostly Positive,2943,902,3845
665370,True,8,Very Positive,307,13,320
665380,True,7,Positive,20,1,21
665410,True,0,No user reviews,0,0,0
665440,True,0,7 user reviews,5,2,7
665450,True,0,4 user reviews,2,2,4
665460,True,0,3 user reviews,3,0,3
665490,True,0,No user reviews,0,0,0
665500,True,0,4 user reviews,4,0,4
665510,True,0,5 user reviews,3,2,5
665520,True,0,No user reviews,0,0,0
665530,True,0,No user reviews,0,0,0
665550,True,0,No user reviews,0,0,0
665590,True,5,Mixed,9,4,13
665620,True,0,6 user reviews,4,2,6
665630,True,0,1 user reviews,1,0,1
665640,True,0,4 user reviews,3,1,4
665650,True,0,5 user reviews,5,0,5
665670,True,0,5 user reviews,3,2,5
665680,True,0,6 user reviews,1,5,6
665710,True,0,No user reviews,0,0,0
665730,True,0,6 user reviews,3,3,6
665740,True,0,No user reviews,0,0,0
665760,True,0,No user reviews,0,0,0
665770,True,0,No user reviews,0,0,0
665780,True,0,1 user reviews,1,0,1
665790,True,0,1 user reviews,1,0,1
665800,True,0,No user reviews,0,0,0
665810,True,0,No user reviews,0,0,0
665820,True,0,No user reviews,0,0,0
665830,True,0,8 user reviews,6,2,8
665840,True,0,No user reviews,0,0,0
665880,True,0,4 user reviews,2,2,4
665890,True,0,No user reviews,0,0,0
665900,True,0,No user reviews,0,0,0
665920,True,0,6 user reviews,5,1,6
665930,True,0,6 user reviews,4,2,6
665950,True,0,2 user reviews,1,1,2
665960,True,5,Mixed,9,13,22
665970,True,0,No user reviews,0,0,0
665980,True,0,No user reviews,0,0,0
665990,True,0,No user reviews,0,0,0
666010,True,0,7 user reviews,5,2,7
666020,True,8,Very Positive,491,49,540
666030,True,0,1 user reviews,0,1,1
666040,True,0,4 user reviews,1,3,4
666050,True,0,3 user reviews,3,0,3
666060,True,0,1 user reviews,0,1,1
666080,True,0,1 user reviews,0,1,1
666090,True,0,3 user reviews,2,1,3
666100,True,8,Very Positive,70,6,76
666110,True,0,1 user reviews,0,1,1
666120,True,0,4 user reviews,0,4,4
666140,True,8,Very Positive,6893,447,7340
666150,True,0,No user reviews,0,0,0
666180,True,0,No user reviews,0,0,0
666200,True,0,No user reviews,0,0,0
666220,True,0,No user reviews,0,0,0
666230,True,7,Positive,24,1,25
666231,True,0,5 user reviews,4,1,5
666232,True,0,5 user reviews,5,0,5
666233,True,0,7 user reviews,6,1,7
666234,True,0,No user reviews,0,0,0
666235,True,0,No user reviews,0,0,0
666236,True,0,No user reviews,0,0,0
666237,True,0,No user reviews,0,0,0
666240,True,0,No user reviews,0,0,0
666250,True,0,7 user reviews,1,6,7
666260,True,0,7 user reviews,3,4,7
666270,True,0,No user reviews,0,0,0
666290,True,0,2 user reviews,0,2,2
666300,True,0,No user reviews,0,0,0
666310,True,0,2 user reviews,0,2,2
666320,True,0,2 user reviews,2,0,2
666330,True,8,Very Positive,150,33,183
666340,True,7,Positive,15,2,17
666350,True,7,Positive,31,3,34
666370,True,0,1 user reviews,1,0,1
666390,True,0,No user reviews,0,0,0
666400,True,0,No user reviews,0,0,0
666410,True,0,No user reviews,0,0,0
666420,True,0,No user reviews,0,0,0
666430,True,0,No user reviews,0,0,0
666440,True,0,No user reviews,0,0,0
666450,True,0,No user reviews,0,0,0
666460,True,0,No user reviews,0,0,0
666470,True,0,No user reviews,0,0,0
666480,True,0,No user reviews,0,0,0
666490,True,0,No user reviews,0,0,0
666500,True,0,No user reviews,0,0,0
666510,True,0,No user reviews,0,0,0
666520,True,0,No user reviews,0,0,0
666530,True,0,No user reviews,0,0,0
666540,True,0,No user reviews,0,0,0
666560,True,0,8 user reviews,4,4,8
666570,True,6,Mostly Positive,203,67,270
666590,True,0,3 user reviews,3,0,3
666600,True,0,7 user reviews,4,3,7
666610,True,8,Very Positive,84,1,85
666620,True,3,Negative,2,10,12
666630,True,7,Positive,11,0,11
666640,True,0,3 user reviews,1,2,3
666650,True,0,No user reviews,0,0,0
666651,True,0,No user reviews,0,0,0
666652,True,0,No user reviews,0,0,0
666653,True,0,No user reviews,0,0,0
666654,True,0,No user reviews,0,0,0
666655,True,0,No user reviews,0,0,0
666656,True,0,No user reviews,0,0,0
666657,True,0,No user reviews,0,0,0
666658,True,0,No user reviews,0,0,0
666659,True,0,No user reviews,0,0,0
666660,True,0,7 user reviews,3,4,7
666670,True,0,7 user reviews,7,0,7
666730,True,6,Mostly Positive,68,19,87
666780,True,0,No user reviews,0,0,0
666790,True,0,1 user reviews,1,0,1
666800,True,5,Mixed,6,7,13
666810,True,0,1 user reviews,1,0,1
666820,True,8,Very Positive,124,14,138
666830,True,0,No user reviews,0,0,0
666840,True,0,No user reviews,0,0,0
666850,True,0,3 user reviews,2,1,3
666860,True,0,No user reviews,0,0,0
666870,True,0,5 user reviews,0,5,5
666910,True,0,3 user reviews,3,0,3
666930,True,0,3 user reviews,1,2,3
666940,True,5,Mixed,11,7,18
666960,True,5,Mixed,7,5,12
666970,True,0,No user reviews,0,0,0
667000,True,0,1 user reviews,0,1,1
667010,True,7,Positive,14,2,16
667030,True,0,6 user reviews,3,3,6
667040,True,7,Positive,9,2,11
667050,True,0,7 user reviews,3,4,7
667060,True,0,1 user reviews,1,0,1
667090,True,0,2 user reviews,2,0,2
667110,True,0,No user reviews,0,0,0
667120,True,0,No user reviews,0,0,0
667130,True,6,Mostly Positive,14,4,18
667160,True,0,No user reviews,0,0,0
667170,True,0,7 user reviews,1,6,7
667200,True,0,No user reviews,0,0,0
667220,True,0,7 user reviews,4,3,7
667230,True,0,No user reviews,0,0,0
667240,True,0,3 user reviews,3,0,3
667250,True,0,1 user reviews,1,0,1
667270,True,0,No user reviews,0,0,0
667280,True,0,No user reviews,0,0,0
667290,True,0,6 user reviews,2,4,6
667291,True,0,5 user reviews,2,3,5
667300,True,5,Mixed,8,11,19
667310,True,0,1 user reviews,1,0,1
667340,True,0,6 user reviews,2,4,6
667360,True,4,Mostly Negative,4,7,11
667370,True,0,No user reviews,0,0,0
667400,True,0,No user reviews,0,0,0
667410,True,0,1 user reviews,0,1,1
667420,True,0,4 user reviews,1,3,4
667430,True,0,No user reviews,0,0,0
667450,True,0,1 user reviews,0,1,1
667460,True,0,No user reviews,0,0,0
667470,True,0,No user reviews,0,0,0
667480,True,0,No user reviews,0,0,0
667490,True,0,No user reviews,0,0,0
667510,True,0,1 user reviews,1,0,1
667520,True,4,Mostly Negative,4,8,12
667530,True,0,No user reviews,0,0,0
667550,True,0,5 user reviews,5,0,5
667580,True,0,No user reviews,0,0,0
667590,True,0,No user reviews,0,0,0
667600,True,8,Very Positive,448,29,477
667620,True,5,Mixed,16,7,23
667630,True,0,1 user reviews,0,1,1
667650,True,0,No user reviews,0,0,0
667660,True,0,No user reviews,0,0,0
667670,True,0,4 user reviews,3,1,4
667690,True,0,4 user reviews,4,0,4
667710,True,0,No user reviews,0,0,0
667720,True,6,Mostly Positive,862,218,1080
667750,True,0,6 user reviews,6,0,6
667760,True,7,Positive,10,0,10
667770,True,0,9 user reviews,5,4,9
667780,True,7,Positive,12,1,13
667790,True,7,Positive,12,0,12
667800,True,7,Positive,26,1,27
667810,True,5,Mixed,25,14,39
667820,True,7,Positive,27,1,28
667840,True,0,3 user reviews,0,3,3
667860,True,0,No user reviews,0,0,0
667870,True,7,Positive,11,0,11
667880,True,0,2 user reviews,2,0,2
667890,True,0,No user reviews,0,0,0
667900,True,0,1 user reviews,0,1,1
667920,True,0,9 user reviews,5,4,9
667930,True,0,1 user reviews,1,0,1
667970,True,9,Overwhelmingly Positive,1759,60,1819
667980,True,0,1 user reviews,1,0,1
668000,True,0,No user reviews,0,0,0
668010,True,0,2 user reviews,2,0,2
668030,True,0,3 user reviews,2,1,3
668040,True,0,5 user reviews,4,1,5
668050,True,0,2 user reviews,0,2,2
668060,True,0,3 user reviews,0,3,3
668090,True,0,No user reviews,0,0,0
668110,True,0,No user reviews,0,0,0
668120,True,0,No user reviews,0,0,0
668121,True,0,No user reviews,0,0,0
668130,True,0,No user reviews,0,0,0
668140,True,0,No user reviews,0,0,0
668160,True,0,No user reviews,0,0,0
668170,True,0,No user reviews,0,0,0
668180,True,0,No user reviews,0,0,0
668190,True,0,1 user reviews,0,1,1
668200,True,0,2 user reviews,2,0,2
668210,True,8,Very Positive,418,49,467
668220,True,0,2 user reviews,2,0,2
668230,True,0,2 user reviews,2,0,2
668280,True,0,2 user reviews,2,0,2
668290,True,0,4 user reviews,2,2,4
668300,True,0,3 user reviews,1,2,3
668320,True,7,Positive,24,3,27
668350,True,8,Very Positive,132,1,133
668360,True,7,Positive,25,5,30
668370,True,0,No user reviews,0,0,0
668390,True,0,No user reviews,0,0,0
668410,True,0,No user reviews,0,0,0
668430,True,8,Very Positive,109,12,121
668440,True,0,No user reviews,0,0,0
668460,True,0,No user reviews,0,0,0
668480,True,0,No user reviews,0,0,0
668490,True,0,No user reviews,0,0,0
668510,True,0,3 user reviews,3,0,3
668520,True,0,3 user reviews,3,0,3
668530,True,0,No user reviews,0,0,0
668550,True,0,No user reviews,0,0,0
668560,True,0,2 user reviews,1,1,2
668570,True,0,No user reviews,0,0,0
668580,True,0,No user reviews,0,0,0
668590,True,8,Very Positive,98,18,116
668600,True,0,No user reviews,0,0,0
668610,True,0,4 user reviews,3,1,4
668620,True,0,No user reviews,0,0,0
668630,True,8,Very Positive,490,117,607
668650,True,0,3 user reviews,3,0,3
668660,True,7,Positive,16,2,18
668670,True,0,6 user reviews,2,4,6
668680,True,0,2 user reviews,2,0,2
668710,True,7,Positive,12,1,13
668714,True,0,2 user reviews,1,1,2
668720,True,0,No user reviews,0,0,0
668721,True,0,No user reviews,0,0,0
668730,True,0,6 user reviews,4,2,6
668770,True,0,No user reviews,0,0,0
668780,True,0,6 user reviews,6,0,6
668790,True,0,3 user reviews,2,1,3
668800,True,0,2 user reviews,2,0,2
668830,True,0,1 user reviews,0,1,1
668840,True,0,6 user reviews,4,2,6
668850,True,0,1 user reviews,0,1,1
668870,True,0,No user reviews,0,0,0
668871,True,0,No user reviews,0,0,0
668880,True,0,No user reviews,0,0,0
668890,True,4,Mostly Negative,7,12,19
668910,True,0,5 user reviews,2,3,5
668950,True,0,No user reviews,0,0,0
668960,True,0,2 user reviews,2,0,2
668970,True,0,3 user reviews,3,0,3
668980,True,8,Very Positive,60,13,73
669000,True,0,3 user reviews,0,3,3
669040,True,0,No user reviews,0,0,0
669050,True,8,Very Positive,113,14,127
669100,True,0,No user reviews,0,0,0
669110,True,0,No user reviews,0,0,0
669120,True,0,No user reviews,0,0,0
669130,True,0,No user reviews,0,0,0
669140,True,0,No user reviews,0,0,0
669150,True,0,1 user reviews,1,0,1
669160,True,0,No user reviews,0,0,0
669170,True,0,No user reviews,0,0,0
669180,True,0,No user reviews,0,0,0
669190,True,0,4 user reviews,1,3,4
669200,True,0,No user reviews,0,0,0
669210,True,0,No user reviews,0,0,0
669220,True,0,No user reviews,0,0,0
669230,True,0,No user reviews,0,0,0
669270,True,0,No user reviews,0,0,0
669290,True,5,Mixed,111,102,213
669300,True,0,No user reviews,0,0,0
669310,True,0,2 user reviews,2,0,2
669320,True,0,6 user reviews,4,2,6
669330,True,0,No user reviews,0,0,0
669340,True,0,9 user reviews,8,1,9
669350,True,0,6 user reviews,4,2,6
669360,True,0,2 user reviews,1,1,2
669380,True,7,Positive,33,6,39
669390,True,0,5 user reviews,4,1,5
669410,True,0,1 user reviews,0,1,1
669440,True,0,No user reviews,0,0,0
669480,True,0,5 user reviews,5,0,5
669490,True,0,2 user reviews,2,0,2
669500,True,8,Very Positive,48,4,52
669520,True,0,1 user reviews,0,1,1
669570,True,0,5 user reviews,1,4,5
669580,True,0,No user reviews,0,0,0
669590,True,0,1 user reviews,1,0,1
669600,True,0,1 user reviews,1,0,1
669620,True,0,No user reviews,0,0,0
669630,True,0,No user reviews,0,0,0
669650,True,0,3 user reviews,0,3,3
669660,True,5,Mixed,36,19,55
669690,True,0,No user reviews,0,0,0
669700,True,0,1 user reviews,0,1,1
669710,True,0,2 user reviews,2,0,2
669730,True,0,7 user reviews,2,5,7
669740,True,0,3 user reviews,3,0,3
669750,True,0,5 user reviews,4,1,5
669760,True,0,No user reviews,0,0,0
669770,True,5,Mixed,25,20,45
669800,True,0,No user reviews,0,0,0
669801,True,0,No user reviews,0,0,0
669820,True,0,No user reviews,0,0,0
669830,True,7,Positive,10,1,11
669840,True,0,No user reviews,0,0,0
669860,True,0,No user reviews,0,0,0
669870,True,0,No user reviews,0,0,0
669880,True,0,No user reviews,0,0,0
669890,True,0,No user reviews,0,0,0
669900,True,0,No user reviews,0,0,0
669910,True,7,Positive,22,1,23
669940,True,0,No user reviews,0,0,0
669950,True,8,Very Positive,263,30,293
669960,True,0,3 user reviews,2,1,3
669970,True,7,Positive,27,3,30
669990,True,0,1 user reviews,1,0,1
670020,True,0,1 user reviews,1,0,1
670030,True,0,No user reviews,0,0,0
670040,True,0,No user reviews,0,0,0
670050,True,0,No user reviews,0,0,0
670060,True,7,Positive,13,0,13
670080,True,0,No user reviews,0,0,0
670090,True,0,1 user reviews,1,0,1
670100,True,0,4 user reviews,1,3,4
670120,True,0,No user reviews,0,0,0
670130,True,0,6 user reviews,5,1,6
670140,True,0,4 user reviews,4,0,4
670160,True,8,Very Positive,217,18,235
670180,True,5,Mixed,7,4,11
670190,True,0,No user reviews,0,0,0
670210,True,0,1 user reviews,1,0,1
670230,True,0,2 user reviews,2,0,2
670240,True,0,3 user reviews,2,1,3
670250,True,0,No user reviews,0,0,0
670260,True,8,Very Positive,166,25,191
670270,True,0,5 user reviews,3,2,5
670280,True,0,4 user reviews,3,1,4
670290,True,0,No user reviews,0,0,0
670300,True,0,No user reviews,0,0,0
670320,True,0,2 user reviews,2,0,2
670330,True,0,5 user reviews,2,3,5
670340,True,0,3 user reviews,3,0,3
670350,True,6,Mostly Positive,152,45,197
670360,True,0,No user reviews,0,0,0
670370,True,0,4 user reviews,1,3,4
670400,True,0,No user reviews,0,0,0
670410,True,0,4 user reviews,2,2,4
670430,True,0,5 user reviews,0,5,5
670440,True,0,No user reviews,0,0,0
670450,True,0,5 user reviews,4,1,5
670460,True,5,Mixed,7,4,11
670470,True,0,9 user reviews,4,5,9
670490,True,4,Mostly Negative,14,51,65
670500,True,0,No user reviews,0,0,0
670510,True,0,No user reviews,0,0,0
670530,True,0,No user reviews,0,0,0
670550,True,0,No user reviews,0,0,0
670560,True,0,No user reviews,0,0,0
670570,True,0,3 user reviews,2,1,3
670600,True,0,No user reviews,0,0,0
670601,True,0,No user reviews,0,0,0
670602,True,0,No user reviews,0,0,0
670603,True,0,No user reviews,0,0,0
670604,True,0,No user reviews,0,0,0
670605,True,0,No user reviews,0,0,0
670610,True,7,Positive,27,0,27
670620,True,0,3 user reviews,2,1,3
670630,True,0,5 user reviews,5,0,5
670640,True,0,No user reviews,0,0,0
670690,True,0,No user reviews,0,0,0
670700,True,0,No user reviews,0,0,0
670720,True,0,5 user reviews,5,0,5
670730,True,0,3 user reviews,3,0,3
670750,True,8,Very Positive,98,14,112
670760,True,0,No user reviews,0,0,0
670780,True,0,2 user reviews,0,2,2
670790,True,0,No user reviews,0,0,0
670820,True,5,Mixed,31,14,45
670830,True,0,No user reviews,0,0,0
670840,True,0,5 user reviews,5,0,5
670850,True,0,4 user reviews,3,1,4
670860,True,0,No user reviews,0,0,0
670870,True,0,2 user reviews,2,0,2
670900,True,5,Mixed,147,106,253
670910,True,0,6 user reviews,0,6,6
670930,True,6,Mostly Positive,10,3,13
670940,True,0,1 user reviews,1,0,1
670950,True,0,4 user reviews,4,0,4
670960,True,0,1 user reviews,1,0,1
670961,True,0,1 user reviews,1,0,1
670970,True,0,No user reviews,0,0,0
670980,True,0,No user reviews,0,0,0
671050,True,0,1 user reviews,1,0,1
671070,True,0,No user reviews,0,0,0
671090,True,7,Positive,37,6,43
671100,True,7,Positive,17,1,18
671110,True,0,No user reviews,0,0,0
671120,True,0,4 user reviews,4,0,4
671130,True,0,No user reviews,0,0,0
671150,True,0,3 user reviews,3,0,3
671160,True,7,Positive,24,2,26
671170,True,8,Very Positive,51,9,60
671180,True,0,4 user reviews,3,1,4
671190,True,7,Positive,41,3,44
671200,True,0,2 user reviews,1,1,2
671210,True,0,No user reviews,0,0,0
671230,True,0,1 user reviews,1,0,1
671240,True,5,Mixed,17,10,27
671260,True,6,Mostly Positive,22,9,31
671270,True,7,Positive,8,2,10
671290,True,0,No user reviews,0,0,0
671310,True,0,No user reviews,0,0,0
671330,True,0,2 user reviews,2,0,2
671340,True,0,No user reviews,0,0,0
671341,True,0,No user reviews,0,0,0
671342,True,0,No user reviews,0,0,0
671360,True,0,No user reviews,0,0,0
671370,True,0,No user reviews,0,0,0
671380,True,0,No user reviews,0,0,0
671381,True,0,No user reviews,0,0,0
671382,True,0,No user reviews,0,0,0
671390,True,6,Mostly Positive,67,21,88
671410,True,0,No user reviews,0,0,0
671430,True,0,No user reviews,0,0,0
671440,True,6,Mostly Positive,1082,298,1380
671460,True,0,No user reviews,0,0,0
671470,True,0,2 user reviews,2,0,2
671480,True,0,2 user reviews,2,0,2
671490,True,0,1 user reviews,0,1,1
671510,True,5,Mixed,1082,472,1554
671540,True,0,1 user reviews,1,0,1
671550,True,7,Positive,37,1,38
671560,True,0,9 user reviews,9,0,9
671580,True,0,3 user reviews,1,2,3
671600,True,5,Mixed,8,10,18
671610,True,0,No user reviews,0,0,0
671620,True,8,Very Positive,344,66,410
671630,True,6,Mostly Positive,8,3,11
671650,True,7,Positive,25,4,29
671670,True,5,Mixed,6,4,10
671690,True,0,No user reviews,0,0,0
671700,True,0,No user reviews,0,0,0
671720,True,0,No user reviews,0,0,0
671740,True,7,Positive,25,3,28
671750,True,0,1 user reviews,1,0,1
671770,True,0,No user reviews,0,0,0
671800,True,5,Mixed,9,7,16
671810,True,0,1 user reviews,0,1,1
671820,True,0,1 user reviews,1,0,1
671840,True,6,Mostly Positive,8,3,11
671850,True,0,1 user reviews,0,1,1
671860,True,0,No user reviews,0,0,0
671880,True,0,2 user reviews,2,0,2
671900,True,5,Mixed,23,22,45
671910,True,0,No user reviews,0,0,0
671920,True,6,Mostly Positive,27,9,36
671950,True,0,No user reviews,0,0,0
671970,True,0,No user reviews,0,0,0
671980,True,7,Positive,29,4,33
672000,True,0,No user reviews,0,0,0
672010,True,0,1 user reviews,1,0,1
672020,True,7,Positive,31,3,34
672030,True,0,4 user reviews,2,2,4
672040,True,0,8 user reviews,6,2,8
672050,True,0,3 user reviews,0,3,3
672080,True,0,No user reviews,0,0,0
672100,True,0,4 user reviews,4,0,4
672130,True,0,2 user reviews,0,2,2
672140,True,0,8 user reviews,2,6,8
672150,True,7,Positive,35,3,38
672160,True,5,Mixed,16,8,24
672170,True,0,No user reviews,0,0,0
672180,True,0,6 user reviews,5,1,6
672200,True,0,No user reviews,0,0,0
672230,True,6,Mostly Positive,28,8,36
672240,True,0,No user reviews,0,0,0
672250,True,0,9 user reviews,4,5,9
672270,True,6,Mostly Positive,34,11,45
672271,True,5,Mixed,28,22,50
672280,True,0,No user reviews,0,0,0
672290,True,0,8 user reviews,5,3,8
672300,True,0,No user reviews,0,0,0
672310,True,0,5 user reviews,4,1,5
672320,True,0,1 user reviews,1,0,1
672380,True,0,3 user reviews,0,3,3
672410,True,0,1 user reviews,1,0,1
672420,True,0,No user reviews,0,0,0
672430,True,0,No user reviews,0,0,0
672440,True,0,No user reviews,0,0,0
672460,True,5,Mixed,9,6,15
672480,True,0,1 user reviews,0,1,1
672490,True,0,No user reviews,0,0,0
672510,True,0,No user reviews,0,0,0
672530,True,0,No user reviews,0,0,0
672560,True,0,No user reviews,0,0,0
672570,True,0,2 user reviews,1,1,2
672590,True,7,Positive,34,8,42
672630,True,8,Very Positive,635,114,749
672640,True,0,No user reviews,0,0,0
672650,True,0,No user reviews,0,0,0
672670,True,0,2 user reviews,1,1,2
672680,True,0,4 user reviews,2,2,4
672690,True,0,9 user reviews,9,0,9
672710,True,5,Mixed,12,9,21
672720,True,0,5 user reviews,4,1,5
672730,True,0,No user reviews,0,0,0
672760,True,0,2 user reviews,1,1,2
672770,True,0,1 user reviews,0,1,1
672780,True,0,No user reviews,0,0,0
672790,True,6,Mostly Positive,10,4,14
672800,True,0,No user reviews,0,0,0
672810,True,0,No user reviews,0,0,0
672830,True,6,Mostly Positive,24,8,32
672840,True,8,Very Positive,108,8,116
672860,True,5,Mixed,25,29,54
672870,True,0,No user reviews,0,0,0
672880,True,0,No user reviews,0,0,0
672910,True,0,3 user reviews,2,1,3
672920,True,0,5 user reviews,5,0,5
672940,True,0,5 user reviews,0,5,5
672960,True,0,No user reviews,0,0,0
672970,True,0,8 user reviews,6,2,8
672990,True,0,No user reviews,0,0,0
673000,True,8,Very Positive,412,65,477
673010,True,0,2 user reviews,0,2,2
673020,True,0,No user reviews,0,0,0
673030,True,0,No user reviews,0,0,0
673040,True,0,2 user reviews,2,0,2
673050,True,0,1 user reviews,1,0,1
673060,True,7,Positive,39,4,43
673070,True,0,No user reviews,0,0,0
673080,True,0,No user reviews,0,0,0
673090,True,0,No user reviews,0,0,0
673120,True,0,1 user reviews,0,1,1
673130,True,9,Overwhelmingly Positive,2267,76,2343
673140,True,0,3 user reviews,3,0,3
673170,True,0,No user reviews,0,0,0
673190,True,6,Mostly Positive,33,12,45
673210,True,5,Mixed,192,86,278
673220,True,0,6 user reviews,3,3,6
673230,True,0,4 user reviews,4,0,4
673240,True,0,No user reviews,0,0,0
673250,True,0,No user reviews,0,0,0
673260,True,6,Mostly Positive,119,41,160
673280,True,0,4 user reviews,4,0,4
673300,True,8,Very Positive,49,3,52
673310,True,0,3 user reviews,0,3,3
673320,True,0,No user reviews,0,0,0
673340,True,0,No user reviews,0,0,0
673360,True,0,1 user reviews,1,0,1
673380,True,0,3 user reviews,3,0,3
673400,True,0,5 user reviews,0,5,5
673410,True,0,No user reviews,0,0,0
673430,True,0,No user reviews,0,0,0
673440,True,0,No user reviews,0,0,0
673450,True,5,Mixed,54,32,86
673480,True,0,2 user reviews,2,0,2
673500,True,5,Mixed,7,6,13
673530,True,0,1 user reviews,1,0,1
673540,True,0,1 user reviews,1,0,1
673550,True,0,3 user reviews,3,0,3
673560,True,0,No user reviews,0,0,0
673570,True,0,5 user reviews,2,3,5
673580,True,0,1 user reviews,0,1,1
673590,True,0,No user reviews,0,0,0
673600,True,8,Very Positive,90,14,104
673610,True,8,Very Positive,2003,408,2411
673620,True,0,No user reviews,0,0,0
673630,True,0,1 user reviews,0,1,1
673660,True,5,Mixed,8,10,18
673690,True,0,No user reviews,0,0,0
673710,True,0,No user reviews,0,0,0
673720,True,0,2 user reviews,0,2,2
673730,True,0,1 user reviews,1,0,1
673740,True,7,Positive,33,5,38
673750,True,8,Very Positive,205,22,227
673790,True,0,No user reviews,0,0,0
673800,True,8,Very Positive,122,27,149
673810,True,0,No user reviews,0,0,0
673820,True,0,3 user reviews,0,3,3
673830,True,5,Mixed,6,4,10
673840,True,6,Mostly Positive,10,3,13
673850,True,8,Very Positive,91,14,105
673870,True,0,No user reviews,0,0,0
673880,True,8,Very Positive,3082,213,3295
673890,True,0,No user reviews,0,0,0
673900,True,0,No user reviews,0,0,0
673910,True,0,No user reviews,0,0,0
673920,True,0,1 user reviews,1,0,1
673930,True,0,No user reviews,0,0,0
673940,True,0,No user reviews,0,0,0
673950,True,8,Very Positive,2314,186,2500
673970,True,0,9 user reviews,8,1,9
673980,True,7,Positive,25,1,26
673990,True,0,No user reviews,0,0,0
674000,True,0,1 user reviews,1,0,1
674010,True,0,2 user reviews,0,2,2
674020,True,5,Mixed,4752,2558,7310
674070,True,0,No user reviews,0,0,0
674080,True,0,No user reviews,0,0,0
674090,True,0,No user reviews,0,0,0
674100,True,0,1 user reviews,1,0,1
674120,True,0,1 user reviews,0,1,1
674130,True,0,No user reviews,0,0,0
674150,True,5,Mixed,10,8,18
674160,True,0,6 user reviews,3,3,6
674170,True,5,Mixed,22,10,32
674180,True,0,3 user reviews,2,1,3
674190,True,7,Positive,20,1,21
674200,True,0,No user reviews,0,0,0
674210,True,7,Positive,12,2,14
674220,True,4,Mostly Negative,7,11,18
674230,True,0,4 user reviews,4,0,4
674240,True,0,No user reviews,0,0,0
674250,True,7,Positive,15,1,16
674290,True,0,No user reviews,0,0,0
674300,True,0,No user reviews,0,0,0
674310,True,7,Positive,27,4,31
674320,True,0,No user reviews,0,0,0
674330,True,7,Positive,21,0,21
674360,True,0,1 user reviews,0,1,1
674370,True,5,Mixed,15,12,27
674380,True,0,9 user reviews,6,3,9
674390,True,0,No user reviews,0,0,0
674400,True,0,No user reviews,0,0,0
674420,True,0,4 user reviews,1,3,4
674430,True,0,No user reviews,0,0,0
674440,True,0,9 user reviews,8,1,9
674450,True,0,1 user reviews,1,0,1
674460,True,0,No user reviews,0,0,0
674480,True,0,2 user reviews,1,1,2
674500,True,8,Very Positive,802,191,993
674520,True,8,Very Positive,605,44,649
674530,True,0,2 user reviews,0,2,2
674550,True,0,2 user reviews,0,2,2
674560,True,0,No user reviews,0,0,0
674570,True,7,Positive,14,3,17
674580,True,0,No user reviews,0,0,0
674590,True,0,No user reviews,0,0,0
674630,True,0,No user reviews,0,0,0
674670,True,0,1 user reviews,1,0,1
674690,True,0,No user reviews,0,0,0
674700,True,0,No user reviews,0,0,0
674720,True,0,No user reviews,0,0,0
674730,True,0,No user reviews,0,0,0
674750,True,8,Very Positive,252,62,314
674760,True,0,No user reviews,0,0,0
674780,True,0,No user reviews,0,0,0
674800,True,0,6 user reviews,3,3,6
674840,True,0,4 user reviews,2,2,4
674850,True,8,Very Positive,117,9,126
674860,True,0,8 user reviews,2,6,8
674880,True,0,No user reviews,0,0,0
674890,True,7,Positive,8,2,10
674900,True,0,No user reviews,0,0,0
674910,True,0,1 user reviews,1,0,1
674920,True,0,1 user reviews,0,1,1
674930,True,0,No user reviews,0,0,0
674940,True,8,Very Positive,23661,1725,25386
674950,True,0,No user reviews,0,0,0
674960,True,8,Very Positive,56,12,68
674970,True,0,No user reviews,0,0,0
674980,True,0,3 user reviews,1,2,3
675010,True,8,Very Positive,5236,622,5858
675030,True,7,Positive,20,2,22
675040,True,0,No user reviews,0,0,0
675060,True,0,No user reviews,0,0,0
675080,True,0,2 user reviews,2,0,2
675090,True,0,No user reviews,0,0,0
675091,True,0,No user reviews,0,0,0
675092,True,0,No user reviews,0,0,0
675093,True,0,No user reviews,0,0,0
675094,True,0,No user reviews,0,0,0
675095,True,0,No user reviews,0,0,0
675096,True,0,No user reviews,0,0,0
675097,True,0,No user reviews,0,0,0
675098,True,0,No user reviews,0,0,0
675099,True,0,No user reviews,0,0,0
675100,True,0,No user reviews,0,0,0
675101,True,0,No user reviews,0,0,0
675120,True,0,4 user reviews,4,0,4
675130,True,0,5 user reviews,2,3,5
675140,True,0,3 user reviews,2,1,3
675150,True,0,No user reviews,0,0,0
675151,True,0,No user reviews,0,0,0
675152,True,0,No user reviews,0,0,0
675160,True,0,No user reviews,0,0,0
675170,True,5,Mixed,67,56,123
675180,True,0,4 user reviews,0,4,4
675190,True,0,No user reviews,0,0,0
675200,True,0,No user reviews,0,0,0
675210,True,5,Mixed,16,23,39
675220,True,0,5 user reviews,2,3,5
675230,True,0,No user reviews,0,0,0
675240,True,8,Very Positive,121,8,129
675250,True,0,No user reviews,0,0,0
675260,True,8,Very Positive,1669,117,1786
675270,True,0,3 user reviews,3,0,3
675280,True,8,Very Positive,46,8,54
675290,True,8,Very Positive,324,31,355
675330,True,0,No user reviews,0,0,0
675340,True,0,7 user reviews,7,0,7
675350,True,0,No user reviews,0,0,0
675351,True,0,1 user reviews,1,0,1
675354,True,0,4 user reviews,4,0,4
675355,True,0,5 user reviews,4,1,5
675356,True,0,1 user reviews,1,0,1
675357,True,0,2 user reviews,1,1,2
675358,True,0,1 user reviews,0,1,1
675359,True,0,No user reviews,0,0,0
675360,True,0,8 user reviews,3,5,8
675370,True,0,1 user reviews,0,1,1
675390,True,0,No user reviews,0,0,0
675400,True,0,No user reviews,0,0,0
675410,True,0,No user reviews,0,0,0
675420,True,0,No user reviews,0,0,0
675430,True,0,No user reviews,0,0,0
675480,True,0,6 user reviews,4,2,6
675490,True,7,Positive,17,3,20
675500,True,0,8 user reviews,4,4,8
675510,True,4,Mostly Negative,4,7,11
675520,True,0,No user reviews,0,0,0
675530,True,0,1 user reviews,1,0,1
675560,True,0,No user reviews,0,0,0
675570,True,0,No user reviews,0,0,0
675590,True,8,Very Positive,79,1,80
675600,True,0,No user reviews,0,0,0
675620,True,0,7 user reviews,5,2,7
675630,True,7,Positive,15,0,15
675640,True,0,6 user reviews,2,4,6
675650,True,0,No user reviews,0,0,0
675660,True,0,4 user reviews,0,4,4
675690,True,0,No user reviews,0,0,0
675720,True,4,Mostly Negative,5,8,13
675730,True,6,Mostly Positive,10,3,13
675750,True,0,1 user reviews,1,0,1
675770,True,0,2 user reviews,1,1,2
675780,True,0,No user reviews,0,0,0
675790,True,0,No user reviews,0,0,0
675800,True,0,No user reviews,0,0,0
675801,True,0,No user reviews,0,0,0
675802,True,0,No user reviews,0,0,0
675803,True,0,No user reviews,0,0,0
675804,True,0,No user reviews,0,0,0
675805,True,0,No user reviews,0,0,0
675806,True,0,No user reviews,0,0,0
675807,True,0,No user reviews,0,0,0
675808,True,0,No user reviews,0,0,0
675809,True,0,No user reviews,0,0,0
675810,True,0,No user reviews,0,0,0
675820,True,0,No user reviews,0,0,0
675821,True,0,No user reviews,0,0,0
675830,True,0,2 user reviews,1,1,2
675860,True,0,No user reviews,0,0,0
675870,True,0,3 user reviews,2,1,3
675880,True,0,No user reviews,0,0,0
675890,True,7,Positive,15,1,16
675900,True,0,No user reviews,0,0,0
675901,True,0,No user reviews,0,0,0
675902,True,0,No user reviews,0,0,0
675903,True,0,No user reviews,0,0,0
675904,True,0,No user reviews,0,0,0
675905,True,0,No user reviews,0,0,0
675906,True,0,No user reviews,0,0,0
675907,True,0,No user reviews,0,0,0
675910,True,7,Positive,10,1,11
675930,True,0,No user reviews,0,0,0
675940,True,5,Mixed,13,8,21
675950,True,5,Mixed,8,5,13
675960,True,0,5 user reviews,1,4,5
675970,True,0,6 user reviews,6,0,6
675980,True,0,2 user reviews,2,0,2
675990,True,7,Positive,10,2,12
676000,True,5,Mixed,16,7,23
676030,True,0,No user reviews,0,0,0
676040,True,0,No user reviews,0,0,0
676050,True,0,No user reviews,0,0,0
676060,True,0,No user reviews,0,0,0
676070,True,0,No user reviews,0,0,0
676080,True,7,Positive,18,2,20
676090,True,6,Mostly Positive,10,4,14
676110,True,0,No user reviews,0,0,0
676120,True,5,Mixed,9,4,13
676130,True,7,Positive,17,1,18
676140,True,0,No user reviews,0,0,0
676150,True,0,No user reviews,0,0,0
676151,True,0,No user reviews,0,0,0
676160,True,0,No user reviews,0,0,0
676170,True,0,2 user reviews,2,0,2
676180,True,0,7 user reviews,7,0,7
676210,True,0,2 user reviews,1,1,2
676240,True,7,Positive,25,3,28
676250,True,0,No user reviews,0,0,0
676251,True,0,No user reviews,0,0,0
676252,True,0,No user reviews,0,0,0
676253,True,0,No user reviews,0,0,0
676254,True,0,No user reviews,0,0,0
676255,True,0,No user reviews,0,0,0
676256,True,0,No user reviews,0,0,0
676257,True,0,No user reviews,0,0,0
676258,True,0,No user reviews,0,0,0
676310,True,0,5 user reviews,1,4,5
676320,True,0,2 user reviews,1,1,2
676340,True,0,6 user reviews,4,2,6
676380,True,0,No user reviews,0,0,0
676410,True,0,3 user reviews,1,2,3
676420,True,8,Very Positive,171,12,183
676430,True,8,Very Positive,186,36,222
676440,True,7,Positive,26,3,29
676450,True,7,Positive,11,0,11
676460,True,0,5 user reviews,1,4,5
676470,True,0,No user reviews,0,0,0
676490,True,0,No user reviews,0,0,0
676500,True,8,Very Positive,215,23,238
676510,True,7,Positive,26,1,27
676520,True,0,2 user reviews,2,0,2
676530,True,0,No user reviews,0,0,0
676540,True,0,No user reviews,0,0,0
676550,True,4,Mostly Negative,2,8,10
676570,True,0,1 user reviews,0,1,1
676580,True,0,5 user reviews,5,0,5
676600,True,0,1 user reviews,1,0,1
676620,True,0,6 user reviews,6,0,6
676630,True,7,Positive,45,2,47
676660,True,0,2 user reviews,2,0,2
676670,True,0,No user reviews,0,0,0
676680,True,0,1 user reviews,1,0,1
676690,True,0,5 user reviews,3,2,5
676700,True,6,Mostly Positive,11,4,15
676720,True,0,8 user reviews,2,6,8
676730,True,5,Mixed,11,12,23
676740,True,6,Mostly Positive,296,96,392
676750,True,0,No user reviews,0,0,0
676760,True,4,Mostly Negative,8,14,22
676770,True,0,No user reviews,0,0,0
676800,True,0,No user reviews,0,0,0
676810,True,0,No user reviews,0,0,0
676820,True,9,Overwhelmingly Positive,955,46,1001
676830,True,7,Positive,23,4,27
676840,True,5,Mixed,242,104,346
676850,True,0,4 user reviews,2,2,4
676860,True,0,No user reviews,0,0,0
676880,True,0,2 user reviews,0,2,2
676890,True,0,No user reviews,0,0,0
676910,True,0,9 user reviews,7,2,9
676930,True,7,Positive,22,2,24
676950,True,0,No user reviews,0,0,0
676960,True,0,8 user reviews,7,1,8
676990,True,0,3 user reviews,0,3,3
677010,True,0,2 user reviews,0,2,2
677020,True,6,Mostly Positive,35,11,46
677030,True,0,2 user reviews,2,0,2
677040,True,5,Mixed,14,8,22
677060,True,6,Mostly Positive,15,6,21
677080,True,0,1 user reviews,1,0,1
677090,True,0,2 user reviews,2,0,2
677100,True,0,No user reviews,0,0,0
677120,True,8,Very Positive,2098,271,2369
677130,True,0,No user reviews,0,0,0
677150,True,0,5 user reviews,4,1,5
677160,True,6,Mostly Positive,904,228,1132
677180,True,5,Mixed,50,68,118
677190,True,7,Positive,9,1,10
677210,True,0,4 user reviews,4,0,4
677220,True,0,3 user reviews,2,1,3
677230,True,0,4 user reviews,1,3,4
677240,True,0,7 user reviews,3,4,7
677250,True,0,1 user reviews,1,0,1
677260,True,0,No user reviews,0,0,0
677280,True,6,Mostly Positive,15,5,20
677290,True,0,No user reviews,0,0,0
677300,True,7,Positive,19,2,21
677310,True,0,No user reviews,0,0,0
677320,True,0,No user reviews,0,0,0
677330,True,7,Positive,17,4,21
677340,True,8,Very Positive,307,68,375
677360,True,0,No user reviews,0,0,0
677370,True,0,No user reviews,0,0,0
677380,True,0,4 user reviews,4,0,4
677390,True,0,No user reviews,0,0,0
677391,True,0,No user reviews,0,0,0
677400,True,0,No user reviews,0,0,0
677401,True,0,No user reviews,0,0,0
677402,True,0,No user reviews,0,0,0
677410,True,0,No user reviews,0,0,0
677420,True,0,No user reviews,0,0,0
677421,True,0,No user reviews,0,0,0
677422,True,0,No user reviews,0,0,0
677430,True,0,No user reviews,0,0,0
677431,True,0,No user reviews,0,0,0
677432,True,0,No user reviews,0,0,0
677440,True,0,No user reviews,0,0,0
677441,True,0,No user reviews,0,0,0
677442,True,0,No user reviews,0,0,0
677450,True,5,Mixed,55,29,84
677480,True,5,Mixed,187,133,320
677490,True,0,No user reviews,0,0,0
677491,True,0,No user reviews,0,0,0
677492,True,0,No user reviews,0,0,0
677493,True,0,No user reviews,0,0,0
677494,True,0,No user reviews,0,0,0
677495,True,0,No user reviews,0,0,0
677496,True,0,No user reviews,0,0,0
677497,True,0,No user reviews,0,0,0
677498,True,0,No user reviews,0,0,0
677499,True,0,No user reviews,0,0,0
677500,True,0,No user reviews,0,0,0
677501,True,0,No user reviews,0,0,0
677502,True,0,No user reviews,0,0,0
677503,True,0,No user reviews,0,0,0
677504,True,0,No user reviews,0,0,0
677505,True,0,No user reviews,0,0,0
677506,True,0,No user reviews,0,0,0
677507,True,0,No user reviews,0,0,0
677508,True,0,No user reviews,0,0,0
677509,True,0,No user reviews,0,0,0
677510,True,0,No user reviews,0,0,0
677511,True,0,No user reviews,0,0,0
677512,True,0,No user reviews,0,0,0
677513,True,0,No user reviews,0,0,0
677514,True,0,No user reviews,0,0,0
677520,True,0,9 user reviews,7,2,9
677530,True,0,No user reviews,0,0,0
677540,True,0,No user reviews,0,0,0
677550,True,0,No user reviews,0,0,0
677570,True,0,No user reviews,0,0,0
677580,True,0,No user reviews,0,0,0
677590,True,0,1 user reviews,1,0,1
677610,True,0,4 user reviews,3,1,4
677620,True,8,Very Positive,54,9,63
677640,True,0,3 user reviews,1,2,3
677650,True,5,Mixed,7,6,13
677670,True,0,No user reviews,0,0,0
677680,True,0,2 user reviews,1,1,2
677690,True,0,1 user reviews,1,0,1
677691,True,0,1 user reviews,1,0,1
677692,True,0,1 user reviews,1,0,1
677700,True,0,3 user reviews,3,0,3
677710,True,0,5 user reviews,4,1,5
677720,True,0,8 user reviews,6,2,8
677730,True,5,Mixed,6,4,10
677780,True,0,No user reviews,0,0,0
677790,True,6,Mostly Positive,10,3,13
677810,True,0,No user reviews,0,0,0
677820,True,4,Mostly Negative,3,9,12
677850,True,5,Mixed,12,6,18
677870,True,0,5 user reviews,1,4,5
677880,True,0,5 user reviews,3,2,5
677900,True,6,Mostly Positive,8,3,11
677910,True,7,Positive,15,2,17
677920,True,0,5 user reviews,1,4,5
677930,True,0,No user reviews,0,0,0
677940,True,0,8 user reviews,6,2,8
677950,True,7,Positive,26,5,31
677951,True,0,4 user reviews,1,3,4
677960,True,7,Positive,10,0,10
677990,True,0,4 user reviews,3,1,4
677991,True,7,Positive,8,2,10
677992,True,0,1 user reviews,1,0,1
677993,True,0,3 user reviews,1,2,3
677994,True,0,No user reviews,0,0,0
677995,True,0,2 user reviews,0,2,2
677996,True,0,1 user reviews,0,1,1
677997,True,0,1 user reviews,1,0,1
677998,True,0,1 user reviews,0,1,1
677999,True,0,3 user reviews,3,0,3
678000,True,0,4 user reviews,2,2,4
678001,True,5,Mixed,14,18,32
678002,True,7,Positive,12,1,13
678003,True,0,8 user reviews,4,4,8
678004,True,4,Mostly Negative,9,17,26
678005,True,7,Positive,16,1,17
678008,True,0,4 user reviews,2,2,4
678009,True,0,1 user reviews,0,1,1
678010,True,0,5 user reviews,4,1,5
678030,True,4,Mostly Negative,8,21,29
678060,True,5,Mixed,4,6,10
678080,True,0,No user reviews,0,0,0
678090,True,0,No user reviews,0,0,0
678100,True,0,3 user reviews,3,0,3
678150,True,0,No user reviews,0,0,0
678160,True,0,No user reviews,0,0,0
678170,True,0,No user reviews,0,0,0
678180,True,0,No user reviews,0,0,0
678181,True,0,No user reviews,0,0,0
678182,True,0,1 user reviews,1,0,1
678183,True,0,1 user reviews,0,1,1
678185,True,0,1 user reviews,1,0,1
678186,True,0,3 user reviews,2,1,3
678187,True,0,No user reviews,0,0,0
678188,True,0,1 user reviews,1,0,1
678190,True,5,Mixed,30,32,62
678200,True,0,6 user reviews,5,1,6
678220,True,6,Mostly Positive,12,4,16
678230,True,0,No user reviews,0,0,0
678240,True,0,2 user reviews,2,0,2
678250,True,0,No user reviews,0,0,0
678270,True,0,No user reviews,0,0,0
678280,True,0,No user reviews,0,0,0
678290,True,0,5 user reviews,4,1,5
678310,True,7,Positive,48,1,49
678320,True,0,No user reviews,0,0,0
678321,True,0,No user reviews,0,0,0
678322,True,0,No user reviews,0,0,0
678323,True,0,No user reviews,0,0,0
678324,True,0,No user reviews,0,0,0
678350,True,0,No user reviews,0,0,0
678390,True,0,No user reviews,0,0,0
678400,True,0,3 user reviews,3,0,3
678410,True,0,2 user reviews,1,1,2
678420,True,0,No user reviews,0,0,0
678430,True,0,2 user reviews,2,0,2
678440,True,0,8 user reviews,8,0,8
678450,True,0,5 user reviews,1,4,5
678460,True,0,No user reviews,0,0,0
678470,True,0,1 user reviews,1,0,1
678480,True,0,1 user reviews,0,1,1
678490,True,0,No user reviews,0,0,0
678500,True,0,1 user reviews,0,1,1
678520,True,8,Very Positive,164,18,182
678530,True,7,Positive,11,0,11
678540,True,0,3 user reviews,3,0,3
678550,True,0,No user reviews,0,0,0
678560,True,7,Positive,20,1,21
678570,True,0,1 user reviews,0,1,1
678590,True,0,No user reviews,0,0,0
678600,True,0,No user reviews,0,0,0
678620,True,0,4 user reviews,3,1,4
678700,True,0,No user reviews,0,0,0
678710,True,0,No user reviews,0,0,0
678720,True,0,No user reviews,0,0,0
678730,True,0,No user reviews,0,0,0
678731,True,0,No user reviews,0,0,0
678732,True,0,No user reviews,0,0,0
678733,True,0,No user reviews,0,0,0
678734,True,0,No user reviews,0,0,0
678740,True,0,No user reviews,0,0,0
678750,True,0,No user reviews,0,0,0
678760,True,0,6 user reviews,2,4,6
678800,True,0,No user reviews,0,0,0
678820,True,6,Mostly Positive,22,6,28
678830,True,0,3 user reviews,3,0,3
678850,True,5,Mixed,12,6,18
678870,True,0,3 user reviews,3,0,3
678880,True,0,2 user reviews,2,0,2
678890,True,4,Mostly Negative,8,26,34
678900,True,6,Mostly Positive,466,180,646
678910,True,0,No user reviews,0,0,0
678920,True,0,No user reviews,0,0,0
678930,True,0,1 user reviews,1,0,1
678940,True,0,No user reviews,0,0,0
678950,True,8,Very Positive,8915,1038,9953
678960,True,8,Very Positive,7303,682,7985
678970,True,8,Very Positive,64,4,68
679030,True,0,2 user reviews,2,0,2
679050,True,0,No user reviews,0,0,0
679070,True,0,8 user reviews,4,4,8
679080,True,0,3 user reviews,1,2,3
679090,True,0,5 user reviews,5,0,5
679100,True,0,1 user reviews,1,0,1
679120,True,6,Mostly Positive,25,8,33
679150,True,0,No user reviews,0,0,0
679160,True,0,2 user reviews,1,1,2
679190,True,5,Mixed,23,11,34
679200,True,0,No user reviews,0,0,0
679230,True,7,Positive,10,0,10
679250,True,0,No user reviews,0,0,0
679260,True,5,Mixed,70,88,158
679270,True,6,Mostly Positive,113,45,158
679280,True,0,No user reviews,0,0,0
679290,True,0,1 user reviews,1,0,1
679300,True,7,Positive,13,0,13
679310,True,7,Positive,15,3,18
679340,True,0,No user reviews,0,0,0
679350,True,0,No user reviews,0,0,0
679390,True,0,2 user reviews,1,1,2
679400,True,0,No user reviews,0,0,0
679410,True,0,5 user reviews,5,0,5
679430,True,0,1 user reviews,1,0,1
679470,True,0,7 user reviews,3,4,7
679480,True,0,3 user reviews,1,2,3
679490,True,0,2 user reviews,1,1,2
679500,True,7,Positive,19,0,19
679510,True,0,2 user reviews,1,1,2
679530,True,5,Mixed,5,7,12
679550,True,0,3 user reviews,2,1,3
679560,True,0,8 user reviews,8,0,8
679570,True,0,2 user reviews,2,0,2
679580,True,0,No user reviews,0,0,0
679590,True,0,No user reviews,0,0,0
679600,True,0,No user reviews,0,0,0
679610,True,0,No user reviews,0,0,0
679620,True,5,Mixed,5,5,10
679640,True,0,2 user reviews,1,1,2
679660,True,8,Very Positive,53,7,60
679670,True,0,5 user reviews,2,3,5
679690,True,0,4 user reviews,2,2,4
679700,True,0,No user reviews,0,0,0
679710,True,0,No user reviews,0,0,0
679720,True,0,2 user reviews,2,0,2
679740,True,0,9 user reviews,5,4,9
679750,True,8,Very Positive,195,20,215
679770,True,7,Positive,19,2,21
679780,True,0,1 user reviews,0,1,1
679790,True,0,No user reviews,0,0,0
679820,True,4,Mostly Negative,5,8,13
679830,True,0,9 user reviews,9,0,9
679840,True,0,No user reviews,0,0,0
679850,True,0,No user reviews,0,0,0
679860,True,0,4 user reviews,0,4,4
679870,True,0,No user reviews,0,0,0
679880,True,0,No user reviews,0,0,0
679900,True,8,Very Positive,833,85,918
679910,True,0,No user reviews,0,0,0
679930,True,0,4 user reviews,3,1,4
679940,True,0,No user reviews,0,0,0
679950,True,0,No user reviews,0,0,0
679960,True,0,No user reviews,0,0,0
679990,True,0,3 user reviews,2,1,3
680010,True,0,No user reviews,0,0,0
680020,True,0,No user reviews,0,0,0
680030,True,7,Positive,11,1,12
680040,True,0,No user reviews,0,0,0
680070,True,0,5 user reviews,3,2,5
680100,True,0,1 user reviews,1,0,1
680130,True,0,No user reviews,0,0,0
680140,True,0,2 user reviews,0,2,2
680160,True,0,No user reviews,0,0,0
680170,True,0,No user reviews,0,0,0
680190,True,0,4 user reviews,4,0,4
680210,True,0,1 user reviews,1,0,1
680240,True,0,No user reviews,0,0,0
680250,True,0,1 user reviews,1,0,1
680300,True,0,No user reviews,0,0,0
680310,True,0,No user reviews,0,0,0
680320,True,6,Mostly Positive,113,37,150
680330,True,5,Mixed,19,10,29
680340,True,6,Mostly Positive,45,12,57
680350,True,0,6 user reviews,5,1,6
680360,True,8,Very Positive,855,137,992
680370,True,0,No user reviews,0,0,0
680380,True,5,Mixed,46,21,67
680390,True,7,Positive,13,2,15
680400,True,0,5 user reviews,4,1,5
680430,True,0,No user reviews,0,0,0
680440,True,0,3 user reviews,1,2,3
680450,True,0,1 user reviews,1,0,1
680470,True,0,No user reviews,0,0,0
680480,True,8,Very Positive,115,21,136
680500,True,0,1 user reviews,1,0,1
680550,True,0,6 user reviews,2,4,6
680560,True,0,1 user reviews,0,1,1
680590,True,8,Very Positive,73,4,77
680600,True,0,No user reviews,0,0,0
680610,True,0,No user reviews,0,0,0
680620,True,7,Positive,14,1,15
680640,True,4,Mostly Negative,9,25,34
680680,True,0,5 user reviews,4,1,5
680690,True,5,Mixed,6,6,12
680700,True,7,Positive,45,2,47
680710,True,0,No user reviews,0,0,0
680730,True,0,No user reviews,0,0,0
680750,True,7,Positive,15,3,18
680760,True,0,No user reviews,0,0,0
680780,True,5,Mixed,8,5,13
680790,True,0,No user reviews,0,0,0
680800,True,0,No user reviews,0,0,0
680830,True,0,6 user reviews,6,0,6
680840,True,0,No user reviews,0,0,0
680860,True,5,Mixed,16,11,27
680870,True,0,No user reviews,0,0,0
680880,True,0,No user reviews,0,0,0
680890,True,0,6 user reviews,6,0,6
680910,True,7,Positive,17,0,17
680930,True,0,6 user reviews,5,1,6
680940,True,0,6 user reviews,1,5,6
680950,True,6,Mostly Positive,19,8,27
680970,True,0,2 user reviews,2,0,2
680980,True,6,Mostly Positive,273,76,349
680990,True,5,Mixed,6,5,11
681000,True,0,6 user reviews,5,1,6
681020,True,0,2 user reviews,1,1,2
681030,True,0,1 user reviews,0,1,1
681040,True,0,6 user reviews,6,0,6
681060,True,7,Positive,25,4,29
681090,True,0,3 user reviews,2,1,3
681100,True,0,3 user reviews,2,1,3
681110,True,5,Mixed,34,15,49
681120,True,0,No user reviews,0,0,0
681140,True,5,Mixed,9,9,18
681150,True,5,Mixed,4,6,10
681160,True,0,2 user reviews,0,2,2
681190,True,0,8 user reviews,8,0,8
681240,True,8,Very Positive,96,8,104
681260,True,0,1 user reviews,0,1,1
681280,True,8,Very Positive,1940,126,2066
681290,True,0,3 user reviews,3,0,3
681330,True,6,Mostly Positive,110,29,139
681340,True,0,1 user reviews,1,0,1
681350,True,0,2 user reviews,1,1,2
681360,True,0,2 user reviews,1,1,2
681380,True,0,3 user reviews,3,0,3
681390,True,8,Very Positive,313,52,365
681410,True,0,4 user reviews,4,0,4
681460,True,6,Mostly Positive,13,4,17
681480,True,0,7 user reviews,2,5,7
681490,True,0,2 user reviews,0,2,2
681500,True,0,No user reviews,0,0,0
681510,True,0,No user reviews,0,0,0
681511,True,0,No user reviews,0,0,0
681512,True,0,No user reviews,0,0,0
681513,True,0,No user reviews,0,0,0
681514,True,0,No user reviews,0,0,0
681515,True,0,No user reviews,0,0,0
681516,True,0,No user reviews,0,0,0
681520,True,5,Mixed,18,10,28
681530,True,7,Positive,21,0,21
681540,True,0,No user reviews,0,0,0
681550,True,5,Mixed,7,5,12
681560,True,0,3 user reviews,2,1,3
681570,True,0,3 user reviews,2,1,3
681580,True,0,No user reviews,0,0,0
681590,True,0,No user reviews,0,0,0
681610,True,0,No user reviews,0,0,0
681620,True,7,Positive,11,1,12
681630,True,0,5 user reviews,3,2,5
681640,True,7,Positive,35,1,36
681660,True,4,Mostly Negative,1801,2967,4768
681670,True,0,No user reviews,0,0,0
681680,True,0,No user reviews,0,0,0
681690,True,0,1 user reviews,1,0,1
681710,True,0,No user reviews,0,0,0
681720,True,5,Mixed,27,39,66
681730,True,8,Very Positive,275,65,340
681740,True,0,No user reviews,0,0,0
681750,True,0,8 user reviews,2,6,8
681760,True,0,2 user reviews,0,2,2
681780,True,0,8 user reviews,0,8,8
681790,True,7,Positive,9,1,10
681800,True,0,1 user reviews,1,0,1
681810,True,0,2 user reviews,0,2,2
681820,True,7,Positive,18,2,20
681830,True,0,4 user reviews,1,3,4
681840,True,7,Positive,8,2,10
681870,True,0,No user reviews,0,0,0
681900,True,0,1 user reviews,1,0,1
681920,True,0,No user reviews,0,0,0
681950,True,0,2 user reviews,2,0,2
681980,True,5,Mixed,6,5,11
681990,True,0,3 user reviews,3,0,3
682000,True,0,No user reviews,0,0,0
682010,True,0,1 user reviews,0,1,1
682020,True,0,7 user reviews,7,0,7
682070,True,0,7 user reviews,5,2,7
682080,True,7,Positive,21,4,25
682100,True,0,5 user reviews,0,5,5
682110,True,0,No user reviews,0,0,0
682130,True,8,Very Positive,593,103,696
682140,True,6,Mostly Positive,157,40,197
682150,True,6,Mostly Positive,20,8,28
682160,True,0,2 user reviews,2,0,2
682170,True,7,Positive,10,1,11
682180,True,0,5 user reviews,4,1,5
682230,True,7,Positive,25,1,26
682250,True,0,No user reviews,0,0,0
682270,True,0,4 user reviews,2,2,4
682280,True,0,2 user reviews,2,0,2
682290,True,0,No user reviews,0,0,0
682300,True,0,No user reviews,0,0,0
682310,True,0,No user reviews,0,0,0
682320,True,0,No user reviews,0,0,0
682340,True,0,No user reviews,0,0,0
682350,True,0,4 user reviews,2,2,4
682360,True,0,4 user reviews,2,2,4
682370,True,0,2 user reviews,1,1,2
682380,True,0,9 user reviews,5,4,9
682390,True,0,2 user reviews,1,1,2
682400,True,0,6 user reviews,4,2,6
682410,True,0,2 user reviews,2,0,2
682420,True,0,No user reviews,0,0,0
682450,True,8,Very Positive,121,17,138
682460,True,0,No user reviews,0,0,0
682470,True,0,6 user reviews,5,1,6
682480,True,0,5 user reviews,5,0,5
682490,True,0,1 user reviews,0,1,1
682500,True,0,8 user reviews,3,5,8
682510,True,0,7 user reviews,3,4,7
682520,True,0,1 user reviews,0,1,1
682530,True,6,Mostly Positive,206,69,275
682540,True,0,No user reviews,0,0,0
682560,True,0,No user reviews,0,0,0
682570,True,5,Mixed,87,39,126
682590,True,6,Mostly Positive,9,3,12
682600,True,0,1 user reviews,1,0,1
682610,True,6,Mostly Positive,9,3,12
682630,True,0,6 user reviews,4,2,6
682650,True,0,No user reviews,0,0,0
682670,True,0,No user reviews,0,0,0
682730,True,4,Mostly Negative,5,8,13
682740,True,0,No user reviews,0,0,0
682760,True,0,No user reviews,0,0,0
682770,True,0,No user reviews,0,0,0
682780,True,7,Positive,9,2,11
682790,True,0,9 user reviews,4,5,9
682810,True,0,3 user reviews,3,0,3
682820,True,0,No user reviews,0,0,0
682830,True,0,No user reviews,0,0,0
682840,True,0,No user reviews,0,0,0
682850,True,0,No user reviews,0,0,0
682870,True,0,6 user reviews,6,0,6
682880,True,0,1 user reviews,1,0,1
682890,True,0,No user reviews,0,0,0
682900,True,0,No user reviews,0,0,0
682910,True,5,Mixed,8,7,15
682920,True,0,No user reviews,0,0,0
682940,True,0,No user reviews,0,0,0
682950,True,0,No user reviews,0,0,0
682960,True,0,No user reviews,0,0,0
682970,True,0,No user reviews,0,0,0
682980,True,0,No user reviews,0,0,0
682990,True,8,Very Positive,2703,431,3134
683000,True,6,Mostly Positive,14,6,20
683010,True,0,No user reviews,0,0,0
683020,True,0,No user reviews,0,0,0
683030,True,0,No user reviews,0,0,0
683031,True,0,No user reviews,0,0,0
683032,True,0,No user reviews,0,0,0
683036,True,0,No user reviews,0,0,0
683037,True,0,No user reviews,0,0,0
683050,True,0,No user reviews,0,0,0
683060,True,0,No user reviews,0,0,0
683070,True,0,1 user reviews,1,0,1
683080,True,0,6 user reviews,1,5,6
683090,True,0,2 user reviews,2,0,2
683100,True,5,Mixed,59,48,107
683130,True,0,3 user reviews,3,0,3
683140,True,0,No user reviews,0,0,0
683150,True,0,6 user reviews,2,4,6
683180,True,5,Mixed,7,4,11
683190,True,0,No user reviews,0,0,0
683210,True,0,2 user reviews,0,2,2
683220,True,5,Mixed,9,6,15
683230,True,5,Mixed,5,7,12
683240,True,0,4 user reviews,4,0,4
683260,True,0,No user reviews,0,0,0
683270,True,0,2 user reviews,1,1,2
683280,True,6,Mostly Positive,55,18,73
683300,True,0,No user reviews,0,0,0
683310,True,0,4 user reviews,3,1,4
683320,True,9,Overwhelmingly Positive,9770,428,10198
683340,True,0,2 user reviews,2,0,2
683360,True,0,No user reviews,0,0,0
683370,True,0,No user reviews,0,0,0
683400,True,0,No user reviews,0,0,0
683420,True,7,Positive,13,0,13
683430,True,0,1 user reviews,1,0,1
683440,True,0,7 user reviews,4,3,7
683490,True,0,1 user reviews,1,0,1
683500,True,0,No user reviews,0,0,0
683510,True,0,No user reviews,0,0,0
683520,True,0,No user reviews,0,0,0
683530,True,0,9 user reviews,4,5,9
683540,True,0,No user reviews,0,0,0
683541,True,0,No user reviews,0,0,0
683542,True,0,No user reviews,0,0,0
683543,True,0,No user reviews,0,0,0
683544,True,0,No user reviews,0,0,0
683545,True,0,No user reviews,0,0,0
683546,True,0,No user reviews,0,0,0
683547,True,0,No user reviews,0,0,0
683548,True,0,No user reviews,0,0,0
683549,True,0,No user reviews,0,0,0
683550,True,0,No user reviews,0,0,0
683551,True,0,No user reviews,0,0,0
683580,True,0,No user reviews,0,0,0
683581,True,0,No user reviews,0,0,0
683582,True,0,No user reviews,0,0,0
683583,True,0,No user reviews,0,0,0
683584,True,0,No user reviews,0,0,0
683585,True,0,No user reviews,0,0,0
683586,True,0,No user reviews,0,0,0
683587,True,0,No user reviews,0,0,0
683588,True,0,No user reviews,0,0,0
683589,True,0,No user reviews,0,0,0
683590,True,0,No user reviews,0,0,0
683591,True,0,No user reviews,0,0,0
683600,True,4,Mostly Negative,3,12,15
683610,True,0,3 user reviews,3,0,3
683620,True,0,1 user reviews,1,0,1
683630,True,0,1 user reviews,1,0,1
683640,True,0,No user reviews,0,0,0
683641,True,0,No user reviews,0,0,0
683642,True,0,No user reviews,0,0,0
683643,True,0,No user reviews,0,0,0
683644,True,0,No user reviews,0,0,0
683645,True,0,No user reviews,0,0,0
683646,True,0,No user reviews,0,0,0
683647,True,0,No user reviews,0,0,0
683648,True,0,No user reviews,0,0,0
683649,True,0,No user reviews,0,0,0
683650,True,0,No user reviews,0,0,0
683651,True,0,No user reviews,0,0,0
683660,True,0,No user reviews,0,0,0
683670,True,0,No user reviews,0,0,0
683680,True,0,No user reviews,0,0,0
683690,True,5,Mixed,10,11,21
683730,True,0,4 user reviews,3,1,4
683740,True,0,1 user reviews,0,1,1
683760,True,6,Mostly Positive,9,3,12
683770,True,6,Mostly Positive,23,8,31
683790,True,0,9 user reviews,6,3,9
683810,True,0,3 user reviews,0,3,3
683830,True,5,Mixed,18,11,29
683840,True,0,1 user reviews,1,0,1
683850,True,6,Mostly Positive,29,9,38
683870,True,7,Positive,10,0,10
683880,True,7,Positive,10,0,10
683890,True,7,Positive,10,0,10
683900,True,8,Very Positive,464,84,548
683910,True,0,5 user reviews,4,1,5
683930,True,0,No user reviews,0,0,0
683940,True,6,Mostly Positive,99,28,127
683960,True,0,No user reviews,0,0,0
683970,True,0,8 user reviews,7,1,8
683990,True,0,1 user reviews,1,0,1
683991,True,0,1 user reviews,1,0,1
683992,True,0,1 user reviews,1,0,1
683993,True,0,1 user reviews,1,0,1
683994,True,0,2 user reviews,2,0,2
684000,True,7,Positive,10,1,11
684040,True,5,Mixed,11,8,19
684050,True,6,Mostly Positive,52,21,73
684060,True,7,Positive,10,2,12
684070,True,0,No user reviews,0,0,0
684080,True,0,No user reviews,0,0,0
684081,True,0,No user reviews,0,0,0
684082,True,0,No user reviews,0,0,0
684083,True,0,No user reviews,0,0,0
684084,True,0,No user reviews,0,0,0
684085,True,0,No user reviews,0,0,0
684086,True,0,No user reviews,0,0,0
684087,True,0,No user reviews,0,0,0
684088,True,0,No user reviews,0,0,0
684089,True,0,No user reviews,0,0,0
684090,True,0,No user reviews,0,0,0
684091,True,0,No user reviews,0,0,0
684100,True,0,No user reviews,0,0,0
684110,True,0,No user reviews,0,0,0
684130,True,0,9 user reviews,4,5,9
684140,True,0,No user reviews,0,0,0
684170,True,0,1 user reviews,0,1,1
684200,True,5,Mixed,8,4,12
684210,True,0,No user reviews,0,0,0
684230,True,0,7 user reviews,6,1,7
684240,True,0,No user reviews,0,0,0
684241,True,0,No user reviews,0,0,0
684250,True,0,No user reviews,0,0,0
684260,True,0,1 user reviews,1,0,1
684270,True,8,Very Positive,142,11,153
684280,True,0,No user reviews,0,0,0
684290,True,0,No user reviews,0,0,0
684300,True,5,Mixed,15,15,30
684320,True,7,Positive,11,1,12
684330,True,0,3 user reviews,3,0,3
684340,True,0,2 user reviews,1,1,2
684360,True,0,No user reviews,0,0,0
684380,True,0,No user reviews,0,0,0
684400,True,0,No user reviews,0,0,0
684410,True,8,Very Positive,1019,116,1135
684420,True,0,8 user reviews,3,5,8
684430,True,0,9 user reviews,9,0,9
684450,True,5,Mixed,78,50,128
684460,True,0,No user reviews,0,0,0
684470,True,0,1 user reviews,1,0,1
684490,True,0,No user reviews,0,0,0
684510,True,0,4 user reviews,2,2,4
684530,True,7,Positive,28,0,28
684560,True,0,4 user reviews,1,3,4
684570,True,0,4 user reviews,3,1,4
684580,True,5,Mixed,390,212,602
684590,True,7,Positive,11,1,12
684610,True,0,No user reviews,0,0,0
684620,True,6,Mostly Positive,8,3,11
684630,True,8,Very Positive,300,15,315
684650,True,0,3 user reviews,2,1,3
684680,True,7,Positive,40,2,42
684690,True,7,Positive,12,0,12
684700,True,5,Mixed,8,7,15
684710,True,0,No user reviews,0,0,0
684720,True,5,Mixed,29,13,42
684730,True,0,No user reviews,0,0,0
684740,True,0,No user reviews,0,0,0
684760,True,0,No user reviews,0,0,0
684770,True,0,3 user reviews,2,1,3
684780,True,0,No user reviews,0,0,0
684800,True,0,No user reviews,0,0,0
684820,True,0,2 user reviews,1,1,2
684830,True,0,No user reviews,0,0,0
684840,True,0,No user reviews,0,0,0
684850,True,5,Mixed,10,12,22
684851,True,0,9 user reviews,5,4,9
684870,True,0,3 user reviews,3,0,3
684930,True,0,4 user reviews,1,3,4
684940,True,6,Mostly Positive,8,3,11
684970,True,0,3 user reviews,1,2,3
684980,True,0,5 user reviews,4,1,5
685040,True,0,No user reviews,0,0,0
685050,True,0,8 user reviews,6,2,8
685060,True,0,7 user reviews,7,0,7
685070,True,0,No user reviews,0,0,0
685080,True,0,2 user reviews,0,2,2
685100,True,0,No user reviews,0,0,0
685110,True,0,No user reviews,0,0,0
685120,True,0,1 user reviews,1,0,1
685130,True,0,3 user reviews,2,1,3
685140,True,0,No user reviews,0,0,0
685180,True,0,No user reviews,0,0,0
685200,True,0,No user reviews,0,0,0
685220,True,0,No user reviews,0,0,0
685230,True,0,2 user reviews,1,1,2
685240,True,8,Very Positive,79,6,85
685250,True,0,No user reviews,0,0,0
685300,True,7,Positive,36,2,38
685310,True,0,No user reviews,0,0,0
685320,True,0,No user reviews,0,0,0
685330,True,0,No user reviews,0,0,0
685340,True,8,Very Positive,61,12,73
685360,True,0,No user reviews,0,0,0
685370,True,0,8 user reviews,3,5,8
685380,True,0,No user reviews,0,0,0
685400,True,8,Very Positive,150,7,157
685420,True,0,No user reviews,0,0,0
685430,True,0,4 user reviews,1,3,4
685450,True,0,No user reviews,0,0,0
685480,True,0,No user reviews,0,0,0
685500,True,0,2 user reviews,1,1,2
685501,True,0,No user reviews,0,0,0
685502,True,0,No user reviews,0,0,0
685503,True,0,No user reviews,0,0,0
685504,True,0,No user reviews,0,0,0
685505,True,0,No user reviews,0,0,0
685506,True,0,No user reviews,0,0,0
685507,True,0,No user reviews,0,0,0
685508,True,0,No user reviews,0,0,0
685509,True,0,No user reviews,0,0,0
685510,True,0,No user reviews,0,0,0
685511,True,0,No user reviews,0,0,0
685512,True,0,No user reviews,0,0,0
685513,True,0,No user reviews,0,0,0
685514,True,0,No user reviews,0,0,0
685515,True,0,No user reviews,0,0,0
685516,True,0,No user reviews,0,0,0
685517,True,0,No user reviews,0,0,0
685518,True,0,No user reviews,0,0,0
685519,True,0,No user reviews,0,0,0
685520,True,0,No user reviews,0,0,0
685521,True,0,No user reviews,0,0,0
685522,True,0,No user reviews,0,0,0
685523,True,0,No user reviews,0,0,0
685524,True,0,No user reviews,0,0,0
685525,True,0,No user reviews,0,0,0
685526,True,0,No user reviews,0,0,0
685527,True,0,No user reviews,0,0,0
685528,True,0,No user reviews,0,0,0
685529,True,0,No user reviews,0,0,0
685530,True,0,No user reviews,0,0,0
685531,True,0,No user reviews,0,0,0
685532,True,0,No user reviews,0,0,0
685533,True,0,No user reviews,0,0,0
685560,True,0,No user reviews,0,0,0
685570,True,0,No user reviews,0,0,0
685580,True,0,No user reviews,0,0,0
685581,True,0,No user reviews,0,0,0
685582,True,0,No user reviews,0,0,0
685583,True,0,No user reviews,0,0,0
685584,True,0,No user reviews,0,0,0
685585,True,0,No user reviews,0,0,0
685586,True,0,No user reviews,0,0,0
685587,True,0,No user reviews,0,0,0
685588,True,0,No user reviews,0,0,0
685589,True,0,No user reviews,0,0,0
685680,True,8,Very Positive,90,17,107
685690,True,8,Very Positive,118,20,138
685700,True,0,No user reviews,0,0,0
685720,True,0,No user reviews,0,0,0
685730,True,0,1 user reviews,0,1,1
685740,True,0,No user reviews,0,0,0
685750,True,5,Mixed,9,13,22
685760,True,0,2 user reviews,1,1,2
685770,True,0,4 user reviews,2,2,4
685790,True,4,Mostly Negative,3,11,14
685800,True,0,6 user reviews,5,1,6
685820,True,0,2 user reviews,2,0,2
685830,True,0,No user reviews,0,0,0
685840,True,0,3 user reviews,3,0,3
685850,True,0,2 user reviews,2,0,2
685870,True,0,No user reviews,0,0,0
685910,True,0,5 user reviews,5,0,5
685920,True,0,3 user reviews,3,0,3
685970,True,0,1 user reviews,0,1,1
685990,True,3,Negative,5,22,27
686000,True,0,1 user reviews,1,0,1
686010,True,0,3 user reviews,3,0,3
686030,True,7,Positive,12,0,12
686040,True,0,3 user reviews,2,1,3
686070,True,0,No user reviews,0,0,0
686080,True,0,No user reviews,0,0,0
686090,True,5,Mixed,11,6,17
686100,True,0,1 user reviews,0,1,1
686110,True,0,2 user reviews,1,1,2
686130,True,0,1 user reviews,1,0,1
686140,True,0,No user reviews,0,0,0
686170,True,0,No user reviews,0,0,0
686180,True,5,Mixed,38,37,75
686190,True,5,Mixed,70,40,110
686200,True,8,Very Positive,931,63,994
686240,True,0,1 user reviews,0,1,1
686260,True,5,Mixed,247,162,409
686270,True,0,No user reviews,0,0,0
686280,True,0,8 user reviews,6,2,8
686300,True,0,1 user reviews,1,0,1
686340,True,0,No user reviews,0,0,0
686350,True,0,No user reviews,0,0,0
686351,True,0,No user reviews,0,0,0
686360,True,6,Mostly Positive,24,8,32
686370,True,0,No user reviews,0,0,0
686380,True,0,5 user reviews,1,4,5
686390,True,0,2 user reviews,1,1,2
686400,True,0,1 user reviews,1,0,1
686401,True,0,4 user reviews,3,1,4
686402,True,0,2 user reviews,2,0,2
686403,True,0,2 user reviews,2,0,2
686404,True,0,1 user reviews,1,0,1
686405,True,0,3 user reviews,3,0,3
686410,True,0,3 user reviews,2,1,3
686430,True,0,4 user reviews,4,0,4
686440,True,6,Mostly Positive,59,16,75
686450,True,7,Positive,18,0,18
686460,True,0,No user reviews,0,0,0
686490,True,0,6 user reviews,0,6,6
686500,True,5,Mixed,16,10,26
686510,True,0,6 user reviews,6,0,6
686520,True,7,Positive,10,0,10
686550,True,5,Mixed,6,7,13
686560,True,0,No user reviews,0,0,0
686570,True,5,Mixed,17,10,27
686580,True,0,4 user reviews,4,0,4
686600,True,4,Mostly Negative,51,87,138
686610,True,0,1 user reviews,0,1,1
686620,True,0,4 user reviews,2,2,4
686630,True,0,1 user reviews,1,0,1
686640,True,0,8 user reviews,3,5,8
686660,True,0,No user reviews,0,0,0
686670,True,0,No user reviews,0,0,0
686680,True,6,Mostly Positive,237,64,301
686700,True,0,No user reviews,0,0,0
686710,True,5,Mixed,13,17,30
686711,True,5,Mixed,10,7,17
686720,True,7,Positive,25,6,31
686740,True,0,5 user reviews,4,1,5
686760,True,8,Very Positive,53,7,60
686770,True,7,Positive,38,0,38
686790,True,4,Mostly Negative,6,10,16
686800,True,5,Mixed,12,6,18
686810,True,8,Very Positive,9867,1558,11425
686840,True,0,No user reviews,0,0,0
686870,True,0,No user reviews,0,0,0
686880,True,0,1 user reviews,1,0,1
686900,True,6,Mostly Positive,40,11,51
686910,True,0,3 user reviews,2,1,3
686940,True,0,No user reviews,0,0,0
686950,True,0,No user reviews,0,0,0
686970,True,0,1 user reviews,1,0,1
686980,True,0,1 user reviews,1,0,1
686990,True,0,1 user reviews,1,0,1
687000,True,0,1 user reviews,1,0,1
687010,True,0,1 user reviews,1,0,1
687020,True,0,1 user reviews,1,0,1
687030,True,0,1 user reviews,1,0,1
687040,True,0,1 user reviews,1,0,1
687050,True,0,1 user reviews,1,0,1
687060,True,0,1 user reviews,1,0,1
687070,True,0,1 user reviews,1,0,1
687080,True,0,1 user reviews,1,0,1
687100,True,0,1 user reviews,1,0,1
687110,True,0,1 user reviews,1,0,1
687120,True,0,1 user reviews,1,0,1
687130,True,0,1 user reviews,1,0,1
687140,True,0,No user reviews,0,0,0
687150,True,0,1 user reviews,1,0,1
687160,True,0,1 user reviews,1,0,1
687170,True,0,1 user reviews,1,0,1
687180,True,0,1 user reviews,1,0,1
687190,True,0,1 user reviews,1,0,1
687200,True,0,1 user reviews,1,0,1
687210,True,0,1 user reviews,1,0,1
687220,True,0,1 user reviews,1,0,1
687230,True,0,1 user reviews,1,0,1
687251,True,4,Mostly Negative,3,7,10
687260,True,8,Very Positive,335,38,373
687270,True,0,2 user reviews,1,1,2
687280,True,0,No user reviews,0,0,0
687310,True,6,Mostly Positive,7,3,10
687320,True,0,No user reviews,0,0,0
687340,True,0,No user reviews,0,0,0
687360,True,7,Positive,11,0,11
687390,True,0,2 user reviews,0,2,2
687420,True,0,No user reviews,0,0,0
687440,True,0,No user reviews,0,0,0
687460,True,0,No user reviews,0,0,0
687470,True,0,No user reviews,0,0,0
687480,True,5,Mixed,10,9,19
687490,True,5,Mixed,11,9,20
687500,True,5,Mixed,22,18,40
687510,True,0,5 user reviews,4,1,5
687520,True,0,No user reviews,0,0,0
687540,True,6,Mostly Positive,39,14,53
687550,True,0,No user reviews,0,0,0
687560,True,0,9 user reviews,8,1,9
687570,True,0,4 user reviews,4,0,4
687580,True,0,No user reviews,0,0,0
687590,True,0,1 user reviews,1,0,1
687600,True,0,4 user reviews,2,2,4
687610,True,0,3 user reviews,3,0,3
687630,True,0,No user reviews,0,0,0
687640,True,0,3 user reviews,0,3,3
687650,True,0,No user reviews,0,0,0
687660,True,0,No user reviews,0,0,0
687661,True,0,No user reviews,0,0,0
687720,True,0,5 user reviews,4,1,5
687730,True,0,No user reviews,0,0,0
687750,True,5,Mixed,49,36,85
687760,True,0,7 user reviews,3,4,7
687780,True,0,No user reviews,0,0,0
687820,True,0,No user reviews,0,0,0
687830,True,8,Very Positive,57,7,64
687850,True,0,8 user reviews,5,3,8
687870,True,0,No user reviews,0,0,0
687890,True,0,7 user reviews,5,2,7
687900,True,5,Mixed,5,5,10
687910,True,0,2 user reviews,2,0,2
687920,True,6,Mostly Positive,124,46,170
687930,True,0,No user reviews,0,0,0
687950,True,0,No user reviews,0,0,0
687980,True,0,No user reviews,0,0,0
688000,True,0,9 user reviews,5,4,9
688010,True,0,No user reviews,0,0,0
688020,True,0,8 user reviews,4,4,8
688030,True,0,No user reviews,0,0,0
688050,True,0,1 user reviews,1,0,1
688060,True,8,Very Positive,296,29,325
688070,True,7,Positive,12,2,14
688090,True,0,6 user reviews,2,4,6
688100,True,0,No user reviews,0,0,0
688110,True,0,2 user reviews,2,0,2
688120,True,0,1 user reviews,1,0,1
688130,True,8,Very Positive,1008,174,1182
688140,True,5,Mixed,54,27,81
688150,True,0,2 user reviews,0,2,2
688170,True,0,1 user reviews,1,0,1
688180,True,0,1 user reviews,0,1,1
688200,True,0,1 user reviews,0,1,1
688210,True,0,No user reviews,0,0,0
688240,True,0,No user reviews,0,0,0
688241,True,0,No user reviews,0,0,0
688242,True,0,No user reviews,0,0,0
688243,True,0,No user reviews,0,0,0
688244,True,0,No user reviews,0,0,0
688245,True,0,No user reviews,0,0,0
688246,True,0,No user reviews,0,0,0
688247,True,0,No user reviews,0,0,0
688248,True,0,No user reviews,0,0,0
688249,True,0,No user reviews,0,0,0
688250,True,0,No user reviews,0,0,0
688251,True,0,No user reviews,0,0,0
688252,True,0,No user reviews,0,0,0
688253,True,0,No user reviews,0,0,0
688254,True,0,No user reviews,0,0,0
688255,True,0,No user reviews,0,0,0
688256,True,0,No user reviews,0,0,0
688257,True,0,No user reviews,0,0,0
688258,True,0,No user reviews,0,0,0
688259,True,0,No user reviews,0,0,0
688260,True,5,Mixed,25,12,37
688270,True,0,No user reviews,0,0,0
688271,True,0,No user reviews,0,0,0
688272,True,0,No user reviews,0,0,0
688273,True,0,1 user reviews,1,0,1
688274,True,0,No user reviews,0,0,0
688280,True,0,1 user reviews,1,0,1
688290,True,0,1 user reviews,1,0,1
688310,True,0,1 user reviews,1,0,1
688330,True,0,No user reviews,0,0,0
688340,True,0,No user reviews,0,0,0
688350,True,0,7 user reviews,0,7,7
688370,True,0,1 user reviews,1,0,1
688380,True,7,Positive,12,2,14
688400,True,7,Positive,11,1,12
688410,True,7,Positive,30,2,32
688420,True,8,Very Positive,1268,143,1411
688430,True,0,No user reviews,0,0,0
688450,True,0,3 user reviews,1,2,3
688460,True,0,No user reviews,0,0,0
688470,True,6,Mostly Positive,29,12,41
688480,True,5,Mixed,118,79,197
688500,True,0,No user reviews,0,0,0
688510,True,0,No user reviews,0,0,0
688520,True,0,No user reviews,0,0,0
688530,True,0,No user reviews,0,0,0
688570,True,5,Mixed,9,10,19
688620,True,0,2 user reviews,1,1,2
688630,True,0,1 user reviews,0,1,1
688650,True,0,No user reviews,0,0,0
688660,True,5,Mixed,29,32,61
688680,True,6,Mostly Positive,12,4,16
688690,True,0,5 user reviews,4,1,5
688700,True,7,Positive,13,0,13
688720,True,0,5 user reviews,5,0,5
688730,True,0,No user reviews,0,0,0
688740,True,8,Very Positive,61,2,63
688750,True,0,1 user reviews,0,1,1
688770,True,8,Very Positive,47,3,50
688780,True,0,1 user reviews,1,0,1
688790,True,0,3 user reviews,3,0,3
688800,True,0,9 user reviews,7,2,9
688810,True,0,No user reviews,0,0,0
688820,True,0,No user reviews,0,0,0
688830,True,0,No user reviews,0,0,0
688860,True,0,3 user reviews,3,0,3
688870,True,0,No user reviews,0,0,0
688880,True,5,Mixed,6,8,14
688890,True,0,No user reviews,0,0,0
688900,True,0,1 user reviews,1,0,1
688910,True,0,No user reviews,0,0,0
688920,True,0,No user reviews,0,0,0
688930,True,0,7 user reviews,6,1,7
688940,True,0,No user reviews,0,0,0
688960,True,0,No user reviews,0,0,0
688970,True,0,No user reviews,0,0,0
688980,True,0,No user reviews,0,0,0
689000,True,0,7 user reviews,5,2,7
689020,True,0,5 user reviews,4,1,5
689030,True,0,1 user reviews,0,1,1
689040,True,0,9 user reviews,8,1,9
689050,True,0,2 user reviews,1,1,2
689070,True,0,No user reviews,0,0,0
689090,True,0,No user reviews,0,0,0
689100,True,0,3 user reviews,2,1,3
689120,True,0,1 user reviews,1,0,1
689130,True,0,No user reviews,0,0,0
689170,True,0,9 user reviews,7,2,9
689180,True,5,Mixed,11,5,16
689210,True,0,1 user reviews,1,0,1
689220,True,0,No user reviews,0,0,0
689270,True,0,1 user reviews,0,1,1
689290,True,7,Positive,13,1,14
689300,True,0,No user reviews,0,0,0
689340,True,0,6 user reviews,4,2,6
689350,True,4,Mostly Negative,7,19,26
689360,True,4,Mostly Negative,5,10,15
689390,True,0,No user reviews,0,0,0
689400,True,0,No user reviews,0,0,0
689420,True,0,No user reviews,0,0,0
689430,True,0,No user reviews,0,0,0
689460,True,0,No user reviews,0,0,0
689470,True,7,Positive,12,0,12
689480,True,0,2 user reviews,0,2,2
689490,True,0,No user reviews,0,0,0
689510,True,0,No user reviews,0,0,0
689520,True,4,Mostly Negative,6,15,21
689550,True,0,1 user reviews,1,0,1
689570,True,7,Positive,9,1,10
689580,True,0,No user reviews,0,0,0
689590,True,0,No user reviews,0,0,0
689600,True,0,No user reviews,0,0,0
689610,True,0,2 user reviews,0,2,2
689620,True,5,Mixed,32,28,60
689630,True,0,No user reviews,0,0,0
689650,True,5,Mixed,31,41,72
689660,True,0,1 user reviews,0,1,1
689680,True,0,No user reviews,0,0,0
689690,True,0,No user reviews,0,0,0
689700,True,5,Mixed,8,5,13
689710,True,7,Positive,20,1,21
689720,True,0,No user reviews,0,0,0
689740,True,0,4 user reviews,4,0,4
689780,True,0,No user reviews,0,0,0
689790,True,5,Mixed,69,43,112
689800,True,5,Mixed,9,13,22
689810,True,5,Mixed,9,5,14
689820,True,0,No user reviews,0,0,0
689830,True,0,No user reviews,0,0,0
689850,True,0,No user reviews,0,0,0
689860,True,6,Mostly Positive,13,5,18
689870,True,7,Positive,8,2,10
689880,True,0,No user reviews,0,0,0
689890,True,0,No user reviews,0,0,0
689900,True,8,Very Positive,86,14,100
689910,True,8,Very Positive,152,12,164
689920,True,6,Mostly Positive,7,3,10
689950,True,7,Positive,10,0,10
689980,True,0,No user reviews,0,0,0
690000,True,0,2 user reviews,1,1,2
690030,True,0,No user reviews,0,0,0
690040,True,8,Very Positive,1952,419,2371
690060,True,0,No user reviews,0,0,0
690080,True,0,3 user reviews,2,1,3
690110,True,0,No user reviews,0,0,0
690120,True,7,Positive,23,3,26
690130,True,0,3 user reviews,3,0,3
690140,True,6,Mostly Positive,78,30,108
690150,True,6,Mostly Positive,19,5,24
690180,True,7,Positive,29,1,30
690200,True,0,6 user reviews,6,0,6
690210,True,0,No user reviews,0,0,0
690220,True,0,1 user reviews,1,0,1
690240,True,5,Mixed,10,6,16
690250,True,0,5 user reviews,2,3,5
690260,True,0,1 user reviews,1,0,1
690280,True,0,7 user reviews,4,3,7
690300,True,0,No user reviews,0,0,0
690310,True,0,7 user reviews,6,1,7
690330,True,0,2 user reviews,2,0,2
690350,True,0,5 user reviews,3,2,5
690370,True,0,No user reviews,0,0,0
690380,True,0,No user reviews,0,0,0
690400,True,7,Positive,13,1,14
690410,True,0,1 user reviews,1,0,1
690420,True,7,Positive,49,0,49
690430,True,0,2 user reviews,1,1,2
690440,True,0,2 user reviews,2,0,2
690450,True,0,No user reviews,0,0,0
690460,True,0,6 user reviews,2,4,6
690500,True,0,No user reviews,0,0,0
690510,True,0,No user reviews,0,0,0
690530,True,5,Mixed,115,74,189
690540,True,0,No user reviews,0,0,0
690550,True,7,Positive,12,1,13
690560,True,8,Very Positive,65,12,77
690570,True,0,1 user reviews,1,0,1
690580,True,0,4 user reviews,0,4,4
690610,True,0,1 user reviews,0,1,1
690620,True,8,Very Positive,47,10,57
690630,True,7,Positive,11,0,11
690640,True,8,Very Positive,1234,108,1342
690660,True,0,1 user reviews,1,0,1
690670,True,0,4 user reviews,1,3,4
690690,True,0,No user reviews,0,0,0
690700,True,0,No user reviews,0,0,0
690710,True,0,9 user reviews,9,0,9
690720,True,0,No user reviews,0,0,0
690730,True,0,2 user reviews,1,1,2
690740,True,5,Mixed,24,17,41
690780,True,0,No user reviews,0,0,0
690790,True,8,Very Positive,3556,846,4402
690800,True,0,No user reviews,0,0,0
690810,True,5,Mixed,175,137,312
690820,True,0,2 user reviews,0,2,2
690830,True,8,Very Positive,2621,436,3057
690840,True,0,1 user reviews,0,1,1
690850,True,0,2 user reviews,2,0,2
690860,True,0,No user reviews,0,0,0
690880,True,0,No user reviews,0,0,0
690930,True,0,No user reviews,0,0,0
690950,True,0,3 user reviews,3,0,3
690980,True,0,No user reviews,0,0,0
690990,True,0,No user reviews,0,0,0
691020,True,0,1 user reviews,0,1,1
691080,True,4,Mostly Negative,7,22,29
691110,True,7,Positive,9,1,10
691120,True,0,2 user reviews,2,0,2
691140,True,0,4 user reviews,3,1,4
691150,True,8,Very Positive,46,4,50
691160,True,8,Very Positive,212,18,230
691190,True,5,Mixed,14,8,22
691210,True,0,No user reviews,0,0,0
691220,True,0,2 user reviews,1,1,2
691240,True,7,Positive,8,2,10
691250,True,0,9 user reviews,8,1,9
691260,True,8,Very Positive,378,38,416
691280,True,5,Mixed,85,41,126
691290,True,0,No user reviews,0,0,0
691300,True,0,3 user reviews,3,0,3
691310,True,0,3 user reviews,2,1,3
691320,True,6,Mostly Positive,182,57,239
691390,True,6,Mostly Positive,16,6,22
691400,True,0,No user reviews,0,0,0
691420,True,0,2 user reviews,0,2,2
691430,True,7,Positive,20,0,20
691440,True,0,2 user reviews,2,0,2
691441,True,0,5 user reviews,5,0,5
691450,True,8,Very Positive,459,10,469
691460,True,0,No user reviews,0,0,0
691480,True,0,2 user reviews,2,0,2
691490,True,0,6 user reviews,6,0,6
691500,True,0,1 user reviews,1,0,1
691510,True,0,3 user reviews,1,2,3
691520,True,0,No user reviews,0,0,0
691530,True,0,No user reviews,0,0,0
691540,True,0,No user reviews,0,0,0
691560,True,0,No user reviews,0,0,0
691570,True,0,2 user reviews,2,0,2
691580,True,0,4 user reviews,4,0,4
691590,True,5,Mixed,6,6,12
691600,True,0,4 user reviews,4,0,4
691620,True,0,5 user reviews,4,1,5
691630,True,5,Mixed,34,22,56
691640,True,0,No user reviews,0,0,0
691650,True,0,2 user reviews,2,0,2
691680,True,0,2 user reviews,2,0,2
691690,True,5,Mixed,328,161,489
691700,True,0,2 user reviews,1,1,2
691720,True,0,6 user reviews,4,2,6
691730,True,0,No user reviews,0,0,0
691750,True,0,6 user reviews,4,2,6
691770,True,8,Very Positive,108,6,114
691790,True,0,No user reviews,0,0,0
691820,True,0,4 user reviews,3,1,4
691830,True,8,Very Positive,96,18,114
691850,True,0,No user reviews,0,0,0
691860,True,0,5 user reviews,3,2,5
691890,True,0,5 user reviews,4,1,5
691910,True,0,1 user reviews,1,0,1
691930,True,0,No user reviews,0,0,0
691950,True,0,No user reviews,0,0,0
691960,True,0,No user reviews,0,0,0
691961,True,0,No user reviews,0,0,0
691970,True,0,No user reviews,0,0,0
691980,True,0,7 user reviews,0,7,7
691990,True,0,No user reviews,0,0,0
692010,True,0,4 user reviews,2,2,4
692030,True,5,Mixed,27,35,62
692050,True,0,No user reviews,0,0,0
692060,True,0,No user reviews,0,0,0
692080,True,7,Positive,18,1,19
692090,True,0,No user reviews,0,0,0
692100,True,8,Very Positive,130,32,162
692110,True,0,1 user reviews,1,0,1
692120,True,0,6 user reviews,5,1,6
692130,True,0,No user reviews,0,0,0
692140,True,0,1 user reviews,1,0,1
692150,True,0,2 user reviews,2,0,2
692151,True,7,Positive,11,0,11
692152,True,0,1 user reviews,1,0,1
692153,True,0,4 user reviews,4,0,4
692170,True,0,4 user reviews,0,4,4
692190,True,0,6 user reviews,5,1,6
692200,True,5,Mixed,19,9,28
692240,True,0,1 user reviews,0,1,1
692270,True,0,No user reviews,0,0,0
692300,True,0,No user reviews,0,0,0
692310,True,0,1 user reviews,0,1,1
692330,True,0,No user reviews,0,0,0
692360,True,6,Mostly Positive,18,6,24
692500,True,0,1 user reviews,1,0,1
692510,True,7,Positive,12,0,12
692520,True,0,No user reviews,0,0,0
692530,True,0,2 user reviews,1,1,2
692590,True,0,7 user reviews,3,4,7
692610,True,0,No user reviews,0,0,0
692630,True,0,2 user reviews,0,2,2
692660,True,0,2 user reviews,2,0,2
692680,True,0,3 user reviews,3,0,3
692690,True,7,Positive,41,7,48
692710,True,0,No user reviews,0,0,0
692770,True,0,3 user reviews,3,0,3
692780,True,4,Mostly Negative,3,9,12
692790,True,0,7 user reviews,3,4,7
692830,True,5,Mixed,9,8,17
692840,True,5,Mixed,153,204,357
692850,True,9,Overwhelmingly Positive,6665,294,6959
692890,True,8,Very Positive,338,15,353
692920,True,0,No user reviews,0,0,0
692930,True,6,Mostly Positive,31,8,39
692950,True,0,6 user reviews,6,0,6
692960,True,0,No user reviews,0,0,0
693000,True,0,2 user reviews,1,1,2
693020,True,0,No user reviews,0,0,0
693030,True,0,5 user reviews,5,0,5
693050,True,0,6 user reviews,1,5,6
693060,True,0,No user reviews,0,0,0
693070,True,0,No user reviews,0,0,0
693080,True,0,No user reviews,0,0,0
693090,True,0,6 user reviews,3,3,6
693150,True,0,No user reviews,0,0,0
693160,True,0,9 user reviews,2,7,9
693170,True,8,Very Positive,95,1,96
693180,True,5,Mixed,7,6,13
693190,True,0,4 user reviews,1,3,4
693200,True,0,No user reviews,0,0,0
693210,True,6,Mostly Positive,15,5,20
693220,True,0,No user reviews,0,0,0
693240,True,0,8 user reviews,4,4,8
693250,True,5,Mixed,16,10,26
693280,True,0,2 user reviews,0,2,2
693290,True,0,No user reviews,0,0,0
693300,True,0,2 user reviews,1,1,2
693310,True,0,2 user reviews,1,1,2
693320,True,0,3 user reviews,2,1,3
693330,True,0,2 user reviews,2,0,2
693380,True,0,5 user reviews,5,0,5
693400,True,0,3 user reviews,0,3,3
693430,True,0,1 user reviews,0,1,1
693450,True,7,Positive,11,0,11
693470,True,0,8 user reviews,7,1,8
693500,True,0,1 user reviews,0,1,1
693510,True,0,2 user reviews,2,0,2
693520,True,0,No user reviews,0,0,0
693560,True,0,4 user reviews,4,0,4
693580,True,5,Mixed,47,33,80
693590,True,0,No user reviews,0,0,0
693600,True,0,No user reviews,0,0,0
693601,True,0,No user reviews,0,0,0
693602,True,0,No user reviews,0,0,0
693603,True,0,No user reviews,0,0,0
693604,True,0,No user reviews,0,0,0
693605,True,0,No user reviews,0,0,0
693606,True,0,No user reviews,0,0,0
693607,True,0,No user reviews,0,0,0
693608,True,0,No user reviews,0,0,0
693609,True,0,No user reviews,0,0,0
693610,True,0,No user reviews,0,0,0
693611,True,0,No user reviews,0,0,0
693612,True,0,No user reviews,0,0,0
693613,True,0,No user reviews,0,0,0
693614,True,0,No user reviews,0,0,0
693615,True,0,No user reviews,0,0,0
693616,True,0,No user reviews,0,0,0
693617,True,0,No user reviews,0,0,0
693618,True,0,No user reviews,0,0,0
693619,True,0,No user reviews,0,0,0
693620,True,0,No user reviews,0,0,0
693621,True,0,No user reviews,0,0,0
693622,True,0,No user reviews,0,0,0
693623,True,0,No user reviews,0,0,0
693624,True,0,No user reviews,0,0,0
693625,True,0,No user reviews,0,0,0
693626,True,0,No user reviews,0,0,0
693627,True,0,No user reviews,0,0,0
693628,True,0,No user reviews,0,0,0
693629,True,0,No user reviews,0,0,0
693630,True,0,No user reviews,0,0,0
693631,True,0,No user reviews,0,0,0
693632,True,0,No user reviews,0,0,0
693633,True,0,No user reviews,0,0,0
693634,True,0,No user reviews,0,0,0
693635,True,0,No user reviews,0,0,0
693636,True,0,No user reviews,0,0,0
693637,True,0,No user reviews,0,0,0
693638,True,0,No user reviews,0,0,0
693639,True,0,No user reviews,0,0,0
693641,True,0,No user reviews,0,0,0
693642,True,0,No user reviews,0,0,0
693643,True,0,No user reviews,0,0,0
693644,True,0,No user reviews,0,0,0
693650,True,0,5 user reviews,5,0,5
693660,True,0,No user reviews,0,0,0
693670,True,6,Mostly Positive,19,8,27
693700,True,8,Very Positive,89,15,104
693710,True,0,1 user reviews,1,0,1
693750,True,5,Mixed,39,26,65
693760,True,0,No user reviews,0,0,0
693790,True,0,8 user reviews,4,4,8
693800,True,5,Mixed,15,13,28
693810,True,0,No user reviews,0,0,0
693820,True,0,1 user reviews,0,1,1
693830,True,0,3 user reviews,2,1,3
693880,True,4,Mostly Negative,5,10,15
693890,True,5,Mixed,7,5,12
693900,True,0,No user reviews,0,0,0
693910,True,0,2 user reviews,1,1,2
693950,True,0,5 user reviews,5,0,5
693960,True,6,Mostly Positive,17,7,24
693990,True,0,No user reviews,0,0,0
694050,True,0,2 user reviews,1,1,2
694070,True,0,5 user reviews,3,2,5
694080,True,0,No user reviews,0,0,0
694090,True,5,Mixed,59,34,93
694100,True,0,No user reviews,0,0,0
694110,True,0,No user reviews,0,0,0
694130,True,0,No user reviews,0,0,0
694140,True,0,4 user reviews,2,2,4
694150,True,0,2 user reviews,2,0,2
694160,True,0,No user reviews,0,0,0
694180,True,0,No user reviews,0,0,0
694190,True,0,8 user reviews,4,4,8
694200,True,0,No user reviews,0,0,0
694210,True,0,1 user reviews,1,0,1
694230,True,0,No user reviews,0,0,0
694240,True,0,No user reviews,0,0,0
694300,True,0,No user reviews,0,0,0
694350,True,0,No user reviews,0,0,0
694360,True,0,No user reviews,0,0,0
694370,True,8,Very Positive,64,4,68
694380,True,0,1 user reviews,1,0,1
694390,True,0,6 user reviews,6,0,6
694400,True,0,No user reviews,0,0,0
694420,True,0,1 user reviews,1,0,1
694430,True,0,3 user reviews,0,3,3
694440,True,0,6 user reviews,0,6,6
694450,True,0,No user reviews,0,0,0
694460,True,0,No user reviews,0,0,0
694470,True,0,5 user reviews,1,4,5
694480,True,6,Mostly Positive,10,4,14
694490,True,3,Negative,3,13,16
694500,True,8,Very Positive,239,49,288
694510,True,0,1 user reviews,1,0,1
694520,True,0,7 user reviews,6,1,7
694550,True,0,No user reviews,0,0,0
694610,True,0,No user reviews,0,0,0
694620,True,0,No user reviews,0,0,0
694630,True,0,1 user reviews,1,0,1
694631,True,0,No user reviews,0,0,0
694632,True,0,No user reviews,0,0,0
694633,True,0,No user reviews,0,0,0
694634,True,0,No user reviews,0,0,0
694635,True,0,No user reviews,0,0,0
694636,True,0,No user reviews,0,0,0
694637,True,0,No user reviews,0,0,0
694638,True,0,No user reviews,0,0,0
694639,True,0,No user reviews,0,0,0
694640,True,0,No user reviews,0,0,0
694641,True,0,No user reviews,0,0,0
694642,True,0,No user reviews,0,0,0
694643,True,0,No user reviews,0,0,0
694644,True,0,No user reviews,0,0,0
694645,True,0,No user reviews,0,0,0
694646,True,0,No user reviews,0,0,0
694647,True,0,No user reviews,0,0,0
694648,True,0,No user reviews,0,0,0
694649,True,0,No user reviews,0,0,0
694650,True,0,No user reviews,0,0,0
694651,True,0,No user reviews,0,0,0
694652,True,0,No user reviews,0,0,0
694653,True,0,1 user reviews,1,0,1
694654,True,0,No user reviews,0,0,0
694660,True,0,2 user reviews,2,0,2
694670,True,0,1 user reviews,1,0,1
694680,True,6,Mostly Positive,19,7,26
694700,True,0,No user reviews,0,0,0
694720,True,0,No user reviews,0,0,0
694730,True,5,Mixed,6,6,12
694760,True,0,7 user reviews,7,0,7
694770,True,8,Very Positive,200,18,218
694780,True,0,No user reviews,0,0,0
694790,True,7,Positive,16,2,18
694800,True,0,No user reviews,0,0,0
694820,True,0,No user reviews,0,0,0
694830,True,0,3 user reviews,3,0,3
694870,True,7,Positive,19,2,21
694880,True,5,Mixed,221,139,360
694930,True,0,7 user reviews,4,3,7
694940,True,0,No user reviews,0,0,0
694950,True,7,Positive,11,0,11
694960,True,0,No user reviews,0,0,0
694980,True,0,6 user reviews,5,1,6
694990,True,0,No user reviews,0,0,0
695000,True,0,No user reviews,0,0,0
695010,True,0,No user reviews,0,0,0
695030,True,0,No user reviews,0,0,0
695050,True,8,Very Positive,85,17,102
695080,True,0,No user reviews,0,0,0
695100,True,8,Very Positive,61,13,74
695110,True,0,7 user reviews,7,0,7
695130,True,0,No user reviews,0,0,0
695140,True,0,No user reviews,0,0,0
695160,True,0,No user reviews,0,0,0
695170,True,0,No user reviews,0,0,0
695180,True,0,No user reviews,0,0,0
695190,True,0,No user reviews,0,0,0
695200,True,0,No user reviews,0,0,0
695210,True,0,No user reviews,0,0,0
695220,True,0,No user reviews,0,0,0
695230,True,0,No user reviews,0,0,0
695240,True,0,No user reviews,0,0,0
695250,True,0,No user reviews,0,0,0
695260,True,0,No user reviews,0,0,0
695270,True,0,No user reviews,0,0,0
695280,True,0,No user reviews,0,0,0
695290,True,6,Mostly Positive,846,316,1162
695320,True,0,2 user reviews,2,0,2
695360,True,0,4 user reviews,0,4,4
695370,True,0,2 user reviews,2,0,2
695371,True,0,2 user reviews,1,1,2
695380,True,0,No user reviews,0,0,0
695420,True,0,2 user reviews,2,0,2
695440,True,0,2 user reviews,1,1,2
695450,True,6,Mostly Positive,11,4,15
695460,True,0,No user reviews,0,0,0
695470,True,0,No user reviews,0,0,0
695490,True,0,6 user reviews,4,2,6
695500,True,0,No user reviews,0,0,0
695510,True,7,Positive,8,2,10
695520,True,0,3 user reviews,1,2,3
695560,True,0,No user reviews,0,0,0
695570,True,7,Positive,10,0,10
695580,True,0,No user reviews,0,0,0
695600,True,6,Mostly Positive,112,39,151
695630,True,5,Mixed,6,7,13
695650,True,0,No user reviews,0,0,0
695660,True,7,Positive,18,3,21
695680,True,6,Mostly Positive,92,25,117
695690,True,5,Mixed,26,34,60
695700,True,0,No user reviews,0,0,0
695720,True,0,No user reviews,0,0,0
695730,True,0,No user reviews,0,0,0
695740,True,0,9 user reviews,1,8,9
695741,True,0,No user reviews,0,0,0
695742,True,0,No user reviews,0,0,0
695743,True,0,2 user reviews,1,1,2
695760,True,5,Mixed,13,10,23
695810,True,0,5 user reviews,2,3,5
695820,True,0,1 user reviews,1,0,1
695830,True,0,No user reviews,0,0,0
695840,True,0,No user reviews,0,0,0
695860,True,0,8 user reviews,4,4,8
695870,True,0,No user reviews,0,0,0
695880,True,0,No user reviews,0,0,0
695910,True,0,5 user reviews,3,2,5
695920,True,8,Very Positive,290,49,339
695940,True,0,3 user reviews,2,1,3
695950,True,0,3 user reviews,3,0,3
695960,True,0,5 user reviews,5,0,5
695970,True,8,Very Positive,51,4,55
695980,True,0,4 user reviews,3,1,4
695990,True,0,1 user reviews,1,0,1
696000,True,0,6 user reviews,5,1,6
696010,True,0,2 user reviews,2,0,2
696020,True,0,2 user reviews,2,0,2
696030,True,0,1 user reviews,1,0,1
696040,True,0,3 user reviews,2,1,3
696050,True,0,No user reviews,0,0,0
696060,True,7,Positive,11,0,11
696070,True,0,No user reviews,0,0,0
696110,True,0,8 user reviews,4,4,8
696120,True,0,No user reviews,0,0,0
696140,True,8,Very Positive,72,12,84
696150,True,7,Positive,10,0,10
696160,True,0,No user reviews,0,0,0
696170,True,8,Very Positive,628,134,762
696180,True,5,Mixed,104,48,152
696190,True,0,5 user reviews,3,2,5
696200,True,7,Positive,18,0,18
696210,True,0,No user reviews,0,0,0
696211,True,0,No user reviews,0,0,0
696220,True,8,Very Positive,268,33,301
696230,True,0,6 user reviews,6,0,6
696250,True,0,9 user reviews,3,6,9
696260,True,0,No user reviews,0,0,0
696280,True,6,Mostly Positive,9,3,12
696290,True,0,No user reviews,0,0,0
696300,True,0,No user reviews,0,0,0
696310,True,0,1 user reviews,1,0,1
696331,True,0,No user reviews,0,0,0
696340,True,0,No user reviews,0,0,0
696350,True,0,No user reviews,0,0,0
696360,True,5,Mixed,21,10,31
696370,True,6,Mostly Positive,329,118,447
696400,True,0,8 user reviews,3,5,8
696410,True,0,3 user reviews,2,1,3
696420,True,0,No user reviews,0,0,0
696430,True,0,No user reviews,0,0,0
696440,True,0,3 user reviews,2,1,3
696460,True,7,Positive,20,4,24
696470,True,0,3 user reviews,1,2,3
696480,True,8,Very Positive,217,5,222
696490,True,7,Positive,10,1,11
696500,True,3,Negative,1,10,11
696510,True,0,6 user reviews,5,1,6
696530,True,6,Mostly Positive,83,23,106
696540,True,0,2 user reviews,1,1,2
696560,True,7,Positive,26,6,32
696570,True,0,No user reviews,0,0,0
696580,True,0,4 user reviews,3,1,4
696590,True,8,Very Positive,59,11,70
696600,True,0,No user reviews,0,0,0
696610,True,0,No user reviews,0,0,0
696620,True,0,No user reviews,0,0,0
696640,True,0,No user reviews,0,0,0
696650,True,5,Mixed,105,55,160
696670,True,0,No user reviews,0,0,0
696680,True,5,Mixed,257,168,425
696710,True,0,5 user reviews,5,0,5
696740,True,0,1 user reviews,1,0,1
696760,True,0,6 user reviews,5,1,6
696770,True,0,No user reviews,0,0,0
696790,True,5,Mixed,253,139,392
696810,True,5,Mixed,6,4,10
696830,True,0,No user reviews,0,0,0
696840,True,0,9 user reviews,5,4,9
696850,True,0,No user reviews,0,0,0
696860,True,0,3 user reviews,3,0,3
696880,True,0,4 user reviews,3,1,4
696890,True,0,No user reviews,0,0,0
696891,True,0,No user reviews,0,0,0
696892,True,0,No user reviews,0,0,0
696910,True,0,4 user reviews,4,0,4
696920,True,0,No user reviews,0,0,0
696940,True,6,Mostly Positive,34,13,47
696990,True,0,No user reviews,0,0,0
697000,True,0,2 user reviews,0,2,2
697010,True,5,Mixed,8,9,17
697020,True,5,Mixed,6,8,14
697040,True,0,1 user reviews,1,0,1
697130,True,0,3 user reviews,0,3,3
697160,True,0,1 user reviews,0,1,1
697170,True,0,No user reviews,0,0,0
697180,True,0,No user reviews,0,0,0
697210,True,0,No user reviews,0,0,0
697250,True,5,Mixed,5,7,12
697270,True,0,No user reviews,0,0,0
697320,True,0,4 user reviews,1,3,4
697330,True,0,No user reviews,0,0,0
697340,True,0,3 user reviews,1,2,3
697350,True,0,3 user reviews,3,0,3
697370,True,0,5 user reviews,4,1,5
697380,True,0,1 user reviews,0,1,1
697400,True,0,No user reviews,0,0,0
697410,True,0,No user reviews,0,0,0
697420,True,0,No user reviews,0,0,0
697430,True,0,2 user reviews,2,0,2
697440,True,8,Very Positive,194,5,199
697450,True,0,No user reviews,0,0,0
697480,True,0,No user reviews,0,0,0
697490,True,0,3 user reviews,0,3,3
697510,True,0,No user reviews,0,0,0
697530,True,0,No user reviews,0,0,0
697550,True,8,Very Positive,694,100,794
697560,True,0,No user reviews,0,0,0
697570,True,0,No user reviews,0,0,0
697580,True,5,Mixed,8,5,13
697600,True,0,6 user reviews,6,0,6
697610,True,0,No user reviews,0,0,0
697620,True,0,No user reviews,0,0,0
697630,True,5,Mixed,9,11,20
697650,True,8,Very Positive,54,4,58
697660,True,5,Mixed,6,4,10
697670,True,0,7 user reviews,6,1,7
697680,True,0,No user reviews,0,0,0
697710,True,0,9 user reviews,9,0,9
697720,True,0,No user reviews,0,0,0
697730,True,0,2 user reviews,1,1,2
697760,True,7,Positive,13,1,14
697800,True,7,Positive,14,0,14
697810,True,0,No user reviews,0,0,0
697850,True,5,Mixed,6,4,10
697860,True,7,Positive,34,6,40
697870,True,0,2 user reviews,1,1,2
697880,True,0,6 user reviews,2,4,6
697890,True,0,No user reviews,0,0,0
697910,True,0,3 user reviews,3,0,3
697920,True,0,No user reviews,0,0,0
697930,True,5,Mixed,9,5,14
697950,True,0,3 user reviews,2,1,3
697960,True,0,9 user reviews,7,2,9
697970,True,0,No user reviews,0,0,0
697990,True,0,No user reviews,0,0,0
698030,True,0,1 user reviews,0,1,1
698040,True,0,9 user reviews,6,3,9
698050,True,0,2 user reviews,1,1,2
698060,True,0,1 user reviews,1,0,1
698080,True,0,3 user reviews,1,2,3
698090,True,0,No user reviews,0,0,0
698100,True,0,No user reviews,0,0,0
698110,True,6,Mostly Positive,10,4,14
698120,True,0,No user reviews,0,0,0
698130,True,0,No user reviews,0,0,0
698160,True,0,4 user reviews,0,4,4
698180,True,0,No user reviews,0,0,0
698190,True,0,No user reviews,0,0,0
698200,True,0,No user reviews,0,0,0
698201,True,0,No user reviews,0,0,0
698202,True,0,No user reviews,0,0,0
698203,True,0,No user reviews,0,0,0
698204,True,0,No user reviews,0,0,0
698205,True,0,No user reviews,0,0,0
698206,True,0,No user reviews,0,0,0
698207,True,0,No user reviews,0,0,0
698208,True,0,No user reviews,0,0,0
698209,True,0,No user reviews,0,0,0
698210,True,0,No user reviews,0,0,0
698211,True,0,No user reviews,0,0,0
698212,True,0,No user reviews,0,0,0
698213,True,0,No user reviews,0,0,0
698214,True,0,No user reviews,0,0,0
698215,True,0,No user reviews,0,0,0
698216,True,0,No user reviews,0,0,0
698217,True,0,No user reviews,0,0,0
698218,True,0,No user reviews,0,0,0
698219,True,0,No user reviews,0,0,0
698220,True,0,No user reviews,0,0,0
698221,True,0,No user reviews,0,0,0
698222,True,0,No user reviews,0,0,0
698223,True,0,No user reviews,0,0,0
698224,True,0,No user reviews,0,0,0
698225,True,0,No user reviews,0,0,0
698226,True,0,No user reviews,0,0,0
698230,True,0,No user reviews,0,0,0
698240,True,7,Positive,14,0,14
698250,True,0,7 user reviews,7,0,7
698260,True,8,Very Positive,212,47,259
698280,True,6,Mostly Positive,19,6,25
698290,True,0,No user reviews,0,0,0
698300,True,7,Positive,22,2,24
698320,True,0,No user reviews,0,0,0
698330,True,6,Mostly Positive,19,6,25
698340,True,0,No user reviews,0,0,0
698360,True,0,5 user reviews,4,1,5
698370,True,0,No user reviews,0,0,0
698390,True,0,No user reviews,0,0,0
698410,True,0,4 user reviews,1,3,4
698440,True,0,2 user reviews,2,0,2
698450,True,7,Positive,13,0,13
698460,True,0,No user reviews,0,0,0
698470,True,0,No user reviews,0,0,0
698480,True,0,1 user reviews,1,0,1
698500,True,0,8 user reviews,6,2,8
698520,True,7,Positive,11,2,13
698540,True,8,Very Positive,259,23,282
698560,True,0,No user reviews,0,0,0
698570,True,0,4 user reviews,4,0,4
698590,True,0,9 user reviews,8,1,9
698600,True,0,2 user reviews,0,2,2
698610,True,0,2 user reviews,1,1,2
698620,True,7,Positive,8,2,10
698640,True,6,Mostly Positive,484,158,642
698650,True,7,Positive,10,0,10
698670,True,0,No user reviews,0,0,0
698690,True,0,No user reviews,0,0,0
698700,True,0,No user reviews,0,0,0
698710,True,5,Mixed,8,11,19
698740,True,0,5 user reviews,5,0,5
698760,True,0,8 user reviews,7,1,8
698770,True,7,Positive,19,1,20
698780,True,8,Very Positive,147,4,151
698790,True,7,Positive,16,3,19
698810,True,0,No user reviews,0,0,0
698830,True,5,Mixed,15,11,26
698840,True,0,No user reviews,0,0,0
698850,True,0,No user reviews,0,0,0
698870,True,7,Positive,34,7,41
698880,True,0,No user reviews,0,0,0
698890,True,0,6 user reviews,6,0,6
698910,True,7,Positive,9,1,10
698920,True,0,No user reviews,0,0,0
698950,True,0,1 user reviews,1,0,1
698960,True,0,No user reviews,0,0,0
698980,True,0,3 user reviews,2,1,3
698990,True,0,No user reviews,0,0,0
699000,True,0,No user reviews,0,0,0
699010,True,0,8 user reviews,2,6,8
699030,True,0,No user reviews,0,0,0
699040,True,0,No user reviews,0,0,0
699060,True,0,2 user reviews,1,1,2
699080,True,7,Positive,33,7,40
699090,True,0,2 user reviews,2,0,2
699100,True,5,Mixed,9,6,15
699150,True,7,Positive,35,3,38
699160,True,0,4 user reviews,2,2,4
699170,True,8,Very Positive,1892,162,2054
699180,True,8,Very Positive,199,18,217
699200,True,0,2 user reviews,2,0,2
699230,True,0,3 user reviews,3,0,3
699240,True,5,Mixed,9,4,13
699250,True,0,No user reviews,0,0,0
699290,True,0,7 user reviews,7,0,7
699330,True,0,No user reviews,0,0,0
699340,True,0,No user reviews,0,0,0
699350,True,7,Positive,22,0,22
699370,True,0,1 user reviews,0,1,1
699390,True,7,Positive,18,3,21
699410,True,0,8 user reviews,6,2,8
699440,True,0,No user reviews,0,0,0
699470,True,0,1 user reviews,0,1,1
699480,True,5,Mixed,4,6,10
699510,True,0,1 user reviews,0,1,1
699520,True,0,No user reviews,0,0,0
699540,True,7,Positive,30,1,31
699550,True,0,7 user reviews,1,6,7
699560,True,0,No user reviews,0,0,0
699570,True,0,2 user reviews,0,2,2
699590,True,5,Mixed,10,6,16
699600,True,8,Very Positive,71,3,74
699670,True,5,Mixed,75,37,112
699680,True,5,Mixed,8,5,13
699700,True,5,Mixed,8,11,19
699720,True,0,No user reviews,0,0,0
699740,True,5,Mixed,48,35,83
699750,True,0,6 user reviews,4,2,6
699760,True,4,Mostly Negative,3,9,12
699770,True,5,Mixed,33,27,60
699780,True,7,Positive,26,3,29
699790,True,0,1 user reviews,1,0,1
699820,True,0,6 user reviews,2,4,6
699830,True,0,4 user reviews,3,1,4
699850,True,0,4 user reviews,3,1,4
699860,True,0,3 user reviews,1,2,3
699870,True,5,Mixed,20,23,43
699920,True,6,Mostly Positive,147,49,196
699930,True,0,1 user reviews,1,0,1
699940,True,5,Mixed,24,12,36
699970,True,0,2 user reviews,1,1,2
699990,True,0,5 user reviews,3,2,5
700010,True,0,9 user reviews,5,4,9
700030,True,5,Mixed,553,771,1324
700050,True,0,No user reviews,0,0,0
700060,True,5,Mixed,6,7,13
700100,True,0,9 user reviews,7,2,9
700140,True,0,5 user reviews,5,0,5
700150,True,0,No user reviews,0,0,0
700160,True,8,Very Positive,60,8,68
700170,True,0,No user reviews,0,0,0
700180,True,0,2 user reviews,2,0,2
700200,True,7,Positive,16,4,20
700210,True,0,No user reviews,0,0,0
700230,True,0,5 user reviews,5,0,5
700240,True,0,8 user reviews,4,4,8
700270,True,0,No user reviews,0,0,0
700280,True,8,Very Positive,377,89,466
700282,True,5,Mixed,418,327,745
700290,True,0,1 user reviews,1,0,1
700300,True,0,No user reviews,0,0,0
700310,True,0,No user reviews,0,0,0
700320,True,0,8 user reviews,7,1,8
700330,True,0,No user reviews,0,0,0
700340,True,0,No user reviews,0,0,0
700360,True,0,6 user reviews,4,2,6
700370,True,0,No user reviews,0,0,0
700380,True,0,No user reviews,0,0,0
700400,True,0,3 user reviews,3,0,3
700420,True,0,No user reviews,0,0,0
700430,True,0,No user reviews,0,0,0
700440,True,5,Mixed,6,5,11
700450,True,0,No user reviews,0,0,0
700460,True,0,1 user reviews,1,0,1
700470,True,4,Mostly Negative,3,8,11
700480,True,0,No user reviews,0,0,0
700490,True,0,No user reviews,0,0,0
700500,True,0,No user reviews,0,0,0
700510,True,0,No user reviews,0,0,0
700520,True,7,Positive,13,0,13
700540,True,0,2 user reviews,1,1,2
700550,True,0,No user reviews,0,0,0
700560,True,0,3 user reviews,1,2,3
700570,True,0,No user reviews,0,0,0
700580,True,0,No user reviews,0,0,0
700590,True,0,6 user reviews,4,2,6
700600,True,0,No user reviews,0,0,0
700610,True,0,No user reviews,0,0,0
700620,True,6,Mostly Positive,14,4,18
700650,True,0,6 user reviews,4,2,6
700660,True,5,Mixed,27,14,41
700670,True,0,No user reviews,0,0,0
700680,True,0,No user reviews,0,0,0
700690,True,0,No user reviews,0,0,0
700700,True,0,No user reviews,0,0,0
700710,True,0,No user reviews,0,0,0
700720,True,0,No user reviews,0,0,0
700730,True,0,1 user reviews,1,0,1
700740,True,5,Mixed,14,14,28
700750,True,0,9 user reviews,7,2,9
700770,True,0,9 user reviews,3,6,9
700800,True,0,3 user reviews,0,3,3
700820,True,0,No user reviews,0,0,0
700830,True,0,9 user reviews,8,1,9
700850,True,0,7 user reviews,6,1,7
700851,True,0,1 user reviews,0,1,1
700860,True,0,No user reviews,0,0,0
700870,True,0,4 user reviews,4,0,4
700880,True,0,1 user reviews,1,0,1
700900,True,0,No user reviews,0,0,0
700910,True,0,2 user reviews,2,0,2
700920,True,0,5 user reviews,3,2,5
700930,True,0,No user reviews,0,0,0
700940,True,0,1 user reviews,0,1,1
700950,True,0,No user reviews,0,0,0
700960,True,0,1 user reviews,1,0,1
700970,True,0,No user reviews,0,0,0
700971,True,0,No user reviews,0,0,0
700972,True,0,No user reviews,0,0,0
700973,True,0,No user reviews,0,0,0
700980,True,0,No user reviews,0,0,0
700990,True,0,9 user reviews,4,5,9
701000,True,0,No user reviews,0,0,0
701010,True,0,No user reviews,0,0,0
701020,True,0,No user reviews,0,0,0
701040,True,7,Positive,30,0,30
701060,True,0,No user reviews,0,0,0
701080,True,7,Positive,13,0,13
701100,True,0,No user reviews,0,0,0
701160,True,8,Very Positive,1725,292,2017
701180,True,7,Positive,18,0,18
701260,True,0,No user reviews,0,0,0
701270,True,0,6 user reviews,6,0,6
701280,True,0,5 user reviews,3,2,5
701290,True,0,9 user reviews,6,3,9
701360,True,0,No user reviews,0,0,0
701370,True,0,1 user reviews,0,1,1
701380,True,7,Positive,35,1,36
701410,True,0,No user reviews,0,0,0
701420,True,7,Positive,12,0,12
701440,True,7,Positive,12,0,12
701460,True,0,7 user reviews,3,4,7
701470,True,7,Positive,35,2,37
701480,True,0,No user reviews,0,0,0
701490,True,0,No user reviews,0,0,0
701500,True,0,No user reviews,0,0,0
701520,True,0,No user reviews,0,0,0
701531,True,8,Very Positive,126,2,128
701540,True,5,Mixed,7,5,12
701560,True,0,No user reviews,0,0,0
701580,True,0,No user reviews,0,0,0
701610,True,7,Positive,9,2,11
701620,True,0,No user reviews,0,0,0
701630,True,0,No user reviews,0,0,0
701640,True,0,No user reviews,0,0,0
701650,True,0,No user reviews,0,0,0
701670,True,0,No user reviews,0,0,0
701680,True,0,No user reviews,0,0,0
701690,True,0,No user reviews,0,0,0
701710,True,0,No user reviews,0,0,0
701720,True,5,Mixed,17,9,26
701730,True,8,Very Positive,48,8,56
701740,True,0,6 user reviews,3,3,6
701750,True,0,No user reviews,0,0,0
701760,True,7,Positive,11,2,13
701800,True,0,2 user reviews,2,0,2
701810,True,7,Positive,13,0,13
701820,True,0,2 user reviews,2,0,2
701840,True,0,No user reviews,0,0,0
701860,True,7,Positive,16,3,19
701870,True,7,Positive,30,3,33
701880,True,0,1 user reviews,1,0,1
701890,True,0,No user reviews,0,0,0
701900,True,0,No user reviews,0,0,0
701910,True,0,3 user reviews,3,0,3
701930,True,0,2 user reviews,2,0,2
701940,True,0,4 user reviews,4,0,4
701950,True,7,Positive,8,2,10
701960,True,0,4 user reviews,2,2,4
701970,True,0,4 user reviews,3,1,4
701980,True,0,3 user reviews,2,1,3
701990,True,0,1 user reviews,1,0,1
702000,True,0,No user reviews,0,0,0
702010,True,0,No user reviews,0,0,0
702030,True,7,Positive,10,1,11
702040,True,0,2 user reviews,2,0,2
702050,True,8,Very Positive,312,31,343
702070,True,0,No user reviews,0,0,0
702080,True,0,1 user reviews,0,1,1
702100,True,0,No user reviews,0,0,0
702110,True,8,Very Positive,58,5,63
702120,True,6,Mostly Positive,47,13,60
702140,True,0,No user reviews,0,0,0
702150,True,0,4 user reviews,3,1,4
702160,True,0,No user reviews,0,0,0
702180,True,0,1 user reviews,0,1,1
702190,True,4,Mostly Negative,4,10,14
702200,True,0,6 user reviews,0,6,6
702210,True,5,Mixed,10,6,16
702220,True,0,7 user reviews,5,2,7
702250,True,0,No user reviews,0,0,0
702270,True,0,1 user reviews,1,0,1
702300,True,0,3 user reviews,3,0,3
702310,True,0,2 user reviews,1,1,2
702320,True,0,No user reviews,0,0,0
702330,True,0,1 user reviews,1,0,1
702340,True,0,No user reviews,0,0,0
702350,True,6,Mostly Positive,486,193,679
702360,True,0,3 user reviews,3,0,3
702410,True,0,No user reviews,0,0,0
702411,True,0,No user reviews,0,0,0
702412,True,0,No user reviews,0,0,0
702413,True,0,No user reviews,0,0,0
702414,True,0,No user reviews,0,0,0
702415,True,0,No user reviews,0,0,0
702430,True,5,Mixed,8,8,16
702490,True,0,No user reviews,0,0,0
702510,True,4,Mostly Negative,7,13,20
702540,True,6,Mostly Positive,126,42,168
702550,True,0,2 user reviews,2,0,2
702590,True,0,No user reviews,0,0,0
702600,True,7,Positive,8,2,10
702620,True,0,No user reviews,0,0,0
702660,True,8,Very Positive,124,10,134
702670,True,8,Very Positive,2007,341,2348
702680,True,0,No user reviews,0,0,0
702690,True,0,No user reviews,0,0,0
702691,True,0,No user reviews,0,0,0
702692,True,0,No user reviews,0,0,0
702693,True,0,No user reviews,0,0,0
702694,True,0,No user reviews,0,0,0
702695,True,0,No user reviews,0,0,0
702696,True,0,No user reviews,0,0,0
702700,True,5,Mixed,35,41,76
702720,True,0,No user reviews,0,0,0
702721,True,0,No user reviews,0,0,0
702722,True,0,No user reviews,0,0,0
702723,True,0,No user reviews,0,0,0
702724,True,0,No user reviews,0,0,0
702725,True,0,No user reviews,0,0,0
702740,True,0,No user reviews,0,0,0
702741,True,0,No user reviews,0,0,0
702742,True,0,No user reviews,0,0,0
702750,True,0,No user reviews,0,0,0
702760,True,0,No user reviews,0,0,0
702770,True,0,No user reviews,0,0,0
702780,True,0,No user reviews,0,0,0
702790,True,0,4 user reviews,3,1,4
702800,True,0,No user reviews,0,0,0
702810,True,0,No user reviews,0,0,0
702820,True,0,1 user reviews,1,0,1
702850,True,0,No user reviews,0,0,0
702890,True,8,Very Positive,1045,221,1266
702900,True,0,No user reviews,0,0,0
702920,True,0,No user reviews,0,0,0
702930,True,0,No user reviews,0,0,0
702940,True,0,3 user reviews,3,0,3
702950,True,5,Mixed,7,9,16
702960,True,5,Mixed,11,6,17
702961,True,0,4 user reviews,3,1,4
702962,True,0,1 user reviews,0,1,1
702963,True,0,No user reviews,0,0,0
702964,True,0,4 user reviews,3,1,4
702965,True,0,7 user reviews,5,2,7
702967,True,0,6 user reviews,3,3,6
702968,True,0,1 user reviews,0,1,1
702980,True,7,Positive,24,1,25
702990,True,7,Positive,38,7,45
703000,True,0,1 user reviews,1,0,1
703030,True,0,No user reviews,0,0,0
703050,True,0,2 user reviews,2,0,2
703060,True,0,No user reviews,0,0,0
703080,True,8,Very Positive,13039,1599,14638
703090,True,0,No user reviews,0,0,0
703100,True,0,No user reviews,0,0,0
703120,True,0,5 user reviews,3,2,5
703140,True,0,2 user reviews,2,0,2
703160,True,0,No user reviews,0,0,0
703170,True,0,No user reviews,0,0,0
703180,True,6,Mostly Positive,28,11,39
703200,True,0,3 user reviews,2,1,3
703210,True,0,5 user reviews,2,3,5
703250,True,0,1 user reviews,1,0,1
703260,True,0,No user reviews,0,0,0
703270,True,0,No user reviews,0,0,0
703280,True,0,No user reviews,0,0,0
703300,True,5,Mixed,6,6,12
703310,True,5,Mixed,14,7,21
703320,True,8,Very Positive,149,11,160
703340,True,0,No user reviews,0,0,0
703360,True,0,2 user reviews,0,2,2
703390,True,0,No user reviews,0,0,0
703400,True,0,7 user reviews,5,2,7
703420,True,0,No user reviews,0,0,0
703430,True,0,No user reviews,0,0,0
703440,True,0,1 user reviews,1,0,1
703441,True,0,No user reviews,0,0,0
703460,True,0,1 user reviews,1,0,1
703461,True,0,1 user reviews,1,0,1
703470,True,0,No user reviews,0,0,0
703471,True,0,No user reviews,0,0,0
703480,True,0,No user reviews,0,0,0
703490,True,0,5 user reviews,3,2,5
703500,True,7,Positive,28,3,31
703510,True,6,Mostly Positive,130,46,176
703530,True,0,8 user reviews,2,6,8
703540,True,0,6 user reviews,4,2,6
703560,True,0,6 user reviews,6,0,6
703590,True,0,No user reviews,0,0,0
703600,True,4,Mostly Negative,8,14,22
703620,True,8,Very Positive,44,7,51
703630,True,7,Positive,20,0,20
703671,True,0,No user reviews,0,0,0
703690,True,0,No user reviews,0,0,0
703700,True,6,Mostly Positive,41,11,52
703720,True,0,9 user reviews,9,0,9
703730,True,7,Positive,17,3,20
703770,True,0,No user reviews,0,0,0
703800,True,0,1 user reviews,1,0,1
703820,True,0,No user reviews,0,0,0
703830,True,0,No user reviews,0,0,0
703840,True,8,Very Positive,215,27,242
703860,True,5,Mixed,514,289,803
703870,True,5,Mixed,7,4,11
703880,True,7,Positive,35,5,40
703900,True,0,No user reviews,0,0,0
703920,True,4,Mostly Negative,4,9,13
703940,True,0,3 user reviews,1,2,3
703950,True,0,No user reviews,0,0,0
703960,True,0,2 user reviews,2,0,2
703970,True,0,No user reviews,0,0,0
703980,True,0,No user reviews,0,0,0
704000,True,0,No user reviews,0,0,0
704010,True,6,Mostly Positive,35,11,46
704020,True,0,2 user reviews,2,0,2
704030,True,6,Mostly Positive,120,50,170
704040,True,0,No user reviews,0,0,0
704060,True,0,4 user reviews,3,1,4
704070,True,0,4 user reviews,2,2,4
704090,True,0,No user reviews,0,0,0
704091,True,0,No user reviews,0,0,0
704092,True,0,No user reviews,0,0,0
704093,True,0,No user reviews,0,0,0
704094,True,0,No user reviews,0,0,0
704095,True,0,No user reviews,0,0,0
704096,True,0,No user reviews,0,0,0
704097,True,0,No user reviews,0,0,0
704098,True,0,No user reviews,0,0,0
704099,True,0,No user reviews,0,0,0
704110,True,5,Mixed,5,7,12
704120,True,0,No user reviews,0,0,0
704130,True,0,No user reviews,0,0,0
704140,True,0,2 user reviews,0,2,2
704150,True,0,4 user reviews,3,1,4
704160,True,0,No user reviews,0,0,0
704180,True,7,Positive,22,1,23
704190,True,5,Mixed,8,5,13
704200,True,7,Positive,16,1,17
704210,True,5,Mixed,50,70,120
704230,True,5,Mixed,40,33,73
704240,True,0,No user reviews,0,0,0
704250,True,5,Mixed,9,6,15
704260,True,0,3 user reviews,3,0,3
704270,True,5,Mixed,3842,1662,5504
704282,True,0,4 user reviews,3,1,4
704283,True,5,Mixed,16,10,26
704285,True,0,5 user reviews,4,1,5
704286,True,0,9 user reviews,4,5,9
704287,True,0,No user reviews,0,0,0
704288,True,0,No user reviews,0,0,0
704289,True,0,No user reviews,0,0,0
704300,True,6,Mostly Positive,39,14,53
704310,True,0,8 user reviews,5,3,8
704320,True,0,No user reviews,0,0,0
704321,True,0,No user reviews,0,0,0
704322,True,0,No user reviews,0,0,0
704325,True,0,No user reviews,0,0,0
704326,True,0,No user reviews,0,0,0
704327,True,0,No user reviews,0,0,0
704328,True,0,No user reviews,0,0,0
704330,True,0,No user reviews,0,0,0
704340,True,0,No user reviews,0,0,0
704350,True,0,No user reviews,0,0,0
704360,True,8,Very Positive,106,17,123
704370,True,0,5 user reviews,2,3,5
704390,True,0,No user reviews,0,0,0
704430,True,0,2 user reviews,1,1,2
704440,True,0,5 user reviews,5,0,5
704450,True,8,Very Positive,1911,318,2229
704470,True,8,Very Positive,64,0,64
704480,True,7,Positive,13,1,14
704510,True,8,Very Positive,73,10,83
704520,True,0,No user reviews,0,0,0
704540,True,0,4 user reviews,2,2,4
704570,True,0,No user reviews,0,0,0
704580,True,0,No user reviews,0,0,0
704600,True,0,No user reviews,0,0,0
704610,True,0,No user reviews,0,0,0
704620,True,0,No user reviews,0,0,0
704630,True,0,1 user reviews,1,0,1
704640,True,8,Very Positive,171,23,194
704660,True,0,No user reviews,0,0,0
704670,True,0,1 user reviews,1,0,1
704680,True,6,Mostly Positive,19,5,24
704690,True,6,Mostly Positive,27,7,34
704700,True,0,1 user reviews,1,0,1
704710,True,8,Very Positive,77,4,81
704720,True,0,1 user reviews,1,0,1
704730,True,0,1 user reviews,1,0,1
704740,True,8,Very Positive,75,18,93
704760,True,0,7 user reviews,6,1,7
704770,True,0,No user reviews,0,0,0
704810,True,0,8 user reviews,7,1,8
704830,True,5,Mixed,30,39,69
704840,True,7,Positive,48,1,49
704850,True,8,Very Positive,2644,430,3074
704860,True,8,Very Positive,58,14,72
704870,True,0,No user reviews,0,0,0
704880,True,5,Mixed,19,11,30
704900,True,0,No user reviews,0,0,0
704910,True,7,Positive,21,2,23
704920,True,0,4 user reviews,4,0,4
704930,True,0,No user reviews,0,0,0
704940,True,0,1 user reviews,0,1,1
704950,True,5,Mixed,9,5,14
704960,True,0,No user reviews,0,0,0
704970,True,0,No user reviews,0,0,0
704990,True,0,1 user reviews,1,0,1
705000,True,0,No user reviews,0,0,0
705020,True,6,Mostly Positive,16,5,21
705050,True,0,6 user reviews,2,4,6
705060,True,6,Mostly Positive,10,4,14
705070,True,4,Mostly Negative,12,20,32
705090,True,5,Mixed,9,6,15
705100,True,8,Very Positive,49,10,59
705120,True,8,Very Positive,283,50,333
