1028470,True,0,No user reviews,0,0,0
1028480,True,0,2 user reviews,2,0,2
1028490,True,0,5 user reviews,4,1,5
1028500,True,0,7 user reviews,7,0,7
1028510,True,0,No user reviews,0,0,0
1028520,True,0,8 user reviews,6,2,8
1028530,True,7,Positive,27,0,27
1028540,True,0,No user reviews,0,0,0
1028550,True,0,2 user reviews,2,0,2
1028570,True,8,Very Positive,109,13,122
1028580,True,0,No user reviews,0,0,0
1028610,True,0,1 user reviews,0,1,1
1028630,True,8,Very Positive,804,89,893
1028650,True,0,No user reviews,0,0,0
1028660,True,0,1 user reviews,1,0,1
1028670,True,0,No user reviews,0,0,0
1028680,True,0,No user reviews,0,0,0
1028700,True,0,No user reviews,0,0,0
1028701,True,0,No user reviews,0,0,0
1028702,True,7,Positive,11,0,11
1028703,True,0,9 user reviews,9,0,9
1028704,True,0,5 user reviews,5,0,5
1028710,True,0,1 user reviews,1,0,1
1028711,True,0,2 user reviews,2,0,2
1028712,True,0,1 user reviews,1,0,1
1028720,True,0,1 user reviews,1,0,1
1028721,True,0,No user reviews,0,0,0
1028730,True,6,Mostly Positive,11,4,15
1028740,True,5,Mixed,6,7,13
1028750,True,0,No user reviews,0,0,0
1028760,True,0,2 user reviews,1,1,2
1028770,True,0,4 user reviews,1,3,4
1028780,True,0,1 user reviews,0,1,1
1028790,True,0,No user reviews,0,0,0
1028791,True,0,No user reviews,0,0,0
1028792,True,0,No user reviews,0,0,0
1028793,True,0,No user reviews,0,0,0
1028794,True,0,No user reviews,0,0,0
1028795,True,0,No user reviews,0,0,0
1028800,True,5,Mixed,9,5,14
1028820,True,0,2 user reviews,1,1,2
1028830,True,0,No user reviews,0,0,0
1028840,True,0,4 user reviews,2,2,4
1028850,True,0,4 user reviews,4,0,4
1028860,True,0,No user reviews,0,0,0
1028880,True,0,No user reviews,0,0,0
1028890,True,0,9 user reviews,7,2,9
1028891,True,0,3 user reviews,3,0,3
1028892,True,0,6 user reviews,1,5,6
1028893,True,0,1 user reviews,0,1,1
1028894,True,0,5 user reviews,3,2,5
1028895,True,0,9 user reviews,6,3,9
1028900,True,0,1 user reviews,1,0,1
1028910,True,0,No user reviews,0,0,0
1028920,True,7,Positive,9,1,10
1028930,True,0,No user reviews,0,0,0
1028960,True,0,No user reviews,0,0,0
1028970,True,0,No user reviews,0,0,0
1028990,True,0,1 user reviews,0,1,1
1029000,True,7,Positive,13,1,14
1029020,True,0,1 user reviews,1,0,1
1029030,True,0,No user reviews,0,0,0
1029040,True,7,Positive,8,2,10
1029050,True,0,3 user reviews,2,1,3
1029070,True,0,6 user reviews,4,2,6
1029080,True,0,5 user reviews,5,0,5
1029090,True,0,6 user reviews,3,3,6
1029100,True,6,Mostly Positive,13,5,18
1029110,True,0,No user reviews,0,0,0
1029120,True,0,No user reviews,0,0,0
1029130,True,7,Positive,15,0,15
1029150,True,0,6 user reviews,5,1,6
1029160,True,0,6 user reviews,5,1,6
1029170,True,7,Positive,21,1,22
1029190,True,0,No user reviews,0,0,0
1029200,True,0,No user reviews,0,0,0
1029210,True,0,No user reviews,0,0,0
1029220,True,0,4 user reviews,4,0,4
1029230,True,0,No user reviews,0,0,0
1029240,True,5,Mixed,53,23,76
1029280,True,0,No user reviews,0,0,0
1029290,True,0,No user reviews,0,0,0
1029300,True,0,1 user reviews,1,0,1
1029301,True,0,No user reviews,0,0,0
1029310,True,0,No user reviews,0,0,0
1029311,True,0,1 user reviews,1,0,1
1029312,True,0,No user reviews,0,0,0
1029320,True,7,Positive,25,0,25
1029321,True,0,1 user reviews,1,0,1
1029322,True,0,1 user reviews,1,0,1
1029323,True,0,2 user reviews,2,0,2
1029330,True,0,6 user reviews,6,0,6
1029331,True,7,Positive,17,1,18
1029340,True,0,6 user reviews,6,0,6
1029350,True,0,1 user reviews,1,0,1
1029351,True,0,No user reviews,0,0,0
1029352,True,0,No user reviews,0,0,0
1029360,True,0,3 user reviews,3,0,3
1029361,True,0,No user reviews,0,0,0
1029362,True,0,No user reviews,0,0,0
1029370,True,0,No user reviews,0,0,0
1029371,True,0,2 user reviews,2,0,2
1029372,True,0,2 user reviews,2,0,2
1029380,True,7,Positive,16,0,16
1029390,True,0,1 user reviews,1,0,1
1029391,True,0,2 user reviews,1,1,2
1029392,True,0,1 user reviews,1,0,1
1029400,True,0,1 user reviews,1,0,1
1029401,True,0,No user reviews,0,0,0
1029402,True,0,No user reviews,0,0,0
1029410,True,0,No user reviews,0,0,0
1029411,True,0,No user reviews,0,0,0
1029412,True,0,4 user reviews,4,0,4
1029430,True,0,No user reviews,0,0,0
1029431,True,0,2 user reviews,2,0,2
1029432,True,0,No user reviews,0,0,0
1029440,True,0,No user reviews,0,0,0
1029441,True,0,No user reviews,0,0,0
1029450,True,0,4 user reviews,4,0,4
1029451,True,0,No user reviews,0,0,0
1029470,True,0,No user reviews,0,0,0
1029480,True,0,No user reviews,0,0,0
1029481,True,0,No user reviews,0,0,0
1029500,True,0,No user reviews,0,0,0
1029530,True,0,2 user reviews,1,1,2
1029540,True,0,No user reviews,0,0,0
1029550,True,6,Mostly Positive,113,35,148
1029560,True,0,1 user reviews,1,0,1
1029570,True,7,Positive,28,4,32
1029590,True,0,No user reviews,0,0,0
1029630,True,5,Mixed,203,145,348
1029640,True,0,No user reviews,0,0,0
1029650,True,0,No user reviews,0,0,0
1029660,True,0,4 user reviews,1,3,4
1029680,True,0,No user reviews,0,0,0
1029720,True,0,5 user reviews,4,1,5
1029730,True,5,Mixed,9,7,16
1029750,True,0,No user reviews,0,0,0
1029760,True,7,Positive,28,2,30
1029770,True,0,No user reviews,0,0,0
1029780,True,0,No user reviews,0,0,0
1029790,True,0,2 user reviews,2,0,2
1029810,True,0,2 user reviews,2,0,2
1029820,True,0,No user reviews,0,0,0
1029830,True,0,No user reviews,0,0,0
1029840,True,0,No user reviews,0,0,0
1029860,True,7,Positive,12,1,13
1029870,True,7,Positive,9,2,11
1029880,True,0,No user reviews,0,0,0
1029890,True,6,Mostly Positive,332,132,464
1029900,True,6,Mostly Positive,14,4,18
1029920,True,0,3 user reviews,2,1,3
1029930,True,0,No user reviews,0,0,0
1029940,True,0,No user reviews,0,0,0
1029950,True,0,No user reviews,0,0,0
1029960,True,0,No user reviews,0,0,0
1029970,True,0,No user reviews,0,0,0
1029980,True,8,Very Positive,66,8,74
1029990,True,6,Mostly Positive,23,9,32
1030050,True,0,1 user reviews,0,1,1
1030060,True,0,No user reviews,0,0,0
1030070,True,0,No user reviews,0,0,0
1030090,True,0,1 user reviews,0,1,1
1030100,True,0,No user reviews,0,0,0
1030130,True,0,No user reviews,0,0,0
1030160,True,0,No user reviews,0,0,0
1030170,True,0,2 user reviews,2,0,2
1030180,True,0,3 user reviews,1,2,3
1030190,True,0,4 user reviews,3,1,4
1030210,True,5,Mixed,1548,1298,2846
1030220,True,0,No user reviews,0,0,0
1030221,True,0,No user reviews,0,0,0
1030222,True,0,No user reviews,0,0,0
1030223,True,0,3 user reviews,2,1,3
1030230,True,0,2 user reviews,1,1,2
1030240,True,0,No user reviews,0,0,0
1030270,True,7,Positive,10,0,10
1030300,True,0,No user reviews,0,0,0
1030330,True,0,1 user reviews,0,1,1
1030360,True,0,6 user reviews,5,1,6
1030370,True,0,No user reviews,0,0,0
1030380,True,0,5 user reviews,1,4,5
1030400,True,0,No user reviews,0,0,0
1030401,True,0,No user reviews,0,0,0
1030402,True,0,No user reviews,0,0,0
1030410,True,5,Mixed,8,6,14
1030430,True,0,8 user reviews,8,0,8
1030460,True,0,No user reviews,0,0,0
1030470,True,7,Positive,15,1,16
1030490,True,0,3 user reviews,3,0,3
1030500,True,6,Mostly Positive,19,6,25
1030520,True,0,No user reviews,0,0,0
1030530,True,0,2 user reviews,2,0,2
1030560,True,0,No user reviews,0,0,0
1030563,True,0,1 user reviews,1,0,1
1030570,True,0,No user reviews,0,0,0
1030580,True,8,Very Positive,47,11,58
1030590,True,0,1 user reviews,1,0,1
1030730,True,0,No user reviews,0,0,0
1030740,True,0,No user reviews,0,0,0
1030760,True,0,1 user reviews,0,1,1
1030770,True,0,No user reviews,0,0,0
1030780,True,0,No user reviews,0,0,0
1030800,True,0,No user reviews,0,0,0
1030810,True,0,No user reviews,0,0,0
1030830,True,5,Mixed,893,486,1379
1030840,True,8,Very Positive,4250,606,4856
1030950,True,4,Mostly Negative,4,7,11
1030960,True,0,7 user reviews,7,0,7
1030970,True,0,1 user reviews,1,0,1
1030980,True,0,1 user reviews,1,0,1
1031020,True,7,Positive,25,4,29
1031030,True,0,No user reviews,0,0,0
1031060,True,0,No user reviews,0,0,0
1031090,True,0,No user reviews,0,0,0
1031110,True,0,No user reviews,0,0,0
1031120,True,0,No user reviews,0,0,0
1031130,True,0,2 user reviews,1,1,2
1031140,True,0,No user reviews,0,0,0
1031150,True,0,No user reviews,0,0,0
1031160,True,0,No user reviews,0,0,0
1031170,True,6,Mostly Positive,29,10,39
1031190,True,0,No user reviews,0,0,0
1031200,True,0,2 user reviews,0,2,2
1031210,True,0,3 user reviews,3,0,3
1031220,True,0,2 user reviews,1,1,2
1031230,True,0,1 user reviews,0,1,1
1031260,True,0,3 user reviews,2,1,3
1031270,True,0,No user reviews,0,0,0
1031290,True,0,No user reviews,0,0,0
1031300,True,0,1 user reviews,1,0,1
1031310,True,0,3 user reviews,1,2,3
1031320,True,0,1 user reviews,1,0,1
1031330,True,0,1 user reviews,1,0,1
1031340,True,0,No user reviews,0,0,0
1031370,True,0,No user reviews,0,0,0
1031380,True,0,No user reviews,0,0,0
1031410,True,0,No user reviews,0,0,0
1031420,True,0,3 user reviews,3,0,3
1031421,True,0,2 user reviews,2,0,2
1031430,True,0,No user reviews,0,0,0
1031440,True,7,Positive,44,4,48
1031450,True,0,No user reviews,0,0,0
1031460,True,0,No user reviews,0,0,0
1031470,True,0,1 user reviews,0,1,1
1031480,True,8,Very Positive,122,1,123
1031500,True,8,Very Positive,163,3,166
1031510,True,8,Very Positive,51,1,52
1031520,True,0,No user reviews,0,0,0
1031530,True,0,No user reviews,0,0,0
1031540,True,0,9 user reviews,5,4,9
1031550,True,0,5 user reviews,5,0,5
1031560,True,0,No user reviews,0,0,0
1031570,True,0,5 user reviews,3,2,5
1031580,True,0,2 user reviews,2,0,2
1031590,True,0,1 user reviews,0,1,1
1031600,True,0,No user reviews,0,0,0
1031620,True,0,No user reviews,0,0,0
1031630,True,0,1 user reviews,1,0,1
1031640,True,0,4 user reviews,3,1,4
1031650,True,0,4 user reviews,3,1,4
1031660,True,0,2 user reviews,0,2,2
1031670,True,0,No user reviews,0,0,0
1031680,True,0,No user reviews,0,0,0
1031690,True,0,No user reviews,0,0,0
1031700,True,0,No user reviews,0,0,0
1031720,True,0,No user reviews,0,0,0
1031740,True,0,No user reviews,0,0,0
1031750,True,0,No user reviews,0,0,0
1031770,True,0,1 user reviews,1,0,1
1031790,True,7,Positive,28,4,32
1031800,True,0,1 user reviews,0,1,1
1031810,True,0,4 user reviews,2,2,4
1031830,True,0,2 user reviews,2,0,2
1031840,True,0,4 user reviews,3,1,4
1031850,True,0,No user reviews,0,0,0
1031910,True,0,1 user reviews,1,0,1
1031920,True,5,Mixed,11,5,16
1031940,True,0,No user reviews,0,0,0
1031950,True,0,No user reviews,0,0,0
1031980,True,0,No user reviews,0,0,0
1032030,True,0,No user reviews,0,0,0
1032040,True,0,1 user reviews,1,0,1
1032050,True,0,9 user reviews,9,0,9
1032060,True,0,No user reviews,0,0,0
1032070,True,0,4 user reviews,4,0,4
1032080,True,0,No user reviews,0,0,0
1032090,True,0,No user reviews,0,0,0
1032120,True,0,No user reviews,0,0,0
1032140,True,0,No user reviews,0,0,0
1032170,True,7,Positive,24,3,27
1032190,True,0,No user reviews,0,0,0
1032200,True,0,No user reviews,0,0,0
1032210,True,0,No user reviews,0,0,0
1032220,True,0,No user reviews,0,0,0
1032230,True,0,2 user reviews,2,0,2
1032240,True,0,3 user reviews,2,1,3
1032260,True,0,1 user reviews,0,1,1
1032270,True,0,1 user reviews,0,1,1
1032280,True,0,No user reviews,0,0,0
1032290,True,0,2 user reviews,2,0,2
1032300,True,0,No user reviews,0,0,0
1032330,True,0,3 user reviews,3,0,3
1032340,True,0,9 user reviews,7,2,9
1032360,True,0,No user reviews,0,0,0
1032370,True,5,Mixed,29,13,42
1032390,True,0,8 user reviews,8,0,8
1032410,True,0,4 user reviews,3,1,4
1032420,True,0,No user reviews,0,0,0
1032430,True,5,Mixed,328,190,518
1032440,True,0,1 user reviews,1,0,1
1032450,True,0,4 user reviews,4,0,4
1032460,True,0,No user reviews,0,0,0
1032490,True,0,No user reviews,0,0,0
1032510,True,0,No user reviews,0,0,0
1032520,True,0,No user reviews,0,0,0
1032530,True,0,No user reviews,0,0,0
1032550,True,0,No user reviews,0,0,0
1032560,True,0,2 user reviews,2,0,2
1032570,True,0,3 user reviews,1,2,3
1032580,True,0,3 user reviews,3,0,3
1032590,True,7,Positive,23,1,24
1032600,True,0,No user reviews,0,0,0
1032650,True,0,No user reviews,0,0,0
1032660,True,0,No user reviews,0,0,0
1032670,True,7,Positive,42,7,49
1032730,True,8,Very Positive,69,7,76
1032740,True,0,No user reviews,0,0,0
1032750,True,0,No user reviews,0,0,0
1032760,True,0,7 user reviews,4,3,7
1032770,True,0,No user reviews,0,0,0
1032790,True,8,Very Positive,43,8,51
1032800,True,0,No user reviews,0,0,0
1032801,True,0,No user reviews,0,0,0
1032830,True,7,Positive,23,1,24
1032990,True,0,No user reviews,0,0,0
1033000,True,0,No user reviews,0,0,0
1033030,True,0,No user reviews,0,0,0
1033040,True,0,No user reviews,0,0,0
1033060,True,4,Mostly Negative,305,602,907
1033070,True,0,3 user reviews,3,0,3
1033080,True,0,No user reviews,0,0,0
1033090,True,0,1 user reviews,1,0,1
1033100,True,0,No user reviews,0,0,0
1033110,True,0,2 user reviews,0,2,2
1033120,True,5,Mixed,7,10,17
1033130,True,0,No user reviews,0,0,0
1033140,True,0,No user reviews,0,0,0
1033150,True,0,No user reviews,0,0,0
1033170,True,8,Very Positive,53,13,66
1033180,True,0,No user reviews,0,0,0
1033190,True,0,No user reviews,0,0,0
1033200,True,0,No user reviews,0,0,0
1033210,True,0,9 user reviews,8,1,9
1033220,True,6,Mostly Positive,18,6,24
1033230,True,0,1 user reviews,1,0,1
1033240,True,0,5 user reviews,3,2,5
1033250,True,0,1 user reviews,0,1,1
1033330,True,0,3 user reviews,1,2,3
1033340,True,0,4 user reviews,4,0,4
1033360,True,0,1 user reviews,1,0,1
1033370,True,0,No user reviews,0,0,0
1033380,True,0,No user reviews,0,0,0
1033410,True,7,Positive,34,3,37
1033420,True,8,Very Positive,50,1,51
1033450,True,0,7 user reviews,4,3,7
1033460,True,0,4 user reviews,3,1,4
1033470,True,0,1 user reviews,1,0,1
1033471,True,0,1 user reviews,1,0,1
1033472,True,0,2 user reviews,2,0,2
1033473,True,0,1 user reviews,1,0,1
1033474,True,0,2 user reviews,2,0,2
1033475,True,0,2 user reviews,1,1,2
1033476,True,0,2 user reviews,2,0,2
1033477,True,0,3 user reviews,2,1,3
1033478,True,0,3 user reviews,2,1,3
1033479,True,0,2 user reviews,1,1,2
1033480,True,0,No user reviews,0,0,0
1033481,True,0,No user reviews,0,0,0
1033482,True,0,1 user reviews,0,1,1
1033483,True,0,1 user reviews,1,0,1
1033484,True,0,1 user reviews,1,0,1
1033485,True,0,1 user reviews,0,1,1
1033486,True,0,1 user reviews,1,0,1
1033487,True,0,1 user reviews,1,0,1
1033488,True,0,1 user reviews,1,0,1
1033489,True,0,1 user reviews,0,1,1
1033490,True,7,Positive,25,2,27
1033500,True,0,No user reviews,0,0,0
1033501,True,0,No user reviews,0,0,0
1033502,True,0,No user reviews,0,0,0
1033503,True,0,1 user reviews,1,0,1
1033510,True,0,4 user reviews,2,2,4
1033520,True,0,No user reviews,0,0,0
1033521,True,0,No user reviews,0,0,0
1033522,True,0,No user reviews,0,0,0
1033530,True,7,Positive,16,4,20
1033540,True,0,No user reviews,0,0,0
1033550,True,0,No user reviews,0,0,0
1033580,True,0,5 user reviews,5,0,5
1033590,True,0,No user reviews,0,0,0
1033600,True,0,No user reviews,0,0,0
1033620,True,0,No user reviews,0,0,0
1033621,True,0,No user reviews,0,0,0
1033630,True,0,No user reviews,0,0,0
1033640,True,4,Mostly Negative,4,11,15
1033660,True,0,No user reviews,0,0,0
1033670,True,0,No user reviews,0,0,0
1033700,True,0,No user reviews,0,0,0
1033710,True,0,2 user reviews,1,1,2
1033720,True,0,5 user reviews,0,5,5
1033760,True,0,No user reviews,0,0,0
1033780,True,7,Positive,16,1,17
1033790,True,0,3 user reviews,3,0,3
1033800,True,0,No user reviews,0,0,0
1033810,True,0,No user reviews,0,0,0
1033820,True,0,No user reviews,0,0,0
1033840,True,0,No user reviews,0,0,0
1033860,True,0,3 user reviews,0,3,3
1033870,True,0,No user reviews,0,0,0
1033880,True,8,Very Positive,82,12,94
1033890,True,5,Mixed,180,130,310
1033900,True,0,No user reviews,0,0,0
1033910,True,0,7 user reviews,3,4,7
1033920,True,0,1 user reviews,1,0,1
1033930,True,0,No user reviews,0,0,0
1033950,True,0,No user reviews,0,0,0
1033960,True,0,No user reviews,0,0,0
1034000,True,0,No user reviews,0,0,0
1034010,True,0,No user reviews,0,0,0
1034030,True,0,3 user reviews,3,0,3
1034040,True,0,No user reviews,0,0,0
1034060,True,5,Mixed,6,4,10
1034070,True,0,No user reviews,0,0,0
1034080,True,0,No user reviews,0,0,0
1034090,True,0,No user reviews,0,0,0
1034100,True,0,No user reviews,0,0,0
1034120,True,0,4 user reviews,2,2,4
1034130,True,0,2 user reviews,1,1,2
1034140,True,0,No user reviews,0,0,0
1034160,True,5,Mixed,6,4,10
1034180,True,0,No user reviews,0,0,0
1034200,True,0,No user reviews,0,0,0
1034230,True,0,3 user reviews,2,1,3
1034240,True,0,5 user reviews,4,1,5
1034250,True,0,4 user reviews,2,2,4
1034260,True,0,2 user reviews,1,1,2
1034270,True,0,2 user reviews,2,0,2
1034280,True,0,5 user reviews,4,1,5
1034290,True,0,No user reviews,0,0,0
1034291,True,0,3 user reviews,3,0,3
1034292,True,0,No user reviews,0,0,0
1034370,True,0,3 user reviews,2,1,3
1034380,True,0,2 user reviews,1,1,2
1034390,True,0,1 user reviews,1,0,1
1034400,True,0,5 user reviews,4,1,5
1034410,True,0,5 user reviews,3,2,5
1034430,True,0,No user reviews,0,0,0
1034440,True,0,No user reviews,0,0,0
1034450,True,0,3 user reviews,3,0,3
1034460,True,0,No user reviews,0,0,0
1034471,True,0,4 user reviews,3,1,4
1034480,True,0,3 user reviews,3,0,3
1034490,True,0,No user reviews,0,0,0
1034500,True,0,No user reviews,0,0,0
1034510,True,0,3 user reviews,3,0,3
1034511,True,0,3 user reviews,3,0,3
1034540,True,0,9 user reviews,7,2,9
1034550,True,0,2 user reviews,2,0,2
1034560,True,0,6 user reviews,5,1,6
1034580,True,0,No user reviews,0,0,0
1034590,True,0,No user reviews,0,0,0
1034610,True,0,No user reviews,0,0,0
1034630,True,0,No user reviews,0,0,0
1034640,True,0,No user reviews,0,0,0
1034680,True,0,No user reviews,0,0,0
1034700,True,6,Mostly Positive,139,36,175
1034740,True,0,No user reviews,0,0,0
1034750,True,7,Positive,22,5,27
1034760,True,0,No user reviews,0,0,0
1034770,True,0,No user reviews,0,0,0
1034780,True,0,No user reviews,0,0,0
1034810,True,5,Mixed,10,5,15
1034820,True,0,1 user reviews,0,1,1
1034850,True,6,Mostly Positive,44,16,60
1034860,True,8,Very Positive,209,13,222
1034870,True,0,6 user reviews,5,1,6
1034880,True,0,No user reviews,0,0,0
1034890,True,7,Positive,21,2,23
1034900,True,8,Very Positive,225,11,236
1034910,True,8,Very Positive,72,11,83
1034920,True,0,9 user reviews,7,2,9
1034930,True,0,No user reviews,0,0,0
1034940,True,8,Very Positive,98,3,101
1034950,True,0,8 user reviews,8,0,8
1034970,True,6,Mostly Positive,7,3,10
1035000,True,0,No user reviews,0,0,0
1035010,True,7,Positive,15,3,18
1035020,True,0,9 user reviews,8,1,9
1035030,True,7,Positive,10,0,10
1035040,True,0,No user reviews,0,0,0
1035050,True,7,Positive,21,4,25
1035110,True,7,Positive,10,2,12
1035120,True,0,No user reviews,0,0,0
1035150,True,0,1 user reviews,0,1,1
1035180,True,0,No user reviews,0,0,0
1035190,True,0,4 user reviews,2,2,4
1035210,True,0,No user reviews,0,0,0
1035220,True,0,No user reviews,0,0,0
1035230,True,0,8 user reviews,8,0,8
1035240,True,0,No user reviews,0,0,0
1035260,True,0,1 user reviews,1,0,1
1035270,True,0,3 user reviews,1,2,3
1035280,True,0,No user reviews,0,0,0
1035300,True,0,No user reviews,0,0,0
1035310,True,0,9 user reviews,5,4,9
1035320,True,0,No user reviews,0,0,0
1035340,True,0,No user reviews,0,0,0
1035410,True,0,No user reviews,0,0,0
1035430,True,0,No user reviews,0,0,0
1035470,True,0,2 user reviews,2,0,2
1035480,True,0,No user reviews,0,0,0
1035490,True,0,1 user reviews,1,0,1
1035500,True,0,1 user reviews,0,1,1
1035510,True,7,Positive,32,2,34
1035520,True,0,No user reviews,0,0,0
1035530,True,0,6 user reviews,5,1,6
1035540,True,0,No user reviews,0,0,0
1035550,True,0,No user reviews,0,0,0
1035560,True,8,Very Positive,65,4,69
1035570,True,0,No user reviews,0,0,0
1035580,True,0,No user reviews,0,0,0
1035610,True,8,Very Positive,52,8,60
1035620,True,0,No user reviews,0,0,0
1035660,True,0,No user reviews,0,0,0
1035690,True,0,1 user reviews,1,0,1
1035700,True,0,4 user reviews,4,0,4
1035720,True,0,No user reviews,0,0,0
1035740,True,0,No user reviews,0,0,0
1035750,True,0,No user reviews,0,0,0
1035760,True,0,No user reviews,0,0,0
1035770,True,0,9 user reviews,8,1,9
1035790,True,0,1 user reviews,1,0,1
1035800,True,0,No user reviews,0,0,0
1035810,True,0,No user reviews,0,0,0
1035830,True,0,1 user reviews,0,1,1
1035840,True,0,No user reviews,0,0,0
1035850,True,7,Positive,22,0,22
1035860,True,0,1 user reviews,0,1,1
1035870,True,0,No user reviews,0,0,0
1035880,True,0,No user reviews,0,0,0
1035890,True,0,No user reviews,0,0,0
1035900,True,0,No user reviews,0,0,0
1035910,True,0,No user reviews,0,0,0
1035920,True,0,1 user reviews,1,0,1
1035930,True,7,Positive,14,1,15
1035950,True,7,Positive,31,2,33
1035960,True,0,No user reviews,0,0,0
1035990,True,0,No user reviews,0,0,0
1036000,True,0,1 user reviews,1,0,1
1036010,True,0,No user reviews,0,0,0
1036020,True,0,1 user reviews,1,0,1
1036030,True,0,No user reviews,0,0,0
1036080,True,0,No user reviews,0,0,0
1036112,True,0,No user reviews,0,0,0
1036114,True,0,No user reviews,0,0,0
1036116,True,0,No user reviews,0,0,0
1036117,True,0,No user reviews,0,0,0
1036120,True,0,2 user reviews,2,0,2
1036160,True,0,No user reviews,0,0,0
1036180,True,0,No user reviews,0,0,0
1036181,True,0,No user reviews,0,0,0
1036190,True,0,No user reviews,0,0,0
1036200,True,0,No user reviews,0,0,0
1036210,True,0,No user reviews,0,0,0
1036220,True,0,1 user reviews,1,0,1
1036260,True,7,Positive,13,3,16
1036270,True,0,No user reviews,0,0,0
1036310,True,0,No user reviews,0,0,0
1036320,True,0,1 user reviews,0,1,1
1036330,True,0,No user reviews,0,0,0
1036370,True,7,Positive,16,0,16
1036380,True,0,No user reviews,0,0,0
1036390,True,0,No user reviews,0,0,0
1036400,True,0,1 user reviews,0,1,1
1036410,True,0,No user reviews,0,0,0
1036420,True,0,6 user reviews,4,2,6
1036430,True,0,No user reviews,0,0,0
1036440,True,6,Mostly Positive,84,33,117
1036450,True,0,No user reviews,0,0,0
1036460,True,0,No user reviews,0,0,0
1036470,True,0,8 user reviews,6,2,8
1036480,True,7,Positive,9,2,11
1036490,True,7,Positive,19,0,19
1036510,True,0,No user reviews,0,0,0
1036530,True,0,No user reviews,0,0,0
1036550,True,0,2 user reviews,1,1,2
1036570,True,0,No user reviews,0,0,0
1036580,True,8,Very Positive,75,5,80
1036600,True,5,Mixed,6,4,10
1036620,True,0,No user reviews,0,0,0
1036650,True,0,No user reviews,0,0,0
1036660,True,7,Positive,16,3,19
1036700,True,7,Positive,41,2,43
1036750,True,7,Positive,21,4,25
1036760,True,7,Positive,32,7,39
1036770,True,0,1 user reviews,1,0,1
1036771,True,0,1 user reviews,1,0,1
1036780,True,0,2 user reviews,1,1,2
1036790,True,0,No user reviews,0,0,0
1036791,True,0,No user reviews,0,0,0
1036792,True,0,No user reviews,0,0,0
1036793,True,0,No user reviews,0,0,0
1036794,True,0,No user reviews,0,0,0
1036795,True,0,No user reviews,0,0,0
1036796,True,0,No user reviews,0,0,0
1036797,True,0,1 user reviews,1,0,1
1036798,True,0,1 user reviews,1,0,1
1036799,True,0,2 user reviews,2,0,2
1036800,True,0,3 user reviews,1,2,3
1036810,True,0,No user reviews,0,0,0
1036820,True,0,7 user reviews,4,3,7
1036840,True,0,4 user reviews,2,2,4
1036850,True,0,No user reviews,0,0,0
1036870,True,0,3 user reviews,2,1,3
1036890,True,0,No user reviews,0,0,0
1036900,True,0,2 user reviews,2,0,2
1036910,True,5,Mixed,9,5,14
1036920,True,0,3 user reviews,1,2,3
1036930,True,0,No user reviews,0,0,0
1036940,True,0,No user reviews,0,0,0
1036950,True,0,8 user reviews,8,0,8
1036960,True,0,No user reviews,0,0,0
1036970,True,7,Positive,8,2,10
1036980,True,6,Mostly Positive,20,8,28
1036990,True,0,6 user reviews,5,1,6
1037000,True,0,No user reviews,0,0,0
1037010,True,0,4 user reviews,3,1,4
1037020,True,8,Very Positive,452,32,484
1037040,True,0,No user reviews,0,0,0
1037050,True,0,5 user reviews,4,1,5
1037060,True,0,No user reviews,0,0,0
1037080,True,0,No user reviews,0,0,0
1037090,True,0,2 user reviews,2,0,2
1037100,True,7,Positive,8,2,10
1037120,True,0,No user reviews,0,0,0
1037130,True,0,No user reviews,0,0,0
1037140,True,0,2 user reviews,1,1,2
1037150,True,0,No user reviews,0,0,0
1037190,True,8,Very Positive,50,0,50
1037200,True,7,Positive,11,2,13
1037220,True,0,No user reviews,0,0,0
1037240,True,0,No user reviews,0,0,0
1037260,True,0,1 user reviews,0,1,1
1037270,True,0,No user reviews,0,0,0
1037300,True,0,No user reviews,0,0,0
1037330,True,0,2 user reviews,0,2,2
1037340,True,0,1 user reviews,0,1,1
1037350,True,0,4 user reviews,1,3,4
1037360,True,0,No user reviews,0,0,0
1037370,True,0,No user reviews,0,0,0
1037380,True,0,No user reviews,0,0,0
1037390,True,0,No user reviews,0,0,0
1037410,True,0,No user reviews,0,0,0
1037420,True,0,2 user reviews,2,0,2
1037430,True,0,1 user reviews,1,0,1
1037450,True,0,No user reviews,0,0,0
1037451,True,0,No user reviews,0,0,0
1037460,True,0,No user reviews,0,0,0
1037470,True,0,No user reviews,0,0,0
1037480,True,7,Positive,42,2,44
1037490,True,0,No user reviews,0,0,0
1037510,True,0,No user reviews,0,0,0
1037560,True,6,Mostly Positive,62,19,81
1037570,True,6,Mostly Positive,27,11,38
1037580,True,0,No user reviews,0,0,0
1037590,True,8,Very Positive,194,29,223
1037600,True,0,No user reviews,0,0,0
1037620,True,0,No user reviews,0,0,0
1037690,True,0,9 user reviews,9,0,9
1037750,True,6,Mostly Positive,27,7,34
1037760,True,6,Mostly Positive,15,5,20
1037810,True,0,No user reviews,0,0,0
1037820,True,5,Mixed,7,4,11
1037830,True,0,1 user reviews,1,0,1
1037840,True,0,3 user reviews,1,2,3
1037850,True,0,1 user reviews,1,0,1
1037860,True,0,No user reviews,0,0,0
1037870,True,0,No user reviews,0,0,0
1037890,True,7,Positive,9,2,11
1037900,True,0,No user reviews,0,0,0
1037910,True,0,No user reviews,0,0,0
1037930,True,0,1 user reviews,0,1,1
1037940,True,7,Positive,24,6,30
1037950,True,0,No user reviews,0,0,0
1037960,True,5,Mixed,21,19,40
1037970,True,0,3 user reviews,2,1,3
1037980,True,0,No user reviews,0,0,0
1037990,True,8,Very Positive,46,8,54
1038000,True,7,Positive,17,1,18
1038030,True,0,No user reviews,0,0,0
1038040,True,0,No user reviews,0,0,0
1038060,True,0,No user reviews,0,0,0
1038070,True,0,No user reviews,0,0,0
1038090,True,0,No user reviews,0,0,0
1038100,True,0,8 user reviews,7,1,8
1038110,True,0,No user reviews,0,0,0
1038120,True,0,1 user reviews,1,0,1
1038240,True,5,Mixed,7,8,15
1038250,True,0,No user reviews,0,0,0
1038260,True,0,1 user reviews,1,0,1
1038270,True,0,No user reviews,0,0,0
1038280,True,8,Very Positive,47,4,51
1038300,True,7,Positive,19,1,20
1038370,True,8,Very Positive,307,17,324
1038380,True,0,4 user reviews,4,0,4
1038400,True,0,2 user reviews,2,0,2
1038410,True,0,No user reviews,0,0,0
1038420,True,0,No user reviews,0,0,0
1038430,True,0,1 user reviews,1,0,1
1038440,True,0,No user reviews,0,0,0
1038450,True,5,Mixed,306,242,548
1038500,True,7,Positive,13,2,15
1038510,True,0,1 user reviews,1,0,1
1038530,True,0,No user reviews,0,0,0
1038550,True,0,No user reviews,0,0,0
1038560,True,0,No user reviews,0,0,0
1038620,True,5,Mixed,11,10,21
1038630,True,0,8 user reviews,7,1,8
1038640,True,0,2 user reviews,1,1,2
1038650,True,0,4 user reviews,2,2,4
1038670,True,0,1 user reviews,0,1,1
1038680,True,0,No user reviews,0,0,0
1038710,True,7,Positive,10,1,11
1038740,True,8,Very Positive,209,10,219
1038810,True,6,Mostly Positive,22,8,30
1038820,True,0,1 user reviews,1,0,1
1038830,True,0,2 user reviews,1,1,2
1038840,True,0,1 user reviews,1,0,1
1038850,True,0,No user reviews,0,0,0
1038950,True,0,1 user reviews,1,0,1
1039030,True,0,1 user reviews,1,0,1
1039031,True,0,No user reviews,0,0,0
1039040,True,0,5 user reviews,4,1,5
1039050,True,0,No user reviews,0,0,0
1039060,True,0,1 user reviews,0,1,1
1039080,True,7,Positive,10,2,12
1039100,True,0,No user reviews,0,0,0
1039110,True,0,No user reviews,0,0,0
1039130,True,0,No user reviews,0,0,0
1039170,True,0,No user reviews,0,0,0
1039180,True,0,No user reviews,0,0,0
1039200,True,7,Positive,20,1,21
1039210,True,0,1 user reviews,1,0,1
1039230,True,0,No user reviews,0,0,0
1039250,True,0,No user reviews,0,0,0
1039280,True,0,No user reviews,0,0,0
1039290,True,0,7 user reviews,7,0,7
1039310,True,0,5 user reviews,3,2,5
1039320,True,0,2 user reviews,1,1,2
1039330,True,0,1 user reviews,1,0,1
1039350,True,7,Positive,21,4,25
1039360,True,0,No user reviews,0,0,0
1039370,True,5,Mixed,21,17,38
1039380,True,0,7 user reviews,6,1,7
1039390,True,0,No user reviews,0,0,0
1039400,True,0,No user reviews,0,0,0
1039420,True,0,No user reviews,0,0,0
1039430,True,0,1 user reviews,1,0,1
1039440,True,0,No user reviews,0,0,0
1039450,True,0,No user reviews,0,0,0
1039470,True,0,1 user reviews,1,0,1
1039480,True,6,Mostly Positive,53,15,68
1039550,True,0,No user reviews,0,0,0
1039560,True,0,No user reviews,0,0,0
1039570,True,0,5 user reviews,3,2,5
1039580,True,0,1 user reviews,1,0,1
1039590,True,0,No user reviews,0,0,0
1039630,True,0,No user reviews,0,0,0
1039640,True,0,No user reviews,0,0,0
1039650,True,0,No user reviews,0,0,0
1039660,True,0,No user reviews,0,0,0
1039670,True,0,No user reviews,0,0,0
1039680,True,0,No user reviews,0,0,0
1039700,True,0,No user reviews,0,0,0
1039720,True,0,No user reviews,0,0,0
1039730,True,0,No user reviews,0,0,0
1039740,True,0,No user reviews,0,0,0
1039760,True,0,No user reviews,0,0,0
1039800,True,0,No user reviews,0,0,0
1039811,True,0,No user reviews,0,0,0
1039820,True,0,No user reviews,0,0,0
1039830,True,0,5 user reviews,1,4,5
1039860,True,0,1 user reviews,1,0,1
1039880,True,8,Very Positive,535,117,652
1039890,True,5,Mixed,164,101,265
1039910,True,0,3 user reviews,3,0,3
1039940,True,8,Very Positive,60,1,61
1039960,True,0,9 user reviews,9,0,9
1039970,True,7,Positive,11,2,13
1040000,True,0,1 user reviews,1,0,1
1040030,True,0,1 user reviews,1,0,1
1040042,True,0,No user reviews,0,0,0
1040070,True,8,Very Positive,426,55,481
1040080,True,6,Mostly Positive,15,4,19
1040090,True,0,No user reviews,0,0,0
1040100,True,0,No user reviews,0,0,0
1040110,True,0,No user reviews,0,0,0
1040150,True,0,1 user reviews,1,0,1
1040190,True,0,No user reviews,0,0,0
1040200,True,0,No user reviews,0,0,0
1040220,True,0,No user reviews,0,0,0
1040230,True,6,Mostly Positive,73,19,92
1040240,True,0,No user reviews,0,0,0
1040300,True,0,No user reviews,0,0,0
1040310,True,0,5 user reviews,3,2,5
1040320,True,0,No user reviews,0,0,0
1040330,True,0,No user reviews,0,0,0
1040350,True,0,No user reviews,0,0,0
1040360,True,0,No user reviews,0,0,0
1040370,True,0,2 user reviews,2,0,2
1040390,True,7,Positive,25,2,27
1040420,True,8,Very Positive,232,9,241
1040430,True,0,No user reviews,0,0,0
1040460,True,6,Mostly Positive,10,4,14
1040480,True,0,No user reviews,0,0,0
1040490,True,0,No user reviews,0,0,0
1040500,True,0,No user reviews,0,0,0
1040501,True,0,2 user reviews,0,2,2
1040510,True,0,No user reviews,0,0,0
1040550,True,8,Very Positive,157,3,160
1040590,True,7,Positive,11,2,13
1040610,True,0,No user reviews,0,0,0
1040620,True,0,2 user reviews,2,0,2
1040630,True,8,Very Positive,71,9,80
1040640,True,0,No user reviews,0,0,0
1040660,True,0,No user reviews,0,0,0
1040690,True,0,3 user reviews,1,2,3
1040700,True,0,1 user reviews,1,0,1
1040720,True,0,1 user reviews,0,1,1
1040730,True,7,Positive,18,2,20
1040740,True,0,3 user reviews,2,1,3
1040750,True,0,1 user reviews,1,0,1
1040790,True,0,No user reviews,0,0,0
1040810,True,0,No user reviews,0,0,0
1040820,True,0,No user reviews,0,0,0
1040860,True,0,2 user reviews,0,2,2
1040880,True,0,1 user reviews,0,1,1
1040890,True,0,No user reviews,0,0,0
1040900,True,0,No user reviews,0,0,0
1040910,True,0,No user reviews,0,0,0
1040920,True,0,No user reviews,0,0,0
1040930,True,7,Positive,22,4,26
1040940,True,5,Mixed,4,6,10
1041000,True,7,Positive,15,0,15
1041010,True,0,6 user reviews,6,0,6
1041020,True,0,No user reviews,0,0,0
1041050,True,0,No user reviews,0,0,0
1041060,True,0,No user reviews,0,0,0
1041070,True,0,No user reviews,0,0,0
1041090,True,0,No user reviews,0,0,0
1041100,True,0,No user reviews,0,0,0
1041120,True,0,No user reviews,0,0,0
1041130,True,0,7 user reviews,5,2,7
1041140,True,0,4 user reviews,0,4,4
1041160,True,0,No user reviews,0,0,0
1041171,True,0,No user reviews,0,0,0
1041172,True,0,No user reviews,0,0,0
1041173,True,0,No user reviews,0,0,0
1041180,True,0,No user reviews,0,0,0
1041210,True,0,No user reviews,0,0,0
1041240,True,0,No user reviews,0,0,0
1041270,True,0,7 user reviews,4,3,7
1041290,True,0,No user reviews,0,0,0
1041300,True,0,No user reviews,0,0,0
1041320,True,0,No user reviews,0,0,0
1041330,True,0,No user reviews,0,0,0
1041390,True,0,3 user reviews,2,1,3
1041400,True,8,Very Positive,85,18,103
1041410,True,0,No user reviews,0,0,0
1041420,True,0,No user reviews,0,0,0
1041450,True,0,3 user reviews,3,0,3
1041460,True,8,Very Positive,50,2,52
1041470,True,0,No user reviews,0,0,0
1041500,True,0,4 user reviews,4,0,4
1041630,True,0,No user reviews,0,0,0
1041650,True,0,1 user reviews,1,0,1
1041660,True,0,No user reviews,0,0,0
1041670,True,0,9 user reviews,6,3,9
1041680,True,5,Mixed,24,13,37
1041690,True,6,Mostly Positive,14,4,18
1041710,True,0,2 user reviews,2,0,2
1041720,True,6,Mostly Positive,1219,426,1645
1041760,True,0,No user reviews,0,0,0
1041780,True,0,8 user reviews,5,3,8
1041790,True,0,No user reviews,0,0,0
1041820,True,0,No user reviews,0,0,0
1041830,True,0,No user reviews,0,0,0
1041831,True,0,No user reviews,0,0,0
1041840,True,5,Mixed,50,25,75
1041880,True,0,No user reviews,0,0,0
1041890,True,0,No user reviews,0,0,0
1041910,True,0,No user reviews,0,0,0
1041920,True,8,Very Positive,112,5,117
1041940,True,7,Positive,35,5,40
1042000,True,0,No user reviews,0,0,0
1042010,True,0,No user reviews,0,0,0
1042020,True,4,Mostly Negative,7,12,19
1042030,True,0,5 user reviews,5,0,5
1042040,True,0,1 user reviews,0,1,1
1042050,True,0,1 user reviews,0,1,1
1042080,True,0,5 user reviews,4,1,5
1042090,True,0,5 user reviews,4,1,5
1042100,True,0,No user reviews,0,0,0
1042110,True,0,No user reviews,0,0,0
1042120,True,0,No user reviews,0,0,0
1042130,True,0,3 user reviews,2,1,3
1042150,True,0,1 user reviews,1,0,1
1042160,True,6,Mostly Positive,17,7,24
1042170,True,0,5 user reviews,4,1,5
1042210,True,0,No user reviews,0,0,0
1042220,True,5,Mixed,363,325,688
1042230,True,0,No user reviews,0,0,0
1042270,True,8,Very Positive,60,6,66
1042290,True,0,2 user reviews,0,2,2
1042310,True,0,4 user reviews,2,2,4
1042330,True,7,Positive,10,0,10
1042340,True,0,No user reviews,0,0,0
1042350,True,0,No user reviews,0,0,0
1042360,True,6,Mostly Positive,23,9,32
1042370,True,0,No user reviews,0,0,0
1042380,True,0,No user reviews,0,0,0
1042390,True,7,Positive,24,0,24
1042400,True,0,No user reviews,0,0,0
1042440,True,0,No user reviews,0,0,0
1042450,True,0,No user reviews,0,0,0
1042460,True,0,No user reviews,0,0,0
1042480,True,0,No user reviews,0,0,0
1042490,True,0,No user reviews,0,0,0
1042500,True,0,No user reviews,0,0,0
1042530,True,0,No user reviews,0,0,0
1042540,True,0,No user reviews,0,0,0
1042550,True,8,Very Positive,1061,60,1121
1042560,True,0,No user reviews,0,0,0
1042570,True,0,No user reviews,0,0,0
1042580,True,0,1 user reviews,1,0,1
1042590,True,0,No user reviews,0,0,0
1042600,True,0,No user reviews,0,0,0
1042620,True,0,No user reviews,0,0,0
1042640,True,0,No user reviews,0,0,0
1042660,True,0,No user reviews,0,0,0
1042670,True,5,Mixed,18,10,28
1042710,True,0,No user reviews,0,0,0
1042730,True,0,6 user reviews,5,1,6
1042731,True,0,9 user reviews,6,3,9
1042740,True,0,No user reviews,0,0,0
1042741,True,0,No user reviews,0,0,0
1042750,True,0,No user reviews,0,0,0
1042780,True,6,Mostly Positive,337,129,466
1042790,True,0,No user reviews,0,0,0
1042800,True,8,Very Positive,452,108,560
1042813,True,0,No user reviews,0,0,0
1042820,True,0,6 user reviews,3,3,6
1042850,True,0,6 user reviews,6,0,6
1042851,True,0,3 user reviews,3,0,3
1042860,True,0,No user reviews,0,0,0
1042880,True,0,1 user reviews,0,1,1
1042920,True,0,No user reviews,0,0,0
1042950,True,0,1 user reviews,0,1,1
1042960,True,0,No user reviews,0,0,0
1042980,True,6,Mostly Positive,12,4,16
1042990,True,5,Mixed,7,4,11
1043000,True,6,Mostly Positive,9,3,12
1043020,True,0,2 user reviews,0,2,2
1043030,True,0,3 user reviews,3,0,3
1043040,True,0,4 user reviews,1,3,4
1043060,True,0,1 user reviews,1,0,1
1043110,True,0,No user reviews,0,0,0
1043120,True,0,4 user reviews,4,0,4
1043140,True,0,1 user reviews,1,0,1
1043150,True,7,Positive,24,2,26
1043160,True,0,2 user reviews,2,0,2
1043180,True,0,No user reviews,0,0,0
1043200,True,0,4 user reviews,4,0,4
1043230,True,7,Positive,35,0,35
1043240,True,7,Positive,40,0,40
1043250,True,0,6 user reviews,6,0,6
1043260,True,0,No user reviews,0,0,0
1043340,True,8,Very Positive,431,13,444
1043350,True,5,Mixed,9,9,18
1043360,True,0,4 user reviews,1,3,4
1043370,True,0,No user reviews,0,0,0
1043380,True,0,No user reviews,0,0,0
1043390,True,8,Very Positive,294,31,325
1043420,True,0,7 user reviews,5,2,7
1043430,True,7,Positive,35,5,40
1043440,True,0,No user reviews,0,0,0
1043450,True,0,No user reviews,0,0,0
1043470,True,0,No user reviews,0,0,0
1043480,True,0,No user reviews,0,0,0
1043500,True,8,Very Positive,99,6,105
1043510,True,0,1 user reviews,1,0,1
1043550,True,0,1 user reviews,1,0,1
1043560,True,0,3 user reviews,3,0,3
1043580,True,0,2 user reviews,2,0,2
1043590,True,0,No user reviews,0,0,0
1043610,True,0,6 user reviews,3,3,6
1043650,True,0,No user reviews,0,0,0
1043660,True,0,No user reviews,0,0,0
1043670,True,0,No user reviews,0,0,0
1043690,True,7,Positive,11,0,11
1043710,True,0,2 user reviews,2,0,2
1043760,True,0,No user reviews,0,0,0
1043770,True,0,No user reviews,0,0,0
1043790,True,0,No user reviews,0,0,0
1043800,True,0,No user reviews,0,0,0
1043810,True,0,No user reviews,0,0,0
1043820,True,0,No user reviews,0,0,0
1043860,True,0,1 user reviews,1,0,1
1043870,True,0,7 user reviews,7,0,7
1043880,True,0,7 user reviews,4,3,7
1043890,True,0,5 user reviews,4,1,5
1044020,True,0,9 user reviews,8,1,9
1044030,True,0,No user reviews,0,0,0
1044040,True,5,Mixed,20,17,37
1044050,True,0,No user reviews,0,0,0
1044070,True,0,No user reviews,0,0,0
1044080,True,0,No user reviews,0,0,0
1044090,True,0,No user reviews,0,0,0
1044110,True,0,No user reviews,0,0,0
1044120,True,0,No user reviews,0,0,0
1044130,True,0,2 user reviews,2,0,2
1044140,True,0,2 user reviews,2,0,2
1044141,True,0,1 user reviews,1,0,1
1044160,True,0,No user reviews,0,0,0
1044170,True,3,Negative,2,14,16
1044180,True,0,No user reviews,0,0,0
1044190,True,0,2 user reviews,2,0,2
1044200,True,0,No user reviews,0,0,0
1044210,True,0,1 user reviews,1,0,1
1044220,True,0,7 user reviews,6,1,7
1044230,True,0,No user reviews,0,0,0
1044231,True,0,No user reviews,0,0,0
1044232,True,0,No user reviews,0,0,0
1044233,True,0,No user reviews,0,0,0
1044234,True,0,No user reviews,0,0,0
1044260,True,0,2 user reviews,2,0,2
1044300,True,0,No user reviews,0,0,0
1044310,True,0,9 user reviews,8,1,9
1044320,True,0,No user reviews,0,0,0
1044330,True,0,No user reviews,0,0,0
1044340,True,6,Mostly Positive,39,15,54
1044350,True,0,4 user reviews,3,1,4
1044410,True,0,No user reviews,0,0,0
1044430,True,0,No user reviews,0,0,0
1044440,True,7,Positive,23,5,28
1044450,True,7,Positive,29,2,31
1044460,True,0,2 user reviews,0,2,2
1044470,True,0,No user reviews,0,0,0
1044480,True,0,No user reviews,0,0,0
1044490,True,8,Very Positive,60,5,65
1044500,True,7,Positive,23,4,27
1044510,True,0,No user reviews,0,0,0
1044520,True,0,6 user reviews,5,1,6
1044620,True,8,Very Positive,307,6,313
1044630,True,4,Mostly Negative,2,8,10
1044640,True,0,2 user reviews,1,1,2
1044650,True,0,No user reviews,0,0,0
1044660,True,0,No user reviews,0,0,0
1044661,True,0,No user reviews,0,0,0
1044662,True,0,No user reviews,0,0,0
1044680,True,0,No user reviews,0,0,0
1044690,True,0,No user reviews,0,0,0
1044700,True,0,No user reviews,0,0,0
1044710,True,0,No user reviews,0,0,0
1044730,True,7,Positive,10,0,10
1044740,True,0,No user reviews,0,0,0
1044750,True,0,No user reviews,0,0,0
1044760,True,6,Mostly Positive,11,4,15
1044770,True,0,6 user reviews,6,0,6
1044790,True,0,2 user reviews,2,0,2
1044800,True,0,3 user reviews,3,0,3
1044820,True,0,No user reviews,0,0,0
1044830,True,0,1 user reviews,0,1,1
1044840,True,0,3 user reviews,3,0,3
1044870,True,0,5 user reviews,5,0,5
1044900,True,0,No user reviews,0,0,0
1044920,True,0,2 user reviews,1,1,2
1044930,True,0,1 user reviews,1,0,1
1044950,True,5,Mixed,5,6,11
1044980,True,0,No user reviews,0,0,0
1044990,True,0,No user reviews,0,0,0
1045010,True,0,7 user reviews,7,0,7
1045020,True,0,No user reviews,0,0,0
1045031,True,0,No user reviews,0,0,0
1045060,True,0,1 user reviews,1,0,1
1045070,True,0,1 user reviews,1,0,1
1045080,True,6,Mostly Positive,58,21,79
1045100,True,3,Negative,2,19,21
1045110,True,5,Mixed,8,4,12
1045120,True,7,Positive,13,0,13
1045130,True,0,No user reviews,0,0,0
1045140,True,0,No user reviews,0,0,0
1045150,True,0,No user reviews,0,0,0
1045170,True,6,Mostly Positive,24,8,32
1045180,True,6,Mostly Positive,52,17,69
1045190,True,5,Mixed,7,6,13
1045200,True,0,No user reviews,0,0,0
1045220,True,0,1 user reviews,0,1,1
1045280,True,0,No user reviews,0,0,0
1045290,True,0,3 user reviews,2,1,3
1045291,True,0,1 user reviews,0,1,1
1045300,True,0,3 user reviews,2,1,3
1045310,True,0,No user reviews,0,0,0
1045320,True,0,No user reviews,0,0,0
1045340,True,7,Positive,31,6,37
1045350,True,7,Positive,29,7,36
1045360,True,0,No user reviews,0,0,0
1045390,True,0,5 user reviews,5,0,5
1045400,True,0,1 user reviews,1,0,1
1045410,True,0,No user reviews,0,0,0
1045420,True,0,No user reviews,0,0,0
1045430,True,7,Positive,34,5,39
1045460,True,0,No user reviews,0,0,0
1045470,True,0,No user reviews,0,0,0
1045490,True,0,1 user reviews,1,0,1
1045500,True,0,No user reviews,0,0,0
1045510,True,0,7 user reviews,5,2,7
1045520,True,9,Overwhelmingly Positive,1633,41,1674
1045540,True,0,No user reviews,0,0,0
1045550,True,0,No user reviews,0,0,0
1045560,True,0,No user reviews,0,0,0
1045570,True,0,No user reviews,0,0,0
1045580,True,7,Positive,24,0,24
1045590,True,0,No user reviews,0,0,0
1045600,True,0,No user reviews,0,0,0
1045620,True,8,Very Positive,66,7,73
1045630,True,0,No user reviews,0,0,0
1045650,True,8,Very Positive,42,8,50
1045670,True,0,No user reviews,0,0,0
1045680,True,5,Mixed,14,10,24
1045710,True,0,No user reviews,0,0,0
1045720,True,8,Very Positive,117,4,121
1045730,True,0,No user reviews,0,0,0
1045740,True,0,4 user reviews,1,3,4
1045750,True,0,No user reviews,0,0,0
1045810,True,0,2 user reviews,2,0,2
1045820,True,0,No user reviews,0,0,0
1045840,True,7,Positive,30,7,37
1045850,True,0,No user reviews,0,0,0
1045880,True,0,No user reviews,0,0,0
1045890,True,0,No user reviews,0,0,0
1045900,True,0,2 user reviews,2,0,2
1045920,True,0,7 user reviews,4,3,7
1045930,True,0,3 user reviews,3,0,3
1045940,True,0,No user reviews,0,0,0
1045980,True,6,Mostly Positive,139,47,186
1046020,True,0,No user reviews,0,0,0
1046030,True,9,Overwhelmingly Positive,6309,272,6581
1046050,True,5,Mixed,12,8,20
1046060,True,0,3 user reviews,3,0,3
1046070,True,0,3 user reviews,2,1,3
1046080,True,0,No user reviews,0,0,0
1046081,True,0,No user reviews,0,0,0
1046083,True,0,No user reviews,0,0,0
1046084,True,0,No user reviews,0,0,0
1046085,True,0,No user reviews,0,0,0
1046086,True,0,No user reviews,0,0,0
1046087,True,0,No user reviews,0,0,0
1046088,True,0,No user reviews,0,0,0
1046089,True,0,No user reviews,0,0,0
1046090,True,0,No user reviews,0,0,0
1046091,True,0,No user reviews,0,0,0
1046092,True,0,No user reviews,0,0,0
1046100,True,0,No user reviews,0,0,0
1046110,True,0,No user reviews,0,0,0
1046130,True,7,Positive,10,0,10
1046140,True,0,1 user reviews,0,1,1
1046160,True,0,No user reviews,0,0,0
1046180,True,6,Mostly Positive,70,24,94
1046190,True,0,2 user reviews,2,0,2
1046210,True,0,7 user reviews,7,0,7
1046220,True,0,No user reviews,0,0,0
1046230,True,6,Mostly Positive,28,10,38
1046240,True,3,Negative,1,9,10
1046260,True,0,No user reviews,0,0,0
1046300,True,8,Very Positive,78,15,93
1046310,True,0,No user reviews,0,0,0
1046311,True,0,No user reviews,0,0,0
1046312,True,0,No user reviews,0,0,0
1046320,True,0,No user reviews,0,0,0
1046321,True,0,No user reviews,0,0,0
1046322,True,0,No user reviews,0,0,0
1046330,True,0,1 user reviews,1,0,1
1046340,True,0,No user reviews,0,0,0
1046341,True,0,No user reviews,0,0,0
1046342,True,0,No user reviews,0,0,0
1046350,True,0,1 user reviews,0,1,1
1046370,True,0,No user reviews,0,0,0
1046400,True,0,No user reviews,0,0,0
1046410,True,0,No user reviews,0,0,0
1046420,True,0,No user reviews,0,0,0
1046440,True,0,No user reviews,0,0,0
1046450,True,0,No user reviews,0,0,0
1046460,True,0,No user reviews,0,0,0
1046470,True,0,No user reviews,0,0,0
1046490,True,0,No user reviews,0,0,0
1046500,True,0,No user reviews,0,0,0
1046530,True,0,4 user reviews,3,1,4
1046540,True,0,No user reviews,0,0,0
1046550,True,0,No user reviews,0,0,0
1046560,True,0,2 user reviews,0,2,2
1046570,True,0,6 user reviews,4,2,6
1046600,True,0,3 user reviews,2,1,3
1046610,True,0,1 user reviews,1,0,1
1046630,True,0,5 user reviews,5,0,5
1046640,True,0,No user reviews,0,0,0
1046650,True,0,No user reviews,0,0,0
1046660,True,6,Mostly Positive,98,37,135
1046670,True,0,3 user reviews,2,1,3
1046690,True,0,No user reviews,0,0,0
1046700,True,0,No user reviews,0,0,0
1046740,True,0,4 user reviews,2,2,4
1046750,True,0,4 user reviews,3,1,4
1046760,True,0,No user reviews,0,0,0
1046770,True,7,Positive,16,3,19
1046780,True,0,No user reviews,0,0,0
1046790,True,0,No user reviews,0,0,0
1046800,True,0,1 user reviews,1,0,1
1046801,True,0,1 user reviews,1,0,1
1046810,True,0,No user reviews,0,0,0
1046820,True,7,Positive,23,5,28
1046880,True,0,2 user reviews,2,0,2
1046900,True,0,No user reviews,0,0,0
1046910,True,0,1 user reviews,1,0,1
1046920,True,0,No user reviews,0,0,0
1046930,True,0,No user reviews,0,0,0
1046970,True,0,No user reviews,0,0,0
1046980,True,0,5 user reviews,3,2,5
1047000,True,0,No user reviews,0,0,0
1047010,True,8,Very Positive,79,7,86
1047020,True,0,1 user reviews,0,1,1
1047040,True,0,No user reviews,0,0,0
1047080,True,0,No user reviews,0,0,0
1047090,True,0,No user reviews,0,0,0
1047110,True,0,6 user reviews,6,0,6
1047120,True,0,8 user reviews,8,0,8
1047140,True,0,4 user reviews,0,4,4
1047150,True,0,5 user reviews,5,0,5
1047160,True,0,2 user reviews,0,2,2
1047180,True,5,Mixed,46,33,79
1047190,True,0,No user reviews,0,0,0
1047220,True,8,Very Positive,250,5,255
1047230,True,0,1 user reviews,1,0,1
1047240,True,5,Mixed,5,5,10
1047330,True,0,No user reviews,0,0,0
1047340,True,0,No user reviews,0,0,0
1047350,True,0,No user reviews,0,0,0
1047380,True,6,Mostly Positive,26,11,37
1047400,True,0,No user reviews,0,0,0
1047410,True,0,No user reviews,0,0,0
1047430,True,0,No user reviews,0,0,0
1047440,True,8,Very Positive,324,16,340
1047460,True,0,No user reviews,0,0,0
1047480,True,0,No user reviews,0,0,0
1047490,True,0,No user reviews,0,0,0
1047500,True,0,No user reviews,0,0,0
1047560,True,0,No user reviews,0,0,0
1047580,True,7,Positive,14,0,14
1047590,True,0,No user reviews,0,0,0
1047600,True,0,No user reviews,0,0,0
1047610,True,0,No user reviews,0,0,0
1047620,True,0,No user reviews,0,0,0
1047640,True,0,No user reviews,0,0,0
1047650,True,0,No user reviews,0,0,0
1047660,True,0,No user reviews,0,0,0
1047670,True,5,Mixed,9,4,13
1047680,True,0,No user reviews,0,0,0
1047690,True,0,No user reviews,0,0,0
1047710,True,0,No user reviews,0,0,0
1047720,True,0,No user reviews,0,0,0
1047730,True,0,No user reviews,0,0,0
1047750,True,0,No user reviews,0,0,0
1047770,True,0,No user reviews,0,0,0
1047780,True,0,2 user reviews,1,1,2
1047800,True,0,3 user reviews,3,0,3
1047810,True,0,3 user reviews,2,1,3
1047830,True,5,Mixed,19,11,30
1047840,True,0,No user reviews,0,0,0
1047850,True,0,5 user reviews,5,0,5
1047860,True,0,5 user reviews,3,2,5
1047870,True,7,Positive,25,2,27
1047880,True,0,No user reviews,0,0,0
1047900,True,0,No user reviews,0,0,0
1047910,True,0,No user reviews,0,0,0
1047920,True,0,No user reviews,0,0,0
1047930,True,0,4 user reviews,4,0,4
1047940,True,0,1 user reviews,1,0,1
1047950,True,0,No user reviews,0,0,0
1047960,True,6,Mostly Positive,19,5,24
1047970,True,0,No user reviews,0,0,0
1047980,True,0,No user reviews,0,0,0
1048000,True,7,Positive,14,3,17
1048010,True,0,No user reviews,0,0,0
1048020,True,0,4 user reviews,2,2,4
1048030,True,0,No user reviews,0,0,0
1048040,True,0,No user reviews,0,0,0
1048050,True,0,6 user reviews,2,4,6
1048080,True,0,3 user reviews,2,1,3
1048090,True,0,5 user reviews,4,1,5
1048100,True,6,Mostly Positive,225,71,296
1048110,True,0,1 user reviews,1,0,1
1048140,True,0,No user reviews,0,0,0
1048150,True,0,No user reviews,0,0,0
1048160,True,0,No user reviews,0,0,0
1048180,True,0,No user reviews,0,0,0
1048190,True,0,No user reviews,0,0,0
1048250,True,0,No user reviews,0,0,0
1048260,True,0,1 user reviews,0,1,1
1048270,True,5,Mixed,7,4,11
1048280,True,0,9 user reviews,4,5,9
1048290,True,0,No user reviews,0,0,0
1048300,True,0,7 user reviews,7,0,7
1048320,True,0,No user reviews,0,0,0
1048340,True,0,No user reviews,0,0,0
1048350,True,0,No user reviews,0,0,0
1048360,True,0,No user reviews,0,0,0
1048380,True,0,1 user reviews,1,0,1
1048381,True,0,1 user reviews,1,0,1
1048390,True,0,No user reviews,0,0,0
1048410,True,0,No user reviews,0,0,0
1048420,True,0,2 user reviews,2,0,2
1048430,True,0,No user reviews,0,0,0
1048460,True,0,5 user reviews,3,2,5
1048470,True,0,No user reviews,0,0,0
1048480,True,0,No user reviews,0,0,0
1048530,True,0,No user reviews,0,0,0
1048540,True,8,Very Positive,289,22,311
1048550,True,0,No user reviews,0,0,0
1048560,True,7,Positive,13,1,14
1048570,True,0,No user reviews,0,0,0
1048580,True,0,No user reviews,0,0,0
1048600,True,6,Mostly Positive,93,24,117
1048610,True,0,No user reviews,0,0,0
1048630,True,0,No user reviews,0,0,0
1048640,True,4,Mostly Negative,4,10,14
1048670,True,0,No user reviews,0,0,0
1048690,True,0,1 user reviews,1,0,1
1048710,True,5,Mixed,6,4,10
1048740,True,8,Very Positive,54,5,59
1048770,True,0,No user reviews,0,0,0
1048780,True,0,No user reviews,0,0,0
1048790,True,0,No user reviews,0,0,0
1048830,True,0,No user reviews,0,0,0
1048840,True,0,No user reviews,0,0,0
1048850,True,0,No user reviews,0,0,0
1048860,True,0,No user reviews,0,0,0
1048870,True,5,Mixed,9,10,19
1048871,True,5,Mixed,6,7,13
1048872,True,5,Mixed,9,6,15
1048873,True,0,9 user reviews,3,6,9
1048874,True,4,Mostly Negative,12,20,32
1048875,True,0,9 user reviews,2,7,9
1048876,True,5,Mixed,9,5,14
1048877,True,0,5 user reviews,1,4,5
1048878,True,4,Mostly Negative,3,9,12
1048879,True,5,Mixed,5,5,10
1048880,True,0,5 user reviews,2,3,5
1048890,True,0,No user reviews,0,0,0
1048900,True,0,7 user reviews,5,2,7
1048910,True,0,No user reviews,0,0,0
1048920,True,0,2 user reviews,1,1,2
1048930,True,0,No user reviews,0,0,0
1048931,True,0,No user reviews,0,0,0
1048950,True,6,Mostly Positive,92,26,118
1048960,True,0,4 user reviews,3,1,4
1048970,True,0,No user reviews,0,0,0
1049000,True,0,No user reviews,0,0,0
1049010,True,0,No user reviews,0,0,0
1049020,True,8,Very Positive,147,20,167
1049030,True,0,1 user reviews,1,0,1
1049040,True,0,No user reviews,0,0,0
1049050,True,0,No user reviews,0,0,0
1049070,True,7,Positive,11,2,13
1049080,True,0,No user reviews,0,0,0
1049090,True,0,5 user reviews,4,1,5
1049100,True,7,Positive,25,2,27
1049120,True,0,1 user reviews,1,0,1
1049121,True,0,No user reviews,0,0,0
1049130,True,5,Mixed,13,8,21
1049140,True,0,3 user reviews,2,1,3
1049150,True,0,No user reviews,0,0,0
1049170,True,0,No user reviews,0,0,0
1049220,True,7,Positive,34,8,42
1049230,True,0,No user reviews,0,0,0
1049240,True,5,Mixed,85,50,135
1049270,True,0,3 user reviews,2,1,3
1049280,True,8,Very Positive,278,16,294
1049290,True,5,Mixed,37,16,53
1049310,True,0,2 user reviews,2,0,2
1049320,True,8,Very Positive,504,106,610
1049330,True,0,No user reviews,0,0,0
1049340,True,0,No user reviews,0,0,0
1049350,True,0,No user reviews,0,0,0
1049360,True,0,No user reviews,0,0,0
1049370,True,0,3 user reviews,2,1,3
1049380,True,0,No user reviews,0,0,0
1049400,True,0,No user reviews,0,0,0
1049410,True,0,No user reviews,0,0,0
1049420,True,0,No user reviews,0,0,0
1049430,True,0,3 user reviews,3,0,3
1049440,True,6,Mostly Positive,20,7,27
1049490,True,0,4 user reviews,3,1,4
1049500,True,0,No user reviews,0,0,0
1049510,True,0,5 user reviews,4,1,5
1049530,True,0,9 user reviews,8,1,9
1049560,True,0,4 user reviews,4,0,4
1049570,True,6,Mostly Positive,7,3,10
1049590,True,0,5 user reviews,4,1,5
1049630,True,0,No user reviews,0,0,0
1049640,True,0,No user reviews,0,0,0
1049650,True,0,6 user reviews,4,2,6
1049660,True,0,No user reviews,0,0,0
1049670,True,7,Positive,10,0,10
1049680,True,0,1 user reviews,0,1,1
1049690,True,0,4 user reviews,4,0,4
1049710,True,0,No user reviews,0,0,0
1049720,True,0,1 user reviews,1,0,1
1049730,True,0,2 user reviews,1,1,2
1049740,True,0,No user reviews,0,0,0
1049770,True,0,No user reviews,0,0,0
1049790,True,8,Very Positive,271,43,314
1049800,True,0,No user reviews,0,0,0
1049810,True,7,Positive,25,4,29
1049820,True,7,Positive,11,1,12
1049840,True,0,1 user reviews,1,0,1
1049870,True,0,No user reviews,0,0,0
1049880,True,0,No user reviews,0,0,0
1049890,True,9,Overwhelmingly Positive,1122,19,1141
1049900,True,7,Positive,15,1,16
1049910,True,0,2 user reviews,1,1,2
1049920,True,0,No user reviews,0,0,0
1049930,True,0,1 user reviews,0,1,1
1049940,True,5,Mixed,9,6,15
1049950,True,0,No user reviews,0,0,0
1049980,True,0,No user reviews,0,0,0
1049990,True,0,No user reviews,0,0,0
1050000,True,7,Positive,20,1,21
1050010,True,0,5 user reviews,5,0,5
1050030,True,0,No user reviews,0,0,0
1050040,True,0,4 user reviews,1,3,4
1050050,True,0,2 user reviews,0,2,2
1050060,True,0,No user reviews,0,0,0
1050070,True,0,No user reviews,0,0,0
1050080,True,0,1 user reviews,0,1,1
1050090,True,0,2 user reviews,1,1,2
1050120,True,0,1 user reviews,0,1,1
1050121,True,0,No user reviews,0,0,0
1050122,True,5,Mixed,5,5,10
1050150,True,5,Mixed,5,5,10
1050160,True,0,2 user reviews,2,0,2
1050170,True,0,1 user reviews,0,1,1
1050180,True,0,2 user reviews,1,1,2
1050190,True,0,No user reviews,0,0,0
1050210,True,0,4 user reviews,2,2,4
1050220,True,0,No user reviews,0,0,0
1050230,True,0,6 user reviews,6,0,6
1050240,True,0,7 user reviews,4,3,7
1050260,True,0,No user reviews,0,0,0
1050270,True,0,No user reviews,0,0,0
1050280,True,0,No user reviews,0,0,0
1050330,True,0,7 user reviews,5,2,7
1050340,True,0,7 user reviews,2,5,7
1050350,True,0,3 user reviews,1,2,3
1050360,True,0,1 user reviews,1,0,1
1050370,True,0,No user reviews,0,0,0
1050410,True,0,No user reviews,0,0,0
1050430,True,0,1 user reviews,1,0,1
1050440,True,6,Mostly Positive,15,4,19
1050450,True,0,5 user reviews,5,0,5
1050460,True,7,Positive,19,0,19
1050480,True,0,1 user reviews,0,1,1
1050500,True,0,5 user reviews,5,0,5
1050510,True,7,Positive,22,4,26
1050520,True,0,5 user reviews,5,0,5
1050530,True,0,No user reviews,0,0,0
1050540,True,0,4 user reviews,1,3,4
1050550,True,0,No user reviews,0,0,0
1050560,True,0,1 user reviews,1,0,1
1050580,True,0,7 user reviews,4,3,7
1050600,True,0,No user reviews,0,0,0
1050610,True,0,No user reviews,0,0,0
1050611,True,0,No user reviews,0,0,0
1050620,True,0,No user reviews,0,0,0
1050660,True,0,No user reviews,0,0,0
1050670,True,0,No user reviews,0,0,0
1050680,True,0,No user reviews,0,0,0
1050690,True,0,No user reviews,0,0,0
1050700,True,0,No user reviews,0,0,0
1050710,True,0,9 user reviews,8,1,9
1050711,True,0,No user reviews,0,0,0
1050712,True,0,5 user reviews,5,0,5
1050713,True,0,No user reviews,0,0,0
1050714,True,0,3 user reviews,3,0,3
1050715,True,0,No user reviews,0,0,0
1050716,True,0,2 user reviews,1,1,2
1050717,True,0,No user reviews,0,0,0
1050720,True,6,Mostly Positive,12,4,16
1050730,True,0,5 user reviews,5,0,5
1050780,True,0,3 user reviews,1,2,3
1050790,True,0,No user reviews,0,0,0
1050810,True,0,6 user reviews,1,5,6
1050850,True,0,No user reviews,0,0,0
1050880,True,7,Positive,11,1,12
1050890,True,0,No user reviews,0,0,0
1050900,True,0,No user reviews,0,0,0
1050910,True,0,No user reviews,0,0,0
1051060,True,0,No user reviews,0,0,0
1051130,True,0,No user reviews,0,0,0
1051140,True,0,No user reviews,0,0,0
1051150,True,0,No user reviews,0,0,0
1051160,True,0,1 user reviews,1,0,1
1051170,True,0,4 user reviews,3,1,4
1051180,True,0,No user reviews,0,0,0
1051190,True,0,1 user reviews,1,0,1
1051200,True,8,Very Positive,1537,143,1680
1051210,True,0,No user reviews,0,0,0
1051220,True,0,1 user reviews,1,0,1
1051250,True,4,Mostly Negative,12,21,33
1051260,True,0,2 user reviews,1,1,2
1051270,True,0,1 user reviews,0,1,1
1051280,True,0,No user reviews,0,0,0
1051290,True,0,6 user reviews,3,3,6
1051300,True,0,3 user reviews,2,1,3
1051310,True,7,Positive,31,4,35
1051320,True,0,1 user reviews,0,1,1
1051330,True,0,No user reviews,0,0,0
1051350,True,0,No user reviews,0,0,0
1051370,True,0,No user reviews,0,0,0
1051380,True,0,5 user reviews,5,0,5
1051390,True,0,No user reviews,0,0,0
1051391,True,0,No user reviews,0,0,0
1051392,True,0,No user reviews,0,0,0
1051410,True,7,Positive,29,3,32
1051420,True,0,3 user reviews,2,1,3
1051430,True,0,No user reviews,0,0,0
1051431,True,0,2 user reviews,1,1,2
1051432,True,0,No user reviews,0,0,0
1051433,True,0,No user reviews,0,0,0
1051434,True,0,No user reviews,0,0,0
1051440,True,0,No user reviews,0,0,0
1051450,True,0,No user reviews,0,0,0
1051460,True,0,No user reviews,0,0,0
1051470,True,0,3 user reviews,3,0,3
1051480,True,0,No user reviews,0,0,0
1051500,True,7,Positive,12,1,13
1051510,True,0,No user reviews,0,0,0
1051520,True,0,No user reviews,0,0,0
1051530,True,0,2 user reviews,2,0,2
1051550,True,0,No user reviews,0,0,0
1051570,True,5,Mixed,18,9,27
1051580,True,0,No user reviews,0,0,0
1051590,True,0,8 user reviews,5,3,8
1051600,True,0,No user reviews,0,0,0
1051620,True,7,Positive,32,8,40
1051621,True,3,Negative,1,13,14
1051630,True,0,2 user reviews,0,2,2
1051650,True,0,No user reviews,0,0,0
1051660,True,0,No user reviews,0,0,0
1051670,True,5,Mixed,16,14,30
1051680,True,0,No user reviews,0,0,0
1051690,True,8,Very Positive,346,12,358
1051700,True,7,Positive,18,1,19
1051710,True,0,No user reviews,0,0,0
1051720,True,0,No user reviews,0,0,0
1051750,True,0,No user reviews,0,0,0
1051760,True,0,No user reviews,0,0,0
1051770,True,0,1 user reviews,1,0,1
1051771,True,0,1 user reviews,1,0,1
1051780,True,0,No user reviews,0,0,0
1051781,True,0,4 user reviews,3,1,4
1051790,True,0,1 user reviews,1,0,1
1051791,True,0,1 user reviews,1,0,1
1051810,True,8,Very Positive,82,8,90
1051830,True,0,5 user reviews,2,3,5
1051840,True,7,Positive,14,0,14
1051850,True,5,Mixed,12,7,19
1051870,True,0,No user reviews,0,0,0
1051890,True,0,7 user reviews,5,2,7
1051900,True,0,No user reviews,0,0,0
1051910,True,0,No user reviews,0,0,0
1051920,True,0,5 user reviews,5,0,5
1051940,True,0,No user reviews,0,0,0
1051950,True,0,No user reviews,0,0,0
1051960,True,7,Positive,24,2,26
1051990,True,0,2 user reviews,2,0,2
1052000,True,0,No user reviews,0,0,0
1052010,True,0,2 user reviews,0,2,2
1052030,True,0,5 user reviews,5,0,5
1052040,True,0,No user reviews,0,0,0
1052060,True,0,No user reviews,0,0,0
1052070,True,0,No user reviews,0,0,0
1052080,True,0,3 user reviews,3,0,3
1052090,True,0,5 user reviews,4,1,5
1052100,True,0,2 user reviews,2,0,2
1052120,True,0,No user reviews,0,0,0
1052140,True,0,No user reviews,0,0,0
1052150,True,0,No user reviews,0,0,0
1052210,True,6,Mostly Positive,7,3,10
1052220,True,7,Positive,11,1,12
1052230,True,0,No user reviews,0,0,0
1052250,True,0,No user reviews,0,0,0
1052270,True,0,No user reviews,0,0,0
1052271,True,0,No user reviews,0,0,0
1052272,True,0,No user reviews,0,0,0
1052273,True,0,No user reviews,0,0,0
1052274,True,0,No user reviews,0,0,0
1052275,True,0,No user reviews,0,0,0
1052310,True,0,3 user reviews,0,3,3
1052320,True,0,No user reviews,0,0,0
1052330,True,0,1 user reviews,0,1,1
1052360,True,0,1 user reviews,0,1,1
1052370,True,0,6 user reviews,4,2,6
1052380,True,0,2 user reviews,2,0,2
1052390,True,0,No user reviews,0,0,0
1052420,True,0,3 user reviews,1,2,3
1052440,True,7,Positive,14,3,17
1052450,True,0,No user reviews,0,0,0
1052470,True,0,1 user reviews,0,1,1
1052480,True,0,2 user reviews,2,0,2
1052490,True,0,No user reviews,0,0,0
1052500,True,0,No user reviews,0,0,0
1052510,True,0,No user reviews,0,0,0
1052520,True,0,No user reviews,0,0,0
1052530,True,0,9 user reviews,9,0,9
1052540,True,0,No user reviews,0,0,0
1052550,True,0,6 user reviews,3,3,6
1052560,True,0,1 user reviews,0,1,1
1052570,True,0,No user reviews,0,0,0
1052580,True,0,3 user reviews,3,0,3
1052590,True,0,No user reviews,0,0,0
1052600,True,0,4 user reviews,1,3,4
1052610,True,0,No user reviews,0,0,0
1052620,True,0,No user reviews,0,0,0
1052630,True,0,1 user reviews,1,0,1
1052640,True,7,Positive,10,0,10
1052650,True,0,No user reviews,0,0,0
1052660,True,0,No user reviews,0,0,0
1052670,True,0,3 user reviews,3,0,3
1052680,True,0,No user reviews,0,0,0
1052690,True,5,Mixed,46,24,70
1052700,True,0,1 user reviews,1,0,1
1052701,True,0,No user reviews,0,0,0
1052730,True,0,1 user reviews,1,0,1
1052731,True,0,No user reviews,0,0,0
1052740,True,0,No user reviews,0,0,0
1052750,True,0,No user reviews,0,0,0
1052760,True,0,5 user reviews,5,0,5
1052780,True,0,No user reviews,0,0,0
1052820,True,0,No user reviews,0,0,0
1052850,True,0,No user reviews,0,0,0
1052860,True,0,No user reviews,0,0,0
1052870,True,0,3 user reviews,3,0,3
1052890,True,0,No user reviews,0,0,0
1052900,True,0,2 user reviews,1,1,2
1052910,True,0,No user reviews,0,0,0
1052920,True,0,No user reviews,0,0,0
1052960,True,0,2 user reviews,2,0,2
1052990,True,8,Very Positive,231,5,236
1053000,True,0,No user reviews,0,0,0
1053020,True,0,No user reviews,0,0,0
1053040,True,0,1 user reviews,1,0,1
1053050,True,0,No user reviews,0,0,0
1053060,True,0,1 user reviews,1,0,1
1053080,True,0,No user reviews,0,0,0
1053090,True,0,2 user reviews,2,0,2
1053160,True,0,2 user reviews,1,1,2
1053170,True,0,No user reviews,0,0,0
1053180,True,0,No user reviews,0,0,0
1053190,True,7,Positive,12,0,12
1053250,True,7,Positive,20,1,21
1053260,True,7,Positive,13,2,15
1053270,True,0,2 user reviews,2,0,2
1053300,True,0,No user reviews,0,0,0
1053330,True,0,2 user reviews,1,1,2
1053340,True,0,No user reviews,0,0,0
1053550,True,0,3 user reviews,3,0,3
1053560,True,0,7 user reviews,7,0,7
1053570,True,0,No user reviews,0,0,0
1053580,True,0,No user reviews,0,0,0
1053590,True,0,5 user reviews,0,5,5
1053600,True,0,No user reviews,0,0,0
1053620,True,0,6 user reviews,6,0,6
1053640,True,0,No user reviews,0,0,0
1053650,True,7,Positive,14,2,16
1053660,True,5,Mixed,7,6,13
1053670,True,0,No user reviews,0,0,0
1053680,True,8,Very Positive,616,61,677
1053700,True,0,No user reviews,0,0,0
1053720,True,0,No user reviews,0,0,0
1053730,True,0,9 user reviews,5,4,9
1053750,True,0,4 user reviews,3,1,4
1053780,True,0,8 user reviews,7,1,8
1053800,True,0,3 user reviews,3,0,3
1053810,True,0,No user reviews,0,0,0
1053820,True,0,1 user reviews,0,1,1
1053830,True,7,Positive,24,2,26
1053850,True,0,7 user reviews,3,4,7
1053860,True,0,No user reviews,0,0,0
1053870,True,0,1 user reviews,0,1,1
1053900,True,0,No user reviews,0,0,0
1053920,True,0,3 user reviews,3,0,3
1053940,True,0,4 user reviews,2,2,4
1053960,True,0,No user reviews,0,0,0
1053970,True,0,2 user reviews,1,1,2
1053980,True,0,No user reviews,0,0,0
1053990,True,0,No user reviews,0,0,0
1054000,True,0,No user reviews,0,0,0
1054010,True,0,No user reviews,0,0,0
1054020,True,0,No user reviews,0,0,0
1054030,True,0,5 user reviews,2,3,5
1054050,True,0,4 user reviews,2,2,4
1054070,True,0,No user reviews,0,0,0
1054071,True,7,Positive,13,3,16
1054080,True,0,No user reviews,0,0,0
1054090,True,0,6 user reviews,4,2,6
1054110,True,6,Mostly Positive,35,12,47
1054120,True,4,Mostly Negative,4,7,11
1054150,True,0,1 user reviews,1,0,1
1054180,True,0,2 user reviews,2,0,2
1054190,True,0,No user reviews,0,0,0
1054240,True,0,2 user reviews,2,0,2
1054250,True,0,1 user reviews,0,1,1
1054260,True,0,No user reviews,0,0,0
1054270,True,7,Positive,19,0,19
1054280,True,0,No user reviews,0,0,0
1054290,True,0,9 user reviews,3,6,9
1054300,True,0,No user reviews,0,0,0
1054310,True,0,5 user reviews,2,3,5
1054340,True,0,No user reviews,0,0,0
1054350,True,0,No user reviews,0,0,0
1054370,True,0,1 user reviews,1,0,1
1054390,True,7,Positive,37,7,44
1054430,True,0,No user reviews,0,0,0
1054440,True,0,No user reviews,0,0,0
1054450,True,0,No user reviews,0,0,0
1054460,True,0,No user reviews,0,0,0
1054470,True,0,8 user reviews,6,2,8
1054480,True,5,Mixed,58,41,99
1054490,True,8,Very Positive,462,35,497
1054500,True,0,No user reviews,0,0,0
1054510,True,8,Very Positive,447,64,511
1054520,True,0,1 user reviews,0,1,1
1054530,True,0,No user reviews,0,0,0
1054550,True,6,Mostly Positive,89,24,113
1054560,True,0,No user reviews,0,0,0
1054570,True,0,1 user reviews,0,1,1
1054580,True,0,No user reviews,0,0,0
1054590,True,0,No user reviews,0,0,0
1054600,True,0,No user reviews,0,0,0
1054610,True,0,1 user reviews,1,0,1
1054620,True,0,2 user reviews,2,0,2
1054630,True,0,No user reviews,0,0,0
1054640,True,0,1 user reviews,1,0,1
1054650,True,0,4 user reviews,2,2,4
1054660,True,7,Positive,36,1,37
1054670,True,0,1 user reviews,1,0,1
1054680,True,0,No user reviews,0,0,0
1054690,True,6,Mostly Positive,20,7,27
1054700,True,7,Positive,31,7,38
1054710,True,6,Mostly Positive,19,5,24
1054720,True,0,2 user reviews,1,1,2
1054730,True,0,7 user reviews,5,2,7
1054750,True,0,No user reviews,0,0,0
1054770,True,0,2 user reviews,1,1,2
1054780,True,0,No user reviews,0,0,0
1054790,True,0,5 user reviews,5,0,5
1054800,True,6,Mostly Positive,12,4,16
1054810,True,0,No user reviews,0,0,0
1054820,True,0,No user reviews,0,0,0
1054840,True,0,No user reviews,0,0,0
1054850,True,0,1 user reviews,0,1,1
1054870,True,0,No user reviews,0,0,0
1054871,True,0,No user reviews,0,0,0
1054872,True,0,No user reviews,0,0,0
1054873,True,0,4 user reviews,4,0,4
1054900,True,0,1 user reviews,0,1,1
1054920,True,0,No user reviews,0,0,0
1054921,True,0,No user reviews,0,0,0
1054930,True,0,4 user reviews,1,3,4
1054950,True,0,No user reviews,0,0,0
1054960,True,0,No user reviews,0,0,0
1054980,True,0,4 user reviews,3,1,4
1054990,True,0,6 user reviews,4,2,6
1055000,True,0,2 user reviews,0,2,2
1055010,True,5,Mixed,59,36,95
1055020,True,0,No user reviews,0,0,0
1055030,True,0,1 user reviews,1,0,1
1055060,True,0,No user reviews,0,0,0
1055061,True,0,No user reviews,0,0,0
1055062,True,0,No user reviews,0,0,0
1055063,True,0,No user reviews,0,0,0
1055064,True,0,No user reviews,0,0,0
1055065,True,0,No user reviews,0,0,0
1055066,True,0,No user reviews,0,0,0
1055067,True,0,No user reviews,0,0,0
1055070,True,0,No user reviews,0,0,0
1055071,True,0,No user reviews,0,0,0
1055072,True,0,No user reviews,0,0,0
1055073,True,0,No user reviews,0,0,0
1055090,True,5,Mixed,143,70,213
1055140,True,0,1 user reviews,1,0,1
1055150,True,0,3 user reviews,3,0,3
1055160,True,0,No user reviews,0,0,0
1055170,True,0,No user reviews,0,0,0
1055180,True,0,3 user reviews,2,1,3
1055210,True,0,3 user reviews,3,0,3
1055220,True,0,3 user reviews,3,0,3
1055240,True,0,No user reviews,0,0,0
1055250,True,0,No user reviews,0,0,0
1055260,True,0,No user reviews,0,0,0
1055270,True,0,No user reviews,0,0,0
1055280,True,0,1 user reviews,1,0,1
1055290,True,7,Positive,20,2,22
1055310,True,5,Mixed,6,6,12
1055331,True,0,3 user reviews,3,0,3
1055332,True,0,5 user reviews,1,4,5
1055333,True,6,Mostly Positive,20,8,28
1055334,True,0,1 user reviews,1,0,1
1055335,True,0,2 user reviews,1,1,2
1055336,True,0,2 user reviews,2,0,2
1055338,True,7,Positive,12,0,12
1055339,True,0,3 user reviews,2,1,3
1055340,True,0,No user reviews,0,0,0
1055360,True,0,No user reviews,0,0,0
1055380,True,0,No user reviews,0,0,0
1055410,True,0,1 user reviews,1,0,1
1055420,True,0,No user reviews,0,0,0
1055430,True,8,Very Positive,302,29,331
1055440,True,0,No user reviews,0,0,0
1055460,True,0,No user reviews,0,0,0
1055490,True,6,Mostly Positive,37,14,51
1055540,True,9,Overwhelmingly Positive,2772,22,2794
1055550,True,0,No user reviews,0,0,0
1055580,True,0,6 user reviews,6,0,6
1055590,True,0,5 user reviews,3,2,5
1055610,True,8,Very Positive,90,9,99
1055620,True,7,Positive,18,3,21
1055630,True,0,No user reviews,0,0,0
1055640,True,0,No user reviews,0,0,0
1055650,True,0,No user reviews,0,0,0
1055660,True,0,No user reviews,0,0,0
1055670,True,0,6 user reviews,4,2,6
1055680,True,0,2 user reviews,2,0,2
1055690,True,0,8 user reviews,8,0,8
1055700,True,0,No user reviews,0,0,0
1055710,True,0,No user reviews,0,0,0
1055720,True,0,No user reviews,0,0,0
1055760,True,0,No user reviews,0,0,0
1055770,True,0,No user reviews,0,0,0
1055780,True,0,2 user reviews,2,0,2
1055790,True,0,No user reviews,0,0,0
1055810,True,8,Very Positive,181,2,183
1055840,True,0,No user reviews,0,0,0
1055850,True,0,No user reviews,0,0,0
1055860,True,0,No user reviews,0,0,0
1055861,True,0,No user reviews,0,0,0
1055870,True,0,No user reviews,0,0,0
1055880,True,0,9 user reviews,9,0,9
1055890,True,0,8 user reviews,8,0,8
1055900,True,0,No user reviews,0,0,0
1055910,True,0,2 user reviews,2,0,2
1055930,True,0,1 user reviews,0,1,1
1055940,True,0,No user reviews,0,0,0
1055950,True,0,1 user reviews,1,0,1
1055960,True,0,No user reviews,0,0,0
1055970,True,0,No user reviews,0,0,0
1055990,True,8,Very Positive,159,21,180
1056000,True,0,No user reviews,0,0,0
1056010,True,0,1 user reviews,1,0,1
1056040,True,0,3 user reviews,3,0,3
1056050,True,4,Mostly Negative,3,7,10
1056060,True,0,No user reviews,0,0,0
1056070,True,0,1 user reviews,1,0,1
1056080,True,0,4 user reviews,0,4,4
1056100,True,0,No user reviews,0,0,0
1056140,True,0,No user reviews,0,0,0
1056170,True,6,Mostly Positive,17,5,22
1056180,True,8,Very Positive,54,9,63
1056190,True,0,No user reviews,0,0,0
1056210,True,0,No user reviews,0,0,0
1056220,True,0,No user reviews,0,0,0
1056230,True,0,5 user reviews,4,1,5
1056240,True,0,No user reviews,0,0,0
1056241,True,0,No user reviews,0,0,0
1056242,True,0,No user reviews,0,0,0
1056243,True,0,No user reviews,0,0,0
1056250,True,0,No user reviews,0,0,0
1056270,True,0,No user reviews,0,0,0
1056280,True,7,Positive,17,1,18
1056300,True,0,No user reviews,0,0,0
1056310,True,0,No user reviews,0,0,0
1056320,True,0,No user reviews,0,0,0
1056330,True,0,No user reviews,0,0,0
1056340,True,0,No user reviews,0,0,0
1056350,True,7,Positive,21,0,21
1056360,True,0,1 user reviews,1,0,1
1056370,True,0,No user reviews,0,0,0
1056380,True,0,No user reviews,0,0,0
1056390,True,8,Very Positive,54,7,61
1056400,True,0,2 user reviews,2,0,2
1056420,True,0,9 user reviews,3,6,9
1056450,True,0,No user reviews,0,0,0
1056470,True,0,9 user reviews,4,5,9
1056480,True,0,6 user reviews,4,2,6
1056490,True,7,Positive,29,2,31
1056510,True,6,Mostly Positive,8,3,11
1056520,True,0,3 user reviews,2,1,3
1056530,True,0,No user reviews,0,0,0
1056540,True,0,No user reviews,0,0,0
1056570,True,8,Very Positive,108,5,113
1056580,True,0,No user reviews,0,0,0
1056590,True,0,8 user reviews,6,2,8
1056610,True,7,Positive,20,2,22
1056620,True,0,No user reviews,0,0,0
1056621,True,0,No user reviews,0,0,0
1056622,True,0,1 user reviews,1,0,1
1056623,True,0,1 user reviews,0,1,1
1056624,True,0,No user reviews,0,0,0
1056625,True,0,No user reviews,0,0,0
1056626,True,0,No user reviews,0,0,0
1056627,True,0,No user reviews,0,0,0
1056628,True,0,No user reviews,0,0,0
1056629,True,0,No user reviews,0,0,0
1056630,True,0,No user reviews,0,0,0
1056640,True,0,1 user reviews,1,0,1
1056650,True,0,2 user reviews,1,1,2
1056660,True,0,4 user reviews,1,3,4
1056670,True,0,No user reviews,0,0,0
1056680,True,0,No user reviews,0,0,0
1056690,True,7,Positive,21,1,22
1056700,True,7,Positive,18,1,19
1056710,True,0,No user reviews,0,0,0
1056720,True,7,Positive,27,0,27
1056730,True,0,1 user reviews,1,0,1
1056750,True,7,Positive,21,5,26
1056760,True,8,Very Positive,232,37,269
1056761,True,8,Very Positive,55,12,67
1056770,True,0,No user reviews,0,0,0
1056780,True,7,Positive,14,1,15
1056840,True,0,No user reviews,0,0,0
1056860,True,0,No user reviews,0,0,0
1056870,True,0,3 user reviews,2,1,3
1056880,True,0,2 user reviews,1,1,2
1056890,True,0,4 user reviews,1,3,4
1056900,True,0,1 user reviews,1,0,1
1056910,True,0,No user reviews,0,0,0
1056920,True,0,No user reviews,0,0,0
1056930,True,0,No user reviews,0,0,0
1056940,True,0,3 user reviews,1,2,3
1056960,True,5,Mixed,1329,1418,2747
1056970,True,4,Mostly Negative,30,54,84
1057020,True,0,No user reviews,0,0,0
1057030,True,0,No user reviews,0,0,0
1057040,True,0,No user reviews,0,0,0
1057060,True,0,2 user reviews,2,0,2
1057070,True,0,2 user reviews,2,0,2
1057090,True,9,Overwhelmingly Positive,9528,347,9875
1057120,True,0,1 user reviews,1,0,1
1057130,True,0,No user reviews,0,0,0
1057150,True,0,No user reviews,0,0,0
1057160,True,0,3 user reviews,3,0,3
1057180,True,5,Mixed,83,52,135
1057190,True,0,No user reviews,0,0,0
1057220,True,0,No user reviews,0,0,0
1057240,True,5,Mixed,36,17,53
1057250,True,0,1 user reviews,1,0,1
1057260,True,0,No user reviews,0,0,0
1057261,True,0,No user reviews,0,0,0
1057262,True,0,No user reviews,0,0,0
1057263,True,0,No user reviews,0,0,0
1057264,True,0,No user reviews,0,0,0
1057265,True,0,No user reviews,0,0,0
1057270,True,7,Positive,12,2,14
1057271,True,7,Positive,9,1,10
1057272,True,0,4 user reviews,4,0,4
1057273,True,0,5 user reviews,5,0,5
1057274,True,0,1 user reviews,1,0,1
1057275,True,0,1 user reviews,1,0,1
1057276,True,0,3 user reviews,2,1,3
1057277,True,0,No user reviews,0,0,0
1057278,True,0,4 user reviews,3,1,4
1057279,True,0,3 user reviews,2,1,3
1057280,True,0,1 user reviews,1,0,1
1057281,True,0,3 user reviews,2,1,3
1057282,True,0,1 user reviews,1,0,1
1057283,True,0,3 user reviews,3,0,3
1057310,True,0,4 user reviews,2,2,4
1057390,True,0,3 user reviews,3,0,3
1057420,True,0,No user reviews,0,0,0
1057430,True,0,3 user reviews,3,0,3
1057450,True,0,No user reviews,0,0,0
1057460,True,0,No user reviews,0,0,0
1057470,True,0,No user reviews,0,0,0
1057490,True,6,Mostly Positive,15,4,19
1057500,True,0,4 user reviews,3,1,4
1057540,True,8,Very Positive,76,12,88
1057560,True,0,1 user reviews,1,0,1
1057570,True,0,No user reviews,0,0,0
1057580,True,0,No user reviews,0,0,0
1057590,True,0,No user reviews,0,0,0
1057600,True,0,No user reviews,0,0,0
1057610,True,0,No user reviews,0,0,0
1057630,True,0,No user reviews,0,0,0
1057640,True,7,Positive,34,8,42
1057670,True,0,No user reviews,0,0,0
1057680,True,0,3 user reviews,2,1,3
1057690,True,0,No user reviews,0,0,0
1057700,True,0,No user reviews,0,0,0
1057710,True,0,No user reviews,0,0,0
1057720,True,0,No user reviews,0,0,0
1057730,True,0,2 user reviews,0,2,2
1057740,True,0,No user reviews,0,0,0
1057750,True,5,Mixed,374,168,542
1057760,True,0,No user reviews,0,0,0
1057770,True,5,Mixed,5,6,11
1057780,True,7,Positive,26,2,28
1057790,True,0,No user reviews,0,0,0
1057800,True,0,No user reviews,0,0,0
1057810,True,5,Mixed,7,7,14
1057820,True,0,3 user reviews,1,2,3
1057850,True,0,No user reviews,0,0,0
1057880,True,0,No user reviews,0,0,0
1057900,True,0,No user reviews,0,0,0
1057910,True,0,No user reviews,0,0,0
1057920,True,0,No user reviews,0,0,0
1057970,True,0,No user reviews,0,0,0
1057980,True,7,Positive,12,0,12
1057990,True,0,No user reviews,0,0,0
1058000,True,0,No user reviews,0,0,0
1058020,True,9,Overwhelmingly Positive,1357,44,1401
1058030,True,0,No user reviews,0,0,0
1058040,True,0,No user reviews,0,0,0
1058050,True,0,No user reviews,0,0,0
1058060,True,6,Mostly Positive,17,6,23
1058110,True,5,Mixed,8,6,14
1058120,True,0,1 user reviews,1,0,1
1058121,True,0,1 user reviews,1,0,1
1058130,True,6,Mostly Positive,127,33,160
1058140,True,7,Positive,27,2,29
1058150,True,0,4 user reviews,1,3,4
1058170,True,0,No user reviews,0,0,0
1058180,True,8,Very Positive,93,2,95
1058190,True,5,Mixed,16,13,29
1058200,True,7,Positive,12,0,12
1058210,True,0,7 user reviews,4,3,7
1058220,True,0,4 user reviews,4,0,4
1058250,True,0,No user reviews,0,0,0
1058260,True,0,No user reviews,0,0,0
1058270,True,0,1 user reviews,1,0,1
1058280,True,0,No user reviews,0,0,0
1058290,True,0,No user reviews,0,0,0
1058300,True,0,9 user reviews,4,5,9
1058320,True,6,Mostly Positive,26,11,37
1058330,True,0,3 user reviews,2,1,3
1058340,True,0,No user reviews,0,0,0
1058350,True,7,Positive,11,1,12
1058360,True,4,Mostly Negative,3,7,10
1058370,True,0,No user reviews,0,0,0
1058380,True,6,Mostly Positive,37,12,49
1058390,True,0,2 user reviews,1,1,2
1058400,True,0,No user reviews,0,0,0
1058410,True,0,No user reviews,0,0,0
1058420,True,0,No user reviews,0,0,0
1058430,True,8,Very Positive,858,156,1014
1058440,True,0,No user reviews,0,0,0
1058450,True,8,Very Positive,379,54,433
1058460,True,0,No user reviews,0,0,0
1058461,True,0,No user reviews,0,0,0
1058462,True,0,No user reviews,0,0,0
1058463,True,0,1 user reviews,1,0,1
1058470,True,0,9 user reviews,9,0,9
1058490,True,0,7 user reviews,1,6,7
1058500,True,0,4 user reviews,2,2,4
1058510,True,0,1 user reviews,1,0,1
1058530,True,7,Positive,36,7,43
1058550,True,0,No user reviews,0,0,0
1058560,True,7,Positive,32,2,34
1058570,True,0,No user reviews,0,0,0
1058590,True,0,2 user reviews,2,0,2
1058600,True,0,No user reviews,0,0,0
1058620,True,0,No user reviews,0,0,0
1058630,True,0,2 user reviews,1,1,2
1058640,True,0,No user reviews,0,0,0
1058650,True,6,Mostly Positive,541,138,679
1058660,True,0,5 user reviews,1,4,5
1058680,True,0,3 user reviews,2,1,3
1058690,True,7,Positive,45,4,49
1058700,True,0,No user reviews,0,0,0
1058710,True,0,2 user reviews,2,0,2
1058730,True,0,No user reviews,0,0,0
1058740,True,7,Positive,22,3,25
1058750,True,0,2 user reviews,1,1,2
1058760,True,0,No user reviews,0,0,0
1058770,True,0,7 user reviews,7,0,7
1058800,True,7,Positive,23,5,28
1058830,True,9,Overwhelmingly Positive,870,21,891
1058840,True,0,4 user reviews,4,0,4
1058860,True,0,No user reviews,0,0,0
1058930,True,0,3 user reviews,2,1,3
1058940,True,0,1 user reviews,0,1,1
1058960,True,0,No user reviews,0,0,0
1058970,True,0,No user reviews,0,0,0
1058980,True,0,9 user reviews,6,3,9
1058990,True,0,No user reviews,0,0,0
1059000,True,0,No user reviews,0,0,0
1059040,True,7,Positive,9,2,11
1059050,True,0,No user reviews,0,0,0
1059080,True,0,2 user reviews,1,1,2
1059090,True,0,2 user reviews,2,0,2
1059110,True,0,No user reviews,0,0,0
1059120,True,0,No user reviews,0,0,0
1059140,True,0,No user reviews,0,0,0
1059150,True,6,Mostly Positive,9,3,12
1059160,True,0,7 user reviews,6,1,7
1059170,True,0,1 user reviews,1,0,1
1059190,True,0,8 user reviews,2,6,8
1059210,True,0,No user reviews,0,0,0
1059220,True,0,No user reviews,0,0,0
1059230,True,6,Mostly Positive,17,5,22
1059240,True,0,6 user reviews,3,3,6
1059250,True,0,No user reviews,0,0,0
1059260,True,0,No user reviews,0,0,0
1059280,True,5,Mixed,14,11,25
1059290,True,0,7 user reviews,5,2,7
1059291,True,0,4 user reviews,3,1,4
1059300,True,0,2 user reviews,2,0,2
1059310,True,0,3 user reviews,2,1,3
1059320,True,0,No user reviews,0,0,0
1059340,True,0,No user reviews,0,0,0
1059360,True,0,1 user reviews,1,0,1
1059370,True,0,3 user reviews,3,0,3
1059380,True,0,No user reviews,0,0,0
1059390,True,0,No user reviews,0,0,0
1059420,True,0,4 user reviews,4,0,4
1059430,True,6,Mostly Positive,41,11,52
1059440,True,0,3 user reviews,2,1,3
1059450,True,0,No user reviews,0,0,0
1059460,True,7,Positive,13,3,16
1059470,True,0,1 user reviews,1,0,1
1059480,True,0,No user reviews,0,0,0
1059500,True,0,2 user reviews,1,1,2
1059510,True,0,No user reviews,0,0,0
1059520,True,0,No user reviews,0,0,0
1059570,True,0,No user reviews,0,0,0
1059590,True,0,No user reviews,0,0,0
1059600,True,0,No user reviews,0,0,0
1059610,True,0,No user reviews,0,0,0
1059620,True,0,2 user reviews,0,2,2
1059630,True,0,No user reviews,0,0,0
1059640,True,0,2 user reviews,2,0,2
1059650,True,0,No user reviews,0,0,0
1059660,True,0,No user reviews,0,0,0
1059670,True,0,No user reviews,0,0,0
1059690,True,0,No user reviews,0,0,0
1059700,True,0,No user reviews,0,0,0
1059710,True,0,1 user reviews,1,0,1
1059720,True,0,No user reviews,0,0,0
1059740,True,0,No user reviews,0,0,0
1059760,True,0,1 user reviews,1,0,1
1059810,True,0,No user reviews,0,0,0
1059820,True,5,Mixed,24,18,42
1059830,True,0,2 user reviews,0,2,2
1059840,True,0,4 user reviews,3,1,4
1059860,True,0,No user reviews,0,0,0
1059870,True,0,No user reviews,0,0,0
1059880,True,8,Very Positive,55,10,65
1059890,True,0,9 user reviews,9,0,9
1059900,True,0,No user reviews,0,0,0
1059910,True,0,No user reviews,0,0,0
1059940,True,0,No user reviews,0,0,0
1059950,True,0,No user reviews,0,0,0
1059990,True,0,No user reviews,0,0,0
1060000,True,0,3 user reviews,2,1,3
1060020,True,0,No user reviews,0,0,0
1060040,True,0,No user reviews,0,0,0
1060060,True,0,4 user reviews,2,2,4
1060100,True,0,No user reviews,0,0,0
1060110,True,0,1 user reviews,0,1,1
1060120,True,0,No user reviews,0,0,0
1060140,True,0,No user reviews,0,0,0
1060160,True,0,No user reviews,0,0,0
1060170,True,0,5 user reviews,4,1,5
1060180,True,6,Mostly Positive,15,4,19
1060200,True,0,No user reviews,0,0,0
1060210,True,6,Mostly Positive,75,20,95
1060220,True,8,Very Positive,106,24,130
1060230,True,0,No user reviews,0,0,0
1060240,True,0,7 user reviews,7,0,7
1060270,True,0,No user reviews,0,0,0
1060280,True,0,No user reviews,0,0,0
1060300,True,5,Mixed,33,29,62
1060310,True,6,Mostly Positive,44,16,60
1060320,True,0,No user reviews,0,0,0
1060340,True,0,No user reviews,0,0,0
1060350,True,0,No user reviews,0,0,0
1060360,True,0,No user reviews,0,0,0
1060370,True,0,No user reviews,0,0,0
1060380,True,0,No user reviews,0,0,0
1060390,True,0,No user reviews,0,0,0
1060391,True,0,No user reviews,0,0,0
1060400,True,0,No user reviews,0,0,0
1060410,True,0,No user reviews,0,0,0
1060420,True,0,No user reviews,0,0,0
1060430,True,0,No user reviews,0,0,0
1060450,True,0,No user reviews,0,0,0
1060460,True,0,6 user reviews,5,1,6
1060470,True,0,3 user reviews,1,2,3
1060510,True,0,No user reviews,0,0,0
1060520,True,0,No user reviews,0,0,0
1060550,True,0,1 user reviews,1,0,1
1060560,True,0,No user reviews,0,0,0
1060570,True,0,8 user reviews,6,2,8
1060590,True,0,2 user reviews,2,0,2
1060600,True,8,Very Positive,397,3,400
1060610,True,0,No user reviews,0,0,0
1060620,True,0,7 user reviews,6,1,7
1060630,True,0,No user reviews,0,0,0
1060642,True,0,No user reviews,0,0,0
1060650,True,0,No user reviews,0,0,0
1060660,True,0,No user reviews,0,0,0
1060670,True,6,Mostly Positive,69,24,93
1060690,True,0,3 user reviews,1,2,3
1060700,True,0,No user reviews,0,0,0
1060730,True,0,No user reviews,0,0,0
1060740,True,0,No user reviews,0,0,0
1060770,True,0,3 user reviews,3,0,3
1060780,True,0,1 user reviews,1,0,1
1060810,True,0,2 user reviews,1,1,2
1060820,True,0,4 user reviews,3,1,4
1060830,True,0,No user reviews,0,0,0
1060840,True,0,1 user reviews,1,0,1
1060850,True,0,No user reviews,0,0,0
1060860,True,0,No user reviews,0,0,0
1060870,True,0,1 user reviews,1,0,1
1060880,True,0,No user reviews,0,0,0
1060890,True,0,No user reviews,0,0,0
1060900,True,0,No user reviews,0,0,0
1060910,True,0,1 user reviews,1,0,1
1060980,True,0,2 user reviews,2,0,2
1060990,True,0,No user reviews,0,0,0
1061010,True,0,4 user reviews,2,2,4
1061020,True,0,No user reviews,0,0,0
1061030,True,0,No user reviews,0,0,0
1061040,True,0,No user reviews,0,0,0
1061050,True,0,No user reviews,0,0,0
1061060,True,0,No user reviews,0,0,0
1061070,True,0,No user reviews,0,0,0
1061080,True,0,No user reviews,0,0,0
1061081,True,0,No user reviews,0,0,0
1061082,True,0,No user reviews,0,0,0
1061083,True,0,No user reviews,0,0,0
1061084,True,0,No user reviews,0,0,0
1061090,True,8,Very Positive,1282,108,1390
1061100,True,6,Mostly Positive,186,74,260
1061120,True,0,1 user reviews,1,0,1
1061140,True,0,No user reviews,0,0,0
1061150,True,0,No user reviews,0,0,0
1061160,True,0,5 user reviews,4,1,5
1061180,True,0,No user reviews,0,0,0
1061190,True,0,No user reviews,0,0,0
1061200,True,0,1 user reviews,1,0,1
1061210,True,0,No user reviews,0,0,0
1061220,True,0,1 user reviews,1,0,1
1061240,True,0,6 user reviews,2,4,6
1061250,True,0,No user reviews,0,0,0
1061260,True,0,1 user reviews,0,1,1
1061270,True,7,Positive,9,1,10
1061290,True,0,No user reviews,0,0,0
1061300,True,6,Mostly Positive,8,3,11
1061310,True,5,Mixed,11,5,16
1061350,True,5,Mixed,15,8,23
1061360,True,0,No user reviews,0,0,0
1061390,True,0,No user reviews,0,0,0
1061420,True,0,1 user reviews,1,0,1
1061430,True,0,No user reviews,0,0,0
1061440,True,0,No user reviews,0,0,0
1061441,True,0,No user reviews,0,0,0
1061442,True,0,No user reviews,0,0,0
1061443,True,0,No user reviews,0,0,0
1061460,True,0,No user reviews,0,0,0
1061470,True,7,Positive,11,1,12
1061490,True,5,Mixed,40,26,66
1061530,True,0,No user reviews,0,0,0
1061540,True,0,5 user reviews,5,0,5
1061550,True,0,No user reviews,0,0,0
1061560,True,0,No user reviews,0,0,0
1061600,True,0,No user reviews,0,0,0
1061610,True,7,Positive,42,0,42
1061620,True,0,3 user reviews,2,1,3
1061640,True,5,Mixed,10,12,22
1061650,True,0,4 user reviews,1,3,4
1061670,True,0,No user reviews,0,0,0
1061680,True,0,No user reviews,0,0,0
1061690,True,0,2 user reviews,2,0,2
1061700,True,0,4 user reviews,3,1,4
1061720,True,0,No user reviews,0,0,0
1061730,True,5,Mixed,71,62,133
1061740,True,0,4 user reviews,3,1,4
1061750,True,0,No user reviews,0,0,0
1061751,True,0,No user reviews,0,0,0
1061752,True,0,No user reviews,0,0,0
1061753,True,0,No user reviews,0,0,0
1061754,True,0,No user reviews,0,0,0
1061755,True,0,No user reviews,0,0,0
1061756,True,0,No user reviews,0,0,0
1061757,True,0,1 user reviews,0,1,1
1061760,True,0,No user reviews,0,0,0
1061770,True,0,No user reviews,0,0,0
1061790,True,0,No user reviews,0,0,0
1061800,True,0,No user reviews,0,0,0
1061810,True,0,No user reviews,0,0,0
1061820,True,5,Mixed,9,10,19
1061830,True,0,No user reviews,0,0,0
1061850,True,0,2 user reviews,2,0,2
1061880,True,0,No user reviews,0,0,0
1061900,True,0,5 user reviews,3,2,5
1061910,True,0,No user reviews,0,0,0
1061920,True,7,Positive,19,2,21
1061930,True,2,Very Negative,11,65,76
1061960,True,0,No user reviews,0,0,0
1061970,True,0,No user reviews,0,0,0
1061990,True,0,No user reviews,0,0,0
1062000,True,0,No user reviews,0,0,0
1062020,True,0,4 user reviews,2,2,4
1062030,True,0,No user reviews,0,0,0
1062040,True,8,Very Positive,67,15,82
1062050,True,0,No user reviews,0,0,0
1062060,True,7,Positive,13,2,15
1062070,True,0,No user reviews,0,0,0
1062080,True,0,3 user reviews,3,0,3
1062090,True,0,No user reviews,0,0,0
1062100,True,0,No user reviews,0,0,0
1062110,True,0,No user reviews,0,0,0
1062120,True,0,1 user reviews,1,0,1
1062130,True,0,No user reviews,0,0,0
1062140,True,0,No user reviews,0,0,0
1062160,True,9,Overwhelmingly Positive,1116,32,1148
1062180,True,0,No user reviews,0,0,0
1062190,True,0,No user reviews,0,0,0
1062200,True,0,1 user reviews,0,1,1
1062210,True,0,No user reviews,0,0,0
1062220,True,7,Positive,9,2,11
1062240,True,0,No user reviews,0,0,0
1062260,True,0,No user reviews,0,0,0
1062300,True,0,1 user reviews,1,0,1
1062330,True,0,No user reviews,0,0,0
1062340,True,8,Very Positive,53,13,66
1062390,True,0,No user reviews,0,0,0
1062400,True,0,No user reviews,0,0,0
1062410,True,0,No user reviews,0,0,0
1062420,True,0,5 user reviews,5,0,5
1062430,True,0,No user reviews,0,0,0
1062440,True,0,No user reviews,0,0,0
1062470,True,0,1 user reviews,0,1,1
1062480,True,0,3 user reviews,2,1,3
1062490,True,0,No user reviews,0,0,0
1062491,True,0,No user reviews,0,0,0
1062492,True,0,No user reviews,0,0,0
1062510,True,0,No user reviews,0,0,0
1062511,True,0,No user reviews,0,0,0
1062512,True,0,No user reviews,0,0,0
1062513,True,0,No user reviews,0,0,0
1062514,True,0,No user reviews,0,0,0
1062515,True,0,No user reviews,0,0,0
1062520,True,0,No user reviews,0,0,0
1062530,True,0,No user reviews,0,0,0
1062540,True,0,3 user reviews,2,1,3
1062570,True,0,No user reviews,0,0,0
1062590,True,5,Mixed,41,38,79
1062600,True,0,No user reviews,0,0,0
1062620,True,0,No user reviews,0,0,0
1062640,True,0,No user reviews,0,0,0
1062660,True,0,2 user reviews,1,1,2
1062670,True,0,1 user reviews,1,0,1
1062680,True,0,1 user reviews,1,0,1
1062690,True,0,No user reviews,0,0,0
1062830,True,8,Very Positive,140,5,145
1062850,True,0,No user reviews,0,0,0
1062860,True,0,No user reviews,0,0,0
1062930,True,0,No user reviews,0,0,0
1062960,True,6,Mostly Positive,164,70,234
1063040,True,6,Mostly Positive,10,4,14
1063050,True,5,Mixed,7,4,11
1063060,True,0,2 user reviews,2,0,2
1063070,True,0,2 user reviews,2,0,2
1063080,True,0,6 user reviews,6,0,6
1063100,True,0,No user reviews,0,0,0
1063110,True,0,5 user reviews,5,0,5
1063120,True,7,Positive,10,0,10
1063130,True,7,Positive,26,6,32
1063140,True,0,No user reviews,0,0,0
1063160,True,0,No user reviews,0,0,0
1063170,True,0,No user reviews,0,0,0
1063180,True,0,No user reviews,0,0,0
1063190,True,0,No user reviews,0,0,0
1063200,True,0,No user reviews,0,0,0
1063210,True,0,No user reviews,0,0,0
1063220,True,0,1 user reviews,1,0,1
1063230,True,0,6 user reviews,1,5,6
1063240,True,5,Mixed,9,4,13
1063270,True,0,1 user reviews,1,0,1
1063280,True,0,2 user reviews,0,2,2
1063300,True,0,2 user reviews,2,0,2
1063310,True,8,Very Positive,46,11,57
1063330,True,0,No user reviews,0,0,0
1063340,True,0,No user reviews,0,0,0
1063350,True,0,3 user reviews,3,0,3
1063360,True,0,1 user reviews,1,0,1
1063380,True,5,Mixed,6,4,10
1063400,True,0,No user reviews,0,0,0
1063430,True,0,2 user reviews,1,1,2
1063440,True,4,Mostly Negative,5,14,19
1063450,True,4,Mostly Negative,10,21,31
1063470,True,0,4 user reviews,2,2,4
1063480,True,0,No user reviews,0,0,0
1063490,True,8,Very Positive,161,23,184
1063500,True,0,1 user reviews,0,1,1
1063510,True,0,No user reviews,0,0,0
1063520,True,0,3 user reviews,2,1,3
1063530,True,0,No user reviews,0,0,0
1063540,True,0,No user reviews,0,0,0
1063560,True,5,Mixed,7,6,13
1063570,True,0,No user reviews,0,0,0
1063580,True,8,Very Positive,72,10,82
1063700,True,0,No user reviews,0,0,0
1063710,True,0,2 user reviews,2,0,2
1063730,True,0,No user reviews,0,0,0
1063740,True,0,No user reviews,0,0,0
1063770,True,0,No user reviews,0,0,0
1063780,True,0,No user reviews,0,0,0
1063781,True,0,No user reviews,0,0,0
1063790,True,8,Very Positive,69,13,82
1063800,True,0,2 user reviews,1,1,2
1063820,True,0,No user reviews,0,0,0
1063830,True,7,Positive,20,3,23
1063850,True,0,8 user reviews,6,2,8
1063860,True,0,9 user reviews,7,2,9
1063870,True,0,2 user reviews,2,0,2
1063880,True,0,No user reviews,0,0,0
1063890,True,6,Mostly Positive,19,8,27
1063910,True,0,No user reviews,0,0,0
1063920,True,0,No user reviews,0,0,0
1063921,True,0,No user reviews,0,0,0
1063922,True,0,No user reviews,0,0,0
1063923,True,0,No user reviews,0,0,0
1063930,True,5,Mixed,9,12,21
1063940,True,0,No user reviews,0,0,0
1063950,True,0,No user reviews,0,0,0
1063960,True,0,4 user reviews,4,0,4
1063970,True,0,No user reviews,0,0,0
1063980,True,0,No user reviews,0,0,0
1063990,True,0,No user reviews,0,0,0
1064000,True,0,No user reviews,0,0,0
1064010,True,7,Positive,19,3,22
1064020,True,0,No user reviews,0,0,0
1064030,True,0,No user reviews,0,0,0
1064040,True,0,No user reviews,0,0,0
1064050,True,0,2 user reviews,2,0,2
1064060,True,5,Mixed,16,13,29
1064070,True,0,No user reviews,0,0,0
1064080,True,0,9 user reviews,8,1,9
1064090,True,7,Positive,8,2,10
1064100,True,0,No user reviews,0,0,0
1064120,True,0,No user reviews,0,0,0
1064130,True,7,Positive,21,1,22
1064140,True,0,No user reviews,0,0,0
1064150,True,0,No user reviews,0,0,0
1064160,True,5,Mixed,19,12,31
1064170,True,0,No user reviews,0,0,0
1064190,True,0,No user reviews,0,0,0
1064191,True,0,1 user reviews,0,1,1
1064192,True,0,No user reviews,0,0,0
1064200,True,7,Positive,18,1,19
1064210,True,0,No user reviews,0,0,0
1064211,True,0,No user reviews,0,0,0
1064212,True,0,No user reviews,0,0,0
1064213,True,0,No user reviews,0,0,0
1064214,True,0,No user reviews,0,0,0
1064215,True,0,No user reviews,0,0,0
1064216,True,0,No user reviews,0,0,0
1064217,True,0,No user reviews,0,0,0
1064218,True,0,No user reviews,0,0,0
1064219,True,0,No user reviews,0,0,0
1064220,True,6,Mostly Positive,2356,757,3113
1064221,True,5,Mixed,580,275,855
1064230,True,0,No user reviews,0,0,0
1064240,True,0,No user reviews,0,0,0
1064260,True,0,No user reviews,0,0,0
1064270,True,6,Mostly Positive,506,184,690
1064271,True,8,Very Positive,1068,134,1202
1064272,True,8,Very Positive,274,41,315
1064273,True,0,No user reviews,0,0,0
1064310,True,5,Mixed,20,10,30
1064320,True,0,8 user reviews,8,0,8
1064360,True,0,No user reviews,0,0,0
1064420,True,0,No user reviews,0,0,0
1064440,True,0,1 user reviews,1,0,1
1064450,True,0,1 user reviews,1,0,1
1064460,True,8,Very Positive,161,13,174
1064470,True,0,No user reviews,0,0,0
1064480,True,0,1 user reviews,1,0,1
1064490,True,0,No user reviews,0,0,0
1064500,True,0,No user reviews,0,0,0
1064520,True,0,No user reviews,0,0,0
1064540,True,0,6 user reviews,5,1,6
1064550,True,0,No user reviews,0,0,0
1064560,True,0,No user reviews,0,0,0
1064570,True,0,No user reviews,0,0,0
1064580,True,0,9 user reviews,9,0,9
1064590,True,0,9 user reviews,9,0,9
1064600,True,0,No user reviews,0,0,0
1064610,True,8,Very Positive,59,1,60
1064620,True,0,1 user reviews,1,0,1
1064630,True,0,No user reviews,0,0,0
1064650,True,0,2 user reviews,1,1,2
1064660,True,6,Mostly Positive,59,17,76
1064670,True,0,No user reviews,0,0,0
1064690,True,7,Positive,20,0,20
1064710,True,0,1 user reviews,1,0,1
1064720,True,0,3 user reviews,3,0,3
1064730,True,8,Very Positive,160,30,190
1064740,True,0,No user reviews,0,0,0
1064750,True,0,No user reviews,0,0,0
1064760,True,0,No user reviews,0,0,0
1064780,True,0,No user reviews,0,0,0
1064800,True,0,8 user reviews,6,2,8
1064810,True,0,1 user reviews,1,0,1
1064820,True,5,Mixed,9,4,13
1064830,True,0,No user reviews,0,0,0
1064840,True,6,Mostly Positive,19,6,25
1064860,True,0,7 user reviews,3,4,7
1064900,True,0,8 user reviews,8,0,8
1064910,True,0,5 user reviews,5,0,5
1064920,True,0,No user reviews,0,0,0
1064950,True,0,No user reviews,0,0,0
1064960,True,0,No user reviews,0,0,0
1064970,True,0,7 user reviews,6,1,7
1064980,True,0,No user reviews,0,0,0
1064981,True,0,No user reviews,0,0,0
1064990,True,0,4 user reviews,1,3,4
1065020,True,8,Very Positive,102,5,107
1065030,True,0,No user reviews,0,0,0
1065050,True,0,No user reviews,0,0,0
1065070,True,0,No user reviews,0,0,0
1065100,True,8,Very Positive,234,8,242
1065110,True,0,No user reviews,0,0,0
1065140,True,0,3 user reviews,3,0,3
1065150,True,0,No user reviews,0,0,0
1065160,True,0,3 user reviews,1,2,3
1065180,True,7,Positive,41,3,44
1065200,True,0,1 user reviews,1,0,1
1065210,True,5,Mixed,5,7,12
1065220,True,0,3 user reviews,3,0,3
1065221,True,0,1 user reviews,0,1,1
1065230,True,0,2 user reviews,2,0,2
1065240,True,0,No user reviews,0,0,0
1065250,True,0,1 user reviews,1,0,1
1065260,True,8,Very Positive,73,7,80
1065280,True,0,No user reviews,0,0,0
1065290,True,0,No user reviews,0,0,0
1065300,True,0,No user reviews,0,0,0
1065320,True,0,No user reviews,0,0,0
1065330,True,0,No user reviews,0,0,0
1065350,True,0,No user reviews,0,0,0
1065370,True,0,No user reviews,0,0,0
1065380,True,5,Mixed,23,12,35
1065390,True,0,No user reviews,0,0,0
1065410,True,0,5 user reviews,5,0,5
1065460,True,7,Positive,13,0,13
1065490,True,6,Mostly Positive,12,4,16
1065491,True,5,Mixed,9,4,13
1065510,True,0,No user reviews,0,0,0
1065520,True,0,No user reviews,0,0,0
1065540,True,0,No user reviews,0,0,0
1065550,True,0,No user reviews,0,0,0
1065560,True,0,No user reviews,0,0,0
1065570,True,5,Mixed,11,8,19
1065580,True,5,Mixed,19,9,28
1065600,True,0,No user reviews,0,0,0
1065620,True,0,No user reviews,0,0,0
1065621,True,0,No user reviews,0,0,0
1065622,True,0,No user reviews,0,0,0
1065623,True,0,No user reviews,0,0,0
1065624,True,0,No user reviews,0,0,0
1065625,True,0,No user reviews,0,0,0
1065630,True,0,No user reviews,0,0,0
1065650,True,0,No user reviews,0,0,0
1065660,True,0,No user reviews,0,0,0
1065670,True,0,No user reviews,0,0,0
1065680,True,0,No user reviews,0,0,0
1065690,True,0,No user reviews,0,0,0
1065710,True,7,Positive,41,3,44
1065730,True,0,4 user reviews,4,0,4
1065740,True,0,No user reviews,0,0,0
1065750,True,0,No user reviews,0,0,0
1065770,True,0,1 user reviews,0,1,1
1065780,True,0,No user reviews,0,0,0
1065790,True,0,No user reviews,0,0,0
1065800,True,0,No user reviews,0,0,0
1065810,True,0,1 user reviews,1,0,1
1065820,True,0,No user reviews,0,0,0
1065830,True,0,4 user reviews,2,2,4
1065850,True,7,Positive,17,0,17
1065860,True,0,No user reviews,0,0,0
1065870,True,0,1 user reviews,1,0,1
1065880,True,8,Very Positive,68,0,68
1065890,True,0,4 user reviews,3,1,4
1065900,True,0,No user reviews,0,0,0
1065910,True,0,No user reviews,0,0,0
1065920,True,0,1 user reviews,1,0,1
1065930,True,0,No user reviews,0,0,0
1065940,True,5,Mixed,9,7,16
1065950,True,0,9 user reviews,6,3,9
1065960,True,0,3 user reviews,2,1,3
1065970,True,8,Very Positive,170,30,200
1065990,True,0,No user reviews,0,0,0
1066010,True,0,2 user reviews,2,0,2
1066030,True,0,5 user reviews,5,0,5
1066040,True,7,Positive,13,0,13
1066050,True,0,No user reviews,0,0,0
1066060,True,0,No user reviews,0,0,0
1066090,True,0,2 user reviews,2,0,2
1066100,True,0,No user reviews,0,0,0
1066101,True,0,No user reviews,0,0,0
1066110,True,0,8 user reviews,5,3,8
1066120,True,0,No user reviews,0,0,0
1066121,True,0,No user reviews,0,0,0
1066122,True,0,No user reviews,0,0,0
1066130,True,0,9 user reviews,4,5,9
1066140,True,6,Mostly Positive,30,10,40
1066150,True,0,7 user reviews,4,3,7
1066160,True,0,6 user reviews,3,3,6
1066180,True,8,Very Positive,63,11,74
1066190,True,5,Mixed,22,16,38
1066200,True,0,No user reviews,0,0,0
1066210,True,0,4 user reviews,2,2,4
1066220,True,0,6 user reviews,3,3,6
1066230,True,0,No user reviews,0,0,0
1066240,True,7,Positive,12,3,15
1066250,True,0,No user reviews,0,0,0
1066260,True,8,Very Positive,574,43,617
1066270,True,0,No user reviews,0,0,0
1066280,True,0,1 user reviews,1,0,1
1066290,True,0,1 user reviews,1,0,1
1066300,True,7,Positive,16,0,16
1066310,True,0,No user reviews,0,0,0
1066320,True,0,1 user reviews,1,0,1
1066330,True,0,No user reviews,0,0,0
1066340,True,0,No user reviews,0,0,0
1066350,True,0,No user reviews,0,0,0
1066370,True,0,No user reviews,0,0,0
1066380,True,0,No user reviews,0,0,0
1066390,True,0,No user reviews,0,0,0
1066400,True,0,No user reviews,0,0,0
1066420,True,0,No user reviews,0,0,0
1066430,True,0,6 user reviews,6,0,6
1066440,True,0,1 user reviews,0,1,1
1066460,True,0,No user reviews,0,0,0
1066490,True,0,No user reviews,0,0,0
1066530,True,0,No user reviews,0,0,0
1066540,True,0,No user reviews,0,0,0
1066560,True,0,No user reviews,0,0,0
1066570,True,0,No user reviews,0,0,0
1066580,True,0,No user reviews,0,0,0
1066590,True,0,No user reviews,0,0,0
1066600,True,5,Mixed,7,8,15
1066610,True,0,No user reviews,0,0,0
1066620,True,0,No user reviews,0,0,0
1066630,True,7,Positive,12,1,13
1066640,True,0,No user reviews,0,0,0
1066660,True,0,No user reviews,0,0,0
1066670,True,0,5 user reviews,4,1,5
1066700,True,0,1 user reviews,1,0,1
1066710,True,0,No user reviews,0,0,0
1066730,True,0,1 user reviews,0,1,1
1066740,True,0,No user reviews,0,0,0
1066760,True,0,No user reviews,0,0,0
1066780,True,8,Very Positive,2513,462,2975
1066810,True,0,7 user reviews,7,0,7
1066830,True,0,1 user reviews,1,0,1
1066840,True,0,1 user reviews,0,1,1
1066851,True,0,No user reviews,0,0,0
1066853,True,0,No user reviews,0,0,0
1066860,True,0,2 user reviews,1,1,2
1066890,True,8,Very Positive,692,119,811
1066900,True,0,No user reviews,0,0,0
1066920,True,0,1 user reviews,0,1,1
1066930,True,0,No user reviews,0,0,0
1066940,True,7,Positive,14,1,15
1066950,True,0,6 user reviews,6,0,6
1067010,True,0,2 user reviews,2,0,2
1067020,True,8,Very Positive,64,4,68
1067030,True,0,No user reviews,0,0,0
1067040,True,0,1 user reviews,0,1,1
1067050,True,0,1 user reviews,1,0,1
1067060,True,0,2 user reviews,1,1,2
1067080,True,0,6 user reviews,6,0,6
1067100,True,0,1 user reviews,1,0,1
1067110,True,0,No user reviews,0,0,0
1067120,True,0,No user reviews,0,0,0
1067130,True,0,No user reviews,0,0,0
1067150,True,0,4 user reviews,4,0,4
1067160,True,0,No user reviews,0,0,0
1067170,True,0,No user reviews,0,0,0
1067200,True,0,No user reviews,0,0,0
1067210,True,0,No user reviews,0,0,0
1067220,True,0,No user reviews,0,0,0
1067230,True,0,No user reviews,0,0,0
1067240,True,0,No user reviews,0,0,0
1067250,True,0,1 user reviews,0,1,1
1067270,True,0,No user reviews,0,0,0
1067280,True,0,No user reviews,0,0,0
1067310,True,0,No user reviews,0,0,0
1067320,True,0,No user reviews,0,0,0
1067340,True,0,1 user reviews,1,0,1
1067350,True,7,Positive,26,1,27
1067360,True,0,No user reviews,0,0,0
1067370,True,0,1 user reviews,1,0,1
1067380,True,0,No user reviews,0,0,0
1067390,True,0,4 user reviews,4,0,4
1067400,True,0,8 user reviews,7,1,8
1067410,True,0,No user reviews,0,0,0
1067430,True,7,Positive,11,1,12
1067440,True,0,1 user reviews,1,0,1
1067450,True,0,2 user reviews,1,1,2
1067460,True,0,2 user reviews,0,2,2
1067471,True,0,No user reviews,0,0,0
1067476,True,0,1 user reviews,1,0,1
1067520,True,0,2 user reviews,1,1,2
1067530,True,0,No user reviews,0,0,0
1067540,True,8,Very Positive,127,5,132
1067560,True,0,5 user reviews,1,4,5
1067580,True,6,Mostly Positive,10,3,13
1067590,True,6,Mostly Positive,17,5,22
1067600,True,0,No user reviews,0,0,0
1067630,True,0,5 user reviews,4,1,5
1067650,True,0,4 user reviews,2,2,4
1067660,True,0,No user reviews,0,0,0
1067680,True,0,No user reviews,0,0,0
1067690,True,8,Very Positive,175,7,182
1067710,True,0,No user reviews,0,0,0
1067720,True,7,Positive,32,2,34
1067730,True,0,1 user reviews,0,1,1
1067750,True,7,Positive,19,0,19
1067760,True,0,No user reviews,0,0,0
1067770,True,0,8 user reviews,8,0,8
1067780,True,0,No user reviews,0,0,0
1067800,True,0,No user reviews,0,0,0
1067810,True,0,4 user reviews,3,1,4
1067830,True,0,1 user reviews,1,0,1
1067850,True,9,Overwhelmingly Positive,905,29,934
1067860,True,8,Very Positive,97,16,113
1067900,True,0,No user reviews,0,0,0
1067910,True,0,No user reviews,0,0,0
1067920,True,0,No user reviews,0,0,0
1067921,True,0,No user reviews,0,0,0
1067930,True,0,No user reviews,0,0,0
1067980,True,0,No user reviews,0,0,0
1067990,True,0,No user reviews,0,0,0
1068000,True,0,No user reviews,0,0,0
1068020,True,0,No user reviews,0,0,0
1068050,True,0,No user reviews,0,0,0
1068070,True,0,No user reviews,0,0,0
1068100,True,0,1 user reviews,0,1,1
1068110,True,0,1 user reviews,1,0,1
1068120,True,0,No user reviews,0,0,0
1068130,True,0,1 user reviews,0,1,1
1068150,True,5,Mixed,33,34,67
1068160,True,0,No user reviews,0,0,0
1068190,True,0,No user reviews,0,0,0
1068210,True,0,5 user reviews,3,2,5
1068220,True,0,No user reviews,0,0,0
1068230,True,0,2 user reviews,0,2,2
1068260,True,6,Mostly Positive,12,4,16
1068290,True,8,Very Positive,121,0,121
1068300,True,0,No user reviews,0,0,0
1068310,True,0,No user reviews,0,0,0
1068320,True,0,No user reviews,0,0,0
1068330,True,0,No user reviews,0,0,0
1068340,True,0,2 user reviews,1,1,2
1068360,True,0,No user reviews,0,0,0
1068400,True,0,8 user reviews,8,0,8
1068420,True,0,No user reviews,0,0,0
1068480,True,0,8 user reviews,7,1,8
1068490,True,0,2 user reviews,1,1,2
1068510,True,0,No user reviews,0,0,0
1068520,True,0,No user reviews,0,0,0
1068530,True,5,Mixed,21,23,44
1068540,True,0,1 user reviews,1,0,1
1068550,True,0,No user reviews,0,0,0
1068560,True,0,No user reviews,0,0,0
1068570,True,0,No user reviews,0,0,0
1068580,True,0,No user reviews,0,0,0
1068600,True,0,7 user reviews,5,2,7
1068610,True,0,No user reviews,0,0,0
1068620,True,0,No user reviews,0,0,0
1068640,True,6,Mostly Positive,106,42,148
1068650,True,0,No user reviews,0,0,0
1068680,True,0,5 user reviews,5,0,5
1068700,True,0,3 user reviews,2,1,3
1068710,True,0,1 user reviews,1,0,1
1068760,True,0,No user reviews,0,0,0
1068770,True,0,2 user reviews,1,1,2
1068800,True,0,5 user reviews,4,1,5
1068810,True,0,1 user reviews,1,0,1
1068820,True,8,Very Positive,502,42,544
1068830,True,0,No user reviews,0,0,0
1068840,True,0,No user reviews,0,0,0
1068860,True,0,No user reviews,0,0,0
1068890,True,0,No user reviews,0,0,0
1068900,True,0,No user reviews,0,0,0
1068910,True,0,2 user reviews,2,0,2
1068970,True,0,No user reviews,0,0,0
1068980,True,0,No user reviews,0,0,0
1068990,True,0,2 user reviews,2,0,2
1069000,True,0,No user reviews,0,0,0
1069030,True,8,Very Positive,112,8,120
1069050,True,5,Mixed,9,6,15
1069070,True,0,No user reviews,0,0,0
1069080,True,0,No user reviews,0,0,0
1069090,True,0,No user reviews,0,0,0
1069100,True,0,No user reviews,0,0,0
1069120,True,0,No user reviews,0,0,0
1069130,True,0,No user reviews,0,0,0
1069140,True,0,8 user reviews,7,1,8
1069180,True,0,No user reviews,0,0,0
1069190,True,0,No user reviews,0,0,0
1069200,True,0,No user reviews,0,0,0
1069210,True,7,Positive,22,5,27
1069220,True,0,No user reviews,0,0,0
1069230,True,0,7 user reviews,7,0,7
1069250,True,0,3 user reviews,1,2,3
1069270,True,7,Positive,9,1,10
1069290,True,0,No user reviews,0,0,0
1069300,True,0,No user reviews,0,0,0
1069310,True,0,No user reviews,0,0,0
1069330,True,0,No user reviews,0,0,0
1069340,True,0,No user reviews,0,0,0
1069360,True,0,No user reviews,0,0,0
1069380,True,0,No user reviews,0,0,0
1069390,True,7,Positive,39,7,46
1069410,True,0,No user reviews,0,0,0
1069430,True,0,1 user reviews,0,1,1
1069450,True,0,1 user reviews,1,0,1
1069460,True,0,5 user reviews,4,1,5
1069470,True,0,9 user reviews,7,2,9
1069480,True,7,Positive,10,1,11
1069490,True,0,3 user reviews,3,0,3
1069500,True,0,1 user reviews,0,1,1
1069520,True,0,No user reviews,0,0,0
1069540,True,0,4 user reviews,2,2,4
1069550,True,0,No user reviews,0,0,0
1069552,True,0,No user reviews,0,0,0
1069580,True,5,Mixed,42,26,68
1069581,True,0,1 user reviews,1,0,1
1069590,True,0,No user reviews,0,0,0
1069600,True,0,3 user reviews,2,1,3
1069610,True,0,7 user reviews,6,1,7
1069620,True,0,No user reviews,0,0,0
1069630,True,0,No user reviews,0,0,0
1069640,True,6,Mostly Positive,619,198,817
1069650,True,6,Mostly Positive,255,89,344
1069660,True,0,No user reviews,0,0,0
1069670,True,0,No user reviews,0,0,0
1069690,True,0,No user reviews,0,0,0
1069710,True,0,No user reviews,0,0,0
1069720,True,0,No user reviews,0,0,0
1069730,True,0,5 user reviews,4,1,5
1069740,True,8,Very Positive,318,29,347
1069750,True,0,7 user reviews,7,0,7
1069760,True,8,Very Positive,213,12,225
1069770,True,0,No user reviews,0,0,0
1069790,True,0,No user reviews,0,0,0
1069810,True,0,No user reviews,0,0,0
1069820,True,0,9 user reviews,6,3,9
1069830,True,0,No user reviews,0,0,0
1069840,True,0,1 user reviews,1,0,1
1069850,True,7,Positive,17,2,19
1069900,True,5,Mixed,6,8,14
1069910,True,5,Mixed,8,5,13
1069920,True,0,1 user reviews,1,0,1
1069940,True,0,No user reviews,0,0,0
1069950,True,0,No user reviews,0,0,0
1069960,True,0,No user reviews,0,0,0
1069970,True,0,3 user reviews,3,0,3
1069980,True,0,No user reviews,0,0,0
1069990,True,0,4 user reviews,4,0,4
1070000,True,0,No user reviews,0,0,0
1070020,True,0,No user reviews,0,0,0
1070030,True,0,1 user reviews,1,0,1
1070040,True,0,No user reviews,0,0,0
1070050,True,0,No user reviews,0,0,0
1070051,True,0,No user reviews,0,0,0
1070052,True,0,1 user reviews,1,0,1
1070053,True,0,1 user reviews,1,0,1
1070054,True,0,No user reviews,0,0,0
1070055,True,0,No user reviews,0,0,0
1070056,True,0,No user reviews,0,0,0
1070057,True,0,No user reviews,0,0,0
1070058,True,0,No user reviews,0,0,0
1070059,True,0,No user reviews,0,0,0
1070060,True,0,No user reviews,0,0,0
1070100,True,0,No user reviews,0,0,0
1070110,True,0,4 user reviews,4,0,4
1070120,True,0,No user reviews,0,0,0
1070121,True,0,1 user reviews,1,0,1
1070122,True,0,No user reviews,0,0,0
1070123,True,0,No user reviews,0,0,0
1070130,True,0,No user reviews,0,0,0
1070131,True,0,No user reviews,0,0,0
1070132,True,0,No user reviews,0,0,0
1070140,True,0,No user reviews,0,0,0
1070141,True,0,No user reviews,0,0,0
1070142,True,0,No user reviews,0,0,0
1070150,True,8,Very Positive,63,3,66
1070160,True,0,1 user reviews,1,0,1
1070170,True,0,No user reviews,0,0,0
1070180,True,0,No user reviews,0,0,0
1070190,True,6,Mostly Positive,14,6,20
1070220,True,0,8 user reviews,6,2,8
1070230,True,0,4 user reviews,3,1,4
1070240,True,0,6 user reviews,1,5,6
1070250,True,0,9 user reviews,9,0,9
1070260,True,0,No user reviews,0,0,0
1070270,True,0,No user reviews,0,0,0
1070280,True,0,5 user reviews,2,3,5
1070300,True,0,3 user reviews,2,1,3
1070320,True,0,8 user reviews,6,2,8
1070330,True,8,Very Positive,528,44,572
1070350,True,0,2 user reviews,2,0,2
1070370,True,0,No user reviews,0,0,0
1070390,True,0,No user reviews,0,0,0
1070400,True,0,No user reviews,0,0,0
1070410,True,7,Positive,11,2,13
1070420,True,0,No user reviews,0,0,0
1070430,True,0,No user reviews,0,0,0
1070440,True,0,4 user reviews,4,0,4
1070450,True,0,1 user reviews,0,1,1
1070460,True,0,1 user reviews,1,0,1
1070510,True,7,Positive,15,0,15
1070520,True,0,No user reviews,0,0,0
1070550,True,8,Very Positive,60,0,60
1070580,True,8,Very Positive,869,76,945
1070590,True,0,No user reviews,0,0,0
1070600,True,0,1 user reviews,1,0,1
1070601,True,0,1 user reviews,1,0,1
1070602,True,0,2 user reviews,2,0,2
1070603,True,0,1 user reviews,1,0,1
1070604,True,0,No user reviews,0,0,0
1070605,True,0,No user reviews,0,0,0
1070606,True,0,No user reviews,0,0,0
1070660,True,0,No user reviews,0,0,0
1070661,True,0,No user reviews,0,0,0
1070662,True,0,No user reviews,0,0,0
1070663,True,0,No user reviews,0,0,0
1070664,True,0,No user reviews,0,0,0
1070690,True,6,Mostly Positive,21,8,29
1070700,True,0,No user reviews,0,0,0
1070701,True,0,No user reviews,0,0,0
1070702,True,0,No user reviews,0,0,0
1070703,True,0,No user reviews,0,0,0
1070704,True,0,No user reviews,0,0,0
1070705,True,0,No user reviews,0,0,0
1070706,True,0,No user reviews,0,0,0
1070707,True,0,No user reviews,0,0,0
1070710,True,9,Overwhelmingly Positive,3298,45,3343
1070720,True,0,No user reviews,0,0,0
1070770,True,0,2 user reviews,1,1,2
1070780,True,7,Positive,33,2,35
1070790,True,0,No user reviews,0,0,0
1070800,True,0,No user reviews,0,0,0
1070820,True,6,Mostly Positive,60,20,80
1070840,True,0,No user reviews,0,0,0
1070850,True,0,No user reviews,0,0,0
1070860,True,8,Very Positive,87,13,100
1070890,True,0,4 user reviews,3,1,4
1070910,True,0,No user reviews,0,0,0
1070940,True,6,Mostly Positive,58,18,76
1070950,True,0,No user reviews,0,0,0
1070960,True,0,1 user reviews,0,1,1
1070980,True,0,1 user reviews,1,0,1
1070990,True,0,3 user reviews,3,0,3
1071030,True,0,1 user reviews,0,1,1
1071050,True,0,No user reviews,0,0,0
1071051,True,0,No user reviews,0,0,0
1071060,True,0,5 user reviews,4,1,5
1071070,True,0,No user reviews,0,0,0
1071080,True,0,No user reviews,0,0,0
1071090,True,0,No user reviews,0,0,0
1071100,True,8,Very Positive,90,7,97
1071110,True,0,No user reviews,0,0,0
1071120,True,0,No user reviews,0,0,0
1071130,True,8,Very Positive,163,2,165
1071140,True,0,No user reviews,0,0,0
1071170,True,0,3 user reviews,2,1,3
1071180,True,0,No user reviews,0,0,0
1071190,True,7,Positive,12,0,12
1071200,True,5,Mixed,77,39,116
1071210,True,0,1 user reviews,1,0,1
1071220,True,0,No user reviews,0,0,0
1071230,True,0,No user reviews,0,0,0
1071240,True,0,No user reviews,0,0,0
1071260,True,0,5 user reviews,5,0,5
1071280,True,7,Positive,19,0,19
1071290,True,8,Very Positive,131,29,160
1071310,True,0,No user reviews,0,0,0
1071320,True,0,No user reviews,0,0,0
1071330,True,7,Positive,40,4,44
1071340,True,0,No user reviews,0,0,0
1071350,True,0,4 user reviews,3,1,4
1071371,True,0,No user reviews,0,0,0
1071372,True,0,No user reviews,0,0,0
1071373,True,0,2 user reviews,2,0,2
1071374,True,0,No user reviews,0,0,0
1071375,True,0,No user reviews,0,0,0
1071376,True,0,No user reviews,0,0,0
1071377,True,0,1 user reviews,1,0,1
1071378,True,0,No user reviews,0,0,0
1071379,True,0,1 user reviews,1,0,1
1071380,True,0,No user reviews,0,0,0
1071390,True,0,No user reviews,0,0,0
1071391,True,0,1 user reviews,1,0,1
1071392,True,0,1 user reviews,0,1,1
1071393,True,0,No user reviews,0,0,0
1071394,True,0,No user reviews,0,0,0
1071395,True,0,No user reviews,0,0,0
1071396,True,0,No user reviews,0,0,0
1071420,True,0,No user reviews,0,0,0
1071430,True,0,No user reviews,0,0,0
1071440,True,0,No user reviews,0,0,0
1071450,True,0,No user reviews,0,0,0
1071460,True,0,3 user reviews,3,0,3
1071470,True,0,No user reviews,0,0,0
1071480,True,0,No user reviews,0,0,0
1071490,True,0,8 user reviews,6,2,8
1071500,True,0,2 user reviews,1,1,2
1071510,True,7,Positive,28,3,31
1071540,True,0,No user reviews,0,0,0
1071550,True,0,No user reviews,0,0,0
1071560,True,0,No user reviews,0,0,0
1071580,True,0,1 user reviews,1,0,1
1071600,True,0,No user reviews,0,0,0
1071610,True,0,No user reviews,0,0,0
1071630,True,0,No user reviews,0,0,0
1071640,True,0,No user reviews,0,0,0
1071650,True,0,No user reviews,0,0,0
1071660,True,7,Positive,10,0,10
1071670,True,0,5 user reviews,1,4,5
1071680,True,8,Very Positive,51,10,61
1071690,True,0,No user reviews,0,0,0
1071700,True,0,No user reviews,0,0,0
1071740,True,0,No user reviews,0,0,0
1071750,True,0,No user reviews,0,0,0
1071760,True,0,1 user reviews,1,0,1
1071770,True,0,6 user reviews,4,2,6
1071780,True,0,No user reviews,0,0,0
1071800,True,0,No user reviews,0,0,0
1071810,True,0,7 user reviews,4,3,7
1071820,True,0,No user reviews,0,0,0
1071830,True,0,No user reviews,0,0,0
1071860,True,0,2 user reviews,2,0,2
1071870,True,8,Very Positive,349,30,379
1071880,True,0,No user reviews,0,0,0
1071890,True,0,No user reviews,0,0,0
1071900,True,0,No user reviews,0,0,0
1071920,True,0,3 user reviews,3,0,3
1071930,True,0,No user reviews,0,0,0
1071940,True,5,Mixed,24,15,39
1071950,True,0,No user reviews,0,0,0
1071960,True,0,No user reviews,0,0,0
1071970,True,0,1 user reviews,1,0,1
1071980,True,0,No user reviews,0,0,0
1071990,True,0,No user reviews,0,0,0
1072000,True,0,No user reviews,0,0,0
1072020,True,7,Positive,11,1,12
1072030,True,0,1 user reviews,1,0,1
1072040,True,6,Mostly Positive,545,145,690
1072050,True,0,1 user reviews,0,1,1
1072070,True,0,No user reviews,0,0,0
1072080,True,0,No user reviews,0,0,0
1072100,True,6,Mostly Positive,44,12,56
1072110,True,0,No user reviews,0,0,0
1072120,True,8,Very Positive,58,6,64
1072130,True,0,No user reviews,0,0,0
1072140,True,0,No user reviews,0,0,0
1072150,True,8,Very Positive,491,30,521
1072170,True,0,No user reviews,0,0,0
1072180,True,0,2 user reviews,2,0,2
1072200,True,0,No user reviews,0,0,0
1072210,True,0,No user reviews,0,0,0
1072220,True,0,No user reviews,0,0,0
1072221,True,0,No user reviews,0,0,0
1072222,True,0,No user reviews,0,0,0
1072230,True,0,No user reviews,0,0,0
1072250,True,0,No user reviews,0,0,0
1072260,True,0,No user reviews,0,0,0
1072270,True,6,Mostly Positive,8,3,11
1072280,True,0,2 user reviews,2,0,2
1072300,True,0,No user reviews,0,0,0
1072310,True,0,7 user reviews,5,2,7
1072340,True,0,No user reviews,0,0,0
1072350,True,0,5 user reviews,5,0,5
1072360,True,0,No user reviews,0,0,0
1072390,True,0,No user reviews,0,0,0
1072400,True,0,No user reviews,0,0,0
1072420,True,8,Very Positive,621,56,677
1072450,True,0,6 user reviews,4,2,6
1072460,True,0,No user reviews,0,0,0
1072480,True,5,Mixed,93,66,159
1072490,True,0,No user reviews,0,0,0
1072500,True,5,Mixed,91,42,133
1072520,True,0,No user reviews,0,0,0
1072530,True,0,No user reviews,0,0,0
1072550,True,0,No user reviews,0,0,0
1072560,True,0,No user reviews,0,0,0
1072561,True,7,Positive,12,0,12
1072562,True,8,Very Positive,152,17,169
1072590,True,7,Positive,13,2,15
1072600,True,0,No user reviews,0,0,0
1072610,True,7,Positive,11,1,12
1072620,True,5,Mixed,6,7,13
1072630,True,0,No user reviews,0,0,0
1072640,True,8,Very Positive,55,1,56
1072660,True,0,6 user reviews,0,6,6
1072670,True,0,No user reviews,0,0,0
1072680,True,0,4 user reviews,4,0,4
1072681,True,0,2 user reviews,2,0,2
1072690,True,0,No user reviews,0,0,0
1072710,True,8,Very Positive,108,5,113
1072720,True,0,1 user reviews,1,0,1
1072750,True,0,No user reviews,0,0,0
1072760,True,0,2 user reviews,2,0,2
1072790,True,0,No user reviews,0,0,0
1072800,True,0,6 user reviews,6,0,6
1072810,True,0,No user reviews,0,0,0
1072840,True,0,No user reviews,0,0,0
1072850,True,0,1 user reviews,0,1,1
1072860,True,7,Positive,13,1,14
1072870,True,0,7 user reviews,7,0,7
1072890,True,0,No user reviews,0,0,0
1072910,True,0,No user reviews,0,0,0
1072920,True,0,5 user reviews,2,3,5
1072930,True,0,No user reviews,0,0,0
1072950,True,6,Mostly Positive,10,3,13
1072970,True,0,No user reviews,0,0,0
1072980,True,0,No user reviews,0,0,0
1073000,True,0,No user reviews,0,0,0
1073020,True,0,No user reviews,0,0,0
1073040,True,0,1 user reviews,0,1,1
1073050,True,0,2 user reviews,1,1,2
1073060,True,0,No user reviews,0,0,0
1073070,True,0,No user reviews,0,0,0
1073080,True,0,2 user reviews,1,1,2
1073090,True,0,No user reviews,0,0,0
1073100,True,0,4 user reviews,4,0,4
1073110,True,0,No user reviews,0,0,0
1073130,True,0,1 user reviews,0,1,1
1073140,True,0,2 user reviews,1,1,2
1073160,True,0,No user reviews,0,0,0
1073180,True,0,No user reviews,0,0,0
1073210,True,5,Mixed,6,7,13
1073220,True,7,Positive,39,3,42
1073230,True,0,3 user reviews,2,1,3
1073260,True,0,No user reviews,0,0,0
1073280,True,0,8 user reviews,6,2,8
1073290,True,0,No user reviews,0,0,0
1073310,True,7,Positive,18,1,19
1073320,True,8,Very Positive,176,3,179
1073350,True,0,No user reviews,0,0,0
1073370,True,0,3 user reviews,2,1,3
1073380,True,0,No user reviews,0,0,0
1073390,True,0,No user reviews,0,0,0
1073400,True,0,No user reviews,0,0,0
1073410,True,0,9 user reviews,6,3,9
1073420,True,0,No user reviews,0,0,0
1073440,True,9,Overwhelmingly Positive,1290,66,1356
1073450,True,0,No user reviews,0,0,0
1073490,True,7,Positive,14,3,17
1073600,True,0,No user reviews,0,0,0
1073610,True,0,4 user reviews,4,0,4
1073620,True,0,No user reviews,0,0,0
1073630,True,0,2 user reviews,2,0,2
1073640,True,0,No user reviews,0,0,0
1073650,True,0,No user reviews,0,0,0
1073660,True,0,1 user reviews,1,0,1
1073680,True,0,No user reviews,0,0,0
1073681,True,0,No user reviews,0,0,0
1073710,True,0,1 user reviews,1,0,1
1073720,True,0,4 user reviews,3,1,4
1073730,True,0,No user reviews,0,0,0
1073740,True,0,No user reviews,0,0,0
1073750,True,0,No user reviews,0,0,0
1073770,True,7,Positive,14,2,16
1073780,True,0,No user reviews,0,0,0
1073790,True,0,No user reviews,0,0,0
1073810,True,7,Positive,26,0,26
1073820,True,8,Very Positive,79,9,88
1073830,True,0,No user reviews,0,0,0
1073840,True,7,Positive,34,3,37
1073850,True,0,No user reviews,0,0,0
1073860,True,0,No user reviews,0,0,0
1073870,True,7,Positive,19,1,20
1073880,True,0,No user reviews,0,0,0
1073890,True,0,No user reviews,0,0,0
1073900,True,7,Positive,29,1,30
1073930,True,0,No user reviews,0,0,0
1073940,True,0,No user reviews,0,0,0
1073960,True,0,1 user reviews,0,1,1
1073980,True,0,No user reviews,0,0,0
1073990,True,0,No user reviews,0,0,0
1074020,True,0,No user reviews,0,0,0
1074030,True,0,No user reviews,0,0,0
1074040,True,0,No user reviews,0,0,0
1074050,True,0,No user reviews,0,0,0
1074060,True,0,No user reviews,0,0,0
1074070,True,0,8 user reviews,5,3,8
1074080,True,8,Very Positive,98,16,114
1074090,True,0,No user reviews,0,0,0
1074100,True,0,No user reviews,0,0,0
1074110,True,0,No user reviews,0,0,0
1074150,True,0,2 user reviews,1,1,2
1074170,True,7,Positive,10,1,11
1074180,True,5,Mixed,30,13,43
1074190,True,0,No user reviews,0,0,0
1074200,True,0,No user reviews,0,0,0
1074201,True,0,No user reviews,0,0,0
1074202,True,0,1 user reviews,1,0,1
1074203,True,0,No user reviews,0,0,0
1074204,True,0,No user reviews,0,0,0
1074205,True,0,No user reviews,0,0,0
1074206,True,0,No user reviews,0,0,0
1074207,True,0,No user reviews,0,0,0
1074208,True,0,No user reviews,0,0,0
1074209,True,0,No user reviews,0,0,0
1074210,True,0,1 user reviews,1,0,1
1074211,True,0,2 user reviews,2,0,2
1074212,True,0,No user reviews,0,0,0
1074213,True,0,No user reviews,0,0,0
1074214,True,0,No user reviews,0,0,0
1074215,True,0,No user reviews,0,0,0
1074216,True,0,No user reviews,0,0,0
1074217,True,0,No user reviews,0,0,0
1074218,True,0,No user reviews,0,0,0
1074219,True,0,No user reviews,0,0,0
1074220,True,0,9 user reviews,8,1,9
1074250,True,0,No user reviews,0,0,0
1074260,True,0,6 user reviews,6,0,6
1074261,True,0,No user reviews,0,0,0
1074262,True,0,No user reviews,0,0,0
1074263,True,0,No user reviews,0,0,0
1074264,True,0,No user reviews,0,0,0
1074265,True,0,1 user reviews,0,1,1
1074266,True,0,No user reviews,0,0,0
1074267,True,0,No user reviews,0,0,0
1074270,True,0,8 user reviews,6,2,8
1074271,True,0,No user reviews,0,0,0
1074272,True,0,No user reviews,0,0,0
1074273,True,0,No user reviews,0,0,0
1074274,True,0,No user reviews,0,0,0
1074275,True,0,No user reviews,0,0,0
1074276,True,0,1 user reviews,0,1,1
1074277,True,0,No user reviews,0,0,0
1074280,True,0,No user reviews,0,0,0
1074300,True,0,8 user reviews,8,0,8
1074310,True,0,8 user reviews,8,0,8
1074320,True,6,Mostly Positive,455,149,604
1074321,True,0,No user reviews,0,0,0
1074330,True,0,3 user reviews,3,0,3
1074340,True,0,2 user reviews,2,0,2
1074350,True,0,No user reviews,0,0,0
1074360,True,0,No user reviews,0,0,0
1074370,True,0,5 user reviews,2,3,5
1074390,True,0,No user reviews,0,0,0
1074400,True,0,No user reviews,0,0,0
1074420,True,5,Mixed,38,20,58
1074450,True,0,No user reviews,0,0,0
1074490,True,0,No user reviews,0,0,0
1074500,True,0,1 user reviews,1,0,1
1074510,True,5,Mixed,10,6,16
1074520,True,7,Positive,18,1,19
1074530,True,0,2 user reviews,0,2,2
1074550,True,6,Mostly Positive,8,3,11
1074560,True,0,No user reviews,0,0,0
1074570,True,0,No user reviews,0,0,0
1074580,True,0,No user reviews,0,0,0
1074590,True,0,No user reviews,0,0,0
1074600,True,0,No user reviews,0,0,0
1074610,True,5,Mixed,22,10,32
1074620,True,8,Very Positive,57,12,69
1074630,True,6,Mostly Positive,48,18,66
1074640,True,0,6 user reviews,6,0,6
1074650,True,7,Positive,15,1,16
1074660,True,0,3 user reviews,1,2,3
1074670,True,0,No user reviews,0,0,0
1074680,True,0,No user reviews,0,0,0
1074690,True,0,No user reviews,0,0,0
1074700,True,0,5 user reviews,5,0,5
1074760,True,0,No user reviews,0,0,0
1074770,True,6,Mostly Positive,16,5,21
1074820,True,0,No user reviews,0,0,0
1074830,True,0,No user reviews,0,0,0
1074840,True,0,6 user reviews,2,4,6
1074860,True,0,No user reviews,0,0,0
1074870,True,0,1 user reviews,0,1,1
1074880,True,0,2 user reviews,2,0,2
1074900,True,0,3 user reviews,2,1,3
1074910,True,0,1 user reviews,1,0,1
1074920,True,0,1 user reviews,1,0,1
1074930,True,0,1 user reviews,1,0,1
1074960,True,0,No user reviews,0,0,0
1074980,True,0,7 user reviews,6,1,7
1074990,True,0,No user reviews,0,0,0
1075000,True,0,No user reviews,0,0,0
1075010,True,0,No user reviews,0,0,0
1075040,True,7,Positive,13,1,14
1075041,True,7,Positive,11,0,11
1075050,True,0,1 user reviews,1,0,1
1075060,True,0,No user reviews,0,0,0
1075080,True,6,Mostly Positive,30,12,42
1075100,True,0,No user reviews,0,0,0
1075101,True,0,1 user reviews,0,1,1
1075102,True,0,1 user reviews,0,1,1
1075103,True,0,1 user reviews,1,0,1
1075104,True,0,1 user reviews,0,1,1
1075105,True,0,No user reviews,0,0,0
1075120,True,0,No user reviews,0,0,0
1075140,True,0,No user reviews,0,0,0
1075150,True,0,No user reviews,0,0,0
1075170,True,0,No user reviews,0,0,0
1075180,True,0,No user reviews,0,0,0
1075190,True,6,Mostly Positive,286,82,368
1075200,True,0,No user reviews,0,0,0
1075210,True,0,No user reviews,0,0,0
1075350,True,0,No user reviews,0,0,0
1075370,True,0,4 user reviews,3,1,4
1075380,True,0,No user reviews,0,0,0
1075381,True,0,No user reviews,0,0,0
1075382,True,0,No user reviews,0,0,0
1075390,True,6,Mostly Positive,12,5,17
1075400,True,5,Mixed,69,39,108
1075410,True,0,No user reviews,0,0,0
1075430,True,0,No user reviews,0,0,0
1075440,True,0,No user reviews,0,0,0
1075450,True,0,No user reviews,0,0,0
1075451,True,0,No user reviews,0,0,0
1075452,True,0,No user reviews,0,0,0
1075453,True,0,No user reviews,0,0,0
1075460,True,0,No user reviews,0,0,0
1075480,True,0,1 user reviews,1,0,1
1075490,True,0,No user reviews,0,0,0
1075520,True,0,No user reviews,0,0,0
1075521,True,0,No user reviews,0,0,0
1075550,True,6,Mostly Positive,14,5,19
1075570,True,0,No user reviews,0,0,0
1075580,True,0,No user reviews,0,0,0
1075720,True,0,No user reviews,0,0,0
1075740,True,6,Mostly Positive,139,39,178
1075750,True,0,6 user reviews,5,1,6
1075770,True,0,1 user reviews,1,0,1
1075790,True,0,4 user reviews,1,3,4
1075820,True,0,No user reviews,0,0,0
1075830,True,0,No user reviews,0,0,0
1075840,True,0,No user reviews,0,0,0
1075850,True,0,1 user reviews,1,0,1
1075860,True,0,1 user reviews,1,0,1
1075870,True,0,No user reviews,0,0,0
1075890,True,0,No user reviews,0,0,0
1075900,True,0,No user reviews,0,0,0
1075910,True,0,No user reviews,0,0,0
1075920,True,0,No user reviews,0,0,0
1075950,True,0,No user reviews,0,0,0
1075960,True,0,No user reviews,0,0,0
1075970,True,0,No user reviews,0,0,0
1075980,True,8,Very Positive,75,6,81
1075990,True,0,1 user reviews,1,0,1
1075991,True,0,No user reviews,0,0,0
1075993,True,7,Positive,10,0,10
1075994,True,0,No user reviews,0,0,0
1075995,True,0,No user reviews,0,0,0
1075996,True,0,No user reviews,0,0,0
1075997,True,0,No user reviews,0,0,0
1075998,True,0,No user reviews,0,0,0
1075999,True,0,No user reviews,0,0,0
1076000,True,0,No user reviews,0,0,0
1076010,True,0,No user reviews,0,0,0
1076011,True,0,2 user reviews,1,1,2
1076012,True,0,2 user reviews,1,1,2
1076013,True,0,No user reviews,0,0,0
1076014,True,0,4 user reviews,3,1,4
1076015,True,7,Positive,10,0,10
1076020,True,0,No user reviews,0,0,0
1076030,True,0,No user reviews,0,0,0
1076040,True,0,1 user reviews,1,0,1
1076050,True,0,No user reviews,0,0,0
1076060,True,0,No user reviews,0,0,0
1076080,True,8,Very Positive,74,3,77
1076090,True,0,No user reviews,0,0,0
1076091,True,0,No user reviews,0,0,0
1076092,True,0,No user reviews,0,0,0
1076100,True,0,1 user reviews,0,1,1
1076110,True,0,1 user reviews,1,0,1
1076120,True,0,No user reviews,0,0,0
1076130,True,0,No user reviews,0,0,0
1076140,True,0,3 user reviews,2,1,3
1076150,True,6,Mostly Positive,19,6,25
1076160,True,8,Very Positive,230,52,282
1076170,True,0,No user reviews,0,0,0
1076180,True,0,No user reviews,0,0,0
1076190,True,0,No user reviews,0,0,0
1076200,True,0,No user reviews,0,0,0
1076210,True,8,Very Positive,47,11,58
1076230,True,7,Positive,37,9,46
1076290,True,0,7 user reviews,3,4,7
1076300,True,0,No user reviews,0,0,0
1076350,True,0,No user reviews,0,0,0
1076360,True,0,No user reviews,0,0,0
1076380,True,0,No user reviews,0,0,0
1076390,True,0,No user reviews,0,0,0
1076400,True,0,No user reviews,0,0,0
1076410,True,0,4 user reviews,0,4,4
1076420,True,0,No user reviews,0,0,0
1076430,True,0,No user reviews,0,0,0
1076450,True,0,1 user reviews,1,0,1
1076480,True,0,8 user reviews,8,0,8
1076490,True,0,No user reviews,0,0,0
1076500,True,0,No user reviews,0,0,0
1076530,True,0,2 user reviews,2,0,2
1076550,True,8,Very Positive,157,11,168
1076580,True,0,No user reviews,0,0,0
1076600,True,0,No user reviews,0,0,0
1076610,True,0,No user reviews,0,0,0
1076620,True,0,No user reviews,0,0,0
1076630,True,0,9 user reviews,6,3,9
1076640,True,5,Mixed,35,26,61
1076720,True,0,No user reviews,0,0,0
1076730,True,0,No user reviews,0,0,0
1076740,True,0,No user reviews,0,0,0
1076741,True,0,No user reviews,0,0,0
1076750,True,0,No user reviews,0,0,0
1076760,True,0,No user reviews,0,0,0
1076761,True,0,No user reviews,0,0,0
1076770,True,0,3 user reviews,3,0,3
1076780,True,0,2 user reviews,1,1,2
1076790,True,0,No user reviews,0,0,0
1076820,True,0,No user reviews,0,0,0
1076830,True,0,1 user reviews,1,0,1
1076840,True,0,No user reviews,0,0,0
1076850,True,6,Mostly Positive,34,9,43
1076860,True,0,No user reviews,0,0,0
1076870,True,0,No user reviews,0,0,0
1076880,True,8,Very Positive,127,6,133
1076890,True,0,No user reviews,0,0,0
1076920,True,5,Mixed,76,54,130
1076930,True,0,No user reviews,0,0,0
1076940,True,0,No user reviews,0,0,0
1076950,True,0,1 user reviews,0,1,1
1076960,True,0,No user reviews,0,0,0
1076970,True,0,No user reviews,0,0,0
1076980,True,0,No user reviews,0,0,0
1077010,True,0,No user reviews,0,0,0
1077030,True,0,No user reviews,0,0,0
1077060,True,0,No user reviews,0,0,0
1077080,True,0,No user reviews,0,0,0
1077090,True,0,4 user reviews,3,1,4
1077110,True,0,1 user reviews,1,0,1
1077150,True,0,No user reviews,0,0,0
1077160,True,0,No user reviews,0,0,0
1077170,True,0,1 user reviews,1,0,1
1077180,True,0,No user reviews,0,0,0
1077200,True,0,4 user reviews,3,1,4
1077210,True,0,5 user reviews,3,2,5
1077220,True,0,No user reviews,0,0,0
1077230,True,0,No user reviews,0,0,0
1077240,True,0,No user reviews,0,0,0
1077250,True,0,1 user reviews,1,0,1
1077270,True,0,No user reviews,0,0,0
1077280,True,0,No user reviews,0,0,0
1077290,True,8,Very Positive,143,12,155
1077300,True,0,No user reviews,0,0,0
1077320,True,0,3 user reviews,1,2,3
1077340,True,7,Positive,9,2,11
1077360,True,0,No user reviews,0,0,0
1077370,True,0,No user reviews,0,0,0
1077371,True,0,No user reviews,0,0,0
1077372,True,0,No user reviews,0,0,0
1077373,True,0,No user reviews,0,0,0
1077380,True,0,No user reviews,0,0,0
1077390,True,0,No user reviews,0,0,0
1077410,True,6,Mostly Positive,21,6,27
1077420,True,0,8 user reviews,8,0,8
1077430,True,8,Very Positive,85,15,100
1077440,True,0,No user reviews,0,0,0
1077450,True,7,Positive,39,0,39
1077470,True,0,4 user reviews,3,1,4
1077490,True,0,5 user reviews,4,1,5
1077500,True,0,No user reviews,0,0,0
1077510,True,0,No user reviews,0,0,0
1077520,True,8,Very Positive,71,14,85
1077530,True,8,Very Positive,70,14,84
1077540,True,0,No user reviews,0,0,0
1077550,True,4,Mostly Negative,5,9,14
1077560,True,0,No user reviews,0,0,0
1077570,True,0,1 user reviews,0,1,1
1077580,True,5,Mixed,25,19,44
1077590,True,0,No user reviews,0,0,0
1077600,True,7,Positive,23,1,24
1077610,True,0,2 user reviews,2,0,2
1077630,True,5,Mixed,12,8,20
1077680,True,0,No user reviews,0,0,0
1077690,True,6,Mostly Positive,46,15,61
1077700,True,0,No user reviews,0,0,0
1077710,True,0,No user reviews,0,0,0
1077730,True,0,No user reviews,0,0,0
1077740,True,0,No user reviews,0,0,0
1077760,True,0,1 user reviews,1,0,1
1077850,True,0,No user reviews,0,0,0
1077860,True,0,No user reviews,0,0,0
1077880,True,0,No user reviews,0,0,0
1077890,True,6,Mostly Positive,12,4,16
1077970,True,7,Positive,29,6,35
1077980,True,0,1 user reviews,1,0,1
1077990,True,0,6 user reviews,2,4,6
1078000,True,7,Positive,14,3,17
1078020,True,0,1 user reviews,1,0,1
1078030,True,0,No user reviews,0,0,0
1078040,True,0,2 user reviews,2,0,2
1078060,True,0,2 user reviews,1,1,2
1078080,True,0,No user reviews,0,0,0
1078100,True,0,No user reviews,0,0,0
1078120,True,0,No user reviews,0,0,0
1078130,True,0,No user reviews,0,0,0
1078140,True,0,No user reviews,0,0,0
1078150,True,0,1 user reviews,1,0,1
1078160,True,0,No user reviews,0,0,0
1078190,True,0,No user reviews,0,0,0
1078200,True,8,Very Positive,132,3,135
1078210,True,0,No user reviews,0,0,0
1078220,True,0,No user reviews,0,0,0
1078230,True,0,No user reviews,0,0,0
1078240,True,0,No user reviews,0,0,0
1078270,True,0,No user reviews,0,0,0
1078280,True,7,Positive,43,3,46
1078300,True,0,No user reviews,0,0,0
1078320,True,0,No user reviews,0,0,0
1078330,True,6,Mostly Positive,25,8,33
1078340,True,0,No user reviews,0,0,0
1078350,True,0,No user reviews,0,0,0
1078360,True,0,No user reviews,0,0,0
1078370,True,0,No user reviews,0,0,0
1078380,True,0,9 user reviews,6,3,9
1078390,True,0,No user reviews,0,0,0
1078400,True,0,No user reviews,0,0,0
1078420,True,0,No user reviews,0,0,0
1078450,True,0,1 user reviews,1,0,1
1078460,True,0,No user reviews,0,0,0
1078490,True,0,8 user reviews,5,3,8
1078500,True,0,No user reviews,0,0,0
1078510,True,8,Very Positive,97,9,106
1078520,True,0,8 user reviews,5,3,8
1078540,True,0,No user reviews,0,0,0
1078550,True,7,Positive,15,0,15
1078560,True,5,Mixed,10,10,20
1078570,True,0,No user reviews,0,0,0
1078590,True,0,No user reviews,0,0,0
1078610,True,0,No user reviews,0,0,0
1078620,True,0,No user reviews,0,0,0
1078640,True,5,Mixed,8,6,14
1078650,True,0,No user reviews,0,0,0
1078670,True,0,2 user reviews,1,1,2
1078690,True,0,No user reviews,0,0,0
1078700,True,0,No user reviews,0,0,0
1078710,True,0,No user reviews,0,0,0
1078730,True,0,No user reviews,0,0,0
1078740,True,0,No user reviews,0,0,0
1078741,True,0,No user reviews,0,0,0
1078750,True,0,4 user reviews,3,1,4
1078760,True,0,No user reviews,0,0,0
1078770,True,0,No user reviews,0,0,0
1078780,True,0,2 user reviews,1,1,2
1078790,True,0,No user reviews,0,0,0
1078800,True,0,No user reviews,0,0,0
1078810,True,0,3 user reviews,2,1,3
1078820,True,0,1 user reviews,1,0,1
1078840,True,0,7 user reviews,6,1,7
1078870,True,0,6 user reviews,5,1,6
1078880,True,0,No user reviews,0,0,0
1078890,True,0,No user reviews,0,0,0
1078900,True,0,No user reviews,0,0,0
1078920,True,8,Very Positive,89,4,93
1078930,True,0,2 user reviews,2,0,2
1078940,True,0,No user reviews,0,0,0
1078950,True,0,No user reviews,0,0,0
1078960,True,0,No user reviews,0,0,0
1078970,True,0,No user reviews,0,0,0
1078980,True,0,No user reviews,0,0,0
1078990,True,0,No user reviews,0,0,0
1079000,True,8,Very Positive,103,8,111
1079020,True,0,No user reviews,0,0,0
1079050,True,0,No user reviews,0,0,0
1079070,True,0,No user reviews,0,0,0
1079090,True,0,No user reviews,0,0,0
1079100,True,0,3 user reviews,1,2,3
1079110,True,0,4 user reviews,4,0,4
1079120,True,0,No user reviews,0,0,0
1079130,True,6,Mostly Positive,23,6,29
1079150,True,0,No user reviews,0,0,0
1079160,True,8,Very Positive,122,3,125
1079170,True,0,No user reviews,0,0,0
1079180,True,8,Very Positive,81,1,82
1079190,True,0,No user reviews,0,0,0
1079200,True,6,Mostly Positive,11,4,15
1079210,True,8,Very Positive,128,18,146
1079220,True,0,No user reviews,0,0,0
1079221,True,0,No user reviews,0,0,0
1079230,True,0,No user reviews,0,0,0
1079240,True,0,No user reviews,0,0,0
1079260,True,0,No user reviews,0,0,0
1079290,True,0,No user reviews,0,0,0
1079310,True,0,9 user reviews,8,1,9
1079320,True,7,Positive,18,3,21
1079330,True,0,1 user reviews,0,1,1
1079340,True,0,No user reviews,0,0,0
1079350,True,0,No user reviews,0,0,0
1079360,True,0,2 user reviews,2,0,2
1079420,True,0,1 user reviews,0,1,1
1079430,True,0,No user reviews,0,0,0
1079440,True,0,2 user reviews,1,1,2
1079450,True,8,Very Positive,53,0,53
1079460,True,0,4 user reviews,3,1,4
1079470,True,0,1 user reviews,1,0,1
1079480,True,0,No user reviews,0,0,0
1079490,True,0,No user reviews,0,0,0
1079510,True,0,No user reviews,0,0,0
1079520,True,0,5 user reviews,3,2,5
1079550,True,0,No user reviews,0,0,0
1079560,True,0,5 user reviews,5,0,5
1079570,True,0,No user reviews,0,0,0
1079600,True,0,2 user reviews,1,1,2
1079610,True,0,3 user reviews,3,0,3
1079620,True,8,Very Positive,220,44,264
1079630,True,6,Mostly Positive,11,3,14
1079650,True,0,No user reviews,0,0,0
1079680,True,0,No user reviews,0,0,0
1079690,True,0,No user reviews,0,0,0
1079700,True,0,No user reviews,0,0,0
1079710,True,0,3 user reviews,3,0,3
1079720,True,0,1 user reviews,1,0,1
1079730,True,0,2 user reviews,2,0,2
1079740,True,0,No user reviews,0,0,0
1079750,True,0,No user reviews,0,0,0
1079760,True,0,No user reviews,0,0,0
1079790,True,5,Mixed,9,9,18
1079800,True,8,Very Positive,1130,104,1234
1079810,True,0,No user reviews,0,0,0
1079830,True,0,No user reviews,0,0,0
1079870,True,0,No user reviews,0,0,0
1079880,True,0,No user reviews,0,0,0
1079890,True,0,No user reviews,0,0,0
1079910,True,0,1 user reviews,1,0,1
1079920,True,0,No user reviews,0,0,0
1079930,True,0,No user reviews,0,0,0
1079940,True,0,3 user reviews,1,2,3
1079970,True,0,3 user reviews,3,0,3
1079990,True,0,1 user reviews,1,0,1
1080000,True,0,No user reviews,0,0,0
1080001,True,0,1 user reviews,1,0,1
1080002,True,0,No user reviews,0,0,0
1080010,True,7,Positive,11,0,11
1080020,True,0,No user reviews,0,0,0
1080030,True,0,No user reviews,0,0,0
1080031,True,0,No user reviews,0,0,0
1080032,True,0,No user reviews,0,0,0
1080040,True,0,No user reviews,0,0,0
1080060,True,0,No user reviews,0,0,0
1080090,True,0,No user reviews,0,0,0
1080100,True,0,No user reviews,0,0,0
1080110,True,8,Very Positive,2994,225,3219
1080120,True,0,No user reviews,0,0,0
1080130,True,0,9 user reviews,6,3,9
1080140,True,0,No user reviews,0,0,0
1080150,True,0,No user reviews,0,0,0
1080180,True,0,No user reviews,0,0,0
1080190,True,0,No user reviews,0,0,0
1080200,True,0,No user reviews,0,0,0
1080210,True,0,No user reviews,0,0,0
1080240,True,0,1 user reviews,1,0,1
1080250,True,7,Positive,15,2,17
1080260,True,0,No user reviews,0,0,0
1080270,True,0,No user reviews,0,0,0
1080280,True,0,1 user reviews,1,0,1
1080290,True,0,No user reviews,0,0,0
1080300,True,0,No user reviews,0,0,0
1080320,True,0,2 user reviews,2,0,2
1080330,True,7,Positive,14,0,14
1080360,True,0,1 user reviews,0,1,1
1080370,True,0,2 user reviews,1,1,2
1080410,True,7,Positive,14,2,16
1080420,True,0,No user reviews,0,0,0
1080430,True,0,No user reviews,0,0,0
1080440,True,0,6 user reviews,0,6,6
1080450,True,0,No user reviews,0,0,0
1080460,True,0,No user reviews,0,0,0
1080470,True,0,1 user reviews,0,1,1
1080480,True,0,No user reviews,0,0,0
1080490,True,0,No user reviews,0,0,0
1080500,True,0,No user reviews,0,0,0
1080510,True,0,No user reviews,0,0,0
1080550,True,7,Positive,25,1,26
1080570,True,0,No user reviews,0,0,0
1080580,True,0,No user reviews,0,0,0
1080590,True,0,No user reviews,0,0,0
1080591,True,0,No user reviews,0,0,0
1080600,True,0,No user reviews,0,0,0
1080610,True,0,No user reviews,0,0,0
1080620,True,0,No user reviews,0,0,0
1080630,True,0,2 user reviews,1,1,2
1080650,True,0,No user reviews,0,0,0
1080680,True,0,No user reviews,0,0,0
1080690,True,0,No user reviews,0,0,0
1080700,True,0,No user reviews,0,0,0
1080710,True,0,No user reviews,0,0,0
1080720,True,0,No user reviews,0,0,0
1080750,True,8,Very Positive,174,4,178
1080770,True,7,Positive,23,3,26
1080780,True,0,9 user reviews,7,2,9
1080790,True,7,Positive,15,0,15
1080810,True,0,No user reviews,0,0,0
1080840,True,0,No user reviews,0,0,0
1080880,True,0,No user reviews,0,0,0
1080900,True,0,2 user reviews,2,0,2
1080910,True,0,No user reviews,0,0,0
1080911,True,0,No user reviews,0,0,0
1080930,True,0,No user reviews,0,0,0
1080940,True,0,No user reviews,0,0,0
1080950,True,0,1 user reviews,1,0,1
1080960,True,0,No user reviews,0,0,0
1080970,True,0,No user reviews,0,0,0
1080980,True,0,No user reviews,0,0,0
1080990,True,0,No user reviews,0,0,0
1081000,True,0,8 user reviews,5,3,8
1081020,True,0,1 user reviews,1,0,1
1081030,True,0,No user reviews,0,0,0
1081040,True,6,Mostly Positive,16,5,21
1081070,True,0,2 user reviews,2,0,2
1081090,True,0,5 user reviews,4,1,5
1081100,True,7,Positive,12,0,12
1081110,True,0,1 user reviews,0,1,1
1081120,True,7,Positive,18,1,19
1081140,True,0,2 user reviews,0,2,2
1081160,True,0,No user reviews,0,0,0
1081170,True,0,1 user reviews,1,0,1
1081190,True,0,1 user reviews,1,0,1
1081200,True,0,1 user reviews,1,0,1
1081240,True,0,1 user reviews,0,1,1
1081250,True,0,6 user reviews,4,2,6
1081260,True,0,2 user reviews,2,0,2
1081270,True,0,No user reviews,0,0,0
1081300,True,0,No user reviews,0,0,0
1081320,True,0,1 user reviews,1,0,1
1081340,True,0,No user reviews,0,0,0
1081350,True,0,No user reviews,0,0,0
1081370,True,0,1 user reviews,1,0,1
1081390,True,0,No user reviews,0,0,0
1081410,True,0,3 user reviews,2,1,3
1081420,True,0,No user reviews,0,0,0
1081430,True,0,1 user reviews,1,0,1
1081460,True,0,No user reviews,0,0,0
1081470,True,0,No user reviews,0,0,0
1081490,True,0,No user reviews,0,0,0
1081500,True,0,No user reviews,0,0,0
1081510,True,8,Very Positive,189,37,226
1081520,True,0,No user reviews,0,0,0
1081540,True,0,No user reviews,0,0,0
1081550,True,0,6 user reviews,6,0,6
1081560,True,6,Mostly Positive,60,23,83
1081570,True,0,No user reviews,0,0,0
1081590,True,0,No user reviews,0,0,0
1081600,True,0,1 user reviews,0,1,1
1081610,True,6,Mostly Positive,86,28,114
1081630,True,0,2 user reviews,2,0,2
1081640,True,0,No user reviews,0,0,0
1081650,True,8,Very Positive,55,6,61
1081660,True,0,No user reviews,0,0,0
1081670,True,0,1 user reviews,0,1,1
1081690,True,0,No user reviews,0,0,0
1081700,True,0,No user reviews,0,0,0
1081710,True,0,6 user reviews,4,2,6
1081720,True,0,1 user reviews,0,1,1
1081730,True,0,No user reviews,0,0,0
1081740,True,0,No user reviews,0,0,0
1081750,True,0,No user reviews,0,0,0
1081760,True,0,8 user reviews,4,4,8
1081780,True,7,Positive,8,2,10
1081800,True,0,No user reviews,0,0,0
1081810,True,0,No user reviews,0,0,0
1081820,True,0,No user reviews,0,0,0
1081830,True,0,No user reviews,0,0,0
1081840,True,0,7 user reviews,7,0,7
1081850,True,0,8 user reviews,8,0,8
1081870,True,7,Positive,13,0,13
1081880,True,0,No user reviews,0,0,0
1081890,True,7,Positive,11,1,12
1081900,True,0,3 user reviews,1,2,3
1081910,True,0,1 user reviews,0,1,1
1081920,True,0,1 user reviews,1,0,1
1081940,True,0,No user reviews,0,0,0
1081960,True,0,No user reviews,0,0,0
1081980,True,0,No user reviews,0,0,0
1081990,True,0,2 user reviews,2,0,2
1082000,True,7,Positive,11,0,11
1082020,True,0,No user reviews,0,0,0
1082030,True,0,No user reviews,0,0,0
1082031,True,0,No user reviews,0,0,0
1082032,True,0,No user reviews,0,0,0
1082040,True,0,No user reviews,0,0,0
1082050,True,0,No user reviews,0,0,0
1082060,True,0,No user reviews,0,0,0
1082070,True,0,No user reviews,0,0,0
1082080,True,0,No user reviews,0,0,0
1082110,True,7,Positive,10,1,11
1082120,True,0,No user reviews,0,0,0
1082150,True,0,No user reviews,0,0,0
1082160,True,0,No user reviews,0,0,0
1082161,True,0,1 user reviews,1,0,1
1082170,True,0,No user reviews,0,0,0
1082171,True,0,No user reviews,0,0,0
1082172,True,0,No user reviews,0,0,0
1082180,True,6,Mostly Positive,96,37,133
1082200,True,0,No user reviews,0,0,0
1082220,True,0,4 user reviews,4,0,4
1082230,True,0,No user reviews,0,0,0
1082240,True,0,No user reviews,0,0,0
1082250,True,7,Positive,20,1,21
1082300,True,0,No user reviews,0,0,0
1082310,True,0,No user reviews,0,0,0
1082320,True,0,No user reviews,0,0,0
1082330,True,0,No user reviews,0,0,0
1082350,True,6,Mostly Positive,22,7,29
1082351,True,0,3 user reviews,3,0,3
1082352,True,5,Mixed,11,5,16
1082353,True,8,Very Positive,160,28,188
1082370,True,0,3 user reviews,2,1,3
1082380,True,0,No user reviews,0,0,0
1082390,True,0,No user reviews,0,0,0
1082410,True,0,No user reviews,0,0,0
1082420,True,0,No user reviews,0,0,0
1082430,True,0,No user reviews,0,0,0
1082440,True,7,Positive,15,0,15
1082450,True,0,No user reviews,0,0,0
1082460,True,0,5 user reviews,5,0,5
1082470,True,0,7 user reviews,7,0,7
1082480,True,0,1 user reviews,1,0,1
1082490,True,0,1 user reviews,0,1,1
1082500,True,0,2 user reviews,2,0,2
1082520,True,0,No user reviews,0,0,0
1082550,True,0,1 user reviews,1,0,1
1082571,True,0,1 user reviews,0,1,1
1082572,True,0,1 user reviews,0,1,1
1082573,True,0,1 user reviews,0,1,1
1082574,True,0,2 user reviews,0,2,2
1082575,True,0,1 user reviews,0,1,1
1082576,True,0,2 user reviews,0,2,2
1082577,True,0,1 user reviews,0,1,1
1082578,True,0,1 user reviews,0,1,1
1082579,True,0,3 user reviews,2,1,3
1082580,True,0,4 user reviews,3,1,4
1082581,True,0,3 user reviews,2,1,3
1082582,True,0,2 user reviews,1,1,2
1082610,True,0,1 user reviews,1,0,1
1082620,True,0,No user reviews,0,0,0
1082650,True,0,1 user reviews,1,0,1
1082660,True,0,No user reviews,0,0,0
1082661,True,0,No user reviews,0,0,0
1082662,True,0,No user reviews,0,0,0
1082680,True,4,Mostly Negative,155,292,447
1082690,True,0,No user reviews,0,0,0
1082700,True,0,No user reviews,0,0,0
1082710,True,9,Overwhelmingly Positive,1228,18,1246
1082720,True,6,Mostly Positive,10,4,14
1082730,True,0,No user reviews,0,0,0
1082750,True,0,No user reviews,0,0,0
1082760,True,0,No user reviews,0,0,0
1082770,True,0,8 user reviews,4,4,8
1082780,True,0,No user reviews,0,0,0
1082790,True,0,No user reviews,0,0,0
1082800,True,0,No user reviews,0,0,0
1082810,True,0,No user reviews,0,0,0
1082820,True,0,No user reviews,0,0,0
1082830,True,0,No user reviews,0,0,0
1082840,True,0,No user reviews,0,0,0
1082860,True,0,2 user reviews,2,0,2
1082890,True,0,No user reviews,0,0,0
1082900,True,0,No user reviews,0,0,0
1082920,True,8,Very Positive,74,0,74
1082930,True,7,Positive,12,3,15
1082940,True,0,5 user reviews,3,2,5
1082950,True,0,No user reviews,0,0,0
1082970,True,0,No user reviews,0,0,0
1082990,True,0,No user reviews,0,0,0
1083000,True,0,No user reviews,0,0,0
1083020,True,0,No user reviews,0,0,0
1083060,True,0,No user reviews,0,0,0
1083070,True,0,No user reviews,0,0,0
1083090,True,0,3 user reviews,3,0,3
1083100,True,0,3 user reviews,1,2,3
1083150,True,0,No user reviews,0,0,0
1083190,True,8,Very Positive,55,3,58
1083210,True,5,Mixed,35,17,52
1083230,True,0,No user reviews,0,0,0
1083240,True,0,6 user reviews,6,0,6
1083250,True,0,No user reviews,0,0,0
1083260,True,0,2 user reviews,0,2,2
1083270,True,0,1 user reviews,1,0,1
1083280,True,0,1 user reviews,1,0,1
1083281,True,0,1 user reviews,1,0,1
1083282,True,7,Positive,16,2,18
1083283,True,0,4 user reviews,3,1,4
1083290,True,0,7 user reviews,2,5,7
1083300,True,0,No user reviews,0,0,0
1083310,True,6,Mostly Positive,37,10,47
1083340,True,0,No user reviews,0,0,0
1083350,True,0,1 user reviews,1,0,1
1083370,True,0,No user reviews,0,0,0
1083380,True,0,No user reviews,0,0,0
1083390,True,0,No user reviews,0,0,0
1083410,True,0,1 user reviews,0,1,1
1083420,True,7,Positive,17,4,21
1083430,True,0,1 user reviews,0,1,1
1083450,True,0,2 user reviews,2,0,2
1083460,True,0,3 user reviews,3,0,3
1083480,True,0,No user reviews,0,0,0
1083490,True,0,4 user reviews,2,2,4
1083500,True,0,No user reviews,0,0,0
1083530,True,0,No user reviews,0,0,0
1083540,True,0,No user reviews,0,0,0
1083580,True,0,No user reviews,0,0,0
1083590,True,0,2 user reviews,1,1,2
1083600,True,0,No user reviews,0,0,0
1083610,True,0,No user reviews,0,0,0
1083650,True,5,Mixed,38,17,55
1083660,True,0,No user reviews,0,0,0
1083670,True,0,9 user reviews,8,1,9
1083680,True,0,No user reviews,0,0,0
1083700,True,0,2 user reviews,2,0,2
1083750,True,0,1 user reviews,1,0,1
1083760,True,7,Positive,44,3,47
1083780,True,0,No user reviews,0,0,0
1083790,True,0,No user reviews,0,0,0
1083800,True,0,1 user reviews,1,0,1
1083810,True,7,Positive,21,2,23
1083820,True,7,Positive,17,4,21
1083830,True,0,No user reviews,0,0,0
1083831,True,0,No user reviews,0,0,0
1083832,True,0,No user reviews,0,0,0
1083833,True,0,No user reviews,0,0,0
1083850,True,5,Mixed,8,11,19
1083870,True,0,No user reviews,0,0,0
1083880,True,8,Very Positive,558,57,615
1083890,True,6,Mostly Positive,14,4,18
1083900,True,0,2 user reviews,2,0,2
1083910,True,0,6 user reviews,6,0,6
1083970,True,0,2 user reviews,0,2,2
1083971,True,0,No user reviews,0,0,0
1083980,True,0,No user reviews,0,0,0
1083990,True,0,3 user reviews,2,1,3
1084000,True,0,No user reviews,0,0,0
1084010,True,0,1 user reviews,0,1,1
1084020,True,8,Very Positive,175,26,201
1084050,True,0,No user reviews,0,0,0
1084060,True,0,4 user reviews,2,2,4
1084070,True,0,4 user reviews,4,0,4
1084071,True,0,1 user reviews,1,0,1
1084072,True,0,2 user reviews,1,1,2
1084073,True,0,4 user reviews,3,1,4
1084080,True,7,Positive,28,7,35
1084090,True,0,1 user reviews,1,0,1
1084100,True,4,Mostly Negative,7,14,21
1084110,True,5,Mixed,11,8,19
1084120,True,0,No user reviews,0,0,0
1084130,True,0,No user reviews,0,0,0
1084210,True,0,7 user reviews,7,0,7
1084220,True,7,Positive,15,0,15
1084230,True,0,No user reviews,0,0,0
1084350,True,7,Positive,11,2,13
1084360,True,0,No user reviews,0,0,0
1084380,True,0,No user reviews,0,0,0
1084390,True,0,No user reviews,0,0,0
1084400,True,6,Mostly Positive,311,87,398
1084410,True,0,No user reviews,0,0,0
1084420,True,0,1 user reviews,1,0,1
1084430,True,0,6 user reviews,5,1,6
1084460,True,0,1 user reviews,1,0,1
1084470,True,0,3 user reviews,1,2,3
1084480,True,7,Positive,16,3,19
1084500,True,0,No user reviews,0,0,0
1084510,True,0,No user reviews,0,0,0
1084520,True,0,No user reviews,0,0,0
1084530,True,0,1 user reviews,1,0,1
1084560,True,0,No user reviews,0,0,0
1084570,True,0,No user reviews,0,0,0
1084580,True,0,No user reviews,0,0,0
1084630,True,0,No user reviews,0,0,0
1084640,True,0,No user reviews,0,0,0
1084650,True,0,No user reviews,0,0,0
1084651,True,0,No user reviews,0,0,0
1084660,True,0,No user reviews,0,0,0
1084680,True,6,Mostly Positive,87,34,121
1084700,True,0,No user reviews,0,0,0
1084701,True,0,No user reviews,0,0,0
1084710,True,0,6 user reviews,5,1,6
1084730,True,0,No user reviews,0,0,0
1084770,True,0,2 user reviews,2,0,2
1084780,True,0,No user reviews,0,0,0
1084790,True,7,Positive,28,6,34
1084810,True,0,1 user reviews,1,0,1
1084820,True,7,Positive,25,2,27
1084830,True,0,No user reviews,0,0,0
1084840,True,0,5 user reviews,5,0,5
1084860,True,0,1 user reviews,1,0,1
1084870,True,5,Mixed,13,8,21
1084880,True,0,1 user reviews,1,0,1
1084890,True,0,No user reviews,0,0,0
1084900,True,0,No user reviews,0,0,0
1084910,True,0,1 user reviews,1,0,1
1084920,True,0,4 user reviews,4,0,4
1084930,True,0,9 user reviews,8,1,9
1084940,True,0,No user reviews,0,0,0
1084950,True,0,No user reviews,0,0,0
1084960,True,0,No user reviews,0,0,0
1084970,True,0,6 user reviews,5,1,6
1084980,True,0,No user reviews,0,0,0
1084990,True,6,Mostly Positive,41,13,54
1085010,True,0,4 user reviews,4,0,4
1085020,True,0,No user reviews,0,0,0
1085030,True,0,No user reviews,0,0,0
1085040,True,0,No user reviews,0,0,0
1085060,True,0,No user reviews,0,0,0
1085070,True,0,No user reviews,0,0,0
1085080,True,0,No user reviews,0,0,0
1085090,True,0,No user reviews,0,0,0
1085100,True,0,No user reviews,0,0,0
1085110,True,0,7 user reviews,2,5,7
1085150,True,0,1 user reviews,0,1,1
1085160,True,8,Very Positive,76,13,89
1085180,True,8,Very Positive,100,8,108
1085190,True,5,Mixed,9,4,13
1085200,True,0,No user reviews,0,0,0
1085210,True,0,No user reviews,0,0,0
1085220,True,0,No user reviews,0,0,0
1085230,True,0,No user reviews,0,0,0
1085240,True,0,4 user reviews,3,1,4
1085260,True,0,9 user reviews,9,0,9
1085270,True,5,Mixed,12,7,19
1085280,True,0,No user reviews,0,0,0
1085310,True,4,Mostly Negative,4,10,14
1085320,True,0,No user reviews,0,0,0
1085340,True,0,3 user reviews,2,1,3
1085360,True,0,No user reviews,0,0,0
1085390,True,0,2 user reviews,1,1,2
1085400,True,0,No user reviews,0,0,0
1085410,True,0,No user reviews,0,0,0
1085510,True,8,Very Positive,663,83,746
1085520,True,0,8 user reviews,5,3,8
1085540,True,0,No user reviews,0,0,0
1085550,True,0,No user reviews,0,0,0
1085560,True,7,Positive,26,2,28
1085570,True,0,No user reviews,0,0,0
1085580,True,0,No user reviews,0,0,0
1085590,True,0,No user reviews,0,0,0
1085600,True,0,No user reviews,0,0,0
1085610,True,0,8 user reviews,5,3,8
1085620,True,0,No user reviews,0,0,0
1085630,True,7,Positive,18,4,22
1085640,True,6,Mostly Positive,12,4,16
1085650,True,0,No user reviews,0,0,0
1085660,True,8,Very Positive,40563,4012,44575
1085700,True,0,No user reviews,0,0,0
1085710,True,0,No user reviews,0,0,0
1085730,True,0,1 user reviews,0,1,1
1085740,True,0,No user reviews,0,0,0
1085750,True,5,Mixed,86,41,127
1085780,True,0,No user reviews,0,0,0
1085800,True,0,No user reviews,0,0,0
1085810,True,0,No user reviews,0,0,0
1085820,True,0,2 user reviews,1,1,2
1085840,True,0,No user reviews,0,0,0
1085850,True,0,No user reviews,0,0,0
1085880,True,0,No user reviews,0,0,0
1085900,True,0,1 user reviews,1,0,1
1085930,True,0,3 user reviews,3,0,3
1085940,True,0,2 user reviews,0,2,2
1085950,True,0,1 user reviews,1,0,1
1085960,True,0,No user reviews,0,0,0
1085980,True,0,No user reviews,0,0,0
1085990,True,0,3 user reviews,3,0,3
1086010,True,8,Very Positive,221,40,261
1086020,True,0,No user reviews,0,0,0
1086030,True,7,Positive,13,3,16
1086040,True,0,No user reviews,0,0,0
1086050,True,0,No user reviews,0,0,0
1086060,True,0,1 user reviews,1,0,1
1086070,True,0,2 user reviews,2,0,2
1086140,True,0,1 user reviews,1,0,1
1086160,True,7,Positive,18,1,19
1086170,True,0,No user reviews,0,0,0
1086180,True,0,3 user reviews,2,1,3
1086190,True,0,No user reviews,0,0,0
1086200,True,0,No user reviews,0,0,0
1086240,True,0,No user reviews,0,0,0
1086250,True,0,1 user reviews,0,1,1
1086260,True,0,No user reviews,0,0,0
1086270,True,0,1 user reviews,1,0,1
1086310,True,0,9 user reviews,2,7,9
1086320,True,0,2 user reviews,0,2,2
1086350,True,0,No user reviews,0,0,0
1086380,True,0,No user reviews,0,0,0
1086410,True,8,Very Positive,56,3,59
1086450,True,7,Positive,13,0,13
1086460,True,0,1 user reviews,1,0,1
1086470,True,0,No user reviews,0,0,0
1086480,True,5,Mixed,68,60,128
1086481,True,6,Mostly Positive,53,21,74
1086490,True,0,3 user reviews,1,2,3
1086530,True,0,No user reviews,0,0,0
1086570,True,0,No user reviews,0,0,0
1086600,True,0,1 user reviews,0,1,1
1086610,True,0,No user reviews,0,0,0
1086620,True,0,No user reviews,0,0,0
1086630,True,0,No user reviews,0,0,0
1086640,True,5,Mixed,153,92,245
1086650,True,0,No user reviews,0,0,0
1086670,True,0,1 user reviews,1,0,1
1086680,True,0,1 user reviews,0,1,1
1086690,True,0,1 user reviews,0,1,1
1086730,True,0,1 user reviews,1,0,1
1086740,True,0,No user reviews,0,0,0
1086750,True,7,Positive,16,2,18
1086760,True,7,Positive,12,3,15
1086810,True,0,5 user reviews,4,1,5
1086820,True,0,3 user reviews,1,2,3
1086840,True,7,Positive,13,1,14
1086850,True,8,Very Positive,138,22,160
1086860,True,7,Positive,15,0,15
1086870,True,7,Positive,23,5,28
1086880,True,0,No user reviews,0,0,0
1086890,True,0,No user reviews,0,0,0
1086900,True,0,2 user reviews,2,0,2
1086920,True,0,3 user reviews,3,0,3
1086930,True,0,No user reviews,0,0,0
1086940,True,8,Very Positive,13388,1707,15095
1086970,True,0,8 user reviews,7,1,8
1086980,True,0,No user reviews,0,0,0
1086990,True,0,6 user reviews,0,6,6
1087000,True,0,No user reviews,0,0,0
1087010,True,0,No user reviews,0,0,0
1087011,True,0,No user reviews,0,0,0
1087020,True,0,No user reviews,0,0,0
1087040,True,0,1 user reviews,0,1,1
1087050,True,0,No user reviews,0,0,0
1087060,True,0,No user reviews,0,0,0
1087070,True,0,1 user reviews,0,1,1
1087080,True,0,No user reviews,0,0,0
1087100,True,0,3 user reviews,1,2,3
1087110,True,6,Mostly Positive,19,5,24
1087120,True,7,Positive,9,2,11
1087121,True,7,Positive,10,0,10
1087122,True,0,9 user reviews,7,2,9
1087123,True,7,Positive,10,0,10
1087130,True,7,Positive,13,2,15
1087131,True,0,6 user reviews,6,0,6
1087180,True,0,No user reviews,0,0,0
1087190,True,0,No user reviews,0,0,0
1087260,True,0,No user reviews,0,0,0
1087270,True,6,Mostly Positive,154,51,205
1087280,True,8,Very Positive,836,76,912
1087290,True,0,1 user reviews,1,0,1
1087300,True,0,No user reviews,0,0,0
1087310,True,0,2 user reviews,2,0,2
1087320,True,0,No user reviews,0,0,0
1087330,True,0,9 user reviews,4,5,9
1087340,True,0,No user reviews,0,0,0
1087350,True,7,Positive,24,5,29
1087390,True,0,No user reviews,0,0,0
1087420,True,0,6 user reviews,4,2,6
1087421,True,0,4 user reviews,4,0,4
1087422,True,0,1 user reviews,1,0,1
1087423,True,0,3 user reviews,3,0,3
1087424,True,5,Mixed,9,6,15
1087425,True,0,2 user reviews,1,1,2
1087426,True,0,2 user reviews,2,0,2
1087427,True,0,4 user reviews,4,0,4
1087428,True,0,9 user reviews,7,2,9
1087429,True,0,3 user reviews,3,0,3
1087430,True,0,No user reviews,0,0,0
1087440,True,7,Positive,16,2,18
1087450,True,0,2 user reviews,2,0,2
1087451,True,0,No user reviews,0,0,0
1087460,True,8,Very Positive,207,28,235
1087480,True,0,No user reviews,0,0,0
1087500,True,6,Mostly Positive,29,9,38
1087540,True,0,No user reviews,0,0,0
1087590,True,0,5 user reviews,5,0,5
1087600,True,5,Mixed,9,4,13
1087610,True,0,No user reviews,0,0,0
1087630,True,0,No user reviews,0,0,0
1087640,True,0,No user reviews,0,0,0
1087650,True,0,No user reviews,0,0,0
1087680,True,0,1 user reviews,1,0,1
1087700,True,7,Positive,17,3,20
1087720,True,7,Positive,21,3,24
1087730,True,0,No user reviews,0,0,0
1087740,True,7,Positive,28,1,29
1087770,True,0,1 user reviews,0,1,1
1087780,True,6,Mostly Positive,11,3,14
1087800,True,0,7 user reviews,5,2,7
1087810,True,7,Positive,29,3,32
1087820,True,0,No user reviews,0,0,0
1087830,True,0,3 user reviews,3,0,3
1087840,True,0,No user reviews,0,0,0
1087850,True,0,No user reviews,0,0,0
1087860,True,0,No user reviews,0,0,0
1087870,True,0,No user reviews,0,0,0
1087880,True,0,No user reviews,0,0,0
1087890,True,0,No user reviews,0,0,0
1087910,True,0,2 user reviews,1,1,2
1087930,True,0,No user reviews,0,0,0
1087940,True,0,3 user reviews,3,0,3
1087950,True,0,2 user reviews,1,1,2
1087960,True,0,No user reviews,0,0,0
1087970,True,6,Mostly Positive,13,4,17
1087980,True,0,No user reviews,0,0,0
1088000,True,6,Mostly Positive,56,20,76
1088010,True,0,2 user reviews,0,2,2
1088030,True,0,No user reviews,0,0,0
1088040,True,0,5 user reviews,4,1,5
1088060,True,0,2 user reviews,2,0,2
1088070,True,0,2 user reviews,0,2,2
1088080,True,0,No user reviews,0,0,0
1088081,True,0,No user reviews,0,0,0
1088090,True,5,Mixed,292,226,518
1088110,True,0,No user reviews,0,0,0
1088120,True,0,2 user reviews,1,1,2
1088130,True,0,8 user reviews,1,7,8
1088150,True,0,3 user reviews,2,1,3
1088160,True,0,No user reviews,0,0,0
1088190,True,0,No user reviews,0,0,0
1088270,True,0,No user reviews,0,0,0
1088280,True,0,No user reviews,0,0,0
1088290,True,8,Very Positive,77,3,80
1088300,True,0,No user reviews,0,0,0
1088310,True,0,2 user reviews,1,1,2
1088320,True,0,No user reviews,0,0,0
1088330,True,0,3 user reviews,3,0,3
1088340,True,0,3 user reviews,3,0,3
1088350,True,0,2 user reviews,2,0,2
1088400,True,0,7 user reviews,7,0,7
1088410,True,0,No user reviews,0,0,0
1088420,True,7,Positive,10,0,10
1088440,True,0,4 user reviews,3,1,4
1088450,True,0,No user reviews,0,0,0
1088481,True,0,1 user reviews,0,1,1
1088482,True,0,1 user reviews,1,0,1
1088487,True,0,No user reviews,0,0,0
1088488,True,0,No user reviews,0,0,0
1088489,True,0,No user reviews,0,0,0
1088490,True,0,No user reviews,0,0,0
1088491,True,0,1 user reviews,1,0,1
1088493,True,0,No user reviews,0,0,0
1088494,True,0,1 user reviews,1,0,1
1088495,True,0,1 user reviews,1,0,1
1088496,True,0,No user reviews,0,0,0
1088498,True,0,No user reviews,0,0,0
1088499,True,0,No user reviews,0,0,0
1088500,True,0,No user reviews,0,0,0
1088530,True,0,No user reviews,0,0,0
1088540,True,0,3 user reviews,2,1,3
1088570,True,0,No user reviews,0,0,0
1088580,True,0,No user reviews,0,0,0
1088590,True,5,Mixed,12,7,19
1088600,True,7,Positive,30,7,37
1088610,True,0,No user reviews,0,0,0
1088630,True,0,1 user reviews,1,0,1
1088640,True,5,Mixed,30,24,54
1088680,True,0,No user reviews,0,0,0
1088690,True,0,No user reviews,0,0,0
1088700,True,0,No user reviews,0,0,0
1088720,True,0,1 user reviews,1,0,1
1088740,True,0,4 user reviews,1,3,4
1088750,True,0,No user reviews,0,0,0
1088760,True,0,No user reviews,0,0,0
1088770,True,0,No user reviews,0,0,0
1088790,True,8,Very Positive,654,149,803
1088800,True,0,No user reviews,0,0,0
1088820,True,0,No user reviews,0,0,0
1088830,True,0,No user reviews,0,0,0
1088870,True,0,No user reviews,0,0,0
1088880,True,5,Mixed,6,4,10
1088900,True,0,No user reviews,0,0,0
1088910,True,0,1 user reviews,1,0,1
1088930,True,7,Positive,10,1,11
1088950,True,8,Very Positive,42,10,52
1088960,True,0,1 user reviews,1,0,1
1088970,True,0,No user reviews,0,0,0
1088980,True,0,No user reviews,0,0,0
1089000,True,0,3 user reviews,3,0,3
1089020,True,0,No user reviews,0,0,0
1089030,True,0,6 user reviews,6,0,6
1089040,True,0,No user reviews,0,0,0
1089050,True,0,6 user reviews,5,1,6
1089080,True,0,No user reviews,0,0,0
1089090,True,8,Very Positive,651,54,705
1089100,True,0,No user reviews,0,0,0
1089110,True,0,9 user reviews,8,1,9
1089130,True,0,No user reviews,0,0,0
1089140,True,0,1 user reviews,1,0,1
1089150,True,0,No user reviews,0,0,0
1089160,True,0,2 user reviews,2,0,2
1089161,True,0,1 user reviews,1,0,1
1089162,True,0,No user reviews,0,0,0
1089163,True,0,No user reviews,0,0,0
1089164,True,0,No user reviews,0,0,0
1089165,True,0,1 user reviews,1,0,1
1089166,True,0,1 user reviews,1,0,1
1089167,True,0,No user reviews,0,0,0
1089168,True,0,No user reviews,0,0,0
1089169,True,0,No user reviews,0,0,0
1089170,True,0,No user reviews,0,0,0
1089171,True,0,No user reviews,0,0,0
1089172,True,0,2 user reviews,2,0,2
1089183,True,0,No user reviews,0,0,0
1089184,True,0,No user reviews,0,0,0
1089185,True,0,No user reviews,0,0,0
1089186,True,0,No user reviews,0,0,0
1089187,True,0,No user reviews,0,0,0
1089188,True,0,No user reviews,0,0,0
1089189,True,0,No user reviews,0,0,0
1089190,True,0,1 user reviews,1,0,1
1089191,True,0,No user reviews,0,0,0
1089192,True,0,No user reviews,0,0,0
1089193,True,0,No user reviews,0,0,0
1089194,True,0,No user reviews,0,0,0
1089195,True,0,1 user reviews,0,1,1
1089196,True,0,1 user reviews,0,1,1
1089197,True,0,No user reviews,0,0,0
1089198,True,0,No user reviews,0,0,0
1089199,True,0,No user reviews,0,0,0
1089210,True,0,No user reviews,0,0,0
1089211,True,0,No user reviews,0,0,0
1089212,True,0,No user reviews,0,0,0
1089213,True,0,No user reviews,0,0,0
1089214,True,0,3 user reviews,1,2,3
1089215,True,0,No user reviews,0,0,0
1089216,True,0,No user reviews,0,0,0
1089218,True,0,No user reviews,0,0,0
1089219,True,0,No user reviews,0,0,0
1089220,True,0,No user reviews,0,0,0
1089221,True,0,No user reviews,0,0,0
1089222,True,0,No user reviews,0,0,0
1089223,True,0,No user reviews,0,0,0
1089225,True,0,No user reviews,0,0,0
1089226,True,0,No user reviews,0,0,0
1089227,True,0,No user reviews,0,0,0
1089228,True,0,No user reviews,0,0,0
1089229,True,0,No user reviews,0,0,0
1089230,True,0,No user reviews,0,0,0
1089231,True,0,No user reviews,0,0,0
1089232,True,0,No user reviews,0,0,0
1089233,True,0,No user reviews,0,0,0
1089234,True,0,No user reviews,0,0,0
1089235,True,0,No user reviews,0,0,0
1089236,True,0,No user reviews,0,0,0
1089237,True,0,No user reviews,0,0,0
1089238,True,0,5 user reviews,5,0,5
1089239,True,0,No user reviews,0,0,0
1089240,True,0,No user reviews,0,0,0
1089241,True,0,2 user reviews,2,0,2
1089242,True,0,No user reviews,0,0,0
1089243,True,0,No user reviews,0,0,0
1089244,True,0,No user reviews,0,0,0
1089245,True,0,No user reviews,0,0,0
1089250,True,0,No user reviews,0,0,0
1089270,True,8,Very Positive,312,63,375
1089280,True,0,No user reviews,0,0,0
1089281,True,0,No user reviews,0,0,0
1089290,True,0,No user reviews,0,0,0
1089310,True,6,Mostly Positive,15,5,20
1089320,True,0,1 user reviews,1,0,1
1089330,True,0,6 user reviews,1,5,6
1089350,True,5,Mixed,5536,3437,8973
1089410,True,0,No user reviews,0,0,0
1089430,True,0,No user reviews,0,0,0
1089520,True,0,1 user reviews,1,0,1
1089540,True,0,No user reviews,0,0,0
1089560,True,0,No user reviews,0,0,0
1089570,True,0,No user reviews,0,0,0
1089580,True,0,No user reviews,0,0,0
1089581,True,0,No user reviews,0,0,0
1089590,True,0,2 user reviews,1,1,2
1089600,True,7,Positive,15,3,18
1089610,True,0,No user reviews,0,0,0
1089620,True,7,Positive,10,1,11
1089630,True,0,5 user reviews,5,0,5
1089650,True,0,No user reviews,0,0,0
1089660,True,6,Mostly Positive,14,4,18
1089670,True,0,4 user reviews,4,0,4
1089671,True,0,6 user reviews,4,2,6
1089672,True,0,4 user reviews,2,2,4
1089680,True,0,No user reviews,0,0,0
1089690,True,0,No user reviews,0,0,0
1089710,True,0,No user reviews,0,0,0
1089730,True,0,No user reviews,0,0,0
1089740,True,0,No user reviews,0,0,0
1089750,True,0,No user reviews,0,0,0
1089760,True,0,4 user reviews,2,2,4
1089770,True,0,7 user reviews,7,0,7
1089790,True,6,Mostly Positive,54,21,75
1089800,True,0,1 user reviews,0,1,1
1089810,True,0,1 user reviews,1,0,1
1089820,True,5,Mixed,9,4,13
1089830,True,6,Mostly Positive,217,56,273
1089840,True,8,Very Positive,56,10,66
1089860,True,0,No user reviews,0,0,0
1089880,True,0,2 user reviews,1,1,2
1089900,True,0,No user reviews,0,0,0
1089910,True,0,No user reviews,0,0,0
1089920,True,0,No user reviews,0,0,0
1089930,True,0,No user reviews,0,0,0
1089940,True,0,No user reviews,0,0,0
1089980,True,9,Overwhelmingly Positive,9510,78,9588
1090020,True,0,No user reviews,0,0,0
1090030,True,7,Positive,16,2,18
1090040,True,0,No user reviews,0,0,0
1090060,True,0,5 user reviews,5,0,5
1090070,True,0,No user reviews,0,0,0
1090090,True,0,No user reviews,0,0,0
1090091,True,0,No user reviews,0,0,0
1090092,True,0,No user reviews,0,0,0
1090093,True,0,No user reviews,0,0,0
1090094,True,0,No user reviews,0,0,0
1090095,True,0,No user reviews,0,0,0
1090096,True,0,No user reviews,0,0,0
1090110,True,0,3 user reviews,3,0,3
1090120,True,0,No user reviews,0,0,0
1090150,True,8,Very Positive,461,69,530
1090151,True,0,No user reviews,0,0,0
1090152,True,0,No user reviews,0,0,0
1090160,True,0,No user reviews,0,0,0
1090161,True,0,No user reviews,0,0,0
1090162,True,0,3 user reviews,0,3,3
1090163,True,0,8 user reviews,1,7,8
1090164,True,0,9 user reviews,7,2,9
1090170,True,0,No user reviews,0,0,0
1090171,True,0,No user reviews,0,0,0
1090190,True,0,No user reviews,0,0,0
1090200,True,5,Mixed,709,628,1337
1090201,True,0,No user reviews,0,0,0
1090202,True,6,Mostly Positive,99,34,133
1090210,True,6,Mostly Positive,12,4,16
1090250,True,0,No user reviews,0,0,0
1090300,True,0,No user reviews,0,0,0
1090320,True,0,No user reviews,0,0,0
1090340,True,0,No user reviews,0,0,0
1090370,True,0,No user reviews,0,0,0
1090380,True,0,1 user reviews,1,0,1
1090390,True,7,Positive,9,2,11
1090400,True,0,No user reviews,0,0,0
1090420,True,0,No user reviews,0,0,0
1090430,True,0,No user reviews,0,0,0
1090440,True,7,Positive,32,5,37
1090470,True,6,Mostly Positive,8,3,11
1090480,True,0,No user reviews,0,0,0
1090490,True,0,No user reviews,0,0,0
1090520,True,0,1 user reviews,0,1,1
1090530,True,0,No user reviews,0,0,0
1090540,True,0,1 user reviews,0,1,1
1090550,True,0,No user reviews,0,0,0
1090560,True,0,No user reviews,0,0,0
1090570,True,0,No user reviews,0,0,0
1090580,True,0,1 user reviews,1,0,1
1090630,True,8,Very Positive,1146,170,1316
1090640,True,0,No user reviews,0,0,0
1090650,True,0,1 user reviews,1,0,1
1090660,True,0,1 user reviews,1,0,1
1090670,True,7,Positive,17,3,20
1090690,True,0,1 user reviews,1,0,1
1090730,True,5,Mixed,8,5,13
1090750,True,0,No user reviews,0,0,0
1090760,True,0,No user reviews,0,0,0
1090790,True,7,Positive,27,1,28
1090800,True,0,No user reviews,0,0,0
1090830,True,0,No user reviews,0,0,0
1090850,True,6,Mostly Positive,134,40,174
1090860,True,0,7 user reviews,7,0,7
1090880,True,0,No user reviews,0,0,0
1090890,True,0,No user reviews,0,0,0
1090900,True,0,No user reviews,0,0,0
1090910,True,0,1 user reviews,0,1,1
1090920,True,0,2 user reviews,2,0,2
1090930,True,6,Mostly Positive,18,5,23
1090940,True,0,3 user reviews,3,0,3
1090950,True,0,No user reviews,0,0,0
1090960,True,0,3 user reviews,3,0,3
1091000,True,0,No user reviews,0,0,0
1091010,True,0,No user reviews,0,0,0
1091020,True,0,No user reviews,0,0,0
1091030,True,0,No user reviews,0,0,0
1091040,True,0,1 user reviews,1,0,1
1091050,True,0,3 user reviews,0,3,3
1091070,True,0,No user reviews,0,0,0
1091090,True,0,6 user reviews,5,1,6
1091100,True,0,No user reviews,0,0,0
1091110,True,0,7 user reviews,5,2,7
1091140,True,0,No user reviews,0,0,0
1091150,True,0,7 user reviews,6,1,7
1091160,True,0,2 user reviews,2,0,2
1091170,True,0,9 user reviews,5,4,9
1091180,True,0,1 user reviews,1,0,1
1091190,True,0,1 user reviews,0,1,1
1091200,True,6,Mostly Positive,13,5,18
1091210,True,5,Mixed,10,5,15
1091220,True,0,1 user reviews,0,1,1
1091240,True,0,6 user reviews,5,1,6
1091250,True,8,Very Positive,52,4,56
1091260,True,0,No user reviews,0,0,0
1091270,True,0,7 user reviews,5,2,7
1091290,True,0,No user reviews,0,0,0
1091291,True,0,No user reviews,0,0,0
1091300,True,0,No user reviews,0,0,0
1091310,True,0,No user reviews,0,0,0
1091320,True,0,No user reviews,0,0,0
1091350,True,0,No user reviews,0,0,0
1091370,True,0,No user reviews,0,0,0
1091380,True,0,No user reviews,0,0,0
1091390,True,0,No user reviews,0,0,0
1091400,True,7,Positive,26,5,31
1091410,True,0,No user reviews,0,0,0
1091420,True,0,No user reviews,0,0,0
1091430,True,0,No user reviews,0,0,0
1091450,True,0,No user reviews,0,0,0
1091460,True,0,7 user reviews,5,2,7
1091470,True,7,Positive,11,2,13
1091480,True,0,No user reviews,0,0,0
1091490,True,0,No user reviews,0,0,0
1091510,True,0,No user reviews,0,0,0
1091520,True,0,No user reviews,0,0,0
1091540,True,0,No user reviews,0,0,0
1091550,True,0,No user reviews,0,0,0
1091560,True,0,8 user reviews,5,3,8
1091570,True,0,3 user reviews,2,1,3
1091580,True,0,4 user reviews,3,1,4
1091590,True,0,6 user reviews,3,3,6
1091600,True,0,No user reviews,0,0,0
1091610,True,0,No user reviews,0,0,0
1091620,True,0,No user reviews,0,0,0
1091630,True,0,No user reviews,0,0,0
1091640,True,0,No user reviews,0,0,0
1091650,True,5,Mixed,8,12,20
1091670,True,0,No user reviews,0,0,0
1091680,True,6,Mostly Positive,12,4,16
1091690,True,0,No user reviews,0,0,0
1091720,True,0,1 user reviews,1,0,1
1091730,True,0,No user reviews,0,0,0
1091760,True,0,No user reviews,0,0,0
1091840,True,0,No user reviews,0,0,0
1091860,True,0,No user reviews,0,0,0
1091870,True,0,No user reviews,0,0,0
1091890,True,0,No user reviews,0,0,0
1091910,True,0,1 user reviews,1,0,1
1091920,True,0,No user reviews,0,0,0
1091940,True,6,Mostly Positive,19,8,27
1091950,True,7,Positive,19,2,21
1091960,True,0,No user reviews,0,0,0
1091970,True,0,No user reviews,0,0,0
1091980,True,6,Mostly Positive,156,59,215
1092000,True,7,Positive,27,4,31
1092010,True,0,No user reviews,0,0,0
1092030,True,0,No user reviews,0,0,0
1092040,True,0,No user reviews,0,0,0
1092060,True,0,No user reviews,0,0,0
1092070,True,0,No user reviews,0,0,0
1092080,True,0,No user reviews,0,0,0
1092140,True,5,Mixed,13,8,21
1092150,True,0,No user reviews,0,0,0
1092160,True,0,No user reviews,0,0,0
1092170,True,0,No user reviews,0,0,0
1092180,True,0,1 user reviews,0,1,1
1092190,True,0,2 user reviews,0,2,2
1092200,True,0,No user reviews,0,0,0
1092210,True,5,Mixed,11,9,20
1092260,True,0,4 user reviews,3,1,4
1092270,True,0,No user reviews,0,0,0
1092291,True,0,3 user reviews,3,0,3
1092300,True,0,2 user reviews,0,2,2
1092310,True,0,No user reviews,0,0,0
1092330,True,7,Positive,8,2,10
1092400,True,0,No user reviews,0,0,0
1092430,True,6,Mostly Positive,134,34,168
1092490,True,0,No user reviews,0,0,0
1092500,True,0,No user reviews,0,0,0
1092510,True,0,3 user reviews,3,0,3
1092520,True,0,No user reviews,0,0,0
1092530,True,0,No user reviews,0,0,0
1092560,True,0,No user reviews,0,0,0
1092580,True,0,No user reviews,0,0,0
1092590,True,0,9 user reviews,9,0,9
1092630,True,7,Positive,31,1,32
1092640,True,0,1 user reviews,0,1,1
1092650,True,0,2 user reviews,1,1,2
1092660,True,6,Mostly Positive,1140,367,1507
1092680,True,0,No user reviews,0,0,0
1092690,True,0,1 user reviews,1,0,1
1092691,True,0,No user reviews,0,0,0
1092692,True,0,No user reviews,0,0,0
1092693,True,0,1 user reviews,1,0,1
1092694,True,0,No user reviews,0,0,0
1092695,True,0,2 user reviews,2,0,2
1092700,True,0,No user reviews,0,0,0
1092710,True,0,No user reviews,0,0,0
1092720,True,0,No user reviews,0,0,0
1092730,True,0,No user reviews,0,0,0
1092750,True,0,No user reviews,0,0,0
1092760,True,0,No user reviews,0,0,0
1092770,True,0,7 user reviews,6,1,7
1092780,True,7,Positive,17,2,19
1092790,True,0,No user reviews,0,0,0
1092800,True,7,Positive,14,0,14
1092810,True,0,No user reviews,0,0,0
1092820,True,0,No user reviews,0,0,0
1092830,True,0,1 user reviews,1,0,1
1092840,True,7,Positive,26,1,27
1092850,True,0,1 user reviews,1,0,1
1092870,True,0,No user reviews,0,0,0
1092880,True,7,Positive,27,2,29
1092890,True,0,No user reviews,0,0,0
1092900,True,0,No user reviews,0,0,0
1092940,True,0,No user reviews,0,0,0
1092950,True,0,No user reviews,0,0,0
1092960,True,0,No user reviews,0,0,0
1092980,True,6,Mostly Positive,13,4,17
1093020,True,0,No user reviews,0,0,0
1093040,True,0,1 user reviews,1,0,1
1093060,True,0,No user reviews,0,0,0
1093090,True,0,No user reviews,0,0,0
1093100,True,0,No user reviews,0,0,0
1093120,True,0,2 user reviews,2,0,2
1093130,True,0,5 user reviews,5,0,5
1093150,True,0,8 user reviews,7,1,8
1093170,True,0,No user reviews,0,0,0
1093180,True,0,No user reviews,0,0,0
1093190,True,0,No user reviews,0,0,0
1093200,True,0,No user reviews,0,0,0
1093210,True,0,No user reviews,0,0,0
1093220,True,0,No user reviews,0,0,0
1093250,True,0,No user reviews,0,0,0
1093260,True,0,2 user reviews,2,0,2
1093270,True,0,2 user reviews,0,2,2
1093280,True,0,1 user reviews,1,0,1
1093290,True,0,No user reviews,0,0,0
1093300,True,0,6 user reviews,5,1,6
1093310,True,0,4 user reviews,1,3,4
1093320,True,5,Mixed,17,10,27
1093330,True,8,Very Positive,213,18,231
1093340,True,0,No user reviews,0,0,0
1093360,True,7,Positive,16,1,17
1093370,True,0,8 user reviews,7,1,8
1093400,True,7,Positive,28,0,28
1093410,True,0,No user reviews,0,0,0
1093430,True,0,1 user reviews,1,0,1
1093431,True,0,No user reviews,0,0,0
1093460,True,0,No user reviews,0,0,0
1093500,True,0,No user reviews,0,0,0
1093520,True,7,Positive,26,1,27
1093540,True,0,No user reviews,0,0,0
1093670,True,0,9 user reviews,8,1,9
1093690,True,0,No user reviews,0,0,0
1093700,True,8,Very Positive,108,18,126
1093720,True,0,No user reviews,0,0,0
1093730,True,6,Mostly Positive,83,27,110
1093740,True,0,No user reviews,0,0,0
1093750,True,0,No user reviews,0,0,0
1093760,True,6,Mostly Positive,11,4,15
1093770,True,0,No user reviews,0,0,0
1093790,True,7,Positive,14,3,17
1093800,True,0,7 user reviews,7,0,7
1093810,True,0,No user reviews,0,0,0
1093820,True,0,No user reviews,0,0,0
1093830,True,0,No user reviews,0,0,0
1093840,True,0,No user reviews,0,0,0
1093850,True,0,No user reviews,0,0,0
1093860,True,0,No user reviews,0,0,0
1093870,True,0,No user reviews,0,0,0
1093880,True,5,Mixed,6,5,11
1093900,True,0,No user reviews,0,0,0
1093910,True,8,Very Positive,113,2,115
1093920,True,7,Positive,13,0,13
1093940,True,0,No user reviews,0,0,0
1093941,True,0,No user reviews,0,0,0
1093950,True,0,3 user reviews,3,0,3
1093980,True,0,No user reviews,0,0,0
1093990,True,0,1 user reviews,0,1,1
1094000,True,5,Mixed,50,37,87
1094010,True,0,No user reviews,0,0,0
1094020,True,0,No user reviews,0,0,0
1094030,True,0,1 user reviews,0,1,1
1094040,True,0,No user reviews,0,0,0
1094050,True,6,Mostly Positive,12,4,16
1094060,True,5,Mixed,37,25,62
1094070,True,0,6 user reviews,5,1,6
1094080,True,0,No user reviews,0,0,0
1094090,True,0,No user reviews,0,0,0
1094100,True,0,2 user reviews,1,1,2
1094110,True,0,7 user reviews,5,2,7
1094120,True,0,No user reviews,0,0,0
1094130,True,0,2 user reviews,2,0,2
1094160,True,0,No user reviews,0,0,0
1094170,True,0,No user reviews,0,0,0
1094180,True,0,No user reviews,0,0,0
1094181,True,0,No user reviews,0,0,0
1094182,True,0,No user reviews,0,0,0
1094183,True,0,No user reviews,0,0,0
1094184,True,0,No user reviews,0,0,0
1094185,True,0,No user reviews,0,0,0
1094186,True,0,No user reviews,0,0,0
1094187,True,0,No user reviews,0,0,0
1094190,True,0,1 user reviews,0,1,1
1094200,True,0,1 user reviews,1,0,1
1094210,True,0,No user reviews,0,0,0
1094220,True,0,No user reviews,0,0,0
1094240,True,0,No user reviews,0,0,0
1094250,True,7,Positive,31,3,34
1094280,True,0,No user reviews,0,0,0
1094281,True,0,1 user reviews,1,0,1
1094283,True,0,No user reviews,0,0,0
1094290,True,0,No user reviews,0,0,0
1094300,True,0,No user reviews,0,0,0
1094320,True,0,4 user reviews,2,2,4
1094330,True,0,No user reviews,0,0,0
1094340,True,0,6 user reviews,5,1,6
1094350,True,0,No user reviews,0,0,0
1094390,True,8,Very Positive,63,7,70
1094400,True,0,No user reviews,0,0,0
1094420,True,8,Very Positive,66,3,69
1094430,True,0,No user reviews,0,0,0
1094440,True,0,4 user reviews,3,1,4
1094450,True,0,No user reviews,0,0,0
1094460,True,0,No user reviews,0,0,0
1094480,True,0,No user reviews,0,0,0
1094490,True,0,1 user reviews,1,0,1
1094500,True,0,No user reviews,0,0,0
1094520,True,8,Very Positive,360,48,408
1094530,True,0,4 user reviews,4,0,4
1094540,True,0,No user reviews,0,0,0
1094550,True,0,No user reviews,0,0,0
1094560,True,0,No user reviews,0,0,0
1094580,True,0,No user reviews,0,0,0
1094590,True,0,No user reviews,0,0,0
1094600,True,0,No user reviews,0,0,0
1094620,True,0,No user reviews,0,0,0
1094630,True,0,No user reviews,0,0,0
1094640,True,0,8 user reviews,5,3,8
1094650,True,0,No user reviews,0,0,0
1094660,True,4,Mostly Negative,3,9,12
1094670,True,0,No user reviews,0,0,0
1094690,True,0,2 user reviews,2,0,2
1094700,True,0,No user reviews,0,0,0
1094710,True,0,No user reviews,0,0,0
1094720,True,0,No user reviews,0,0,0
1094730,True,0,No user reviews,0,0,0
1094740,True,0,1 user reviews,1,0,1
1094760,True,5,Mixed,12,10,22
1094780,True,8,Very Positive,185,25,210
1094800,True,0,No user reviews,0,0,0
1094810,True,0,No user reviews,0,0,0
1094820,True,7,Positive,16,0,16
1094840,True,0,1 user reviews,1,0,1
1094860,True,0,No user reviews,0,0,0
1094870,True,7,Positive,27,3,30
1094880,True,5,Mixed,10,6,16
1094900,True,0,No user reviews,0,0,0
1094920,True,0,No user reviews,0,0,0
1094930,True,0,5 user reviews,5,0,5
1094940,True,0,No user reviews,0,0,0
1094960,True,7,Positive,16,0,16
1095030,True,7,Positive,20,2,22
1095031,True,5,Mixed,10,5,15
1095040,True,0,No user reviews,0,0,0
1095050,True,0,No user reviews,0,0,0
1095060,True,0,No user reviews,0,0,0
1095070,True,0,3 user reviews,0,3,3
1095080,True,0,No user reviews,0,0,0
1095090,True,0,No user reviews,0,0,0
1095120,True,7,Positive,32,1,33
1095140,True,0,2 user reviews,2,0,2
1095200,True,0,No user reviews,0,0,0
1095230,True,0,1 user reviews,1,0,1
1095250,True,0,1 user reviews,1,0,1
1095260,True,0,No user reviews,0,0,0
1095270,True,0,No user reviews,0,0,0
1095280,True,0,2 user reviews,0,2,2
1095290,True,0,No user reviews,0,0,0
1095300,True,0,No user reviews,0,0,0
1095310,True,0,No user reviews,0,0,0
1095320,True,0,5 user reviews,5,0,5
1095360,True,0,1 user reviews,1,0,1
1095370,True,0,4 user reviews,4,0,4
1095380,True,0,3 user reviews,2,1,3
1095390,True,0,No user reviews,0,0,0
1095400,True,0,No user reviews,0,0,0
1095450,True,0,No user reviews,0,0,0
1095470,True,0,No user reviews,0,0,0
1095480,True,0,No user reviews,0,0,0
1095500,True,0,5 user reviews,4,1,5
1095520,True,0,No user reviews,0,0,0
1095540,True,0,2 user reviews,1,1,2
1095550,True,0,1 user reviews,1,0,1
1095560,True,0,No user reviews,0,0,0
1095580,True,0,No user reviews,0,0,0
1095590,True,0,No user reviews,0,0,0
1095610,True,0,No user reviews,0,0,0
1095621,True,0,No user reviews,0,0,0
1095622,True,0,No user reviews,0,0,0
1095624,True,0,No user reviews,0,0,0
1095626,True,0,No user reviews,0,0,0
1095650,True,0,3 user reviews,0,3,3
1095680,True,0,No user reviews,0,0,0
1095690,True,0,No user reviews,0,0,0
1095700,True,0,7 user reviews,4,3,7
1095710,True,6,Mostly Positive,7,3,10
1095720,True,0,No user reviews,0,0,0
1095721,True,0,No user reviews,0,0,0
1095730,True,0,No user reviews,0,0,0
1095740,True,0,No user reviews,0,0,0
1095750,True,0,6 user reviews,5,1,6
1095760,True,0,No user reviews,0,0,0
1095770,True,0,1 user reviews,1,0,1
1095780,True,0,3 user reviews,3,0,3
1095790,True,0,1 user reviews,1,0,1
1095810,True,0,No user reviews,0,0,0
1095820,True,0,2 user reviews,2,0,2
1095830,True,0,No user reviews,0,0,0
1095840,True,0,5 user reviews,5,0,5
1095850,True,0,1 user reviews,1,0,1
1095860,True,0,1 user reviews,1,0,1
1095870,True,0,No user reviews,0,0,0
1095880,True,0,No user reviews,0,0,0
1095910,True,0,No user reviews,0,0,0
1095960,True,0,No user reviews,0,0,0
1095980,True,0,No user reviews,0,0,0
1095990,True,0,No user reviews,0,0,0
1096000,True,0,6 user reviews,5,1,6
1096010,True,5,Mixed,14,10,24
1096020,True,0,2 user reviews,2,0,2
1096030,True,0,No user reviews,0,0,0
1096040,True,0,No user reviews,0,0,0
1096060,True,7,Positive,23,0,23
1096080,True,0,No user reviews,0,0,0
1096081,True,0,No user reviews,0,0,0
1096090,True,0,No user reviews,0,0,0
1096100,True,0,No user reviews,0,0,0
1096120,True,0,1 user reviews,0,1,1
1096130,True,0,1 user reviews,0,1,1
1096140,True,0,No user reviews,0,0,0
1096180,True,7,Positive,12,0,12
1096200,True,0,No user reviews,0,0,0
1096210,True,7,Positive,15,3,18
1096220,True,0,No user reviews,0,0,0
1096230,True,0,5 user reviews,4,1,5
1096240,True,0,3 user reviews,2,1,3
1096250,True,0,No user reviews,0,0,0
1096270,True,0,No user reviews,0,0,0
1096290,True,0,No user reviews,0,0,0
1096300,True,0,5 user reviews,2,3,5
1096310,True,0,No user reviews,0,0,0
1096320,True,0,No user reviews,0,0,0
1096321,True,0,No user reviews,0,0,0
1096330,True,0,No user reviews,0,0,0
1096340,True,0,1 user reviews,1,0,1
1096350,True,0,No user reviews,0,0,0
1096360,True,0,No user reviews,0,0,0
1096410,True,5,Mixed,434,197,631
1096420,True,0,2 user reviews,2,0,2
1096430,True,0,2 user reviews,0,2,2
1096450,True,0,No user reviews,0,0,0
1096451,True,0,No user reviews,0,0,0
1096460,True,0,No user reviews,0,0,0
1096510,True,0,7 user reviews,4,3,7
1096520,True,8,Very Positive,212,45,257
1096530,True,8,Very Positive,754,46,800
1096540,True,4,Mostly Negative,3,7,10
1096550,True,8,Very Positive,79,14,93
1096560,True,5,Mixed,16,7,23
1096570,True,8,Very Positive,342,66,408
1096580,True,5,Mixed,10,13,23
1096590,True,0,No user reviews,0,0,0
1096600,True,0,2 user reviews,2,0,2
1096610,True,6,Mostly Positive,32,10,42
1096630,True,0,6 user reviews,3,3,6
1096640,True,0,No user reviews,0,0,0
1096650,True,0,No user reviews,0,0,0
1096660,True,0,No user reviews,0,0,0
1096680,True,0,No user reviews,0,0,0
1096690,True,0,8 user reviews,7,1,8
1096710,True,0,No user reviews,0,0,0
1096720,True,8,Very Positive,121,28,149
1096730,True,5,Mixed,24,15,39
1096750,True,0,5 user reviews,4,1,5
1096820,True,0,No user reviews,0,0,0
1096830,True,0,1 user reviews,0,1,1
1096890,True,0,1 user reviews,1,0,1
1096900,True,5,Mixed,88,43,131
1096910,True,0,4 user reviews,1,3,4
1096930,True,8,Very Positive,58,6,64
1096940,True,0,2 user reviews,2,0,2
1096950,True,0,4 user reviews,2,2,4
1096960,True,0,1 user reviews,1,0,1
1096970,True,0,4 user reviews,1,3,4
1096980,True,0,6 user reviews,5,1,6
1097000,True,0,No user reviews,0,0,0
1097080,True,0,No user reviews,0,0,0
1097090,True,0,4 user reviews,1,3,4
1097100,True,0,No user reviews,0,0,0
1097110,True,7,Positive,34,3,37
1097120,True,0,4 user reviews,3,1,4
1097130,True,0,No user reviews,0,0,0
1097140,True,0,No user reviews,0,0,0
1097150,True,8,Very Positive,79879,13994,93873
1097160,True,0,2 user reviews,2,0,2
1097170,True,7,Positive,23,2,25
1097180,True,5,Mixed,6,4,10
1097190,True,0,No user reviews,0,0,0
1097200,True,0,No user reviews,0,0,0
1097210,True,6,Mostly Positive,11,3,14
1097223,True,0,No user reviews,0,0,0
1097240,True,6,Mostly Positive,23,9,32
1097260,True,0,No user reviews,0,0,0
1097270,True,0,3 user reviews,3,0,3
1097290,True,0,No user reviews,0,0,0
1097300,True,0,No user reviews,0,0,0
1097310,True,0,4 user reviews,1,3,4
1097320,True,0,No user reviews,0,0,0
1097330,True,0,5 user reviews,5,0,5
1097340,True,0,No user reviews,0,0,0
1097350,True,0,No user reviews,0,0,0
1097360,True,0,No user reviews,0,0,0
1097370,True,7,Positive,20,4,24
1097390,True,0,No user reviews,0,0,0
1097391,True,0,No user reviews,0,0,0
1097400,True,0,No user reviews,0,0,0
1097420,True,5,Mixed,15,8,23
1097430,True,0,No user reviews,0,0,0
1097440,True,0,No user reviews,0,0,0
1097450,True,0,No user reviews,0,0,0
1097470,True,0,No user reviews,0,0,0
1097480,True,0,No user reviews,0,0,0
1097500,True,0,No user reviews,0,0,0
1097510,True,0,No user reviews,0,0,0
1097520,True,6,Mostly Positive,9,3,12
1097530,True,8,Very Positive,175,19,194
1097550,True,0,2 user reviews,2,0,2
1097560,True,0,No user reviews,0,0,0
1097570,True,0,2 user reviews,2,0,2
1097580,True,8,Very Positive,270,52,322
1097590,True,0,1 user reviews,0,1,1
1097600,True,0,3 user reviews,0,3,3
1097620,True,8,Very Positive,109,24,133
1097630,True,0,No user reviews,0,0,0
1097640,True,0,No user reviews,0,0,0
1097650,True,0,No user reviews,0,0,0
1097670,True,7,Positive,8,2,10
1097680,True,0,No user reviews,0,0,0
1097690,True,0,4 user reviews,0,4,4
1097700,True,0,No user reviews,0,0,0
1097710,True,0,8 user reviews,7,1,8
1097720,True,0,No user reviews,0,0,0
1097750,True,7,Positive,23,0,23
1097760,True,0,4 user reviews,4,0,4
1097770,True,0,8 user reviews,8,0,8
1097780,True,7,Positive,20,0,20
1097790,True,6,Mostly Positive,38,10,48
1097800,True,8,Very Positive,162,29,191
1097810,True,7,Positive,14,1,15
1097820,True,0,No user reviews,0,0,0
1097830,True,0,No user reviews,0,0,0
1097840,True,5,Mixed,2437,1157,3594
1097860,True,0,No user reviews,0,0,0
1097870,True,0,4 user reviews,4,0,4
1097880,True,8,Very Positive,213,48,261
1097890,True,0,No user reviews,0,0,0
1097891,True,0,No user reviews,0,0,0
1097892,True,0,No user reviews,0,0,0
1097893,True,0,No user reviews,0,0,0
1097894,True,0,No user reviews,0,0,0
1097895,True,0,No user reviews,0,0,0
1097896,True,0,2 user reviews,0,2,2
1097900,True,0,2 user reviews,2,0,2
1097910,True,0,No user reviews,0,0,0
1097960,True,5,Mixed,49,23,72
1097970,True,0,No user reviews,0,0,0
1097980,True,0,No user reviews,0,0,0
1097990,True,0,No user reviews,0,0,0
1098000,True,0,No user reviews,0,0,0
1098020,True,0,No user reviews,0,0,0
1098040,True,0,No user reviews,0,0,0
1098050,True,0,No user reviews,0,0,0
1098060,True,0,No user reviews,0,0,0
1098080,True,8,Very Positive,53,8,61
1098090,True,0,7 user reviews,6,1,7
1098100,True,6,Mostly Positive,44,17,61
1098120,True,5,Mixed,52,24,76
1098140,True,0,2 user reviews,1,1,2
1098150,True,0,No user reviews,0,0,0
1098160,True,0,No user reviews,0,0,0
1098161,True,0,2 user reviews,2,0,2
1098162,True,0,3 user reviews,3,0,3
1098163,True,0,7 user reviews,2,5,7
1098165,True,0,2 user reviews,2,0,2
1098166,True,0,5 user reviews,1,4,5
1098167,True,0,6 user reviews,6,0,6
1098170,True,8,Very Positive,88,11,99
1098180,True,0,No user reviews,0,0,0
1098190,True,0,No user reviews,0,0,0
1098200,True,5,Mixed,6,7,13
1098210,True,6,Mostly Positive,73,31,104
1098220,True,0,2 user reviews,2,0,2
1098230,True,0,No user reviews,0,0,0
1098240,True,0,No user reviews,0,0,0
1098250,True,0,3 user reviews,3,0,3
1098270,True,0,No user reviews,0,0,0
1098280,True,0,No user reviews,0,0,0
1098290,True,0,No user reviews,0,0,0
1098291,True,7,Positive,11,1,12
1098292,True,8,Very Positive,849,174,1023
1098300,True,6,Mostly Positive,39,11,50
1098301,True,0,No user reviews,0,0,0
1098310,True,0,No user reviews,0,0,0
1098320,True,0,No user reviews,0,0,0
1098340,True,8,Very Positive,173,9,182
1098350,True,0,No user reviews,0,0,0
1098360,True,0,1 user reviews,1,0,1
1098370,True,8,Very Positive,50,2,52
1098390,True,0,No user reviews,0,0,0
1098420,True,7,Positive,24,1,25
1098430,True,0,2 user reviews,0,2,2
1098440,True,0,1 user reviews,1,0,1
1098480,True,0,No user reviews,0,0,0
1098490,True,0,4 user reviews,3,1,4
1098500,True,0,No user reviews,0,0,0
1098510,True,5,Mixed,9,4,13
1098520,True,5,Mixed,7,9,16
1098530,True,0,2 user reviews,0,2,2
1098540,True,0,4 user reviews,2,2,4
1098560,True,0,1 user reviews,1,0,1
1098570,True,0,No user reviews,0,0,0
1098580,True,0,No user reviews,0,0,0
1098590,True,0,No user reviews,0,0,0
1098620,True,0,No user reviews,0,0,0
1098640,True,0,3 user reviews,1,2,3
1098650,True,0,1 user reviews,0,1,1
1098660,True,0,No user reviews,0,0,0
1098670,True,0,3 user reviews,1,2,3
1098680,True,0,2 user reviews,2,0,2
1098700,True,0,6 user reviews,6,0,6
1098720,True,0,7 user reviews,6,1,7
1098730,True,0,3 user reviews,2,1,3
1098750,True,0,No user reviews,0,0,0
1098760,True,0,5 user reviews,2,3,5
1098770,True,0,No user reviews,0,0,0
1098780,True,0,No user reviews,0,0,0
1098790,True,5,Mixed,8,9,17
1098810,True,0,No user reviews,0,0,0
1098820,True,0,1 user reviews,1,0,1
1098840,True,0,No user reviews,0,0,0
1098870,True,0,4 user reviews,1,3,4
1098880,True,0,No user reviews,0,0,0
1098910,True,0,No user reviews,0,0,0
1098920,True,0,No user reviews,0,0,0
1098930,True,0,No user reviews,0,0,0
1098940,True,5,Mixed,81,39,120
1098950,True,0,No user reviews,0,0,0
1098970,True,0,No user reviews,0,0,0
1098980,True,0,1 user reviews,0,1,1
1099000,True,0,No user reviews,0,0,0
1099010,True,0,4 user reviews,3,1,4
1099070,True,0,1 user reviews,0,1,1
1099090,True,0,4 user reviews,3,1,4
1099100,True,0,No user reviews,0,0,0
1099110,True,0,No user reviews,0,0,0
1099120,True,0,1 user reviews,1,0,1
1099121,True,0,No user reviews,0,0,0
1099122,True,0,2 user reviews,0,2,2
1099130,True,0,No user reviews,0,0,0
1099140,True,0,2 user reviews,1,1,2
1099170,True,7,Positive,15,1,16
1099190,True,0,No user reviews,0,0,0
1099191,True,0,No user reviews,0,0,0
1099200,True,0,No user reviews,0,0,0
1099201,True,0,No user reviews,0,0,0
1099202,True,0,1 user reviews,1,0,1
1099203,True,0,No user reviews,0,0,0
1099210,True,0,1 user reviews,1,0,1
1099211,True,0,1 user reviews,1,0,1
1099212,True,0,No user reviews,0,0,0
1099213,True,0,1 user reviews,1,0,1
1099214,True,0,No user reviews,0,0,0
1099215,True,0,No user reviews,0,0,0
1099216,True,0,No user reviews,0,0,0
1099220,True,0,No user reviews,0,0,0
1099230,True,0,No user reviews,0,0,0
1099231,True,0,No user reviews,0,0,0
1099232,True,0,No user reviews,0,0,0
1099233,True,0,No user reviews,0,0,0
1099240,True,0,No user reviews,0,0,0
1099241,True,0,No user reviews,0,0,0
1099260,True,0,No user reviews,0,0,0
1099261,True,0,No user reviews,0,0,0
1099262,True,0,No user reviews,0,0,0
1099263,True,0,No user reviews,0,0,0
1099264,True,0,No user reviews,0,0,0
1099270,True,0,No user reviews,0,0,0
1099271,True,0,No user reviews,0,0,0
1099272,True,0,No user reviews,0,0,0
1099273,True,0,No user reviews,0,0,0
1099280,True,0,No user reviews,0,0,0
1099281,True,0,No user reviews,0,0,0
1099282,True,0,No user reviews,0,0,0
1099283,True,0,No user reviews,0,0,0
1099290,True,0,No user reviews,0,0,0
1099291,True,0,No user reviews,0,0,0
1099292,True,0,No user reviews,0,0,0
1099293,True,0,No user reviews,0,0,0
1099294,True,0,No user reviews,0,0,0
1099300,True,0,No user reviews,0,0,0
1099301,True,0,No user reviews,0,0,0
1099302,True,0,No user reviews,0,0,0
1099303,True,0,No user reviews,0,0,0
1099304,True,0,No user reviews,0,0,0
1099305,True,0,No user reviews,0,0,0
1099310,True,0,No user reviews,0,0,0
1099311,True,0,No user reviews,0,0,0
1099312,True,0,No user reviews,0,0,0
1099313,True,0,No user reviews,0,0,0
1099314,True,0,No user reviews,0,0,0
1099315,True,0,No user reviews,0,0,0
1099316,True,0,No user reviews,0,0,0
1099320,True,0,No user reviews,0,0,0
1099330,True,0,No user reviews,0,0,0
1099340,True,0,No user reviews,0,0,0
1099341,True,0,No user reviews,0,0,0
1099342,True,0,No user reviews,0,0,0
1099343,True,0,No user reviews,0,0,0
1099344,True,0,No user reviews,0,0,0
1099345,True,0,1 user reviews,1,0,1
1099350,True,0,No user reviews,0,0,0
1099351,True,0,No user reviews,0,0,0
1099352,True,0,No user reviews,0,0,0
1099360,True,0,No user reviews,0,0,0
1099361,True,0,No user reviews,0,0,0
1099362,True,0,No user reviews,0,0,0
1099363,True,0,No user reviews,0,0,0
1099364,True,0,No user reviews,0,0,0
1099365,True,0,No user reviews,0,0,0
1099370,True,0,No user reviews,0,0,0
1099371,True,0,No user reviews,0,0,0
1099372,True,0,No user reviews,0,0,0
1099373,True,0,No user reviews,0,0,0
1099380,True,0,No user reviews,0,0,0
1099390,True,0,No user reviews,0,0,0
1099391,True,0,2 user reviews,2,0,2
1099392,True,0,No user reviews,0,0,0
1099393,True,0,No user reviews,0,0,0
1099400,True,0,No user reviews,0,0,0
1099420,True,0,No user reviews,0,0,0
1099421,True,0,No user reviews,0,0,0
1099422,True,0,No user reviews,0,0,0
1099440,True,7,Positive,20,5,25
1099450,True,0,9 user reviews,5,4,9
1099460,True,0,7 user reviews,5,2,7
1099470,True,0,No user reviews,0,0,0
1099490,True,0,No user reviews,0,0,0
1099500,True,7,Positive,46,2,48
1099510,True,0,No user reviews,0,0,0
1099520,True,0,No user reviews,0,0,0
1099530,True,7,Positive,10,2,12
1099540,True,0,No user reviews,0,0,0
1099550,True,0,No user reviews,0,0,0
1099560,True,0,9 user reviews,7,2,9
1099561,True,7,Positive,11,2,13
1099562,True,0,6 user reviews,2,4,6
1099563,True,7,Positive,8,2,10
1099570,True,0,No user reviews,0,0,0
1099580,True,0,2 user reviews,0,2,2
1099581,True,0,8 user reviews,4,4,8
1099582,True,0,7 user reviews,3,4,7
1099583,True,0,3 user reviews,1,2,3
1099584,True,5,Mixed,8,5,13
1099585,True,0,6 user reviews,2,4,6
1099590,True,0,3 user reviews,3,0,3
1099591,True,0,No user reviews,0,0,0
1099592,True,7,Positive,10,0,10
1099593,True,0,No user reviews,0,0,0
1099594,True,0,6 user reviews,6,0,6
1099595,True,0,No user reviews,0,0,0
1099597,True,0,No user reviews,0,0,0
1099600,True,0,No user reviews,0,0,0
1099610,True,0,No user reviews,0,0,0
1099620,True,0,1 user reviews,1,0,1
1099630,True,0,7 user reviews,4,3,7
1099640,True,0,No user reviews,0,0,0
1099650,True,0,No user reviews,0,0,0
1099660,True,0,3 user reviews,3,0,3
1099760,True,0,No user reviews,0,0,0
1099780,True,0,No user reviews,0,0,0
1099790,True,0,No user reviews,0,0,0
1099830,True,4,Mostly Negative,4,10,14
1099840,True,0,7 user reviews,5,2,7
1099850,True,0,No user reviews,0,0,0
1099900,True,0,No user reviews,0,0,0
1099910,True,0,No user reviews,0,0,0
1099920,True,6,Mostly Positive,23,7,30
1099930,True,0,No user reviews,0,0,0
1099960,True,7,Positive,17,4,21
1099980,True,0,No user reviews,0,0,0
1099990,True,0,No user reviews,0,0,0
1100020,True,0,No user reviews,0,0,0
1100030,True,0,No user reviews,0,0,0
1100040,True,0,No user reviews,0,0,0
1100050,True,0,1 user reviews,1,0,1
1100070,True,0,2 user reviews,1,1,2
1100080,True,0,No user reviews,0,0,0
1100090,True,0,No user reviews,0,0,0
1100100,True,0,No user reviews,0,0,0
1100110,True,8,Very Positive,111,17,128
1100120,True,0,No user reviews,0,0,0
1100130,True,0,1 user reviews,1,0,1
1100140,True,7,Positive,35,0,35
1100150,True,7,Positive,33,0,33
1100160,True,7,Positive,10,1,11
1100170,True,0,7 user reviews,7,0,7
1100180,True,7,Positive,10,0,10
1100200,True,7,Positive,10,0,10
1100210,True,0,1 user reviews,1,0,1
1100220,True,0,No user reviews,0,0,0
1100250,True,4,Mostly Negative,11,19,30
1100260,True,8,Very Positive,145,19,164
1100270,True,0,No user reviews,0,0,0
1100280,True,0,No user reviews,0,0,0
1100290,True,0,No user reviews,0,0,0
1100300,True,0,5 user reviews,5,0,5
1100310,True,0,No user reviews,0,0,0
1100320,True,0,No user reviews,0,0,0
1100330,True,0,No user reviews,0,0,0
1100340,True,0,No user reviews,0,0,0
1100350,True,0,5 user reviews,5,0,5
1100380,True,0,No user reviews,0,0,0
1100410,True,5,Mixed,105,110,215
1100420,True,8,Very Positive,82,10,92
1100430,True,7,Positive,26,1,27
1100480,True,0,No user reviews,0,0,0
1100510,True,0,No user reviews,0,0,0
1100550,True,0,3 user reviews,2,1,3
1100560,True,0,2 user reviews,2,0,2
1100580,True,0,No user reviews,0,0,0
1100600,True,8,Very Positive,5553,608,6161
1100620,True,8,Very Positive,223,40,263
1100720,True,0,No user reviews,0,0,0
1100730,True,0,No user reviews,0,0,0
1100750,True,5,Mixed,64,78,142
1100760,True,0,No user reviews,0,0,0
1100770,True,0,No user reviews,0,0,0
1100780,True,0,No user reviews,0,0,0
1100781,True,0,2 user reviews,0,2,2
1100782,True,0,No user reviews,0,0,0
1100783,True,0,No user reviews,0,0,0
1100784,True,0,1 user reviews,0,1,1
1100785,True,0,No user reviews,0,0,0
1100787,True,0,No user reviews,0,0,0
1100788,True,0,No user reviews,0,0,0
1100789,True,0,No user reviews,0,0,0
1100790,True,0,No user reviews,0,0,0
1100791,True,0,No user reviews,0,0,0
1100792,True,0,No user reviews,0,0,0
1100793,True,0,2 user reviews,0,2,2
1100794,True,0,No user reviews,0,0,0
1100795,True,0,No user reviews,0,0,0
1100796,True,0,No user reviews,0,0,0
1100797,True,0,No user reviews,0,0,0
1100800,True,7,Positive,30,0,30
1100810,True,0,No user reviews,0,0,0
1100830,True,0,8 user reviews,4,4,8
1100840,True,0,No user reviews,0,0,0
1100880,True,0,No user reviews,0,0,0
1100900,True,0,4 user reviews,3,1,4
1100910,True,0,No user reviews,0,0,0
1100920,True,0,4 user reviews,2,2,4
1100930,True,6,Mostly Positive,12,5,17
1100960,True,7,Positive,9,1,10
1100970,True,6,Mostly Positive,19,5,24
1100990,True,8,Very Positive,491,34,525
1101000,True,0,3 user reviews,1,2,3
1101050,True,0,No user reviews,0,0,0
1101060,True,0,No user reviews,0,0,0
1101080,True,0,4 user reviews,3,1,4
1101100,True,0,2 user reviews,1,1,2
1101110,True,0,No user reviews,0,0,0
1101120,True,0,No user reviews,0,0,0
1101130,True,6,Mostly Positive,18,5,23
1101140,True,8,Very Positive,151,12,163
1101150,True,0,No user reviews,0,0,0
1101160,True,0,No user reviews,0,0,0
1101170,True,0,No user reviews,0,0,0
1101180,True,0,9 user reviews,9,0,9
1101190,True,6,Mostly Positive,851,319,1170
1101200,True,0,1 user reviews,1,0,1
1101220,True,0,2 user reviews,2,0,2
1101260,True,8,Very Positive,82,13,95
1101270,True,7,Positive,14,3,17
1101290,True,0,No user reviews,0,0,0
1101300,True,7,Positive,26,0,26
1101310,True,0,1 user reviews,1,0,1
1101330,True,0,No user reviews,0,0,0
1101340,True,0,No user reviews,0,0,0
1101350,True,7,Positive,32,1,33
1101351,True,7,Positive,39,0,39
1101360,True,5,Mixed,38,20,58
1101370,True,0,No user reviews,0,0,0
1101380,True,0,No user reviews,0,0,0
1101390,True,0,No user reviews,0,0,0
1101400,True,0,No user reviews,0,0,0
1101410,True,0,No user reviews,0,0,0
1101420,True,7,Positive,8,2,10
1101450,True,8,Very Positive,216,19,235
1101480,True,0,No user reviews,0,0,0
1101530,True,0,No user reviews,0,0,0
1101560,True,0,No user reviews,0,0,0
1101570,True,0,2 user reviews,0,2,2
1101580,True,0,No user reviews,0,0,0
1101590,True,0,No user reviews,0,0,0
1101630,True,0,No user reviews,0,0,0
1101660,True,0,4 user reviews,3,1,4
1101670,True,0,No user reviews,0,0,0
1101710,True,0,3 user reviews,2,1,3
1101711,True,0,4 user reviews,4,0,4
1101720,True,7,Positive,15,2,17
1101740,True,0,No user reviews,0,0,0
1101750,True,0,4 user reviews,1,3,4
1101760,True,5,Mixed,15,7,22
1101770,True,0,3 user reviews,3,0,3
1101780,True,0,6 user reviews,2,4,6
1101790,True,0,No user reviews,0,0,0
1101800,True,0,7 user reviews,7,0,7
1101810,True,0,No user reviews,0,0,0
1101830,True,0,No user reviews,0,0,0
1101840,True,0,1 user reviews,1,0,1
1101850,True,0,1 user reviews,1,0,1
1101860,True,0,No user reviews,0,0,0
1101870,True,0,No user reviews,0,0,0
1101880,True,0,No user reviews,0,0,0
1101890,True,0,No user reviews,0,0,0
1101910,True,0,No user reviews,0,0,0
1101930,True,7,Positive,13,3,16
1101940,True,0,4 user reviews,2,2,4
1101960,True,0,1 user reviews,1,0,1
1101970,True,5,Mixed,9,6,15
1101980,True,0,No user reviews,0,0,0
1102000,True,0,1 user reviews,1,0,1
1102010,True,0,No user reviews,0,0,0
1102030,True,0,No user reviews,0,0,0
1102040,True,0,6 user reviews,5,1,6
1102060,True,0,3 user reviews,2,1,3
1102080,True,0,7 user reviews,7,0,7
1102090,True,0,No user reviews,0,0,0
1102100,True,6,Mostly Positive,50,17,67
1102110,True,0,No user reviews,0,0,0
1102120,True,0,No user reviews,0,0,0
1102130,True,8,Very Positive,583,58,641
1102150,True,0,2 user reviews,1,1,2
1102160,True,0,No user reviews,0,0,0
1102170,True,0,No user reviews,0,0,0
1102180,True,0,No user reviews,0,0,0
1102190,True,9,Overwhelmingly Positive,5710,136,5846
1102200,True,0,3 user reviews,2,1,3
1102210,True,0,No user reviews,0,0,0
1102230,True,0,1 user reviews,1,0,1
1102250,True,0,7 user reviews,4,3,7
1102260,True,0,7 user reviews,5,2,7
1102280,True,0,No user reviews,0,0,0
1102300,True,0,No user reviews,0,0,0
1102310,True,5,Mixed,142,146,288
1102320,True,0,1 user reviews,1,0,1
1102321,True,0,No user reviews,0,0,0
1102322,True,0,No user reviews,0,0,0
1102323,True,0,No user reviews,0,0,0
1102340,True,7,Positive,16,0,16
1102360,True,0,4 user reviews,2,2,4
1102370,True,7,Positive,10,1,11
1102380,True,7,Positive,14,2,16
1102390,True,0,3 user reviews,3,0,3
1102410,True,0,No user reviews,0,0,0
1102420,True,0,1 user reviews,1,0,1
1102430,True,0,1 user reviews,1,0,1
1102440,True,0,No user reviews,0,0,0
1102450,True,0,No user reviews,0,0,0
1102480,True,0,1 user reviews,1,0,1
1102500,True,6,Mostly Positive,10,4,14
1102510,True,0,1 user reviews,1,0,1
1102520,True,0,No user reviews,0,0,0
1102530,True,0,No user reviews,0,0,0
1102540,True,0,No user reviews,0,0,0
1102560,True,0,No user reviews,0,0,0
1102570,True,0,No user reviews,0,0,0
1102580,True,7,Positive,13,3,16
1102590,True,0,1 user reviews,1,0,1
1102600,True,0,No user reviews,0,0,0
1102610,True,0,1 user reviews,1,0,1
1102620,True,0,No user reviews,0,0,0
1102630,True,0,1 user reviews,1,0,1
1102640,True,0,1 user reviews,1,0,1
1102650,True,0,8 user reviews,8,0,8
1102670,True,0,1 user reviews,1,0,1
1102671,True,0,2 user reviews,2,0,2
1102680,True,0,6 user reviews,4,2,6
1102700,True,0,8 user reviews,7,1,8
1102710,True,0,No user reviews,0,0,0
1102720,True,0,9 user reviews,7,2,9
1102740,True,0,1 user reviews,1,0,1
1102750,True,0,7 user reviews,5,2,7
1102770,True,0,No user reviews,0,0,0
1102780,True,5,Mixed,18,12,30
1102880,True,5,Mixed,10,6,16
1102890,True,0,No user reviews,0,0,0
1102900,True,0,No user reviews,0,0,0
1102901,True,0,No user reviews,0,0,0
1102910,True,0,No user reviews,0,0,0
1102920,True,0,No user reviews,0,0,0
1102921,True,0,No user reviews,0,0,0
1102922,True,0,No user reviews,0,0,0
1102930,True,7,Positive,31,7,38
1102940,True,0,No user reviews,0,0,0
1102980,True,0,5 user reviews,4,1,5
1103000,True,0,No user reviews,0,0,0
1103040,True,0,No user reviews,0,0,0
1103050,True,0,1 user reviews,0,1,1
1103060,True,0,No user reviews,0,0,0
1103070,True,0,No user reviews,0,0,0
1103080,True,0,No user reviews,0,0,0
1103100,True,8,Very Positive,76,18,94
1103120,True,0,3 user reviews,2,1,3
1103130,True,7,Positive,13,0,13
1103140,True,0,9 user reviews,6,3,9
1103160,True,0,No user reviews,0,0,0
1103170,True,0,No user reviews,0,0,0
1103190,True,0,No user reviews,0,0,0
1103210,True,0,5 user reviews,3,2,5
1103220,True,0,No user reviews,0,0,0
1103230,True,0,No user reviews,0,0,0
1103240,True,0,1 user reviews,1,0,1
1103250,True,0,3 user reviews,2,1,3
1103260,True,0,No user reviews,0,0,0
1103270,True,0,No user reviews,0,0,0
1103290,True,0,1 user reviews,1,0,1
1103300,True,0,1 user reviews,0,1,1
1103310,True,0,8 user reviews,8,0,8
1103320,True,0,2 user reviews,1,1,2
1103330,True,0,No user reviews,0,0,0
1103340,True,0,1 user reviews,1,0,1
1103370,True,0,1 user reviews,1,0,1
1103380,True,0,No user reviews,0,0,0
1103390,True,0,1 user reviews,1,0,1
1103400,True,0,No user reviews,0,0,0
1103410,True,0,1 user reviews,1,0,1
1103420,True,0,1 user reviews,1,0,1
1103430,True,0,1 user reviews,1,0,1
1103440,True,0,No user reviews,0,0,0
1103441,True,0,No user reviews,0,0,0
1103460,True,0,No user reviews,0,0,0
1103490,True,6,Mostly Positive,51,17,68
1103510,True,0,No user reviews,0,0,0
1103520,True,0,1 user reviews,1,0,1
1103530,True,0,No user reviews,0,0,0
1103540,True,0,1 user reviews,1,0,1
1103550,True,0,1 user reviews,1,0,1
1103560,True,0,No user reviews,0,0,0
1103570,True,0,No user reviews,0,0,0
1103590,True,0,No user reviews,0,0,0
1103610,True,0,No user reviews,0,0,0
1103620,True,0,No user reviews,0,0,0
1103630,True,0,4 user reviews,0,4,4
1103640,True,0,2 user reviews,2,0,2
1103650,True,0,1 user reviews,0,1,1
1103670,True,0,2 user reviews,2,0,2
1103680,True,0,No user reviews,0,0,0
1103690,True,0,No user reviews,0,0,0
1103700,True,0,No user reviews,0,0,0
1103710,True,0,1 user reviews,1,0,1
1103711,True,0,1 user reviews,1,0,1
1103730,True,0,8 user reviews,6,2,8
1103740,True,7,Positive,13,0,13
1103741,True,0,3 user reviews,2,1,3
1103742,True,0,No user reviews,0,0,0
1103750,True,0,No user reviews,0,0,0
1103751,True,0,No user reviews,0,0,0
1103752,True,0,No user reviews,0,0,0
1103770,True,7,Positive,28,1,29
1103780,True,0,No user reviews,0,0,0
1103790,True,0,1 user reviews,1,0,1
1103800,True,7,Positive,14,2,16
1103810,True,0,4 user reviews,2,2,4
1103820,True,0,No user reviews,0,0,0
1103830,True,0,No user reviews,0,0,0
1103840,True,7,Positive,13,2,15
1103860,True,8,Very Positive,79,18,97
1103870,True,0,1 user reviews,1,0,1
1103880,True,8,Very Positive,100,13,113
1103890,True,0,5 user reviews,4,1,5
1103910,True,0,No user reviews,0,0,0
1103920,True,0,2 user reviews,0,2,2
1103930,True,7,Positive,17,0,17
1103940,True,0,No user reviews,0,0,0
1103950,True,5,Mixed,235,165,400
1103960,True,0,No user reviews,0,0,0
1103970,True,0,No user reviews,0,0,0
1103980,True,0,No user reviews,0,0,0
1104010,True,0,No user reviews,0,0,0
1104030,True,0,1 user reviews,0,1,1
1104040,True,0,No user reviews,0,0,0
1104050,True,0,5 user reviews,1,4,5
1104100,True,0,1 user reviews,1,0,1
1104150,True,0,No user reviews,0,0,0
1104170,True,0,No user reviews,0,0,0
1104200,True,0,No user reviews,0,0,0
1104210,True,0,No user reviews,0,0,0
1104220,True,8,Very Positive,56,10,66
1104230,True,0,2 user reviews,1,1,2
1104240,True,0,No user reviews,0,0,0
1104250,True,0,1 user reviews,0,1,1
1104260,True,7,Positive,20,3,23
1104270,True,0,No user reviews,0,0,0
1104280,True,0,No user reviews,0,0,0
1104290,True,0,No user reviews,0,0,0
1104300,True,0,No user reviews,0,0,0
1104320,True,0,No user reviews,0,0,0
1104330,True,8,Very Positive,190,13,203
1104340,True,0,5 user reviews,4,1,5
1104360,True,0,No user reviews,0,0,0
1104380,True,9,Overwhelmingly Positive,613,23,636
1104390,True,0,No user reviews,0,0,0
1104400,True,0,No user reviews,0,0,0
1104410,True,0,7 user reviews,3,4,7
1104420,True,0,No user reviews,0,0,0
1104450,True,0,No user reviews,0,0,0
1104460,True,0,2 user reviews,1,1,2
1104470,True,0,1 user reviews,1,0,1
1104480,True,0,2 user reviews,0,2,2
1104490,True,0,3 user reviews,2,1,3
1104510,True,0,No user reviews,0,0,0
1104540,True,0,No user reviews,0,0,0
1104560,True,0,No user reviews,0,0,0
1104570,True,0,No user reviews,0,0,0
1104600,True,0,No user reviews,0,0,0
1104610,True,0,No user reviews,0,0,0
1104620,True,0,7 user reviews,6,1,7
1104630,True,0,No user reviews,0,0,0
1104640,True,0,No user reviews,0,0,0
1104660,True,8,Very Positive,610,49,659
1104670,True,0,No user reviews,0,0,0
1104680,True,7,Positive,14,3,17
1104690,True,0,No user reviews,0,0,0
1104710,True,0,No user reviews,0,0,0
1104750,True,0,No user reviews,0,0,0
1104760,True,0,No user reviews,0,0,0
1104790,True,0,No user reviews,0,0,0
1104800,True,0,No user reviews,0,0,0
1104810,True,0,No user reviews,0,0,0
1104820,True,0,No user reviews,0,0,0
1104830,True,0,3 user reviews,3,0,3
1104840,True,0,No user reviews,0,0,0
1104860,True,0,1 user reviews,0,1,1
1104870,True,0,No user reviews,0,0,0
1104880,True,8,Very Positive,134,26,160
1104890,True,0,No user reviews,0,0,0
1104910,True,0,No user reviews,0,0,0
1104920,True,0,No user reviews,0,0,0
1104930,True,0,No user reviews,0,0,0
1104950,True,0,No user reviews,0,0,0
1104960,True,0,1 user reviews,1,0,1
1105010,True,0,2 user reviews,1,1,2
1105030,True,0,No user reviews,0,0,0
1105040,True,7,Positive,23,4,27
1105060,True,0,No user reviews,0,0,0
1105110,True,7,Positive,39,4,43
1105140,True,0,1 user reviews,1,0,1
1105160,True,0,No user reviews,0,0,0
1105180,True,0,No user reviews,0,0,0
1105190,True,0,1 user reviews,1,0,1
1105210,True,0,No user reviews,0,0,0
1105220,True,0,No user reviews,0,0,0
1105230,True,0,No user reviews,0,0,0
1105240,True,0,No user reviews,0,0,0
1105290,True,0,No user reviews,0,0,0
1105300,True,0,5 user reviews,5,0,5
1105320,True,0,No user reviews,0,0,0
1105321,True,0,No user reviews,0,0,0
1105322,True,0,2 user reviews,0,2,2
1105323,True,0,No user reviews,0,0,0
1105330,True,0,No user reviews,0,0,0
1105350,True,0,1 user reviews,1,0,1
1105360,True,5,Mixed,14,12,26
1105370,True,5,Mixed,14,10,24
1105371,True,0,No user reviews,0,0,0
1105380,True,0,2 user reviews,2,0,2
1105400,True,0,No user reviews,0,0,0
1105410,True,7,Positive,10,1,11
1105420,True,0,No user reviews,0,0,0
1105430,True,0,9 user reviews,8,1,9
1105450,True,0,4 user reviews,3,1,4
1105470,True,0,No user reviews,0,0,0
1105480,True,0,No user reviews,0,0,0
1105490,True,0,1 user reviews,1,0,1
1105530,True,0,No user reviews,0,0,0
1105542,True,0,8 user reviews,7,1,8
1105550,True,0,No user reviews,0,0,0
1105560,True,0,No user reviews,0,0,0
1105570,True,0,No user reviews,0,0,0
1105600,True,0,1 user reviews,1,0,1
1105620,True,7,Positive,40,7,47
1105630,True,7,Positive,10,0,10
1105640,True,0,No user reviews,0,0,0
1105660,True,6,Mostly Positive,16,6,22
1105670,True,0,No user reviews,0,0,0
1105680,True,0,No user reviews,0,0,0
1105730,True,0,9 user reviews,7,2,9
1105740,True,7,Positive,14,1,15
1105750,True,0,No user reviews,0,0,0
1105760,True,0,No user reviews,0,0,0
1105770,True,0,4 user reviews,3,1,4
1105780,True,0,No user reviews,0,0,0
1105790,True,0,No user reviews,0,0,0
1105800,True,0,No user reviews,0,0,0
1105810,True,5,Mixed,86,45,131
1105820,True,0,No user reviews,0,0,0
1105830,True,0,No user reviews,0,0,0
1105840,True,0,No user reviews,0,0,0
1105870,True,0,1 user reviews,1,0,1
1105880,True,0,3 user reviews,3,0,3
1105890,True,7,Positive,28,3,31
1105950,True,7,Positive,16,4,20
1105951,True,5,Mixed,9,4,13
1105960,True,0,No user reviews,0,0,0
1105970,True,0,No user reviews,0,0,0
1105990,True,0,No user reviews,0,0,0
1106000,True,0,No user reviews,0,0,0
1106010,True,0,No user reviews,0,0,0
1106011,True,0,No user reviews,0,0,0
1106012,True,0,No user reviews,0,0,0
1106013,True,0,No user reviews,0,0,0
1106020,True,0,No user reviews,0,0,0
1106021,True,0,No user reviews,0,0,0
1106022,True,0,No user reviews,0,0,0
1106023,True,0,No user reviews,0,0,0
1106030,True,0,No user reviews,0,0,0
1106060,True,6,Mostly Positive,10,4,14
1106070,True,7,Positive,13,1,14
1106080,True,7,Positive,31,6,37
1106100,True,0,2 user reviews,2,0,2
1106120,True,0,No user reviews,0,0,0
1106130,True,0,5 user reviews,5,0,5
1106150,True,7,Positive,18,1,19
1106170,True,7,Positive,9,2,11
1106180,True,5,Mixed,18,8,26
1106190,True,0,No user reviews,0,0,0
1106200,True,0,4 user reviews,4,0,4
1106220,True,0,3 user reviews,1,2,3
1106221,True,0,1 user reviews,1,0,1
1106222,True,0,1 user reviews,0,1,1
1106223,True,0,1 user reviews,1,0,1
1106224,True,0,1 user reviews,0,1,1
1106225,True,0,1 user reviews,1,0,1
1106226,True,0,1 user reviews,1,0,1
1106227,True,0,1 user reviews,1,0,1
1106228,True,0,1 user reviews,1,0,1
1106231,True,0,1 user reviews,1,0,1
1106233,True,0,1 user reviews,0,1,1
1106234,True,0,1 user reviews,1,0,1
1106243,True,0,No user reviews,0,0,0
1106250,True,0,1 user reviews,1,0,1
1106251,True,0,No user reviews,0,0,0
1106260,True,0,No user reviews,0,0,0
1106270,True,0,No user reviews,0,0,0
1106290,True,0,1 user reviews,1,0,1
1106300,True,0,2 user reviews,2,0,2
1106310,True,0,1 user reviews,1,0,1
1106320,True,0,2 user reviews,2,0,2
1106321,True,0,1 user reviews,0,1,1
1106340,True,0,No user reviews,0,0,0
1106350,True,0,4 user reviews,2,2,4
1106360,True,0,1 user reviews,0,1,1
1106361,True,0,2 user reviews,2,0,2
1106362,True,0,1 user reviews,1,0,1
1106363,True,0,No user reviews,0,0,0
1106370,True,0,1 user reviews,1,0,1
1106371,True,0,1 user reviews,1,0,1
1106380,True,0,1 user reviews,1,0,1
1106381,True,0,No user reviews,0,0,0
1106391,True,0,1 user reviews,1,0,1
1106450,True,0,1 user reviews,1,0,1
1106451,True,0,2 user reviews,2,0,2
1106452,True,0,1 user reviews,1,0,1
1106530,True,8,Very Positive,926,160,1086
1106660,True,0,No user reviews,0,0,0
1106670,True,0,5 user reviews,3,2,5
1106680,True,0,No user reviews,0,0,0
1106690,True,0,2 user reviews,0,2,2
1106700,True,0,No user reviews,0,0,0
1106710,True,0,2 user reviews,1,1,2
1106720,True,0,No user reviews,0,0,0
1106730,True,0,No user reviews,0,0,0
1106740,True,0,No user reviews,0,0,0
1106750,True,6,Mostly Positive,1041,442,1483
1106760,True,0,No user reviews,0,0,0
1106770,True,0,No user reviews,0,0,0
1106780,True,0,3 user reviews,3,0,3
1106790,True,0,4 user reviews,3,1,4
1106810,True,0,No user reviews,0,0,0
1106820,True,0,1 user reviews,1,0,1
1106830,True,0,No user reviews,0,0,0
1106840,True,8,Very Positive,1986,347,2333
1106850,True,0,No user reviews,0,0,0
1106860,True,8,Very Positive,70,3,73
1106870,True,0,No user reviews,0,0,0
1106880,True,0,No user reviews,0,0,0
1106910,True,0,No user reviews,0,0,0
1106920,True,7,Positive,18,2,20
1106930,True,0,No user reviews,0,0,0
1106940,True,8,Very Positive,72,6,78
1106950,True,0,No user reviews,0,0,0
1106960,True,0,No user reviews,0,0,0
1106970,True,0,2 user reviews,0,2,2
1106980,True,0,2 user reviews,2,0,2
1107040,True,5,Mixed,10,6,16
1107050,True,0,1 user reviews,1,0,1
1107060,True,0,7 user reviews,7,0,7
1107080,True,0,No user reviews,0,0,0
1107090,True,0,1 user reviews,1,0,1
1107100,True,0,No user reviews,0,0,0
1107120,True,0,No user reviews,0,0,0
1107130,True,0,No user reviews,0,0,0
1107150,True,0,No user reviews,0,0,0
1107160,True,0,1 user reviews,0,1,1
1107180,True,6,Mostly Positive,35,10,45
1107190,True,0,1 user reviews,0,1,1
1107210,True,0,1 user reviews,1,0,1
1107220,True,0,No user reviews,0,0,0
1107230,True,7,Positive,44,3,47
1107260,True,0,2 user reviews,2,0,2
1107280,True,0,No user reviews,0,0,0
1107290,True,7,Positive,15,0,15
1107300,True,0,No user reviews,0,0,0
1107320,True,0,No user reviews,0,0,0
1107350,True,0,1 user reviews,0,1,1
1107370,True,5,Mixed,37,16,53
1107380,True,0,No user reviews,0,0,0
1107390,True,0,No user reviews,0,0,0
1107400,True,0,No user reviews,0,0,0
1107410,True,0,No user reviews,0,0,0
1107430,True,0,No user reviews,0,0,0
1107440,True,0,4 user reviews,2,2,4
1107450,True,0,No user reviews,0,0,0
1107460,True,0,No user reviews,0,0,0
1107470,True,0,9 user reviews,9,0,9
1107480,True,0,No user reviews,0,0,0
1107490,True,0,No user reviews,0,0,0
1107500,True,0,No user reviews,0,0,0
1107510,True,0,2 user reviews,1,1,2
1107520,True,0,No user reviews,0,0,0
1107580,True,0,No user reviews,0,0,0
1107590,True,0,No user reviews,0,0,0
1107620,True,0,No user reviews,0,0,0
1107640,True,0,No user reviews,0,0,0
1107660,True,0,No user reviews,0,0,0
1107700,True,0,No user reviews,0,0,0
1107720,True,0,2 user reviews,0,2,2
1107730,True,0,No user reviews,0,0,0
1107760,True,7,Positive,37,0,37
1107770,True,0,No user reviews,0,0,0
1107790,True,6,Mostly Positive,208,61,269
1107810,True,0,1 user reviews,0,1,1
1107811,True,0,2 user reviews,1,1,2
1107812,True,5,Mixed,7,9,16
1107813,True,0,9 user reviews,2,7,9
1107814,True,0,1 user reviews,1,0,1
1107820,True,0,7 user reviews,7,0,7
1107840,True,5,Mixed,43,33,76
1107860,True,0,No user reviews,0,0,0
1107880,True,0,No user reviews,0,0,0
1107881,True,0,No user reviews,0,0,0
1107890,True,0,No user reviews,0,0,0
1107920,True,0,1 user reviews,1,0,1
1107940,True,0,No user reviews,0,0,0
1107960,True,0,No user reviews,0,0,0
1107990,True,0,No user reviews,0,0,0
1108000,True,0,No user reviews,0,0,0
1108020,True,0,No user reviews,0,0,0
1108030,True,0,No user reviews,0,0,0
1108040,True,0,No user reviews,0,0,0
1108070,True,0,No user reviews,0,0,0
1108090,True,7,Positive,40,7,47
1108110,True,0,No user reviews,0,0,0
1108130,True,0,No user reviews,0,0,0
1108170,True,0,No user reviews,0,0,0
1108180,True,0,No user reviews,0,0,0
1108190,True,0,7 user reviews,5,2,7
1108240,True,0,No user reviews,0,0,0
1108250,True,0,2 user reviews,2,0,2
1108260,True,0,No user reviews,0,0,0
1108280,True,7,Positive,11,0,11
1108290,True,0,No user reviews,0,0,0
1108310,True,0,2 user reviews,2,0,2
1108320,True,7,Positive,9,2,11
1108330,True,0,No user reviews,0,0,0
1108340,True,0,No user reviews,0,0,0
1108350,True,8,Very Positive,96,11,107
1108370,True,8,Very Positive,582,70,652
1108380,True,0,5 user reviews,5,0,5
1108390,True,0,No user reviews,0,0,0
1108410,True,7,Positive,25,6,31
1108420,True,0,No user reviews,0,0,0
1108450,True,5,Mixed,23,27,50
1108460,True,7,Positive,12,3,15
1108530,True,0,No user reviews,0,0,0
1108540,True,7,Positive,9,1,10
1108550,True,0,7 user reviews,7,0,7
1108560,True,0,No user reviews,0,0,0
1108580,True,0,1 user reviews,1,0,1
1108590,True,0,No user reviews,0,0,0
1108600,True,0,No user reviews,0,0,0
1108620,True,5,Mixed,10,5,15
1108630,True,0,No user reviews,0,0,0
1108640,True,0,7 user reviews,6,1,7
1108650,True,0,2 user reviews,0,2,2
1108660,True,0,1 user reviews,1,0,1
1108670,True,0,No user reviews,0,0,0
1108680,True,0,No user reviews,0,0,0
1108740,True,5,Mixed,27,15,42
1108760,True,0,No user reviews,0,0,0
1108761,True,0,No user reviews,0,0,0
1108763,True,0,No user reviews,0,0,0
1108770,True,0,No user reviews,0,0,0
1108780,True,0,No user reviews,0,0,0
1108790,True,0,No user reviews,0,0,0
1108791,True,0,No user reviews,0,0,0
1108792,True,0,No user reviews,0,0,0
1108793,True,0,No user reviews,0,0,0
1108794,True,0,No user reviews,0,0,0
1108800,True,0,No user reviews,0,0,0
1108820,True,0,3 user reviews,2,1,3
1108830,True,0,No user reviews,0,0,0
1108860,True,0,2 user reviews,1,1,2
1108870,True,0,4 user reviews,4,0,4
1108900,True,5,Mixed,4,6,10
1108910,True,7,Positive,9,1,10
1108920,True,5,Mixed,9,7,16
1108930,True,0,2 user reviews,2,0,2
1108940,True,0,No user reviews,0,0,0
1108950,True,0,No user reviews,0,0,0
1109070,True,0,No user reviews,0,0,0
1109080,True,0,1 user reviews,1,0,1
1109100,True,0,No user reviews,0,0,0
1109110,True,0,2 user reviews,1,1,2
1109130,True,0,No user reviews,0,0,0
1109160,True,0,No user reviews,0,0,0
1109170,True,0,1 user reviews,1,0,1
1109180,True,0,No user reviews,0,0,0
1109190,True,0,No user reviews,0,0,0
1109200,True,0,2 user reviews,1,1,2
1109202,True,0,1 user reviews,0,1,1
1109203,True,0,4 user reviews,2,2,4
1109204,True,0,1 user reviews,1,0,1
1109205,True,0,9 user reviews,8,1,9
1109206,True,0,4 user reviews,3,1,4
1109207,True,0,2 user reviews,1,1,2
1109208,True,0,3 user reviews,2,1,3
1109209,True,5,Mixed,6,8,14
1109240,True,0,No user reviews,0,0,0
1109270,True,0,No user reviews,0,0,0
1109280,True,0,1 user reviews,1,0,1
1109300,True,0,No user reviews,0,0,0
1109310,True,0,8 user reviews,3,5,8
1109330,True,0,No user reviews,0,0,0
1109331,True,0,No user reviews,0,0,0
1109340,True,0,No user reviews,0,0,0
1109350,True,0,2 user reviews,2,0,2
1109360,True,8,Very Positive,48,3,51
1109380,True,0,2 user reviews,1,1,2
1109390,True,0,No user reviews,0,0,0
1109400,True,0,No user reviews,0,0,0
1109410,True,0,No user reviews,0,0,0
1109420,True,0,No user reviews,0,0,0
1109430,True,0,No user reviews,0,0,0
1109460,True,0,No user reviews,0,0,0
1109470,True,0,No user reviews,0,0,0
1109490,True,0,No user reviews,0,0,0
1109530,True,0,No user reviews,0,0,0
1109550,True,0,2 user reviews,1,1,2
1109560,True,0,No user reviews,0,0,0
1109561,True,0,No user reviews,0,0,0
1109562,True,0,1 user reviews,1,0,1
1109563,True,0,1 user reviews,1,0,1
1109564,True,0,No user reviews,0,0,0
1109565,True,0,No user reviews,0,0,0
1109570,True,0,No user reviews,0,0,0
1109630,True,0,No user reviews,0,0,0
1109650,True,0,1 user reviews,1,0,1
1109670,True,0,9 user reviews,1,8,9
1109680,True,0,No user reviews,0,0,0
1109690,True,5,Mixed,14,8,22
1109700,True,0,No user reviews,0,0,0
1109720,True,0,1 user reviews,1,0,1
1109740,True,0,8 user reviews,2,6,8
1109750,True,0,1 user reviews,1,0,1
1109770,True,0,No user reviews,0,0,0
1109780,True,0,No user reviews,0,0,0
1109800,True,0,1 user reviews,1,0,1
1109820,True,0,No user reviews,0,0,0
1109840,True,0,3 user reviews,3,0,3
1109850,True,0,No user reviews,0,0,0
1109880,True,0,No user reviews,0,0,0
1109890,True,0,No user reviews,0,0,0
1109920,True,0,No user reviews,0,0,0
1109930,True,0,No user reviews,0,0,0
1109940,True,0,2 user reviews,2,0,2
1109950,True,0,No user reviews,0,0,0
1109960,True,0,1 user reviews,1,0,1
1109970,True,0,No user reviews,0,0,0
1109980,True,0,3 user reviews,0,3,3
1110010,True,0,No user reviews,0,0,0
1110020,True,0,No user reviews,0,0,0
1110030,True,7,Positive,32,7,39
1110040,True,0,No user reviews,0,0,0
1110050,True,8,Very Positive,127,21,148
1110090,True,0,No user reviews,0,0,0
1110100,True,8,Very Positive,337,36,373
1110110,True,0,No user reviews,0,0,0
1110111,True,0,No user reviews,0,0,0
1110112,True,0,No user reviews,0,0,0
1110113,True,0,No user reviews,0,0,0
1110120,True,0,No user reviews,0,0,0
1110121,True,0,No user reviews,0,0,0
1110122,True,0,No user reviews,0,0,0
1110123,True,0,No user reviews,0,0,0
1110124,True,0,No user reviews,0,0,0
1110125,True,0,No user reviews,0,0,0
1110130,True,0,No user reviews,0,0,0
1110131,True,0,No user reviews,0,0,0
1110140,True,0,No user reviews,0,0,0
1110141,True,0,No user reviews,0,0,0
1110142,True,0,No user reviews,0,0,0
1110143,True,0,No user reviews,0,0,0
1110150,True,0,No user reviews,0,0,0
1110160,True,0,No user reviews,0,0,0
1110170,True,0,No user reviews,0,0,0
1110180,True,0,No user reviews,0,0,0
1110200,True,0,2 user reviews,1,1,2
1110210,True,0,No user reviews,0,0,0
1110220,True,0,3 user reviews,3,0,3
1110230,True,0,No user reviews,0,0,0
1110260,True,0,No user reviews,0,0,0
1110280,True,0,1 user reviews,1,0,1
1110300,True,0,No user reviews,0,0,0
1110320,True,0,No user reviews,0,0,0
1110340,True,0,3 user reviews,2,1,3
1110350,True,0,3 user reviews,3,0,3
1110380,True,7,Positive,21,2,23
1110390,True,0,No user reviews,0,0,0
1110410,True,6,Mostly Positive,34,14,48
1110430,True,0,No user reviews,0,0,0
1110440,True,0,No user reviews,0,0,0
1110450,True,0,No user reviews,0,0,0
1110460,True,0,No user reviews,0,0,0
1110470,True,0,No user reviews,0,0,0
1110480,True,0,No user reviews,0,0,0
1110490,True,0,1 user reviews,0,1,1
1110500,True,0,No user reviews,0,0,0
1110560,True,0,No user reviews,0,0,0
1110580,True,7,Positive,18,4,22
1110590,True,0,No user reviews,0,0,0
1110600,True,0,No user reviews,0,0,0
1110620,True,0,No user reviews,0,0,0
1110630,True,0,No user reviews,0,0,0
1110631,True,0,No user reviews,0,0,0
1110632,True,0,No user reviews,0,0,0
1110640,True,0,5 user reviews,1,4,5
1110650,True,0,1 user reviews,1,0,1
1110660,True,0,1 user reviews,1,0,1
1110670,True,0,No user reviews,0,0,0
1110690,True,0,No user reviews,0,0,0
1110700,True,0,1 user reviews,1,0,1
1110710,True,0,No user reviews,0,0,0
1110720,True,0,1 user reviews,1,0,1
1110730,True,0,No user reviews,0,0,0
1110750,True,0,No user reviews,0,0,0
1110770,True,0,4 user reviews,3,1,4
1110780,True,0,No user reviews,0,0,0
1110810,True,0,No user reviews,0,0,0
1110820,True,0,No user reviews,0,0,0
1110830,True,0,3 user reviews,2,1,3
1110840,True,0,3 user reviews,1,2,3
1110870,True,0,No user reviews,0,0,0
1110880,True,0,No user reviews,0,0,0
1110890,True,7,Positive,24,1,25
1110910,True,0,No user reviews,0,0,0
1110920,True,0,No user reviews,0,0,0
1110930,True,0,2 user reviews,2,0,2
1110960,True,0,No user reviews,0,0,0
1110970,True,0,No user reviews,0,0,0
1110980,True,7,Positive,17,2,19
1111000,True,0,No user reviews,0,0,0
1111030,True,7,Positive,22,4,26
1111040,True,0,No user reviews,0,0,0
1111060,True,0,No user reviews,0,0,0
1111070,True,0,No user reviews,0,0,0
1111090,True,0,1 user reviews,1,0,1
1111100,True,0,1 user reviews,1,0,1
1111110,True,0,1 user reviews,0,1,1
1111120,True,0,4 user reviews,4,0,4
1111130,True,0,No user reviews,0,0,0
1111140,True,0,3 user reviews,3,0,3
1111150,True,0,No user reviews,0,0,0
1111170,True,0,1 user reviews,1,0,1
1111180,True,0,No user reviews,0,0,0
1111200,True,0,1 user reviews,0,1,1
1111210,True,0,4 user reviews,3,1,4
1111220,True,0,2 user reviews,2,0,2
1111230,True,0,No user reviews,0,0,0
1111240,True,0,No user reviews,0,0,0
1111250,True,0,No user reviews,0,0,0
1111260,True,0,No user reviews,0,0,0
1111270,True,0,No user reviews,0,0,0
1111290,True,0,No user reviews,0,0,0
1111300,True,0,No user reviews,0,0,0
1111310,True,0,3 user reviews,2,1,3
1111330,True,0,No user reviews,0,0,0
1111340,True,0,No user reviews,0,0,0
1111350,True,0,No user reviews,0,0,0
1111351,True,0,No user reviews,0,0,0
1111352,True,0,No user reviews,0,0,0
1111360,True,0,No user reviews,0,0,0
1111370,True,8,Very Positive,287,0,287
1111380,True,6,Mostly Positive,26,9,35
1111390,True,0,9 user reviews,7,2,9
1111410,True,0,No user reviews,0,0,0
1111420,True,0,No user reviews,0,0,0
1111440,True,7,Positive,9,1,10
1111441,True,0,No user reviews,0,0,0
1111442,True,0,No user reviews,0,0,0
1111443,True,0,No user reviews,0,0,0
1111444,True,0,1 user reviews,1,0,1
1111445,True,0,No user reviews,0,0,0
1111446,True,0,No user reviews,0,0,0
1111447,True,0,4 user reviews,4,0,4
1111448,True,0,No user reviews,0,0,0
1111450,True,0,1 user reviews,1,0,1
1111470,True,0,No user reviews,0,0,0
1111471,True,0,1 user reviews,1,0,1
1111472,True,0,No user reviews,0,0,0
1111473,True,0,No user reviews,0,0,0
1111474,True,0,2 user reviews,1,1,2
1111475,True,0,No user reviews,0,0,0
1111476,True,0,No user reviews,0,0,0
1111477,True,0,No user reviews,0,0,0
1111480,True,0,No user reviews,0,0,0
1111481,True,0,No user reviews,0,0,0
1111482,True,0,No user reviews,0,0,0
1111490,True,0,No user reviews,0,0,0
1111500,True,0,3 user reviews,1,2,3
1111510,True,0,No user reviews,0,0,0
1111511,True,0,1 user reviews,1,0,1
1111512,True,0,No user reviews,0,0,0
1111513,True,0,No user reviews,0,0,0
1111514,True,0,No user reviews,0,0,0
1111515,True,0,No user reviews,0,0,0
1111516,True,0,1 user reviews,1,0,1
1111517,True,0,1 user reviews,1,0,1
1111518,True,0,2 user reviews,2,0,2
1111530,True,0,1 user reviews,1,0,1
1111540,True,0,No user reviews,0,0,0
1111550,True,0,No user reviews,0,0,0
1111560,True,0,No user reviews,0,0,0
1111590,True,0,No user reviews,0,0,0
1111600,True,0,No user reviews,0,0,0
1111610,True,0,4 user reviews,1,3,4
1111620,True,7,Positive,20,3,23
1111640,True,0,No user reviews,0,0,0
1111650,True,0,No user reviews,0,0,0
1111660,True,0,No user reviews,0,0,0
1111670,True,0,No user reviews,0,0,0
1111671,True,0,No user reviews,0,0,0
1111700,True,0,No user reviews,0,0,0
1111720,True,0,No user reviews,0,0,0
1111730,True,0,No user reviews,0,0,0
1111760,True,0,No user reviews,0,0,0
1111790,True,0,3 user reviews,2,1,3
1111810,True,6,Mostly Positive,25,7,32
1111830,True,0,No user reviews,0,0,0
1111840,True,0,No user reviews,0,0,0
1111870,True,0,No user reviews,0,0,0
1111880,True,0,No user reviews,0,0,0
1111910,True,0,No user reviews,0,0,0
1111920,True,0,No user reviews,0,0,0
1111930,True,0,No user reviews,0,0,0
1111940,True,6,Mostly Positive,22,7,29
1111950,True,0,No user reviews,0,0,0
1111960,True,0,No user reviews,0,0,0
1111970,True,0,7 user reviews,6,1,7
1111990,True,0,5 user reviews,1,4,5
1112010,True,0,2 user reviews,1,1,2
1112050,True,0,4 user reviews,4,0,4
1112080,True,0,No user reviews,0,0,0
1112081,True,0,1 user reviews,1,0,1
1112082,True,0,1 user reviews,1,0,1
1112083,True,0,1 user reviews,1,0,1
1112100,True,0,No user reviews,0,0,0
1112120,True,0,2 user reviews,0,2,2
1112130,True,0,No user reviews,0,0,0
1112140,True,0,No user reviews,0,0,0
1112150,True,0,8 user reviews,8,0,8
1112200,True,0,2 user reviews,1,1,2
1112230,True,0,No user reviews,0,0,0
1112240,True,5,Mixed,9,5,14
1112250,True,0,No user reviews,0,0,0
1112290,True,0,No user reviews,0,0,0
1112300,True,0,No user reviews,0,0,0
1112310,True,0,No user reviews,0,0,0
1112330,True,0,No user reviews,0,0,0
1112340,True,8,Very Positive,111,12,123
1112350,True,0,No user reviews,0,0,0
1112360,True,0,2 user reviews,2,0,2
1112370,True,7,Positive,18,3,21
1112380,True,0,No user reviews,0,0,0
1112390,True,0,No user reviews,0,0,0
1112400,True,0,No user reviews,0,0,0
1112420,True,0,3 user reviews,2,1,3
1112430,True,0,No user reviews,0,0,0
1112440,True,0,No user reviews,0,0,0
1112450,True,0,No user reviews,0,0,0
1112460,True,0,No user reviews,0,0,0
1112470,True,0,7 user reviews,7,0,7
1112480,True,0,No user reviews,0,0,0
1112481,True,0,1 user reviews,1,0,1
1112482,True,0,1 user reviews,1,0,1
1112483,True,0,6 user reviews,3,3,6
1112484,True,0,1 user reviews,1,0,1
1112485,True,0,No user reviews,0,0,0
1112510,True,0,No user reviews,0,0,0
1112520,True,7,Positive,14,1,15
1112521,True,0,7 user reviews,5,2,7
1112570,True,0,3 user reviews,2,1,3
1112580,True,0,5 user reviews,4,1,5
1112590,True,7,Positive,11,0,11
1112591,True,0,3 user reviews,2,1,3
1112620,True,7,Positive,32,8,40
1112640,True,6,Mostly Positive,11,3,14
1112650,True,0,No user reviews,0,0,0
1112660,True,0,No user reviews,0,0,0
1112670,True,0,No user reviews,0,0,0
1112680,True,0,No user reviews,0,0,0
1112690,True,7,Positive,11,2,13
1112700,True,0,5 user reviews,5,0,5
1112710,True,0,No user reviews,0,0,0
1112720,True,0,No user reviews,0,0,0
1112760,True,0,2 user reviews,2,0,2
1112790,True,5,Mixed,772,346,1118
1112830,True,5,Mixed,28,15,43
1112840,True,0,No user reviews,0,0,0
1112850,True,0,No user reviews,0,0,0
1112860,True,0,No user reviews,0,0,0
1112870,True,0,No user reviews,0,0,0
1112880,True,0,No user reviews,0,0,0
1112890,True,0,No user reviews,0,0,0
1112900,True,0,No user reviews,0,0,0
1112930,True,8,Very Positive,115,11,126
1112940,True,0,No user reviews,0,0,0
1112950,True,0,No user reviews,0,0,0
1112960,True,0,4 user reviews,2,2,4
1112970,True,0,No user reviews,0,0,0
1112971,True,0,No user reviews,0,0,0
1112980,True,0,No user reviews,0,0,0
1113000,True,9,Overwhelmingly Positive,18746,421,19167
1113010,True,0,No user reviews,0,0,0
1113030,True,0,No user reviews,0,0,0
1113040,True,0,2 user reviews,2,0,2
1113060,True,0,3 user reviews,3,0,3
1113080,True,0,No user reviews,0,0,0
1113090,True,0,1 user reviews,1,0,1
1113110,True,0,2 user reviews,1,1,2
1113140,True,0,2 user reviews,2,0,2
1113150,True,0,No user reviews,0,0,0
1113180,True,0,No user reviews,0,0,0
1113210,True,0,No user reviews,0,0,0
1113220,True,0,3 user reviews,3,0,3
1113230,True,0,1 user reviews,1,0,1
1113240,True,0,2 user reviews,2,0,2
1113250,True,0,No user reviews,0,0,0
1113260,True,0,No user reviews,0,0,0
1113290,True,0,No user reviews,0,0,0
1113300,True,6,Mostly Positive,21,7,28
1113310,True,7,Positive,21,1,22
1113340,True,0,No user reviews,0,0,0
1113360,True,0,1 user reviews,1,0,1
1113370,True,0,No user reviews,0,0,0
1113380,True,0,No user reviews,0,0,0
1113390,True,0,4 user reviews,4,0,4
1113400,True,0,No user reviews,0,0,0
1113410,True,5,Mixed,534,569,1103
1113430,True,0,1 user reviews,1,0,1
1113490,True,0,2 user reviews,2,0,2
1113510,True,0,No user reviews,0,0,0
1113530,True,0,No user reviews,0,0,0
1113550,True,7,Positive,14,0,14
1113580,True,0,No user reviews,0,0,0
1113590,True,0,No user reviews,0,0,0
1113620,True,0,8 user reviews,3,5,8
1113630,True,0,No user reviews,0,0,0
1113640,True,0,1 user reviews,0,1,1
1113650,True,0,1 user reviews,0,1,1
1113670,True,0,No user reviews,0,0,0
1113680,True,8,Very Positive,164,36,200
1113690,True,7,Positive,10,0,10
1113700,True,0,No user reviews,0,0,0
1113710,True,0,No user reviews,0,0,0
1113730,True,0,No user reviews,0,0,0
1113740,True,0,2 user reviews,1,1,2
1113750,True,0,8 user reviews,4,4,8
1113760,True,0,3 user reviews,3,0,3
1113770,True,7,Positive,10,0,10
1113780,True,7,Positive,15,3,18
1113810,True,0,No user reviews,0,0,0
1113820,True,5,Mixed,29,23,52
1113821,True,7,Positive,27,3,30
1113822,True,7,Positive,18,4,22
1113823,True,6,Mostly Positive,16,5,21
1113824,True,5,Mixed,11,6,17
1113840,True,0,No user reviews,0,0,0
1113850,True,0,No user reviews,0,0,0
1113860,True,0,No user reviews,0,0,0
1113870,True,0,No user reviews,0,0,0
1113880,True,0,No user reviews,0,0,0
1113910,True,8,Very Positive,94,20,114
1113930,True,0,4 user reviews,3,1,4
1113940,True,7,Positive,13,1,14
1113950,True,0,No user reviews,0,0,0
1113960,True,0,3 user reviews,3,0,3
1113970,True,7,Positive,14,0,14
1114000,True,0,7 user reviews,2,5,7
1114010,True,0,3 user reviews,3,0,3
1114020,True,0,1 user reviews,1,0,1
1114030,True,0,No user reviews,0,0,0
1114040,True,0,No user reviews,0,0,0
1114050,True,0,No user reviews,0,0,0
1114070,True,0,1 user reviews,1,0,1
1114090,True,0,No user reviews,0,0,0
1114100,True,0,No user reviews,0,0,0
1114110,True,0,1 user reviews,0,1,1
1114130,True,8,Very Positive,109,4,113
1114140,True,0,No user reviews,0,0,0
1114150,True,0,No user reviews,0,0,0
1114170,True,0,No user reviews,0,0,0
1114180,True,0,No user reviews,0,0,0
1114190,True,0,No user reviews,0,0,0
1114200,True,0,No user reviews,0,0,0
1114210,True,0,2 user reviews,2,0,2
1114220,True,8,Very Positive,186,25,211
1114230,True,0,3 user reviews,2,1,3
1114250,True,0,No user reviews,0,0,0
1114260,True,0,No user reviews,0,0,0
1114270,True,0,3 user reviews,2,1,3
1114290,True,0,No user reviews,0,0,0
1114310,True,0,No user reviews,0,0,0
1114320,True,0,No user reviews,0,0,0
1114330,True,0,No user reviews,0,0,0
1114340,True,0,No user reviews,0,0,0
1114360,True,0,8 user reviews,5,3,8
1114390,True,0,No user reviews,0,0,0
1114420,True,0,No user reviews,0,0,0
1114430,True,7,Positive,24,1,25
1114440,True,0,No user reviews,0,0,0
1114441,True,0,No user reviews,0,0,0
1114450,True,0,No user reviews,0,0,0
1114460,True,0,7 user reviews,7,0,7
1114470,True,0,No user reviews,0,0,0
1114480,True,0,No user reviews,0,0,0
1114530,True,7,Positive,30,4,34
1114540,True,0,No user reviews,0,0,0
1114550,True,6,Mostly Positive,46,12,58
1114560,True,0,No user reviews,0,0,0
1114561,True,7,Positive,26,0,26
1114580,True,0,No user reviews,0,0,0
1114590,True,0,No user reviews,0,0,0
1114591,True,0,No user reviews,0,0,0
1114600,True,0,No user reviews,0,0,0
1114610,True,0,No user reviews,0,0,0
1114620,True,0,8 user reviews,8,0,8
1114630,True,0,4 user reviews,3,1,4
1114640,True,0,No user reviews,0,0,0
1114650,True,0,No user reviews,0,0,0
1114660,True,0,No user reviews,0,0,0
1114690,True,0,No user reviews,0,0,0
1114700,True,0,2 user reviews,1,1,2
1114710,True,0,3 user reviews,0,3,3
1114720,True,0,No user reviews,0,0,0
1114730,True,7,Positive,17,3,20
1114740,True,0,No user reviews,0,0,0
1114750,True,0,2 user reviews,2,0,2
1114760,True,0,No user reviews,0,0,0
1114780,True,0,No user reviews,0,0,0
1114800,True,0,1 user reviews,1,0,1
1114830,True,5,Mixed,28,19,47
1114840,True,0,No user reviews,0,0,0
1114860,True,0,No user reviews,0,0,0
1114870,True,8,Very Positive,82,11,93
1114880,True,0,No user reviews,0,0,0
1114900,True,0,No user reviews,0,0,0
1114910,True,0,1 user reviews,1,0,1
1114940,True,0,No user reviews,0,0,0
1114970,True,0,No user reviews,0,0,0
1114990,True,0,No user reviews,0,0,0
1115010,True,0,No user reviews,0,0,0
1115020,True,0,No user reviews,0,0,0
1115030,True,0,No user reviews,0,0,0
1115040,True,0,2 user reviews,0,2,2
1115050,True,0,No user reviews,0,0,0
1115060,True,0,1 user reviews,0,1,1
1115090,True,0,No user reviews,0,0,0
1115110,True,0,No user reviews,0,0,0
1115120,True,0,No user reviews,0,0,0
1115130,True,0,No user reviews,0,0,0
1115140,True,0,No user reviews,0,0,0
1115150,True,0,No user reviews,0,0,0
1115160,True,0,No user reviews,0,0,0
1115170,True,0,No user reviews,0,0,0
1115190,True,0,No user reviews,0,0,0
1115200,True,0,No user reviews,0,0,0
1115210,True,0,No user reviews,0,0,0
1115220,True,0,No user reviews,0,0,0
1115230,True,0,No user reviews,0,0,0
1115240,True,0,No user reviews,0,0,0
1115250,True,0,No user reviews,0,0,0
1115260,True,0,No user reviews,0,0,0
1115270,True,0,No user reviews,0,0,0
1115280,True,0,No user reviews,0,0,0
1115290,True,0,No user reviews,0,0,0
1115300,True,0,No user reviews,0,0,0
1115310,True,0,No user reviews,0,0,0
1115320,True,0,No user reviews,0,0,0
1115330,True,0,No user reviews,0,0,0
1115340,True,0,No user reviews,0,0,0
1115350,True,0,No user reviews,0,0,0
1115360,True,0,No user reviews,0,0,0
1115370,True,0,No user reviews,0,0,0
1115380,True,0,No user reviews,0,0,0
1115390,True,0,No user reviews,0,0,0
1115410,True,0,No user reviews,0,0,0
1115420,True,0,5 user reviews,3,2,5
1115440,True,0,No user reviews,0,0,0
1115450,True,6,Mostly Positive,24,7,31
1115460,True,0,No user reviews,0,0,0
1115470,True,0,No user reviews,0,0,0
1115480,True,0,No user reviews,0,0,0
1115490,True,0,No user reviews,0,0,0
1115540,True,0,No user reviews,0,0,0
1115570,True,0,1 user reviews,0,1,1
1115580,True,7,Positive,26,0,26
1115600,True,0,3 user reviews,3,0,3
1115610,True,0,No user reviews,0,0,0
1115620,True,0,2 user reviews,2,0,2
1115630,True,0,1 user reviews,1,0,1
1115640,True,7,Positive,34,5,39
1115650,True,5,Mixed,7,8,15
1115660,True,0,No user reviews,0,0,0
1115670,True,0,No user reviews,0,0,0
1115680,True,0,No user reviews,0,0,0
1115690,True,8,Very Positive,1297,238,1535
1115710,True,0,No user reviews,0,0,0
1115720,True,0,No user reviews,0,0,0
1115730,True,0,No user reviews,0,0,0
1115740,True,0,No user reviews,0,0,0
1115760,True,0,3 user reviews,3,0,3
1115780,True,6,Mostly Positive,23,6,29
1115790,True,0,No user reviews,0,0,0
1115791,True,0,No user reviews,0,0,0
1115820,True,0,2 user reviews,2,0,2
1115830,True,0,No user reviews,0,0,0
1115840,True,0,2 user reviews,0,2,2
1115860,True,0,No user reviews,0,0,0
1115870,True,0,No user reviews,0,0,0
1115900,True,0,No user reviews,0,0,0
1115940,True,0,No user reviews,0,0,0
1115960,True,0,No user reviews,0,0,0
1115970,True,0,1 user reviews,1,0,1
1115980,True,0,No user reviews,0,0,0
1116000,True,0,No user reviews,0,0,0
1116010,True,0,No user reviews,0,0,0
1116020,True,0,4 user reviews,2,2,4
1116030,True,0,No user reviews,0,0,0
1116050,True,0,No user reviews,0,0,0
1116060,True,5,Mixed,8,6,14
1116080,True,0,No user reviews,0,0,0
1116100,True,0,No user reviews,0,0,0
1116110,True,7,Positive,14,1,15
1116160,True,0,2 user reviews,2,0,2
1116170,True,0,No user reviews,0,0,0
1116180,True,0,3 user reviews,3,0,3
1116190,True,0,No user reviews,0,0,0
1116200,True,0,1 user reviews,1,0,1
1116210,True,5,Mixed,8,5,13
1116230,True,8,Very Positive,59,9,68
1116240,True,0,3 user reviews,2,1,3
1116260,True,0,No user reviews,0,0,0
1116270,True,0,No user reviews,0,0,0
1116280,True,0,No user reviews,0,0,0
1116290,True,7,Positive,11,2,13
1116300,True,0,1 user reviews,1,0,1
1116310,True,7,Positive,29,1,30
1116330,True,0,No user reviews,0,0,0
1116340,True,6,Mostly Positive,22,9,31
1116350,True,0,1 user reviews,0,1,1
1116360,True,0,1 user reviews,1,0,1
1116410,True,0,No user reviews,0,0,0
1116430,True,7,Positive,14,1,15
1116450,True,0,2 user reviews,2,0,2
1116470,True,4,Mostly Negative,4,11,15
1116480,True,0,No user reviews,0,0,0
1116490,True,7,Positive,12,3,15
1116500,True,0,No user reviews,0,0,0
1116520,True,4,Mostly Negative,3,7,10
1116530,True,0,No user reviews,0,0,0
1116540,True,0,No user reviews,0,0,0
1116550,True,0,No user reviews,0,0,0
1116560,True,0,No user reviews,0,0,0
1116570,True,0,No user reviews,0,0,0
1116580,True,0,No user reviews,0,0,0
1116590,True,0,5 user reviews,3,2,5
1116600,True,0,2 user reviews,0,2,2
1116630,True,0,No user reviews,0,0,0
1116640,True,0,No user reviews,0,0,0
1116650,True,0,2 user reviews,2,0,2
1116660,True,0,No user reviews,0,0,0
1116670,True,0,2 user reviews,2,0,2
1116700,True,0,4 user reviews,4,0,4
1116750,True,0,No user reviews,0,0,0
1116770,True,7,Positive,12,2,14
1116780,True,7,Positive,32,2,34
1116800,True,0,1 user reviews,1,0,1
1116810,True,0,No user reviews,0,0,0
1116860,True,0,No user reviews,0,0,0
1116870,True,0,4 user reviews,3,1,4
1116880,True,7,Positive,14,1,15
1116890,True,0,3 user reviews,3,0,3
1116910,True,0,2 user reviews,1,1,2
1116940,True,0,2 user reviews,2,0,2
1116960,True,0,No user reviews,0,0,0
1116970,True,0,No user reviews,0,0,0
1116990,True,7,Positive,24,2,26
1117000,True,0,No user reviews,0,0,0
1117020,True,0,No user reviews,0,0,0
1117030,True,0,No user reviews,0,0,0
1117040,True,0,3 user reviews,2,1,3
1117050,True,0,No user reviews,0,0,0
1117060,True,0,No user reviews,0,0,0
1117120,True,0,2 user reviews,1,1,2
1117140,True,7,Positive,20,2,22
1117150,True,0,No user reviews,0,0,0
1117160,True,0,No user reviews,0,0,0
1117200,True,0,No user reviews,0,0,0
1117210,True,0,No user reviews,0,0,0
1117220,True,0,1 user reviews,1,0,1
1117230,True,0,No user reviews,0,0,0
1117250,True,7,Positive,22,4,26
1117270,True,0,No user reviews,0,0,0
1117300,True,0,No user reviews,0,0,0
1117310,True,8,Very Positive,88,2,90
1117330,True,0,1 user reviews,0,1,1
1117340,True,0,2 user reviews,2,0,2
1117360,True,0,3 user reviews,3,0,3
1117370,True,0,No user reviews,0,0,0
1117380,True,7,Positive,16,1,17
1117390,True,0,No user reviews,0,0,0
1117420,True,0,No user reviews,0,0,0
1117450,True,0,No user reviews,0,0,0
1117470,True,0,No user reviews,0,0,0
1117480,True,7,Positive,9,1,10
1117490,True,0,3 user reviews,1,2,3
1117500,True,0,No user reviews,0,0,0
1117520,True,0,3 user reviews,1,2,3
1117540,True,0,No user reviews,0,0,0
1117541,True,0,No user reviews,0,0,0
1117550,True,0,5 user reviews,4,1,5
1117560,True,0,No user reviews,0,0,0
1117590,True,0,No user reviews,0,0,0
1117600,True,0,No user reviews,0,0,0
1117610,True,0,No user reviews,0,0,0
1117630,True,6,Mostly Positive,136,36,172
1117640,True,0,No user reviews,0,0,0
1117641,True,0,2 user reviews,2,0,2
1117660,True,0,9 user reviews,4,5,9
1117670,True,7,Positive,13,2,15
1117680,True,0,6 user reviews,1,5,6
1117690,True,0,No user reviews,0,0,0
1117710,True,0,1 user reviews,0,1,1
1117720,True,0,No user reviews,0,0,0
1117721,True,0,No user reviews,0,0,0
1117730,True,0,No user reviews,0,0,0
1117760,True,0,2 user reviews,2,0,2
1117770,True,7,Positive,13,2,15
1117800,True,0,No user reviews,0,0,0
1117810,True,0,No user reviews,0,0,0
1117840,True,0,No user reviews,0,0,0
1117850,True,0,No user reviews,0,0,0
1117860,True,5,Mixed,12,6,18
1117880,True,7,Positive,19,1,20
1117890,True,0,4 user reviews,4,0,4
1117900,True,0,3 user reviews,2,1,3
1117930,True,0,1 user reviews,1,0,1
1117940,True,0,1 user reviews,1,0,1
1117950,True,0,2 user reviews,2,0,2
1117970,True,0,1 user reviews,1,0,1
1117980,True,0,1 user reviews,1,0,1
1117990,True,0,2 user reviews,2,0,2
1118000,True,0,6 user reviews,6,0,6
1118010,True,6,Mostly Positive,2696,997,3693
1118012,True,7,Positive,21,5,26
1118013,True,0,No user reviews,0,0,0
1118014,True,0,No user reviews,0,0,0
1118015,True,0,No user reviews,0,0,0
1118017,True,0,No user reviews,0,0,0
1118018,True,0,No user reviews,0,0,0
1118019,True,0,1 user reviews,1,0,1
1118021,True,7,Positive,13,0,13
1118022,True,0,2 user reviews,2,0,2
1118023,True,0,2 user reviews,2,0,2
1118024,True,0,9 user reviews,8,1,9
1118025,True,0,5 user reviews,5,0,5
1118026,True,7,Positive,22,0,22
1118029,True,0,8 user reviews,8,0,8
1118030,True,0,No user reviews,0,0,0
1118050,True,0,5 user reviews,4,1,5
1118100,True,0,No user reviews,0,0,0
1118110,True,0,No user reviews,0,0,0
1118120,True,0,No user reviews,0,0,0
1118130,True,0,1 user reviews,1,0,1
1118140,True,0,No user reviews,0,0,0
1118150,True,0,No user reviews,0,0,0
1118160,True,0,No user reviews,0,0,0
1118170,True,0,No user reviews,0,0,0
1118180,True,0,No user reviews,0,0,0
1118200,True,9,Overwhelmingly Positive,9222,108,9330
1118210,True,0,No user reviews,0,0,0
1118220,True,0,No user reviews,0,0,0
1118230,True,0,No user reviews,0,0,0
1118240,True,0,No user reviews,0,0,0
1118263,True,0,1 user reviews,1,0,1
1118265,True,0,No user reviews,0,0,0
1118270,True,7,Positive,14,0,14
1118271,True,0,1 user reviews,1,0,1
1118272,True,0,1 user reviews,1,0,1
1118273,True,0,No user reviews,0,0,0
1118274,True,0,2 user reviews,2,0,2
1118275,True,0,2 user reviews,2,0,2
1118280,True,0,1 user reviews,0,1,1
1118281,True,0,1 user reviews,0,1,1
1118282,True,0,1 user reviews,0,1,1
1118283,True,0,2 user reviews,1,1,2
1118284,True,0,4 user reviews,2,2,4
1118285,True,0,1 user reviews,0,1,1
1118286,True,0,1 user reviews,0,1,1
1118287,True,0,1 user reviews,0,1,1
1118288,True,0,2 user reviews,1,1,2
1118290,True,5,Mixed,7,5,12
1118291,True,0,1 user reviews,0,1,1
1118292,True,5,Mixed,9,5,14
1118293,True,0,1 user reviews,0,1,1
1118294,True,0,3 user reviews,2,1,3
1118310,True,0,No user reviews,0,0,0
1118320,True,0,1 user reviews,1,0,1
1118350,True,7,Positive,10,2,12
1118370,True,0,No user reviews,0,0,0
1118380,True,7,Positive,37,9,46
1118390,True,0,No user reviews,0,0,0
1118400,True,0,No user reviews,0,0,0
1118410,True,7,Positive,13,1,14
1118430,True,0,No user reviews,0,0,0
1118440,True,0,No user reviews,0,0,0
1118470,True,0,No user reviews,0,0,0
1118500,True,0,No user reviews,0,0,0
1118510,True,0,No user reviews,0,0,0
1118520,True,0,No user reviews,0,0,0
1118540,True,0,No user reviews,0,0,0
1118550,True,0,No user reviews,0,0,0
1118570,True,0,No user reviews,0,0,0
1118580,True,0,No user reviews,0,0,0
1118590,True,0,4 user reviews,1,3,4
1118600,True,0,No user reviews,0,0,0
1118630,True,0,No user reviews,0,0,0
1118640,True,0,No user reviews,0,0,0
1118650,True,0,No user reviews,0,0,0
1118660,True,0,No user reviews,0,0,0
1118670,True,0,No user reviews,0,0,0
1118680,True,0,No user reviews,0,0,0
1118690,True,0,1 user reviews,0,1,1
1118700,True,0,7 user reviews,5,2,7
1118710,True,0,No user reviews,0,0,0
1118730,True,0,2 user reviews,0,2,2
1118740,True,0,7 user reviews,7,0,7
1118790,True,0,No user reviews,0,0,0
1118800,True,0,No user reviews,0,0,0
1118820,True,0,3 user reviews,2,1,3
1118840,True,6,Mostly Positive,9,3,12
1118870,True,0,1 user reviews,0,1,1
1118880,True,7,Positive,28,1,29
1118910,True,0,4 user reviews,1,3,4
1118920,True,0,No user reviews,0,0,0
1118930,True,0,1 user reviews,0,1,1
1118940,True,0,3 user reviews,2,1,3
1118950,True,0,1 user reviews,1,0,1
1118970,True,0,No user reviews,0,0,0
1118980,True,0,No user reviews,0,0,0
1119010,True,0,No user reviews,0,0,0
1119030,True,0,5 user reviews,5,0,5
1119040,True,0,No user reviews,0,0,0
1119050,True,0,No user reviews,0,0,0
1119060,True,0,No user reviews,0,0,0
1119070,True,0,No user reviews,0,0,0
1119100,True,0,4 user reviews,4,0,4
1119110,True,0,1 user reviews,1,0,1
1119370,True,0,No user reviews,0,0,0
1119380,True,0,1 user reviews,1,0,1
1119390,True,0,No user reviews,0,0,0
1119400,True,0,No user reviews,0,0,0
1119410,True,0,No user reviews,0,0,0
1119420,True,0,No user reviews,0,0,0
1119430,True,0,5 user reviews,5,0,5
1119500,True,0,1 user reviews,0,1,1
1119510,True,0,No user reviews,0,0,0
1119520,True,0,1 user reviews,1,0,1
1119530,True,0,4 user reviews,3,1,4
1119540,True,0,No user reviews,0,0,0
1119550,True,0,No user reviews,0,0,0
1119560,True,0,No user reviews,0,0,0
1119570,True,5,Mixed,10,7,17
1119580,True,0,No user reviews,0,0,0
1119590,True,0,No user reviews,0,0,0
1119600,True,6,Mostly Positive,75,30,105
1119620,True,0,No user reviews,0,0,0
1119630,True,0,2 user reviews,1,1,2
1119640,True,0,1 user reviews,0,1,1
1119670,True,0,3 user reviews,3,0,3
1119680,True,0,No user reviews,0,0,0
1119690,True,0,No user reviews,0,0,0
1119700,True,6,Mostly Positive,114,42,156
1119710,True,6,Mostly Positive,14,4,18
1119730,True,0,No user reviews,0,0,0
1119740,True,0,1 user reviews,1,0,1
1119750,True,0,3 user reviews,2,1,3
1119760,True,0,4 user reviews,4,0,4
1119770,True,0,1 user reviews,0,1,1
1119790,True,0,6 user reviews,6,0,6
1119800,True,7,Positive,33,4,37
1119820,True,0,No user reviews,0,0,0
1119840,True,0,No user reviews,0,0,0
1119850,True,0,No user reviews,0,0,0
1119860,True,7,Positive,10,1,11
1119880,True,0,No user reviews,0,0,0
1119890,True,0,1 user reviews,1,0,1
1119900,True,0,No user reviews,0,0,0
1119910,True,0,No user reviews,0,0,0
1119940,True,7,Positive,15,1,16
1119950,True,0,No user reviews,0,0,0
1119960,True,0,7 user reviews,7,0,7
1119970,True,0,2 user reviews,1,1,2
1119980,True,0,No user reviews,0,0,0
1119990,True,0,No user reviews,0,0,0
1119991,True,0,No user reviews,0,0,0
1119992,True,0,No user reviews,0,0,0
1119993,True,0,No user reviews,0,0,0
1119994,True,0,No user reviews,0,0,0
1119995,True,0,No user reviews,0,0,0
1119996,True,0,No user reviews,0,0,0
1119997,True,0,No user reviews,0,0,0
1119998,True,0,No user reviews,0,0,0
1119999,True,0,No user reviews,0,0,0
1120020,True,0,1 user reviews,1,0,1
1120021,True,0,No user reviews,0,0,0
1120022,True,0,No user reviews,0,0,0
1120023,True,0,No user reviews,0,0,0
1120024,True,0,No user reviews,0,0,0
1120025,True,0,1 user reviews,1,0,1
1120050,True,0,No user reviews,0,0,0
1120060,True,0,No user reviews,0,0,0
1120070,True,0,No user reviews,0,0,0
1120090,True,0,No user reviews,0,0,0
1120160,True,0,2 user reviews,2,0,2
1120180,True,0,No user reviews,0,0,0
1120200,True,0,5 user reviews,5,0,5
1120210,True,6,Mostly Positive,7,3,10
1120220,True,0,No user reviews,0,0,0
1120240,True,0,3 user reviews,2,1,3
1120250,True,0,No user reviews,0,0,0
1120260,True,0,3 user reviews,1,2,3
1120280,True,0,7 user reviews,5,2,7
1120290,True,0,2 user reviews,1,1,2
1120300,True,5,Mixed,31,14,45
1120301,True,0,5 user reviews,3,2,5
1120302,True,5,Mixed,9,11,20
1120304,True,6,Mostly Positive,12,4,16
1120305,True,5,Mixed,38,24,62
1120310,True,0,4 user reviews,4,0,4
1120320,True,0,No user reviews,0,0,0
1120330,True,0,No user reviews,0,0,0
1120340,True,0,No user reviews,0,0,0
1120360,True,7,Positive,34,3,37
1120370,True,0,2 user reviews,2,0,2
1120390,True,0,1 user reviews,1,0,1
1120400,True,0,No user reviews,0,0,0
1120410,True,0,No user reviews,0,0,0
1120420,True,7,Positive,13,0,13
1120440,True,0,No user reviews,0,0,0
1120450,True,0,No user reviews,0,0,0
1120460,True,0,No user reviews,0,0,0
1120461,True,0,2 user reviews,2,0,2
1120470,True,0,No user reviews,0,0,0
1120490,True,0,No user reviews,0,0,0
1120510,True,0,No user reviews,0,0,0
1120540,True,0,No user reviews,0,0,0
1120550,True,5,Mixed,6,7,13
1120560,True,6,Mostly Positive,30,10,40
1120570,True,0,1 user reviews,1,0,1
1120580,True,0,5 user reviews,1,4,5
1120600,True,0,2 user reviews,2,0,2
1120620,True,0,No user reviews,0,0,0
1120630,True,0,No user reviews,0,0,0
1120640,True,0,1 user reviews,1,0,1
1120670,True,0,6 user reviews,5,1,6
1120680,True,0,2 user reviews,1,1,2
1120690,True,0,No user reviews,0,0,0
1120700,True,0,No user reviews,0,0,0
1120710,True,0,2 user reviews,2,0,2
1120711,True,0,No user reviews,0,0,0
1120720,True,0,No user reviews,0,0,0
1120730,True,0,No user reviews,0,0,0
1120770,True,0,No user reviews,0,0,0
1120790,True,0,No user reviews,0,0,0
1120800,True,0,3 user reviews,3,0,3
1120810,True,8,Very Positive,76,2,78
1120820,True,0,No user reviews,0,0,0
1120840,True,0,No user reviews,0,0,0
1120841,True,0,No user reviews,0,0,0
1120842,True,0,No user reviews,0,0,0
1120843,True,0,No user reviews,0,0,0
1120844,True,0,No user reviews,0,0,0
1120850,True,0,No user reviews,0,0,0
1120860,True,0,No user reviews,0,0,0
1120880,True,0,No user reviews,0,0,0
1120890,True,0,No user reviews,0,0,0
1120900,True,0,1 user reviews,0,1,1
1120920,True,0,5 user reviews,5,0,5
1120940,True,0,9 user reviews,8,1,9
1120950,True,7,Positive,10,0,10
1120960,True,0,2 user reviews,1,1,2
1120970,True,0,3 user reviews,3,0,3
1120980,True,7,Positive,19,0,19
1120990,True,0,8 user reviews,6,2,8
1121000,True,0,No user reviews,0,0,0
1121010,True,0,No user reviews,0,0,0
1121020,True,0,No user reviews,0,0,0
1121030,True,0,No user reviews,0,0,0
1121090,True,0,No user reviews,0,0,0
1121100,True,0,1 user reviews,1,0,1
1121120,True,0,No user reviews,0,0,0
1121130,True,0,No user reviews,0,0,0
1121140,True,0,No user reviews,0,0,0
1121160,True,0,No user reviews,0,0,0
1121190,True,0,No user reviews,0,0,0
1121200,True,0,No user reviews,0,0,0
1121220,True,0,No user reviews,0,0,0
1121230,True,0,2 user reviews,1,1,2
1121260,True,0,No user reviews,0,0,0
1121270,True,7,Positive,8,2,10
1121290,True,0,No user reviews,0,0,0
1121300,True,7,Positive,21,0,21
1121310,True,0,No user reviews,0,0,0
1121320,True,0,No user reviews,0,0,0
1121330,True,0,No user reviews,0,0,0
1121340,True,0,1 user reviews,1,0,1
1121370,True,0,No user reviews,0,0,0
1121380,True,0,No user reviews,0,0,0
1121390,True,0,No user reviews,0,0,0
1121400,True,0,2 user reviews,2,0,2
1121420,True,8,Very Positive,426,25,451
1121430,True,5,Mixed,11,7,18
1121460,True,0,No user reviews,0,0,0
1121490,True,0,2 user reviews,1,1,2
1121510,True,0,No user reviews,0,0,0
1121530,True,7,Positive,32,3,35
1121550,True,0,7 user reviews,6,1,7
1121560,True,8,Very Positive,722,89,811
1121570,True,0,No user reviews,0,0,0
1121580,True,4,Mostly Negative,12,20,32
1121590,True,7,Positive,36,5,41
1121600,True,0,1 user reviews,1,0,1
1121610,True,0,No user reviews,0,0,0
1121620,True,0,2 user reviews,2,0,2
1121621,True,0,4 user reviews,4,0,4
1121622,True,0,2 user reviews,1,1,2
1121630,True,0,No user reviews,0,0,0
1121640,True,0,No user reviews,0,0,0
1121650,True,0,4 user reviews,3,1,4
1121680,True,0,No user reviews,0,0,0
1121700,True,0,No user reviews,0,0,0
1121710,True,5,Mixed,26,14,40
1121720,True,7,Positive,9,1,10
1121740,True,0,No user reviews,0,0,0
1121760,True,0,No user reviews,0,0,0
1121770,True,0,2 user reviews,1,1,2
1121790,True,0,No user reviews,0,0,0
1121800,True,0,No user reviews,0,0,0
1121810,True,0,7 user reviews,6,1,7
1121820,True,0,No user reviews,0,0,0
1121830,True,0,No user reviews,0,0,0
1121840,True,0,No user reviews,0,0,0
1121860,True,0,No user reviews,0,0,0
1121870,True,0,No user reviews,0,0,0
1121900,True,0,No user reviews,0,0,0
1121910,True,0,No user reviews,0,0,0
1121930,True,0,No user reviews,0,0,0
1121940,True,0,No user reviews,0,0,0
1121960,True,0,2 user reviews,1,1,2
1121970,True,0,No user reviews,0,0,0
1121980,True,0,No user reviews,0,0,0
1122040,True,7,Positive,36,9,45
1122050,True,8,Very Positive,226,24,250
1122060,True,0,No user reviews,0,0,0
1122080,True,0,7 user reviews,7,0,7
1122090,True,0,No user reviews,0,0,0
1122100,True,7,Positive,36,2,38
1122110,True,0,5 user reviews,0,5,5
1122120,True,8,Very Positive,119,16,135
1122140,True,0,No user reviews,0,0,0
1122150,True,5,Mixed,8,9,17
1122160,True,0,No user reviews,0,0,0
1122170,True,0,No user reviews,0,0,0
1122180,True,6,Mostly Positive,21,6,27
1122200,True,0,1 user reviews,1,0,1
1122201,True,0,No user reviews,0,0,0
1122202,True,0,No user reviews,0,0,0
1122203,True,0,No user reviews,0,0,0
1122204,True,0,1 user reviews,1,0,1
1122210,True,0,1 user reviews,0,1,1
1122230,True,0,No user reviews,0,0,0
1122240,True,7,Positive,22,5,27
1122250,True,0,2 user reviews,1,1,2
1122260,True,0,3 user reviews,1,2,3
1122270,True,4,Mostly Negative,3,9,12
1122280,True,0,No user reviews,0,0,0
1122290,True,0,No user reviews,0,0,0
1122300,True,0,No user reviews,0,0,0
1122310,True,0,1 user reviews,1,0,1
1122330,True,0,No user reviews,0,0,0
1122360,True,0,No user reviews,0,0,0
1122370,True,0,No user reviews,0,0,0
1122380,True,0,No user reviews,0,0,0
1122400,True,7,Positive,10,1,11
1122440,True,0,1 user reviews,1,0,1
1122450,True,0,No user reviews,0,0,0
1122460,True,0,1 user reviews,0,1,1
1122490,True,0,7 user reviews,6,1,7
1122510,True,0,4 user reviews,3,1,4
1122530,True,0,No user reviews,0,0,0
1122540,True,0,2 user reviews,2,0,2
1122551,True,0,No user reviews,0,0,0
1122552,True,0,No user reviews,0,0,0
1122553,True,0,No user reviews,0,0,0
1122554,True,0,No user reviews,0,0,0
1122555,True,0,No user reviews,0,0,0
1122556,True,0,No user reviews,0,0,0
1122557,True,0,No user reviews,0,0,0
1122558,True,0,No user reviews,0,0,0
1122559,True,0,No user reviews,0,0,0
1122560,True,0,No user reviews,0,0,0
1122561,True,0,No user reviews,0,0,0
1122562,True,0,No user reviews,0,0,0
1122563,True,0,No user reviews,0,0,0
1122564,True,0,No user reviews,0,0,0
1122565,True,0,1 user reviews,0,1,1
1122566,True,0,No user reviews,0,0,0
1122567,True,0,No user reviews,0,0,0
1122568,True,0,No user reviews,0,0,0
1122569,True,0,No user reviews,0,0,0
1122570,True,0,No user reviews,0,0,0
1122571,True,0,No user reviews,0,0,0
1122572,True,0,No user reviews,0,0,0
1122573,True,0,No user reviews,0,0,0
1122574,True,0,No user reviews,0,0,0
1122575,True,0,No user reviews,0,0,0
1122576,True,0,No user reviews,0,0,0
1122577,True,0,No user reviews,0,0,0
1122578,True,0,No user reviews,0,0,0
1122579,True,0,No user reviews,0,0,0
1122585,True,0,No user reviews,0,0,0
1122586,True,0,No user reviews,0,0,0
1122587,True,0,No user reviews,0,0,0
1122588,True,0,No user reviews,0,0,0
1122593,True,0,No user reviews,0,0,0
1122594,True,0,No user reviews,0,0,0
1122595,True,0,No user reviews,0,0,0
1122596,True,0,No user reviews,0,0,0
1122597,True,0,No user reviews,0,0,0
1122598,True,0,No user reviews,0,0,0
1122599,True,0,No user reviews,0,0,0
1122600,True,0,No user reviews,0,0,0
1122601,True,0,No user reviews,0,0,0
1122602,True,0,No user reviews,0,0,0
1122603,True,0,No user reviews,0,0,0
1122604,True,0,No user reviews,0,0,0
1122605,True,0,No user reviews,0,0,0
1122606,True,0,No user reviews,0,0,0
1122607,True,0,No user reviews,0,0,0
1122608,True,0,No user reviews,0,0,0
1122609,True,0,No user reviews,0,0,0
1122610,True,0,No user reviews,0,0,0
1122611,True,0,1 user reviews,0,1,1
1122612,True,0,No user reviews,0,0,0
1122614,True,0,No user reviews,0,0,0
1122615,True,0,No user reviews,0,0,0
1122616,True,0,No user reviews,0,0,0
1122617,True,0,No user reviews,0,0,0
1122618,True,0,No user reviews,0,0,0
1122619,True,0,No user reviews,0,0,0
1122620,True,0,No user reviews,0,0,0
1122621,True,0,No user reviews,0,0,0
1122622,True,0,No user reviews,0,0,0
1122623,True,0,No user reviews,0,0,0
1122624,True,0,No user reviews,0,0,0
1122625,True,0,No user reviews,0,0,0
1122626,True,0,No user reviews,0,0,0
1122627,True,0,No user reviews,0,0,0
1122628,True,0,No user reviews,0,0,0
1122629,True,0,1 user reviews,1,0,1
1122630,True,0,No user reviews,0,0,0
1122631,True,0,No user reviews,0,0,0
1122632,True,0,No user reviews,0,0,0
1122633,True,0,1 user reviews,1,0,1
1122634,True,0,No user reviews,0,0,0
1122635,True,0,No user reviews,0,0,0
1122636,True,0,No user reviews,0,0,0
1122637,True,0,No user reviews,0,0,0
1122638,True,0,No user reviews,0,0,0
1122639,True,0,No user reviews,0,0,0
1122640,True,0,No user reviews,0,0,0
1122641,True,0,No user reviews,0,0,0
1122642,True,0,No user reviews,0,0,0
1122643,True,0,No user reviews,0,0,0
1122644,True,0,No user reviews,0,0,0
1122645,True,0,No user reviews,0,0,0
1122646,True,0,No user reviews,0,0,0
1122647,True,0,No user reviews,0,0,0
1122648,True,0,No user reviews,0,0,0
1122649,True,0,No user reviews,0,0,0
1122650,True,0,No user reviews,0,0,0
1122651,True,0,No user reviews,0,0,0
1122652,True,0,No user reviews,0,0,0
1122653,True,0,No user reviews,0,0,0
1122654,True,0,1 user reviews,1,0,1
1122655,True,0,No user reviews,0,0,0
1122656,True,0,No user reviews,0,0,0
1122657,True,0,No user reviews,0,0,0
1122658,True,0,No user reviews,0,0,0
1122659,True,0,No user reviews,0,0,0
1122660,True,0,1 user reviews,1,0,1
1122661,True,0,1 user reviews,1,0,1
1122662,True,0,1 user reviews,1,0,1
1122663,True,0,No user reviews,0,0,0
1122664,True,0,1 user reviews,1,0,1
1122680,True,0,No user reviews,0,0,0
1122690,True,0,No user reviews,0,0,0
1122710,True,0,2 user reviews,0,2,2
1122720,True,9,Overwhelmingly Positive,1351,47,1398
1122740,True,0,2 user reviews,2,0,2
1122750,True,0,No user reviews,0,0,0
1122760,True,0,No user reviews,0,0,0
1122770,True,0,No user reviews,0,0,0
1122780,True,0,9 user reviews,7,2,9
1122810,True,0,2 user reviews,2,0,2
1122820,True,0,No user reviews,0,0,0
1122830,True,0,5 user reviews,5,0,5
1122850,True,0,No user reviews,0,0,0
1122860,True,0,5 user reviews,2,3,5
1122870,True,0,No user reviews,0,0,0
1122880,True,0,No user reviews,0,0,0
1122890,True,0,No user reviews,0,0,0
1122900,True,0,No user reviews,0,0,0
1122920,True,0,3 user reviews,2,1,3
1122930,True,0,No user reviews,0,0,0
1122960,True,0,No user reviews,0,0,0
1122970,True,0,No user reviews,0,0,0
1122980,True,0,3 user reviews,1,2,3
1123000,True,0,3 user reviews,2,1,3
1123020,True,0,No user reviews,0,0,0
1123030,True,0,8 user reviews,8,0,8
1123050,True,0,No user reviews,0,0,0
1123060,True,0,3 user reviews,2,1,3
1123070,True,0,1 user reviews,1,0,1
1123080,True,0,1 user reviews,1,0,1
1123090,True,0,No user reviews,0,0,0
1123100,True,0,No user reviews,0,0,0
1123120,True,0,No user reviews,0,0,0
1123140,True,5,Mixed,21,11,32
1123150,True,0,No user reviews,0,0,0
1123170,True,0,No user reviews,0,0,0
1123180,True,0,No user reviews,0,0,0
1123190,True,0,1 user reviews,1,0,1
1123200,True,0,No user reviews,0,0,0
1123210,True,0,No user reviews,0,0,0
1123230,True,7,Positive,16,1,17
1123270,True,0,7 user reviews,6,1,7
1123300,True,0,No user reviews,0,0,0
1123310,True,0,2 user reviews,2,0,2
1123340,True,0,2 user reviews,2,0,2
1123360,True,0,No user reviews,0,0,0
1123390,True,0,No user reviews,0,0,0
1123400,True,0,3 user reviews,3,0,3
1123410,True,0,1 user reviews,0,1,1
1123420,True,0,No user reviews,0,0,0
1123430,True,0,No user reviews,0,0,0
1123431,True,0,No user reviews,0,0,0
1123432,True,0,No user reviews,0,0,0
1123433,True,0,No user reviews,0,0,0
1123434,True,0,No user reviews,0,0,0
1123440,True,0,No user reviews,0,0,0
1123441,True,0,1 user reviews,1,0,1
1123450,True,0,No user reviews,0,0,0
1123460,True,0,No user reviews,0,0,0
1123470,True,0,No user reviews,0,0,0
1123471,True,0,No user reviews,0,0,0
1123472,True,0,No user reviews,0,0,0
1123480,True,0,No user reviews,0,0,0
1123481,True,0,No user reviews,0,0,0
1123482,True,0,No user reviews,0,0,0
1123500,True,0,3 user reviews,1,2,3
1123510,True,0,No user reviews,0,0,0
1123520,True,0,No user reviews,0,0,0
1123540,True,0,5 user reviews,3,2,5
1123550,True,0,4 user reviews,2,2,4
1123570,True,0,No user reviews,0,0,0
1123580,True,0,No user reviews,0,0,0
1123590,True,0,No user reviews,0,0,0
1123610,True,0,4 user reviews,0,4,4
1123620,True,0,2 user reviews,2,0,2
1123630,True,0,No user reviews,0,0,0
1123631,True,0,No user reviews,0,0,0
1123632,True,0,No user reviews,0,0,0
1123633,True,0,No user reviews,0,0,0
1123634,True,0,No user reviews,0,0,0
1123640,True,0,No user reviews,0,0,0
1123650,True,0,4 user reviews,2,2,4
1123670,True,0,No user reviews,0,0,0
1123690,True,0,No user reviews,0,0,0
1123700,True,0,No user reviews,0,0,0
1123720,True,0,No user reviews,0,0,0
1123730,True,0,No user reviews,0,0,0
1123760,True,0,No user reviews,0,0,0
1123770,True,8,Very Positive,734,77,811
1123790,True,6,Mostly Positive,9,3,12
1123800,True,0,No user reviews,0,0,0
1123801,True,0,No user reviews,0,0,0
1123802,True,0,No user reviews,0,0,0
1123803,True,0,No user reviews,0,0,0
1123804,True,0,No user reviews,0,0,0
1123805,True,0,No user reviews,0,0,0
1123810,True,0,No user reviews,0,0,0
1123830,True,0,No user reviews,0,0,0
1123840,True,0,No user reviews,0,0,0
1123850,True,0,No user reviews,0,0,0
1123860,True,0,No user reviews,0,0,0
1123870,True,0,3 user reviews,1,2,3
1123880,True,0,No user reviews,0,0,0
1123890,True,0,1 user reviews,1,0,1
1123900,True,0,1 user reviews,1,0,1
1123910,True,0,1 user reviews,0,1,1
1123920,True,0,No user reviews,0,0,0
1123930,True,0,No user reviews,0,0,0
1123950,True,0,3 user reviews,2,1,3
1123960,True,0,No user reviews,0,0,0
1123980,True,0,No user reviews,0,0,0
1124000,True,0,No user reviews,0,0,0
1124010,True,0,No user reviews,0,0,0
1124030,True,0,2 user reviews,2,0,2
1124040,True,0,No user reviews,0,0,0
1124050,True,5,Mixed,10,7,17
1124060,True,7,Positive,20,1,21
1124070,True,0,No user reviews,0,0,0
1124090,True,0,No user reviews,0,0,0
1124100,True,0,No user reviews,0,0,0
1124110,True,0,No user reviews,0,0,0
1124113,True,0,No user reviews,0,0,0
1124114,True,0,1 user reviews,1,0,1
1124115,True,0,No user reviews,0,0,0
1124116,True,0,No user reviews,0,0,0
1124120,True,0,No user reviews,0,0,0
1124130,True,0,No user reviews,0,0,0
1124140,True,0,3 user reviews,3,0,3
1124151,True,0,No user reviews,0,0,0
1124152,True,0,No user reviews,0,0,0
1124153,True,0,2 user reviews,2,0,2
1124154,True,0,1 user reviews,0,1,1
1124155,True,0,1 user reviews,0,1,1
1124156,True,0,No user reviews,0,0,0
1124157,True,0,No user reviews,0,0,0
1124158,True,0,No user reviews,0,0,0
1124160,True,0,No user reviews,0,0,0
1124170,True,0,No user reviews,0,0,0
1124190,True,0,4 user reviews,3,1,4
1124200,True,0,No user reviews,0,0,0
1124210,True,0,1 user reviews,1,0,1
1124260,True,0,No user reviews,0,0,0
1124270,True,0,1 user reviews,0,1,1
1124280,True,0,No user reviews,0,0,0
1124300,True,0,No user reviews,0,0,0
1124310,True,0,1 user reviews,1,0,1
1124320,True,0,No user reviews,0,0,0
1124340,True,0,No user reviews,0,0,0
1124370,True,0,No user reviews,0,0,0
1124380,True,0,1 user reviews,1,0,1
1124390,True,0,4 user reviews,3,1,4
1124400,True,0,3 user reviews,1,2,3
1124410,True,0,2 user reviews,2,0,2
1124430,True,0,6 user reviews,5,1,6
1124440,True,0,No user reviews,0,0,0
1124441,True,0,No user reviews,0,0,0
1124460,True,0,No user reviews,0,0,0
1124470,True,0,No user reviews,0,0,0
1124480,True,0,No user reviews,0,0,0
1124510,True,0,1 user reviews,0,1,1
1124520,True,0,No user reviews,0,0,0
1124530,True,5,Mixed,7,10,17
1124540,True,0,7 user reviews,6,1,7
1124541,True,0,8 user reviews,8,0,8
1124550,True,0,1 user reviews,1,0,1
1124560,True,7,Positive,8,2,10
1124590,True,0,No user reviews,0,0,0
1124600,True,0,No user reviews,0,0,0
1124630,True,0,1 user reviews,1,0,1
1124640,True,0,No user reviews,0,0,0
1124660,True,8,Very Positive,182,24,206
1124680,True,0,No user reviews,0,0,0
1124690,True,0,No user reviews,0,0,0
1124700,True,0,No user reviews,0,0,0
1124701,True,0,No user reviews,0,0,0
1124702,True,0,No user reviews,0,0,0
1124710,True,0,5 user reviews,4,1,5
1124740,True,0,No user reviews,0,0,0
1124750,True,0,No user reviews,0,0,0
1124760,True,0,No user reviews,0,0,0
1124780,True,0,No user reviews,0,0,0
1124790,True,0,1 user reviews,0,1,1
1124800,True,0,No user reviews,0,0,0
1124810,True,0,No user reviews,0,0,0
1124820,True,0,No user reviews,0,0,0
1124830,True,7,Positive,11,0,11
1124850,True,0,No user reviews,0,0,0
1124860,True,0,1 user reviews,1,0,1
1124910,True,0,4 user reviews,4,0,4
1124930,True,0,No user reviews,0,0,0
1124940,True,0,No user reviews,0,0,0
1124950,True,0,1 user reviews,1,0,1
1124960,True,0,1 user reviews,1,0,1
1124970,True,0,No user reviews,0,0,0
1124980,True,0,2 user reviews,2,0,2
1124990,True,0,9 user reviews,9,0,9
1125000,True,0,1 user reviews,1,0,1
1125020,True,5,Mixed,58,54,112
1125030,True,0,4 user reviews,0,4,4
1125050,True,0,1 user reviews,0,1,1
1125060,True,0,2 user reviews,2,0,2
1125090,True,7,Positive,12,0,12
1125100,True,0,4 user reviews,3,1,4
1125110,True,7,Positive,37,5,42
1125130,True,0,2 user reviews,1,1,2
1125210,True,7,Positive,17,2,19
1125220,True,0,No user reviews,0,0,0
1125240,True,0,No user reviews,0,0,0
1125250,True,0,8 user reviews,6,2,8
1125260,True,7,Positive,11,1,12
1125270,True,7,Positive,16,2,18
1125290,True,0,No user reviews,0,0,0
1125300,True,0,No user reviews,0,0,0
1125310,True,0,No user reviews,0,0,0
1125320,True,0,No user reviews,0,0,0
1125330,True,8,Very Positive,84,16,100
1125340,True,0,2 user reviews,2,0,2
1125350,True,0,3 user reviews,3,0,3
1125360,True,0,6 user reviews,6,0,6
1125370,True,0,4 user reviews,4,0,4
1125390,True,0,No user reviews,0,0,0
1125400,True,0,6 user reviews,6,0,6
1125420,True,0,6 user reviews,6,0,6
1125430,True,0,No user reviews,0,0,0
1125440,True,0,No user reviews,0,0,0
1125450,True,0,1 user reviews,1,0,1
1125480,True,0,1 user reviews,0,1,1
1125490,True,0,6 user reviews,4,2,6
1125510,True,0,No user reviews,0,0,0
1125550,True,0,No user reviews,0,0,0
1125590,True,0,No user reviews,0,0,0
1125600,True,0,1 user reviews,0,1,1
1125610,True,0,No user reviews,0,0,0
1125620,True,0,No user reviews,0,0,0
1125630,True,5,Mixed,30,19,49
1125640,True,0,No user reviews,0,0,0
1125641,True,0,No user reviews,0,0,0
1125642,True,0,1 user reviews,0,1,1
1125660,True,0,No user reviews,0,0,0
1125670,True,0,No user reviews,0,0,0
1125680,True,0,No user reviews,0,0,0
1125690,True,0,No user reviews,0,0,0
1125700,True,0,No user reviews,0,0,0
1125710,True,0,No user reviews,0,0,0
1125730,True,0,No user reviews,0,0,0
1125760,True,7,Positive,9,1,10
1125770,True,0,1 user reviews,0,1,1
1125780,True,0,No user reviews,0,0,0
1125790,True,0,2 user reviews,2,0,2
1125791,True,0,No user reviews,0,0,0
1125800,True,0,4 user reviews,4,0,4
1125810,True,0,No user reviews,0,0,0
1125820,True,0,2 user reviews,2,0,2
1125830,True,0,No user reviews,0,0,0
1125860,True,7,Positive,19,0,19
1125870,True,0,No user reviews,0,0,0
1125880,True,0,No user reviews,0,0,0
1125890,True,0,No user reviews,0,0,0
1125900,True,0,3 user reviews,2,1,3
1125910,True,0,No user reviews,0,0,0
1125930,True,7,Positive,10,0,10
1125980,True,0,No user reviews,0,0,0
1126020,True,0,No user reviews,0,0,0
1126030,True,0,No user reviews,0,0,0
1126040,True,0,No user reviews,0,0,0
1126050,True,6,Mostly Positive,96,28,124
1126060,True,0,4 user reviews,4,0,4
1126070,True,0,4 user reviews,4,0,4
1126080,True,0,No user reviews,0,0,0
1126090,True,0,1 user reviews,1,0,1
1126100,True,0,1 user reviews,0,1,1
1126120,True,0,No user reviews,0,0,0
1126130,True,0,6 user reviews,5,1,6
1126140,True,0,No user reviews,0,0,0
1126190,True,5,Mixed,20,9,29
1126200,True,8,Very Positive,62,4,66
1126210,True,0,No user reviews,0,0,0
1126220,True,0,6 user reviews,3,3,6
1126230,True,0,No user reviews,0,0,0
1126240,True,0,No user reviews,0,0,0
1126260,True,0,No user reviews,0,0,0
1126270,True,7,Positive,26,1,27
1126280,True,0,No user reviews,0,0,0
1126290,True,6,Mostly Positive,148,43,191
1126300,True,0,2 user reviews,1,1,2
1126310,True,7,Positive,11,0,11
1126320,True,9,Overwhelmingly Positive,1556,34,1590
1126340,True,0,4 user reviews,3,1,4
1126350,True,0,No user reviews,0,0,0
1126380,True,0,No user reviews,0,0,0
1126400,True,0,No user reviews,0,0,0
1126410,True,0,No user reviews,0,0,0
1126420,True,8,Very Positive,68,8,76
1126430,True,0,No user reviews,0,0,0
1126440,True,0,3 user reviews,2,1,3
1126450,True,0,No user reviews,0,0,0
1126460,True,0,No user reviews,0,0,0
1126470,True,7,Positive,11,1,12
1126480,True,0,No user reviews,0,0,0
1126510,True,0,No user reviews,0,0,0
1126520,True,0,No user reviews,0,0,0
1126530,True,0,No user reviews,0,0,0
1126540,True,0,No user reviews,0,0,0
1126550,True,0,1 user reviews,1,0,1
1126560,True,0,4 user reviews,1,3,4
1126570,True,0,2 user reviews,1,1,2
1126580,True,0,No user reviews,0,0,0
1126590,True,0,No user reviews,0,0,0
1126600,True,7,Positive,20,1,21
1126610,True,0,No user reviews,0,0,0
1126620,True,0,No user reviews,0,0,0
1126630,True,0,No user reviews,0,0,0
1126640,True,0,No user reviews,0,0,0
1126670,True,0,No user reviews,0,0,0
1126680,True,0,No user reviews,0,0,0
1126700,True,0,No user reviews,0,0,0
1126710,True,0,8 user reviews,7,1,8
1126720,True,0,No user reviews,0,0,0
1126740,True,0,No user reviews,0,0,0
1126750,True,7,Positive,22,1,23
1126760,True,0,No user reviews,0,0,0
1126770,True,4,Mostly Negative,5,9,14
1126810,True,0,No user reviews,0,0,0
1126820,True,0,1 user reviews,1,0,1
1126840,True,0,3 user reviews,2,1,3
1126850,True,0,4 user reviews,4,0,4
1126860,True,0,1 user reviews,1,0,1
1126890,True,7,Positive,35,5,40
1126900,True,0,No user reviews,0,0,0
1126910,True,0,No user reviews,0,0,0
1126930,True,0,3 user reviews,3,0,3
1126940,True,0,No user reviews,0,0,0
1126950,True,0,2 user reviews,2,0,2
1126960,True,0,No user reviews,0,0,0
1126970,True,0,No user reviews,0,0,0
1126990,True,6,Mostly Positive,59,18,77
1127000,True,0,No user reviews,0,0,0
1127010,True,0,No user reviews,0,0,0
1127030,True,0,No user reviews,0,0,0
1127070,True,7,Positive,34,8,42
1127100,True,0,1 user reviews,1,0,1
1127110,True,0,No user reviews,0,0,0
1127120,True,0,1 user reviews,1,0,1
1127130,True,0,2 user reviews,2,0,2
1127140,True,0,No user reviews,0,0,0
1127160,True,0,No user reviews,0,0,0
1127170,True,0,3 user reviews,1,2,3
1127180,True,0,2 user reviews,1,1,2
1127190,True,8,Very Positive,237,36,273
1127200,True,0,1 user reviews,1,0,1
1127210,True,0,1 user reviews,1,0,1
1127230,True,0,1 user reviews,1,0,1
1127250,True,0,No user reviews,0,0,0
1127270,True,0,1 user reviews,1,0,1
1127290,True,0,6 user reviews,3,3,6
1127300,True,0,No user reviews,0,0,0
1127310,True,5,Mixed,24,13,37
1127330,True,0,No user reviews,0,0,0
1127340,True,0,No user reviews,0,0,0
1127350,True,0,2 user reviews,1,1,2
1127360,True,0,No user reviews,0,0,0
1127390,True,7,Positive,8,2,10
1127400,True,9,Overwhelmingly Positive,2904,73,2977
1127410,True,0,1 user reviews,1,0,1
1127411,True,0,1 user reviews,1,0,1
1127412,True,0,1 user reviews,1,0,1
1127420,True,0,1 user reviews,0,1,1
1127430,True,0,No user reviews,0,0,0
1127450,True,7,Positive,35,3,38
1127460,True,5,Mixed,300,297,597
1127470,True,0,No user reviews,0,0,0
1127480,True,0,1 user reviews,1,0,1
1127490,True,0,No user reviews,0,0,0
1127500,True,0,No user reviews,0,0,0
1127510,True,0,No user reviews,0,0,0
1127520,True,0,1 user reviews,1,0,1
1127530,True,0,1 user reviews,1,0,1
1127540,True,0,8 user reviews,7,1,8
1127560,True,0,No user reviews,0,0,0
1127580,True,0,1 user reviews,1,0,1
1127590,True,0,No user reviews,0,0,0
1127600,True,0,3 user reviews,2,1,3
1127610,True,8,Very Positive,74,7,81
1127620,True,0,No user reviews,0,0,0
1127640,True,0,No user reviews,0,0,0
1127670,True,0,No user reviews,0,0,0
1127680,True,7,Positive,25,0,25
1127690,True,0,1 user reviews,0,1,1
1127700,True,0,No user reviews,0,0,0
1127730,True,0,3 user reviews,2,1,3
1127750,True,0,No user reviews,0,0,0
1127760,True,0,No user reviews,0,0,0
1127770,True,0,No user reviews,0,0,0
1127780,True,0,No user reviews,0,0,0
1127800,True,0,1 user reviews,1,0,1
1127820,True,0,3 user reviews,2,1,3
1127840,True,8,Very Positive,277,34,311
1127850,True,8,Very Positive,63,0,63
1127860,True,0,5 user reviews,4,1,5
1127870,True,0,3 user reviews,2,1,3
1127880,True,0,2 user reviews,2,0,2
1127900,True,0,9 user reviews,7,2,9
1127910,True,0,No user reviews,0,0,0
1127920,True,0,1 user reviews,0,1,1
1127930,True,0,8 user reviews,5,3,8
1127940,True,0,No user reviews,0,0,0
1127950,True,0,No user reviews,0,0,0
1127970,True,0,No user reviews,0,0,0
1127980,True,8,Very Positive,513,106,619
1128000,True,5,Mixed,1652,2273,3925
1128010,True,0,No user reviews,0,0,0
1128020,True,7,Positive,21,1,22
1128030,True,0,No user reviews,0,0,0
1128040,True,0,No user reviews,0,0,0
1128050,True,0,No user reviews,0,0,0
1128060,True,0,No user reviews,0,0,0
1128070,True,0,1 user reviews,1,0,1
1128080,True,0,2 user reviews,1,1,2
1128090,True,0,No user reviews,0,0,0
1128100,True,7,Positive,20,5,25
1128120,True,0,No user reviews,0,0,0
1128130,True,0,No user reviews,0,0,0
1128140,True,5,Mixed,18,8,26
1128150,True,0,1 user reviews,0,1,1
1128160,True,0,1 user reviews,0,1,1
1128170,True,0,4 user reviews,3,1,4
1128180,True,7,Positive,41,5,46
1128190,True,7,Positive,26,6,32
1128200,True,0,1 user reviews,1,0,1
1128210,True,0,7 user reviews,6,1,7
1128220,True,0,9 user reviews,7,2,9
1128230,True,0,No user reviews,0,0,0
1128250,True,0,No user reviews,0,0,0
1128260,True,7,Positive,12,1,13
1128270,True,0,4 user reviews,3,1,4
1128280,True,0,No user reviews,0,0,0
1128290,True,0,No user reviews,0,0,0
1128310,True,0,1 user reviews,0,1,1
1128330,True,0,No user reviews,0,0,0
1128350,True,0,1 user reviews,0,1,1
1128360,True,0,No user reviews,0,0,0
1128370,True,0,1 user reviews,1,0,1
1128380,True,0,No user reviews,0,0,0
1128400,True,0,1 user reviews,1,0,1
1128420,True,0,2 user reviews,2,0,2
1128430,True,0,1 user reviews,1,0,1
1128440,True,0,3 user reviews,3,0,3
1128450,True,0,2 user reviews,2,0,2
1128460,True,0,No user reviews,0,0,0
1128480,True,0,No user reviews,0,0,0
1128500,True,0,No user reviews,0,0,0
1128510,True,0,1 user reviews,1,0,1
1128520,True,0,6 user reviews,6,0,6
1128530,True,0,No user reviews,0,0,0
1128540,True,4,Mostly Negative,26,56,82
1128550,True,0,2 user reviews,1,1,2
1128560,True,0,No user reviews,0,0,0
1128570,True,0,6 user reviews,6,0,6
1128580,True,0,No user reviews,0,0,0
1128610,True,0,6 user reviews,6,0,6
1128630,True,0,1 user reviews,1,0,1
1128640,True,0,No user reviews,0,0,0
1128650,True,0,No user reviews,0,0,0
1128660,True,0,1 user reviews,0,1,1
1128670,True,0,No user reviews,0,0,0
1128680,True,0,No user reviews,0,0,0
1128690,True,7,Positive,44,2,46
1128740,True,0,No user reviews,0,0,0
1128750,True,0,No user reviews,0,0,0
1128760,True,0,No user reviews,0,0,0
1128770,True,0,2 user reviews,2,0,2
1128790,True,0,No user reviews,0,0,0
1128800,True,5,Mixed,11,14,25
1128810,True,7,Positive,18,0,18
1128820,True,0,No user reviews,0,0,0
1128830,True,0,2 user reviews,2,0,2
1128840,True,0,3 user reviews,2,1,3
1128850,True,0,No user reviews,0,0,0
1128880,True,7,Positive,9,1,10
1128890,True,0,No user reviews,0,0,0
1128900,True,5,Mixed,28,16,44
1128910,True,0,No user reviews,0,0,0
1128920,True,0,No user reviews,0,0,0
1128930,True,0,No user reviews,0,0,0
1128940,True,0,No user reviews,0,0,0
1128950,True,0,No user reviews,0,0,0
1128970,True,0,No user reviews,0,0,0
1129000,True,0,No user reviews,0,0,0
1129010,True,8,Very Positive,98,17,115
1129030,True,0,9 user reviews,7,2,9
1129040,True,0,4 user reviews,4,0,4
1129050,True,7,Positive,28,4,32
1129060,True,0,No user reviews,0,0,0
1129070,True,0,No user reviews,0,0,0
1129080,True,0,2 user reviews,1,1,2
1129090,True,7,Positive,17,2,19
1129100,True,0,No user reviews,0,0,0
1129110,True,0,No user reviews,0,0,0
1129120,True,0,No user reviews,0,0,0
1129180,True,0,2 user reviews,2,0,2
1129190,True,0,No user reviews,0,0,0
1129200,True,0,1 user reviews,0,1,1
1129210,True,0,No user reviews,0,0,0
1129220,True,8,Very Positive,214,22,236
1129230,True,0,No user reviews,0,0,0
1129240,True,0,2 user reviews,2,0,2
1129250,True,7,Positive,17,0,17
1129300,True,0,No user reviews,0,0,0
1129310,True,8,Very Positive,923,113,1036
1129330,True,0,6 user reviews,6,0,6
1129340,True,0,No user reviews,0,0,0
1129350,True,0,6 user reviews,6,0,6
1129360,True,0,No user reviews,0,0,0
1129370,True,0,No user reviews,0,0,0
1129410,True,0,No user reviews,0,0,0
1129430,True,0,No user reviews,0,0,0
1129470,True,0,1 user reviews,1,0,1
1129480,True,0,No user reviews,0,0,0
1129500,True,0,No user reviews,0,0,0
1129520,True,0,No user reviews,0,0,0
1129530,True,0,No user reviews,0,0,0
1129540,True,0,No user reviews,0,0,0
1129550,True,0,No user reviews,0,0,0
1129580,True,8,Very Positive,3316,308,3624
1129610,True,0,No user reviews,0,0,0
1129650,True,0,No user reviews,0,0,0
1129660,True,6,Mostly Positive,21,6,27
1129670,True,0,No user reviews,0,0,0
1129680,True,0,5 user reviews,4,1,5
1129690,True,0,5 user reviews,5,0,5
1129700,True,0,No user reviews,0,0,0
1129710,True,0,No user reviews,0,0,0
1129720,True,0,2 user reviews,2,0,2
1129730,True,7,Positive,8,2,10
1129810,True,0,No user reviews,0,0,0
1129920,True,8,Very Positive,114,1,115
1130220,True,0,No user reviews,0,0,0
1130390,True,0,No user reviews,0,0,0
1130400,True,0,7 user reviews,5,2,7
1130410,True,8,Very Positive,107,2,109
1130430,True,0,2 user reviews,2,0,2
1130440,True,0,No user reviews,0,0,0
1130510,True,0,6 user reviews,5,1,6
1130560,True,6,Mostly Positive,32,9,41
1130570,True,0,6 user reviews,6,0,6
1130590,True,0,5 user reviews,3,2,5
1130600,True,0,No user reviews,0,0,0
1130620,True,8,Very Positive,84,11,95
1130630,True,7,Positive,20,1,21
1130660,True,0,No user reviews,0,0,0
1130680,True,0,No user reviews,0,0,0
1130690,True,0,1 user reviews,1,0,1
1130700,True,0,No user reviews,0,0,0
1130710,True,0,4 user reviews,3,1,4
1130720,True,0,5 user reviews,3,2,5
1130750,True,0,1 user reviews,1,0,1
1130760,True,0,No user reviews,0,0,0
1130770,True,0,4 user reviews,3,1,4
1130780,True,0,1 user reviews,1,0,1
1130790,True,0,1 user reviews,0,1,1
1130800,True,0,2 user reviews,1,1,2
1130810,True,0,2 user reviews,1,1,2
1130820,True,0,No user reviews,0,0,0
1130840,True,0,6 user reviews,5,1,6
1130850,True,0,No user reviews,0,0,0
1130870,True,0,No user reviews,0,0,0
1130871,True,0,No user reviews,0,0,0
1130872,True,0,No user reviews,0,0,0
1130880,True,0,5 user reviews,5,0,5
1130900,True,0,No user reviews,0,0,0
1130960,True,0,No user reviews,0,0,0
1130970,True,0,No user reviews,0,0,0
1130990,True,0,5 user reviews,5,0,5
1131000,True,0,No user reviews,0,0,0
1131010,True,0,No user reviews,0,0,0
1131020,True,0,No user reviews,0,0,0
1131050,True,0,8 user reviews,6,2,8
1131090,True,0,No user reviews,0,0,0
1131110,True,0,2 user reviews,2,0,2
1131130,True,0,No user reviews,0,0,0
1131140,True,0,No user reviews,0,0,0
1131150,True,0,No user reviews,0,0,0
1131160,True,0,1 user reviews,0,1,1
1131170,True,7,Positive,29,6,35
1131210,True,0,No user reviews,0,0,0
1131230,True,0,No user reviews,0,0,0
1131240,True,6,Mostly Positive,68,18,86
1131270,True,0,4 user reviews,3,1,4
1131280,True,0,1 user reviews,0,1,1
1131290,True,0,No user reviews,0,0,0
1131320,True,0,No user reviews,0,0,0
1131330,True,0,8 user reviews,6,2,8
1131340,True,0,No user reviews,0,0,0
1131350,True,0,No user reviews,0,0,0
1131360,True,0,No user reviews,0,0,0
1131370,True,0,No user reviews,0,0,0
1131390,True,0,No user reviews,0,0,0
1131400,True,5,Mixed,34,15,49
1131410,True,7,Positive,19,0,19
1131420,True,0,5 user reviews,0,5,5
1131430,True,0,1 user reviews,1,0,1
1131440,True,0,No user reviews,0,0,0
1131450,True,5,Mixed,7,4,11
1131460,True,0,No user reviews,0,0,0
1131470,True,0,No user reviews,0,0,0
1131480,True,0,No user reviews,0,0,0
1131490,True,0,No user reviews,0,0,0
1131500,True,0,No user reviews,0,0,0
1131520,True,0,3 user reviews,3,0,3
1131530,True,7,Positive,11,0,11
1131540,True,0,4 user reviews,4,0,4
1131570,True,0,No user reviews,0,0,0
1131580,True,0,1 user reviews,1,0,1
1131590,True,0,No user reviews,0,0,0
1131640,True,0,1 user reviews,1,0,1
1131650,True,0,No user reviews,0,0,0
1131660,True,0,1 user reviews,1,0,1
1131670,True,0,No user reviews,0,0,0
1131680,True,0,3 user reviews,2,1,3
1131690,True,0,No user reviews,0,0,0
1131720,True,0,4 user reviews,3,1,4
1131740,True,0,2 user reviews,2,0,2
1131750,True,7,Positive,27,1,28
1131780,True,0,1 user reviews,1,0,1
1131790,True,0,1 user reviews,1,0,1
1131800,True,0,No user reviews,0,0,0
1131810,True,0,4 user reviews,2,2,4
1131820,True,0,No user reviews,0,0,0
1131830,True,0,No user reviews,0,0,0
1131840,True,0,No user reviews,0,0,0
1131850,True,0,No user reviews,0,0,0
1131860,True,0,No user reviews,0,0,0
1131870,True,0,No user reviews,0,0,0
1131880,True,0,No user reviews,0,0,0
1131900,True,7,Positive,24,3,27
1131910,True,0,1 user reviews,1,0,1
1131930,True,0,5 user reviews,5,0,5
1131940,True,0,1 user reviews,1,0,1
1131960,True,0,No user reviews,0,0,0
1131980,True,0,No user reviews,0,0,0
1131990,True,0,4 user reviews,1,3,4
1132010,True,0,3 user reviews,1,2,3
1132020,True,0,No user reviews,0,0,0
1132030,True,0,No user reviews,0,0,0
1132050,True,0,No user reviews,0,0,0
1132060,True,0,1 user reviews,1,0,1
1132070,True,7,Positive,11,1,12
1132080,True,0,7 user reviews,4,3,7
1132090,True,0,5 user reviews,4,1,5
1132100,True,7,Positive,29,6,35
1132110,True,0,7 user reviews,6,1,7
1132120,True,7,Positive,22,3,25
1132130,True,0,No user reviews,0,0,0
1132150,True,0,No user reviews,0,0,0
1132160,True,0,6 user reviews,6,0,6
1132180,True,0,No user reviews,0,0,0
1132190,True,0,2 user reviews,2,0,2
1132210,True,6,Mostly Positive,632,255,887
1132220,True,0,6 user reviews,6,0,6
1132230,True,0,2 user reviews,1,1,2
1132240,True,0,3 user reviews,2,1,3
1132290,True,0,3 user reviews,2,1,3
1132300,True,0,1 user reviews,0,1,1
1132310,True,0,No user reviews,0,0,0
1132330,True,0,No user reviews,0,0,0
1132350,True,0,No user reviews,0,0,0
1132390,True,0,No user reviews,0,0,0
1132410,True,4,Mostly Negative,4,8,12
1132450,True,0,No user reviews,0,0,0
1132460,True,0,3 user reviews,2,1,3
1132480,True,0,No user reviews,0,0,0
1132490,True,0,No user reviews,0,0,0
1132510,True,0,2 user reviews,2,0,2
1132530,True,0,No user reviews,0,0,0
1132540,True,0,3 user reviews,2,1,3
1132550,True,0,No user reviews,0,0,0
1132600,True,0,4 user reviews,2,2,4
1132620,True,0,3 user reviews,3,0,3
1132630,True,0,No user reviews,0,0,0
1132640,True,0,1 user reviews,1,0,1
1132650,True,0,No user reviews,0,0,0
1132670,True,0,No user reviews,0,0,0
1132690,True,0,No user reviews,0,0,0
1132700,True,0,3 user reviews,3,0,3
1132710,True,7,Positive,19,3,22
1132730,True,0,8 user reviews,7,1,8
1132750,True,0,5 user reviews,2,3,5
1132760,True,0,No user reviews,0,0,0
1132780,True,0,No user reviews,0,0,0
1132790,True,0,No user reviews,0,0,0
1132830,True,0,No user reviews,0,0,0
1132840,True,0,1 user reviews,0,1,1
1132850,True,0,1 user reviews,1,0,1
1132860,True,0,No user reviews,0,0,0
1132870,True,0,No user reviews,0,0,0
1132871,True,0,1 user reviews,1,0,1
1132872,True,0,No user reviews,0,0,0
1132873,True,0,1 user reviews,1,0,1
1132880,True,0,No user reviews,0,0,0
1132900,True,0,No user reviews,0,0,0
1132910,True,0,No user reviews,0,0,0
1132920,True,0,1 user reviews,0,1,1
1132930,True,0,2 user reviews,2,0,2
1132960,True,0,No user reviews,0,0,0
1132970,True,0,No user reviews,0,0,0
1132980,True,0,No user reviews,0,0,0
1132990,True,0,No user reviews,0,0,0
1133000,True,8,Very Positive,53,13,66
1133020,True,7,Positive,16,4,20
1133040,True,0,No user reviews,0,0,0
1133050,True,0,No user reviews,0,0,0
1133070,True,7,Positive,16,3,19
1133090,True,0,No user reviews,0,0,0
1133110,True,0,No user reviews,0,0,0
1133120,True,0,No user reviews,0,0,0
1133130,True,0,No user reviews,0,0,0
1133160,True,0,No user reviews,0,0,0
1133170,True,0,No user reviews,0,0,0
1133200,True,0,1 user reviews,1,0,1
1133210,True,0,7 user reviews,6,1,7
1133220,True,0,No user reviews,0,0,0
1133230,True,0,9 user reviews,4,5,9
1133250,True,0,1 user reviews,1,0,1
1133260,True,0,3 user reviews,3,0,3
1133290,True,0,No user reviews,0,0,0
1133300,True,0,No user reviews,0,0,0
1133310,True,0,3 user reviews,2,1,3
1133320,True,8,Very Positive,134,25,159
1133330,True,5,Mixed,28,16,44
1133340,True,0,No user reviews,0,0,0
1133350,True,0,4 user reviews,1,3,4
1133360,True,0,No user reviews,0,0,0
1133380,True,0,No user reviews,0,0,0
1133400,True,0,No user reviews,0,0,0
1133410,True,0,No user reviews,0,0,0
1133420,True,5,Mixed,13,8,21
1133450,True,7,Positive,8,2,10
1133470,True,0,No user reviews,0,0,0
1133490,True,0,No user reviews,0,0,0
1133510,True,0,No user reviews,0,0,0
1133520,True,0,1 user reviews,1,0,1
1133530,True,0,No user reviews,0,0,0
1133540,True,0,No user reviews,0,0,0
1133550,True,0,1 user reviews,1,0,1
1133551,True,0,1 user reviews,1,0,1
1133560,True,0,No user reviews,0,0,0
1133570,True,0,No user reviews,0,0,0
1133580,True,7,Positive,28,2,30
1133590,True,8,Very Positive,64,3,67
1133600,True,0,No user reviews,0,0,0
1133610,True,0,No user reviews,0,0,0
1133640,True,0,No user reviews,0,0,0
1133650,True,0,No user reviews,0,0,0
1133660,True,0,No user reviews,0,0,0
1133680,True,0,No user reviews,0,0,0
1133690,True,0,No user reviews,0,0,0
1133700,True,0,No user reviews,0,0,0
1133720,True,0,No user reviews,0,0,0
1133730,True,0,No user reviews,0,0,0
1133770,True,6,Mostly Positive,33,10,43
1133780,True,0,2 user reviews,2,0,2
1133790,True,7,Positive,17,1,18
1133800,True,0,No user reviews,0,0,0
1133820,True,0,No user reviews,0,0,0
1133840,True,0,No user reviews,0,0,0
1133850,True,0,No user reviews,0,0,0
1133860,True,0,No user reviews,0,0,0
1133880,True,0,No user reviews,0,0,0
1133890,True,0,2 user reviews,2,0,2
1133910,True,0,No user reviews,0,0,0
1133930,True,7,Positive,20,4,24
1133950,True,0,3 user reviews,3,0,3
1133960,True,0,No user reviews,0,0,0
1133970,True,0,2 user reviews,2,0,2
1133980,True,0,1 user reviews,1,0,1
1133990,True,7,Positive,14,1,15
1134010,True,5,Mixed,9,9,18
1134020,True,0,No user reviews,0,0,0
1134030,True,0,No user reviews,0,0,0
1134040,True,0,1 user reviews,1,0,1
1134050,True,0,2 user reviews,1,1,2
1134070,True,0,No user reviews,0,0,0
1134090,True,0,No user reviews,0,0,0
1134120,True,0,1 user reviews,1,0,1
1134130,True,0,No user reviews,0,0,0
1134140,True,0,1 user reviews,1,0,1
1134150,True,0,No user reviews,0,0,0
1134160,True,7,Positive,17,0,17
1134180,True,7,Positive,21,4,25
1134190,True,0,6 user reviews,6,0,6
1134200,True,6,Mostly Positive,10,3,13
1134250,True,0,5 user reviews,4,1,5
1134260,True,0,No user reviews,0,0,0
1134320,True,0,No user reviews,0,0,0
1134340,True,0,No user reviews,0,0,0
1134350,True,0,No user reviews,0,0,0
1134360,True,0,5 user reviews,2,3,5
1134370,True,0,1 user reviews,1,0,1
1134380,True,0,4 user reviews,4,0,4
1134381,True,0,No user reviews,0,0,0
1134382,True,0,No user reviews,0,0,0
1134383,True,0,No user reviews,0,0,0
1134384,True,0,1 user reviews,1,0,1
1134385,True,0,No user reviews,0,0,0
1134386,True,0,No user reviews,0,0,0
1134387,True,0,4 user reviews,4,0,4
1134390,True,0,1 user reviews,0,1,1
1134400,True,0,1 user reviews,1,0,1
1134401,True,0,No user reviews,0,0,0
1134402,True,0,No user reviews,0,0,0
1134403,True,0,No user reviews,0,0,0
1134404,True,0,No user reviews,0,0,0
1134405,True,0,No user reviews,0,0,0
1134406,True,0,No user reviews,0,0,0
1134407,True,0,No user reviews,0,0,0
1134408,True,0,1 user reviews,1,0,1
1134409,True,0,No user reviews,0,0,0
1134410,True,0,2 user reviews,2,0,2
1134411,True,0,No user reviews,0,0,0
1134412,True,0,No user reviews,0,0,0
1134413,True,0,No user reviews,0,0,0
1134414,True,0,No user reviews,0,0,0
1134415,True,0,No user reviews,0,0,0
1134416,True,0,No user reviews,0,0,0
1134417,True,0,No user reviews,0,0,0
1134418,True,0,No user reviews,0,0,0
1134419,True,0,1 user reviews,1,0,1
1134420,True,0,No user reviews,0,0,0
1134421,True,0,No user reviews,0,0,0
1134422,True,0,No user reviews,0,0,0
1134423,True,0,No user reviews,0,0,0
1134430,True,0,No user reviews,0,0,0
1134431,True,0,No user reviews,0,0,0
1134432,True,0,2 user reviews,2,0,2
1134440,True,0,No user reviews,0,0,0
1134450,True,0,No user reviews,0,0,0
1134460,True,0,No user reviews,0,0,0
1134470,True,0,2 user reviews,2,0,2
1134480,True,5,Mixed,23,15,38
1134490,True,0,No user reviews,0,0,0
1134500,True,0,1 user reviews,0,1,1
1134510,True,0,No user reviews,0,0,0
1134520,True,7,Positive,34,7,41
1134530,True,0,No user reviews,0,0,0
1134550,True,0,No user reviews,0,0,0
1134560,True,0,No user reviews,0,0,0
1134561,True,0,No user reviews,0,0,0
1134562,True,0,No user reviews,0,0,0
1134590,True,0,No user reviews,0,0,0
1134600,True,0,No user reviews,0,0,0
1134620,True,0,No user reviews,0,0,0
1134630,True,0,9 user reviews,8,1,9
1134640,True,0,No user reviews,0,0,0
1134650,True,0,No user reviews,0,0,0
1134690,True,0,No user reviews,0,0,0
1134700,True,0,No user reviews,0,0,0
1134710,True,0,No user reviews,0,0,0
1134730,True,0,No user reviews,0,0,0
1135030,True,0,3 user reviews,2,1,3
1135040,True,0,4 user reviews,3,1,4
1135050,True,0,4 user reviews,2,2,4
1135060,True,0,5 user reviews,4,1,5
1135070,True,0,3 user reviews,1,2,3
1135080,True,0,No user reviews,0,0,0
1135090,True,0,8 user reviews,8,0,8
1135100,True,0,2 user reviews,0,2,2
1135110,True,0,4 user reviews,4,0,4
1135120,True,0,1 user reviews,0,1,1
1135130,True,0,6 user reviews,3,3,6
1135140,True,0,3 user reviews,0,3,3
1135150,True,0,3 user reviews,2,1,3
1135160,True,0,1 user reviews,0,1,1
1135170,True,0,1 user reviews,1,0,1
1135180,True,0,8 user reviews,6,2,8
1135190,True,0,2 user reviews,0,2,2
1135200,True,0,1 user reviews,1,0,1
1135210,True,0,5 user reviews,2,3,5
1135220,True,0,No user reviews,0,0,0
1135230,True,0,No user reviews,0,0,0
1135240,True,4,Mostly Negative,66,236,302
1135260,True,0,No user reviews,0,0,0
1135280,True,8,Very Positive,308,36,344
1135290,True,0,No user reviews,0,0,0
1135300,True,0,No user reviews,0,0,0
1135320,True,0,No user reviews,0,0,0
1135370,True,0,6 user reviews,5,1,6
1135380,True,0,1 user reviews,0,1,1
1135400,True,5,Mixed,9,8,17
1135410,True,0,2 user reviews,1,1,2
1135420,True,0,No user reviews,0,0,0
1135430,True,7,Positive,18,2,20
1135431,True,7,Positive,12,0,12
1135432,True,5,Mixed,9,11,20
1135433,True,7,Positive,21,0,21
1135434,True,7,Positive,9,1,10
1135435,True,0,8 user reviews,8,0,8
1135436,True,7,Positive,14,0,14
1135437,True,7,Positive,10,1,11
1135438,True,7,Positive,11,2,13
1135450,True,0,7 user reviews,6,1,7
1135460,True,0,No user reviews,0,0,0
1135480,True,0,No user reviews,0,0,0
1135490,True,0,No user reviews,0,0,0
1135520,True,0,1 user reviews,1,0,1
1135540,True,0,No user reviews,0,0,0
1135550,True,0,No user reviews,0,0,0
1135570,True,0,1 user reviews,1,0,1
1135580,True,0,No user reviews,0,0,0
1135590,True,0,No user reviews,0,0,0
1135591,True,0,No user reviews,0,0,0
1135640,True,0,1 user reviews,1,0,1
1135680,True,0,No user reviews,0,0,0
1135690,True,0,No user reviews,0,0,0
1135700,True,0,No user reviews,0,0,0
1135710,True,0,No user reviews,0,0,0
1135720,True,0,No user reviews,0,0,0
1135721,True,0,No user reviews,0,0,0
1135730,True,0,1 user reviews,1,0,1
1135740,True,7,Positive,19,4,23
1135750,True,0,1 user reviews,1,0,1
1135760,True,0,No user reviews,0,0,0
1135780,True,0,No user reviews,0,0,0
1135790,True,0,No user reviews,0,0,0
1135800,True,0,No user reviews,0,0,0
1135810,True,0,No user reviews,0,0,0
1135830,True,7,Positive,45,3,48
1135850,True,0,No user reviews,0,0,0
1135860,True,0,3 user reviews,2,1,3
1135880,True,0,No user reviews,0,0,0
1135900,True,0,6 user reviews,5,1,6
1135910,True,5,Mixed,46,28,74
1135960,True,8,Very Positive,54,8,62
1135970,True,0,1 user reviews,1,0,1
1135971,True,0,4 user reviews,4,0,4
1135972,True,0,4 user reviews,4,0,4
1136000,True,0,2 user reviews,2,0,2
1136001,True,0,2 user reviews,2,0,2
1136002,True,0,2 user reviews,2,0,2
1136010,True,0,1 user reviews,0,1,1
1136020,True,7,Positive,14,3,17
1136030,True,0,No user reviews,0,0,0
1136040,True,0,4 user reviews,4,0,4
1136060,True,0,No user reviews,0,0,0
1136070,True,0,9 user reviews,7,2,9
1136080,True,0,5 user reviews,5,0,5
1136090,True,0,2 user reviews,2,0,2
1136100,True,0,1 user reviews,1,0,1
1136110,True,0,8 user reviews,1,7,8
1136130,True,0,No user reviews,0,0,0
1136150,True,0,5 user reviews,2,3,5
1136160,True,6,Mostly Positive,463,166,629
1136170,True,0,No user reviews,0,0,0
1136180,True,0,No user reviews,0,0,0
1136210,True,0,No user reviews,0,0,0
1136240,True,0,No user reviews,0,0,0
1136250,True,0,No user reviews,0,0,0
1136290,True,0,No user reviews,0,0,0
1136310,True,0,1 user reviews,1,0,1
1136311,True,0,1 user reviews,1,0,1
1136312,True,0,No user reviews,0,0,0
1136313,True,0,1 user reviews,1,0,1
1136330,True,7,Positive,43,3,46
1136370,True,0,No user reviews,0,0,0
1136380,True,0,No user reviews,0,0,0
1136390,True,0,8 user reviews,2,6,8
1136400,True,0,No user reviews,0,0,0
1136410,True,0,No user reviews,0,0,0
1136420,True,0,1 user reviews,1,0,1
1136430,True,0,No user reviews,0,0,0
1136440,True,5,Mixed,7,9,16
1136460,True,0,No user reviews,0,0,0
1136470,True,0,No user reviews,0,0,0
1136500,True,0,No user reviews,0,0,0
1136510,True,0,No user reviews,0,0,0
1136580,True,0,No user reviews,0,0,0
1136680,True,0,No user reviews,0,0,0
1136690,True,0,No user reviews,0,0,0
1136750,True,0,No user reviews,0,0,0
1136751,True,0,No user reviews,0,0,0
1136760,True,0,No user reviews,0,0,0
1136770,True,0,No user reviews,0,0,0
1136790,True,0,No user reviews,0,0,0
1136820,True,0,1 user reviews,1,0,1
1136830,True,0,2 user reviews,1,1,2
1136880,True,7,Positive,16,0,16
1136890,True,0,No user reviews,0,0,0
1136900,True,0,No user reviews,0,0,0
1136910,True,6,Mostly Positive,7,3,10
1136920,True,0,No user reviews,0,0,0
1136930,True,0,3 user reviews,2,1,3
1136950,True,0,No user reviews,0,0,0
1136960,True,0,2 user reviews,2,0,2
1136970,True,0,No user reviews,0,0,0
1136990,True,0,No user reviews,0,0,0
1137000,True,0,No user reviews,0,0,0
1137020,True,7,Positive,29,3,32
1137040,True,0,2 user reviews,2,0,2
1137050,True,0,2 user reviews,1,1,2
1137070,True,0,No user reviews,0,0,0
1137090,True,0,No user reviews,0,0,0
1137100,True,0,No user reviews,0,0,0
1137110,True,0,7 user reviews,6,1,7
1137140,True,0,No user reviews,0,0,0
1137160,True,0,No user reviews,0,0,0
1137170,True,0,No user reviews,0,0,0
1137180,True,0,No user reviews,0,0,0
1137190,True,0,No user reviews,0,0,0
1137210,True,0,1 user reviews,1,0,1
1137220,True,0,1 user reviews,0,1,1
1137230,True,0,1 user reviews,0,1,1
1137250,True,0,1 user reviews,0,1,1
1137260,True,0,4 user reviews,1,3,4
1137270,True,0,No user reviews,0,0,0
1137280,True,0,No user reviews,0,0,0
1137281,True,0,No user reviews,0,0,0
1137282,True,0,No user reviews,0,0,0
1137283,True,0,No user reviews,0,0,0
1137300,True,0,No user reviews,0,0,0
1137320,True,0,No user reviews,0,0,0
1137330,True,7,Positive,9,1,10
1137340,True,0,No user reviews,0,0,0
1137350,True,8,Very Positive,150,8,158
1137360,True,0,1 user reviews,1,0,1
1137370,True,0,No user reviews,0,0,0
1137380,True,0,No user reviews,0,0,0
1137390,True,0,No user reviews,0,0,0
1137400,True,6,Mostly Positive,24,7,31
1137410,True,8,Very Positive,163,8,171
1137430,True,0,No user reviews,0,0,0
1137440,True,0,No user reviews,0,0,0
1137450,True,0,No user reviews,0,0,0
1137470,True,8,Very Positive,56,14,70
1137480,True,0,No user reviews,0,0,0
1137490,True,5,Mixed,42,23,65
1137520,True,0,No user reviews,0,0,0
1137530,True,0,No user reviews,0,0,0
1137531,True,0,No user reviews,0,0,0
1137532,True,0,1 user reviews,1,0,1
1137533,True,0,2 user reviews,2,0,2
1137540,True,0,5 user reviews,3,2,5
1137550,True,0,No user reviews,0,0,0
1137620,True,0,6 user reviews,4,2,6
1137630,True,0,No user reviews,0,0,0
1137640,True,0,2 user reviews,2,0,2
1137641,True,5,Mixed,15,21,36
1137650,True,0,No user reviews,0,0,0
1137660,True,0,3 user reviews,3,0,3
1137670,True,0,1 user reviews,0,1,1
1137680,True,0,1 user reviews,1,0,1
1137690,True,0,No user reviews,0,0,0
1137700,True,0,No user reviews,0,0,0
1137730,True,0,7 user reviews,5,2,7
1137750,True,0,No user reviews,0,0,0
1137770,True,0,4 user reviews,1,3,4
1137800,True,7,Positive,25,4,29
1137801,True,7,Positive,25,5,30
1137802,True,0,No user reviews,0,0,0
1137810,True,0,No user reviews,0,0,0
1137820,True,0,No user reviews,0,0,0
1137860,True,0,No user reviews,0,0,0
1137870,True,0,No user reviews,0,0,0
1137880,True,0,No user reviews,0,0,0
1137890,True,0,No user reviews,0,0,0
1137900,True,0,No user reviews,0,0,0
1137910,True,0,No user reviews,0,0,0
1137930,True,0,No user reviews,0,0,0
1137940,True,7,Positive,18,2,20
1137950,True,0,No user reviews,0,0,0
1138000,True,0,No user reviews,0,0,0
1138010,True,0,No user reviews,0,0,0
1138020,True,0,No user reviews,0,0,0
1138030,True,0,No user reviews,0,0,0
1138050,True,0,No user reviews,0,0,0
1138060,True,0,5 user reviews,1,4,5
1138070,True,0,No user reviews,0,0,0
1138080,True,5,Mixed,8,7,15
1138100,True,7,Positive,34,1,35
1138110,True,0,No user reviews,0,0,0
1138130,True,0,1 user reviews,1,0,1
1138150,True,0,2 user reviews,0,2,2
1138160,True,0,No user reviews,0,0,0
1138190,True,0,No user reviews,0,0,0
1138210,True,0,No user reviews,0,0,0
1138220,True,0,No user reviews,0,0,0
1138250,True,0,No user reviews,0,0,0
1138260,True,0,6 user reviews,6,0,6
1138280,True,0,1 user reviews,0,1,1
1138290,True,0,1 user reviews,1,0,1
1138300,True,0,2 user reviews,1,1,2
1138310,True,0,1 user reviews,1,0,1
1138320,True,0,3 user reviews,0,3,3
1138330,True,0,No user reviews,0,0,0
1138340,True,0,No user reviews,0,0,0
1138350,True,0,No user reviews,0,0,0
1138360,True,0,No user reviews,0,0,0
1138370,True,0,3 user reviews,3,0,3
1138380,True,0,No user reviews,0,0,0
1138400,True,5,Mixed,8,7,15
1138410,True,7,Positive,18,1,19
1138440,True,0,No user reviews,0,0,0
1138480,True,0,No user reviews,0,0,0
1138490,True,0,8 user reviews,8,0,8
1138530,True,0,No user reviews,0,0,0
1138570,True,0,No user reviews,0,0,0
1138580,True,7,Positive,43,4,47
1138610,True,0,No user reviews,0,0,0
1138620,True,0,No user reviews,0,0,0
1138630,True,0,4 user reviews,3,1,4
1138640,True,0,No user reviews,0,0,0
1138650,True,0,No user reviews,0,0,0
1138660,True,0,No user reviews,0,0,0
1138670,True,0,No user reviews,0,0,0
1138780,True,0,No user reviews,0,0,0
1138800,True,0,No user reviews,0,0,0
1138810,True,0,2 user reviews,1,1,2
1138840,True,0,No user reviews,0,0,0
1138850,True,0,No user reviews,0,0,0
1138860,True,0,No user reviews,0,0,0
1138900,True,0,No user reviews,0,0,0
1138910,True,7,Positive,17,0,17
1138950,True,0,No user reviews,0,0,0
1138960,True,7,Positive,22,0,22
1138970,True,7,Positive,14,2,16
1138980,True,0,No user reviews,0,0,0
1138990,True,0,2 user reviews,2,0,2
1139000,True,0,No user reviews,0,0,0
1139020,True,0,4 user reviews,2,2,4
1139040,True,0,No user reviews,0,0,0
1139060,True,0,No user reviews,0,0,0
1139080,True,6,Mostly Positive,57,15,72
1139090,True,0,No user reviews,0,0,0
1139100,True,0,1 user reviews,1,0,1
1139110,True,7,Positive,34,3,37
1139130,True,0,1 user reviews,0,1,1
1139140,True,7,Positive,10,1,11
1139160,True,0,No user reviews,0,0,0
1139190,True,0,No user reviews,0,0,0
1139200,True,0,No user reviews,0,0,0
1139210,True,0,No user reviews,0,0,0
1139230,True,0,No user reviews,0,0,0
1139240,True,0,5 user reviews,5,0,5
1139250,True,0,No user reviews,0,0,0
1139260,True,0,No user reviews,0,0,0
1139270,True,0,No user reviews,0,0,0
1139280,True,0,No user reviews,0,0,0
1139290,True,0,No user reviews,0,0,0
1139310,True,0,No user reviews,0,0,0
1139470,True,0,5 user reviews,4,1,5
1139480,True,0,7 user reviews,5,2,7
1139490,True,0,No user reviews,0,0,0
1139500,True,0,No user reviews,0,0,0
1139660,True,0,No user reviews,0,0,0
1139680,True,0,3 user reviews,3,0,3
1139720,True,0,No user reviews,0,0,0
1139750,True,0,No user reviews,0,0,0
1139760,True,0,5 user reviews,5,0,5
1139770,True,0,No user reviews,0,0,0
1139780,True,0,No user reviews,0,0,0
1139790,True,0,No user reviews,0,0,0
1139800,True,7,Positive,10,0,10
1139830,True,0,2 user reviews,1,1,2
1139840,True,0,No user reviews,0,0,0
1139852,True,0,1 user reviews,1,0,1
1139860,True,0,1 user reviews,1,0,1
1139870,True,5,Mixed,23,34,57
1139880,True,0,7 user reviews,7,0,7
1139890,True,8,Very Positive,310,13,323
1139900,True,8,Very Positive,1726,248,1974
1139910,True,0,No user reviews,0,0,0
1139920,True,0,No user reviews,0,0,0
1139930,True,0,3 user reviews,3,0,3
1139940,True,8,Very Positive,115,16,131
1139950,True,0,9 user reviews,7,2,9
1139980,True,8,Very Positive,379,18,397
1139990,True,0,2 user reviews,2,0,2
1140000,True,6,Mostly Positive,113,44,157
1140001,True,6,Mostly Positive,275,86,361
1140010,True,0,No user reviews,0,0,0
1140020,True,0,2 user reviews,0,2,2
1140030,True,6,Mostly Positive,10,4,14
1140040,True,0,No user reviews,0,0,0
1140060,True,0,No user reviews,0,0,0
1140070,True,0,2 user reviews,1,1,2
1140100,True,6,Mostly Positive,19,7,26
1140110,True,0,3 user reviews,1,2,3
1140120,True,0,2 user reviews,2,0,2
1140130,True,6,Mostly Positive,24,8,32
1140140,True,0,3 user reviews,2,1,3
1140160,True,0,No user reviews,0,0,0
1140170,True,0,No user reviews,0,0,0
1140190,True,0,No user reviews,0,0,0
1140200,True,0,No user reviews,0,0,0
1140210,True,0,No user reviews,0,0,0
1140220,True,0,No user reviews,0,0,0
1140230,True,0,No user reviews,0,0,0
1140240,True,0,No user reviews,0,0,0
1140250,True,0,No user reviews,0,0,0
1140260,True,0,1 user reviews,1,0,1
1140270,True,9,Overwhelmingly Positive,861,7,868
1140290,True,8,Very Positive,257,29,286
1140320,True,0,No user reviews,0,0,0
1140350,True,0,No user reviews,0,0,0
1140360,True,0,1 user reviews,1,0,1
1140370,True,0,No user reviews,0,0,0
1140380,True,0,No user reviews,0,0,0
1140390,True,0,No user reviews,0,0,0
1140400,True,0,2 user reviews,1,1,2
1140410,True,0,2 user reviews,0,2,2
1140420,True,0,3 user reviews,2,1,3
1140430,True,0,No user reviews,0,0,0
1140440,True,5,Mixed,47,22,69
1140460,True,7,Positive,15,0,15
1140470,True,0,No user reviews,0,0,0
1140490,True,0,No user reviews,0,0,0
1140500,True,0,9 user reviews,3,6,9
1140510,True,0,No user reviews,0,0,0
1140520,True,0,2 user reviews,2,0,2
1140530,True,0,1 user reviews,1,0,1
1140540,True,0,No user reviews,0,0,0
1140550,True,0,No user reviews,0,0,0
1140551,True,0,No user reviews,0,0,0
1140552,True,0,No user reviews,0,0,0
1140553,True,0,No user reviews,0,0,0
1140560,True,0,No user reviews,0,0,0
1140570,True,7,Positive,18,1,19
1140590,True,0,2 user reviews,2,0,2
1140610,True,0,5 user reviews,5,0,5
1140630,True,0,No user reviews,0,0,0
1140640,True,0,2 user reviews,2,0,2
1140650,True,0,No user reviews,0,0,0
1140662,True,0,No user reviews,0,0,0
1140670,True,0,No user reviews,0,0,0
1140680,True,0,No user reviews,0,0,0
1140690,True,0,4 user reviews,4,0,4
1140700,True,0,No user reviews,0,0,0
1140710,True,0,No user reviews,0,0,0
1140720,True,0,1 user reviews,1,0,1
1140730,True,0,No user reviews,0,0,0
1140740,True,0,No user reviews,0,0,0
1140760,True,0,No user reviews,0,0,0
1140790,True,0,No user reviews,0,0,0
1140870,True,0,No user reviews,0,0,0
1140880,True,6,Mostly Positive,9,3,12
1140890,True,0,No user reviews,0,0,0
1140900,True,0,1 user reviews,0,1,1
1140910,True,0,No user reviews,0,0,0
1140920,True,0,No user reviews,0,0,0
1140930,True,0,No user reviews,0,0,0
1140940,True,0,No user reviews,0,0,0
1140950,True,0,No user reviews,0,0,0
1140970,True,0,3 user reviews,1,2,3
1140980,True,0,No user reviews,0,0,0
1141020,True,0,No user reviews,0,0,0
1141030,True,0,No user reviews,0,0,0
1141040,True,0,No user reviews,0,0,0
1141050,True,0,No user reviews,0,0,0
1141060,True,0,No user reviews,0,0,0
1141070,True,0,1 user reviews,1,0,1
1141100,True,7,Positive,25,3,28
1141110,True,0,No user reviews,0,0,0
1141120,True,0,No user reviews,0,0,0
1141130,True,7,Positive,16,0,16
1141150,True,0,2 user reviews,1,1,2
1141160,True,0,1 user reviews,1,0,1
1141170,True,0,1 user reviews,0,1,1
1141180,True,0,2 user reviews,2,0,2
1141190,True,0,No user reviews,0,0,0
1141200,True,0,No user reviews,0,0,0
1141220,True,8,Very Positive,398,77,475
1141250,True,0,No user reviews,0,0,0
1141270,True,0,No user reviews,0,0,0
1141280,True,0,No user reviews,0,0,0
1141290,True,7,Positive,25,1,26
1141300,True,0,2 user reviews,2,0,2
1141310,True,0,No user reviews,0,0,0
1141340,True,0,No user reviews,0,0,0
1141360,True,7,Positive,8,2,10
1141370,True,0,No user reviews,0,0,0
1141380,True,0,2 user reviews,1,1,2
1141390,True,0,1 user reviews,1,0,1
1141400,True,0,No user reviews,0,0,0
1141401,True,0,No user reviews,0,0,0
1141410,True,0,No user reviews,0,0,0
1141450,True,0,8 user reviews,7,1,8
1141500,True,0,No user reviews,0,0,0
1141510,True,0,No user reviews,0,0,0
1141520,True,0,No user reviews,0,0,0
1141530,True,0,1 user reviews,0,1,1
1141540,True,0,No user reviews,0,0,0
1141570,True,0,6 user reviews,6,0,6
1141580,True,0,No user reviews,0,0,0
1141600,True,0,3 user reviews,2,1,3
1141610,True,0,No user reviews,0,0,0
1141640,True,0,1 user reviews,0,1,1
1141650,True,7,Positive,13,2,15
1141660,True,0,No user reviews,0,0,0
1141670,True,0,No user reviews,0,0,0
1141680,True,0,No user reviews,0,0,0
1141690,True,0,No user reviews,0,0,0
1141700,True,0,No user reviews,0,0,0
1141710,True,0,4 user reviews,4,0,4
1141711,True,0,9 user reviews,8,1,9
1141740,True,0,No user reviews,0,0,0
1141750,True,0,No user reviews,0,0,0
1141770,True,0,No user reviews,0,0,0
1141790,True,0,1 user reviews,1,0,1
1141800,True,0,No user reviews,0,0,0
1141810,True,0,2 user reviews,2,0,2
1141811,True,0,2 user reviews,1,1,2
1141820,True,0,No user reviews,0,0,0
1141840,True,0,1 user reviews,1,0,1
1141850,True,0,No user reviews,0,0,0
1141860,True,0,No user reviews,0,0,0
1141870,True,0,2 user reviews,2,0,2
1141880,True,0,5 user reviews,5,0,5
1141920,True,0,No user reviews,0,0,0
1141930,True,5,Mixed,11,6,17
1141950,True,0,8 user reviews,4,4,8
1141960,True,7,Positive,33,1,34
1141970,True,0,No user reviews,0,0,0
1141980,True,5,Mixed,8,6,14
1141990,True,0,9 user reviews,6,3,9
1142000,True,0,No user reviews,0,0,0
1142050,True,0,No user reviews,0,0,0
1142070,True,0,5 user reviews,2,3,5
1142080,True,0,No user reviews,0,0,0
1142090,True,0,3 user reviews,3,0,3
1142100,True,5,Mixed,86,40,126
1142110,True,0,No user reviews,0,0,0
1142130,True,0,1 user reviews,1,0,1
1142180,True,0,No user reviews,0,0,0
1142200,True,0,No user reviews,0,0,0
1142220,True,5,Mixed,18,9,27
1142230,True,0,2 user reviews,2,0,2
1142240,True,0,1 user reviews,1,0,1
1142250,True,0,4 user reviews,4,0,4
1142260,True,0,No user reviews,0,0,0
1142270,True,7,Positive,16,4,20
1142280,True,0,No user reviews,0,0,0
1142290,True,0,1 user reviews,1,0,1
1142300,True,0,7 user reviews,7,0,7
1142320,True,0,2 user reviews,2,0,2
1142330,True,5,Mixed,19,16,35
1142340,True,0,No user reviews,0,0,0
1142350,True,0,No user reviews,0,0,0
1142360,True,0,6 user reviews,4,2,6
1142370,True,0,No user reviews,0,0,0
1142390,True,5,Mixed,53,46,99
1142400,True,0,No user reviews,0,0,0
1142410,True,6,Mostly Positive,11,3,14
1142440,True,0,No user reviews,0,0,0
1142450,True,0,No user reviews,0,0,0
1142460,True,0,No user reviews,0,0,0
1142470,True,0,7 user reviews,4,3,7
1142480,True,7,Positive,15,2,17
1142500,True,8,Very Positive,1230,96,1326
1142510,True,0,No user reviews,0,0,0
1142520,True,0,No user reviews,0,0,0
1142540,True,0,No user reviews,0,0,0
1142550,True,0,9 user reviews,8,1,9
1142560,True,0,No user reviews,0,0,0
1142570,True,0,No user reviews,0,0,0
1142590,True,0,No user reviews,0,0,0
1142600,True,0,No user reviews,0,0,0
1142610,True,0,No user reviews,0,0,0
1142630,True,0,No user reviews,0,0,0
1142640,True,0,No user reviews,0,0,0
1142650,True,0,No user reviews,0,0,0
1142670,True,0,No user reviews,0,0,0
1142680,True,0,No user reviews,0,0,0
1142690,True,0,No user reviews,0,0,0
1142700,True,0,No user reviews,0,0,0
1142730,True,0,No user reviews,0,0,0
1142740,True,0,No user reviews,0,0,0
1142750,True,0,1 user reviews,1,0,1
1142760,True,0,No user reviews,0,0,0
1142790,True,0,No user reviews,0,0,0
1142800,True,7,Positive,13,2,15
1142810,True,7,Positive,18,0,18
1142820,True,0,No user reviews,0,0,0
1142830,True,7,Positive,23,0,23
1142840,True,0,No user reviews,0,0,0
1142850,True,0,5 user reviews,4,1,5
1142860,True,0,No user reviews,0,0,0
1142870,True,0,4 user reviews,0,4,4
1142880,True,5,Mixed,31,36,67
1142890,True,0,No user reviews,0,0,0
1142900,True,0,2 user reviews,1,1,2
1142910,True,0,No user reviews,0,0,0
1142920,True,0,1 user reviews,0,1,1
1143070,True,0,No user reviews,0,0,0
1143130,True,0,No user reviews,0,0,0
1143140,True,0,No user reviews,0,0,0
1143160,True,0,No user reviews,0,0,0
1143170,True,0,4 user reviews,3,1,4
1143300,True,0,No user reviews,0,0,0
1143310,True,0,No user reviews,0,0,0
1143320,True,0,1 user reviews,1,0,1
1143330,True,0,1 user reviews,1,0,1
1143340,True,0,No user reviews,0,0,0
1143350,True,7,Positive,17,1,18
1143360,True,0,No user reviews,0,0,0
1143390,True,0,3 user reviews,3,0,3
1143400,True,7,Positive,24,6,30
1143410,True,0,No user reviews,0,0,0
1143420,True,0,No user reviews,0,0,0
1143430,True,0,6 user reviews,5,1,6
1143440,True,0,6 user reviews,6,0,6
1143450,True,0,No user reviews,0,0,0
1143460,True,0,3 user reviews,2,1,3
1143500,True,0,No user reviews,0,0,0
1143510,True,0,1 user reviews,1,0,1
1143520,True,0,2 user reviews,2,0,2
1143530,True,0,No user reviews,0,0,0
1143540,True,0,No user reviews,0,0,0
1143550,True,0,1 user reviews,1,0,1
1143560,True,0,No user reviews,0,0,0
1143570,True,0,3 user reviews,3,0,3
1143580,True,0,No user reviews,0,0,0
1143590,True,0,No user reviews,0,0,0
1143610,True,0,No user reviews,0,0,0
1143650,True,5,Mixed,55,39,94
1143660,True,0,No user reviews,0,0,0
1143670,True,0,No user reviews,0,0,0
1143680,True,0,8 user reviews,8,0,8
1143710,True,0,4 user reviews,3,1,4
1143720,True,0,3 user reviews,2,1,3
1143740,True,0,3 user reviews,3,0,3
1143750,True,7,Positive,14,1,15
1143770,True,0,No user reviews,0,0,0
1143780,True,0,2 user reviews,2,0,2
1143800,True,0,7 user reviews,6,1,7
1143810,True,0,No user reviews,0,0,0
1143820,True,0,9 user reviews,5,4,9
1143830,True,0,No user reviews,0,0,0
1143840,True,8,Very Positive,170,17,187
1143850,True,0,7 user reviews,7,0,7
1143851,True,0,6 user reviews,5,1,6
1143852,True,0,6 user reviews,6,0,6
1143853,True,7,Positive,12,2,14
1143870,True,0,No user reviews,0,0,0
1143890,True,7,Positive,13,3,16
1143900,True,0,1 user reviews,1,0,1
1143950,True,0,No user reviews,0,0,0
1143961,True,0,No user reviews,0,0,0
1143970,True,0,No user reviews,0,0,0
1143971,True,0,No user reviews,0,0,0
1143972,True,0,No user reviews,0,0,0
1143973,True,0,No user reviews,0,0,0
1143974,True,0,No user reviews,0,0,0
1143975,True,0,No user reviews,0,0,0
1143976,True,0,No user reviews,0,0,0
1143977,True,0,1 user reviews,1,0,1
1143978,True,0,1 user reviews,1,0,1
1143979,True,0,No user reviews,0,0,0
1143980,True,0,No user reviews,0,0,0
1143981,True,0,No user reviews,0,0,0
1143982,True,0,No user reviews,0,0,0
1143983,True,0,No user reviews,0,0,0
1143990,True,0,No user reviews,0,0,0
1143991,True,0,No user reviews,0,0,0
1143992,True,0,No user reviews,0,0,0
1143993,True,0,No user reviews,0,0,0
1143994,True,0,No user reviews,0,0,0
1143995,True,0,No user reviews,0,0,0
1144000,True,0,No user reviews,0,0,0
1144020,True,8,Very Positive,123,6,129
1144030,True,8,Very Positive,690,38,728
1144060,True,0,1 user reviews,0,1,1
1144070,True,0,5 user reviews,2,3,5
1144080,True,0,No user reviews,0,0,0
1144090,True,0,No user reviews,0,0,0
1144100,True,0,6 user reviews,6,0,6
1144110,True,0,4 user reviews,4,0,4
1144120,True,0,No user reviews,0,0,0
1144130,True,0,No user reviews,0,0,0
1144140,True,7,Positive,9,1,10
1144150,True,7,Positive,20,0,20
1144170,True,0,No user reviews,0,0,0
1144180,True,0,6 user reviews,6,0,6
1144190,True,0,No user reviews,0,0,0
1144200,True,0,No user reviews,0,0,0
1144230,True,0,No user reviews,0,0,0
1144231,True,0,No user reviews,0,0,0
1144250,True,8,Very Positive,154,38,192
1144260,True,0,No user reviews,0,0,0
1144270,True,0,2 user reviews,2,0,2
1144280,True,7,Positive,33,0,33
1144290,True,0,1 user reviews,1,0,1
1144300,True,0,5 user reviews,4,1,5
1144310,True,0,5 user reviews,5,0,5
1144320,True,0,No user reviews,0,0,0
1144330,True,7,Positive,9,1,10
1144350,True,0,2 user reviews,1,1,2
1144370,True,0,No user reviews,0,0,0
1144380,True,0,No user reviews,0,0,0
1144400,True,8,Very Positive,187,7,194
1144410,True,6,Mostly Positive,114,31,145
1144420,True,7,Positive,41,6,47
1144430,True,0,No user reviews,0,0,0
1144440,True,7,Positive,30,6,36
1144450,True,0,1 user reviews,1,0,1
1144460,True,7,Positive,9,2,11
1144470,True,0,No user reviews,0,0,0
1144480,True,0,4 user reviews,4,0,4
1144490,True,0,3 user reviews,3,0,3
1144500,True,0,5 user reviews,5,0,5
1144510,True,0,6 user reviews,5,1,6
1144520,True,0,2 user reviews,0,2,2
1144550,True,0,3 user reviews,1,2,3
1144560,True,0,No user reviews,0,0,0
1144580,True,0,No user reviews,0,0,0
1144590,True,0,4 user reviews,4,0,4
1144620,True,0,No user reviews,0,0,0
1144630,True,0,2 user reviews,2,0,2
1144640,True,6,Mostly Positive,13,5,18
1144641,True,0,No user reviews,0,0,0
1144642,True,0,No user reviews,0,0,0
1144643,True,0,6 user reviews,2,4,6
1144644,True,0,No user reviews,0,0,0
1144645,True,0,4 user reviews,2,2,4
1144646,True,5,Mixed,36,38,74
1144670,True,0,No user reviews,0,0,0
1144690,True,0,1 user reviews,1,0,1
1144710,True,0,No user reviews,0,0,0
1144740,True,0,No user reviews,0,0,0
1144750,True,0,2 user reviews,2,0,2
1144760,True,0,No user reviews,0,0,0
1144780,True,0,2 user reviews,1,1,2
1144800,True,0,No user reviews,0,0,0
1144810,True,0,No user reviews,0,0,0
1144820,True,0,No user reviews,0,0,0
1144830,True,0,No user reviews,0,0,0
1144850,True,0,No user reviews,0,0,0
1144860,True,7,Positive,9,1,10
1144890,True,0,No user reviews,0,0,0
1144900,True,0,No user reviews,0,0,0
1144910,True,8,Very Positive,50,0,50
1144930,True,0,No user reviews,0,0,0
1144940,True,0,No user reviews,0,0,0
1144941,True,0,No user reviews,0,0,0
1144942,True,0,No user reviews,0,0,0
1144943,True,0,1 user reviews,0,1,1
1144944,True,0,2 user reviews,1,1,2
1144970,True,6,Mostly Positive,82,28,110
1145000,True,0,No user reviews,0,0,0
1145020,True,0,No user reviews,0,0,0
1145030,True,0,3 user reviews,3,0,3
1145040,True,0,6 user reviews,1,5,6
1145050,True,0,No user reviews,0,0,0
1145060,True,0,No user reviews,0,0,0
1145080,True,0,No user reviews,0,0,0
1145100,True,0,No user reviews,0,0,0
1145120,True,0,No user reviews,0,0,0
1145170,True,0,No user reviews,0,0,0
1145180,True,0,1 user reviews,1,0,1
1145190,True,0,No user reviews,0,0,0
1145200,True,0,No user reviews,0,0,0
1145210,True,0,1 user reviews,0,1,1
1145220,True,0,No user reviews,0,0,0
1145240,True,0,No user reviews,0,0,0
1145250,True,6,Mostly Positive,43,17,60
1145270,True,0,No user reviews,0,0,0
1145280,True,0,1 user reviews,1,0,1
1145290,True,0,No user reviews,0,0,0
1145300,True,0,No user reviews,0,0,0
1145310,True,0,No user reviews,0,0,0
1145330,True,0,No user reviews,0,0,0
1145340,True,0,No user reviews,0,0,0
1145360,True,9,Overwhelmingly Positive,25853,272,26125
1145380,True,0,3 user reviews,3,0,3
1145400,True,0,No user reviews,0,0,0
1145410,True,7,Positive,27,2,29
1145430,True,0,1 user reviews,0,1,1
1145440,True,0,No user reviews,0,0,0
1145450,True,0,6 user reviews,5,1,6
1145460,True,0,3 user reviews,0,3,3
1145470,True,0,No user reviews,0,0,0
1145480,True,0,No user reviews,0,0,0
1145490,True,0,No user reviews,0,0,0
1145500,True,0,No user reviews,0,0,0
1145510,True,0,No user reviews,0,0,0
1145520,True,0,2 user reviews,2,0,2
1145530,True,0,2 user reviews,2,0,2
1145540,True,0,No user reviews,0,0,0
1145550,True,0,No user reviews,0,0,0
1145560,True,7,Positive,13,1,14
1145570,True,6,Mostly Positive,19,7,26
1145580,True,0,1 user reviews,0,1,1
1145590,True,0,1 user reviews,0,1,1
1145600,True,0,No user reviews,0,0,0
1145630,True,0,No user reviews,0,0,0
1145660,True,6,Mostly Positive,196,60,256
1145670,True,0,No user reviews,0,0,0
1145680,True,0,2 user reviews,2,0,2
1145690,True,0,No user reviews,0,0,0
1145710,True,0,No user reviews,0,0,0
1145711,True,0,No user reviews,0,0,0
1145740,True,0,9 user reviews,6,3,9
1145760,True,0,1 user reviews,1,0,1
1145770,True,0,No user reviews,0,0,0
1145780,True,7,Positive,8,2,10
1145810,True,0,5 user reviews,3,2,5
1145820,True,0,5 user reviews,2,3,5
1145840,True,0,No user reviews,0,0,0
1145850,True,0,No user reviews,0,0,0
1145851,True,0,1 user reviews,1,0,1
1145860,True,0,1 user reviews,0,1,1
1145890,True,0,No user reviews,0,0,0
1145920,True,0,No user reviews,0,0,0
1145930,True,0,No user reviews,0,0,0
1145960,True,8,Very Positive,512,66,578
1145970,True,0,5 user reviews,5,0,5
1145990,True,0,1 user reviews,0,1,1
1146000,True,0,No user reviews,0,0,0
1146010,True,5,Mixed,16,12,28
1146040,True,0,No user reviews,0,0,0
1146070,True,0,No user reviews,0,0,0
1146090,True,0,1 user reviews,1,0,1
1146100,True,6,Mostly Positive,45,15,60
1146120,True,0,No user reviews,0,0,0
1146130,True,0,No user reviews,0,0,0
1146131,True,0,No user reviews,0,0,0
1146132,True,0,No user reviews,0,0,0
1146140,True,0,No user reviews,0,0,0
1146141,True,0,No user reviews,0,0,0
1146142,True,0,No user reviews,0,0,0
1146160,True,0,1 user reviews,1,0,1
1146170,True,7,Positive,24,3,27
1146190,True,0,No user reviews,0,0,0
1146210,True,0,3 user reviews,3,0,3
1146230,True,8,Very Positive,106,9,115
1146240,True,0,No user reviews,0,0,0
1146250,True,0,2 user reviews,1,1,2
1146260,True,0,3 user reviews,3,0,3
1146280,True,0,No user reviews,0,0,0
1146300,True,0,No user reviews,0,0,0
1146310,True,8,Very Positive,247,48,295
1146320,True,0,2 user reviews,1,1,2
1146330,True,0,No user reviews,0,0,0
1146350,True,0,1 user reviews,0,1,1
1146360,True,0,No user reviews,0,0,0
1146370,True,8,Very Positive,147,4,151
1146380,True,0,No user reviews,0,0,0
1146390,True,0,1 user reviews,1,0,1
1146400,True,0,No user reviews,0,0,0
1146430,True,0,No user reviews,0,0,0
1146450,True,0,No user reviews,0,0,0
1146460,True,0,No user reviews,0,0,0
1146480,True,0,No user reviews,0,0,0
1146490,True,0,No user reviews,0,0,0
1146500,True,0,No user reviews,0,0,0
1146510,True,7,Positive,46,1,47
1146520,True,0,7 user reviews,4,3,7
1146521,True,0,1 user reviews,0,1,1
1146522,True,0,4 user reviews,2,2,4
1146523,True,0,4 user reviews,0,4,4
1146540,True,0,No user reviews,0,0,0
1146550,True,0,No user reviews,0,0,0
1146560,True,0,3 user reviews,3,0,3
1146580,True,0,No user reviews,0,0,0
1146590,True,0,No user reviews,0,0,0
1146600,True,7,Positive,35,7,42
1146620,True,0,No user reviews,0,0,0
1146630,True,8,Very Positive,264,20,284
1146650,True,0,No user reviews,0,0,0
1146660,True,0,No user reviews,0,0,0
1146670,True,0,No user reviews,0,0,0
1146680,True,0,1 user reviews,1,0,1
1146690,True,0,No user reviews,0,0,0
1146700,True,0,3 user reviews,2,1,3
1146710,True,0,No user reviews,0,0,0
1146720,True,5,Mixed,14,7,21
1146730,True,0,No user reviews,0,0,0
1146780,True,0,1 user reviews,1,0,1
1146790,True,0,2 user reviews,2,0,2
1146810,True,0,2 user reviews,1,1,2
1146830,True,5,Mixed,31,24,55
1146870,True,0,6 user reviews,0,6,6
1146880,True,0,6 user reviews,6,0,6
1146890,True,0,2 user reviews,2,0,2
1146910,True,0,4 user reviews,4,0,4
1146920,True,0,5 user reviews,3,2,5
1146930,True,5,Mixed,81,73,154
1146940,True,6,Mostly Positive,63,19,82
1146950,True,8,Very Positive,293,17,310
1146960,True,6,Mostly Positive,228,69,297
1146970,True,7,Positive,25,0,25
1147010,True,4,Mostly Negative,140,214,354
1147020,True,0,2 user reviews,1,1,2
1147030,True,0,5 user reviews,3,2,5
1147040,True,0,2 user reviews,2,0,2
1147060,True,0,No user reviews,0,0,0
1147080,True,0,No user reviews,0,0,0
1147100,True,5,Mixed,31,24,55
1147110,True,7,Positive,10,1,11
1147130,True,0,No user reviews,0,0,0
1147140,True,0,1 user reviews,0,1,1
1147150,True,0,No user reviews,0,0,0
1147151,True,0,No user reviews,0,0,0
1147152,True,0,3 user reviews,1,2,3
1147153,True,6,Mostly Positive,10,3,13
1147154,True,0,5 user reviews,5,0,5
1147155,True,0,3 user reviews,3,0,3
1147157,True,4,Mostly Negative,4,12,16
1147158,True,5,Mixed,9,4,13
1147159,True,0,2 user reviews,1,1,2
1147160,True,0,No user reviews,0,0,0
1147170,True,0,No user reviews,0,0,0
1147200,True,0,No user reviews,0,0,0
1147220,True,0,1 user reviews,1,0,1
1147230,True,0,No user reviews,0,0,0
1147240,True,0,No user reviews,0,0,0
1147250,True,0,No user reviews,0,0,0
1147270,True,0,No user reviews,0,0,0
1147280,True,0,4 user reviews,4,0,4
1147290,True,0,No user reviews,0,0,0
1147320,True,0,No user reviews,0,0,0
1147330,True,0,No user reviews,0,0,0
1147370,True,0,2 user reviews,1,1,2
1147380,True,0,No user reviews,0,0,0
1147381,True,0,2 user reviews,2,0,2
1147382,True,0,7 user reviews,7,0,7
1147383,True,0,No user reviews,0,0,0
1147390,True,0,No user reviews,0,0,0
1147410,True,0,No user reviews,0,0,0
1147420,True,0,No user reviews,0,0,0
1147430,True,0,No user reviews,0,0,0
1147450,True,5,Mixed,17,9,26
1147460,True,0,No user reviews,0,0,0
1147480,True,0,8 user reviews,7,1,8
1147490,True,7,Positive,16,3,19
1147500,True,7,Positive,20,1,21
1147510,True,8,Very Positive,325,44,369
1147520,True,0,1 user reviews,0,1,1
1147540,True,0,No user reviews,0,0,0
1147550,True,9,Overwhelmingly Positive,1881,60,1941
1147560,True,8,Very Positive,798,59,857
1147600,True,0,3 user reviews,3,0,3
1147620,True,0,1 user reviews,0,1,1
1147640,True,0,No user reviews,0,0,0
1147660,True,5,Mixed,1118,675,1793
1147670,True,5,Mixed,23,12,35
1147680,True,0,No user reviews,0,0,0
1147690,True,0,No user reviews,0,0,0
1147710,True,0,No user reviews,0,0,0
1147730,True,0,No user reviews,0,0,0
1147750,True,0,No user reviews,0,0,0
1147760,True,0,5 user reviews,4,1,5
1147770,True,6,Mostly Positive,14,4,18
1147830,True,0,No user reviews,0,0,0
1147840,True,0,1 user reviews,1,0,1
1147850,True,0,4 user reviews,4,0,4
1147860,True,0,No user reviews,0,0,0
1147870,True,0,No user reviews,0,0,0
1147880,True,0,No user reviews,0,0,0
1147890,True,0,No user reviews,0,0,0
1147900,True,0,No user reviews,0,0,0
1147910,True,0,No user reviews,0,0,0
1147940,True,8,Very Positive,148,7,155
1147950,True,0,No user reviews,0,0,0
1147960,True,6,Mostly Positive,70,19,89
1147970,True,8,Very Positive,54,12,66
1147980,True,0,2 user reviews,1,1,2
1147990,True,0,No user reviews,0,0,0
1148000,True,0,No user reviews,0,0,0
1148010,True,0,6 user reviews,3,3,6
1148020,True,5,Mixed,34,16,50
1148021,True,0,8 user reviews,6,2,8
1148022,True,5,Mixed,17,16,33
1148030,True,0,No user reviews,0,0,0
1148040,True,0,No user reviews,0,0,0
1148080,True,0,1 user reviews,1,0,1
1148090,True,0,5 user reviews,5,0,5
1148100,True,0,No user reviews,0,0,0
1148120,True,0,No user reviews,0,0,0
1148130,True,0,No user reviews,0,0,0
1148150,True,8,Very Positive,301,34,335
1148160,True,0,No user reviews,0,0,0
1148180,True,0,6 user reviews,6,0,6
1148190,True,0,No user reviews,0,0,0
1148200,True,0,No user reviews,0,0,0
1148230,True,0,No user reviews,0,0,0
1148240,True,0,No user reviews,0,0,0
1148250,True,0,No user reviews,0,0,0
1148260,True,0,2 user reviews,2,0,2
1148270,True,0,1 user reviews,1,0,1
1148280,True,0,No user reviews,0,0,0
1148290,True,0,2 user reviews,2,0,2
1148300,True,0,No user reviews,0,0,0
1148320,True,7,Positive,14,3,17
1148330,True,0,No user reviews,0,0,0
1148400,True,0,No user reviews,0,0,0
1148410,True,0,No user reviews,0,0,0
1148420,True,0,No user reviews,0,0,0
1148430,True,0,3 user reviews,2,1,3
1148450,True,7,Positive,18,2,20
1148460,True,0,1 user reviews,0,1,1
1148470,True,0,7 user reviews,6,1,7
1148480,True,0,No user reviews,0,0,0
1148490,True,0,No user reviews,0,0,0
1148500,True,0,3 user reviews,3,0,3
1148510,True,8,Very Positive,164,14,178
1148530,True,0,6 user reviews,2,4,6
1148540,True,0,1 user reviews,1,0,1
1148550,True,0,4 user reviews,3,1,4
1148560,True,0,No user reviews,0,0,0
1148570,True,0,No user reviews,0,0,0
1148580,True,0,No user reviews,0,0,0
1148590,True,8,Very Positive,1429,90,1519
1148610,True,0,No user reviews,0,0,0
1148620,True,0,5 user reviews,5,0,5
1148640,True,0,1 user reviews,1,0,1
1148650,True,6,Mostly Positive,2273,621,2894
1148670,True,0,2 user reviews,2,0,2
1148680,True,0,1 user reviews,1,0,1
1148700,True,7,Positive,24,5,29
1148710,True,0,1 user reviews,1,0,1
1148730,True,7,Positive,16,1,17
1148740,True,0,1 user reviews,1,0,1
1148750,True,0,No user reviews,0,0,0
1148760,True,0,No user reviews,0,0,0
1148790,True,0,No user reviews,0,0,0
1148800,True,0,No user reviews,0,0,0
1148810,True,8,Very Positive,74,9,83
1148820,True,0,No user reviews,0,0,0
1148830,True,0,1 user reviews,0,1,1
1148880,True,0,No user reviews,0,0,0
1148890,True,0,1 user reviews,0,1,1
1148910,True,5,Mixed,8,5,13
1148920,True,0,4 user reviews,2,2,4
1148930,True,0,5 user reviews,5,0,5
1148940,True,0,4 user reviews,3,1,4
1148950,True,0,No user reviews,0,0,0
1148960,True,0,6 user reviews,4,2,6
1148970,True,0,No user reviews,0,0,0
1148980,True,7,Positive,8,2,10
1149010,True,0,No user reviews,0,0,0
1149060,True,0,No user reviews,0,0,0
1149070,True,0,No user reviews,0,0,0
1149080,True,0,8 user reviews,5,3,8
1149090,True,0,3 user reviews,2,1,3
1149110,True,0,No user reviews,0,0,0
1149120,True,0,1 user reviews,0,1,1
1149130,True,0,No user reviews,0,0,0
1149160,True,0,No user reviews,0,0,0
1149180,True,0,No user reviews,0,0,0
1149190,True,0,1 user reviews,0,1,1
1149200,True,0,1 user reviews,0,1,1
1149210,True,0,1 user reviews,1,0,1
1149220,True,0,1 user reviews,1,0,1
1149240,True,0,No user reviews,0,0,0
1149260,True,0,No user reviews,0,0,0
1149261,True,0,No user reviews,0,0,0
1149330,True,0,No user reviews,0,0,0
1149340,True,0,No user reviews,0,0,0
1149370,True,0,2 user reviews,1,1,2
1149400,True,6,Mostly Positive,97,34,131
1149430,True,0,No user reviews,0,0,0
1149440,True,8,Very Positive,152,25,177
1149450,True,0,No user reviews,0,0,0
1149460,True,0,No user reviews,0,0,0
1149490,True,0,No user reviews,0,0,0
1149500,True,0,No user reviews,0,0,0
1149510,True,0,6 user reviews,6,0,6
1149520,True,0,No user reviews,0,0,0
1149540,True,0,2 user reviews,2,0,2
1149550,True,8,Very Positive,79,4,83
1149580,True,0,2 user reviews,2,0,2
1149590,True,0,5 user reviews,5,0,5
1149620,True,0,No user reviews,0,0,0
1149630,True,0,No user reviews,0,0,0
1149640,True,8,Very Positive,679,111,790
1149650,True,0,No user reviews,0,0,0
1149660,True,6,Mostly Positive,105,31,136
1149690,True,0,7 user reviews,7,0,7
1149700,True,0,1 user reviews,1,0,1
1149710,True,6,Mostly Positive,13,5,18
1149720,True,0,4 user reviews,4,0,4
1149740,True,0,No user reviews,0,0,0
1149760,True,0,No user reviews,0,0,0
1149770,True,0,No user reviews,0,0,0
1149780,True,0,No user reviews,0,0,0
1149781,True,0,No user reviews,0,0,0
1149800,True,0,No user reviews,0,0,0
1149830,True,0,No user reviews,0,0,0
1149840,True,0,No user reviews,0,0,0
1149860,True,7,Positive,12,0,12
1149870,True,0,No user reviews,0,0,0
1149900,True,0,1 user reviews,0,1,1
1149910,True,0,No user reviews,0,0,0
1149930,True,0,2 user reviews,2,0,2
1149940,True,8,Very Positive,112,18,130
1149990,True,0,No user reviews,0,0,0
1150010,True,0,No user reviews,0,0,0
1150020,True,0,No user reviews,0,0,0
1150030,True,5,Mixed,6,6,12
1150031,True,6,Mostly Positive,8,3,11
1150032,True,0,2 user reviews,1,1,2
1150033,True,0,3 user reviews,2,1,3
1150040,True,0,No user reviews,0,0,0
1150050,True,0,6 user reviews,5,1,6
1150060,True,0,No user reviews,0,0,0
1150070,True,0,5 user reviews,5,0,5
1150080,True,6,Mostly Positive,563,200,763
1150090,True,0,No user reviews,0,0,0
1150100,True,0,No user reviews,0,0,0
1150101,True,0,No user reviews,0,0,0
1150102,True,0,No user reviews,0,0,0
1150130,True,0,No user reviews,0,0,0
1150140,True,0,No user reviews,0,0,0
1150150,True,0,No user reviews,0,0,0
1150160,True,0,2 user reviews,1,1,2
1150180,True,0,No user reviews,0,0,0
1150190,True,6,Mostly Positive,31,11,42
1150191,True,0,No user reviews,0,0,0
1150192,True,0,No user reviews,0,0,0
1150194,True,0,No user reviews,0,0,0
1150195,True,0,2 user reviews,2,0,2
1150210,True,0,No user reviews,0,0,0
1150230,True,0,No user reviews,0,0,0
1150240,True,0,No user reviews,0,0,0
1150250,True,0,1 user reviews,1,0,1
1150260,True,0,No user reviews,0,0,0
1150270,True,0,1 user reviews,0,1,1
1150280,True,0,No user reviews,0,0,0
1150290,True,0,No user reviews,0,0,0
1150300,True,0,No user reviews,0,0,0
1150310,True,0,1 user reviews,0,1,1
1150320,True,0,1 user reviews,0,1,1
1150330,True,0,No user reviews,0,0,0
1150370,True,0,1 user reviews,1,0,1
1150380,True,0,4 user reviews,1,3,4
1150390,True,0,No user reviews,0,0,0
1150400,True,0,5 user reviews,5,0,5
1150410,True,0,No user reviews,0,0,0
1150420,True,0,No user reviews,0,0,0
1150460,True,7,Positive,45,2,47
1150480,True,0,2 user reviews,2,0,2
1150500,True,0,9 user reviews,3,6,9
1150540,True,0,1 user reviews,1,0,1
1150550,True,7,Positive,10,0,10
1150580,True,0,2 user reviews,0,2,2
1150590,True,8,Very Positive,279,56,335
1150610,True,0,2 user reviews,2,0,2
1150620,True,6,Mostly Positive,18,6,24
1150640,True,8,Very Positive,395,94,489
1150650,True,0,No user reviews,0,0,0
1150670,True,0,No user reviews,0,0,0
1150680,True,0,1 user reviews,1,0,1
1150690,True,0,No user reviews,0,0,0
1150720,True,8,Very Positive,92,4,96
1150730,True,7,Positive,38,5,43
1150750,True,0,No user reviews,0,0,0
1150760,True,0,No user reviews,0,0,0
1150790,True,0,4 user reviews,3,1,4
1150800,True,0,No user reviews,0,0,0
1150810,True,0,2 user reviews,2,0,2
1150820,True,0,No user reviews,0,0,0
1150830,True,0,No user reviews,0,0,0
1150840,True,0,No user reviews,0,0,0
1150850,True,0,No user reviews,0,0,0
1150860,True,0,No user reviews,0,0,0
1150870,True,0,No user reviews,0,0,0
1150880,True,0,No user reviews,0,0,0
1150890,True,6,Mostly Positive,43,11,54
1150900,True,0,No user reviews,0,0,0
1150910,True,0,No user reviews,0,0,0
1150930,True,0,2 user reviews,2,0,2
1150940,True,0,3 user reviews,3,0,3
1150950,True,8,Very Positive,253,12,265
1150970,True,0,No user reviews,0,0,0
1150990,True,0,No user reviews,0,0,0
1151060,True,0,No user reviews,0,0,0
1151070,True,7,Positive,13,3,16
1151080,True,0,1 user reviews,1,0,1
1151090,True,0,No user reviews,0,0,0
1151100,True,0,No user reviews,0,0,0
1151110,True,5,Mixed,23,10,33
1151120,True,7,Positive,35,8,43
1151130,True,0,No user reviews,0,0,0
1151160,True,0,3 user reviews,2,1,3
1151170,True,6,Mostly Positive,49,21,70
1151180,True,0,2 user reviews,1,1,2
1151200,True,7,Positive,8,2,10
1151250,True,7,Positive,26,3,29
1151270,True,0,No user reviews,0,0,0
1151300,True,0,No user reviews,0,0,0
1151310,True,0,No user reviews,0,0,0
1151320,True,0,No user reviews,0,0,0
1151330,True,0,No user reviews,0,0,0
1151340,True,6,Mostly Positive,4982,1299,6281
1151370,True,0,No user reviews,0,0,0
1151380,True,0,No user reviews,0,0,0
1151390,True,7,Positive,28,1,29
1151400,True,0,3 user reviews,1,2,3
1151410,True,0,No user reviews,0,0,0
1151420,True,0,No user reviews,0,0,0
1151430,True,0,2 user reviews,2,0,2
1151440,True,8,Very Positive,63,0,63
1151460,True,0,No user reviews,0,0,0
1151480,True,0,No user reviews,0,0,0
1151500,True,0,No user reviews,0,0,0
1151540,True,0,No user reviews,0,0,0
1151550,True,0,No user reviews,0,0,0
1151570,True,0,No user reviews,0,0,0
1151580,True,0,1 user reviews,1,0,1
1151590,True,0,No user reviews,0,0,0
1151600,True,0,4 user reviews,4,0,4
1151610,True,0,No user reviews,0,0,0
1151620,True,0,No user reviews,0,0,0
1151630,True,7,Positive,8,2,10
1151640,True,6,Mostly Positive,10883,3280,14163
1151650,True,0,3 user reviews,3,0,3
1151660,True,0,No user reviews,0,0,0
1151661,True,0,No user reviews,0,0,0
1151670,True,0,3 user reviews,2,1,3
1151680,True,7,Positive,12,0,12
1151700,True,5,Mixed,190,87,277
1151710,True,0,No user reviews,0,0,0
1151720,True,0,No user reviews,0,0,0
1151730,True,0,8 user reviews,6,2,8
1151740,True,7,Positive,22,1,23
1151750,True,0,9 user reviews,6,3,9
1151770,True,0,2 user reviews,1,1,2
1151790,True,0,No user reviews,0,0,0
1151820,True,0,No user reviews,0,0,0
1151840,True,0,4 user reviews,3,1,4
1151850,True,0,No user reviews,0,0,0
1151860,True,0,No user reviews,0,0,0
1151880,True,0,No user reviews,0,0,0
1151910,True,0,1 user reviews,1,0,1
1151920,True,0,No user reviews,0,0,0
1151930,True,0,No user reviews,0,0,0
1151940,True,0,1 user reviews,1,0,1
1151950,True,0,1 user reviews,0,1,1
1151960,True,0,No user reviews,0,0,0
1151970,True,0,No user reviews,0,0,0
1151980,True,0,No user reviews,0,0,0
1152000,True,0,No user reviews,0,0,0
1152010,True,0,No user reviews,0,0,0
1152011,True,0,No user reviews,0,0,0
1152012,True,0,No user reviews,0,0,0
1152020,True,7,Positive,28,6,34
1152030,True,0,No user reviews,0,0,0
1152040,True,0,2 user reviews,2,0,2
1152050,True,0,7 user reviews,4,3,7
1152060,True,0,No user reviews,0,0,0
1152090,True,8,Very Positive,87,17,104
1152100,True,0,No user reviews,0,0,0
1152130,True,0,No user reviews,0,0,0
1152160,True,6,Mostly Positive,10,4,14
1152170,True,0,No user reviews,0,0,0
1152200,True,0,No user reviews,0,0,0
1152210,True,0,No user reviews,0,0,0
1152230,True,0,No user reviews,0,0,0
1152250,True,0,No user reviews,0,0,0
1152260,True,0,No user reviews,0,0,0
1152280,True,0,No user reviews,0,0,0
1152300,True,7,Positive,31,3,34
1152310,True,7,Positive,15,2,17
1152320,True,7,Positive,10,1,11
1152330,True,0,No user reviews,0,0,0
1152340,True,0,No user reviews,0,0,0
1152350,True,0,No user reviews,0,0,0
1152360,True,0,5 user reviews,3,2,5
1152380,True,0,No user reviews,0,0,0
1152390,True,0,No user reviews,0,0,0
1152410,True,7,Positive,11,2,13
1152420,True,7,Positive,12,1,13
1152440,True,5,Mixed,8,4,12
1152450,True,0,9 user reviews,9,0,9
1152480,True,0,No user reviews,0,0,0
1152520,True,0,No user reviews,0,0,0
1152530,True,0,No user reviews,0,0,0
1152540,True,0,1 user reviews,0,1,1
1152550,True,0,1 user reviews,1,0,1
1152560,True,0,1 user reviews,0,1,1
1152570,True,0,No user reviews,0,0,0
1152580,True,7,Positive,12,0,12
1152620,True,0,No user reviews,0,0,0
1152640,True,0,1 user reviews,1,0,1
1152660,True,0,No user reviews,0,0,0
1152670,True,0,5 user reviews,5,0,5
1152680,True,0,No user reviews,0,0,0
1152700,True,0,2 user reviews,0,2,2
1152710,True,0,No user reviews,0,0,0
1152730,True,0,No user reviews,0,0,0
1152740,True,0,No user reviews,0,0,0
1152760,True,0,No user reviews,0,0,0
1152800,True,0,No user reviews,0,0,0
1152810,True,0,2 user reviews,1,1,2
1152820,True,0,3 user reviews,3,0,3
1152830,True,0,1 user reviews,1,0,1
1152840,True,0,3 user reviews,3,0,3
1152850,True,0,No user reviews,0,0,0
1152860,True,0,No user reviews,0,0,0
1152870,True,0,No user reviews,0,0,0
1152890,True,0,No user reviews,0,0,0
1152900,True,0,4 user reviews,4,0,4
1152910,True,0,No user reviews,0,0,0
1152920,True,0,1 user reviews,1,0,1
1152930,True,0,No user reviews,0,0,0
1152940,True,0,No user reviews,0,0,0
1152950,True,0,No user reviews,0,0,0
1152960,True,0,No user reviews,0,0,0
1152990,True,0,No user reviews,0,0,0
1153020,True,0,No user reviews,0,0,0
1153021,True,0,No user reviews,0,0,0
1153030,True,0,No user reviews,0,0,0
1153050,True,0,No user reviews,0,0,0
1153060,True,0,No user reviews,0,0,0
1153070,True,0,8 user reviews,6,2,8
1153100,True,0,No user reviews,0,0,0
1153110,True,0,2 user reviews,1,1,2
1153120,True,0,No user reviews,0,0,0
1153130,True,0,No user reviews,0,0,0
1153170,True,0,No user reviews,0,0,0
1153180,True,0,No user reviews,0,0,0
1153200,True,7,Positive,20,1,21
1153220,True,0,1 user reviews,1,0,1
1153230,True,0,No user reviews,0,0,0
1153240,True,0,No user reviews,0,0,0
1153250,True,0,8 user reviews,4,4,8
1153260,True,0,No user reviews,0,0,0
1153270,True,0,No user reviews,0,0,0
1153290,True,0,No user reviews,0,0,0
1153300,True,0,No user reviews,0,0,0
1153320,True,0,No user reviews,0,0,0
1153330,True,0,2 user reviews,2,0,2
1153340,True,0,No user reviews,0,0,0
1153350,True,0,No user reviews,0,0,0
1153351,True,0,1 user reviews,1,0,1
1153352,True,0,No user reviews,0,0,0
1153353,True,0,1 user reviews,1,0,1
1153360,True,0,No user reviews,0,0,0
1153370,True,0,No user reviews,0,0,0
1153420,True,0,1 user reviews,1,0,1
1153421,True,0,No user reviews,0,0,0
1153422,True,0,No user reviews,0,0,0
1153423,True,0,No user reviews,0,0,0
1153430,True,8,Very Positive,61,13,74
1153440,True,0,No user reviews,0,0,0
1153441,True,0,No user reviews,0,0,0
1153442,True,0,No user reviews,0,0,0
1153443,True,0,2 user reviews,1,1,2
1153460,True,7,Positive,10,1,11
1153470,True,0,4 user reviews,3,1,4
1153490,True,0,No user reviews,0,0,0
1153500,True,0,No user reviews,0,0,0
1153510,True,0,No user reviews,0,0,0
1153520,True,0,No user reviews,0,0,0
1153530,True,0,No user reviews,0,0,0
1153540,True,7,Positive,16,3,19
1153550,True,0,1 user reviews,0,1,1
1153560,True,0,No user reviews,0,0,0
1153570,True,0,No user reviews,0,0,0
1153580,True,0,No user reviews,0,0,0
1153600,True,0,1 user reviews,1,0,1
1153620,True,0,No user reviews,0,0,0
1153630,True,0,3 user reviews,3,0,3
1153640,True,0,No user reviews,0,0,0
1153650,True,0,No user reviews,0,0,0
1153660,True,0,No user reviews,0,0,0
1153670,True,0,8 user reviews,8,0,8
1153680,True,0,1 user reviews,0,1,1
1153690,True,0,3 user reviews,2,1,3
1153700,True,0,1 user reviews,0,1,1
1153710,True,0,No user reviews,0,0,0
1153720,True,0,No user reviews,0,0,0
1153730,True,0,2 user reviews,0,2,2
1153750,True,0,No user reviews,0,0,0
1153770,True,0,No user reviews,0,0,0
1153810,True,0,No user reviews,0,0,0
1153820,True,0,No user reviews,0,0,0
1153840,True,0,1 user reviews,1,0,1
1153860,True,0,2 user reviews,0,2,2
1153870,True,0,No user reviews,0,0,0
1153880,True,0,No user reviews,0,0,0
1153890,True,0,6 user reviews,0,6,6
1153920,True,0,No user reviews,0,0,0
1153930,True,0,2 user reviews,1,1,2
1153950,True,0,5 user reviews,3,2,5
1153960,True,0,No user reviews,0,0,0
1153970,True,0,No user reviews,0,0,0
1153980,True,7,Positive,13,0,13
1153990,True,0,2 user reviews,1,1,2
1154000,True,0,No user reviews,0,0,0
1154010,True,0,1 user reviews,0,1,1
1154040,True,0,No user reviews,0,0,0
1154060,True,0,1 user reviews,1,0,1
1154070,True,0,No user reviews,0,0,0
1154080,True,6,Mostly Positive,35,9,44
1154090,True,0,No user reviews,0,0,0
1154110,True,8,Very Positive,54,11,65
1154120,True,0,No user reviews,0,0,0
1154130,True,0,No user reviews,0,0,0
1154150,True,0,No user reviews,0,0,0
1154160,True,0,No user reviews,0,0,0
1154170,True,0,6 user reviews,4,2,6
1154190,True,0,No user reviews,0,0,0
1154200,True,0,No user reviews,0,0,0
1154210,True,0,1 user reviews,0,1,1
1154280,True,0,No user reviews,0,0,0
1154290,True,0,No user reviews,0,0,0
1154300,True,7,Positive,12,0,12
1154310,True,0,No user reviews,0,0,0
1154311,True,0,4 user reviews,2,2,4
1154320,True,6,Mostly Positive,26,7,33
1154340,True,0,4 user reviews,4,0,4
1154350,True,0,No user reviews,0,0,0
1154360,True,0,No user reviews,0,0,0
1154420,True,0,No user reviews,0,0,0
1154430,True,0,No user reviews,0,0,0
1154440,True,0,6 user reviews,6,0,6
1154470,True,0,No user reviews,0,0,0
1154480,True,0,3 user reviews,2,1,3
1154490,True,0,2 user reviews,2,0,2
1154500,True,0,No user reviews,0,0,0
1154540,True,0,No user reviews,0,0,0
1154560,True,0,1 user reviews,0,1,1
1154570,True,0,No user reviews,0,0,0
1154591,True,7,Positive,11,0,11
1154600,True,0,No user reviews,0,0,0
1154620,True,0,No user reviews,0,0,0
1154640,True,0,1 user reviews,1,0,1
1154650,True,0,6 user reviews,4,2,6
1154670,True,0,No user reviews,0,0,0
1154680,True,0,6 user reviews,5,1,6
1154700,True,0,8 user reviews,6,2,8
1154710,True,0,No user reviews,0,0,0
1154720,True,5,Mixed,9,5,14
1154730,True,5,Mixed,6,5,11
1154760,True,5,Mixed,178,81,259
1154770,True,0,5 user reviews,4,1,5
1154780,True,6,Mostly Positive,17,5,22
1154790,True,0,No user reviews,0,0,0
1154800,True,0,No user reviews,0,0,0
1154810,True,8,Very Positive,200,13,213
1154820,True,0,No user reviews,0,0,0
1154830,True,0,No user reviews,0,0,0
1154840,True,0,No user reviews,0,0,0
1154850,True,8,Very Positive,154,11,165
1154860,True,0,No user reviews,0,0,0
1154940,True,0,7 user reviews,6,1,7
1154970,True,0,No user reviews,0,0,0
1154990,True,5,Mixed,6,5,11
1155010,True,0,No user reviews,0,0,0
1155030,True,0,2 user reviews,2,0,2
1155040,True,0,No user reviews,0,0,0
1155041,True,0,No user reviews,0,0,0
1155050,True,0,No user reviews,0,0,0
1155070,True,0,4 user reviews,4,0,4
1155090,True,0,1 user reviews,1,0,1
1155100,True,0,No user reviews,0,0,0
1155120,True,0,No user reviews,0,0,0
1155130,True,0,4 user reviews,4,0,4
1155140,True,0,No user reviews,0,0,0
1155150,True,0,No user reviews,0,0,0
1155220,True,0,No user reviews,0,0,0
1155230,True,0,2 user reviews,1,1,2
1155240,True,0,No user reviews,0,0,0
1155260,True,0,No user reviews,0,0,0
1155270,True,7,Positive,13,1,14
1155280,True,0,No user reviews,0,0,0
1155290,True,0,1 user reviews,1,0,1
1155320,True,7,Positive,20,3,23
1155340,True,0,2 user reviews,2,0,2
1155370,True,0,No user reviews,0,0,0
1155380,True,0,No user reviews,0,0,0
1155381,True,0,No user reviews,0,0,0
1155390,True,0,No user reviews,0,0,0
1155400,True,0,No user reviews,0,0,0
1155410,True,0,8 user reviews,7,1,8
1155420,True,0,5 user reviews,3,2,5
1155430,True,0,4 user reviews,3,1,4
1155440,True,0,2 user reviews,1,1,2
1155460,True,5,Mixed,8,7,15
1155470,True,0,No user reviews,0,0,0
1155480,True,0,4 user reviews,1,3,4
1155490,True,0,2 user reviews,0,2,2
1155500,True,0,2 user reviews,0,2,2
1155510,True,0,No user reviews,0,0,0
1155530,True,0,No user reviews,0,0,0
1155540,True,0,No user reviews,0,0,0
1155560,True,0,2 user reviews,2,0,2
1155580,True,0,No user reviews,0,0,0
1155590,True,0,No user reviews,0,0,0
1155600,True,0,No user reviews,0,0,0
1155620,True,0,2 user reviews,1,1,2
1155650,True,0,No user reviews,0,0,0
1155660,True,7,Positive,19,1,20
1155670,True,0,3 user reviews,2,1,3
1155680,True,0,4 user reviews,1,3,4
1155700,True,7,Positive,31,7,38
1155720,True,7,Positive,29,1,30
1155730,True,0,No user reviews,0,0,0
1155740,True,0,No user reviews,0,0,0
1155760,True,0,9 user reviews,5,4,9
1155780,True,0,No user reviews,0,0,0
1155790,True,0,5 user reviews,5,0,5
1155800,True,0,3 user reviews,2,1,3
1155810,True,0,4 user reviews,2,2,4
1155830,True,7,Positive,17,4,21
1155840,True,0,No user reviews,0,0,0
1155850,True,0,No user reviews,0,0,0
1155860,True,0,No user reviews,0,0,0
1155870,True,0,No user reviews,0,0,0
1155880,True,5,Mixed,24,15,39
1155900,True,0,No user reviews,0,0,0
1155910,True,0,1 user reviews,0,1,1
1155920,True,0,2 user reviews,0,2,2
1155930,True,0,1 user reviews,1,0,1
1155940,True,0,8 user reviews,7,1,8
1155950,True,0,2 user reviews,0,2,2
1155960,True,0,4 user reviews,4,0,4
1155970,True,0,No user reviews,0,0,0
1155980,True,0,5 user reviews,4,1,5
1155990,True,0,6 user reviews,4,2,6
1156000,True,8,Very Positive,55,5,60
1156030,True,0,2 user reviews,0,2,2
1156050,True,0,9 user reviews,5,4,9
1156120,True,0,No user reviews,0,0,0
1156130,True,0,1 user reviews,0,1,1
1156140,True,0,No user reviews,0,0,0
1156150,True,0,No user reviews,0,0,0
1156160,True,0,1 user reviews,1,0,1
1156200,True,0,1 user reviews,0,1,1
1156240,True,0,No user reviews,0,0,0
1156250,True,7,Positive,30,5,35
1156260,True,0,No user reviews,0,0,0
1156270,True,0,No user reviews,0,0,0
1156271,True,0,No user reviews,0,0,0
1156272,True,0,No user reviews,0,0,0
1156273,True,0,No user reviews,0,0,0
1156280,True,0,No user reviews,0,0,0
1156290,True,0,No user reviews,0,0,0
1156310,True,0,No user reviews,0,0,0
1156320,True,0,No user reviews,0,0,0
1156330,True,0,No user reviews,0,0,0
1156340,True,0,No user reviews,0,0,0
1156350,True,0,No user reviews,0,0,0
1156360,True,7,Positive,45,2,47
1156380,True,0,No user reviews,0,0,0
1156390,True,0,No user reviews,0,0,0
1156420,True,0,1 user reviews,0,1,1
1156450,True,0,No user reviews,0,0,0
1156470,True,0,No user reviews,0,0,0
1156480,True,0,No user reviews,0,0,0
1156490,True,0,No user reviews,0,0,0
1156500,True,0,No user reviews,0,0,0
1156510,True,0,No user reviews,0,0,0
1156540,True,0,No user reviews,0,0,0
1156550,True,0,6 user reviews,5,1,6
1156560,True,0,No user reviews,0,0,0
1156570,True,0,No user reviews,0,0,0
1156590,True,7,Positive,36,7,43
1156610,True,0,No user reviews,0,0,0
1156630,True,7,Positive,10,1,11
1156640,True,0,1 user reviews,1,0,1
1156650,True,0,2 user reviews,1,1,2
1156660,True,0,No user reviews,0,0,0
1156670,True,0,6 user reviews,5,1,6
1156680,True,0,3 user reviews,2,1,3
1156700,True,0,No user reviews,0,0,0
1156710,True,0,4 user reviews,4,0,4
1156720,True,0,No user reviews,0,0,0
1156730,True,5,Mixed,12,7,19
1156740,True,0,1 user reviews,1,0,1
1156760,True,0,No user reviews,0,0,0
1156770,True,0,No user reviews,0,0,0
1156780,True,0,2 user reviews,2,0,2
1156810,True,0,1 user reviews,0,1,1
1156830,True,0,No user reviews,0,0,0
1156850,True,0,No user reviews,0,0,0
1156900,True,0,1 user reviews,1,0,1
1156910,True,0,2 user reviews,0,2,2
1156950,True,0,No user reviews,0,0,0
1156960,True,0,1 user reviews,1,0,1
1156970,True,0,No user reviews,0,0,0
1156980,True,0,4 user reviews,3,1,4
1156990,True,0,6 user reviews,6,0,6
1157010,True,0,4 user reviews,4,0,4
1157020,True,0,No user reviews,0,0,0
1157030,True,0,No user reviews,0,0,0
1157040,True,0,3 user reviews,2,1,3
1157050,True,0,No user reviews,0,0,0
1157060,True,0,No user reviews,0,0,0
1157070,True,0,No user reviews,0,0,0
1157080,True,0,2 user reviews,1,1,2
1157090,True,0,No user reviews,0,0,0
1157100,True,0,No user reviews,0,0,0
1157120,True,0,1 user reviews,0,1,1
1157130,True,0,No user reviews,0,0,0
1157140,True,0,No user reviews,0,0,0
1157160,True,0,No user reviews,0,0,0
1157161,True,0,No user reviews,0,0,0
1157162,True,0,No user reviews,0,0,0
1157163,True,0,No user reviews,0,0,0
1157170,True,0,9 user reviews,7,2,9
1157190,True,0,No user reviews,0,0,0
1157200,True,0,No user reviews,0,0,0
1157210,True,0,No user reviews,0,0,0
1157220,True,0,No user reviews,0,0,0
1157230,True,0,4 user reviews,4,0,4
1157240,True,0,No user reviews,0,0,0
1157250,True,0,No user reviews,0,0,0
1157260,True,0,7 user reviews,7,0,7
1157300,True,0,9 user reviews,9,0,9
1157310,True,0,5 user reviews,5,0,5
1157320,True,0,2 user reviews,2,0,2
1157330,True,0,No user reviews,0,0,0
1157340,True,6,Mostly Positive,201,53,254
1157350,True,0,2 user reviews,0,2,2
1157360,True,0,No user reviews,0,0,0
1157370,True,0,No user reviews,0,0,0
1157390,True,0,No user reviews,0,0,0
1157430,True,0,No user reviews,0,0,0
1157440,True,0,No user reviews,0,0,0
1157450,True,0,No user reviews,0,0,0
1157460,True,0,No user reviews,0,0,0
1157470,True,0,No user reviews,0,0,0
1157480,True,0,1 user reviews,0,1,1
1157490,True,0,No user reviews,0,0,0
1157520,True,0,No user reviews,0,0,0
1157530,True,0,No user reviews,0,0,0
1157540,True,0,No user reviews,0,0,0
1157550,True,8,Very Positive,53,7,60
1157560,True,0,No user reviews,0,0,0
1157590,True,0,No user reviews,0,0,0
1157600,True,0,No user reviews,0,0,0
1157620,True,6,Mostly Positive,14,6,20
1157640,True,6,Mostly Positive,18,5,23
1157650,True,0,3 user reviews,3,0,3
1157690,True,0,No user reviews,0,0,0
1157730,True,7,Positive,11,0,11
1157731,True,0,4 user reviews,4,0,4
1157732,True,0,4 user reviews,4,0,4
1157740,True,0,No user reviews,0,0,0
1157750,True,7,Positive,26,6,32
1157760,True,0,No user reviews,0,0,0
1157770,True,0,No user reviews,0,0,0
1157780,True,0,2 user reviews,2,0,2
1157790,True,5,Mixed,13,6,19
1157800,True,0,No user reviews,0,0,0
1157810,True,0,6 user reviews,6,0,6
1157820,True,0,1 user reviews,1,0,1
1157830,True,0,No user reviews,0,0,0
1157840,True,0,No user reviews,0,0,0
1157850,True,0,1 user reviews,1,0,1
1157860,True,0,No user reviews,0,0,0
1157870,True,0,No user reviews,0,0,0
1157880,True,0,No user reviews,0,0,0
1157890,True,0,1 user reviews,0,1,1
1157900,True,0,No user reviews,0,0,0
1157910,True,0,4 user reviews,4,0,4
1157920,True,0,No user reviews,0,0,0
1157940,True,5,Mixed,28,15,43
1157950,True,0,No user reviews,0,0,0
1157960,True,0,No user reviews,0,0,0
1157980,True,0,1 user reviews,1,0,1
1158000,True,0,No user reviews,0,0,0
1158010,True,6,Mostly Positive,16,5,21
1158040,True,0,No user reviews,0,0,0
1158080,True,0,No user reviews,0,0,0
1158100,True,4,Mostly Negative,277,429,706
1158110,True,0,No user reviews,0,0,0
1158111,True,0,1 user reviews,0,1,1
1158120,True,0,5 user reviews,4,1,5
1158130,True,0,1 user reviews,0,1,1
1158150,True,0,2 user reviews,2,0,2
1158160,True,0,No user reviews,0,0,0
1158180,True,6,Mostly Positive,158,52,210
1158181,True,0,No user reviews,0,0,0
1158190,True,0,No user reviews,0,0,0
1158200,True,0,8 user reviews,5,3,8
1158210,True,0,1 user reviews,1,0,1
1158220,True,0,No user reviews,0,0,0
1158230,True,0,1 user reviews,0,1,1
1158240,True,0,2 user reviews,2,0,2
1158241,True,0,No user reviews,0,0,0
1158260,True,7,Positive,10,0,10
1158270,True,0,4 user reviews,3,1,4
1158280,True,7,Positive,43,5,48
1158290,True,7,Positive,36,1,37
1158310,True,8,Very Positive,10448,842,11290
1158320,True,7,Positive,12,3,15
1158330,True,0,No user reviews,0,0,0
1158340,True,0,No user reviews,0,0,0
1158370,True,0,No user reviews,0,0,0
1158390,True,0,1 user reviews,0,1,1
1158410,True,7,Positive,10,0,10
1158420,True,0,No user reviews,0,0,0
1158430,True,0,2 user reviews,0,2,2
1158440,True,0,No user reviews,0,0,0
1158441,True,0,No user reviews,0,0,0
1158450,True,0,No user reviews,0,0,0
1158460,True,0,No user reviews,0,0,0
1158470,True,8,Very Positive,103,2,105
1158480,True,0,No user reviews,0,0,0
1158490,True,0,5 user reviews,4,1,5
1158500,True,5,Mixed,7,5,12
1158530,True,0,No user reviews,0,0,0
1158540,True,0,No user reviews,0,0,0
1158550,True,0,No user reviews,0,0,0
1158560,True,0,No user reviews,0,0,0
1158590,True,0,5 user reviews,0,5,5
1158600,True,0,No user reviews,0,0,0
1158620,True,0,No user reviews,0,0,0
1158640,True,0,No user reviews,0,0,0
1158650,True,0,1 user reviews,0,1,1
1158660,True,8,Very Positive,59,8,67
1158670,True,0,No user reviews,0,0,0
1158680,True,0,No user reviews,0,0,0
1158690,True,8,Very Positive,54,12,66
1158730,True,4,Mostly Negative,17,48,65
1158740,True,0,No user reviews,0,0,0
1158750,True,0,No user reviews,0,0,0
1158770,True,0,No user reviews,0,0,0
1158780,True,0,1 user reviews,1,0,1
1158790,True,0,No user reviews,0,0,0
1158800,True,0,No user reviews,0,0,0
1158820,True,0,No user reviews,0,0,0
1158830,True,0,1 user reviews,1,0,1
1158840,True,0,No user reviews,0,0,0
1158860,True,0,No user reviews,0,0,0
1158870,True,0,No user reviews,0,0,0
1158890,True,0,No user reviews,0,0,0
1158900,True,0,No user reviews,0,0,0
1158910,True,0,6 user reviews,5,1,6
1158930,True,0,No user reviews,0,0,0
1158940,True,8,Very Positive,132,30,162
1158960,True,0,No user reviews,0,0,0
1158970,True,6,Mostly Positive,14,4,18
1158980,True,0,No user reviews,0,0,0
1158990,True,0,No user reviews,0,0,0
1159000,True,0,No user reviews,0,0,0
1159010,True,0,2 user reviews,0,2,2
1159020,True,0,2 user reviews,1,1,2
1159030,True,0,8 user reviews,7,1,8
1159040,True,0,1 user reviews,0,1,1
1159050,True,0,No user reviews,0,0,0
1159060,True,4,Mostly Negative,10,25,35
1159070,True,0,No user reviews,0,0,0
1159090,True,0,No user reviews,0,0,0
1159100,True,0,No user reviews,0,0,0
1159110,True,0,No user reviews,0,0,0
1159130,True,0,1 user reviews,1,0,1
1159140,True,0,No user reviews,0,0,0
1159150,True,0,No user reviews,0,0,0
1159160,True,0,No user reviews,0,0,0
1159200,True,0,1 user reviews,1,0,1
1159240,True,0,No user reviews,0,0,0
1159260,True,0,No user reviews,0,0,0
1159270,True,0,No user reviews,0,0,0
1159280,True,0,No user reviews,0,0,0
1159290,True,0,No user reviews,0,0,0
1159310,True,0,1 user reviews,1,0,1
1159311,True,0,No user reviews,0,0,0
1159312,True,0,No user reviews,0,0,0
1159313,True,0,No user reviews,0,0,0
1159314,True,0,No user reviews,0,0,0
1159315,True,0,No user reviews,0,0,0
1159316,True,0,1 user reviews,1,0,1
1159320,True,0,No user reviews,0,0,0
1159321,True,0,No user reviews,0,0,0
1159322,True,0,No user reviews,0,0,0
1159323,True,0,2 user reviews,2,0,2
1159324,True,0,No user reviews,0,0,0
1159325,True,0,1 user reviews,1,0,1
1159326,True,0,No user reviews,0,0,0
1159327,True,0,No user reviews,0,0,0
1159328,True,0,No user reviews,0,0,0
1159329,True,0,2 user reviews,1,1,2
1159340,True,0,No user reviews,0,0,0
1159350,True,0,No user reviews,0,0,0
1159360,True,0,1 user reviews,1,0,1
1159380,True,0,No user reviews,0,0,0
1159390,True,0,No user reviews,0,0,0
1159430,True,0,No user reviews,0,0,0
1159450,True,7,Positive,14,1,15
1159480,True,0,1 user reviews,1,0,1
1159490,True,0,No user reviews,0,0,0
1159500,True,7,Positive,13,1,14
1159510,True,0,8 user reviews,5,3,8
1159520,True,6,Mostly Positive,69,22,91
1159530,True,0,1 user reviews,1,0,1
1159540,True,6,Mostly Positive,12,4,16
1159550,True,0,No user reviews,0,0,0
1159560,True,8,Very Positive,76,2,78
1159570,True,0,No user reviews,0,0,0
1159580,True,0,2 user reviews,1,1,2
1159590,True,0,3 user reviews,0,3,3
1159610,True,0,3 user reviews,3,0,3
1159620,True,0,No user reviews,0,0,0
1159640,True,8,Very Positive,371,61,432
1159660,True,0,No user reviews,0,0,0
1159670,True,0,No user reviews,0,0,0
1159680,True,0,9 user reviews,9,0,9
1159690,True,0,No user reviews,0,0,0
1159700,True,3,Negative,3,21,24
1159770,True,0,1 user reviews,1,0,1
1159830,True,0,No user reviews,0,0,0
1159850,True,0,No user reviews,0,0,0
1159860,True,0,No user reviews,0,0,0
1159870,True,0,No user reviews,0,0,0
1159880,True,0,No user reviews,0,0,0
1159890,True,0,1 user reviews,1,0,1
1159900,True,0,No user reviews,0,0,0
1159910,True,0,No user reviews,0,0,0
1159920,True,0,1 user reviews,0,1,1
1159930,True,0,No user reviews,0,0,0
1159940,True,0,No user reviews,0,0,0
1159970,True,0,No user reviews,0,0,0
1160000,True,0,No user reviews,0,0,0
1160010,True,0,No user reviews,0,0,0
1160020,True,7,Positive,13,1,14
1160040,True,0,No user reviews,0,0,0
1160050,True,0,4 user reviews,2,2,4
1160060,True,0,No user reviews,0,0,0
1160100,True,0,2 user reviews,2,0,2
1160140,True,0,1 user reviews,0,1,1
1160160,True,0,No user reviews,0,0,0
1160170,True,0,No user reviews,0,0,0
1160190,True,0,1 user reviews,1,0,1
1160220,True,8,Very Positive,288,10,298
1160230,True,0,No user reviews,0,0,0
1160243,True,7,Positive,8,2,10
1160300,True,0,No user reviews,0,0,0
1160330,True,8,Very Positive,140,3,143
1160350,True,0,No user reviews,0,0,0
1160360,True,5,Mixed,49,35,84
1160390,True,0,1 user reviews,1,0,1
1160420,True,0,No user reviews,0,0,0
1160430,True,0,No user reviews,0,0,0
1160440,True,0,7 user reviews,7,0,7
1160480,True,0,6 user reviews,1,5,6
1160490,True,8,Very Positive,196,2,198
1160500,True,0,9 user reviews,5,4,9
1160510,True,0,No user reviews,0,0,0
1160520,True,0,No user reviews,0,0,0
1160550,True,0,No user reviews,0,0,0
1160560,True,0,No user reviews,0,0,0
1160580,True,0,7 user reviews,4,3,7
1160600,True,0,No user reviews,0,0,0
1160601,True,0,No user reviews,0,0,0
1160602,True,0,No user reviews,0,0,0
1160603,True,0,No user reviews,0,0,0
1160610,True,0,1 user reviews,1,0,1
1160620,True,0,4 user reviews,4,0,4
1160660,True,0,No user reviews,0,0,0
1160661,True,0,No user reviews,0,0,0
1160662,True,0,No user reviews,0,0,0
1160663,True,0,No user reviews,0,0,0
1160670,True,0,3 user reviews,3,0,3
1160690,True,0,No user reviews,0,0,0
1160700,True,7,Positive,13,0,13
1160710,True,0,No user reviews,0,0,0
1160730,True,0,No user reviews,0,0,0
1160750,True,0,No user reviews,0,0,0
1160760,True,0,1 user reviews,1,0,1
1160770,True,0,No user reviews,0,0,0
1160780,True,0,2 user reviews,1,1,2
1160790,True,0,3 user reviews,3,0,3
1160800,True,0,1 user reviews,1,0,1
1160820,True,0,7 user reviews,7,0,7
1160830,True,0,No user reviews,0,0,0
1160850,True,0,No user reviews,0,0,0
1160870,True,0,7 user reviews,7,0,7
1160880,True,0,9 user reviews,7,2,9
1160900,True,0,2 user reviews,1,1,2
1160920,True,0,No user reviews,0,0,0
1160930,True,0,1 user reviews,0,1,1
1160950,True,5,Mixed,14,7,21
1160960,True,0,No user reviews,0,0,0
1160970,True,0,No user reviews,0,0,0
1160980,True,0,1 user reviews,1,0,1
1160990,True,0,No user reviews,0,0,0
1161000,True,0,No user reviews,0,0,0
1161020,True,0,No user reviews,0,0,0
1161110,True,0,No user reviews,0,0,0
1161120,True,0,1 user reviews,1,0,1
1161140,True,0,No user reviews,0,0,0
1161160,True,0,No user reviews,0,0,0
1161170,True,0,No user reviews,0,0,0
1161180,True,0,8 user reviews,8,0,8
1161190,True,0,3 user reviews,3,0,3
1161200,True,0,No user reviews,0,0,0
1161210,True,0,No user reviews,0,0,0
1161220,True,0,No user reviews,0,0,0
1161230,True,0,No user reviews,0,0,0
1161270,True,5,Mixed,23,11,34
1161290,True,0,No user reviews,0,0,0
1161300,True,0,1 user reviews,1,0,1
1161310,True,0,No user reviews,0,0,0
1161320,True,0,3 user reviews,0,3,3
1161330,True,0,1 user reviews,1,0,1
1161340,True,0,No user reviews,0,0,0
1161350,True,0,No user reviews,0,0,0
1161360,True,7,Positive,15,0,15
1161370,True,0,2 user reviews,2,0,2
1161380,True,0,No user reviews,0,0,0
1161390,True,0,No user reviews,0,0,0
1161410,True,0,7 user reviews,6,1,7
1161420,True,0,7 user reviews,5,2,7
1161421,True,7,Positive,13,3,16
1161430,True,0,No user reviews,0,0,0
1161440,True,0,2 user reviews,0,2,2
1161450,True,0,No user reviews,0,0,0
1161460,True,0,No user reviews,0,0,0
1161470,True,0,No user reviews,0,0,0
1161490,True,8,Very Positive,488,64,552
1161510,True,0,2 user reviews,2,0,2
1161530,True,0,No user reviews,0,0,0
1161550,True,0,No user reviews,0,0,0
1161560,True,0,No user reviews,0,0,0
1161561,True,0,No user reviews,0,0,0
1161570,True,6,Mostly Positive,10,3,13
1161580,True,8,Very Positive,4004,362,4366
1161600,True,0,1 user reviews,1,0,1
1161601,True,0,2 user reviews,1,1,2
1161602,True,0,1 user reviews,1,0,1
1161603,True,0,1 user reviews,1,0,1
1161610,True,0,No user reviews,0,0,0
1161650,True,7,Positive,16,1,17
1161660,True,0,2 user reviews,2,0,2
1161670,True,0,1 user reviews,1,0,1
1161680,True,0,1 user reviews,1,0,1
1161690,True,0,No user reviews,0,0,0
1161740,True,0,No user reviews,0,0,0
1161770,True,0,No user reviews,0,0,0
1161780,True,0,No user reviews,0,0,0
1161800,True,0,No user reviews,0,0,0
1161810,True,0,No user reviews,0,0,0
1161820,True,0,No user reviews,0,0,0
1161840,True,0,No user reviews,0,0,0
1161850,True,0,No user reviews,0,0,0
1161870,True,0,4 user reviews,4,0,4
1161880,True,7,Positive,39,2,41
1161900,True,0,8 user reviews,3,5,8
1161910,True,0,3 user reviews,3,0,3
1161920,True,0,No user reviews,0,0,0
1161930,True,0,1 user reviews,1,0,1
1161940,True,0,No user reviews,0,0,0
1161950,True,0,No user reviews,0,0,0
1161960,True,0,No user reviews,0,0,0
1161970,True,0,No user reviews,0,0,0
1161980,True,0,No user reviews,0,0,0
1161990,True,0,No user reviews,0,0,0
1162000,True,0,No user reviews,0,0,0
1162010,True,0,1 user reviews,1,0,1
1162040,True,0,No user reviews,0,0,0
1162050,True,7,Positive,8,2,10
1162060,True,0,No user reviews,0,0,0
1162070,True,7,Positive,35,2,37
1162080,True,0,No user reviews,0,0,0
1162100,True,0,No user reviews,0,0,0
1162110,True,0,6 user reviews,6,0,6
1162130,True,5,Mixed,150,101,251
1162160,True,8,Very Positive,71,0,71
1162170,True,5,Mixed,16,7,23
1162180,True,0,No user reviews,0,0,0
1162190,True,0,No user reviews,0,0,0
1162200,True,7,Positive,19,2,21
1162201,True,4,Mostly Negative,4,12,16
1162202,True,7,Positive,14,1,15
1162203,True,3,Negative,4,19,23
1162204,True,7,Positive,13,0,13
1162205,True,0,5 user reviews,4,1,5
1162208,True,7,Positive,27,3,30
1162210,True,0,No user reviews,0,0,0
1162230,True,4,Mostly Negative,3,7,10
1162260,True,0,No user reviews,0,0,0
1162270,True,0,No user reviews,0,0,0
1162280,True,7,Positive,14,0,14
1162290,True,0,3 user reviews,0,3,3
1162310,True,0,No user reviews,0,0,0
1162320,True,0,4 user reviews,4,0,4
1162330,True,0,No user reviews,0,0,0
1162340,True,7,Positive,8,2,10
1162341,True,0,3 user reviews,3,0,3
1162342,True,0,8 user reviews,5,3,8
1162350,True,7,Positive,17,2,19
1162360,True,0,No user reviews,0,0,0
1162370,True,0,No user reviews,0,0,0
1162380,True,7,Positive,48,0,48
1162390,True,0,No user reviews,0,0,0
1162400,True,0,No user reviews,0,0,0
1162430,True,0,7 user reviews,7,0,7
1162440,True,0,5 user reviews,3,2,5
1162450,True,0,No user reviews,0,0,0
1162451,True,0,No user reviews,0,0,0
1162452,True,0,No user reviews,0,0,0
1162470,True,7,Positive,34,4,38
1162480,True,0,8 user reviews,8,0,8
1162490,True,0,No user reviews,0,0,0
1162520,True,5,Mixed,85,67,152
1162550,True,0,No user reviews,0,0,0
1162560,True,8,Very Positive,132,8,140
1162570,True,0,No user reviews,0,0,0
1162580,True,0,No user reviews,0,0,0
1162590,True,6,Mostly Positive,7,3,10
1162601,True,5,Mixed,32,41,73
1162602,True,4,Mostly Negative,43,83,126
1162630,True,0,No user reviews,0,0,0
1162640,True,0,1 user reviews,1,0,1
1162650,True,0,3 user reviews,3,0,3
1162670,True,5,Mixed,8,8,16
1162680,True,8,Very Positive,150,31,181
1162690,True,0,3 user reviews,2,1,3
1162700,True,0,No user reviews,0,0,0
1162710,True,0,1 user reviews,1,0,1
1162711,True,0,No user reviews,0,0,0
1162712,True,0,No user reviews,0,0,0
1162713,True,0,No user reviews,0,0,0
1162714,True,0,No user reviews,0,0,0
1162715,True,0,No user reviews,0,0,0
1162716,True,0,No user reviews,0,0,0
1162720,True,0,No user reviews,0,0,0
1162721,True,0,No user reviews,0,0,0
1162722,True,0,No user reviews,0,0,0
1162723,True,0,3 user reviews,3,0,3
1162730,True,0,3 user reviews,0,3,3
1162740,True,0,No user reviews,0,0,0
1162750,True,8,Very Positive,127,10,137
1162760,True,0,5 user reviews,5,0,5
1162780,True,0,No user reviews,0,0,0
1162781,True,0,No user reviews,0,0,0
1162782,True,0,No user reviews,0,0,0
1162783,True,0,No user reviews,0,0,0
1162784,True,0,No user reviews,0,0,0
1162785,True,0,No user reviews,0,0,0
1162790,True,0,No user reviews,0,0,0
1162791,True,0,No user reviews,0,0,0
1162792,True,0,No user reviews,0,0,0
1162793,True,0,No user reviews,0,0,0
1162794,True,0,No user reviews,0,0,0
1162795,True,0,No user reviews,0,0,0
1162796,True,0,No user reviews,0,0,0
1162800,True,0,No user reviews,0,0,0
1162801,True,0,No user reviews,0,0,0
1162810,True,0,No user reviews,0,0,0
1162820,True,0,No user reviews,0,0,0
1162870,True,0,No user reviews,0,0,0
1162880,True,0,4 user reviews,2,2,4
1162900,True,0,3 user reviews,2,1,3
1162920,True,0,1 user reviews,1,0,1
1162930,True,0,No user reviews,0,0,0
1162940,True,0,No user reviews,0,0,0
1162950,True,0,2 user reviews,0,2,2
1162960,True,0,No user reviews,0,0,0
1162990,True,0,No user reviews,0,0,0
1163010,True,0,No user reviews,0,0,0
1163020,True,0,No user reviews,0,0,0
1163030,True,0,No user reviews,0,0,0
1163040,True,7,Positive,37,4,41
1163070,True,7,Positive,27,3,30
1163090,True,0,7 user reviews,7,0,7
1163100,True,0,No user reviews,0,0,0
1163110,True,0,No user reviews,0,0,0
1163120,True,0,No user reviews,0,0,0
1163130,True,0,No user reviews,0,0,0
1163140,True,0,1 user reviews,1,0,1
1163150,True,5,Mixed,11,6,17
1163160,True,0,No user reviews,0,0,0
1163170,True,0,3 user reviews,3,0,3
1163180,True,0,No user reviews,0,0,0
1163200,True,0,No user reviews,0,0,0
1163210,True,0,No user reviews,0,0,0
1163220,True,0,No user reviews,0,0,0
1163240,True,0,No user reviews,0,0,0
1163250,True,0,No user reviews,0,0,0
1163280,True,0,No user reviews,0,0,0
1163290,True,0,6 user reviews,4,2,6
1163300,True,0,3 user reviews,1,2,3
1163310,True,0,No user reviews,0,0,0
1163320,True,0,2 user reviews,0,2,2
1163330,True,0,No user reviews,0,0,0
1163340,True,7,Positive,39,8,47
1163350,True,0,No user reviews,0,0,0
1163360,True,0,No user reviews,0,0,0
1163370,True,0,No user reviews,0,0,0
1163390,True,0,No user reviews,0,0,0
1163400,True,0,No user reviews,0,0,0
1163401,True,0,No user reviews,0,0,0
1163402,True,0,No user reviews,0,0,0
1163410,True,0,No user reviews,0,0,0
1163420,True,0,No user reviews,0,0,0
1163450,True,0,No user reviews,0,0,0
1163460,True,5,Mixed,11,6,17
1163470,True,0,3 user reviews,3,0,3
1163480,True,0,No user reviews,0,0,0
1163490,True,0,1 user reviews,0,1,1
1163520,True,0,9 user reviews,4,5,9
1163540,True,0,No user reviews,0,0,0
1163550,True,5,Mixed,289,172,461
1163560,True,0,8 user reviews,6,2,8
1163570,True,0,3 user reviews,3,0,3
1163590,True,8,Very Positive,59,11,70
1163600,True,6,Mostly Positive,38,12,50
1163610,True,0,No user reviews,0,0,0
1163620,True,0,No user reviews,0,0,0
1163640,True,0,5 user reviews,5,0,5
1163650,True,0,No user reviews,0,0,0
1163660,True,0,4 user reviews,3,1,4
1163690,True,0,No user reviews,0,0,0
1163740,True,8,Very Positive,106,0,106
1163770,True,5,Mixed,46,21,67
1163780,True,0,2 user reviews,1,1,2
1163790,True,0,1 user reviews,1,0,1
1163810,True,0,No user reviews,0,0,0
1163811,True,0,No user reviews,0,0,0
1163812,True,0,No user reviews,0,0,0
1163830,True,0,No user reviews,0,0,0
1163840,True,0,No user reviews,0,0,0
1163870,True,0,No user reviews,0,0,0
1163900,True,0,No user reviews,0,0,0
1163910,True,8,Very Positive,136,11,147
1163920,True,0,No user reviews,0,0,0
1163930,True,0,No user reviews,0,0,0
1163950,True,0,2 user reviews,1,1,2
1163960,True,0,3 user reviews,3,0,3
1163980,True,0,No user reviews,0,0,0
1163990,True,0,2 user reviews,1,1,2
1164000,True,0,1 user reviews,1,0,1
1164010,True,6,Mostly Positive,18,5,23
1164020,True,0,No user reviews,0,0,0
1164040,True,0,No user reviews,0,0,0
1164050,True,8,Very Positive,145,6,151
1164060,True,0,No user reviews,0,0,0
1164090,True,0,No user reviews,0,0,0
1164100,True,0,No user reviews,0,0,0
1164110,True,4,Mostly Negative,13,21,34
1164130,True,0,No user reviews,0,0,0
1164150,True,0,No user reviews,0,0,0
1164160,True,0,No user reviews,0,0,0
1164170,True,0,No user reviews,0,0,0
1164180,True,0,No user reviews,0,0,0
1164190,True,0,No user reviews,0,0,0
1164200,True,0,No user reviews,0,0,0
1164210,True,0,4 user reviews,4,0,4
1164211,True,0,No user reviews,0,0,0
1164212,True,0,No user reviews,0,0,0
1164213,True,0,1 user reviews,0,1,1
1164214,True,0,No user reviews,0,0,0
1164215,True,0,No user reviews,0,0,0
1164216,True,0,No user reviews,0,0,0
1164217,True,0,1 user reviews,0,1,1
1164218,True,0,No user reviews,0,0,0
1164219,True,0,No user reviews,0,0,0
1164220,True,0,No user reviews,0,0,0
1164230,True,0,No user reviews,0,0,0
1164240,True,0,1 user reviews,1,0,1
1164250,True,0,No user reviews,0,0,0
1164290,True,0,No user reviews,0,0,0
1164300,True,0,No user reviews,0,0,0
1164310,True,0,3 user reviews,3,0,3
1164320,True,0,No user reviews,0,0,0
1164330,True,0,4 user reviews,4,0,4
1164350,True,0,No user reviews,0,0,0
1164380,True,0,No user reviews,0,0,0
1164390,True,0,No user reviews,0,0,0
1164400,True,0,No user reviews,0,0,0
1164410,True,0,4 user reviews,4,0,4
1164420,True,0,No user reviews,0,0,0
1164430,True,0,No user reviews,0,0,0
1164440,True,0,2 user reviews,0,2,2
1164460,True,0,No user reviews,0,0,0
1164470,True,0,3 user reviews,2,1,3
1164480,True,0,4 user reviews,4,0,4
1164490,True,0,No user reviews,0,0,0
1164510,True,0,No user reviews,0,0,0
1164520,True,0,1 user reviews,0,1,1
1164530,True,0,No user reviews,0,0,0
1164540,True,0,No user reviews,0,0,0
1164550,True,0,5 user reviews,4,1,5
1164570,True,0,No user reviews,0,0,0
1164660,True,0,2 user reviews,1,1,2
1164690,True,0,No user reviews,0,0,0
1164740,True,7,Positive,37,1,38
1164750,True,7,Positive,20,3,23
1164760,True,0,No user reviews,0,0,0
1164780,True,0,No user reviews,0,0,0
1164790,True,0,No user reviews,0,0,0
1164810,True,0,No user reviews,0,0,0
1164820,True,0,No user reviews,0,0,0
1164830,True,0,No user reviews,0,0,0
1164840,True,0,No user reviews,0,0,0
1164850,True,0,9 user reviews,8,1,9
1164860,True,0,No user reviews,0,0,0
1164900,True,0,No user reviews,0,0,0
1164910,True,0,5 user reviews,5,0,5
1164920,True,0,No user reviews,0,0,0
1164930,True,3,Negative,3,16,19
1164940,True,0,No user reviews,0,0,0
1164950,True,0,1 user reviews,0,1,1
1164970,True,0,6 user reviews,6,0,6
1164990,True,0,1 user reviews,0,1,1
1165000,True,0,No user reviews,0,0,0
1165010,True,0,No user reviews,0,0,0
1165020,True,0,1 user reviews,1,0,1
1165030,True,0,No user reviews,0,0,0
1165050,True,0,No user reviews,0,0,0
1165051,True,0,No user reviews,0,0,0
1165052,True,0,No user reviews,0,0,0
1165070,True,7,Positive,18,0,18
1165090,True,0,2 user reviews,2,0,2
1165100,True,0,1 user reviews,1,0,1
1165120,True,0,No user reviews,0,0,0
1165130,True,0,No user reviews,0,0,0
1165140,True,0,9 user reviews,7,2,9
1165150,True,0,No user reviews,0,0,0
1165160,True,0,No user reviews,0,0,0
1165170,True,0,No user reviews,0,0,0
1165180,True,0,7 user reviews,7,0,7
1165200,True,0,No user reviews,0,0,0
1165210,True,0,No user reviews,0,0,0
1165220,True,0,No user reviews,0,0,0
1165221,True,0,No user reviews,0,0,0
1165230,True,0,No user reviews,0,0,0
1165240,True,0,No user reviews,0,0,0
1165250,True,0,No user reviews,0,0,0
1165260,True,0,No user reviews,0,0,0
1165261,True,0,No user reviews,0,0,0
1165262,True,0,No user reviews,0,0,0
1165270,True,7,Positive,22,3,25
1165280,True,0,3 user reviews,1,2,3
1165290,True,0,No user reviews,0,0,0
1165300,True,0,1 user reviews,1,0,1
1165340,True,0,No user reviews,0,0,0
1165350,True,0,No user reviews,0,0,0
1165380,True,5,Mixed,16,10,26
1165390,True,0,No user reviews,0,0,0
1165400,True,0,9 user reviews,7,2,9
1165410,True,0,2 user reviews,1,1,2
1165420,True,0,2 user reviews,2,0,2
1165430,True,0,No user reviews,0,0,0
1165450,True,0,No user reviews,0,0,0
1165460,True,0,1 user reviews,0,1,1
1165470,True,0,No user reviews,0,0,0
1165480,True,0,No user reviews,0,0,0
1165490,True,0,No user reviews,0,0,0
1165510,True,7,Positive,19,3,22
1165520,True,0,No user reviews,0,0,0
1165530,True,0,No user reviews,0,0,0
1165540,True,0,No user reviews,0,0,0
1165570,True,0,No user reviews,0,0,0
1165590,True,0,4 user reviews,2,2,4
1165600,True,0,No user reviews,0,0,0
1165610,True,0,1 user reviews,0,1,1
1165620,True,0,No user reviews,0,0,0
1165630,True,0,No user reviews,0,0,0
1165640,True,0,No user reviews,0,0,0
1165650,True,0,No user reviews,0,0,0
1165660,True,0,No user reviews,0,0,0
1165670,True,0,No user reviews,0,0,0
1165710,True,0,No user reviews,0,0,0
1165720,True,0,No user reviews,0,0,0
1165740,True,0,2 user reviews,2,0,2
1165750,True,7,Positive,12,2,14
1165770,True,0,No user reviews,0,0,0
1165800,True,0,No user reviews,0,0,0
1165810,True,0,No user reviews,0,0,0
1165820,True,0,No user reviews,0,0,0
1165830,True,0,No user reviews,0,0,0
1165840,True,6,Mostly Positive,12,4,16
1165850,True,0,No user reviews,0,0,0
1165860,True,6,Mostly Positive,7,3,10
1165870,True,8,Very Positive,84,9,93
1165910,True,0,4 user reviews,3,1,4
1165920,True,0,5 user reviews,3,2,5
1165940,True,0,No user reviews,0,0,0
1165980,True,0,No user reviews,0,0,0
1166000,True,0,4 user reviews,4,0,4
1166020,True,0,No user reviews,0,0,0
1166040,True,0,No user reviews,0,0,0
1166050,True,0,No user reviews,0,0,0
1166070,True,0,No user reviews,0,0,0
1166090,True,0,No user reviews,0,0,0
1166100,True,0,1 user reviews,0,1,1
1166110,True,5,Mixed,9,6,15
1166120,True,0,4 user reviews,4,0,4
1166130,True,0,6 user reviews,6,0,6
1166140,True,0,No user reviews,0,0,0
1166150,True,0,No user reviews,0,0,0
1166170,True,0,No user reviews,0,0,0
1166171,True,0,No user reviews,0,0,0
1166180,True,0,No user reviews,0,0,0
1166181,True,0,No user reviews,0,0,0
1166200,True,0,No user reviews,0,0,0
1166210,True,0,No user reviews,0,0,0
1166230,True,7,Positive,9,1,10
1166240,True,0,2 user reviews,1,1,2
1166250,True,0,No user reviews,0,0,0
1166280,True,0,No user reviews,0,0,0
1166290,True,8,Very Positive,818,79,897
1166300,True,0,No user reviews,0,0,0
1166310,True,0,No user reviews,0,0,0
1166320,True,0,4 user reviews,4,0,4
1166330,True,0,No user reviews,0,0,0
1166350,True,0,1 user reviews,0,1,1
1166390,True,0,No user reviews,0,0,0
1166400,True,0,No user reviews,0,0,0
1166410,True,0,No user reviews,0,0,0
1166420,True,0,1 user reviews,1,0,1
1166430,True,0,No user reviews,0,0,0
1166470,True,7,Positive,16,2,18
1166471,True,6,Mostly Positive,31,9,40
1166472,True,6,Mostly Positive,17,5,22
1166480,True,0,No user reviews,0,0,0
1166490,True,0,4 user reviews,2,2,4
1166500,True,0,No user reviews,0,0,0
1166510,True,0,1 user reviews,0,1,1
1166540,True,0,No user reviews,0,0,0
1166550,True,0,No user reviews,0,0,0
1166560,True,0,No user reviews,0,0,0
1166580,True,7,Positive,12,2,14
1166600,True,7,Positive,27,5,32
1166610,True,0,No user reviews,0,0,0
1166620,True,0,No user reviews,0,0,0
1166660,True,0,No user reviews,0,0,0
1166670,True,0,No user reviews,0,0,0
1166680,True,0,No user reviews,0,0,0
1166710,True,0,No user reviews,0,0,0
1166720,True,0,No user reviews,0,0,0
1166721,True,0,1 user reviews,1,0,1
1166730,True,0,5 user reviews,5,0,5
1166740,True,4,Mostly Negative,4,8,12
1166760,True,0,2 user reviews,0,2,2
1166770,True,0,No user reviews,0,0,0
1166780,True,6,Mostly Positive,8,3,11
1166790,True,0,No user reviews,0,0,0
1166800,True,0,3 user reviews,3,0,3
1166810,True,0,No user reviews,0,0,0
1166820,True,0,No user reviews,0,0,0
1166821,True,0,No user reviews,0,0,0
1166822,True,0,No user reviews,0,0,0
1166823,True,0,No user reviews,0,0,0
1166824,True,0,No user reviews,0,0,0
1166825,True,0,No user reviews,0,0,0
1166826,True,0,No user reviews,0,0,0
1166827,True,0,No user reviews,0,0,0
1166830,True,0,No user reviews,0,0,0
1166840,True,7,Positive,36,1,37
1166850,True,0,No user reviews,0,0,0
1166860,True,8,Very Positive,162,31,193
1166870,True,0,No user reviews,0,0,0
1166871,True,0,No user reviews,0,0,0
1166880,True,0,No user reviews,0,0,0
1166890,True,0,No user reviews,0,0,0
1166900,True,0,No user reviews,0,0,0
1166910,True,0,No user reviews,0,0,0
1166930,True,0,No user reviews,0,0,0
1166940,True,0,No user reviews,0,0,0
1166980,True,0,5 user reviews,4,1,5
1166990,True,0,No user reviews,0,0,0
1167020,True,0,No user reviews,0,0,0
1167030,True,0,No user reviews,0,0,0
1167040,True,0,No user reviews,0,0,0
1167050,True,0,No user reviews,0,0,0
1167090,True,0,1 user reviews,0,1,1
1167100,True,0,No user reviews,0,0,0
1167110,True,0,No user reviews,0,0,0
1167140,True,0,No user reviews,0,0,0
1167160,True,0,No user reviews,0,0,0
1167170,True,0,No user reviews,0,0,0
1167180,True,0,No user reviews,0,0,0
1167190,True,0,No user reviews,0,0,0
1167200,True,0,No user reviews,0,0,0
1167230,True,0,No user reviews,0,0,0
1167231,True,0,No user reviews,0,0,0
1167232,True,0,No user reviews,0,0,0
1167233,True,0,No user reviews,0,0,0
1167240,True,0,No user reviews,0,0,0
1167270,True,0,1 user reviews,0,1,1
1167310,True,0,7 user reviews,0,7,7
1167320,True,8,Very Positive,101,21,122
1167330,True,0,4 user reviews,2,2,4
1167340,True,0,No user reviews,0,0,0
1167350,True,0,No user reviews,0,0,0
1167370,True,0,No user reviews,0,0,0
1167380,True,0,No user reviews,0,0,0
1167420,True,0,No user reviews,0,0,0
1167430,True,0,No user reviews,0,0,0
1167450,True,8,Very Positive,936,114,1050
1167460,True,0,6 user reviews,6,0,6
1167470,True,0,5 user reviews,1,4,5
1167480,True,0,No user reviews,0,0,0
1167490,True,0,No user reviews,0,0,0
1167500,True,0,1 user reviews,1,0,1
1167510,True,0,2 user reviews,2,0,2
1167520,True,0,9 user reviews,9,0,9
1167530,True,0,2 user reviews,2,0,2
1167540,True,0,1 user reviews,1,0,1
1167550,True,0,8 user reviews,7,1,8
1167570,True,0,No user reviews,0,0,0
1167590,True,0,No user reviews,0,0,0
1167610,True,0,No user reviews,0,0,0
1167630,True,9,Overwhelmingly Positive,1069,37,1106
1167640,True,7,Positive,9,2,11
1167650,True,0,No user reviews,0,0,0
1167660,True,7,Positive,12,2,14
1167661,True,0,5 user reviews,4,1,5
1167662,True,0,6 user reviews,4,2,6
1167663,True,6,Mostly Positive,7,3,10
1167670,True,0,No user reviews,0,0,0
1167680,True,0,No user reviews,0,0,0
1167700,True,0,No user reviews,0,0,0
1167710,True,0,1 user reviews,1,0,1
1167720,True,0,No user reviews,0,0,0
1167730,True,0,No user reviews,0,0,0
1167740,True,0,No user reviews,0,0,0
1167760,True,0,6 user reviews,5,1,6
1167770,True,0,3 user reviews,2,1,3
1167790,True,0,No user reviews,0,0,0
1167800,True,0,No user reviews,0,0,0
1167820,True,0,No user reviews,0,0,0
1167840,True,0,No user reviews,0,0,0
1167850,True,0,5 user reviews,5,0,5
1167860,True,0,6 user reviews,6,0,6
1167870,True,7,Positive,13,2,15
1167880,True,0,4 user reviews,4,0,4
1167900,True,0,No user reviews,0,0,0
1167910,True,6,Mostly Positive,99,28,127
1167930,True,0,No user reviews,0,0,0
1167940,True,0,No user reviews,0,0,0
1167950,True,8,Very Positive,120,28,148
1167970,True,0,6 user reviews,5,1,6
1167980,True,0,No user reviews,0,0,0
1168000,True,0,No user reviews,0,0,0
1168030,True,7,Positive,32,6,38
1168050,True,0,1 user reviews,1,0,1
1168060,True,0,4 user reviews,4,0,4
1168070,True,0,4 user reviews,4,0,4
1168080,True,0,No user reviews,0,0,0
1168130,True,0,No user reviews,0,0,0
1168131,True,0,No user reviews,0,0,0
1168160,True,0,No user reviews,0,0,0
1168170,True,5,Mixed,26,18,44
1168180,True,0,No user reviews,0,0,0
1168200,True,0,1 user reviews,0,1,1
1168210,True,0,No user reviews,0,0,0
1168250,True,0,No user reviews,0,0,0
1168260,True,0,No user reviews,0,0,0
1168280,True,0,No user reviews,0,0,0
1168290,True,0,2 user reviews,0,2,2
1168320,True,0,1 user reviews,0,1,1
1168330,True,0,No user reviews,0,0,0
1168360,True,0,2 user reviews,2,0,2
1168380,True,0,6 user reviews,6,0,6
1168420,True,0,3 user reviews,2,1,3
1168430,True,0,No user reviews,0,0,0
1168440,True,0,No user reviews,0,0,0
1168450,True,0,No user reviews,0,0,0
1168460,True,0,No user reviews,0,0,0
1168470,True,0,3 user reviews,3,0,3
1168480,True,0,1 user reviews,1,0,1
1168490,True,0,No user reviews,0,0,0
1168500,True,0,3 user reviews,0,3,3
1168510,True,0,No user reviews,0,0,0
1168511,True,0,No user reviews,0,0,0
1168512,True,0,No user reviews,0,0,0
1168513,True,0,No user reviews,0,0,0
1168514,True,0,No user reviews,0,0,0
1168515,True,0,No user reviews,0,0,0
1168516,True,0,1 user reviews,1,0,1
1168517,True,0,No user reviews,0,0,0
1168518,True,0,No user reviews,0,0,0
1168519,True,0,No user reviews,0,0,0
1168520,True,0,No user reviews,0,0,0
1168521,True,0,No user reviews,0,0,0
1168522,True,0,No user reviews,0,0,0
1168523,True,0,1 user reviews,1,0,1
1168524,True,0,No user reviews,0,0,0
1168525,True,0,No user reviews,0,0,0
1168526,True,0,1 user reviews,0,1,1
1168530,True,0,No user reviews,0,0,0
1168540,True,0,No user reviews,0,0,0
1168550,True,0,No user reviews,0,0,0
1168560,True,0,No user reviews,0,0,0
1168561,True,0,No user reviews,0,0,0
1168562,True,0,No user reviews,0,0,0
1168563,True,0,No user reviews,0,0,0
1168564,True,0,1 user reviews,1,0,1
1168565,True,0,No user reviews,0,0,0
1168566,True,0,1 user reviews,1,0,1
1168567,True,0,No user reviews,0,0,0
1168568,True,0,No user reviews,0,0,0
1168580,True,0,No user reviews,0,0,0
1168600,True,0,1 user reviews,1,0,1
1168610,True,0,No user reviews,0,0,0
1168620,True,0,No user reviews,0,0,0
1168630,True,0,8 user reviews,8,0,8
1168650,True,0,9 user reviews,5,4,9
1168660,True,6,Mostly Positive,35,10,45
1168680,True,7,Positive,11,2,13
1168690,True,0,No user reviews,0,0,0
1168700,True,0,No user reviews,0,0,0
1168710,True,0,No user reviews,0,0,0
1168720,True,0,No user reviews,0,0,0
1168730,True,0,No user reviews,0,0,0
1168740,True,0,No user reviews,0,0,0
1168780,True,0,No user reviews,0,0,0
1168790,True,0,No user reviews,0,0,0
1168800,True,0,No user reviews,0,0,0
1168810,True,0,No user reviews,0,0,0
1168820,True,0,1 user reviews,1,0,1
1168830,True,0,6 user reviews,4,2,6
1168840,True,0,No user reviews,0,0,0
1168850,True,0,No user reviews,0,0,0
1168870,True,6,Mostly Positive,59,20,79
1168880,True,8,Very Positive,226,22,248
1168890,True,0,No user reviews,0,0,0
1168910,True,0,No user reviews,0,0,0
1168930,True,0,No user reviews,0,0,0
1168940,True,0,1 user reviews,0,1,1
1168960,True,0,3 user reviews,3,0,3
1168970,True,0,1 user reviews,1,0,1
1168980,True,0,No user reviews,0,0,0
1168990,True,0,3 user reviews,1,2,3
1169000,True,0,No user reviews,0,0,0
1169010,True,0,No user reviews,0,0,0
1169020,True,8,Very Positive,57,5,62
1169030,True,0,3 user reviews,1,2,3
1169040,True,7,Positive,30,6,36
1169050,True,0,1 user reviews,1,0,1
1169060,True,0,1 user reviews,1,0,1
1169070,True,0,3 user reviews,1,2,3
1169080,True,0,No user reviews,0,0,0
1169090,True,0,No user reviews,0,0,0
1169100,True,8,Very Positive,65,4,69
1169110,True,0,No user reviews,0,0,0
1169120,True,0,No user reviews,0,0,0
1169140,True,0,No user reviews,0,0,0
1169160,True,0,7 user reviews,6,1,7
1169170,True,0,No user reviews,0,0,0
1169180,True,7,Positive,9,1,10
1169182,True,0,5 user reviews,3,2,5
1169200,True,0,No user reviews,0,0,0
1169220,True,0,No user reviews,0,0,0
1169230,True,0,No user reviews,0,0,0
1169310,True,0,2 user reviews,1,1,2
1169320,True,0,3 user reviews,2,1,3
1169330,True,0,No user reviews,0,0,0
1169340,True,0,No user reviews,0,0,0
1169350,True,0,No user reviews,0,0,0
1169370,True,0,No user reviews,0,0,0
1169420,True,0,5 user reviews,4,1,5
1169430,True,0,1 user reviews,1,0,1
1169460,True,0,No user reviews,0,0,0
1169490,True,0,No user reviews,0,0,0
1169500,True,0,No user reviews,0,0,0
1169510,True,0,2 user reviews,1,1,2
1169520,True,0,No user reviews,0,0,0
1169540,True,0,No user reviews,0,0,0
1169550,True,0,No user reviews,0,0,0
1169600,True,0,No user reviews,0,0,0
1169610,True,0,1 user reviews,1,0,1
1169630,True,0,No user reviews,0,0,0
1169640,True,0,No user reviews,0,0,0
1169660,True,0,No user reviews,0,0,0
1169670,True,0,No user reviews,0,0,0
1169680,True,0,No user reviews,0,0,0
1169690,True,0,No user reviews,0,0,0
1169700,True,0,No user reviews,0,0,0
1169720,True,0,1 user reviews,1,0,1
1169721,True,0,1 user reviews,1,0,1
1169722,True,0,No user reviews,0,0,0
1169723,True,0,No user reviews,0,0,0
1169724,True,0,No user reviews,0,0,0
1169725,True,0,No user reviews,0,0,0
1169726,True,0,3 user reviews,2,1,3
1169740,True,7,Positive,15,3,18
1169760,True,0,No user reviews,0,0,0
1169770,True,0,2 user reviews,1,1,2
1169780,True,0,No user reviews,0,0,0
1169790,True,0,No user reviews,0,0,0
1169800,True,0,No user reviews,0,0,0
1169801,True,0,No user reviews,0,0,0
1169810,True,0,1 user reviews,1,0,1
1169811,True,0,4 user reviews,2,2,4
1169870,True,0,No user reviews,0,0,0
1169880,True,0,4 user reviews,4,0,4
1169910,True,0,No user reviews,0,0,0
1169920,True,0,No user reviews,0,0,0
1169930,True,0,1 user reviews,1,0,1
1169931,True,0,No user reviews,0,0,0
1169940,True,0,No user reviews,0,0,0
1169950,True,0,No user reviews,0,0,0
1169951,True,0,No user reviews,0,0,0
1169960,True,0,2 user reviews,1,1,2
1169970,True,0,No user reviews,0,0,0
1169980,True,0,No user reviews,0,0,0
1169990,True,0,2 user reviews,2,0,2
1170010,True,6,Mostly Positive,10,4,14
1170030,True,0,No user reviews,0,0,0
1170050,True,0,7 user reviews,6,1,7
1170060,True,0,No user reviews,0,0,0
1170100,True,0,No user reviews,0,0,0
1170110,True,0,1 user reviews,1,0,1
1170120,True,7,Positive,25,0,25
1170130,True,0,No user reviews,0,0,0
1170160,True,0,1 user reviews,1,0,1
1170170,True,0,1 user reviews,1,0,1
1170180,True,5,Mixed,7,7,14
1170190,True,7,Positive,9,1,10
1170200,True,0,No user reviews,0,0,0
1170210,True,0,6 user reviews,5,1,6
1170230,True,0,No user reviews,0,0,0
1170240,True,0,No user reviews,0,0,0
1170250,True,0,No user reviews,0,0,0
1170270,True,0,No user reviews,0,0,0
1170290,True,0,5 user reviews,2,3,5
1170300,True,0,No user reviews,0,0,0
1170320,True,7,Positive,12,1,13
1170330,True,0,6 user reviews,5,1,6
1170340,True,7,Positive,10,0,10
1170370,True,0,No user reviews,0,0,0
1170390,True,0,No user reviews,0,0,0
1170400,True,0,1 user reviews,0,1,1
1170410,True,0,No user reviews,0,0,0
1170420,True,0,No user reviews,0,0,0
1170430,True,0,No user reviews,0,0,0
1170440,True,0,No user reviews,0,0,0
1170450,True,0,No user reviews,0,0,0
1170451,True,0,No user reviews,0,0,0
1170452,True,0,No user reviews,0,0,0
1170453,True,0,No user reviews,0,0,0
1170454,True,0,No user reviews,0,0,0
1170455,True,0,No user reviews,0,0,0
1170456,True,0,No user reviews,0,0,0
1170457,True,0,No user reviews,0,0,0
1170458,True,0,No user reviews,0,0,0
1170459,True,0,No user reviews,0,0,0
1170460,True,0,No user reviews,0,0,0
1170461,True,0,No user reviews,0,0,0
1170462,True,0,No user reviews,0,0,0
1170463,True,0,No user reviews,0,0,0
1170470,True,0,No user reviews,0,0,0
1170480,True,0,No user reviews,0,0,0
1170490,True,0,No user reviews,0,0,0
1170491,True,0,No user reviews,0,0,0
1170492,True,0,No user reviews,0,0,0
1170500,True,0,No user reviews,0,0,0
1170520,True,0,No user reviews,0,0,0
1170521,True,0,No user reviews,0,0,0
1170522,True,0,1 user reviews,1,0,1
1170523,True,0,No user reviews,0,0,0
1170524,True,0,No user reviews,0,0,0
1170525,True,0,No user reviews,0,0,0
1170526,True,0,1 user reviews,1,0,1
1170530,True,0,No user reviews,0,0,0
1170531,True,0,No user reviews,0,0,0
1170532,True,0,No user reviews,0,0,0
1170540,True,0,No user reviews,0,0,0
1170541,True,0,No user reviews,0,0,0
1170542,True,0,No user reviews,0,0,0
1170543,True,0,No user reviews,0,0,0
1170544,True,0,No user reviews,0,0,0
1170545,True,0,No user reviews,0,0,0
1170546,True,0,No user reviews,0,0,0
1170547,True,0,No user reviews,0,0,0
1170548,True,0,No user reviews,0,0,0
1170549,True,0,No user reviews,0,0,0
1170570,True,0,No user reviews,0,0,0
1170580,True,0,No user reviews,0,0,0
1170610,True,5,Mixed,9,4,13
1170620,True,0,No user reviews,0,0,0
1170630,True,0,3 user reviews,0,3,3
1170640,True,0,No user reviews,0,0,0
1170660,True,0,No user reviews,0,0,0
1170670,True,0,No user reviews,0,0,0
1170680,True,0,No user reviews,0,0,0
1170690,True,0,No user reviews,0,0,0
1170710,True,0,5 user reviews,5,0,5
1170711,True,0,No user reviews,0,0,0
1170712,True,0,1 user reviews,0,1,1
1170713,True,0,No user reviews,0,0,0
1170714,True,0,No user reviews,0,0,0
1170715,True,0,No user reviews,0,0,0
1170720,True,7,Positive,13,0,13
1170730,True,0,1 user reviews,1,0,1
1170731,True,0,No user reviews,0,0,0
1170732,True,0,No user reviews,0,0,0
1170733,True,0,No user reviews,0,0,0
1170750,True,0,3 user reviews,3,0,3
1170760,True,8,Very Positive,105,9,114
1170784,True,0,No user reviews,0,0,0
1170785,True,0,No user reviews,0,0,0
1170786,True,0,No user reviews,0,0,0
1170787,True,0,No user reviews,0,0,0
1170789,True,0,No user reviews,0,0,0
1170803,True,0,3 user reviews,0,3,3
1170807,True,0,4 user reviews,3,1,4
1170814,True,5,Mixed,6,7,13
1170820,True,0,No user reviews,0,0,0
1170830,True,0,1 user reviews,0,1,1
1170840,True,0,2 user reviews,2,0,2
1170870,True,0,No user reviews,0,0,0
1170880,True,0,No user reviews,0,0,0
1170890,True,0,No user reviews,0,0,0
1170910,True,0,No user reviews,0,0,0
1170920,True,0,No user reviews,0,0,0
1170950,True,0,No user reviews,0,0,0
1170960,True,0,8 user reviews,8,0,8
1170970,True,0,No user reviews,0,0,0
1170980,True,0,7 user reviews,5,2,7
1171000,True,0,No user reviews,0,0,0
1171020,True,0,No user reviews,0,0,0
1171030,True,0,1 user reviews,1,0,1
1171040,True,0,No user reviews,0,0,0
1171070,True,0,4 user reviews,3,1,4
1171080,True,0,1 user reviews,1,0,1
1171110,True,0,No user reviews,0,0,0
1171120,True,7,Positive,15,1,16
1171130,True,7,Positive,14,0,14
1171140,True,0,No user reviews,0,0,0
1171160,True,0,5 user reviews,5,0,5
1171170,True,0,No user reviews,0,0,0
1171180,True,0,No user reviews,0,0,0
1171190,True,6,Mostly Positive,14,4,18
1171200,True,0,No user reviews,0,0,0
1171201,True,0,No user reviews,0,0,0
1171202,True,0,No user reviews,0,0,0
1171220,True,0,No user reviews,0,0,0
1171230,True,0,No user reviews,0,0,0
1171240,True,6,Mostly Positive,55,14,69
1171250,True,0,No user reviews,0,0,0
1171260,True,6,Mostly Positive,8,3,11
1171270,True,7,Positive,40,4,44
1171310,True,5,Mixed,36,18,54
1171330,True,0,No user reviews,0,0,0
1171340,True,0,No user reviews,0,0,0
1171370,True,0,6 user reviews,6,0,6
1171380,True,0,3 user reviews,2,1,3
1171410,True,0,No user reviews,0,0,0
1171420,True,0,4 user reviews,4,0,4
1171430,True,0,1 user reviews,0,1,1
1171440,True,0,9 user reviews,9,0,9
1171460,True,0,1 user reviews,1,0,1
1171470,True,0,2 user reviews,2,0,2
1171500,True,0,No user reviews,0,0,0
1171520,True,0,No user reviews,0,0,0
1171540,True,0,No user reviews,0,0,0
1171560,True,0,4 user reviews,4,0,4
1171570,True,0,1 user reviews,1,0,1
1171590,True,0,No user reviews,0,0,0
1171591,True,0,No user reviews,0,0,0
1171600,True,0,No user reviews,0,0,0
1171610,True,0,No user reviews,0,0,0
1171620,True,0,1 user reviews,1,0,1
1171640,True,0,5 user reviews,2,3,5
1171660,True,7,Positive,16,0,16
1171680,True,0,No user reviews,0,0,0
1171700,True,0,No user reviews,0,0,0
1171710,True,0,No user reviews,0,0,0
1171750,True,0,No user reviews,0,0,0
1171770,True,0,1 user reviews,1,0,1
1171780,True,0,No user reviews,0,0,0
1171790,True,0,No user reviews,0,0,0
1171800,True,0,No user reviews,0,0,0
1171810,True,0,1 user reviews,0,1,1
1171820,True,7,Positive,24,3,27
1171830,True,0,No user reviews,0,0,0
1171840,True,7,Positive,14,2,16
1171850,True,0,No user reviews,0,0,0
1171870,True,0,No user reviews,0,0,0
1171880,True,0,1 user reviews,1,0,1
1171890,True,5,Mixed,6,6,12
1171950,True,0,1 user reviews,0,1,1
1171970,True,0,No user reviews,0,0,0
1171980,True,0,No user reviews,0,0,0
1171990,True,0,No user reviews,0,0,0
1172000,True,0,1 user reviews,0,1,1
1172040,True,0,No user reviews,0,0,0
1172050,True,6,Mostly Positive,75,22,97
1172060,True,6,Mostly Positive,12,4,16
1172080,True,0,1 user reviews,0,1,1
1172090,True,0,No user reviews,0,0,0
1172110,True,0,7 user reviews,7,0,7
1172130,True,0,6 user reviews,6,0,6
1172140,True,0,No user reviews,0,0,0
1172150,True,0,4 user reviews,4,0,4
1172160,True,0,No user reviews,0,0,0
1172170,True,7,Positive,19,2,21
1172190,True,0,No user reviews,0,0,0
1172200,True,0,No user reviews,0,0,0
1172210,True,0,No user reviews,0,0,0
1172220,True,0,1 user reviews,1,0,1
1172270,True,0,1 user reviews,1,0,1
1172280,True,0,No user reviews,0,0,0
1172290,True,0,1 user reviews,1,0,1
1172310,True,0,No user reviews,0,0,0
1172320,True,0,No user reviews,0,0,0
1172330,True,0,No user reviews,0,0,0
1172340,True,0,1 user reviews,0,1,1
1172350,True,0,No user reviews,0,0,0
1172370,True,0,No user reviews,0,0,0
1172380,True,8,Very Positive,31538,2969,34507
1172390,True,5,Mixed,8,4,12
1172400,True,0,No user reviews,0,0,0
1172410,True,0,7 user reviews,7,0,7
1172420,True,0,3 user reviews,3,0,3
1172430,True,5,Mixed,22,16,38
1172450,True,7,Positive,13,0,13
1172460,True,0,No user reviews,0,0,0
1172470,True,0,No user reviews,0,0,0
1172480,True,0,2 user reviews,2,0,2
1172490,True,0,4 user reviews,4,0,4
1172500,True,7,Positive,14,0,14
1172510,True,8,Very Positive,71,1,72
1172520,True,7,Positive,36,1,37
1172530,True,7,Positive,21,2,23
1172540,True,0,8 user reviews,5,3,8
1172550,True,0,2 user reviews,1,1,2
1172551,True,0,No user reviews,0,0,0
1172552,True,0,No user reviews,0,0,0
1172553,True,0,No user reviews,0,0,0
1172600,True,0,No user reviews,0,0,0
1172610,True,0,2 user reviews,2,0,2
1172620,True,8,Very Positive,12045,1226,13271
1172640,True,0,1 user reviews,1,0,1
1172650,True,0,No user reviews,0,0,0
1172660,True,0,2 user reviews,1,1,2
1172670,True,0,No user reviews,0,0,0
1172680,True,0,No user reviews,0,0,0
1172700,True,0,1 user reviews,1,0,1
1172720,True,0,1 user reviews,1,0,1
1172730,True,0,No user reviews,0,0,0
1172740,True,0,No user reviews,0,0,0
1172760,True,0,1 user reviews,0,1,1
1172790,True,0,No user reviews,0,0,0
1172810,True,0,No user reviews,0,0,0
1172820,True,0,No user reviews,0,0,0
1172830,True,0,No user reviews,0,0,0
1172850,True,0,No user reviews,0,0,0
1172860,True,7,Positive,17,3,20
1172870,True,0,No user reviews,0,0,0
1172890,True,0,2 user reviews,2,0,2
1172900,True,0,No user reviews,0,0,0
1172920,True,0,No user reviews,0,0,0
1172930,True,0,No user reviews,0,0,0
1172940,True,6,Mostly Positive,199,54,253
1172950,True,0,No user reviews,0,0,0
1172970,True,0,No user reviews,0,0,0
1172980,True,0,No user reviews,0,0,0
1173010,True,0,No user reviews,0,0,0
1173030,True,0,4 user reviews,4,0,4
1173031,True,0,1 user reviews,1,0,1
1173050,True,0,5 user reviews,5,0,5
1173070,True,0,No user reviews,0,0,0
1173080,True,0,No user reviews,0,0,0
1173100,True,0,No user reviews,0,0,0
1173110,True,0,No user reviews,0,0,0
1173120,True,0,6 user reviews,6,0,6
1173130,True,0,No user reviews,0,0,0
1173140,True,7,Positive,23,3,26
1173150,True,0,6 user reviews,4,2,6
1173160,True,0,No user reviews,0,0,0
1173170,True,0,No user reviews,0,0,0
1173200,True,8,Very Positive,60,3,63
1173210,True,0,3 user reviews,3,0,3
1173230,True,0,9 user reviews,7,2,9
1173240,True,0,1 user reviews,0,1,1
1173250,True,0,3 user reviews,3,0,3
1173260,True,0,1 user reviews,0,1,1
1173270,True,5,Mixed,5,7,12
1173280,True,0,No user reviews,0,0,0
1173290,True,0,No user reviews,0,0,0
1173300,True,0,No user reviews,0,0,0
1173310,True,7,Positive,9,1,10
1173330,True,0,No user reviews,0,0,0
1173340,True,0,4 user reviews,0,4,4
1173350,True,5,Mixed,20,9,29
1173360,True,0,No user reviews,0,0,0
1173370,True,0,No user reviews,0,0,0
1173380,True,8,Very Positive,128,13,141
1173400,True,0,No user reviews,0,0,0
1173410,True,5,Mixed,57,30,87
1173420,True,0,No user reviews,0,0,0
1173500,True,0,3 user reviews,1,2,3
1173510,True,8,Very Positive,49,9,58
1173520,True,0,No user reviews,0,0,0
1173540,True,0,No user reviews,0,0,0
1173550,True,0,No user reviews,0,0,0
1173560,True,0,No user reviews,0,0,0
1173570,True,0,No user reviews,0,0,0
1173580,True,0,No user reviews,0,0,0
1173590,True,0,No user reviews,0,0,0
1173610,True,0,1 user reviews,1,0,1
1173630,True,0,No user reviews,0,0,0
1173640,True,0,No user reviews,0,0,0
1173650,True,0,1 user reviews,0,1,1
1173670,True,0,No user reviews,0,0,0
1173740,True,7,Positive,10,1,11
1173750,True,0,No user reviews,0,0,0
1173751,True,0,1 user reviews,0,1,1
1173752,True,0,No user reviews,0,0,0
1173760,True,0,1 user reviews,1,0,1
1173830,True,7,Positive,30,1,31
1173850,True,0,3 user reviews,3,0,3
1173860,True,0,2 user reviews,2,0,2
1173870,True,7,Positive,10,1,11
1173880,True,0,No user reviews,0,0,0
1173890,True,0,No user reviews,0,0,0
1173900,True,6,Mostly Positive,17,5,22
1173910,True,0,No user reviews,0,0,0
1173920,True,0,No user reviews,0,0,0
1173930,True,0,No user reviews,0,0,0
1173940,True,7,Positive,11,0,11
1173950,True,0,No user reviews,0,0,0
1173960,True,0,No user reviews,0,0,0
1173980,True,0,No user reviews,0,0,0
1173990,True,0,No user reviews,0,0,0
1174000,True,0,No user reviews,0,0,0
1174050,True,0,No user reviews,0,0,0
1174080,True,0,No user reviews,0,0,0
1174090,True,7,Positive,9,2,11
1174100,True,0,No user reviews,0,0,0
1174120,True,0,2 user reviews,2,0,2
1174160,True,0,No user reviews,0,0,0
1174170,True,0,3 user reviews,3,0,3
1174180,True,8,Very Positive,28609,6495,35104
1174200,True,0,No user reviews,0,0,0
1174230,True,0,No user reviews,0,0,0
1174260,True,0,2 user reviews,1,1,2
1174270,True,0,No user reviews,0,0,0
1174280,True,0,No user reviews,0,0,0
1174290,True,0,4 user reviews,1,3,4
1174300,True,0,No user reviews,0,0,0
1174310,True,0,No user reviews,0,0,0
1174311,True,0,No user reviews,0,0,0
1174312,True,0,No user reviews,0,0,0
1174313,True,0,No user reviews,0,0,0
1174320,True,0,5 user reviews,5,0,5
1174360,True,0,1 user reviews,1,0,1
1174370,True,8,Very Positive,289,19,308
1174390,True,7,Positive,34,5,39
1174400,True,7,Positive,45,2,47
1174410,True,0,5 user reviews,5,0,5
1174420,True,0,5 user reviews,3,2,5
1174430,True,0,1 user reviews,1,0,1
1174440,True,0,2 user reviews,2,0,2
1174450,True,0,No user reviews,0,0,0
1174460,True,0,No user reviews,0,0,0
1174470,True,5,Mixed,10,5,15
1174490,True,0,No user reviews,0,0,0
1174500,True,0,6 user reviews,5,1,6
1174550,True,5,Mixed,8,6,14
1174560,True,0,No user reviews,0,0,0
1174570,True,0,No user reviews,0,0,0
1174580,True,0,9 user reviews,9,0,9
1174581,True,0,2 user reviews,2,0,2
1174620,True,0,1 user reviews,1,0,1
1174630,True,0,5 user reviews,5,0,5
1174631,True,0,6 user reviews,4,2,6
1174632,True,0,2 user reviews,2,0,2
1174640,True,0,No user reviews,0,0,0
1174670,True,7,Positive,14,0,14
1174680,True,0,No user reviews,0,0,0
1174690,True,8,Very Positive,53,6,59
1174720,True,5,Mixed,59,37,96
1174730,True,0,4 user reviews,4,0,4
1174780,True,0,4 user reviews,4,0,4
1174810,True,0,No user reviews,0,0,0
1174820,True,0,No user reviews,0,0,0
1174830,True,0,7 user reviews,5,2,7
1174840,True,0,No user reviews,0,0,0
1174850,True,0,No user reviews,0,0,0
1174860,True,0,7 user reviews,6,1,7
1174870,True,0,No user reviews,0,0,0
1174880,True,0,No user reviews,0,0,0
1174890,True,0,1 user reviews,0,1,1
1174900,True,0,2 user reviews,1,1,2
1174920,True,0,No user reviews,0,0,0
1174930,True,0,No user reviews,0,0,0
1174940,True,0,No user reviews,0,0,0
1174960,True,0,No user reviews,0,0,0
1174970,True,0,No user reviews,0,0,0
1174980,True,0,2 user reviews,2,0,2
1174990,True,0,1 user reviews,1,0,1
1175010,True,0,No user reviews,0,0,0
1175020,True,0,No user reviews,0,0,0
1175030,True,0,No user reviews,0,0,0
1175040,True,0,No user reviews,0,0,0
1175050,True,0,No user reviews,0,0,0
1175060,True,7,Positive,12,2,14
1175070,True,0,2 user reviews,2,0,2
1175080,True,0,No user reviews,0,0,0
1175090,True,7,Positive,35,0,35
1175100,True,0,No user reviews,0,0,0
1175110,True,0,No user reviews,0,0,0
1175120,True,0,No user reviews,0,0,0
1175130,True,0,1 user reviews,1,0,1
1175140,True,0,2 user reviews,2,0,2
1175150,True,0,No user reviews,0,0,0
1175160,True,0,2 user reviews,2,0,2
1175170,True,0,1 user reviews,1,0,1
1175180,True,0,No user reviews,0,0,0
1175190,True,0,No user reviews,0,0,0
1175200,True,6,Mostly Positive,39,15,54
1175220,True,0,No user reviews,0,0,0
1175221,True,0,No user reviews,0,0,0
1175222,True,0,1 user reviews,1,0,1
1175223,True,0,No user reviews,0,0,0
1175240,True,0,No user reviews,0,0,0
1175250,True,0,4 user reviews,4,0,4
1175270,True,0,No user reviews,0,0,0
1175310,True,0,No user reviews,0,0,0
1175320,True,0,No user reviews,0,0,0
1175330,True,0,No user reviews,0,0,0
1175350,True,0,No user reviews,0,0,0
1175360,True,8,Very Positive,121,8,129
1175370,True,0,No user reviews,0,0,0
1175390,True,4,Mostly Negative,12,21,33
1175400,True,0,No user reviews,0,0,0
1175410,True,0,No user reviews,0,0,0
1175420,True,0,8 user reviews,7,1,8
1175430,True,7,Positive,22,0,22
1175440,True,0,No user reviews,0,0,0
1175450,True,0,No user reviews,0,0,0
1175460,True,0,No user reviews,0,0,0
1175470,True,0,3 user reviews,1,2,3
1175480,True,5,Mixed,8,4,12
1175500,True,0,1 user reviews,0,1,1
1175510,True,0,2 user reviews,1,1,2
1175530,True,0,No user reviews,0,0,0
1175540,True,0,No user reviews,0,0,0
1175550,True,0,1 user reviews,0,1,1
1175560,True,0,No user reviews,0,0,0
1175570,True,0,No user reviews,0,0,0
1175581,True,0,2 user reviews,2,0,2
1175590,True,0,4 user reviews,3,1,4
1175600,True,0,No user reviews,0,0,0
1175640,True,7,Positive,12,3,15
1175650,True,0,1 user reviews,1,0,1
1175660,True,0,No user reviews,0,0,0
1175680,True,0,No user reviews,0,0,0
1175690,True,0,No user reviews,0,0,0
1175720,True,0,No user reviews,0,0,0
1175730,True,0,No user reviews,0,0,0
1175770,True,0,No user reviews,0,0,0
1175800,True,0,No user reviews,0,0,0
1175820,True,0,No user reviews,0,0,0
1175840,True,0,No user reviews,0,0,0
1175870,True,0,No user reviews,0,0,0
1175880,True,0,No user reviews,0,0,0
1175890,True,0,No user reviews,0,0,0
1175900,True,0,3 user reviews,1,2,3
1175930,True,0,5 user reviews,4,1,5
1175950,True,5,Mixed,5,6,11
1175960,True,0,No user reviews,0,0,0
1175970,True,0,No user reviews,0,0,0
1175980,True,0,1 user reviews,1,0,1
1175990,True,0,No user reviews,0,0,0
1176000,True,0,No user reviews,0,0,0
1176020,True,7,Positive,33,6,39
1176040,True,0,2 user reviews,1,1,2
1176050,True,0,2 user reviews,2,0,2
1176060,True,0,No user reviews,0,0,0
1176080,True,0,No user reviews,0,0,0
1176090,True,0,No user reviews,0,0,0
1176110,True,6,Mostly Positive,14,4,18
1176130,True,0,6 user reviews,3,3,6
1176140,True,0,No user reviews,0,0,0
1176150,True,0,No user reviews,0,0,0
1176151,True,0,No user reviews,0,0,0
1176152,True,0,No user reviews,0,0,0
1176154,True,0,No user reviews,0,0,0
1176156,True,0,No user reviews,0,0,0
1176157,True,0,No user reviews,0,0,0
1176158,True,0,No user reviews,0,0,0
1176159,True,0,No user reviews,0,0,0
1176160,True,0,5 user reviews,4,1,5
1176170,True,6,Mostly Positive,13,5,18
1176181,True,0,No user reviews,0,0,0
1176182,True,0,No user reviews,0,0,0
1176183,True,0,No user reviews,0,0,0
1176184,True,0,No user reviews,0,0,0
1176190,True,0,9 user reviews,4,5,9
1176330,True,0,No user reviews,0,0,0
1176350,True,0,No user reviews,0,0,0
1176360,True,0,3 user reviews,0,3,3
1176370,True,0,No user reviews,0,0,0
1176371,True,0,No user reviews,0,0,0
1176372,True,0,No user reviews,0,0,0
1176373,True,0,1 user reviews,1,0,1
1176378,True,0,1 user reviews,1,0,1
1176379,True,0,No user reviews,0,0,0
1176440,True,0,1 user reviews,1,0,1
1176450,True,0,No user reviews,0,0,0
1176460,True,7,Positive,12,2,14
1176470,True,0,No user reviews,0,0,0
1176480,True,0,2 user reviews,1,1,2
1176490,True,0,No user reviews,0,0,0
1176510,True,0,No user reviews,0,0,0
1176550,True,0,No user reviews,0,0,0
1176560,True,0,8 user reviews,1,7,8
1176570,True,0,No user reviews,0,0,0
1176580,True,5,Mixed,6,5,11
1176590,True,0,1 user reviews,1,0,1
1176610,True,0,1 user reviews,0,1,1
1176611,True,0,1 user reviews,0,1,1
1176612,True,0,No user reviews,0,0,0
1176613,True,0,1 user reviews,0,1,1
1176614,True,0,3 user reviews,3,0,3
1176615,True,0,No user reviews,0,0,0
1176616,True,0,2 user reviews,2,0,2
1176617,True,0,No user reviews,0,0,0
1176618,True,0,1 user reviews,1,0,1
1176619,True,0,No user reviews,0,0,0
1176620,True,0,No user reviews,0,0,0
1176621,True,0,No user reviews,0,0,0
1176622,True,0,No user reviews,0,0,0
1176623,True,0,No user reviews,0,0,0
1176640,True,0,No user reviews,0,0,0
1176660,True,0,2 user reviews,2,0,2
1176670,True,0,No user reviews,0,0,0
1176680,True,0,No user reviews,0,0,0
1176681,True,0,1 user reviews,1,0,1
1176682,True,0,No user reviews,0,0,0
1176700,True,0,7 user reviews,7,0,7
1176710,True,6,Mostly Positive,280,79,359
1176720,True,0,No user reviews,0,0,0
1176740,True,0,7 user reviews,2,5,7
1176750,True,0,1 user reviews,1,0,1
1176760,True,0,1 user reviews,1,0,1
1176780,True,0,No user reviews,0,0,0
1176800,True,0,No user reviews,0,0,0
1176820,True,0,No user reviews,0,0,0
1176830,True,0,No user reviews,0,0,0
1176840,True,0,No user reviews,0,0,0
1176850,True,0,2 user reviews,2,0,2
1176860,True,0,No user reviews,0,0,0
1176870,True,7,Positive,16,0,16
1176890,True,0,No user reviews,0,0,0
1176900,True,0,No user reviews,0,0,0
1176918,True,0,No user reviews,0,0,0
1176920,True,0,3 user reviews,3,0,3
1176923,True,0,1 user reviews,1,0,1
1176970,True,0,3 user reviews,2,1,3
1176980,True,0,No user reviews,0,0,0
1176990,True,0,6 user reviews,6,0,6
1177000,True,0,3 user reviews,2,1,3
1177010,True,0,No user reviews,0,0,0
1177020,True,0,1 user reviews,1,0,1
1177030,True,0,9 user reviews,7,2,9
1177050,True,0,6 user reviews,5,1,6
1177060,True,0,1 user reviews,0,1,1
1177070,True,0,No user reviews,0,0,0
1177080,True,0,1 user reviews,1,0,1
1177090,True,0,No user reviews,0,0,0
1177100,True,0,No user reviews,0,0,0
1177110,True,7,Positive,10,2,12
1177120,True,0,No user reviews,0,0,0
1177130,True,8,Very Positive,66,2,68
1177170,True,0,1 user reviews,1,0,1
1177190,True,0,No user reviews,0,0,0
1177200,True,0,No user reviews,0,0,0
1177210,True,0,No user reviews,0,0,0
1177230,True,0,No user reviews,0,0,0
1177250,True,0,No user reviews,0,0,0
1177270,True,0,No user reviews,0,0,0
1177300,True,0,No user reviews,0,0,0
1177310,True,0,No user reviews,0,0,0
1177320,True,0,No user reviews,0,0,0
1177330,True,0,No user reviews,0,0,0
1177340,True,0,No user reviews,0,0,0
1177350,True,0,1 user reviews,0,1,1
1177360,True,0,No user reviews,0,0,0
1177370,True,0,No user reviews,0,0,0
1177380,True,0,No user reviews,0,0,0
1177390,True,0,No user reviews,0,0,0
1177400,True,0,No user reviews,0,0,0
1177410,True,0,No user reviews,0,0,0
1177420,True,8,Very Positive,136,5,141
1177430,True,0,No user reviews,0,0,0
1177440,True,0,No user reviews,0,0,0
1177460,True,0,1 user reviews,1,0,1
1177480,True,0,No user reviews,0,0,0
1177490,True,0,No user reviews,0,0,0
1177510,True,0,1 user reviews,1,0,1
1177520,True,0,No user reviews,0,0,0
1177530,True,0,No user reviews,0,0,0
1177550,True,0,No user reviews,0,0,0
1177560,True,0,No user reviews,0,0,0
1177580,True,0,No user reviews,0,0,0
1177610,True,7,Positive,15,3,18
1177640,True,0,8 user reviews,8,0,8
1177650,True,0,No user reviews,0,0,0
1177660,True,6,Mostly Positive,41,11,52
1177690,True,7,Positive,24,5,29
1177720,True,0,8 user reviews,7,1,8
1177730,True,0,No user reviews,0,0,0
1177760,True,0,No user reviews,0,0,0
1177761,True,0,No user reviews,0,0,0
1177762,True,0,No user reviews,0,0,0
1177763,True,0,No user reviews,0,0,0
1177764,True,0,No user reviews,0,0,0
1177765,True,0,No user reviews,0,0,0
1177770,True,0,No user reviews,0,0,0
1177771,True,0,No user reviews,0,0,0
1177772,True,0,No user reviews,0,0,0
1177773,True,0,No user reviews,0,0,0
1177774,True,0,No user reviews,0,0,0
1177775,True,0,No user reviews,0,0,0
1177776,True,0,1 user reviews,1,0,1
1177777,True,0,1 user reviews,1,0,1
1177780,True,0,No user reviews,0,0,0
1177781,True,0,No user reviews,0,0,0
1177782,True,0,No user reviews,0,0,0
1177783,True,0,No user reviews,0,0,0
1177784,True,0,No user reviews,0,0,0
1177785,True,0,No user reviews,0,0,0
1177786,True,0,No user reviews,0,0,0
1177787,True,0,No user reviews,0,0,0
1177800,True,0,No user reviews,0,0,0
1177801,True,0,No user reviews,0,0,0
1177802,True,0,No user reviews,0,0,0
1177803,True,0,No user reviews,0,0,0
1177804,True,0,No user reviews,0,0,0
1177805,True,0,No user reviews,0,0,0
1177806,True,0,No user reviews,0,0,0
1177807,True,0,No user reviews,0,0,0
1177810,True,0,2 user reviews,1,1,2
1177820,True,0,1 user reviews,1,0,1
1177830,True,0,2 user reviews,2,0,2
1177850,True,0,1 user reviews,1,0,1
1177880,True,7,Positive,43,1,44
1177890,True,6,Mostly Positive,12,4,16
1177900,True,0,No user reviews,0,0,0
1177910,True,0,No user reviews,0,0,0
1177940,True,0,No user reviews,0,0,0
1177950,True,0,1 user reviews,0,1,1
1177960,True,0,No user reviews,0,0,0
1177980,True,0,No user reviews,0,0,0
1177990,True,0,9 user reviews,7,2,9
1178000,True,0,8 user reviews,8,0,8
1178010,True,0,No user reviews,0,0,0
1178020,True,0,2 user reviews,0,2,2
1178030,True,0,No user reviews,0,0,0
1178050,True,0,No user reviews,0,0,0
1178060,True,0,1 user reviews,0,1,1
1178070,True,0,No user reviews,0,0,0
1178080,True,0,No user reviews,0,0,0
1178120,True,7,Positive,22,5,27
1178140,True,8,Very Positive,52,1,53
1178150,True,0,6 user reviews,6,0,6
1178160,True,0,No user reviews,0,0,0
1178180,True,0,2 user reviews,1,1,2
1178200,True,6,Mostly Positive,12,4,16
1178210,True,0,5 user reviews,5,0,5
1178220,True,0,No user reviews,0,0,0
1178230,True,0,No user reviews,0,0,0
1178250,True,0,No user reviews,0,0,0
1178260,True,0,No user reviews,0,0,0
1178280,True,4,Mostly Negative,4,16,20
1178290,True,7,Positive,11,0,11
1178300,True,0,No user reviews,0,0,0
1178310,True,0,3 user reviews,1,2,3
1178320,True,0,1 user reviews,1,0,1
1178321,True,0,6 user reviews,6,0,6
1178330,True,0,2 user reviews,2,0,2
1178350,True,0,No user reviews,0,0,0
1178370,True,0,No user reviews,0,0,0
1178380,True,0,2 user reviews,1,1,2
1178390,True,0,No user reviews,0,0,0
1178400,True,6,Mostly Positive,44,16,60
1178410,True,0,No user reviews,0,0,0
1178420,True,0,No user reviews,0,0,0
1178430,True,0,No user reviews,0,0,0
1178460,True,7,Positive,33,5,38
1178480,True,0,No user reviews,0,0,0
1178490,True,8,Very Positive,98,24,122
1178500,True,0,3 user reviews,2,1,3
1178510,True,0,No user reviews,0,0,0
1178570,True,0,1 user reviews,0,1,1
1178600,True,0,No user reviews,0,0,0
1178610,True,5,Mixed,8,8,16
1178620,True,0,No user reviews,0,0,0
1178630,True,0,1 user reviews,1,0,1
1178640,True,0,6 user reviews,3,3,6
1178660,True,0,1 user reviews,1,0,1
1178670,True,0,4 user reviews,3,1,4
1178680,True,0,9 user reviews,9,0,9
1178690,True,0,No user reviews,0,0,0
1178710,True,0,3 user reviews,0,3,3
1178730,True,0,No user reviews,0,0,0
1178770,True,0,No user reviews,0,0,0
1178780,True,8,Very Positive,143,6,149
1178790,True,0,No user reviews,0,0,0
1178800,True,0,No user reviews,0,0,0
1178810,True,0,No user reviews,0,0,0
1178830,True,0,No user reviews,0,0,0
1178870,True,0,3 user reviews,1,2,3
1178871,True,0,1 user reviews,0,1,1
1178872,True,0,No user reviews,0,0,0
1178873,True,0,2 user reviews,0,2,2
1178874,True,0,No user reviews,0,0,0
1178875,True,0,No user reviews,0,0,0
1178876,True,0,No user reviews,0,0,0
1178877,True,0,No user reviews,0,0,0
1178878,True,0,No user reviews,0,0,0
1178879,True,0,1 user reviews,0,1,1
1178880,True,8,Very Positive,70,9,79
1178890,True,0,No user reviews,0,0,0
1178910,True,0,No user reviews,0,0,0
1178920,True,0,1 user reviews,0,1,1
1178921,True,0,No user reviews,0,0,0
1178922,True,0,No user reviews,0,0,0
1178930,True,0,No user reviews,0,0,0
1178931,True,0,No user reviews,0,0,0
1178932,True,0,No user reviews,0,0,0
1178933,True,0,No user reviews,0,0,0
1178934,True,0,No user reviews,0,0,0
1178935,True,0,No user reviews,0,0,0
1178936,True,0,No user reviews,0,0,0
1178940,True,0,No user reviews,0,0,0
1178950,True,0,1 user reviews,1,0,1
1178960,True,0,No user reviews,0,0,0
1178970,True,0,No user reviews,0,0,0
1178980,True,0,No user reviews,0,0,0
1178990,True,0,No user reviews,0,0,0
1179010,True,0,No user reviews,0,0,0
1179020,True,0,No user reviews,0,0,0
1179060,True,0,No user reviews,0,0,0
1179080,True,0,No user reviews,0,0,0
1179090,True,0,No user reviews,0,0,0
1179100,True,0,No user reviews,0,0,0
1179110,True,0,No user reviews,0,0,0
1179130,True,0,No user reviews,0,0,0
1179140,True,0,No user reviews,0,0,0
1179141,True,0,No user reviews,0,0,0
1179142,True,0,No user reviews,0,0,0
1179150,True,0,No user reviews,0,0,0
1179170,True,0,1 user reviews,1,0,1
1179190,True,0,1 user reviews,1,0,1
1179200,True,0,No user reviews,0,0,0
1179210,True,8,Very Positive,268,9,277
1179220,True,0,7 user reviews,6,1,7
1179230,True,0,No user reviews,0,0,0
1179260,True,0,No user reviews,0,0,0
1179280,True,0,No user reviews,0,0,0
1179290,True,7,Positive,38,1,39
1179300,True,0,2 user reviews,2,0,2
1179310,True,0,No user reviews,0,0,0
1179340,True,0,1 user reviews,1,0,1
1179350,True,0,No user reviews,0,0,0
1179360,True,0,No user reviews,0,0,0
1179380,True,0,No user reviews,0,0,0
1179390,True,0,1 user reviews,0,1,1
1179400,True,0,No user reviews,0,0,0
1179410,True,0,8 user reviews,5,3,8
1179420,True,0,1 user reviews,0,1,1
1179430,True,0,No user reviews,0,0,0
1179440,True,0,1 user reviews,1,0,1
1179450,True,7,Positive,9,1,10
1179451,True,0,2 user reviews,2,0,2
1179452,True,0,2 user reviews,2,0,2
1179453,True,0,2 user reviews,2,0,2
1179454,True,0,1 user reviews,1,0,1
1179455,True,0,No user reviews,0,0,0
1179456,True,0,No user reviews,0,0,0
1179457,True,0,1 user reviews,1,0,1
1179458,True,0,No user reviews,0,0,0
1179460,True,0,9 user reviews,9,0,9
1179470,True,0,No user reviews,0,0,0
1179490,True,0,No user reviews,0,0,0
1179491,True,0,No user reviews,0,0,0
1179492,True,0,1 user reviews,1,0,1
1179493,True,0,1 user reviews,1,0,1
1179494,True,0,No user reviews,0,0,0
1179500,True,0,3 user reviews,3,0,3
1179510,True,0,No user reviews,0,0,0
1179520,True,0,No user reviews,0,0,0
1179530,True,0,No user reviews,0,0,0
1179540,True,0,4 user reviews,4,0,4
1179550,True,0,No user reviews,0,0,0
1179560,True,7,Positive,19,3,22
1179570,True,0,3 user reviews,3,0,3
1179580,True,0,No user reviews,0,0,0
1179590,True,0,No user reviews,0,0,0
1179620,True,0,3 user reviews,3,0,3
1179630,True,0,No user reviews,0,0,0
1179631,True,0,No user reviews,0,0,0
1179632,True,0,No user reviews,0,0,0
1179633,True,0,No user reviews,0,0,0
1179634,True,0,No user reviews,0,0,0
1179635,True,0,1 user reviews,1,0,1
1179636,True,0,No user reviews,0,0,0
1179637,True,0,No user reviews,0,0,0
1179638,True,0,No user reviews,0,0,0
1179639,True,0,No user reviews,0,0,0
1179650,True,0,No user reviews,0,0,0
1179651,True,0,No user reviews,0,0,0
1179652,True,0,No user reviews,0,0,0
1179653,True,0,1 user reviews,1,0,1
1179654,True,0,No user reviews,0,0,0
1179655,True,0,No user reviews,0,0,0
1179656,True,0,1 user reviews,1,0,1
1179660,True,0,No user reviews,0,0,0
1179680,True,0,No user reviews,0,0,0
1179690,True,0,No user reviews,0,0,0
1179710,True,5,Mixed,43,35,78
1179720,True,4,Mostly Negative,16,31,47
1179750,True,0,No user reviews,0,0,0
1179760,True,0,No user reviews,0,0,0
1179780,True,0,No user reviews,0,0,0
1179790,True,0,No user reviews,0,0,0
1179800,True,0,No user reviews,0,0,0
1179830,True,7,Positive,18,0,18
1179840,True,0,2 user reviews,0,2,2
1179880,True,0,1 user reviews,1,0,1
1179890,True,0,No user reviews,0,0,0
1179900,True,0,No user reviews,0,0,0
1179910,True,0,No user reviews,0,0,0
1179920,True,0,No user reviews,0,0,0
1179930,True,0,5 user reviews,4,1,5
1179950,True,0,4 user reviews,2,2,4
1179960,True,0,No user reviews,0,0,0
1180000,True,0,1 user reviews,1,0,1
1180010,True,7,Positive,13,1,14
1180020,True,0,No user reviews,0,0,0
1180030,True,0,No user reviews,0,0,0
1180050,True,0,No user reviews,0,0,0
1180070,True,0,1 user reviews,1,0,1
1180110,True,0,No user reviews,0,0,0
1180120,True,8,Very Positive,51,1,52
1180130,True,0,No user reviews,0,0,0
1180140,True,0,No user reviews,0,0,0
1180150,True,0,No user reviews,0,0,0
1180160,True,0,No user reviews,0,0,0
1180170,True,0,No user reviews,0,0,0
1180180,True,0,No user reviews,0,0,0
1180190,True,0,2 user reviews,2,0,2
1180210,True,0,No user reviews,0,0,0
1180230,True,0,No user reviews,0,0,0
1180240,True,0,No user reviews,0,0,0
1180250,True,7,Positive,30,3,33
1180260,True,0,No user reviews,0,0,0
1180270,True,6,Mostly Positive,11,3,14
1180310,True,0,No user reviews,0,0,0
1180330,True,6,Mostly Positive,25,7,32
1180350,True,0,No user reviews,0,0,0
1180360,True,0,No user reviews,0,0,0
1180370,True,0,3 user reviews,2,1,3
1180380,True,0,No user reviews,0,0,0
1180390,True,0,No user reviews,0,0,0
1180410,True,0,No user reviews,0,0,0
1180420,True,0,3 user reviews,2,1,3
1180450,True,0,3 user reviews,2,1,3
1180460,True,0,No user reviews,0,0,0
1180490,True,7,Positive,18,0,18
1180491,True,7,Positive,18,1,19
1180510,True,7,Positive,12,0,12
1180520,True,0,No user reviews,0,0,0
1180530,True,0,No user reviews,0,0,0
1180540,True,7,Positive,40,0,40
1180550,True,0,1 user reviews,0,1,1
1180560,True,0,2 user reviews,2,0,2
1180570,True,0,1 user reviews,1,0,1
1180590,True,0,No user reviews,0,0,0
1180600,True,0,No user reviews,0,0,0
1180610,True,0,9 user reviews,9,0,9
1180620,True,0,6 user reviews,4,2,6
1180630,True,0,No user reviews,0,0,0
1180640,True,0,No user reviews,0,0,0
1180650,True,0,2 user reviews,1,1,2
1180660,True,8,Very Positive,481,48,529
1180670,True,0,No user reviews,0,0,0
1180690,True,0,1 user reviews,1,0,1
1180700,True,0,2 user reviews,2,0,2
1180730,True,0,2 user reviews,1,1,2
1180750,True,0,No user reviews,0,0,0
1180760,True,0,No user reviews,0,0,0
1180770,True,0,No user reviews,0,0,0
1180780,True,0,No user reviews,0,0,0
1180790,True,0,No user reviews,0,0,0
1180800,True,0,No user reviews,0,0,0
1180820,True,0,1 user reviews,0,1,1
1180840,True,0,No user reviews,0,0,0
1180890,True,0,No user reviews,0,0,0
1180900,True,7,Positive,15,0,15
1180910,True,0,2 user reviews,0,2,2
1180940,True,0,3 user reviews,2,1,3
1180950,True,0,2 user reviews,1,1,2
1180960,True,0,No user reviews,0,0,0
1180970,True,0,6 user reviews,5,1,6
1180980,True,0,No user reviews,0,0,0
1181000,True,8,Very Positive,51,1,52
1181010,True,0,No user reviews,0,0,0
1181020,True,0,1 user reviews,0,1,1
1181030,True,7,Positive,13,2,15
1181040,True,0,No user reviews,0,0,0
1181050,True,0,No user reviews,0,0,0
1181070,True,0,No user reviews,0,0,0
1181120,True,0,6 user reviews,4,2,6
1181130,True,5,Mixed,7,4,11
1181140,True,6,Mostly Positive,72,21,93
1181150,True,0,No user reviews,0,0,0
1181160,True,0,No user reviews,0,0,0
1181170,True,0,1 user reviews,0,1,1
1181220,True,0,3 user reviews,3,0,3
1181230,True,0,No user reviews,0,0,0
1181250,True,0,No user reviews,0,0,0
1181260,True,0,No user reviews,0,0,0
1181270,True,0,7 user reviews,4,3,7
1181280,True,0,3 user reviews,1,2,3
1181290,True,0,2 user reviews,1,1,2
1181320,True,0,No user reviews,0,0,0
1181330,True,0,5 user reviews,4,1,5
1181350,True,0,No user reviews,0,0,0
1181360,True,0,No user reviews,0,0,0
1181390,True,0,No user reviews,0,0,0
1181400,True,7,Positive,39,0,39
1181430,True,0,No user reviews,0,0,0
1181440,True,7,Positive,31,7,38
1181470,True,0,3 user reviews,2,1,3
1181490,True,0,No user reviews,0,0,0
1181500,True,0,No user reviews,0,0,0
1181510,True,0,1 user reviews,1,0,1
1181520,True,7,Positive,9,2,11
1181530,True,0,5 user reviews,4,1,5
1181540,True,0,No user reviews,0,0,0
1181541,True,0,No user reviews,0,0,0
1181542,True,0,No user reviews,0,0,0
1181550,True,0,No user reviews,0,0,0
1181570,True,7,Positive,32,1,33
1181600,True,0,5 user reviews,5,0,5
1181630,True,0,2 user reviews,2,0,2
1181640,True,0,No user reviews,0,0,0
1181650,True,0,No user reviews,0,0,0
1181680,True,0,No user reviews,0,0,0
1181700,True,0,No user reviews,0,0,0
1181720,True,0,No user reviews,0,0,0
1181740,True,0,No user reviews,0,0,0
1181750,True,0,1 user reviews,1,0,1
1181760,True,0,No user reviews,0,0,0
1181770,True,0,4 user reviews,4,0,4
1181771,True,7,Positive,9,1,10
1181772,True,0,2 user reviews,2,0,2
1181773,True,0,1 user reviews,1,0,1
1181774,True,0,2 user reviews,2,0,2
1181775,True,0,No user reviews,0,0,0
1181790,True,0,2 user reviews,2,0,2
1181800,True,0,No user reviews,0,0,0
1181820,True,0,1 user reviews,0,1,1
1181830,True,8,Very Positive,363,21,384
1181840,True,0,No user reviews,0,0,0
1181860,True,0,No user reviews,0,0,0
1181870,True,0,No user reviews,0,0,0
1181880,True,0,1 user reviews,1,0,1
1181890,True,0,No user reviews,0,0,0
1181900,True,0,No user reviews,0,0,0
1181910,True,0,5 user reviews,5,0,5
1181930,True,0,No user reviews,0,0,0
1181940,True,0,No user reviews,0,0,0
1181950,True,0,No user reviews,0,0,0
1181970,True,0,No user reviews,0,0,0
1181990,True,5,Mixed,8,4,12
1182000,True,7,Positive,15,3,18
1182020,True,0,3 user reviews,3,0,3
1182040,True,0,No user reviews,0,0,0
1182050,True,0,No user reviews,0,0,0
1182060,True,5,Mixed,11,7,18
1182070,True,0,No user reviews,0,0,0
1182080,True,0,No user reviews,0,0,0
1182090,True,0,8 user reviews,8,0,8
1182100,True,0,No user reviews,0,0,0
1182110,True,0,No user reviews,0,0,0
1182120,True,0,No user reviews,0,0,0
1182150,True,0,No user reviews,0,0,0
1182160,True,0,No user reviews,0,0,0
1182180,True,0,No user reviews,0,0,0
1182190,True,0,6 user reviews,4,2,6
1182200,True,0,6 user reviews,5,1,6
1182210,True,0,No user reviews,0,0,0
1182220,True,0,No user reviews,0,0,0
1182230,True,0,No user reviews,0,0,0
1182260,True,0,No user reviews,0,0,0
1182270,True,0,No user reviews,0,0,0
1182280,True,0,No user reviews,0,0,0
1182290,True,0,No user reviews,0,0,0
1182291,True,0,2 user reviews,2,0,2
1182292,True,0,1 user reviews,1,0,1
1182293,True,0,1 user reviews,1,0,1
1182294,True,0,1 user reviews,1,0,1
1182300,True,0,1 user reviews,1,0,1
1182301,True,0,1 user reviews,1,0,1
1182302,True,0,No user reviews,0,0,0
1182303,True,0,1 user reviews,1,0,1
1182304,True,0,1 user reviews,1,0,1
1182305,True,0,1 user reviews,1,0,1
1182306,True,0,1 user reviews,1,0,1
1182307,True,0,No user reviews,0,0,0
1182308,True,0,1 user reviews,1,0,1
1182309,True,0,No user reviews,0,0,0
1182310,True,0,No user reviews,0,0,0
1182320,True,0,No user reviews,0,0,0
1182330,True,0,1 user reviews,0,1,1
1182340,True,0,2 user reviews,2,0,2
1182360,True,0,1 user reviews,0,1,1
1182370,True,0,No user reviews,0,0,0
1182380,True,0,No user reviews,0,0,0
1182390,True,0,1 user reviews,0,1,1
1182400,True,0,No user reviews,0,0,0
1182410,True,0,No user reviews,0,0,0
1182420,True,0,No user reviews,0,0,0
1182450,True,0,No user reviews,0,0,0
1182470,True,7,Positive,9,1,10
1182510,True,0,No user reviews,0,0,0
1182520,True,0,No user reviews,0,0,0
1182540,True,0,No user reviews,0,0,0
1182550,True,0,No user reviews,0,0,0
1182560,True,0,No user reviews,0,0,0
1182590,True,0,No user reviews,0,0,0
1182620,True,0,No user reviews,0,0,0
1182640,True,0,No user reviews,0,0,0
1182670,True,0,4 user reviews,3,1,4
1182690,True,0,1 user reviews,0,1,1
1182720,True,0,2 user reviews,2,0,2
1182730,True,0,No user reviews,0,0,0
1182760,True,5,Mixed,8,8,16
1182770,True,0,2 user reviews,2,0,2
1182790,True,0,No user reviews,0,0,0
1182820,True,0,No user reviews,0,0,0
1182830,True,8,Very Positive,49,3,52
1182840,True,0,No user reviews,0,0,0
1182870,True,0,No user reviews,0,0,0
1182880,True,0,No user reviews,0,0,0
1182890,True,0,1 user reviews,1,0,1
1182920,True,8,Very Positive,86,6,92
1182930,True,5,Mixed,10,5,15
1182940,True,6,Mostly Positive,12,5,17
1182950,True,0,No user reviews,0,0,0
1182970,True,5,Mixed,7,10,17
1183010,True,0,No user reviews,0,0,0
1183030,True,5,Mixed,44,20,64
1183050,True,0,9 user reviews,6,3,9
1183051,True,0,4 user reviews,2,2,4
1183052,True,0,3 user reviews,3,0,3
1183080,True,0,8 user reviews,6,2,8
1183100,True,0,5 user reviews,5,0,5
1183101,True,0,4 user reviews,4,0,4
1183102,True,0,3 user reviews,3,0,3
1183110,True,0,No user reviews,0,0,0
1183140,True,0,4 user reviews,4,0,4
1183170,True,0,8 user reviews,7,1,8
1183180,True,0,No user reviews,0,0,0
1183190,True,0,No user reviews,0,0,0
1183200,True,0,1 user reviews,1,0,1
1183210,True,0,2 user reviews,2,0,2
1183220,True,0,No user reviews,0,0,0
1183230,True,0,4 user reviews,4,0,4
1183240,True,0,6 user reviews,5,1,6
1183250,True,0,No user reviews,0,0,0
1183260,True,0,5 user reviews,5,0,5
1183270,True,0,No user reviews,0,0,0
1183280,True,0,3 user reviews,2,1,3
1183290,True,0,No user reviews,0,0,0
1183300,True,0,5 user reviews,3,2,5
1183310,True,0,No user reviews,0,0,0
1183320,True,0,No user reviews,0,0,0
1183340,True,0,No user reviews,0,0,0
1183350,True,0,No user reviews,0,0,0
1183370,True,0,No user reviews,0,0,0
1183410,True,0,1 user reviews,1,0,1
1183420,True,0,No user reviews,0,0,0
1183440,True,0,No user reviews,0,0,0
1183460,True,0,No user reviews,0,0,0
1183470,True,7,Positive,37,6,43
1183480,True,0,3 user reviews,3,0,3
1183500,True,7,Positive,22,2,24
1183510,True,0,6 user reviews,2,4,6
1183520,True,0,No user reviews,0,0,0
1183530,True,0,No user reviews,0,0,0
1183540,True,0,5 user reviews,4,1,5
1183560,True,0,No user reviews,0,0,0
1183580,True,0,2 user reviews,2,0,2
1183590,True,7,Positive,11,1,12
1183600,True,0,No user reviews,0,0,0
1183610,True,0,No user reviews,0,0,0
1183620,True,0,No user reviews,0,0,0
1183621,True,0,No user reviews,0,0,0
1183630,True,0,No user reviews,0,0,0
1183650,True,0,No user reviews,0,0,0
1183670,True,0,5 user reviews,4,1,5
1183720,True,7,Positive,30,7,37
1183730,True,0,No user reviews,0,0,0
1183740,True,0,No user reviews,0,0,0
1183750,True,0,No user reviews,0,0,0
1183800,True,0,No user reviews,0,0,0
1183820,True,0,No user reviews,0,0,0
1183840,True,0,4 user reviews,4,0,4
1183860,True,0,No user reviews,0,0,0
1183960,True,0,No user reviews,0,0,0
1183970,True,8,Very Positive,1465,109,1574
1183980,True,0,No user reviews,0,0,0
1183990,True,0,No user reviews,0,0,0
1184010,True,0,No user reviews,0,0,0
1184040,True,0,6 user reviews,5,1,6
1184050,True,8,Very Positive,1157,266,1423
1184070,True,0,1 user reviews,0,1,1
1184080,True,0,No user reviews,0,0,0
1184090,True,0,7 user reviews,4,3,7
1184100,True,0,1 user reviews,1,0,1
1184101,True,0,1 user reviews,1,0,1
1184110,True,0,No user reviews,0,0,0
1184130,True,0,No user reviews,0,0,0
1184140,True,0,No user reviews,0,0,0
1184160,True,0,No user reviews,0,0,0
1184190,True,0,No user reviews,0,0,0
1184200,True,0,No user reviews,0,0,0
1184210,True,0,No user reviews,0,0,0
1184230,True,0,3 user reviews,1,2,3
1184240,True,0,3 user reviews,2,1,3
1184250,True,0,No user reviews,0,0,0
1184260,True,0,No user reviews,0,0,0
1184270,True,0,No user reviews,0,0,0
1184290,True,0,3 user reviews,3,0,3
1184310,True,0,1 user reviews,1,0,1
1184320,True,0,No user reviews,0,0,0
1184330,True,0,No user reviews,0,0,0
1184350,True,7,Positive,13,0,13
1184351,True,0,No user reviews,0,0,0
1184360,True,0,No user reviews,0,0,0
1184380,True,0,No user reviews,0,0,0
1184400,True,5,Mixed,9,8,17
1184410,True,8,Very Positive,137,11,148
1184411,True,5,Mixed,140,98,238
1184412,True,5,Mixed,44,44,88
1184420,True,0,2 user reviews,2,0,2
1184450,True,7,Positive,13,0,13
1184460,True,0,No user reviews,0,0,0
1184470,True,0,1 user reviews,1,0,1
1184480,True,8,Very Positive,178,10,188
1184520,True,0,No user reviews,0,0,0
1184530,True,0,No user reviews,0,0,0
1184550,True,6,Mostly Positive,9,3,12
1184560,True,0,No user reviews,0,0,0
1184570,True,0,4 user reviews,2,2,4
1184580,True,0,No user reviews,0,0,0
1184590,True,0,No user reviews,0,0,0
1184600,True,0,No user reviews,0,0,0
1184630,True,0,No user reviews,0,0,0
1184640,True,0,No user reviews,0,0,0
1184650,True,0,No user reviews,0,0,0
1184651,True,0,No user reviews,0,0,0
1184660,True,0,No user reviews,0,0,0
1184661,True,0,No user reviews,0,0,0
1184680,True,0,No user reviews,0,0,0
1184690,True,0,No user reviews,0,0,0
1184700,True,0,1 user reviews,1,0,1
1184710,True,0,No user reviews,0,0,0
1184720,True,0,No user reviews,0,0,0
1184750,True,0,No user reviews,0,0,0
1184770,True,9,Overwhelmingly Positive,695,27,722
1184780,True,0,2 user reviews,2,0,2
1184790,True,0,No user reviews,0,0,0
1184810,True,8,Very Positive,55,1,56
1184820,True,0,No user reviews,0,0,0
1184830,True,0,No user reviews,0,0,0
1184840,True,7,Positive,41,2,43
1184870,True,0,No user reviews,0,0,0
1184880,True,0,3 user reviews,2,1,3
1184890,True,0,No user reviews,0,0,0
1184900,True,7,Positive,17,0,17
1184910,True,0,No user reviews,0,0,0
1184920,True,0,No user reviews,0,0,0
1184960,True,0,9 user reviews,9,0,9
1184980,True,0,1 user reviews,0,1,1
1184990,True,7,Positive,45,4,49
1185000,True,0,3 user reviews,2,1,3
1185030,True,0,No user reviews,0,0,0
1185040,True,0,No user reviews,0,0,0
1185050,True,0,No user reviews,0,0,0
1185070,True,0,No user reviews,0,0,0
1185130,True,0,No user reviews,0,0,0
1185160,True,8,Very Positive,52,12,64
1185190,True,0,No user reviews,0,0,0
1185200,True,0,No user reviews,0,0,0
1185210,True,0,No user reviews,0,0,0
1185230,True,0,No user reviews,0,0,0
1185260,True,0,No user reviews,0,0,0
1185270,True,0,1 user reviews,0,1,1
1185280,True,0,3 user reviews,3,0,3
1185290,True,0,No user reviews,0,0,0
1185310,True,0,No user reviews,0,0,0
1185330,True,0,6 user reviews,4,2,6
1185340,True,0,No user reviews,0,0,0
1185360,True,0,No user reviews,0,0,0
1185370,True,0,No user reviews,0,0,0
1185390,True,0,1 user reviews,1,0,1
1185400,True,0,No user reviews,0,0,0
1185410,True,0,No user reviews,0,0,0
1185440,True,0,3 user reviews,3,0,3
1185470,True,0,7 user reviews,7,0,7
1185480,True,0,3 user reviews,3,0,3
1185490,True,0,No user reviews,0,0,0
1185500,True,0,No user reviews,0,0,0
1185520,True,8,Very Positive,82,18,100
1185530,True,0,No user reviews,0,0,0
1185550,True,0,No user reviews,0,0,0
1185560,True,5,Mixed,327,160,487
1185570,True,0,No user reviews,0,0,0
1185580,True,0,No user reviews,0,0,0
1185600,True,0,1 user reviews,0,1,1
1185620,True,0,No user reviews,0,0,0
1185630,True,0,2 user reviews,2,0,2
1185640,True,0,No user reviews,0,0,0
1185650,True,0,No user reviews,0,0,0
1185660,True,0,4 user reviews,3,1,4
1185680,True,0,6 user reviews,1,5,6
1185690,True,0,No user reviews,0,0,0
1185700,True,7,Positive,14,2,16
1185710,True,0,No user reviews,0,0,0
1185720,True,0,No user reviews,0,0,0
1185730,True,0,5 user reviews,5,0,5
1185740,True,0,5 user reviews,4,1,5
1185760,True,0,1 user reviews,0,1,1
1185771,True,0,No user reviews,0,0,0
1185780,True,0,No user reviews,0,0,0
1185790,True,0,No user reviews,0,0,0
1185810,True,0,No user reviews,0,0,0
1185820,True,7,Positive,36,2,38
1185850,True,0,No user reviews,0,0,0
1185870,True,7,Positive,8,2,10
1185890,True,0,No user reviews,0,0,0
1185910,True,0,6 user reviews,5,1,6
1185920,True,0,No user reviews,0,0,0
1185930,True,0,No user reviews,0,0,0
1185950,True,0,4 user reviews,3,1,4
1185960,True,0,2 user reviews,1,1,2
1185970,True,0,No user reviews,0,0,0
1185980,True,0,No user reviews,0,0,0
1185990,True,0,1 user reviews,0,1,1
1186000,True,0,No user reviews,0,0,0
1186010,True,0,1 user reviews,0,1,1
1186030,True,0,5 user reviews,4,1,5
1186040,True,0,No user reviews,0,0,0
1186050,True,0,No user reviews,0,0,0
1186060,True,0,No user reviews,0,0,0
1186080,True,0,No user reviews,0,0,0
1186100,True,0,5 user reviews,4,1,5
1186120,True,0,No user reviews,0,0,0
1186130,True,0,No user reviews,0,0,0
1186140,True,0,No user reviews,0,0,0
1186160,True,7,Positive,14,2,16
1186170,True,0,No user reviews,0,0,0
1186200,True,0,No user reviews,0,0,0
1186220,True,7,Positive,16,1,17
1186260,True,5,Mixed,7,7,14
1186270,True,0,1 user reviews,1,0,1
1186280,True,0,2 user reviews,2,0,2
1186290,True,0,8 user reviews,2,6,8
1186300,True,0,No user reviews,0,0,0
1186310,True,0,1 user reviews,1,0,1
1186320,True,0,No user reviews,0,0,0
1186340,True,0,4 user reviews,4,0,4
1186350,True,0,2 user reviews,2,0,2
1186390,True,0,No user reviews,0,0,0
1186400,True,6,Mostly Positive,69,19,88
1186410,True,0,No user reviews,0,0,0
1186420,True,0,No user reviews,0,0,0
1186430,True,0,No user reviews,0,0,0
1186460,True,0,4 user reviews,4,0,4
1186510,True,0,2 user reviews,1,1,2
1186520,True,0,No user reviews,0,0,0
1186530,True,0,3 user reviews,2,1,3
1186540,True,0,No user reviews,0,0,0
1186560,True,5,Mixed,11,6,17
1186561,True,5,Mixed,8,5,13
1186570,True,0,2 user reviews,2,0,2
1186580,True,0,9 user reviews,8,1,9
1186590,True,0,No user reviews,0,0,0
1186600,True,5,Mixed,4,6,10
1186610,True,0,No user reviews,0,0,0
1186620,True,0,No user reviews,0,0,0
1186630,True,0,3 user reviews,1,2,3
1186640,True,8,Very Positive,392,17,409
1186650,True,0,2 user reviews,0,2,2
1186670,True,0,No user reviews,0,0,0
1186680,True,0,No user reviews,0,0,0
1186690,True,0,1 user reviews,1,0,1
1186720,True,0,1 user reviews,1,0,1
1186730,True,0,No user reviews,0,0,0
1186740,True,0,1 user reviews,1,0,1
1186750,True,0,No user reviews,0,0,0
1186760,True,0,No user reviews,0,0,0
1186770,True,0,1 user reviews,0,1,1
1186860,True,0,No user reviews,0,0,0
1186870,True,0,2 user reviews,2,0,2
1186871,True,0,1 user reviews,1,0,1
1186872,True,0,2 user reviews,2,0,2
1186873,True,0,1 user reviews,1,0,1
1186874,True,0,3 user reviews,3,0,3
1186875,True,0,1 user reviews,1,0,1
1186876,True,0,2 user reviews,2,0,2
1186877,True,0,4 user reviews,4,0,4
1186880,True,7,Positive,24,4,28
1186940,True,0,1 user reviews,0,1,1
1186960,True,0,No user reviews,0,0,0
1186970,True,0,No user reviews,0,0,0
1186980,True,0,No user reviews,0,0,0
1187020,True,0,No user reviews,0,0,0
1187030,True,0,1 user reviews,0,1,1
1187040,True,0,No user reviews,0,0,0
1187050,True,0,No user reviews,0,0,0
1187060,True,0,No user reviews,0,0,0
1187100,True,0,No user reviews,0,0,0
1187110,True,0,2 user reviews,1,1,2
1187130,True,0,No user reviews,0,0,0
1187150,True,0,No user reviews,0,0,0
1187151,True,0,No user reviews,0,0,0
1187152,True,0,No user reviews,0,0,0
1187153,True,0,1 user reviews,1,0,1
1187154,True,0,No user reviews,0,0,0
1187155,True,0,No user reviews,0,0,0
1187160,True,0,No user reviews,0,0,0
1187170,True,0,3 user reviews,3,0,3
1187190,True,0,2 user reviews,2,0,2
1187210,True,0,No user reviews,0,0,0
1187230,True,0,1 user reviews,1,0,1
1187240,True,0,2 user reviews,2,0,2
1187250,True,0,No user reviews,0,0,0
1187260,True,0,No user reviews,0,0,0
1187300,True,0,No user reviews,0,0,0
1187301,True,0,No user reviews,0,0,0
1187302,True,0,No user reviews,0,0,0
1187303,True,0,No user reviews,0,0,0
1187304,True,0,No user reviews,0,0,0
1187305,True,0,No user reviews,0,0,0
1187306,True,0,No user reviews,0,0,0
1187307,True,0,No user reviews,0,0,0
1187308,True,0,No user reviews,0,0,0
1187309,True,0,No user reviews,0,0,0
1187310,True,0,No user reviews,0,0,0
1187311,True,0,No user reviews,0,0,0
1187312,True,0,No user reviews,0,0,0
1187313,True,0,No user reviews,0,0,0
1187314,True,0,No user reviews,0,0,0
1187315,True,0,No user reviews,0,0,0
1187316,True,0,No user reviews,0,0,0
1187317,True,0,No user reviews,0,0,0
1187318,True,0,No user reviews,0,0,0
1187319,True,0,No user reviews,0,0,0
1187320,True,0,No user reviews,0,0,0
1187321,True,0,No user reviews,0,0,0
1187322,True,0,No user reviews,0,0,0
1187323,True,0,No user reviews,0,0,0
1187324,True,0,No user reviews,0,0,0
1187325,True,0,No user reviews,0,0,0
1187326,True,0,No user reviews,0,0,0
1187327,True,0,No user reviews,0,0,0
1187328,True,0,No user reviews,0,0,0
1187330,True,8,Very Positive,77,14,91
1187360,True,0,No user reviews,0,0,0
1187370,True,0,No user reviews,0,0,0
1187410,True,0,No user reviews,0,0,0
1187420,True,0,7 user reviews,3,4,7
1187430,True,0,No user reviews,0,0,0
1187450,True,0,No user reviews,0,0,0
1187490,True,0,4 user reviews,3,1,4
1187500,True,0,No user reviews,0,0,0
1187510,True,8,Very Positive,86,5,91
1187520,True,0,No user reviews,0,0,0
1187530,True,0,No user reviews,0,0,0
1187540,True,0,No user reviews,0,0,0
1187541,True,0,No user reviews,0,0,0
1187550,True,0,No user reviews,0,0,0
1187560,True,0,No user reviews,0,0,0
1187600,True,7,Positive,14,2,16
1187620,True,0,6 user reviews,3,3,6
1187630,True,0,3 user reviews,2,1,3
1187631,True,0,5 user reviews,4,1,5
1187640,True,0,No user reviews,0,0,0
1187650,True,0,4 user reviews,3,1,4
1187670,True,0,No user reviews,0,0,0
1187680,True,0,1 user reviews,1,0,1
1187700,True,0,No user reviews,0,0,0
1187740,True,0,3 user reviews,1,2,3
1187750,True,0,No user reviews,0,0,0
1187760,True,0,No user reviews,0,0,0
1187780,True,0,No user reviews,0,0,0
1187790,True,0,5 user reviews,3,2,5
1187810,True,0,No user reviews,0,0,0
1187820,True,0,No user reviews,0,0,0
1187821,True,0,No user reviews,0,0,0
1187830,True,0,1 user reviews,1,0,1
1187840,True,0,No user reviews,0,0,0
1187850,True,0,No user reviews,0,0,0
1187870,True,0,No user reviews,0,0,0
1187880,True,0,No user reviews,0,0,0
1187881,True,0,No user reviews,0,0,0
1187900,True,0,1 user reviews,1,0,1
1187910,True,0,No user reviews,0,0,0
1187920,True,0,No user reviews,0,0,0
1187940,True,5,Mixed,24,28,52
1187950,True,0,1 user reviews,1,0,1
1187990,True,0,No user reviews,0,0,0
1188000,True,7,Positive,15,0,15
1188020,True,0,No user reviews,0,0,0
1188040,True,0,2 user reviews,2,0,2
1188060,True,0,2 user reviews,1,1,2
1188070,True,0,No user reviews,0,0,0
1188080,True,7,Positive,40,3,43
1188090,True,0,2 user reviews,1,1,2
1188100,True,0,No user reviews,0,0,0
1188110,True,0,No user reviews,0,0,0
1188120,True,0,1 user reviews,1,0,1
1188140,True,0,5 user reviews,4,1,5
1188210,True,0,No user reviews,0,0,0
1188230,True,0,No user reviews,0,0,0
1188250,True,7,Positive,39,5,44
1188260,True,5,Mixed,29,16,45
1188280,True,0,1 user reviews,1,0,1
1188290,True,0,No user reviews,0,0,0
1188310,True,0,5 user reviews,5,0,5
1188320,True,0,No user reviews,0,0,0
1188330,True,8,Very Positive,151,8,159
1188360,True,0,No user reviews,0,0,0
1188400,True,0,No user reviews,0,0,0
1188420,True,0,No user reviews,0,0,0
1188430,True,0,5 user reviews,2,3,5
1188460,True,0,No user reviews,0,0,0
1188490,True,0,No user reviews,0,0,0
1188500,True,0,No user reviews,0,0,0
1188520,True,0,No user reviews,0,0,0
1188530,True,0,No user reviews,0,0,0
1188540,True,7,Positive,22,4,26
1188570,True,0,No user reviews,0,0,0
1188580,True,0,2 user reviews,2,0,2
1188590,True,0,No user reviews,0,0,0
1188600,True,0,6 user reviews,4,2,6
1188601,True,0,No user reviews,0,0,0
1188602,True,0,No user reviews,0,0,0
1188603,True,0,No user reviews,0,0,0
1188604,True,0,No user reviews,0,0,0
1188605,True,0,No user reviews,0,0,0
1188606,True,0,No user reviews,0,0,0
1188607,True,0,No user reviews,0,0,0
1188608,True,0,1 user reviews,1,0,1
1188609,True,0,2 user reviews,0,2,2
1188610,True,0,2 user reviews,2,0,2
1188611,True,0,2 user reviews,2,0,2
1188612,True,0,No user reviews,0,0,0
1188613,True,0,No user reviews,0,0,0
1188614,True,0,No user reviews,0,0,0
1188615,True,0,4 user reviews,4,0,4
1188616,True,0,1 user reviews,0,1,1
1188617,True,0,2 user reviews,0,2,2
1188618,True,0,2 user reviews,1,1,2
1188619,True,0,2 user reviews,2,0,2
1188620,True,0,1 user reviews,1,0,1
1188630,True,0,No user reviews,0,0,0
1188640,True,0,No user reviews,0,0,0
1188660,True,0,3 user reviews,3,0,3
1188670,True,0,1 user reviews,1,0,1
1188680,True,6,Mostly Positive,190,67,257
1188690,True,0,No user reviews,0,0,0
1188710,True,0,No user reviews,0,0,0
1188720,True,0,No user reviews,0,0,0
1188730,True,0,No user reviews,0,0,0
1188760,True,7,Positive,17,2,19
1188770,True,0,No user reviews,0,0,0
1188780,True,0,No user reviews,0,0,0
1188800,True,0,2 user reviews,2,0,2
1188810,True,0,No user reviews,0,0,0
1188830,True,0,No user reviews,0,0,0
1188840,True,0,No user reviews,0,0,0
1188850,True,0,No user reviews,0,0,0
1188860,True,0,No user reviews,0,0,0
1188870,True,0,No user reviews,0,0,0
1188900,True,0,No user reviews,0,0,0
1188910,True,0,No user reviews,0,0,0
1188920,True,0,No user reviews,0,0,0
1188930,True,8,Very Positive,128,8,136
1188940,True,0,No user reviews,0,0,0
1188950,True,0,No user reviews,0,0,0
1188970,True,8,Very Positive,79,17,96
1188990,True,0,6 user reviews,5,1,6
1189000,True,0,No user reviews,0,0,0
1189020,True,0,2 user reviews,0,2,2
1189030,True,0,No user reviews,0,0,0
1189040,True,0,1 user reviews,0,1,1
1189050,True,5,Mixed,7,6,13
1189060,True,0,No user reviews,0,0,0
1189080,True,0,4 user reviews,2,2,4
1189090,True,0,No user reviews,0,0,0
1189110,True,0,No user reviews,0,0,0
1189120,True,0,1 user reviews,0,1,1
1189150,True,0,No user reviews,0,0,0
1189160,True,0,No user reviews,0,0,0
1189200,True,0,1 user reviews,1,0,1
1189210,True,0,No user reviews,0,0,0
1189220,True,0,No user reviews,0,0,0
1189230,True,6,Mostly Positive,98,33,131
1189250,True,0,No user reviews,0,0,0
1189260,True,0,No user reviews,0,0,0
1189261,True,0,No user reviews,0,0,0
1189290,True,0,No user reviews,0,0,0
1189300,True,0,No user reviews,0,0,0
1189310,True,0,No user reviews,0,0,0
1189350,True,0,No user reviews,0,0,0
1189360,True,0,5 user reviews,5,0,5
1189380,True,0,No user reviews,0,0,0
1189390,True,0,No user reviews,0,0,0
1189400,True,0,No user reviews,0,0,0
1189430,True,0,No user reviews,0,0,0
1189440,True,7,Positive,19,4,23
1189460,True,6,Mostly Positive,10,3,13
1189470,True,0,No user reviews,0,0,0
1189480,True,5,Mixed,22,19,41
1189490,True,7,Positive,14,0,14
1189520,True,0,2 user reviews,2,0,2
1189530,True,0,No user reviews,0,0,0
1189570,True,0,No user reviews,0,0,0
1189590,True,0,No user reviews,0,0,0
1189600,True,0,1 user reviews,1,0,1
1189620,True,0,No user reviews,0,0,0
1189630,True,8,Very Positive,364,16,380
1189650,True,0,2 user reviews,1,1,2
1189660,True,0,No user reviews,0,0,0
1189670,True,0,No user reviews,0,0,0
1189671,True,0,No user reviews,0,0,0
1189680,True,0,No user reviews,0,0,0
1189690,True,0,No user reviews,0,0,0
1189700,True,0,3 user reviews,1,2,3
1189720,True,0,No user reviews,0,0,0
1189730,True,0,No user reviews,0,0,0
1189740,True,6,Mostly Positive,11,4,15
1189750,True,0,4 user reviews,3,1,4
1189760,True,0,No user reviews,0,0,0
1189770,True,0,1 user reviews,1,0,1
1189780,True,7,Positive,26,6,32
1189800,True,6,Mostly Positive,525,199,724
1189820,True,0,No user reviews,0,0,0
1189850,True,0,No user reviews,0,0,0
1189870,True,0,No user reviews,0,0,0
1189871,True,0,1 user reviews,1,0,1
1189890,True,0,7 user reviews,4,3,7
1189900,True,0,6 user reviews,2,4,6
1189910,True,5,Mixed,5,5,10
1189940,True,0,No user reviews,0,0,0
1189950,True,0,No user reviews,0,0,0
1189990,True,0,No user reviews,0,0,0
1190010,True,0,1 user reviews,1,0,1
1190011,True,0,No user reviews,0,0,0
1190012,True,0,No user reviews,0,0,0
1190013,True,0,No user reviews,0,0,0
1190060,True,0,4 user reviews,4,0,4
1190110,True,8,Very Positive,240,21,261
1190120,True,0,4 user reviews,1,3,4
1190130,True,0,3 user reviews,1,2,3
1190140,True,0,No user reviews,0,0,0
1190150,True,0,5 user reviews,3,2,5
1190160,True,8,Very Positive,63,5,68
1190180,True,0,1 user reviews,1,0,1
1190190,True,0,No user reviews,0,0,0
1190210,True,0,1 user reviews,1,0,1
1190230,True,0,No user reviews,0,0,0
1190240,True,0,No user reviews,0,0,0
1190260,True,0,No user reviews,0,0,0
1190270,True,0,No user reviews,0,0,0
1190310,True,0,2 user reviews,2,0,2
1190320,True,0,No user reviews,0,0,0
1190330,True,0,No user reviews,0,0,0
1190331,True,0,No user reviews,0,0,0
1190350,True,0,No user reviews,0,0,0
1190360,True,0,No user reviews,0,0,0
1190370,True,0,No user reviews,0,0,0
1190380,True,6,Mostly Positive,8,3,11
1190400,True,8,Very Positive,117,22,139
1190410,True,0,3 user reviews,2,1,3
1190440,True,0,No user reviews,0,0,0
1190450,True,0,No user reviews,0,0,0
1190460,True,8,Very Positive,6427,532,6959
1190480,True,0,2 user reviews,1,1,2
1190490,True,0,1 user reviews,1,0,1
1190500,True,0,No user reviews,0,0,0
1190510,True,0,No user reviews,0,0,0
1190520,True,0,No user reviews,0,0,0
1190530,True,0,No user reviews,0,0,0
1190540,True,0,No user reviews,0,0,0
1190560,True,0,No user reviews,0,0,0
1190570,True,0,3 user reviews,2,1,3
1190580,True,0,No user reviews,0,0,0
1190590,True,0,1 user reviews,1,0,1
1190610,True,0,No user reviews,0,0,0
1190620,True,0,6 user reviews,1,5,6
1190630,True,0,No user reviews,0,0,0
1190640,True,0,1 user reviews,1,0,1
1190680,True,0,No user reviews,0,0,0
1190690,True,0,No user reviews,0,0,0
1190720,True,0,No user reviews,0,0,0
1190730,True,0,No user reviews,0,0,0
1190750,True,0,No user reviews,0,0,0
1190760,True,0,3 user reviews,0,3,3
1190770,True,0,1 user reviews,1,0,1
1190780,True,0,2 user reviews,0,2,2
1190800,True,0,No user reviews,0,0,0
1190810,True,0,7 user reviews,7,0,7
1190820,True,0,5 user reviews,5,0,5
1190840,True,0,7 user reviews,7,0,7
1190900,True,0,No user reviews,0,0,0
1190910,True,0,1 user reviews,1,0,1
1190920,True,0,No user reviews,0,0,0
1190930,True,0,7 user reviews,7,0,7
1190940,True,0,No user reviews,0,0,0
1190950,True,0,2 user reviews,2,0,2
1190960,True,0,No user reviews,0,0,0
1190980,True,0,1 user reviews,0,1,1
1190990,True,0,4 user reviews,4,0,4
1191000,True,0,No user reviews,0,0,0
1191010,True,0,7 user reviews,7,0,7
1191060,True,0,No user reviews,0,0,0
1191070,True,6,Mostly Positive,24,8,32
1191090,True,0,No user reviews,0,0,0
1191100,True,7,Positive,11,2,13
1191130,True,0,No user reviews,0,0,0
1191150,True,0,No user reviews,0,0,0
1191160,True,0,6 user reviews,4,2,6
1191161,True,7,Positive,13,1,14
1191162,True,0,8 user reviews,6,2,8
1191170,True,0,No user reviews,0,0,0
1191190,True,0,2 user reviews,2,0,2
1191210,True,8,Very Positive,138,33,171
1191230,True,0,No user reviews,0,0,0
1191250,True,0,No user reviews,0,0,0
1191270,True,0,No user reviews,0,0,0
1191280,True,0,4 user reviews,2,2,4
1191290,True,0,No user reviews,0,0,0
1191330,True,0,No user reviews,0,0,0
1191360,True,0,No user reviews,0,0,0
1191420,True,0,No user reviews,0,0,0
1191430,True,0,No user reviews,0,0,0
1191440,True,0,1 user reviews,0,1,1
1191450,True,0,No user reviews,0,0,0
1191490,True,7,Positive,16,0,16
1191500,True,5,Mixed,6,6,12
1191510,True,0,1 user reviews,0,1,1
1191530,True,0,No user reviews,0,0,0
1191540,True,0,No user reviews,0,0,0
1191550,True,0,No user reviews,0,0,0
1191570,True,0,No user reviews,0,0,0
1191580,True,8,Very Positive,222,20,242
1191590,True,0,9 user reviews,9,0,9
1191610,True,0,1 user reviews,1,0,1
1191630,True,8,Very Positive,333,32,365
1191650,True,0,No user reviews,0,0,0
1191660,True,0,No user reviews,0,0,0
1191680,True,0,No user reviews,0,0,0
1191690,True,0,No user reviews,0,0,0
1191700,True,0,No user reviews,0,0,0
1191790,True,0,5 user reviews,2,3,5
1191800,True,0,No user reviews,0,0,0
1191810,True,0,1 user reviews,1,0,1
1191820,True,0,2 user reviews,2,0,2
1191830,True,0,No user reviews,0,0,0
1191840,True,7,Positive,15,1,16
1191850,True,0,No user reviews,0,0,0
1191860,True,7,Positive,13,1,14
1191870,True,0,No user reviews,0,0,0
1191900,True,0,No user reviews,0,0,0
1191930,True,0,No user reviews,0,0,0
1191940,True,8,Very Positive,68,7,75
1191960,True,0,No user reviews,0,0,0
1191970,True,0,No user reviews,0,0,0
1191980,True,0,No user reviews,0,0,0
1192020,True,0,8 user reviews,4,4,8
1192060,True,0,3 user reviews,0,3,3
1192070,True,0,1 user reviews,1,0,1
1192080,True,0,No user reviews,0,0,0
1192110,True,0,No user reviews,0,0,0
1192160,True,0,1 user reviews,1,0,1
1192180,True,0,No user reviews,0,0,0
1192220,True,0,No user reviews,0,0,0
1192230,True,0,No user reviews,0,0,0
1192260,True,0,1 user reviews,1,0,1
1192270,True,0,1 user reviews,1,0,1
1192300,True,0,No user reviews,0,0,0
1192310,True,0,6 user reviews,4,2,6
1192320,True,0,No user reviews,0,0,0
1192340,True,0,3 user reviews,2,1,3
1192350,True,0,4 user reviews,3,1,4
1192360,True,0,No user reviews,0,0,0
1192370,True,0,No user reviews,0,0,0
1192371,True,0,No user reviews,0,0,0
1192380,True,7,Positive,11,1,12
1192390,True,0,2 user reviews,0,2,2
1192400,True,0,No user reviews,0,0,0
1192410,True,0,No user reviews,0,0,0
1192440,True,0,No user reviews,0,0,0
1192450,True,0,7 user reviews,6,1,7
1192490,True,0,No user reviews,0,0,0
1192500,True,0,1 user reviews,0,1,1
1192520,True,0,No user reviews,0,0,0
1192540,True,0,No user reviews,0,0,0
1192550,True,0,No user reviews,0,0,0
1192561,True,0,2 user reviews,0,2,2
1192580,True,5,Mixed,9,4,13
1192600,True,0,No user reviews,0,0,0
1192610,True,6,Mostly Positive,74,20,94
1192640,True,8,Very Positive,58,7,65
1192650,True,0,2 user reviews,2,0,2
1192670,True,0,No user reviews,0,0,0
1192680,True,0,2 user reviews,2,0,2
1192690,True,0,No user reviews,0,0,0
1192700,True,0,No user reviews,0,0,0
1192710,True,0,No user reviews,0,0,0
1192730,True,5,Mixed,21,12,33
1192740,True,0,3 user reviews,3,0,3
1192750,True,5,Mixed,11,5,16
1192770,True,0,No user reviews,0,0,0
1192790,True,0,No user reviews,0,0,0
1192820,True,5,Mixed,29,25,54
1192840,True,0,1 user reviews,1,0,1
1192860,True,0,2 user reviews,2,0,2
1192880,True,0,No user reviews,0,0,0
1192890,True,6,Mostly Positive,11,4,15
1192900,True,0,No user reviews,0,0,0
1192910,True,0,1 user reviews,1,0,1
1192920,True,0,No user reviews,0,0,0
1192940,True,0,No user reviews,0,0,0
1192950,True,0,No user reviews,0,0,0
1192960,True,0,No user reviews,0,0,0
1192990,True,0,No user reviews,0,0,0
1193040,True,0,No user reviews,0,0,0
1193060,True,0,No user reviews,0,0,0
1193070,True,0,No user reviews,0,0,0
1193080,True,0,No user reviews,0,0,0
1193090,True,0,No user reviews,0,0,0
1193110,True,0,2 user reviews,1,1,2
1193120,True,0,No user reviews,0,0,0
1193130,True,0,No user reviews,0,0,0
1193160,True,0,1 user reviews,0,1,1
1193190,True,0,No user reviews,0,0,0
1193200,True,0,3 user reviews,3,0,3
1193210,True,0,2 user reviews,2,0,2
1193220,True,0,No user reviews,0,0,0
1193240,True,0,No user reviews,0,0,0
1193280,True,0,No user reviews,0,0,0
1193290,True,0,No user reviews,0,0,0
1193300,True,0,No user reviews,0,0,0
1193320,True,0,No user reviews,0,0,0
1193330,True,0,3 user reviews,3,0,3
1193340,True,8,Very Positive,119,26,145
1193350,True,0,No user reviews,0,0,0
1193360,True,0,No user reviews,0,0,0
1193370,True,0,2 user reviews,2,0,2
1193380,True,0,No user reviews,0,0,0
1193390,True,0,1 user reviews,1,0,1
1193400,True,0,No user reviews,0,0,0
1193410,True,0,No user reviews,0,0,0
1193420,True,0,1 user reviews,1,0,1
1193430,True,0,2 user reviews,2,0,2
1193440,True,0,No user reviews,0,0,0
1193450,True,0,1 user reviews,0,1,1
1193460,True,0,1 user reviews,1,0,1
1193470,True,0,No user reviews,0,0,0
1193480,True,0,No user reviews,0,0,0
1193510,True,0,No user reviews,0,0,0
1193520,True,0,2 user reviews,1,1,2
1193530,True,0,2 user reviews,1,1,2
1193550,True,0,No user reviews,0,0,0
1193560,True,0,6 user reviews,6,0,6
1193570,True,0,No user reviews,0,0,0
1193590,True,0,No user reviews,0,0,0
1193600,True,0,No user reviews,0,0,0
1193610,True,0,No user reviews,0,0,0
1193611,True,0,No user reviews,0,0,0
1193612,True,0,No user reviews,0,0,0
1193613,True,0,No user reviews,0,0,0
1193620,True,0,No user reviews,0,0,0
1193630,True,0,No user reviews,0,0,0
1193640,True,0,No user reviews,0,0,0
1193660,True,0,No user reviews,0,0,0
1193680,True,0,No user reviews,0,0,0
1193690,True,0,No user reviews,0,0,0
1193730,True,0,No user reviews,0,0,0
1193750,True,0,No user reviews,0,0,0
1193760,True,0,No user reviews,0,0,0
1193780,True,0,1 user reviews,1,0,1
1193790,True,0,No user reviews,0,0,0
1193830,True,0,No user reviews,0,0,0
1193840,True,0,No user reviews,0,0,0
1193860,True,0,No user reviews,0,0,0
1193870,True,0,1 user reviews,1,0,1
1193871,True,7,Positive,12,3,15
1193890,True,0,1 user reviews,0,1,1
1193900,True,0,No user reviews,0,0,0
1193930,True,0,2 user reviews,2,0,2
1193950,True,0,1 user reviews,1,0,1
1193990,True,0,8 user reviews,7,1,8
1194000,True,0,2 user reviews,1,1,2
1194010,True,6,Mostly Positive,39,13,52
1194020,True,0,No user reviews,0,0,0
1194021,True,0,2 user reviews,2,0,2
1194050,True,0,No user reviews,0,0,0
1194060,True,0,No user reviews,0,0,0
1194070,True,0,No user reviews,0,0,0
1194080,True,0,No user reviews,0,0,0
1194100,True,0,1 user reviews,0,1,1
1194110,True,8,Very Positive,97,17,114
1194120,True,7,Positive,16,2,18
1194130,True,0,No user reviews,0,0,0
1194140,True,5,Mixed,12,10,22
1194160,True,0,2 user reviews,2,0,2
1194170,True,0,1 user reviews,1,0,1
1194190,True,0,No user reviews,0,0,0
1194200,True,0,No user reviews,0,0,0
1194220,True,0,2 user reviews,2,0,2
1194230,True,0,No user reviews,0,0,0
1194250,True,0,No user reviews,0,0,0
1194270,True,0,No user reviews,0,0,0
1194290,True,0,No user reviews,0,0,0
1194330,True,0,No user reviews,0,0,0
1194360,True,0,No user reviews,0,0,0
1194361,True,0,No user reviews,0,0,0
1194380,True,0,1 user reviews,1,0,1
1194390,True,0,4 user reviews,4,0,4
1194430,True,0,No user reviews,0,0,0
1194440,True,0,2 user reviews,2,0,2
1194470,True,0,2 user reviews,2,0,2
1194480,True,7,Positive,10,0,10
1194490,True,0,No user reviews,0,0,0
1194520,True,0,No user reviews,0,0,0
1194540,True,0,1 user reviews,1,0,1
1194560,True,0,No user reviews,0,0,0
1194570,True,7,Positive,14,3,17
1194590,True,0,No user reviews,0,0,0
1194600,True,0,1 user reviews,1,0,1
1194610,True,0,8 user reviews,7,1,8
1194620,True,0,No user reviews,0,0,0
1194630,True,6,Mostly Positive,21,9,30
1194640,True,0,No user reviews,0,0,0
1194650,True,0,No user reviews,0,0,0
1194661,True,0,No user reviews,0,0,0
1194670,True,0,No user reviews,0,0,0
1194680,True,8,Very Positive,48,7,55
1194690,True,0,4 user reviews,1,3,4
1194700,True,0,No user reviews,0,0,0
1194710,True,0,No user reviews,0,0,0
1194730,True,0,No user reviews,0,0,0
1194740,True,0,No user reviews,0,0,0
1194750,True,0,No user reviews,0,0,0
1194770,True,5,Mixed,13,9,22
1194780,True,0,1 user reviews,1,0,1
1194781,True,0,1 user reviews,1,0,1
1194790,True,0,8 user reviews,4,4,8
1194800,True,0,No user reviews,0,0,0
1194820,True,0,No user reviews,0,0,0
1194830,True,8,Very Positive,63,5,68
1194840,True,8,Very Positive,52,0,52
1194850,True,0,No user reviews,0,0,0
1194851,True,0,No user reviews,0,0,0
1194852,True,0,No user reviews,0,0,0
1194853,True,0,No user reviews,0,0,0
1194854,True,0,No user reviews,0,0,0
1194855,True,0,No user reviews,0,0,0
1194856,True,0,No user reviews,0,0,0
1194857,True,0,No user reviews,0,0,0
1194858,True,0,No user reviews,0,0,0
1194859,True,0,No user reviews,0,0,0
1194870,True,0,No user reviews,0,0,0
1194890,True,0,No user reviews,0,0,0
1194910,True,0,3 user reviews,3,0,3
1194930,True,5,Mixed,214,98,312
1194940,True,7,Positive,12,3,15
1194970,True,0,No user reviews,0,0,0
1194980,True,0,No user reviews,0,0,0
1195020,True,8,Very Positive,68,17,85
1195030,True,0,No user reviews,0,0,0
1195040,True,0,No user reviews,0,0,0
1195050,True,0,No user reviews,0,0,0
1195060,True,0,No user reviews,0,0,0
1195080,True,0,No user reviews,0,0,0
1195090,True,0,1 user reviews,1,0,1
1195130,True,0,No user reviews,0,0,0
1195140,True,0,No user reviews,0,0,0
1195150,True,0,3 user reviews,2,1,3
1195160,True,0,2 user reviews,2,0,2
1195161,True,0,No user reviews,0,0,0
1195162,True,0,No user reviews,0,0,0
1195163,True,0,No user reviews,0,0,0
1195164,True,0,No user reviews,0,0,0
1195165,True,0,No user reviews,0,0,0
1195166,True,0,No user reviews,0,0,0
1195167,True,0,No user reviews,0,0,0
1195170,True,0,4 user reviews,2,2,4
1195200,True,0,No user reviews,0,0,0
1195201,True,0,No user reviews,0,0,0
1195202,True,0,No user reviews,0,0,0
1195203,True,0,No user reviews,0,0,0
1195204,True,0,No user reviews,0,0,0
1195205,True,0,No user reviews,0,0,0
1195206,True,0,No user reviews,0,0,0
1195207,True,0,No user reviews,0,0,0
1195208,True,0,No user reviews,0,0,0
1195209,True,0,No user reviews,0,0,0
1195210,True,0,No user reviews,0,0,0
1195211,True,0,No user reviews,0,0,0
1195212,True,0,No user reviews,0,0,0
1195213,True,0,No user reviews,0,0,0
1195214,True,0,No user reviews,0,0,0
1195215,True,0,No user reviews,0,0,0
1195216,True,0,1 user reviews,0,1,1
1195220,True,0,No user reviews,0,0,0
1195230,True,7,Positive,12,0,12
1195240,True,5,Mixed,8,4,12
1195250,True,0,No user reviews,0,0,0
1195260,True,0,No user reviews,0,0,0
1195270,True,7,Positive,10,1,11
1195290,True,0,No user reviews,0,0,0
1195300,True,0,No user reviews,0,0,0
1195301,True,0,No user reviews,0,0,0
1195320,True,7,Positive,29,0,29
1195330,True,0,No user reviews,0,0,0
1195331,True,0,No user reviews,0,0,0
1195332,True,0,No user reviews,0,0,0
1195340,True,0,No user reviews,0,0,0
1195350,True,0,2 user reviews,1,1,2
1195360,True,5,Mixed,11,5,16
1195410,True,7,Positive,18,1,19
1195430,True,0,4 user reviews,4,0,4
1195440,True,0,No user reviews,0,0,0
1195450,True,0,No user reviews,0,0,0
1195460,True,5,Mixed,1009,523,1532
1195480,True,7,Positive,23,5,28
1195530,True,0,4 user reviews,4,0,4
1195540,True,0,1 user reviews,1,0,1
1195550,True,0,1 user reviews,0,1,1
1195570,True,0,2 user reviews,2,0,2
1195590,True,0,No user reviews,0,0,0
1195600,True,0,2 user reviews,2,0,2
1195610,True,0,No user reviews,0,0,0
1195620,True,0,2 user reviews,2,0,2
1195630,True,0,No user reviews,0,0,0
1195690,True,0,No user reviews,0,0,0
1195710,True,0,2 user reviews,2,0,2
1195740,True,0,No user reviews,0,0,0
1195750,True,0,1 user reviews,1,0,1
1195790,True,0,No user reviews,0,0,0
1195820,True,0,2 user reviews,0,2,2
1195830,True,0,No user reviews,0,0,0
1195840,True,0,No user reviews,0,0,0
1195870,True,0,No user reviews,0,0,0
1195880,True,0,No user reviews,0,0,0
1195881,True,0,No user reviews,0,0,0
1195882,True,0,No user reviews,0,0,0
1195883,True,0,No user reviews,0,0,0
1195884,True,0,No user reviews,0,0,0
1195885,True,0,No user reviews,0,0,0
1195886,True,0,No user reviews,0,0,0
1195900,True,0,No user reviews,0,0,0
1195901,True,0,No user reviews,0,0,0
1195902,True,0,No user reviews,0,0,0
1195903,True,0,No user reviews,0,0,0
1195904,True,0,No user reviews,0,0,0
1195905,True,0,No user reviews,0,0,0
1195906,True,0,1 user reviews,1,0,1
1195907,True,0,1 user reviews,1,0,1
1195910,True,7,Positive,15,1,16
1195920,True,7,Positive,10,2,12
1195930,True,0,No user reviews,0,0,0
1195940,True,0,No user reviews,0,0,0
1195950,True,0,No user reviews,0,0,0
1195960,True,0,No user reviews,0,0,0
1195970,True,0,No user reviews,0,0,0
1195980,True,0,No user reviews,0,0,0
1195990,True,0,No user reviews,0,0,0
1196010,True,0,No user reviews,0,0,0
1196020,True,0,No user reviews,0,0,0
1196030,True,0,No user reviews,0,0,0
1196040,True,0,1 user reviews,0,1,1
1196041,True,0,3 user reviews,2,1,3
1196070,True,0,No user reviews,0,0,0
1196080,True,6,Mostly Positive,13,4,17
1196100,True,0,7 user reviews,7,0,7
1196130,True,0,2 user reviews,2,0,2
1196141,True,0,No user reviews,0,0,0
1196150,True,7,Positive,12,3,15
1196160,True,0,2 user reviews,0,2,2
1196170,True,0,4 user reviews,4,0,4
1196180,True,0,No user reviews,0,0,0
1196190,True,0,2 user reviews,1,1,2
1196210,True,0,No user reviews,0,0,0
1196220,True,0,No user reviews,0,0,0
1196230,True,0,No user reviews,0,0,0
1196240,True,0,No user reviews,0,0,0
1196260,True,0,5 user reviews,2,3,5
1196280,True,0,1 user reviews,1,0,1
1196290,True,0,No user reviews,0,0,0
1196310,True,7,Positive,25,3,28
1196320,True,0,1 user reviews,1,0,1
1196330,True,0,No user reviews,0,0,0
1196340,True,0,No user reviews,0,0,0
1196350,True,0,1 user reviews,0,1,1
1196380,True,0,2 user reviews,2,0,2
1196390,True,0,4 user reviews,4,0,4
1196400,True,7,Positive,13,1,14
1196420,True,7,Positive,16,0,16
1196440,True,0,No user reviews,0,0,0
1196450,True,7,Positive,10,0,10
1196490,True,0,No user reviews,0,0,0
1196500,True,7,Positive,15,3,18
1196510,True,0,No user reviews,0,0,0
1196520,True,0,3 user reviews,1,2,3
1196550,True,0,No user reviews,0,0,0
1196560,True,0,No user reviews,0,0,0
1196561,True,0,No user reviews,0,0,0
1196570,True,0,3 user reviews,2,1,3
1196580,True,0,5 user reviews,5,0,5
1196620,True,0,No user reviews,0,0,0
1196630,True,8,Very Positive,356,44,400
1196651,True,0,6 user reviews,5,1,6
1196660,True,0,No user reviews,0,0,0
1196670,True,5,Mixed,6,6,12
1196680,True,0,No user reviews,0,0,0
1196690,True,0,1 user reviews,1,0,1
1196700,True,0,No user reviews,0,0,0
1196710,True,0,7 user reviews,5,2,7
1196720,True,0,No user reviews,0,0,0
1196730,True,0,No user reviews,0,0,0
1196750,True,0,5 user reviews,3,2,5
1196760,True,0,No user reviews,0,0,0
1196770,True,5,Mixed,84,47,131
1196780,True,0,7 user reviews,6,1,7
1196781,True,0,5 user reviews,4,1,5
1196782,True,0,3 user reviews,3,0,3
1196783,True,0,5 user reviews,5,0,5
1196784,True,0,8 user reviews,8,0,8
1196785,True,0,3 user reviews,2,1,3
1196786,True,0,2 user reviews,2,0,2
1196787,True,0,7 user reviews,7,0,7
1196788,True,7,Positive,10,1,11
1196789,True,0,2 user reviews,2,0,2
1196790,True,0,5 user reviews,5,0,5
1196791,True,7,Positive,46,1,47
1196792,True,0,4 user reviews,4,0,4
1196793,True,0,7 user reviews,7,0,7
1196794,True,7,Positive,9,1,10
1196800,True,0,9 user reviews,9,0,9
1196840,True,0,No user reviews,0,0,0
1196850,True,0,1 user reviews,0,1,1
1196870,True,0,No user reviews,0,0,0
1196880,True,0,No user reviews,0,0,0
1196890,True,0,7 user reviews,6,1,7
1196910,True,0,No user reviews,0,0,0
1196920,True,0,No user reviews,0,0,0
1196930,True,7,Positive,31,7,38
1196940,True,0,2 user reviews,2,0,2
1196960,True,0,No user reviews,0,0,0
1196970,True,0,2 user reviews,2,0,2
1197010,True,0,3 user reviews,2,1,3
1197020,True,0,1 user reviews,1,0,1
1197030,True,7,Positive,20,0,20
1197040,True,0,No user reviews,0,0,0
1197050,True,0,No user reviews,0,0,0
1197060,True,0,2 user reviews,2,0,2
1197070,True,0,No user reviews,0,0,0
1197080,True,0,No user reviews,0,0,0
1197100,True,0,5 user reviews,3,2,5
1197110,True,0,5 user reviews,1,4,5
1197130,True,0,No user reviews,0,0,0
1197150,True,0,5 user reviews,4,1,5
1197170,True,0,No user reviews,0,0,0
1197180,True,0,No user reviews,0,0,0
1197210,True,0,3 user reviews,2,1,3
1197220,True,6,Mostly Positive,47,15,62
1197230,True,0,7 user reviews,7,0,7
1197250,True,0,No user reviews,0,0,0
1197260,True,0,No user reviews,0,0,0
1197280,True,0,6 user reviews,4,2,6
1197300,True,0,No user reviews,0,0,0
1197310,True,0,No user reviews,0,0,0
1197320,True,0,No user reviews,0,0,0
1197340,True,0,1 user reviews,0,1,1
1197350,True,0,7 user reviews,7,0,7
1197360,True,0,1 user reviews,1,0,1
1197370,True,8,Very Positive,145,12,157
1197380,True,0,1 user reviews,1,0,1
1197390,True,7,Positive,13,0,13
1197410,True,0,No user reviews,0,0,0
1197440,True,0,4 user reviews,1,3,4
1197460,True,0,No user reviews,0,0,0
1197470,True,0,No user reviews,0,0,0
1197480,True,0,No user reviews,0,0,0
1197490,True,0,No user reviews,0,0,0
1197500,True,0,1 user reviews,1,0,1
1197520,True,7,Positive,13,0,13
1197530,True,0,3 user reviews,3,0,3
1197550,True,0,9 user reviews,1,8,9
1197570,True,0,No user reviews,0,0,0
1197580,True,0,No user reviews,0,0,0
1197590,True,6,Mostly Positive,23,6,29
1197620,True,0,5 user reviews,4,1,5
1197650,True,7,Positive,16,1,17
1197651,True,0,2 user reviews,2,0,2
1197670,True,0,No user reviews,0,0,0
1197690,True,0,No user reviews,0,0,0
1197700,True,0,No user reviews,0,0,0
1197710,True,0,2 user reviews,2,0,2
1197730,True,0,No user reviews,0,0,0
1197740,True,0,No user reviews,0,0,0
1197750,True,0,No user reviews,0,0,0
1197770,True,6,Mostly Positive,60,23,83
1197790,True,0,No user reviews,0,0,0
1197800,True,0,1 user reviews,1,0,1
1197810,True,0,4 user reviews,4,0,4
1197820,True,7,Positive,25,5,30
1197840,True,0,1 user reviews,0,1,1
1197860,True,0,3 user reviews,3,0,3
1197870,True,0,No user reviews,0,0,0
1197890,True,0,No user reviews,0,0,0
1197891,True,0,No user reviews,0,0,0
1197892,True,0,No user reviews,0,0,0
1197893,True,0,No user reviews,0,0,0
1197894,True,0,No user reviews,0,0,0
1197895,True,0,No user reviews,0,0,0
1197900,True,0,No user reviews,0,0,0
1197901,True,0,No user reviews,0,0,0
1197902,True,0,No user reviews,0,0,0
1197903,True,0,No user reviews,0,0,0
1197904,True,0,No user reviews,0,0,0
1197905,True,0,No user reviews,0,0,0
1197906,True,0,No user reviews,0,0,0
1197907,True,0,No user reviews,0,0,0
1197910,True,0,No user reviews,0,0,0
1197911,True,0,No user reviews,0,0,0
1197912,True,0,No user reviews,0,0,0
1197913,True,0,No user reviews,0,0,0
1197914,True,0,No user reviews,0,0,0
1197915,True,0,No user reviews,0,0,0
1197960,True,0,No user reviews,0,0,0
1197970,True,0,No user reviews,0,0,0
1197980,True,0,2 user reviews,2,0,2
1197990,True,0,6 user reviews,6,0,6
1198010,True,0,No user reviews,0,0,0
1198020,True,0,1 user reviews,0,1,1
1198040,True,8,Very Positive,68,1,69
1198050,True,6,Mostly Positive,39,14,53
1198060,True,0,3 user reviews,1,2,3
1198070,True,0,2 user reviews,2,0,2
1198080,True,0,No user reviews,0,0,0
1198090,True,0,No user reviews,0,0,0
1198110,True,0,3 user reviews,2,1,3
1198140,True,0,No user reviews,0,0,0
1198141,True,0,No user reviews,0,0,0
1198142,True,0,No user reviews,0,0,0
1198143,True,0,No user reviews,0,0,0
1198144,True,0,No user reviews,0,0,0
1198145,True,0,No user reviews,0,0,0
1198146,True,0,1 user reviews,1,0,1
1198147,True,0,No user reviews,0,0,0
1198148,True,0,No user reviews,0,0,0
1198149,True,0,No user reviews,0,0,0
1198160,True,0,No user reviews,0,0,0
1198161,True,0,No user reviews,0,0,0
1198162,True,0,No user reviews,0,0,0
1198163,True,0,1 user reviews,1,0,1
1198164,True,0,No user reviews,0,0,0
1198165,True,0,1 user reviews,0,1,1
1198166,True,0,No user reviews,0,0,0
1198180,True,0,No user reviews,0,0,0
1198181,True,0,No user reviews,0,0,0
1198182,True,0,No user reviews,0,0,0
1198183,True,0,No user reviews,0,0,0
1198184,True,0,No user reviews,0,0,0
1198185,True,0,No user reviews,0,0,0
1198186,True,0,1 user reviews,0,1,1
1198187,True,0,No user reviews,0,0,0
1198188,True,0,No user reviews,0,0,0
1198189,True,0,No user reviews,0,0,0
1198190,True,0,No user reviews,0,0,0
1198191,True,0,No user reviews,0,0,0
1198192,True,0,No user reviews,0,0,0
1198210,True,0,No user reviews,0,0,0
1198220,True,0,3 user reviews,1,2,3
1198240,True,0,3 user reviews,2,1,3
1198250,True,0,No user reviews,0,0,0
1198260,True,0,No user reviews,0,0,0
1198270,True,0,No user reviews,0,0,0
1198280,True,0,2 user reviews,1,1,2
1198290,True,7,Positive,10,0,10
1198310,True,0,1 user reviews,1,0,1
1198320,True,0,No user reviews,0,0,0
1198340,True,0,No user reviews,0,0,0
1198350,True,0,No user reviews,0,0,0
1198360,True,5,Mixed,13,7,20
1198361,True,0,6 user reviews,6,0,6
1198362,True,0,No user reviews,0,0,0
1198363,True,0,No user reviews,0,0,0
1198364,True,0,No user reviews,0,0,0
1198370,True,0,No user reviews,0,0,0
1198380,True,0,3 user reviews,2,1,3
1198390,True,0,5 user reviews,3,2,5
1198400,True,7,Positive,12,0,12
1198410,True,0,1 user reviews,0,1,1
1198440,True,0,2 user reviews,2,0,2
1198450,True,7,Positive,13,3,16
1198460,True,7,Positive,22,1,23
1198461,True,0,4 user reviews,4,0,4
1198462,True,7,Positive,10,0,10
1198470,True,5,Mixed,25,16,41
1198480,True,0,2 user reviews,2,0,2
1198481,True,0,2 user reviews,2,0,2
1198490,True,0,No user reviews,0,0,0
1198500,True,0,No user reviews,0,0,0
1198510,True,8,Very Positive,94,2,96
1198550,True,0,1 user reviews,1,0,1
1198560,True,0,No user reviews,0,0,0
1198570,True,0,No user reviews,0,0,0
1198600,True,7,Positive,15,1,16
1198620,True,0,2 user reviews,0,2,2
1198630,True,0,7 user reviews,5,2,7
1198680,True,0,No user reviews,0,0,0
1198690,True,0,No user reviews,0,0,0
1198700,True,7,Positive,9,1,10
1198710,True,0,No user reviews,0,0,0
1198730,True,8,Very Positive,48,10,58
1198740,True,7,Positive,37,1,38
1198760,True,0,No user reviews,0,0,0
1198770,True,0,No user reviews,0,0,0
1198780,True,0,6 user reviews,6,0,6
1198800,True,0,No user reviews,0,0,0
1198810,True,0,3 user reviews,3,0,3
1198820,True,0,9 user reviews,7,2,9
1198830,True,0,No user reviews,0,0,0
1198831,True,0,No user reviews,0,0,0
1198832,True,0,No user reviews,0,0,0
1198833,True,0,No user reviews,0,0,0
1198834,True,0,No user reviews,0,0,0
1198835,True,0,No user reviews,0,0,0
1198836,True,0,No user reviews,0,0,0
1198837,True,0,No user reviews,0,0,0
1198839,True,0,No user reviews,0,0,0
1198840,True,0,1 user reviews,1,0,1
1198841,True,0,No user reviews,0,0,0
1198843,True,0,No user reviews,0,0,0
1198844,True,0,No user reviews,0,0,0
1198845,True,0,No user reviews,0,0,0
1198846,True,0,No user reviews,0,0,0
1198847,True,0,No user reviews,0,0,0
1198848,True,0,No user reviews,0,0,0
1198849,True,0,No user reviews,0,0,0
1198850,True,0,No user reviews,0,0,0
1198860,True,0,9 user reviews,7,2,9
1198890,True,0,No user reviews,0,0,0
1198900,True,0,4 user reviews,4,0,4
1198910,True,0,No user reviews,0,0,0
1198940,True,0,4 user reviews,2,2,4
1198960,True,0,8 user reviews,8,0,8
1198970,True,0,No user reviews,0,0,0
1198990,True,0,No user reviews,0,0,0
1199000,True,0,No user reviews,0,0,0
1199001,True,0,No user reviews,0,0,0
1199010,True,0,7 user reviews,7,0,7
1199020,True,0,No user reviews,0,0,0
1199030,True,8,Very Positive,238,38,276
1199050,True,0,No user reviews,0,0,0
1199060,True,0,No user reviews,0,0,0
1199070,True,0,No user reviews,0,0,0
1199110,True,0,No user reviews,0,0,0
1199120,True,7,Positive,45,1,46
1199140,True,7,Positive,18,0,18
1199150,True,0,1 user reviews,1,0,1
1199170,True,0,4 user reviews,4,0,4
1199180,True,0,2 user reviews,2,0,2
1199190,True,0,No user reviews,0,0,0
1199200,True,0,No user reviews,0,0,0
1199210,True,0,2 user reviews,2,0,2
1199220,True,0,6 user reviews,3,3,6
1199230,True,0,No user reviews,0,0,0
1199240,True,0,1 user reviews,1,0,1
1199270,True,0,8 user reviews,8,0,8
1199310,True,0,No user reviews,0,0,0
1199324,True,0,No user reviews,0,0,0
1199360,True,0,5 user reviews,4,1,5
1199370,True,4,Mostly Negative,5,11,16
1199380,True,0,No user reviews,0,0,0
1199390,True,0,No user reviews,0,0,0
1199400,True,0,No user reviews,0,0,0
1199420,True,0,4 user reviews,3,1,4
1199440,True,0,No user reviews,0,0,0
1199450,True,5,Mixed,8,4,12
1199470,True,0,3 user reviews,3,0,3
1199500,True,0,1 user reviews,0,1,1
1199520,True,0,No user reviews,0,0,0
1199530,True,0,1 user reviews,1,0,1
1199531,True,0,8 user reviews,5,3,8
1199532,True,0,1 user reviews,1,0,1
1199540,True,0,No user reviews,0,0,0
1199550,True,7,Positive,14,0,14
1199560,True,0,2 user reviews,2,0,2
1199570,True,0,No user reviews,0,0,0
1199580,True,0,No user reviews,0,0,0
1199590,True,0,No user reviews,0,0,0
1199600,True,0,No user reviews,0,0,0
1199601,True,0,1 user reviews,1,0,1
1199602,True,0,No user reviews,0,0,0
1199610,True,0,1 user reviews,0,1,1
1199630,True,6,Mostly Positive,8,3,11
1199640,True,0,No user reviews,0,0,0
1199650,True,0,1 user reviews,1,0,1
1199660,True,7,Positive,31,1,32
1199670,True,0,No user reviews,0,0,0
1199690,True,0,No user reviews,0,0,0
1199720,True,0,No user reviews,0,0,0
1199740,True,0,2 user reviews,2,0,2
1199750,True,0,No user reviews,0,0,0
1199760,True,0,No user reviews,0,0,0
1199770,True,0,No user reviews,0,0,0
1199780,True,0,2 user reviews,2,0,2
1199790,True,5,Mixed,9,5,14
1199800,True,0,No user reviews,0,0,0
1199810,True,0,No user reviews,0,0,0
1199830,True,0,No user reviews,0,0,0
1199880,True,5,Mixed,109,58,167
1199890,True,0,No user reviews,0,0,0
1199900,True,0,4 user reviews,3,1,4
1199910,True,0,No user reviews,0,0,0
1199920,True,0,No user reviews,0,0,0
1199930,True,0,No user reviews,0,0,0
1199940,True,0,No user reviews,0,0,0
1199950,True,0,No user reviews,0,0,0
1199960,True,0,No user reviews,0,0,0
1199980,True,0,No user reviews,0,0,0
1200060,True,0,No user reviews,0,0,0
1200090,True,0,No user reviews,0,0,0
1200110,True,0,3 user reviews,3,0,3
1200120,True,0,No user reviews,0,0,0
1200140,True,0,3 user reviews,2,1,3
1200150,True,0,3 user reviews,3,0,3
1200160,True,0,1 user reviews,1,0,1
1200170,True,0,1 user reviews,1,0,1
1200171,True,0,1 user reviews,1,0,1
1200180,True,0,1 user reviews,1,0,1
1200200,True,0,1 user reviews,0,1,1
1200220,True,0,No user reviews,0,0,0
1200230,True,5,Mixed,16,17,33
1200250,True,0,No user reviews,0,0,0
1200270,True,0,9 user reviews,5,4,9
1200280,True,0,No user reviews,0,0,0
1200290,True,0,2 user reviews,2,0,2
1200300,True,0,1 user reviews,1,0,1
1200310,True,0,No user reviews,0,0,0
1200330,True,8,Very Positive,50,12,62
1200340,True,0,No user reviews,0,0,0
1200341,True,0,8 user reviews,6,2,8
1200342,True,0,2 user reviews,2,0,2
1200343,True,0,1 user reviews,1,0,1
1200344,True,0,2 user reviews,2,0,2
1200345,True,0,1 user reviews,1,0,1
1200346,True,0,1 user reviews,1,0,1
1200350,True,0,No user reviews,0,0,0
1200360,True,0,No user reviews,0,0,0
1200370,True,0,No user reviews,0,0,0
1200400,True,0,2 user reviews,0,2,2
1200420,True,0,4 user reviews,4,0,4
1200430,True,0,2 user reviews,1,1,2
1200440,True,0,No user reviews,0,0,0
1200450,True,0,No user reviews,0,0,0
1200460,True,0,No user reviews,0,0,0
1200470,True,0,No user reviews,0,0,0
1200480,True,0,No user reviews,0,0,0
1200500,True,0,No user reviews,0,0,0
1200520,True,0,1 user reviews,1,0,1
1200550,True,7,Positive,16,4,20
1200551,True,0,No user reviews,0,0,0
1200552,True,7,Positive,9,1,10
1200570,True,0,No user reviews,0,0,0
1200580,True,0,No user reviews,0,0,0
1200590,True,0,2 user reviews,1,1,2
1200600,True,0,1 user reviews,1,0,1
1200610,True,0,4 user reviews,3,1,4
1200620,True,0,No user reviews,0,0,0
1200621,True,0,No user reviews,0,0,0
1200622,True,0,No user reviews,0,0,0
1200623,True,0,No user reviews,0,0,0
1200630,True,0,1 user reviews,0,1,1
1200640,True,0,No user reviews,0,0,0
1200650,True,0,2 user reviews,1,1,2
1200660,True,0,No user reviews,0,0,0
1200700,True,0,No user reviews,0,0,0
1200710,True,6,Mostly Positive,69,20,89
1200720,True,8,Very Positive,172,1,173
1200730,True,8,Very Positive,60,6,66
1200740,True,0,No user reviews,0,0,0
1200770,True,0,No user reviews,0,0,0
1200780,True,0,2 user reviews,2,0,2
1200790,True,0,No user reviews,0,0,0
1200800,True,0,No user reviews,0,0,0
1200820,True,0,No user reviews,0,0,0
1200830,True,0,No user reviews,0,0,0
1200860,True,0,No user reviews,0,0,0
1200870,True,0,No user reviews,0,0,0
1200900,True,0,No user reviews,0,0,0
1200910,True,0,5 user reviews,5,0,5
1200930,True,0,1 user reviews,0,1,1
1200940,True,0,No user reviews,0,0,0
1200960,True,0,No user reviews,0,0,0
1200990,True,0,No user reviews,0,0,0
1201000,True,0,6 user reviews,2,4,6
1201010,True,0,No user reviews,0,0,0
1201020,True,0,No user reviews,0,0,0
1201030,True,0,No user reviews,0,0,0
1201050,True,0,5 user reviews,5,0,5
1201070,True,0,No user reviews,0,0,0
1201080,True,0,No user reviews,0,0,0
1201090,True,0,No user reviews,0,0,0
1201140,True,0,No user reviews,0,0,0
1201150,True,0,No user reviews,0,0,0
1201151,True,0,No user reviews,0,0,0
1201152,True,0,No user reviews,0,0,0
1201180,True,0,No user reviews,0,0,0
1201200,True,0,No user reviews,0,0,0
1201220,True,0,2 user reviews,1,1,2
1201230,True,0,No user reviews,0,0,0
1201240,True,0,No user reviews,0,0,0
1201250,True,0,No user reviews,0,0,0
1201260,True,0,3 user reviews,2,1,3
1201270,True,0,No user reviews,0,0,0
1201280,True,0,No user reviews,0,0,0
1201300,True,0,No user reviews,0,0,0
1201310,True,0,9 user reviews,7,2,9
1201330,True,0,No user reviews,0,0,0
1201350,True,0,2 user reviews,1,1,2
1201360,True,8,Very Positive,149,4,153
1201370,True,0,8 user reviews,6,2,8
1201380,True,0,No user reviews,0,0,0
1201390,True,0,No user reviews,0,0,0
1201400,True,0,No user reviews,0,0,0
1201430,True,0,1 user reviews,1,0,1
1201440,True,0,No user reviews,0,0,0
1201450,True,0,8 user reviews,6,2,8
1201460,True,0,No user reviews,0,0,0
1201470,True,0,No user reviews,0,0,0
1201480,True,0,No user reviews,0,0,0
1201500,True,0,1 user reviews,0,1,1
1201510,True,0,No user reviews,0,0,0
1201520,True,0,No user reviews,0,0,0
1201530,True,0,No user reviews,0,0,0
1201540,True,0,No user reviews,0,0,0
1201550,True,7,Positive,46,2,48
1201600,True,0,No user reviews,0,0,0
1201620,True,0,No user reviews,0,0,0
1201630,True,6,Mostly Positive,16,6,22
1201640,True,0,No user reviews,0,0,0
1201650,True,0,No user reviews,0,0,0
1201670,True,0,No user reviews,0,0,0
1201680,True,0,No user reviews,0,0,0
1201710,True,0,No user reviews,0,0,0
1201730,True,0,No user reviews,0,0,0
1201750,True,0,3 user reviews,3,0,3
1201760,True,0,No user reviews,0,0,0
1201770,True,0,No user reviews,0,0,0
1201780,True,0,No user reviews,0,0,0
1201790,True,0,2 user reviews,2,0,2
1201800,True,0,8 user reviews,8,0,8
1201810,True,5,Mixed,11,5,16
1201820,True,0,No user reviews,0,0,0
1201821,True,0,No user reviews,0,0,0
1201830,True,8,Very Positive,59,9,68
1201840,True,8,Very Positive,101,17,118
1201850,True,0,No user reviews,0,0,0
1201870,True,0,No user reviews,0,0,0
1201880,True,0,1 user reviews,1,0,1
1201890,True,0,No user reviews,0,0,0
1201910,True,4,Mostly Negative,4,7,11
1201930,True,0,No user reviews,0,0,0
1201940,True,0,No user reviews,0,0,0
1201950,True,0,1 user reviews,1,0,1
1201960,True,0,3 user reviews,3,0,3
1201970,True,0,No user reviews,0,0,0
1201980,True,0,No user reviews,0,0,0
1202010,True,0,No user reviews,0,0,0
1202011,True,0,No user reviews,0,0,0
1202012,True,0,No user reviews,0,0,0
1202013,True,0,1 user reviews,1,0,1
1202014,True,0,No user reviews,0,0,0
1202070,True,7,Positive,35,3,38
1202080,True,0,No user reviews,0,0,0
1202090,True,0,5 user reviews,2,3,5
1202100,True,0,No user reviews,0,0,0
1202120,True,0,No user reviews,0,0,0
1202130,True,0,No user reviews,0,0,0
1202140,True,0,No user reviews,0,0,0
1202150,True,7,Positive,12,3,15
1202160,True,0,2 user reviews,1,1,2
1202170,True,0,8 user reviews,8,0,8
1202190,True,0,6 user reviews,4,2,6
1202200,True,0,No user reviews,0,0,0
1202220,True,0,1 user reviews,1,0,1
1202240,True,0,7 user reviews,7,0,7
1202250,True,0,1 user reviews,1,0,1
1202290,True,0,No user reviews,0,0,0
1202300,True,0,No user reviews,0,0,0
1202310,True,8,Very Positive,57,13,70
1202330,True,0,No user reviews,0,0,0
1202340,True,0,No user reviews,0,0,0
1202350,True,0,No user reviews,0,0,0
1202360,True,0,No user reviews,0,0,0
1202400,True,0,3 user reviews,3,0,3
1202410,True,0,No user reviews,0,0,0
1202420,True,0,7 user reviews,7,0,7
1202430,True,0,No user reviews,0,0,0
1202440,True,0,No user reviews,0,0,0
1202450,True,0,No user reviews,0,0,0
1202460,True,0,7 user reviews,6,1,7
1202480,True,0,No user reviews,0,0,0
1202510,True,0,No user reviews,0,0,0
1202520,True,5,Mixed,137,167,304
1202530,True,0,No user reviews,0,0,0
1202540,True,8,Very Positive,136,1,137
1202550,True,0,1 user reviews,0,1,1
1202560,True,0,3 user reviews,2,1,3
1202570,True,0,4 user reviews,4,0,4
1202580,True,0,No user reviews,0,0,0
1202600,True,0,No user reviews,0,0,0
1202601,True,0,No user reviews,0,0,0
1202603,True,0,2 user reviews,0,2,2
1202604,True,0,No user reviews,0,0,0
1202605,True,0,No user reviews,0,0,0
1202610,True,0,1 user reviews,1,0,1
1202630,True,0,6 user reviews,5,1,6
1202640,True,0,5 user reviews,3,2,5
1202650,True,6,Mostly Positive,15,4,19
1202660,True,0,4 user reviews,3,1,4
1202690,True,0,No user reviews,0,0,0
1202710,True,0,3 user reviews,3,0,3
1202730,True,0,3 user reviews,3,0,3
1202750,True,0,No user reviews,0,0,0
1202760,True,0,No user reviews,0,0,0
1202770,True,0,5 user reviews,5,0,5
1202780,True,0,5 user reviews,3,2,5
1202790,True,0,5 user reviews,2,3,5
1202810,True,0,No user reviews,0,0,0
1202820,True,0,1 user reviews,1,0,1
1202830,True,0,1 user reviews,0,1,1
1202850,True,0,1 user reviews,1,0,1
1202860,True,0,1 user reviews,0,1,1
1202870,True,7,Positive,12,1,13
1202880,True,0,No user reviews,0,0,0
1202900,True,8,Very Positive,600,68,668
1202910,True,0,No user reviews,0,0,0
1202920,True,0,No user reviews,0,0,0
1202930,True,0,1 user reviews,1,0,1
1202950,True,0,No user reviews,0,0,0
1202970,True,0,9 user reviews,8,1,9
1202990,True,0,4 user reviews,3,1,4
1203000,True,0,No user reviews,0,0,0
1203010,True,0,No user reviews,0,0,0
1203030,True,0,No user reviews,0,0,0
1203040,True,0,6 user reviews,6,0,6
1203042,True,0,4 user reviews,0,4,4
1203050,True,0,1 user reviews,1,0,1
1203110,True,0,No user reviews,0,0,0
1203140,True,0,4 user reviews,3,1,4
1203160,True,0,No user reviews,0,0,0
1203220,True,0,No user reviews,0,0,0
1203240,True,0,5 user reviews,5,0,5
1203250,True,0,No user reviews,0,0,0
1203280,True,0,1 user reviews,1,0,1
1203300,True,0,No user reviews,0,0,0
1203310,True,0,1 user reviews,1,0,1
1203350,True,4,Mostly Negative,14,25,39
1203360,True,8,Very Positive,85,10,95
1203370,True,5,Mixed,6,4,10
1203390,True,0,No user reviews,0,0,0
1203400,True,0,1 user reviews,1,0,1
1203430,True,0,1 user reviews,0,1,1
1203440,True,0,5 user reviews,3,2,5
1203450,True,0,No user reviews,0,0,0
1203460,True,7,Positive,9,1,10
1203470,True,0,No user reviews,0,0,0
1203490,True,0,No user reviews,0,0,0
1203500,True,0,3 user reviews,3,0,3
1203510,True,7,Positive,18,2,20
1203520,True,0,No user reviews,0,0,0
1203530,True,0,1 user reviews,0,1,1
1203540,True,0,1 user reviews,1,0,1
1203541,True,0,1 user reviews,1,0,1
1203542,True,0,1 user reviews,0,1,1
1203543,True,0,No user reviews,0,0,0
1203560,True,7,Positive,27,6,33
1203570,True,7,Positive,11,1,12
1203580,True,0,2 user reviews,2,0,2
1203600,True,0,No user reviews,0,0,0
1203630,True,8,Very Positive,461,21,482
1203640,True,0,2 user reviews,2,0,2
1203650,True,5,Mixed,14,12,26
1203680,True,0,No user reviews,0,0,0
1203700,True,0,No user reviews,0,0,0
1203710,True,0,No user reviews,0,0,0
1203720,True,0,4 user reviews,2,2,4
1203740,True,0,No user reviews,0,0,0
1203750,True,0,8 user reviews,8,0,8
1203760,True,0,4 user reviews,2,2,4
1203770,True,0,4 user reviews,2,2,4
1203780,True,0,No user reviews,0,0,0
1203790,True,0,5 user reviews,5,0,5
1203800,True,0,No user reviews,0,0,0
1203810,True,0,No user reviews,0,0,0
1203830,True,0,1 user reviews,1,0,1
1203850,True,0,4 user reviews,4,0,4
1203880,True,0,No user reviews,0,0,0
1203890,True,0,No user reviews,0,0,0
1203900,True,0,No user reviews,0,0,0
1203910,True,0,No user reviews,0,0,0
1203930,True,6,Mostly Positive,184,47,231
1203950,True,0,No user reviews,0,0,0
1203960,True,0,7 user reviews,5,2,7
1203970,True,7,Positive,10,0,10
1203980,True,0,No user reviews,0,0,0
1203990,True,0,6 user reviews,5,1,6
1204010,True,0,No user reviews,0,0,0
1204020,True,0,No user reviews,0,0,0
1204030,True,0,1 user reviews,1,0,1
1204040,True,0,No user reviews,0,0,0
1204050,True,0,No user reviews,0,0,0
1204070,True,0,3 user reviews,3,0,3
1204080,True,0,No user reviews,0,0,0
1204090,True,0,No user reviews,0,0,0
1204100,True,0,1 user reviews,1,0,1
1204110,True,0,No user reviews,0,0,0
1204130,True,8,Very Positive,145,4,149
1204160,True,0,No user reviews,0,0,0
1204170,True,0,No user reviews,0,0,0
1204200,True,0,2 user reviews,2,0,2
1204210,True,0,2 user reviews,2,0,2
1204220,True,7,Positive,9,2,11
1204230,True,6,Mostly Positive,23,6,29
1204240,True,0,No user reviews,0,0,0
1204250,True,0,No user reviews,0,0,0
1204260,True,0,No user reviews,0,0,0
1204270,True,0,2 user reviews,1,1,2
1204280,True,0,4 user reviews,4,0,4
1204320,True,0,9 user reviews,9,0,9
1204330,True,0,No user reviews,0,0,0
1204340,True,0,No user reviews,0,0,0
1204360,True,0,No user reviews,0,0,0
1204370,True,7,Positive,20,4,24
1204380,True,0,No user reviews,0,0,0
1204400,True,0,No user reviews,0,0,0
1204410,True,0,No user reviews,0,0,0
1204420,True,0,No user reviews,0,0,0
1204440,True,0,No user reviews,0,0,0
1204460,True,0,No user reviews,0,0,0
1204470,True,7,Positive,14,1,15
1204480,True,0,1 user reviews,1,0,1
1204490,True,0,No user reviews,0,0,0
1204500,True,0,No user reviews,0,0,0
1204530,True,0,1 user reviews,1,0,1
1204540,True,0,No user reviews,0,0,0
1204550,True,0,No user reviews,0,0,0
1204560,True,0,5 user reviews,4,1,5
1204570,True,0,No user reviews,0,0,0
1204580,True,0,3 user reviews,3,0,3
1204590,True,0,No user reviews,0,0,0
1204610,True,0,No user reviews,0,0,0
1204630,True,0,2 user reviews,2,0,2
1204640,True,0,No user reviews,0,0,0
1204650,True,0,No user reviews,0,0,0
1204660,True,0,3 user reviews,1,2,3
1204670,True,0,No user reviews,0,0,0
1204700,True,0,2 user reviews,1,1,2
1204710,True,7,Positive,13,0,13
1204720,True,8,Very Positive,104,13,117
1204740,True,0,No user reviews,0,0,0
1204760,True,0,8 user reviews,7,1,8
1204770,True,0,No user reviews,0,0,0
1204780,True,0,No user reviews,0,0,0
1204790,True,0,No user reviews,0,0,0
1204820,True,0,No user reviews,0,0,0
1204830,True,0,No user reviews,0,0,0
1204840,True,0,No user reviews,0,0,0
1204850,True,4,Mostly Negative,4,12,16
1204860,True,0,1 user reviews,0,1,1
1204870,True,0,No user reviews,0,0,0
1204880,True,0,3 user reviews,2,1,3
1204900,True,0,No user reviews,0,0,0
1204920,True,5,Mixed,12,16,28
1204930,True,0,7 user reviews,7,0,7
1204940,True,0,No user reviews,0,0,0
1204950,True,0,No user reviews,0,0,0
1204970,True,0,No user reviews,0,0,0
1205000,True,0,No user reviews,0,0,0
1205010,True,0,No user reviews,0,0,0
1205020,True,0,1 user reviews,0,1,1
1205040,True,8,Very Positive,94,3,97
1205050,True,0,No user reviews,0,0,0
1205060,True,0,5 user reviews,4,1,5
1205070,True,0,No user reviews,0,0,0
1205080,True,0,No user reviews,0,0,0
1205090,True,0,No user reviews,0,0,0
1205100,True,0,4 user reviews,1,3,4
1205110,True,0,No user reviews,0,0,0
1205111,True,0,No user reviews,0,0,0
1205112,True,0,No user reviews,0,0,0
1205113,True,0,No user reviews,0,0,0
1205114,True,0,No user reviews,0,0,0
1205115,True,0,No user reviews,0,0,0
1205120,True,0,2 user reviews,2,0,2
1205130,True,0,No user reviews,0,0,0
1205140,True,0,No user reviews,0,0,0
1205150,True,0,No user reviews,0,0,0
1205160,True,0,No user reviews,0,0,0
1205170,True,0,No user reviews,0,0,0
1205180,True,0,2 user reviews,1,1,2
1205200,True,0,No user reviews,0,0,0
1205220,True,0,No user reviews,0,0,0
1205230,True,0,1 user reviews,1,0,1
1205240,True,8,Very Positive,47,7,54
1205250,True,0,1 user reviews,1,0,1
1205260,True,0,6 user reviews,6,0,6
1205270,True,0,No user reviews,0,0,0
1205280,True,0,No user reviews,0,0,0
1205290,True,0,No user reviews,0,0,0
1205310,True,0,No user reviews,0,0,0
1205330,True,0,No user reviews,0,0,0
1205361,True,4,Mostly Negative,4,13,17
1205364,True,0,No user reviews,0,0,0
1205370,True,0,No user reviews,0,0,0
1205380,True,0,6 user reviews,1,5,6
1205390,True,0,No user reviews,0,0,0
1205400,True,0,No user reviews,0,0,0
1205410,True,0,No user reviews,0,0,0
1205420,True,0,No user reviews,0,0,0
1205430,True,5,Mixed,91,94,185
1205450,True,0,No user reviews,0,0,0
1205470,True,0,No user reviews,0,0,0
1205500,True,0,2 user reviews,2,0,2
1205501,True,0,1 user reviews,1,0,1
1205510,True,0,2 user reviews,2,0,2
1205511,True,0,No user reviews,0,0,0
1205512,True,0,No user reviews,0,0,0
1205513,True,0,No user reviews,0,0,0
1205540,True,0,7 user reviews,7,0,7
1205560,True,0,No user reviews,0,0,0
1205580,True,0,No user reviews,0,0,0
1205590,True,0,No user reviews,0,0,0
1205600,True,0,8 user reviews,3,5,8
1205620,True,0,7 user reviews,3,4,7
1205630,True,7,Positive,13,0,13
1205670,True,0,1 user reviews,1,0,1
1205680,True,0,No user reviews,0,0,0
1205690,True,0,No user reviews,0,0,0
1205730,True,0,No user reviews,0,0,0
1205750,True,0,No user reviews,0,0,0
1205760,True,0,No user reviews,0,0,0
1205761,True,0,No user reviews,0,0,0
1205762,True,0,No user reviews,0,0,0
1205780,True,0,No user reviews,0,0,0
1205781,True,0,No user reviews,0,0,0
1205782,True,0,No user reviews,0,0,0
1205783,True,0,No user reviews,0,0,0
1205784,True,0,No user reviews,0,0,0
1205785,True,0,No user reviews,0,0,0
1205786,True,0,No user reviews,0,0,0
1205787,True,0,No user reviews,0,0,0
1205788,True,0,No user reviews,0,0,0
1205789,True,0,1 user reviews,1,0,1
1205790,True,0,1 user reviews,1,0,1
1205791,True,0,No user reviews,0,0,0
1205792,True,0,No user reviews,0,0,0
1205793,True,0,No user reviews,0,0,0
1205794,True,0,No user reviews,0,0,0
1205795,True,0,No user reviews,0,0,0
1205796,True,0,No user reviews,0,0,0
1205797,True,0,No user reviews,0,0,0
1205798,True,0,No user reviews,0,0,0
1205799,True,0,No user reviews,0,0,0
1205800,True,0,1 user reviews,1,0,1
1205810,True,0,No user reviews,0,0,0
1205860,True,0,No user reviews,0,0,0
1205861,True,0,No user reviews,0,0,0
1205862,True,0,No user reviews,0,0,0
1205863,True,0,No user reviews,0,0,0
1205864,True,0,No user reviews,0,0,0
1205865,True,0,No user reviews,0,0,0
1205866,True,0,1 user reviews,0,1,1
1205867,True,0,No user reviews,0,0,0
1205868,True,0,No user reviews,0,0,0
1205869,True,0,No user reviews,0,0,0
1205870,True,0,No user reviews,0,0,0
1205880,True,0,No user reviews,0,0,0
1205881,True,0,No user reviews,0,0,0
1205882,True,0,No user reviews,0,0,0
1205883,True,0,No user reviews,0,0,0
1205884,True,0,No user reviews,0,0,0
1205885,True,0,No user reviews,0,0,0
1205886,True,0,No user reviews,0,0,0
1205887,True,0,1 user reviews,0,1,1
1205890,True,0,No user reviews,0,0,0
1205900,True,7,Positive,46,1,47
1205930,True,7,Positive,10,0,10
1205950,True,8,Very Positive,117,17,134
1205960,True,8,Very Positive,77,8,85
1205980,True,0,No user reviews,0,0,0
1206000,True,0,7 user reviews,5,2,7
1206010,True,0,No user reviews,0,0,0
1206020,True,0,No user reviews,0,0,0
1206040,True,0,4 user reviews,3,1,4
1206050,True,0,1 user reviews,1,0,1
1206080,True,0,4 user reviews,0,4,4
1206090,True,0,No user reviews,0,0,0
1206110,True,0,7 user reviews,6,1,7
1206140,True,0,2 user reviews,1,1,2
1206150,True,0,No user reviews,0,0,0
1206160,True,0,No user reviews,0,0,0
1206170,True,0,No user reviews,0,0,0
1206180,True,0,1 user reviews,0,1,1
1206190,True,0,3 user reviews,3,0,3
1206200,True,5,Mixed,195,241,436
1206210,True,0,No user reviews,0,0,0
1206220,True,0,No user reviews,0,0,0
1206230,True,0,5 user reviews,3,2,5
1206240,True,0,No user reviews,0,0,0
1206260,True,0,4 user reviews,4,0,4
1206270,True,0,2 user reviews,2,0,2
1206280,True,0,2 user reviews,2,0,2
1206290,True,0,6 user reviews,6,0,6
1206310,True,0,1 user reviews,1,0,1
1206320,True,0,1 user reviews,0,1,1
1206330,True,0,4 user reviews,4,0,4
1206340,True,7,Positive,28,0,28
1206350,True,0,3 user reviews,3,0,3
1206380,True,0,1 user reviews,1,0,1
1206390,True,0,No user reviews,0,0,0
1206400,True,0,No user reviews,0,0,0
1206430,True,8,Very Positive,109,21,130
1206440,True,0,No user reviews,0,0,0
1206460,True,0,1 user reviews,0,1,1
1206470,True,0,4 user reviews,4,0,4
1206480,True,5,Mixed,17,13,30
1206490,True,5,Mixed,12,9,21
1206500,True,0,No user reviews,0,0,0
1206510,True,0,No user reviews,0,0,0
1206540,True,0,No user reviews,0,0,0
1206541,True,0,No user reviews,0,0,0
1206550,True,0,No user reviews,0,0,0
1206570,True,0,3 user reviews,2,1,3
1206590,True,0,No user reviews,0,0,0
1206600,True,0,No user reviews,0,0,0
1206610,True,0,No user reviews,0,0,0
1206620,True,0,5 user reviews,5,0,5
1206630,True,0,1 user reviews,1,0,1
1206640,True,0,1 user reviews,1,0,1
1206650,True,0,No user reviews,0,0,0
1206660,True,0,2 user reviews,1,1,2
1206670,True,7,Positive,33,1,34
1206681,True,0,No user reviews,0,0,0
1206682,True,0,1 user reviews,0,1,1
1206683,True,0,1 user reviews,1,0,1
1206685,True,0,No user reviews,0,0,0
1206688,True,0,No user reviews,0,0,0
1206689,True,0,No user reviews,0,0,0
1206690,True,0,No user reviews,0,0,0
1206700,True,7,Positive,10,2,12
1206710,True,0,No user reviews,0,0,0
1206720,True,0,3 user reviews,2,1,3
1206730,True,0,1 user reviews,0,1,1
1206740,True,0,No user reviews,0,0,0
1206750,True,0,No user reviews,0,0,0
1206760,True,0,No user reviews,0,0,0
1206761,True,0,No user reviews,0,0,0
1206762,True,0,No user reviews,0,0,0
1206770,True,0,4 user reviews,4,0,4
1206790,True,0,No user reviews,0,0,0
1206800,True,0,No user reviews,0,0,0
1206810,True,0,2 user reviews,2,0,2
1206820,True,0,No user reviews,0,0,0
1206821,True,0,2 user reviews,2,0,2
1206830,True,0,No user reviews,0,0,0
1206840,True,0,2 user reviews,0,2,2
1206870,True,0,No user reviews,0,0,0
1206900,True,0,3 user reviews,3,0,3
1206910,True,0,4 user reviews,4,0,4
1206920,True,0,No user reviews,0,0,0
1206930,True,0,No user reviews,0,0,0
1206940,True,7,Positive,11,1,12
1206950,True,0,No user reviews,0,0,0
1206960,True,5,Mixed,5,6,11
1206980,True,0,No user reviews,0,0,0
1206990,True,0,No user reviews,0,0,0
1207000,True,0,7 user reviews,7,0,7
1207010,True,0,No user reviews,0,0,0
1207020,True,0,No user reviews,0,0,0
1207030,True,5,Mixed,5,7,12
1207050,True,0,No user reviews,0,0,0
1207070,True,0,No user reviews,0,0,0
1207071,True,0,No user reviews,0,0,0
1207072,True,0,No user reviews,0,0,0
1207073,True,0,No user reviews,0,0,0
1207074,True,0,No user reviews,0,0,0
1207075,True,0,No user reviews,0,0,0
1207076,True,0,No user reviews,0,0,0
1207077,True,0,No user reviews,0,0,0
1207078,True,0,No user reviews,0,0,0
1207079,True,0,No user reviews,0,0,0
1207080,True,0,No user reviews,0,0,0
1207081,True,0,No user reviews,0,0,0
1207082,True,0,No user reviews,0,0,0
1207110,True,0,No user reviews,0,0,0
1207130,True,0,1 user reviews,1,0,1
1207140,True,0,No user reviews,0,0,0
1207160,True,0,No user reviews,0,0,0
1207170,True,0,No user reviews,0,0,0
1207210,True,0,1 user reviews,1,0,1
1207220,True,0,No user reviews,0,0,0
1207230,True,0,5 user reviews,5,0,5
1207240,True,0,1 user reviews,1,0,1
1207260,True,0,2 user reviews,2,0,2
1207270,True,0,No user reviews,0,0,0
1207290,True,0,No user reviews,0,0,0
1207310,True,0,8 user reviews,8,0,8
1207320,True,0,8 user reviews,7,1,8
1207330,True,0,No user reviews,0,0,0
1207350,True,0,No user reviews,0,0,0
1207351,True,0,No user reviews,0,0,0
1207360,True,0,No user reviews,0,0,0
1207370,True,0,No user reviews,0,0,0
1207380,True,0,4 user reviews,3,1,4
1207390,True,0,No user reviews,0,0,0
1207400,True,0,4 user reviews,4,0,4
1207420,True,0,3 user reviews,3,0,3
1207430,True,0,No user reviews,0,0,0
1207450,True,0,No user reviews,0,0,0
1207460,True,0,1 user reviews,1,0,1
1207480,True,0,5 user reviews,4,1,5
1207500,True,0,1 user reviews,1,0,1
1207510,True,0,No user reviews,0,0,0
1207520,True,0,1 user reviews,1,0,1
1207530,True,0,No user reviews,0,0,0
1207540,True,0,5 user reviews,5,0,5
1207550,True,0,No user reviews,0,0,0
1207560,True,0,No user reviews,0,0,0
1207590,True,0,No user reviews,0,0,0
1207600,True,0,No user reviews,0,0,0
1207610,True,0,No user reviews,0,0,0
1207650,True,0,No user reviews,0,0,0
1207660,True,0,1 user reviews,1,0,1
1207670,True,0,No user reviews,0,0,0
1207690,True,0,No user reviews,0,0,0
1207710,True,0,7 user reviews,5,2,7
1207750,True,0,No user reviews,0,0,0
1207760,True,0,No user reviews,0,0,0
1207770,True,0,No user reviews,0,0,0
1207780,True,8,Very Positive,242,25,267
1207800,True,0,No user reviews,0,0,0
1207830,True,0,No user reviews,0,0,0
1207840,True,0,5 user reviews,5,0,5
1207850,True,5,Mixed,11,15,26
1207860,True,0,3 user reviews,3,0,3
1207880,True,7,Positive,29,4,33
1207890,True,0,No user reviews,0,0,0
1207900,True,0,No user reviews,0,0,0
1207910,True,0,No user reviews,0,0,0
1207920,True,0,No user reviews,0,0,0
1207930,True,0,No user reviews,0,0,0
1207950,True,0,No user reviews,0,0,0
1207960,True,0,No user reviews,0,0,0
1207970,True,0,No user reviews,0,0,0
1207980,True,0,No user reviews,0,0,0
1208030,True,0,3 user reviews,3,0,3
1208040,True,0,No user reviews,0,0,0
1208050,True,0,1 user reviews,1,0,1
1208060,True,0,No user reviews,0,0,0
1208080,True,0,1 user reviews,1,0,1
1208090,True,0,4 user reviews,0,4,4
1208100,True,0,No user reviews,0,0,0
1208110,True,0,No user reviews,0,0,0
1208120,True,0,3 user reviews,1,2,3
1208140,True,0,No user reviews,0,0,0
1208160,True,0,No user reviews,0,0,0
1208170,True,0,No user reviews,0,0,0
1208180,True,0,No user reviews,0,0,0
1208210,True,0,No user reviews,0,0,0
1208220,True,7,Positive,9,2,11
1208240,True,0,No user reviews,0,0,0
1208250,True,0,No user reviews,0,0,0
1208260,True,8,Very Positive,124,13,137
1208270,True,0,No user reviews,0,0,0
1208280,True,0,No user reviews,0,0,0
1208290,True,0,No user reviews,0,0,0
1208291,True,0,No user reviews,0,0,0
1208292,True,0,1 user reviews,0,1,1
1208310,True,0,No user reviews,0,0,0
1208330,True,0,6 user reviews,4,2,6
1208360,True,0,No user reviews,0,0,0
1208370,True,0,No user reviews,0,0,0
1208380,True,0,No user reviews,0,0,0
1208390,True,0,No user reviews,0,0,0
1208400,True,0,1 user reviews,1,0,1
1208420,True,0,No user reviews,0,0,0
1208430,True,0,No user reviews,0,0,0
1208440,True,0,4 user reviews,4,0,4
1208460,True,0,No user reviews,0,0,0
1208470,True,0,1 user reviews,0,1,1
1208480,True,0,No user reviews,0,0,0
1208490,True,0,4 user reviews,2,2,4
1208500,True,0,No user reviews,0,0,0
1208510,True,0,No user reviews,0,0,0
1208520,True,0,No user reviews,0,0,0
1208550,True,0,2 user reviews,2,0,2
1208560,True,0,No user reviews,0,0,0
1208580,True,0,2 user reviews,2,0,2
1208590,True,0,No user reviews,0,0,0
1208600,True,8,Very Positive,90,9,99
1208620,True,0,No user reviews,0,0,0
1208650,True,0,No user reviews,0,0,0
1208660,True,0,7 user reviews,7,0,7
1208730,True,0,No user reviews,0,0,0
1208760,True,0,9 user reviews,8,1,9
1208770,True,6,Mostly Positive,64,26,90
1208810,True,7,Positive,21,0,21
1208820,True,0,No user reviews,0,0,0
1208830,True,0,No user reviews,0,0,0
1208840,True,0,No user reviews,0,0,0
1208850,True,0,3 user reviews,3,0,3
1208860,True,0,No user reviews,0,0,0
1208870,True,0,No user reviews,0,0,0
1208880,True,0,4 user reviews,3,1,4
1208890,True,0,No user reviews,0,0,0
1208900,True,0,7 user reviews,6,1,7
1208940,True,0,No user reviews,0,0,0
1208950,True,0,3 user reviews,1,2,3
1208970,True,0,No user reviews,0,0,0
1208980,True,0,No user reviews,0,0,0
1209000,True,0,2 user reviews,1,1,2
1209040,True,0,No user reviews,0,0,0
1209060,True,0,4 user reviews,0,4,4
1209080,True,0,No user reviews,0,0,0
1209110,True,6,Mostly Positive,108,32,140
1209120,True,6,Mostly Positive,386,145,531
1209121,True,0,No user reviews,0,0,0
1209130,True,4,Mostly Negative,14,24,38
1209131,True,0,1 user reviews,1,0,1
1209132,True,0,7 user reviews,3,4,7
1209133,True,0,5 user reviews,2,3,5
1209134,True,0,2 user reviews,2,0,2
1209135,True,0,2 user reviews,2,0,2
1209140,True,0,1 user reviews,1,0,1
1209150,True,5,Mixed,7,7,14
1209160,True,0,1 user reviews,1,0,1
1209170,True,0,2 user reviews,1,1,2
1209180,True,0,No user reviews,0,0,0
1209190,True,0,3 user reviews,1,2,3
1209200,True,0,4 user reviews,1,3,4
1209210,True,0,No user reviews,0,0,0
1209220,True,0,No user reviews,0,0,0
1209230,True,0,No user reviews,0,0,0
1209240,True,0,No user reviews,0,0,0
1209250,True,0,No user reviews,0,0,0
1209260,True,0,No user reviews,0,0,0
1209300,True,0,No user reviews,0,0,0
1209310,True,0,No user reviews,0,0,0
1209330,True,7,Positive,14,3,17
1209340,True,0,No user reviews,0,0,0
1209360,True,6,Mostly Positive,9,3,12
1209400,True,0,No user reviews,0,0,0
1209410,True,0,No user reviews,0,0,0
1209420,True,0,No user reviews,0,0,0
1209430,True,7,Positive,13,3,16
1209440,True,0,4 user reviews,3,1,4
1209450,True,7,Positive,22,0,22
1209460,True,0,No user reviews,0,0,0
1209461,True,5,Mixed,28,23,51
1209470,True,8,Very Positive,186,21,207
1209471,True,0,No user reviews,0,0,0
1209480,True,0,1 user reviews,0,1,1
1209490,True,8,Very Positive,526,110,636
1209500,True,0,No user reviews,0,0,0
1209510,True,0,No user reviews,0,0,0
1209520,True,0,3 user reviews,3,0,3
1209530,True,0,6 user reviews,6,0,6
1209531,True,0,8 user reviews,7,1,8
1209532,True,7,Positive,15,0,15
1209540,True,0,No user reviews,0,0,0
1209560,True,0,1 user reviews,1,0,1
1209570,True,0,6 user reviews,6,0,6
1209580,True,0,No user reviews,0,0,0
1209590,True,0,1 user reviews,1,0,1
1209600,True,0,No user reviews,0,0,0
1209610,True,0,No user reviews,0,0,0
1209620,True,0,No user reviews,0,0,0
1209621,True,0,No user reviews,0,0,0
1209630,True,0,No user reviews,0,0,0
1209640,True,0,No user reviews,0,0,0
1209641,True,0,No user reviews,0,0,0
1209650,True,0,7 user reviews,6,1,7
1209690,True,0,No user reviews,0,0,0
1209700,True,0,No user reviews,0,0,0
1209710,True,0,No user reviews,0,0,0
1209720,True,0,4 user reviews,2,2,4
1209740,True,5,Mixed,6,5,11
1209750,True,0,No user reviews,0,0,0
1209760,True,0,2 user reviews,1,1,2
1209770,True,0,No user reviews,0,0,0
1209820,True,0,No user reviews,0,0,0
1209860,True,0,No user reviews,0,0,0
1209870,True,0,No user reviews,0,0,0
1209900,True,0,3 user reviews,3,0,3
1209910,True,7,Positive,34,6,40
1209950,True,0,No user reviews,0,0,0
1209960,True,0,No user reviews,0,0,0
1209970,True,0,No user reviews,0,0,0
1209980,True,0,No user reviews,0,0,0
1209990,True,0,No user reviews,0,0,0
1210000,True,0,2 user reviews,2,0,2
1210010,True,0,9 user reviews,8,1,9
1210030,True,0,4 user reviews,4,0,4
1210041,True,0,No user reviews,0,0,0
1210060,True,0,4 user reviews,3,1,4
1210070,True,0,No user reviews,0,0,0
1210080,True,0,No user reviews,0,0,0
1210090,True,0,1 user reviews,1,0,1
1210091,True,0,No user reviews,0,0,0
1210110,True,5,Mixed,101,49,150
1210130,True,0,No user reviews,0,0,0
1210131,True,0,No user reviews,0,0,0
1210132,True,0,No user reviews,0,0,0
1210133,True,0,No user reviews,0,0,0
1210150,True,0,8 user reviews,7,1,8
1210170,True,0,8 user reviews,5,3,8
1210171,True,5,Mixed,5,6,11
1210180,True,0,No user reviews,0,0,0
1210200,True,0,No user reviews,0,0,0
1210220,True,0,No user reviews,0,0,0
1210230,True,7,Positive,31,0,31
1210250,True,0,5 user reviews,5,0,5
1210270,True,0,3 user reviews,3,0,3
1210280,True,0,No user reviews,0,0,0
1210290,True,0,No user reviews,0,0,0
1210300,True,0,1 user reviews,1,0,1
1210330,True,0,6 user reviews,6,0,6
1210340,True,0,4 user reviews,4,0,4
1210350,True,0,No user reviews,0,0,0
1210360,True,0,No user reviews,0,0,0
1210380,True,0,No user reviews,0,0,0
1210400,True,0,No user reviews,0,0,0
1210410,True,0,No user reviews,0,0,0
1210470,True,0,No user reviews,0,0,0
1210490,True,0,No user reviews,0,0,0
1210520,True,0,No user reviews,0,0,0
1210530,True,0,No user reviews,0,0,0
1210570,True,0,5 user reviews,5,0,5
1210590,True,0,No user reviews,0,0,0
1210600,True,0,No user reviews,0,0,0
1210610,True,8,Very Positive,81,6,87
1210620,True,0,7 user reviews,5,2,7
1210630,True,0,No user reviews,0,0,0
1210640,True,0,No user reviews,0,0,0
1210650,True,0,No user reviews,0,0,0
1210660,True,7,Positive,10,0,10
1210670,True,0,No user reviews,0,0,0
1210680,True,0,No user reviews,0,0,0
1210700,True,0,2 user reviews,1,1,2
1210730,True,0,No user reviews,0,0,0
1210740,True,0,No user reviews,0,0,0
1210750,True,0,No user reviews,0,0,0
1210770,True,0,6 user reviews,4,2,6
1210780,True,0,No user reviews,0,0,0
1210790,True,0,2 user reviews,2,0,2
1210800,True,7,Positive,27,0,27
1210810,True,0,No user reviews,0,0,0
1210820,True,0,4 user reviews,1,3,4
1210830,True,0,5 user reviews,4,1,5
1210840,True,0,No user reviews,0,0,0
1210850,True,0,No user reviews,0,0,0
1210870,True,7,Positive,15,1,16
1210880,True,0,2 user reviews,1,1,2
1210910,True,0,No user reviews,0,0,0
1210920,True,0,No user reviews,0,0,0
1210940,True,0,No user reviews,0,0,0
1210950,True,0,No user reviews,0,0,0
1210960,True,0,1 user reviews,1,0,1
1210970,True,0,3 user reviews,3,0,3
1210990,True,0,No user reviews,0,0,0
1211000,True,0,No user reviews,0,0,0
1211020,True,8,Very Positive,161,8,169
1211050,True,0,No user reviews,0,0,0
1211060,True,0,No user reviews,0,0,0
1211070,True,0,1 user reviews,1,0,1
1211080,True,0,No user reviews,0,0,0
1211090,True,0,No user reviews,0,0,0
1211100,True,0,2 user reviews,2,0,2
1211110,True,8,Very Positive,58,1,59
1211140,True,0,No user reviews,0,0,0
1211150,True,0,No user reviews,0,0,0
1211160,True,0,No user reviews,0,0,0
1211170,True,7,Positive,10,1,11
1211171,True,0,2 user reviews,2,0,2
1211172,True,0,No user reviews,0,0,0
1211173,True,0,8 user reviews,8,0,8
1211174,True,7,Positive,45,4,49
1211175,True,0,2 user reviews,2,0,2
1211176,True,0,6 user reviews,6,0,6
1211177,True,0,3 user reviews,3,0,3
1211178,True,7,Positive,10,0,10
1211179,True,0,3 user reviews,3,0,3
1211200,True,0,2 user reviews,2,0,2
1211201,True,0,5 user reviews,4,1,5
1211202,True,0,3 user reviews,2,1,3
1211203,True,0,2 user reviews,2,0,2
1211204,True,0,3 user reviews,3,0,3
1211205,True,0,3 user reviews,2,1,3
1211206,True,0,7 user reviews,7,0,7
1211207,True,0,5 user reviews,5,0,5
1211208,True,7,Positive,10,0,10
1211209,True,7,Positive,10,0,10
1211220,True,0,No user reviews,0,0,0
1211230,True,0,No user reviews,0,0,0
1211240,True,0,No user reviews,0,0,0
1211260,True,0,No user reviews,0,0,0
1211270,True,0,No user reviews,0,0,0
1211280,True,0,No user reviews,0,0,0
1211290,True,0,No user reviews,0,0,0
1211300,True,0,No user reviews,0,0,0
1211301,True,0,No user reviews,0,0,0
1211302,True,0,No user reviews,0,0,0
1211303,True,0,No user reviews,0,0,0
1211310,True,0,No user reviews,0,0,0
1211311,True,0,No user reviews,0,0,0
1211312,True,0,No user reviews,0,0,0
1211313,True,0,No user reviews,0,0,0
1211314,True,0,No user reviews,0,0,0
1211320,True,0,2 user reviews,0,2,2
1211340,True,0,No user reviews,0,0,0
1211350,True,0,No user reviews,0,0,0
1211360,True,6,Mostly Positive,42,15,57
1211390,True,0,No user reviews,0,0,0
1211420,True,0,3 user reviews,0,3,3
1211460,True,0,No user reviews,0,0,0
1211470,True,7,Positive,17,2,19
1211471,True,0,3 user reviews,1,2,3
1211472,True,0,2 user reviews,2,0,2
1211473,True,0,4 user reviews,4,0,4
1211474,True,0,4 user reviews,3,1,4
1211475,True,5,Mixed,4,6,10
1211476,True,0,9 user reviews,5,4,9
1211478,True,4,Mostly Negative,3,7,10
1211479,True,0,5 user reviews,4,1,5
1211480,True,6,Mostly Positive,38,10,48
1211490,True,0,3 user reviews,2,1,3
1211530,True,0,No user reviews,0,0,0
1211540,True,0,3 user reviews,3,0,3
1211590,True,0,No user reviews,0,0,0
1211610,True,0,1 user reviews,1,0,1
1211630,True,8,Very Positive,301,13,314
1211640,True,5,Mixed,6,8,14
1211650,True,0,No user reviews,0,0,0
1211671,True,0,1 user reviews,1,0,1
1211672,True,0,3 user reviews,3,0,3
1211673,True,0,5 user reviews,4,1,5
1211674,True,0,1 user reviews,1,0,1
1211675,True,0,No user reviews,0,0,0
1211676,True,0,3 user reviews,3,0,3
1211677,True,0,No user reviews,0,0,0
1211678,True,0,1 user reviews,1,0,1
1211679,True,0,No user reviews,0,0,0
1211680,True,0,3 user reviews,1,2,3
1211681,True,0,1 user reviews,1,0,1
1211682,True,0,No user reviews,0,0,0
1211683,True,0,No user reviews,0,0,0
1211690,True,0,No user reviews,0,0,0
1211700,True,0,No user reviews,0,0,0
1211710,True,0,No user reviews,0,0,0
1211730,True,0,No user reviews,0,0,0
1211740,True,0,No user reviews,0,0,0
1211770,True,0,No user reviews,0,0,0
1211780,True,0,1 user reviews,0,1,1
1211790,True,0,No user reviews,0,0,0
1211800,True,0,No user reviews,0,0,0
1211820,True,0,1 user reviews,1,0,1
1211830,True,0,No user reviews,0,0,0
1211850,True,0,No user reviews,0,0,0
1211860,True,0,No user reviews,0,0,0
1211880,True,0,No user reviews,0,0,0
1211900,True,0,3 user reviews,2,1,3
1211930,True,0,No user reviews,0,0,0
1211940,True,0,No user reviews,0,0,0
1211950,True,0,2 user reviews,2,0,2
1211960,True,5,Mixed,5,5,10
1211970,True,0,No user reviews,0,0,0
1211980,True,0,No user reviews,0,0,0
1212000,True,0,No user reviews,0,0,0
1212020,True,8,Very Positive,95,15,110
1212030,True,0,No user reviews,0,0,0
1212040,True,0,4 user reviews,2,2,4
1212060,True,0,No user reviews,0,0,0
1212080,True,0,7 user reviews,4,3,7
1212090,True,0,3 user reviews,2,1,3
1212100,True,7,Positive,23,4,27
1212110,True,7,Positive,11,0,11
1212170,True,0,8 user reviews,6,2,8
1212180,True,0,No user reviews,0,0,0
1212190,True,0,9 user reviews,8,1,9
1212220,True,0,No user reviews,0,0,0
1212290,True,0,2 user reviews,1,1,2
1212300,True,0,6 user reviews,6,0,6
1212320,True,0,1 user reviews,1,0,1
1212330,True,0,No user reviews,0,0,0
1212340,True,0,No user reviews,0,0,0
1212360,True,0,No user reviews,0,0,0
1212370,True,0,3 user reviews,3,0,3
1212380,True,0,No user reviews,0,0,0
1212400,True,7,Positive,36,3,39
1212410,True,0,No user reviews,0,0,0
1212430,True,0,No user reviews,0,0,0
1212440,True,0,2 user reviews,2,0,2
1212450,True,0,2 user reviews,0,2,2
1212460,True,0,No user reviews,0,0,0
1212470,True,0,1 user reviews,0,1,1
1212480,True,0,No user reviews,0,0,0
1212490,True,0,No user reviews,0,0,0
1212500,True,0,No user reviews,0,0,0
1212510,True,0,No user reviews,0,0,0
1212530,True,0,2 user reviews,1,1,2
1212540,True,0,No user reviews,0,0,0
1212550,True,0,No user reviews,0,0,0
1212580,True,0,No user reviews,0,0,0
1212590,True,0,2 user reviews,2,0,2
1212600,True,0,5 user reviews,0,5,5
1212610,True,0,3 user reviews,1,2,3
1212620,True,8,Very Positive,188,13,201
1212630,True,0,No user reviews,0,0,0
1212640,True,0,2 user reviews,2,0,2
1212660,True,0,No user reviews,0,0,0
1212670,True,0,No user reviews,0,0,0
1212680,True,0,No user reviews,0,0,0
1212690,True,0,No user reviews,0,0,0
1212710,True,0,1 user reviews,1,0,1
1212730,True,0,No user reviews,0,0,0
1212740,True,0,No user reviews,0,0,0
1212750,True,0,2 user reviews,0,2,2
1212760,True,0,No user reviews,0,0,0
1212780,True,0,No user reviews,0,0,0
1212800,True,0,No user reviews,0,0,0
1212801,True,0,No user reviews,0,0,0
1212802,True,0,No user reviews,0,0,0
1212803,True,0,No user reviews,0,0,0
1212804,True,0,No user reviews,0,0,0
1212805,True,0,No user reviews,0,0,0
1212806,True,0,No user reviews,0,0,0
1212807,True,0,No user reviews,0,0,0
1212808,True,0,No user reviews,0,0,0
1212809,True,0,No user reviews,0,0,0
1212810,True,0,1 user reviews,1,0,1
1212811,True,0,No user reviews,0,0,0
1212812,True,0,No user reviews,0,0,0
1212813,True,0,No user reviews,0,0,0
1212814,True,0,No user reviews,0,0,0
1212815,True,0,No user reviews,0,0,0
1212816,True,0,No user reviews,0,0,0
1212817,True,0,3 user reviews,3,0,3
1212830,True,6,Mostly Positive,61,26,87
1212840,True,0,No user reviews,0,0,0
1212850,True,0,No user reviews,0,0,0
1212860,True,0,1 user reviews,1,0,1
1212870,True,0,No user reviews,0,0,0
1212880,True,0,No user reviews,0,0,0
1212890,True,0,No user reviews,0,0,0
1212900,True,0,No user reviews,0,0,0
1212910,True,0,2 user reviews,2,0,2
1212930,True,0,3 user reviews,2,1,3
1212940,True,8,Very Positive,85,15,100
1212960,True,0,No user reviews,0,0,0
1212970,True,0,No user reviews,0,0,0
1212980,True,0,No user reviews,0,0,0
1213000,True,0,1 user reviews,1,0,1
1213010,True,0,No user reviews,0,0,0
1213020,True,0,No user reviews,0,0,0
1213070,True,0,2 user reviews,1,1,2
1213100,True,0,No user reviews,0,0,0
1213110,True,0,No user reviews,0,0,0
1213140,True,0,2 user reviews,2,0,2
1213160,True,0,No user reviews,0,0,0
1213180,True,0,8 user reviews,5,3,8
1213190,True,0,No user reviews,0,0,0
1213200,True,0,No user reviews,0,0,0
1213210,True,8,Very Positive,7754,649,8403
1213220,True,0,No user reviews,0,0,0
1213230,True,0,No user reviews,0,0,0
1213250,True,0,No user reviews,0,0,0
1213270,True,0,No user reviews,0,0,0
1213310,True,0,2 user reviews,0,2,2
1213320,True,0,No user reviews,0,0,0
1213330,True,0,3 user reviews,2,1,3
1213331,True,0,No user reviews,0,0,0
1213332,True,0,No user reviews,0,0,0
1213353,True,0,No user reviews,0,0,0
1213354,True,0,No user reviews,0,0,0
1213355,True,0,No user reviews,0,0,0
1213370,True,7,Positive,11,1,12
1213380,True,0,No user reviews,0,0,0
1213381,True,0,No user reviews,0,0,0
1213382,True,0,No user reviews,0,0,0
1213383,True,0,No user reviews,0,0,0
1213384,True,0,No user reviews,0,0,0
1213385,True,0,No user reviews,0,0,0
1213386,True,0,No user reviews,0,0,0
1213390,True,6,Mostly Positive,12,4,16
1213400,True,0,No user reviews,0,0,0
1213410,True,0,No user reviews,0,0,0
1213420,True,0,2 user reviews,1,1,2
1213440,True,6,Mostly Positive,8,3,11
1213450,True,0,No user reviews,0,0,0
1213460,True,0,No user reviews,0,0,0
1213470,True,0,No user reviews,0,0,0
1213480,True,0,1 user reviews,0,1,1
1213490,True,0,No user reviews,0,0,0
1213491,True,0,No user reviews,0,0,0
1213500,True,0,No user reviews,0,0,0
1213510,True,0,No user reviews,0,0,0
1213520,True,0,No user reviews,0,0,0
1213540,True,0,9 user reviews,6,3,9
1213550,True,7,Positive,19,0,19
1213560,True,0,No user reviews,0,0,0
1213570,True,7,Positive,11,0,11
1213590,True,0,2 user reviews,0,2,2
1213600,True,0,2 user reviews,1,1,2
1213610,True,0,No user reviews,0,0,0
1213611,True,0,No user reviews,0,0,0
1213613,True,0,No user reviews,0,0,0
1213640,True,0,3 user reviews,2,1,3
1213650,True,0,No user reviews,0,0,0
1213660,True,0,2 user reviews,2,0,2
1213670,True,0,No user reviews,0,0,0
1213680,True,6,Mostly Positive,17,5,22
1213700,True,8,Very Positive,218,26,244
1213740,True,6,Mostly Positive,105,32,137
1213750,True,8,Very Positive,208,16,224
1213760,True,0,1 user reviews,1,0,1
1213770,True,0,7 user reviews,7,0,7
1213780,True,0,2 user reviews,1,1,2
1213800,True,0,No user reviews,0,0,0
1213810,True,0,No user reviews,0,0,0
1213820,True,0,No user reviews,0,0,0
1213860,True,0,3 user reviews,2,1,3
1213870,True,0,1 user reviews,1,0,1
1213890,True,0,1 user reviews,1,0,1
1213940,True,7,Positive,14,0,14
1213950,True,0,5 user reviews,4,1,5
1213970,True,0,No user reviews,0,0,0
1213980,True,0,No user reviews,0,0,0
1214000,True,0,No user reviews,0,0,0
1214050,True,0,No user reviews,0,0,0
1214060,True,0,No user reviews,0,0,0
1214090,True,0,No user reviews,0,0,0
1214091,True,0,No user reviews,0,0,0
1214092,True,0,No user reviews,0,0,0
1214093,True,0,No user reviews,0,0,0
1214094,True,0,No user reviews,0,0,0
1214095,True,0,No user reviews,0,0,0
1214096,True,0,No user reviews,0,0,0
1214110,True,0,No user reviews,0,0,0
1214111,True,0,No user reviews,0,0,0
1214112,True,0,No user reviews,0,0,0
1214113,True,0,No user reviews,0,0,0
1214114,True,0,No user reviews,0,0,0
1214115,True,0,No user reviews,0,0,0
1214116,True,0,No user reviews,0,0,0
1214130,True,0,1 user reviews,1,0,1
1214150,True,0,2 user reviews,1,1,2
1214170,True,0,1 user reviews,1,0,1
1214180,True,0,No user reviews,0,0,0
1214200,True,0,No user reviews,0,0,0
1214210,True,0,No user reviews,0,0,0
1214230,True,0,No user reviews,0,0,0
1214250,True,0,No user reviews,0,0,0
1214280,True,0,No user reviews,0,0,0
1214290,True,0,1 user reviews,1,0,1
1214310,True,0,No user reviews,0,0,0
1214320,True,0,1 user reviews,1,0,1
1214330,True,8,Very Positive,70,7,77
1214350,True,0,No user reviews,0,0,0
1214360,True,0,No user reviews,0,0,0
1214380,True,0,No user reviews,0,0,0
1214390,True,0,No user reviews,0,0,0
1214400,True,0,2 user reviews,1,1,2
1214410,True,7,Positive,10,0,10
1214420,True,8,Very Positive,574,101,675
1214430,True,0,No user reviews,0,0,0
1214440,True,0,No user reviews,0,0,0
1214450,True,8,Very Positive,61,4,65
1214460,True,0,1 user reviews,1,0,1
1214470,True,0,No user reviews,0,0,0
1214480,True,7,Positive,17,4,21
1214490,True,0,No user reviews,0,0,0
1214500,True,0,No user reviews,0,0,0
1214520,True,7,Positive,17,0,17
1214530,True,0,1 user reviews,1,0,1
1214540,True,0,1 user reviews,1,0,1
1214550,True,0,No user reviews,0,0,0
1214551,True,0,No user reviews,0,0,0
1214552,True,0,No user reviews,0,0,0
1214553,True,0,No user reviews,0,0,0
1214554,True,0,No user reviews,0,0,0
1214555,True,0,No user reviews,0,0,0
1214556,True,0,No user reviews,0,0,0
1214557,True,0,No user reviews,0,0,0
1214570,True,7,Positive,18,1,19
1214590,True,0,2 user reviews,1,1,2
1214600,True,0,4 user reviews,1,3,4
1214610,True,0,No user reviews,0,0,0
1214620,True,0,No user reviews,0,0,0
1214630,True,0,1 user reviews,0,1,1
1214640,True,0,No user reviews,0,0,0
1214680,True,0,2 user reviews,2,0,2
1214690,True,0,No user reviews,0,0,0
1214710,True,0,No user reviews,0,0,0
1214720,True,0,No user reviews,0,0,0
1214730,True,0,No user reviews,0,0,0
1214740,True,0,No user reviews,0,0,0
1214760,True,0,2 user reviews,2,0,2
1214770,True,0,No user reviews,0,0,0
1214810,True,0,7 user reviews,5,2,7
1214850,True,7,Positive,12,0,12
1214880,True,0,No user reviews,0,0,0
1214890,True,0,No user reviews,0,0,0
1214891,True,0,No user reviews,0,0,0
1214892,True,0,No user reviews,0,0,0
1214893,True,0,No user reviews,0,0,0
1214894,True,0,No user reviews,0,0,0
1214895,True,0,No user reviews,0,0,0
1214896,True,0,No user reviews,0,0,0
1214897,True,0,No user reviews,0,0,0
1214900,True,0,No user reviews,0,0,0
1214910,True,0,No user reviews,0,0,0
1214920,True,0,2 user reviews,2,0,2
1214930,True,0,No user reviews,0,0,0
1214950,True,0,No user reviews,0,0,0
1214970,True,0,1 user reviews,0,1,1
1214980,True,0,6 user reviews,4,2,6
1214990,True,0,1 user reviews,1,0,1
1215000,True,0,8 user reviews,8,0,8
1215020,True,0,No user reviews,0,0,0
1215030,True,0,No user reviews,0,0,0
1215040,True,0,No user reviews,0,0,0
1215050,True,0,8 user reviews,8,0,8
1215080,True,0,No user reviews,0,0,0
1215090,True,0,No user reviews,0,0,0
1215100,True,0,No user reviews,0,0,0
1215110,True,7,Positive,10,1,11
1215120,True,0,No user reviews,0,0,0
1215160,True,0,2 user reviews,2,0,2
1215170,True,0,No user reviews,0,0,0
1215180,True,5,Mixed,25,27,52
1215190,True,0,No user reviews,0,0,0
1215200,True,7,Positive,24,3,27
1215220,True,0,No user reviews,0,0,0
1215230,True,0,1 user reviews,1,0,1
1215260,True,6,Mostly Positive,22,6,28
1215270,True,7,Positive,44,1,45
1215280,True,7,Positive,27,2,29
1215310,True,0,No user reviews,0,0,0
1215320,True,7,Positive,10,0,10
1215330,True,0,No user reviews,0,0,0
1215340,True,0,No user reviews,0,0,0
1215350,True,0,1 user reviews,1,0,1
1215360,True,0,1 user reviews,1,0,1
1215380,True,0,1 user reviews,1,0,1
1215390,True,8,Very Positive,120,3,123
1215400,True,0,No user reviews,0,0,0
1215410,True,0,5 user reviews,1,4,5
1215420,True,0,No user reviews,0,0,0
1215430,True,0,No user reviews,0,0,0
1215450,True,0,No user reviews,0,0,0
1215460,True,0,No user reviews,0,0,0
1215461,True,0,No user reviews,0,0,0
1215462,True,0,No user reviews,0,0,0
1215463,True,0,No user reviews,0,0,0
1215470,True,0,No user reviews,0,0,0
1215480,True,0,No user reviews,0,0,0
1215500,True,0,6 user reviews,6,0,6
1215520,True,0,1 user reviews,1,0,1
1215540,True,0,3 user reviews,2,1,3
1215550,True,5,Mixed,5,6,11
1215580,True,0,No user reviews,0,0,0
1215600,True,0,No user reviews,0,0,0
1215620,True,0,No user reviews,0,0,0
1215640,True,0,1 user reviews,1,0,1
1215650,True,0,5 user reviews,3,2,5
1215660,True,0,1 user reviews,1,0,1
1215680,True,0,No user reviews,0,0,0
1215690,True,0,2 user reviews,1,1,2
1215700,True,0,3 user reviews,3,0,3
1215710,True,0,8 user reviews,4,4,8
1215720,True,0,No user reviews,0,0,0
1215750,True,7,Positive,10,0,10
1215760,True,0,No user reviews,0,0,0
1215770,True,0,6 user reviews,6,0,6
1215830,True,0,1 user reviews,1,0,1
1215840,True,0,No user reviews,0,0,0
1215860,True,5,Mixed,6,4,10
1215870,True,4,Mostly Negative,4,7,11
1215900,True,0,2 user reviews,2,0,2
1215920,True,0,No user reviews,0,0,0
1215930,True,0,8 user reviews,5,3,8
1215940,True,0,No user reviews,0,0,0
1215950,True,0,2 user reviews,0,2,2
1215960,True,0,3 user reviews,2,1,3
1215970,True,0,No user reviews,0,0,0
1215980,True,0,No user reviews,0,0,0
1215990,True,0,No user reviews,0,0,0
1216000,True,0,No user reviews,0,0,0
1216020,True,0,No user reviews,0,0,0
1216050,True,0,6 user reviews,6,0,6
1216070,True,0,No user reviews,0,0,0
1216080,True,0,No user reviews,0,0,0
1216130,True,0,6 user reviews,5,1,6
1216150,True,0,3 user reviews,3,0,3
1216160,True,0,No user reviews,0,0,0
1216170,True,0,No user reviews,0,0,0
1216180,True,0,4 user reviews,3,1,4
1216190,True,0,No user reviews,0,0,0
1216200,True,0,3 user reviews,3,0,3
1216220,True,0,No user reviews,0,0,0
1216230,True,7,Positive,20,2,22
1216270,True,0,No user reviews,0,0,0
1216290,True,0,No user reviews,0,0,0
1216300,True,0,3 user reviews,3,0,3
1216310,True,0,No user reviews,0,0,0
1216320,True,8,Very Positive,1251,113,1364
1216350,True,0,7 user reviews,6,1,7
1216360,True,0,No user reviews,0,0,0
1216370,True,0,4 user reviews,1,3,4
1216380,True,0,No user reviews,0,0,0
1216390,True,0,No user reviews,0,0,0
1216400,True,0,No user reviews,0,0,0
1216410,True,0,No user reviews,0,0,0
1216470,True,0,No user reviews,0,0,0
1216480,True,0,1 user reviews,1,0,1
1216490,True,8,Very Positive,78,0,78
1216510,True,0,2 user reviews,1,1,2
1216530,True,0,No user reviews,0,0,0
1216540,True,7,Positive,12,2,14
1216550,True,0,2 user reviews,1,1,2
1216560,True,0,No user reviews,0,0,0
1216590,True,7,Positive,13,3,16
1216600,True,0,No user reviews,0,0,0
1216610,True,0,4 user reviews,2,2,4
1216640,True,0,2 user reviews,1,1,2
1216660,True,0,4 user reviews,2,2,4
1216680,True,0,No user reviews,0,0,0
1216681,True,0,No user reviews,0,0,0
1216690,True,0,No user reviews,0,0,0
1216700,True,0,No user reviews,0,0,0
1216710,True,8,Very Positive,103,11,114
1216720,True,0,7 user reviews,3,4,7
1216750,True,0,No user reviews,0,0,0
1216790,True,0,1 user reviews,1,0,1
1216792,True,0,1 user reviews,1,0,1
1216793,True,0,1 user reviews,1,0,1
1216794,True,0,2 user reviews,1,1,2
1216810,True,0,No user reviews,0,0,0
1216820,True,0,No user reviews,0,0,0
1216830,True,0,No user reviews,0,0,0
1216840,True,0,No user reviews,0,0,0
1216880,True,8,Very Positive,67,14,81
1216890,True,0,No user reviews,0,0,0
1216900,True,0,No user reviews,0,0,0
1216930,True,0,2 user reviews,1,1,2
1216950,True,0,4 user reviews,4,0,4
1216951,True,0,No user reviews,0,0,0
1216952,True,0,1 user reviews,1,0,1
1216953,True,0,No user reviews,0,0,0
1216954,True,0,1 user reviews,1,0,1
1216955,True,0,No user reviews,0,0,0
1216956,True,0,No user reviews,0,0,0
1216960,True,0,No user reviews,0,0,0
1216980,True,0,1 user reviews,1,0,1
1216990,True,0,No user reviews,0,0,0
1217000,True,0,No user reviews,0,0,0
1217050,True,8,Very Positive,65,7,72
1217060,True,9,Overwhelmingly Positive,8178,327,8505
1217070,True,0,2 user reviews,2,0,2
1217090,True,0,No user reviews,0,0,0
1217100,True,0,No user reviews,0,0,0
1217150,True,0,No user reviews,0,0,0
1217160,True,0,No user reviews,0,0,0
1217180,True,0,No user reviews,0,0,0
1217190,True,0,No user reviews,0,0,0
1217200,True,0,No user reviews,0,0,0
1217220,True,0,1 user reviews,0,1,1
1217230,True,0,No user reviews,0,0,0
1217240,True,0,No user reviews,0,0,0
1217260,True,0,6 user reviews,5,1,6
1217280,True,0,No user reviews,0,0,0
1217290,True,0,No user reviews,0,0,0
1217310,True,0,4 user reviews,4,0,4
1217320,True,0,No user reviews,0,0,0
1217330,True,0,6 user reviews,5,1,6
1217340,True,0,No user reviews,0,0,0
1217350,True,0,9 user reviews,9,0,9
1217370,True,0,2 user reviews,1,1,2
1217380,True,0,5 user reviews,4,1,5
1217390,True,7,Positive,35,1,36
1217400,True,0,No user reviews,0,0,0
1217401,True,0,2 user reviews,2,0,2
1217410,True,0,No user reviews,0,0,0
1217440,True,0,No user reviews,0,0,0
1217460,True,0,No user reviews,0,0,0
1217480,True,0,1 user reviews,0,1,1
1217490,True,0,No user reviews,0,0,0
1217510,True,0,No user reviews,0,0,0
1217520,True,0,No user reviews,0,0,0
1217550,True,0,No user reviews,0,0,0
1217560,True,0,1 user reviews,1,0,1
1217570,True,7,Positive,8,2,10
1217580,True,0,1 user reviews,1,0,1
1217600,True,0,No user reviews,0,0,0
1217601,True,0,No user reviews,0,0,0
1217610,True,0,3 user reviews,2,1,3
1217630,True,0,2 user reviews,0,2,2
1217640,True,0,4 user reviews,3,1,4
1217660,True,0,No user reviews,0,0,0
1217671,True,0,No user reviews,0,0,0
1217672,True,0,No user reviews,0,0,0
1217673,True,0,No user reviews,0,0,0
1217674,True,0,No user reviews,0,0,0
1217675,True,0,No user reviews,0,0,0
1217676,True,0,No user reviews,0,0,0
1217677,True,0,No user reviews,0,0,0
1217679,True,0,No user reviews,0,0,0
1217682,True,0,No user reviews,0,0,0
1217683,True,0,No user reviews,0,0,0
1217684,True,0,No user reviews,0,0,0
1217685,True,0,No user reviews,0,0,0
1217686,True,0,No user reviews,0,0,0
1217687,True,0,No user reviews,0,0,0
1217688,True,0,No user reviews,0,0,0
1217689,True,0,No user reviews,0,0,0
1217690,True,0,No user reviews,0,0,0
1217691,True,0,No user reviews,0,0,0
1217692,True,0,No user reviews,0,0,0
1217700,True,0,No user reviews,0,0,0
1217710,True,0,No user reviews,0,0,0
1217720,True,7,Positive,13,1,14
1217750,True,0,No user reviews,0,0,0
1217820,True,0,No user reviews,0,0,0
1217840,True,0,3 user reviews,3,0,3
1217850,True,0,No user reviews,0,0,0
1217860,True,0,7 user reviews,5,2,7
1217870,True,0,3 user reviews,3,0,3
1217880,True,0,No user reviews,0,0,0
1217890,True,0,No user reviews,0,0,0
1217900,True,0,4 user reviews,4,0,4
1217910,True,0,No user reviews,0,0,0
1217930,True,0,No user reviews,0,0,0
1217940,True,0,No user reviews,0,0,0
1217950,True,0,No user reviews,0,0,0
1217970,True,0,1 user reviews,1,0,1
1217980,True,0,No user reviews,0,0,0
1217990,True,0,No user reviews,0,0,0
1218010,True,0,1 user reviews,0,1,1
1218020,True,0,No user reviews,0,0,0
1218030,True,0,1 user reviews,1,0,1
1218040,True,0,No user reviews,0,0,0
1218080,True,0,No user reviews,0,0,0
1218090,True,0,2 user reviews,1,1,2
1218110,True,0,No user reviews,0,0,0
1218150,True,0,No user reviews,0,0,0
1218160,True,0,No user reviews,0,0,0
1218170,True,0,No user reviews,0,0,0
1218190,True,0,No user reviews,0,0,0
1218200,True,0,3 user reviews,2,1,3
1218210,True,0,No user reviews,0,0,0
1218220,True,0,No user reviews,0,0,0
1218230,True,7,Positive,9,1,10
1218240,True,0,No user reviews,0,0,0
1218250,True,0,No user reviews,0,0,0
1218260,True,0,No user reviews,0,0,0
1218280,True,8,Very Positive,128,22,150
1218300,True,0,No user reviews,0,0,0
1218310,True,0,3 user reviews,3,0,3
1218320,True,0,No user reviews,0,0,0
1218360,True,0,No user reviews,0,0,0
1218390,True,0,1 user reviews,0,1,1
1218400,True,0,No user reviews,0,0,0
1218420,True,0,2 user reviews,0,2,2
1218440,True,0,No user reviews,0,0,0
1218460,True,0,No user reviews,0,0,0
1218500,True,0,No user reviews,0,0,0
1218510,True,0,No user reviews,0,0,0
1218520,True,7,Positive,21,0,21
1218530,True,0,No user reviews,0,0,0
1218540,True,0,No user reviews,0,0,0
1218550,True,0,No user reviews,0,0,0
1218560,True,0,1 user reviews,1,0,1
1218570,True,7,Positive,18,3,21
1218580,True,0,2 user reviews,2,0,2
1218590,True,0,No user reviews,0,0,0
1218640,True,0,No user reviews,0,0,0
1218650,True,0,No user reviews,0,0,0
1218670,True,0,No user reviews,0,0,0
1218680,True,0,3 user reviews,2,1,3
1218690,True,0,No user reviews,0,0,0
1218710,True,0,2 user reviews,0,2,2
1218720,True,0,9 user reviews,5,4,9
1218730,True,0,No user reviews,0,0,0
1218740,True,0,No user reviews,0,0,0
1218750,True,0,No user reviews,0,0,0
1218760,True,0,2 user reviews,1,1,2
1218770,True,0,4 user reviews,1,3,4
1218780,True,0,No user reviews,0,0,0
1218790,True,0,3 user reviews,2,1,3
1218810,True,0,3 user reviews,3,0,3
1218830,True,7,Positive,14,2,16
1218850,True,0,No user reviews,0,0,0
1218860,True,0,No user reviews,0,0,0
1218880,True,0,No user reviews,0,0,0
1218890,True,0,8 user reviews,6,2,8
1218910,True,0,No user reviews,0,0,0
1218920,True,6,Mostly Positive,14,4,18
1218930,True,0,No user reviews,0,0,0
1218940,True,0,No user reviews,0,0,0
1218950,True,0,No user reviews,0,0,0
1218960,True,0,No user reviews,0,0,0
1218990,True,0,No user reviews,0,0,0
1219000,True,0,No user reviews,0,0,0
1219010,True,0,No user reviews,0,0,0
1219020,True,0,6 user reviews,5,1,6
1219040,True,0,No user reviews,0,0,0
1219060,True,0,No user reviews,0,0,0
1219080,True,0,No user reviews,0,0,0
1219110,True,0,No user reviews,0,0,0
1219120,True,0,1 user reviews,1,0,1
1219130,True,0,3 user reviews,3,0,3
1219140,True,0,1 user reviews,1,0,1
1219150,True,0,No user reviews,0,0,0
1219160,True,0,No user reviews,0,0,0
1219170,True,0,No user reviews,0,0,0
1219180,True,0,No user reviews,0,0,0
1219200,True,0,No user reviews,0,0,0
1219220,True,0,1 user reviews,0,1,1
1219230,True,0,8 user reviews,6,2,8
1219240,True,0,No user reviews,0,0,0
1219260,True,0,No user reviews,0,0,0
1219261,True,0,No user reviews,0,0,0
1219270,True,0,No user reviews,0,0,0
1219280,True,0,No user reviews,0,0,0
1219300,True,0,No user reviews,0,0,0
1219310,True,0,No user reviews,0,0,0
1219320,True,0,9 user reviews,7,2,9
1219330,True,0,No user reviews,0,0,0
1219350,True,0,No user reviews,0,0,0
1219370,True,0,No user reviews,0,0,0
1219410,True,0,No user reviews,0,0,0
1219420,True,0,4 user reviews,4,0,4
1219440,True,0,1 user reviews,1,0,1
1219450,True,0,No user reviews,0,0,0
1219470,True,0,No user reviews,0,0,0
1219480,True,0,No user reviews,0,0,0
1219500,True,0,3 user reviews,3,0,3
1219510,True,0,No user reviews,0,0,0
1219520,True,0,3 user reviews,0,3,3
1219530,True,0,No user reviews,0,0,0
1219540,True,0,No user reviews,0,0,0
1219550,True,0,No user reviews,0,0,0
1219560,True,0,No user reviews,0,0,0
1219580,True,0,9 user reviews,7,2,9
1219590,True,0,No user reviews,0,0,0
1219600,True,0,No user reviews,0,0,0
1219610,True,0,6 user reviews,4,2,6
1219620,True,0,No user reviews,0,0,0
1219630,True,0,No user reviews,0,0,0
1219640,True,0,No user reviews,0,0,0
1219650,True,0,5 user reviews,4,1,5
1219660,True,0,No user reviews,0,0,0
1219670,True,0,No user reviews,0,0,0
1219680,True,0,No user reviews,0,0,0
1219690,True,0,No user reviews,0,0,0
1219700,True,0,8 user reviews,8,0,8
1219730,True,0,4 user reviews,4,0,4
1219740,True,0,No user reviews,0,0,0
1219750,True,0,1 user reviews,1,0,1
1219790,True,0,No user reviews,0,0,0
1219810,True,0,No user reviews,0,0,0
1219820,True,0,1 user reviews,1,0,1
1219840,True,0,No user reviews,0,0,0
1219850,True,0,1 user reviews,1,0,1
1219851,True,0,No user reviews,0,0,0
1219852,True,0,1 user reviews,1,0,1
1219860,True,0,6 user reviews,5,1,6
1219870,True,0,No user reviews,0,0,0
1219890,True,0,No user reviews,0,0,0
1219910,True,0,No user reviews,0,0,0
1219920,True,0,No user reviews,0,0,0
1219930,True,0,No user reviews,0,0,0
1219940,True,5,Mixed,11,7,18
1219950,True,8,Very Positive,140,16,156
1219980,True,0,4 user reviews,4,0,4
1219990,True,0,9 user reviews,9,0,9
1220010,True,0,No user reviews,0,0,0
1220040,True,0,No user reviews,0,0,0
1220050,True,0,No user reviews,0,0,0
1220070,True,0,1 user reviews,0,1,1
1220080,True,7,Positive,8,2,10
1220110,True,0,No user reviews,0,0,0
1220120,True,5,Mixed,6,4,10
1220130,True,0,No user reviews,0,0,0
1220140,True,0,No user reviews,0,0,0
1220150,True,0,No user reviews,0,0,0
1220160,True,0,1 user reviews,1,0,1
1220170,True,0,No user reviews,0,0,0
1220180,True,0,No user reviews,0,0,0
1220190,True,0,4 user reviews,2,2,4
1220200,True,0,No user reviews,0,0,0
1220210,True,0,No user reviews,0,0,0
1220260,True,0,No user reviews,0,0,0
1220300,True,0,No user reviews,0,0,0
1220310,True,0,No user reviews,0,0,0
1220330,True,0,No user reviews,0,0,0
1220340,True,0,5 user reviews,2,3,5
1220350,True,0,No user reviews,0,0,0
1220360,True,0,1 user reviews,0,1,1
1220370,True,6,Mostly Positive,14,4,18
1220380,True,0,No user reviews,0,0,0
1220390,True,0,No user reviews,0,0,0
1220400,True,0,No user reviews,0,0,0
1220401,True,0,No user reviews,0,0,0
1220410,True,0,No user reviews,0,0,0
1220420,True,0,1 user reviews,1,0,1
1220421,True,0,1 user reviews,1,0,1
1220440,True,0,No user reviews,0,0,0
1220460,True,0,No user reviews,0,0,0
1220510,True,0,2 user reviews,2,0,2
1220520,True,0,1 user reviews,1,0,1
1220540,True,0,1 user reviews,0,1,1
1220550,True,0,No user reviews,0,0,0
1220560,True,0,No user reviews,0,0,0
1220580,True,0,1 user reviews,0,1,1
1220590,True,0,No user reviews,0,0,0
1220600,True,0,No user reviews,0,0,0
1220610,True,0,No user reviews,0,0,0
1220650,True,0,No user reviews,0,0,0
1220660,True,0,No user reviews,0,0,0
1220670,True,0,No user reviews,0,0,0
1220680,True,0,No user reviews,0,0,0
1220690,True,0,2 user reviews,2,0,2
1220710,True,0,3 user reviews,3,0,3
1220740,True,0,No user reviews,0,0,0
1220750,True,0,No user reviews,0,0,0
1220760,True,0,No user reviews,0,0,0
1220790,True,0,No user reviews,0,0,0
1220810,True,0,No user reviews,0,0,0
1220840,True,0,No user reviews,0,0,0
1220850,True,0,2 user reviews,1,1,2
1220860,True,0,No user reviews,0,0,0
1220880,True,0,No user reviews,0,0,0
1220890,True,0,2 user reviews,1,1,2
1220900,True,0,No user reviews,0,0,0
1220910,True,0,1 user reviews,1,0,1
1220920,True,0,4 user reviews,3,1,4
1220930,True,0,No user reviews,0,0,0
1220950,True,0,No user reviews,0,0,0
1220960,True,0,No user reviews,0,0,0
1220970,True,0,No user reviews,0,0,0
1220980,True,0,2 user reviews,0,2,2
1220990,True,0,No user reviews,0,0,0
1221000,True,0,No user reviews,0,0,0
1221010,True,0,No user reviews,0,0,0
1221020,True,0,No user reviews,0,0,0
1221030,True,0,5 user reviews,5,0,5
1221040,True,0,No user reviews,0,0,0
1221050,True,0,7 user reviews,4,3,7
1221070,True,0,4 user reviews,3,1,4
1221080,True,8,Very Positive,165,38,203
1221090,True,0,No user reviews,0,0,0
1221100,True,0,No user reviews,0,0,0
1221110,True,0,No user reviews,0,0,0
1221120,True,0,No user reviews,0,0,0
1221130,True,0,No user reviews,0,0,0
1221140,True,0,No user reviews,0,0,0
1221150,True,0,No user reviews,0,0,0
1221160,True,0,No user reviews,0,0,0
1221170,True,0,No user reviews,0,0,0
1221180,True,0,No user reviews,0,0,0
1221190,True,0,No user reviews,0,0,0
1221200,True,0,No user reviews,0,0,0
1221210,True,0,No user reviews,0,0,0
1221220,True,0,1 user reviews,1,0,1
1221230,True,0,4 user reviews,4,0,4
1221240,True,5,Mixed,6,5,11
1221250,True,0,No user reviews,0,0,0
1221260,True,0,No user reviews,0,0,0
1221280,True,0,1 user reviews,1,0,1
1221290,True,0,4 user reviews,3,1,4
1221300,True,0,No user reviews,0,0,0
1221320,True,0,4 user reviews,4,0,4
1221330,True,0,1 user reviews,1,0,1
1221340,True,0,No user reviews,0,0,0
1221360,True,0,1 user reviews,1,0,1
1221370,True,0,No user reviews,0,0,0
1221390,True,0,1 user reviews,1,0,1
1221400,True,0,1 user reviews,1,0,1
1221420,True,0,No user reviews,0,0,0
1221430,True,0,No user reviews,0,0,0
1221440,True,6,Mostly Positive,7,3,10
1221460,True,0,8 user reviews,3,5,8
1221500,True,0,No user reviews,0,0,0
1221510,True,0,2 user reviews,1,1,2
1221520,True,0,2 user reviews,1,1,2
1221530,True,0,No user reviews,0,0,0
1221540,True,7,Positive,24,6,30
1221560,True,0,No user reviews,0,0,0
1221590,True,7,Positive,8,2,10
1221600,True,0,1 user reviews,1,0,1
1221610,True,0,No user reviews,0,0,0
1221620,True,0,No user reviews,0,0,0
1221630,True,0,4 user reviews,4,0,4
1221640,True,7,Positive,15,0,15
1221660,True,0,1 user reviews,0,1,1
1221670,True,0,No user reviews,0,0,0
1221700,True,0,7 user reviews,5,2,7
1221740,True,0,No user reviews,0,0,0
1221750,True,0,No user reviews,0,0,0
1221780,True,0,No user reviews,0,0,0
1221790,True,0,3 user reviews,3,0,3
1221800,True,7,Positive,10,1,11
1221810,True,0,No user reviews,0,0,0
1221830,True,0,2 user reviews,2,0,2
1221850,True,0,1 user reviews,1,0,1
1221851,True,0,No user reviews,0,0,0
1221852,True,0,No user reviews,0,0,0
1221853,True,0,No user reviews,0,0,0
1221860,True,0,3 user reviews,3,0,3
1221870,True,0,No user reviews,0,0,0
1221880,True,0,4 user reviews,4,0,4
1221890,True,0,No user reviews,0,0,0
1221900,True,0,4 user reviews,3,1,4
1221940,True,0,No user reviews,0,0,0
1221950,True,0,No user reviews,0,0,0
1221980,True,0,No user reviews,0,0,0
1221990,True,7,Positive,10,0,10
1222000,True,0,2 user reviews,2,0,2
1222020,True,7,Positive,15,0,15
1222040,True,8,Very Positive,64,5,69
1222050,True,5,Mixed,20,14,34
1222060,True,0,No user reviews,0,0,0
1222080,True,0,No user reviews,0,0,0
1222090,True,0,No user reviews,0,0,0
1222100,True,0,No user reviews,0,0,0
1222101,True,0,No user reviews,0,0,0
1222110,True,0,No user reviews,0,0,0
1222120,True,0,No user reviews,0,0,0
1222130,True,0,No user reviews,0,0,0
1222140,True,8,Very Positive,3801,440,4241
1222150,True,0,No user reviews,0,0,0
1222160,True,0,8 user reviews,7,1,8
1222170,True,0,7 user reviews,6,1,7
1222180,True,0,7 user reviews,4,3,7
1222190,True,0,No user reviews,0,0,0
1222200,True,0,No user reviews,0,0,0
1222210,True,0,No user reviews,0,0,0
1222220,True,0,1 user reviews,1,0,1
1222230,True,0,1 user reviews,1,0,1
1222240,True,0,1 user reviews,1,0,1
1222250,True,0,1 user reviews,1,0,1
1222260,True,0,No user reviews,0,0,0
1222270,True,0,4 user reviews,4,0,4
1222300,True,8,Very Positive,67,5,72
1222310,True,0,No user reviews,0,0,0
1222320,True,0,No user reviews,0,0,0
1222330,True,0,No user reviews,0,0,0
1222340,True,0,No user reviews,0,0,0
1222360,True,0,No user reviews,0,0,0
1222390,True,0,No user reviews,0,0,0
1222400,True,6,Mostly Positive,31,13,44
1222410,True,0,No user reviews,0,0,0
1222420,True,0,No user reviews,0,0,0
1222440,True,0,No user reviews,0,0,0
1222470,True,0,6 user reviews,4,2,6
1222480,True,0,No user reviews,0,0,0
1222490,True,0,No user reviews,0,0,0
1222530,True,0,No user reviews,0,0,0
1222540,True,0,No user reviews,0,0,0
1222550,True,0,No user reviews,0,0,0
1222560,True,0,No user reviews,0,0,0
1222570,True,0,No user reviews,0,0,0
1222580,True,0,4 user reviews,3,1,4
1222590,True,0,No user reviews,0,0,0
1222600,True,7,Positive,25,4,29
1222610,True,0,8 user reviews,7,1,8
1222632,True,0,No user reviews,0,0,0
1222634,True,0,No user reviews,0,0,0
1222640,True,0,6 user reviews,2,4,6
1222650,True,0,No user reviews,0,0,0
1222670,True,8,Very Positive,1416,200,1616
1222680,True,8,Very Positive,2821,645,3466
1222690,True,6,Mostly Positive,634,264,898
1222700,True,8,Very Positive,1388,227,1615
1222720,True,0,No user reviews,0,0,0
1222730,True,6,Mostly Positive,7122,2492,9614
1222740,True,0,No user reviews,0,0,0
1222760,True,0,4 user reviews,3,1,4
1222780,True,0,No user reviews,0,0,0
1222800,True,0,No user reviews,0,0,0
1222820,True,0,No user reviews,0,0,0
1222840,True,0,No user reviews,0,0,0
1222860,True,0,No user reviews,0,0,0
1222870,True,0,1 user reviews,0,1,1
1222890,True,0,No user reviews,0,0,0
1222891,True,0,No user reviews,0,0,0
1222920,True,0,No user reviews,0,0,0
1222930,True,0,9 user reviews,6,3,9
1222940,True,0,No user reviews,0,0,0
1222960,True,0,No user reviews,0,0,0
1222980,True,0,2 user reviews,2,0,2
1223000,True,0,No user reviews,0,0,0
1223010,True,0,No user reviews,0,0,0
1223030,True,0,No user reviews,0,0,0
1223060,True,6,Mostly Positive,19,5,24
1223090,True,0,4 user reviews,2,2,4
1223110,True,0,7 user reviews,7,0,7
1223130,True,0,1 user reviews,1,0,1
1223140,True,0,No user reviews,0,0,0
1223160,True,0,No user reviews,0,0,0
1223170,True,0,No user reviews,0,0,0
1223200,True,0,No user reviews,0,0,0
1223210,True,0,2 user reviews,1,1,2
1223230,True,0,No user reviews,0,0,0
1223240,True,0,No user reviews,0,0,0
1223250,True,7,Positive,14,1,15
1223260,True,0,6 user reviews,6,0,6
1223270,True,0,3 user reviews,1,2,3
1223290,True,0,3 user reviews,3,0,3
1223300,True,0,1 user reviews,1,0,1
1223310,True,0,No user reviews,0,0,0
1223330,True,0,No user reviews,0,0,0
1223340,True,0,No user reviews,0,0,0
1223350,True,0,9 user reviews,5,4,9
1223360,True,0,No user reviews,0,0,0
1223370,True,0,5 user reviews,5,0,5
1223380,True,0,2 user reviews,1,1,2
1223390,True,0,3 user reviews,3,0,3
1223400,True,0,No user reviews,0,0,0
1223440,True,0,No user reviews,0,0,0
1223460,True,0,No user reviews,0,0,0
1223490,True,5,Mixed,21,10,31
1223500,True,8,Very Positive,126,7,133
1223510,True,0,No user reviews,0,0,0
1223530,True,0,No user reviews,0,0,0
1223550,True,0,No user reviews,0,0,0
1223580,True,8,Very Positive,45,6,51
1223630,True,0,No user reviews,0,0,0
1223660,True,0,No user reviews,0,0,0
1223670,True,0,No user reviews,0,0,0
1223680,True,0,No user reviews,0,0,0
1223710,True,0,No user reviews,0,0,0
1223720,True,0,No user reviews,0,0,0
1223730,True,0,No user reviews,0,0,0
1223750,True,6,Mostly Positive,279,105,384
1223760,True,0,No user reviews,0,0,0
1223780,True,0,No user reviews,0,0,0
1223800,True,0,No user reviews,0,0,0
1223810,True,8,Very Positive,115,3,118
1223820,True,0,No user reviews,0,0,0
1223830,True,0,1 user reviews,1,0,1
1223840,True,0,No user reviews,0,0,0
1223850,True,0,No user reviews,0,0,0
1223860,True,7,Positive,40,1,41
1223880,True,0,2 user reviews,2,0,2
1223910,True,5,Mixed,8,9,17
1223950,True,0,No user reviews,0,0,0
1223960,True,0,No user reviews,0,0,0
1224000,True,0,3 user reviews,3,0,3
1224010,True,0,No user reviews,0,0,0
1224020,True,8,Very Positive,106,19,125
1224050,True,0,No user reviews,0,0,0
1224060,True,0,No user reviews,0,0,0
1224070,True,0,No user reviews,0,0,0
1224100,True,0,1 user reviews,1,0,1
1224120,True,7,Positive,17,3,20
1224130,True,0,5 user reviews,3,2,5
1224140,True,0,1 user reviews,1,0,1
1224160,True,8,Very Positive,174,8,182
1224190,True,0,No user reviews,0,0,0
1224210,True,0,No user reviews,0,0,0
1224220,True,0,No user reviews,0,0,0
1224230,True,0,No user reviews,0,0,0
1224240,True,0,No user reviews,0,0,0
1224250,True,0,No user reviews,0,0,0
1224260,True,0,No user reviews,0,0,0
1224290,True,8,Very Positive,206,13,219
1224300,True,0,No user reviews,0,0,0
1224320,True,0,1 user reviews,1,0,1
1224330,True,0,No user reviews,0,0,0
1224340,True,5,Mixed,14,8,22
1224341,True,5,Mixed,12,9,21
1224350,True,0,7 user reviews,7,0,7
1224370,True,0,1 user reviews,1,0,1
1224380,True,0,9 user reviews,4,5,9
1224390,True,0,No user reviews,0,0,0
1224410,True,0,No user reviews,0,0,0
1224440,True,0,No user reviews,0,0,0
1224450,True,7,Positive,22,0,22
1224460,True,0,No user reviews,0,0,0
1224470,True,0,No user reviews,0,0,0
1224480,True,6,Mostly Positive,11,4,15
1224490,True,0,1 user reviews,1,0,1
1224530,True,6,Mostly Positive,34,13,47
1224550,True,0,1 user reviews,1,0,1
1224570,True,0,No user reviews,0,0,0
1224580,True,0,No user reviews,0,0,0
1224590,True,0,No user reviews,0,0,0
1224600,True,8,Very Positive,94,17,111
1224620,True,0,No user reviews,0,0,0
1224630,True,0,No user reviews,0,0,0
1224640,True,0,No user reviews,0,0,0
1224650,True,0,No user reviews,0,0,0
1224680,True,0,No user reviews,0,0,0
1224690,True,5,Mixed,38,24,62
1224700,True,0,No user reviews,0,0,0
1224710,True,0,No user reviews,0,0,0
1224720,True,0,3 user reviews,0,3,3
1224740,True,0,1 user reviews,1,0,1
1224760,True,0,1 user reviews,1,0,1
1224761,True,0,No user reviews,0,0,0
1224762,True,0,No user reviews,0,0,0
1224763,True,0,No user reviews,0,0,0
1224764,True,0,No user reviews,0,0,0
1224770,True,0,No user reviews,0,0,0
1224780,True,0,No user reviews,0,0,0
1224781,True,0,No user reviews,0,0,0
1224782,True,0,No user reviews,0,0,0
1224783,True,0,1 user reviews,1,0,1
1224784,True,0,No user reviews,0,0,0
1224785,True,0,No user reviews,0,0,0
1224786,True,0,No user reviews,0,0,0
1224787,True,0,No user reviews,0,0,0
1224788,True,0,No user reviews,0,0,0
1224789,True,0,No user reviews,0,0,0
1224790,True,0,No user reviews,0,0,0
1224791,True,0,No user reviews,0,0,0
1224792,True,0,No user reviews,0,0,0
1224793,True,0,No user reviews,0,0,0
1224794,True,0,No user reviews,0,0,0
1224795,True,0,No user reviews,0,0,0
1224796,True,0,1 user reviews,0,1,1
1224800,True,0,No user reviews,0,0,0
1224820,True,0,5 user reviews,5,0,5
1224821,True,0,1 user reviews,1,0,1
1224822,True,0,No user reviews,0,0,0
1224823,True,0,No user reviews,0,0,0
1224824,True,0,No user reviews,0,0,0
1224825,True,0,No user reviews,0,0,0
1224826,True,0,No user reviews,0,0,0
1224827,True,0,2 user reviews,2,0,2
1224830,True,0,No user reviews,0,0,0
1224831,True,0,No user reviews,0,0,0
1224832,True,0,1 user reviews,1,0,1
1224833,True,0,No user reviews,0,0,0
1224834,True,0,No user reviews,0,0,0
1224835,True,0,No user reviews,0,0,0
1224836,True,0,No user reviews,0,0,0
1224840,True,0,No user reviews,0,0,0
1224850,True,0,No user reviews,0,0,0
1224851,True,0,No user reviews,0,0,0
1224852,True,0,No user reviews,0,0,0
1224853,True,0,No user reviews,0,0,0
1224854,True,0,No user reviews,0,0,0
1224855,True,0,No user reviews,0,0,0
1224856,True,0,No user reviews,0,0,0
1224857,True,0,No user reviews,0,0,0
1224858,True,0,No user reviews,0,0,0
1224859,True,0,No user reviews,0,0,0
1224860,True,0,No user reviews,0,0,0
1224861,True,0,No user reviews,0,0,0
1224862,True,0,No user reviews,0,0,0
1224863,True,0,No user reviews,0,0,0
1224864,True,0,No user reviews,0,0,0
1224865,True,0,No user reviews,0,0,0
1224866,True,0,No user reviews,0,0,0
1224867,True,0,No user reviews,0,0,0
1224868,True,0,No user reviews,0,0,0
1224870,True,0,No user reviews,0,0,0
1224871,True,0,No user reviews,0,0,0
1224872,True,0,1 user reviews,1,0,1
1224873,True,0,No user reviews,0,0,0
1224874,True,0,No user reviews,0,0,0
1224875,True,0,No user reviews,0,0,0
1224876,True,0,No user reviews,0,0,0
1224877,True,0,No user reviews,0,0,0
1224878,True,0,No user reviews,0,0,0
1224879,True,0,No user reviews,0,0,0
1224890,True,0,No user reviews,0,0,0
1224891,True,0,No user reviews,0,0,0
1224892,True,0,No user reviews,0,0,0
1224893,True,0,No user reviews,0,0,0
1224894,True,0,No user reviews,0,0,0
1224895,True,0,No user reviews,0,0,0
1224896,True,0,No user reviews,0,0,0
1224897,True,0,No user reviews,0,0,0
1224898,True,0,No user reviews,0,0,0
1224900,True,0,No user reviews,0,0,0
1224940,True,0,2 user reviews,0,2,2
1224950,True,0,No user reviews,0,0,0
1225000,True,0,No user reviews,0,0,0
1225030,True,0,No user reviews,0,0,0
1225060,True,0,No user reviews,0,0,0
1225070,True,6,Mostly Positive,10,3,13
1225100,True,0,No user reviews,0,0,0
1225110,True,5,Mixed,14,12,26
1225120,True,7,Positive,11,0,11
1225130,True,0,7 user reviews,6,1,7
1225140,True,7,Positive,27,2,29
1225190,True,0,No user reviews,0,0,0
1225200,True,0,No user reviews,0,0,0
1225210,True,7,Positive,18,3,21
1225220,True,0,No user reviews,0,0,0
1225240,True,0,No user reviews,0,0,0
1225250,True,0,No user reviews,0,0,0
1225260,True,0,5 user reviews,3,2,5
1225270,True,0,No user reviews,0,0,0
1225290,True,0,No user reviews,0,0,0
1225300,True,0,1 user reviews,1,0,1
1225310,True,0,No user reviews,0,0,0
1225320,True,0,2 user reviews,1,1,2
1225330,True,5,Mixed,847,959,1806
1225340,True,0,No user reviews,0,0,0
1225350,True,0,No user reviews,0,0,0
1225360,True,0,No user reviews,0,0,0
1225370,True,0,1 user reviews,1,0,1
1225380,True,0,No user reviews,0,0,0
1225390,True,0,No user reviews,0,0,0
1225410,True,0,No user reviews,0,0,0
1225420,True,0,No user reviews,0,0,0
1225430,True,0,No user reviews,0,0,0
1225440,True,0,No user reviews,0,0,0
1225450,True,0,No user reviews,0,0,0
1225500,True,0,No user reviews,0,0,0
1225510,True,0,No user reviews,0,0,0
1225511,True,0,No user reviews,0,0,0
1225512,True,0,No user reviews,0,0,0
1225513,True,0,No user reviews,0,0,0
1225514,True,0,No user reviews,0,0,0
1225515,True,0,No user reviews,0,0,0
1225550,True,5,Mixed,6,6,12
1225560,True,8,Very Positive,120,22,142
1225570,True,8,Very Positive,86,21,107
1225580,True,7,Positive,27,4,31
1225590,True,8,Very Positive,120,18,138
1225600,True,7,Positive,9,1,10
1225610,True,0,6 user reviews,6,0,6
1225620,True,0,No user reviews,0,0,0
1225630,True,0,No user reviews,0,0,0
1225640,True,0,2 user reviews,2,0,2
1225680,True,0,No user reviews,0,0,0
1225690,True,0,No user reviews,0,0,0
1225710,True,0,2 user reviews,2,0,2
1225720,True,0,1 user reviews,1,0,1
1225740,True,0,3 user reviews,1,2,3
1225750,True,0,No user reviews,0,0,0
1225760,True,0,No user reviews,0,0,0
1225780,True,0,8 user reviews,8,0,8
1225790,True,0,No user reviews,0,0,0
1225800,True,0,No user reviews,0,0,0
1225810,True,0,No user reviews,0,0,0
1225820,True,0,No user reviews,0,0,0
1225830,True,0,No user reviews,0,0,0
1225840,True,0,2 user reviews,2,0,2
1225850,True,0,No user reviews,0,0,0
1225870,True,0,8 user reviews,6,2,8
1225890,True,0,No user reviews,0,0,0
1225900,True,0,No user reviews,0,0,0
1225910,True,0,1 user reviews,0,1,1
1225920,True,0,3 user reviews,1,2,3
1225930,True,0,No user reviews,0,0,0
1225940,True,0,No user reviews,0,0,0
1225960,True,0,2 user reviews,2,0,2
1225980,True,0,No user reviews,0,0,0
1226000,True,7,Positive,38,4,42
1226010,True,0,3 user reviews,3,0,3
1226020,True,0,No user reviews,0,0,0
1226030,True,0,No user reviews,0,0,0
1226040,True,0,No user reviews,0,0,0
1226050,True,0,No user reviews,0,0,0
1226070,True,0,No user reviews,0,0,0
1226080,True,0,2 user reviews,1,1,2
1226100,True,0,No user reviews,0,0,0
1226130,True,0,No user reviews,0,0,0
1226150,True,0,No user reviews,0,0,0
1226170,True,0,1 user reviews,1,0,1
1226190,True,0,No user reviews,0,0,0
1226210,True,0,7 user reviews,5,2,7
1226220,True,0,No user reviews,0,0,0
1226222,True,0,No user reviews,0,0,0
1226230,True,0,1 user reviews,1,0,1
1226250,True,0,No user reviews,0,0,0
1226270,True,0,No user reviews,0,0,0
1226280,True,0,No user reviews,0,0,0
1226290,True,0,No user reviews,0,0,0
1226300,True,0,No user reviews,0,0,0
1226310,True,0,No user reviews,0,0,0
1226320,True,0,No user reviews,0,0,0
1226330,True,0,No user reviews,0,0,0
1226340,True,0,No user reviews,0,0,0
1226350,True,0,No user reviews,0,0,0
1226360,True,0,No user reviews,0,0,0
1226410,True,0,No user reviews,0,0,0
1226420,True,0,1 user reviews,0,1,1
1226430,True,0,No user reviews,0,0,0
1226450,True,0,No user reviews,0,0,0
1226460,True,0,No user reviews,0,0,0
1226470,True,5,Mixed,32,32,64
1226480,True,0,No user reviews,0,0,0
1226490,True,0,2 user reviews,1,1,2
1226500,True,0,1 user reviews,1,0,1
1226510,True,0,No user reviews,0,0,0
1226530,True,8,Very Positive,64,4,68
1226540,True,5,Mixed,11,8,19
1226550,True,0,No user reviews,0,0,0
1226560,True,0,No user reviews,0,0,0
1226570,True,0,No user reviews,0,0,0
1226580,True,0,No user reviews,0,0,0
1226610,True,0,No user reviews,0,0,0
1226620,True,0,No user reviews,0,0,0
1226640,True,6,Mostly Positive,36,10,46
1226650,True,0,No user reviews,0,0,0
1226670,True,0,No user reviews,0,0,0
1226680,True,0,No user reviews,0,0,0
1226690,True,5,Mixed,8,5,13
1226710,True,0,No user reviews,0,0,0
1226720,True,0,No user reviews,0,0,0
1226730,True,0,No user reviews,0,0,0
1226740,True,0,No user reviews,0,0,0
1226750,True,0,No user reviews,0,0,0
1226760,True,0,No user reviews,0,0,0
1226770,True,0,No user reviews,0,0,0
1226780,True,0,No user reviews,0,0,0
1226800,True,0,No user reviews,0,0,0
1226820,True,0,No user reviews,0,0,0
1226840,True,0,No user reviews,0,0,0
1226850,True,0,1 user reviews,1,0,1
1226870,True,0,No user reviews,0,0,0
1226880,True,0,No user reviews,0,0,0
1226890,True,0,4 user reviews,3,1,4
1226900,True,0,No user reviews,0,0,0
1226910,True,0,5 user reviews,1,4,5
1226920,True,0,1 user reviews,1,0,1
1226930,True,0,No user reviews,0,0,0
1226940,True,0,1 user reviews,0,1,1
1226960,True,3,Negative,2,11,13
1226970,True,0,No user reviews,0,0,0
1226980,True,0,No user reviews,0,0,0
1226990,True,8,Very Positive,191,19,210
1227000,True,0,3 user reviews,0,3,3
1227010,True,0,3 user reviews,3,0,3
1227030,True,0,2 user reviews,2,0,2
1227040,True,0,No user reviews,0,0,0
1227050,True,0,No user reviews,0,0,0
1227090,True,0,1 user reviews,0,1,1
1227100,True,0,No user reviews,0,0,0
1227130,True,0,No user reviews,0,0,0
1227140,True,0,No user reviews,0,0,0
1227150,True,0,No user reviews,0,0,0
1227160,True,5,Mixed,19,13,32
1227170,True,0,No user reviews,0,0,0
1227180,True,0,No user reviews,0,0,0
1227190,True,0,1 user reviews,1,0,1
1227200,True,0,No user reviews,0,0,0
1227250,True,0,No user reviews,0,0,0
1227260,True,0,No user reviews,0,0,0
1227280,True,0,No user reviews,0,0,0
1227320,True,0,No user reviews,0,0,0
1227330,True,0,No user reviews,0,0,0
1227340,True,0,No user reviews,0,0,0
1227350,True,6,Mostly Positive,62,18,80
1227360,True,5,Mixed,12,6,18
1227390,True,0,1 user reviews,1,0,1
1227400,True,8,Very Positive,49,2,51
1227410,True,0,No user reviews,0,0,0
1227420,True,0,No user reviews,0,0,0
1227440,True,0,No user reviews,0,0,0
1227441,True,0,No user reviews,0,0,0
1227443,True,0,No user reviews,0,0,0
1227448,True,0,No user reviews,0,0,0
1227449,True,0,No user reviews,0,0,0
1227461,True,0,No user reviews,0,0,0
1227490,True,0,2 user reviews,1,1,2
1227500,True,0,No user reviews,0,0,0
1227510,True,0,1 user reviews,1,0,1
1227520,True,0,No user reviews,0,0,0
1227530,True,6,Mostly Positive,199,53,252
1227540,True,0,No user reviews,0,0,0
1227560,True,0,No user reviews,0,0,0
1227570,True,0,No user reviews,0,0,0
1227580,True,0,1 user reviews,0,1,1
1227590,True,0,8 user reviews,7,1,8
1227600,True,7,Positive,9,1,10
1227610,True,0,No user reviews,0,0,0
1227640,True,0,No user reviews,0,0,0
1227670,True,0,No user reviews,0,0,0
1227690,True,0,No user reviews,0,0,0
1227710,True,0,No user reviews,0,0,0
1227730,True,0,6 user reviews,5,1,6
1227740,True,0,4 user reviews,4,0,4
1227750,True,7,Positive,12,2,14
1227760,True,0,5 user reviews,2,3,5
1227770,True,0,No user reviews,0,0,0
1227780,True,6,Mostly Positive,337,105,442
1227820,True,0,No user reviews,0,0,0
1227830,True,0,No user reviews,0,0,0
1227860,True,0,9 user reviews,9,0,9
1227890,True,8,Very Positive,79,7,86
1227900,True,0,1 user reviews,1,0,1
1227910,True,0,8 user reviews,7,1,8
1228340,True,0,3 user reviews,3,0,3
1228360,True,0,No user reviews,0,0,0
1228390,True,0,No user reviews,0,0,0
1228400,True,0,No user reviews,0,0,0
1228410,True,0,2 user reviews,2,0,2
1228430,True,0,No user reviews,0,0,0
1228440,True,0,1 user reviews,1,0,1
1228450,True,0,No user reviews,0,0,0
1228470,True,0,No user reviews,0,0,0
1228480,True,0,No user reviews,0,0,0
1228490,True,0,1 user reviews,1,0,1
1228500,True,0,No user reviews,0,0,0
1228510,True,0,4 user reviews,2,2,4
1228520,True,8,Very Positive,303,56,359
1228530,True,8,Very Positive,76,10,86
1228560,True,7,Positive,33,6,39
1228570,True,4,Mostly Negative,6,14,20
1228580,True,0,No user reviews,0,0,0
1228600,True,7,Positive,20,1,21
1228610,True,0,No user reviews,0,0,0
1228630,True,0,No user reviews,0,0,0
1228650,True,0,No user reviews,0,0,0
1228660,True,0,5 user reviews,4,1,5
1228670,True,0,No user reviews,0,0,0
1228680,True,0,8 user reviews,7,1,8
1228700,True,0,No user reviews,0,0,0
1228720,True,0,2 user reviews,1,1,2
1228730,True,0,1 user reviews,1,0,1
1228740,True,0,6 user reviews,6,0,6
1228760,True,0,2 user reviews,2,0,2
1228790,True,0,6 user reviews,4,2,6
1228810,True,0,7 user reviews,6,1,7
1228820,True,0,No user reviews,0,0,0
1228840,True,0,1 user reviews,0,1,1
1228860,True,0,1 user reviews,1,0,1
1228870,True,0,6 user reviews,6,0,6
1228880,True,0,No user reviews,0,0,0
1228910,True,0,2 user reviews,1,1,2
1228920,True,0,2 user reviews,0,2,2
1228950,True,0,No user reviews,0,0,0
1228960,True,0,4 user reviews,4,0,4
1228970,True,0,1 user reviews,1,0,1
1228980,True,0,No user reviews,0,0,0
1229000,True,0,No user reviews,0,0,0
1229010,True,0,3 user reviews,1,2,3
1229030,True,7,Positive,19,4,23
1229040,True,0,2 user reviews,1,1,2
1229060,True,0,No user reviews,0,0,0
1229090,True,0,No user reviews,0,0,0
1229100,True,0,1 user reviews,1,0,1
1229170,True,0,1 user reviews,1,0,1
1229190,True,0,1 user reviews,1,0,1
1229200,True,0,No user reviews,0,0,0
1229240,True,0,No user reviews,0,0,0
1229250,True,0,3 user reviews,1,2,3
1229260,True,0,4 user reviews,4,0,4
1229270,True,0,No user reviews,0,0,0
1229280,True,0,5 user reviews,5,0,5
1229310,True,6,Mostly Positive,14,5,19
1229320,True,0,4 user reviews,3,1,4
1229330,True,0,No user reviews,0,0,0
1229350,True,0,No user reviews,0,0,0
1229370,True,0,2 user reviews,1,1,2
1229380,True,0,No user reviews,0,0,0
1229400,True,0,No user reviews,0,0,0
1229420,True,5,Mixed,14,18,32
1229450,True,0,No user reviews,0,0,0
1229460,True,0,No user reviews,0,0,0
1229490,True,9,Overwhelmingly Positive,2384,9,2393
1229500,True,0,6 user reviews,2,4,6
1229510,True,0,2 user reviews,1,1,2
1229520,True,0,No user reviews,0,0,0
1229530,True,0,No user reviews,0,0,0
1229570,True,0,No user reviews,0,0,0
1229580,True,8,Very Positive,86,2,88
1229590,True,0,1 user reviews,1,0,1
1229630,True,0,No user reviews,0,0,0
1229640,True,0,1 user reviews,0,1,1
1229650,True,0,3 user reviews,3,0,3
1229670,True,0,No user reviews,0,0,0
1229690,True,0,No user reviews,0,0,0
1229700,True,0,No user reviews,0,0,0
1229720,True,0,1 user reviews,0,1,1
1229730,True,5,Mixed,5,6,11
1229770,True,0,No user reviews,0,0,0
1229820,True,0,No user reviews,0,0,0
1229830,True,0,No user reviews,0,0,0
1229840,True,0,No user reviews,0,0,0
1229850,True,0,No user reviews,0,0,0
1229860,True,0,No user reviews,0,0,0
1229870,True,0,No user reviews,0,0,0
1229900,True,8,Very Positive,123,14,137
1229920,True,0,No user reviews,0,0,0
1229950,True,0,No user reviews,0,0,0
1229951,True,0,No user reviews,0,0,0
1229952,True,0,No user reviews,0,0,0
1229970,True,0,1 user reviews,1,0,1
1230000,True,0,No user reviews,0,0,0
1230010,True,0,No user reviews,0,0,0
1230020,True,0,No user reviews,0,0,0
1230040,True,0,No user reviews,0,0,0
1230100,True,0,5 user reviews,2,3,5
1230120,True,0,No user reviews,0,0,0
1230140,True,8,Very Positive,132,3,135
1230160,True,0,No user reviews,0,0,0
1230170,True,0,No user reviews,0,0,0
1230180,True,0,No user reviews,0,0,0
1230200,True,0,9 user reviews,8,1,9
1230210,True,0,No user reviews,0,0,0
1230230,True,7,Positive,22,0,22
1230260,True,0,No user reviews,0,0,0
1230270,True,0,7 user reviews,2,5,7
1230271,True,7,Positive,15,1,16
1230272,True,0,2 user reviews,2,0,2
1230273,True,0,3 user reviews,3,0,3
1230274,True,0,3 user reviews,3,0,3
1230275,True,4,Mostly Negative,5,10,15
1230276,True,0,2 user reviews,2,0,2
1230277,True,3,Negative,3,14,17
1230278,True,0,2 user reviews,1,1,2
1230279,True,7,Positive,37,1,38
1230280,True,0,No user reviews,0,0,0
1230290,True,0,No user reviews,0,0,0
1230300,True,0,2 user reviews,2,0,2
1230340,True,7,Positive,9,2,11
1230360,True,0,No user reviews,0,0,0
1230380,True,0,No user reviews,0,0,0
1230410,True,0,No user reviews,0,0,0
1230430,True,0,1 user reviews,1,0,1
1230440,True,0,No user reviews,0,0,0
1230441,True,0,No user reviews,0,0,0
1230442,True,0,No user reviews,0,0,0
1230470,True,0,No user reviews,0,0,0
1230480,True,0,1 user reviews,1,0,1
1230481,True,0,5 user reviews,3,2,5
1230482,True,0,No user reviews,0,0,0
1230483,True,0,1 user reviews,0,1,1
1230490,True,0,No user reviews,0,0,0
1230500,True,0,No user reviews,0,0,0
1230510,True,6,Mostly Positive,27,7,34
1230540,True,0,No user reviews,0,0,0
1230560,True,7,Positive,22,5,27
1230570,True,0,2 user reviews,1,1,2
1230580,True,0,1 user reviews,1,0,1
1230600,True,0,No user reviews,0,0,0
1230630,True,0,No user reviews,0,0,0
1230640,True,0,No user reviews,0,0,0
1230650,True,0,5 user reviews,5,0,5
1230660,True,0,2 user reviews,2,0,2
1230690,True,0,No user reviews,0,0,0
1230700,True,0,No user reviews,0,0,0
1230710,True,0,No user reviews,0,0,0
1230730,True,0,No user reviews,0,0,0
1230740,True,0,No user reviews,0,0,0
1230750,True,0,No user reviews,0,0,0
1230760,True,7,Positive,26,4,30
1230770,True,0,No user reviews,0,0,0
1230790,True,0,1 user reviews,0,1,1
1230800,True,8,Very Positive,51,4,55
1230830,True,0,3 user reviews,3,0,3
1230840,True,0,No user reviews,0,0,0
1230860,True,7,Positive,32,3,35
1230870,True,0,1 user reviews,0,1,1
1230880,True,0,No user reviews,0,0,0
1230910,True,0,No user reviews,0,0,0
1230930,True,0,No user reviews,0,0,0
1230940,True,0,No user reviews,0,0,0
1230950,True,0,No user reviews,0,0,0
1230960,True,0,No user reviews,0,0,0
1230970,True,0,No user reviews,0,0,0
1230980,True,0,No user reviews,0,0,0
1230990,True,0,7 user reviews,7,0,7
1231000,True,0,No user reviews,0,0,0
1231010,True,0,No user reviews,0,0,0
1231020,True,0,No user reviews,0,0,0
1231040,True,0,1 user reviews,0,1,1
1231060,True,0,No user reviews,0,0,0
1231080,True,0,No user reviews,0,0,0
1231090,True,0,2 user reviews,0,2,2
1231100,True,0,No user reviews,0,0,0
1231120,True,0,1 user reviews,1,0,1
1231130,True,0,1 user reviews,1,0,1
1231150,True,0,No user reviews,0,0,0
1231160,True,0,No user reviews,0,0,0
1231180,True,0,1 user reviews,0,1,1
1231190,True,0,1 user reviews,0,1,1
1231200,True,0,No user reviews,0,0,0
1231210,True,0,No user reviews,0,0,0
1231250,True,0,3 user reviews,3,0,3
1231270,True,0,1 user reviews,1,0,1
1231290,True,0,5 user reviews,5,0,5
1231320,True,0,No user reviews,0,0,0
1231340,True,0,No user reviews,0,0,0
1231440,True,0,No user reviews,0,0,0
1231450,True,0,No user reviews,0,0,0
1231460,True,0,No user reviews,0,0,0
1231500,True,0,No user reviews,0,0,0
1231510,True,0,No user reviews,0,0,0
1231520,True,6,Mostly Positive,14,4,18
1231530,True,0,No user reviews,0,0,0
1231560,True,0,No user reviews,0,0,0
1231570,True,0,No user reviews,0,0,0
1231580,True,0,8 user reviews,4,4,8
1231590,True,0,No user reviews,0,0,0
1231610,True,0,No user reviews,0,0,0
1231640,True,0,3 user reviews,3,0,3
1231660,True,0,2 user reviews,2,0,2
1231670,True,0,1 user reviews,1,0,1
1231690,True,0,2 user reviews,2,0,2
1231700,True,0,No user reviews,0,0,0
1231710,True,0,No user reviews,0,0,0
1231720,True,0,No user reviews,0,0,0
1231740,True,0,7 user reviews,6,1,7
1231750,True,0,4 user reviews,2,2,4
1231760,True,0,2 user reviews,0,2,2
1231770,True,0,No user reviews,0,0,0
1231780,True,0,No user reviews,0,0,0
1231790,True,0,No user reviews,0,0,0
1231800,True,0,1 user reviews,0,1,1
1231810,True,0,No user reviews,0,0,0
1231820,True,0,2 user reviews,0,2,2
1231830,True,0,No user reviews,0,0,0
1231840,True,0,No user reviews,0,0,0
1231850,True,0,No user reviews,0,0,0
1231860,True,0,No user reviews,0,0,0
1231870,True,0,No user reviews,0,0,0
1231880,True,0,No user reviews,0,0,0
1231900,True,0,No user reviews,0,0,0
1231910,True,0,No user reviews,0,0,0
1231920,True,0,No user reviews,0,0,0
1231930,True,0,No user reviews,0,0,0
1231940,True,0,4 user reviews,4,0,4
1231950,True,7,Positive,12,1,13
1231960,True,0,No user reviews,0,0,0
1231970,True,7,Positive,14,3,17
1231980,True,0,1 user reviews,1,0,1
1231990,True,0,No user reviews,0,0,0
1232010,True,7,Positive,16,0,16
1232030,True,0,2 user reviews,2,0,2
1232050,True,0,No user reviews,0,0,0
1232070,True,8,Very Positive,52,10,62
1232080,True,0,No user reviews,0,0,0
1232100,True,7,Positive,14,0,14
1232120,True,0,1 user reviews,0,1,1
1232130,True,7,Positive,43,4,47
1232140,True,6,Mostly Positive,10,3,13
1232150,True,0,No user reviews,0,0,0
1232170,True,0,No user reviews,0,0,0
1232180,True,8,Very Positive,419,7,426
1232190,True,0,No user reviews,0,0,0
1232200,True,0,No user reviews,0,0,0
1232210,True,0,No user reviews,0,0,0
1232230,True,0,1 user reviews,1,0,1
1232251,True,4,Mostly Negative,9,26,35
1232252,True,0,3 user reviews,0,3,3
1232253,True,5,Mixed,28,23,51
1232254,True,5,Mixed,18,24,42
1232255,True,2,Very Negative,11,67,78
1232256,True,8,Very Positive,181,16,197
1232257,True,6,Mostly Positive,234,87,321
1232260,True,0,3 user reviews,3,0,3
1232290,True,0,1 user reviews,1,0,1
1232310,True,0,4 user reviews,3,1,4
1232320,True,0,No user reviews,0,0,0
1232330,True,8,Very Positive,52,2,54
1232340,True,0,No user reviews,0,0,0
1232350,True,0,No user reviews,0,0,0
1232370,True,0,No user reviews,0,0,0
1232380,True,0,3 user reviews,1,2,3
1232390,True,0,2 user reviews,2,0,2
1232420,True,0,No user reviews,0,0,0
1232430,True,0,3 user reviews,3,0,3
1232450,True,0,No user reviews,0,0,0
1232460,True,6,Mostly Positive,37,14,51
1232470,True,0,No user reviews,0,0,0
1232500,True,0,2 user reviews,1,1,2
1232510,True,0,No user reviews,0,0,0
1232520,True,0,7 user reviews,7,0,7
1232530,True,0,No user reviews,0,0,0
1232540,True,0,1 user reviews,0,1,1
1232550,True,0,No user reviews,0,0,0
1232570,True,8,Very Positive,106,4,110
1232580,True,8,Very Positive,47,10,57
1232590,True,7,Positive,20,3,23
1232610,True,0,No user reviews,0,0,0
1232640,True,0,9 user reviews,8,1,9
1232650,True,0,No user reviews,0,0,0
1232670,True,0,1 user reviews,1,0,1
1232690,True,0,No user reviews,0,0,0
1232710,True,0,No user reviews,0,0,0
1232720,True,0,No user reviews,0,0,0
1232730,True,0,1 user reviews,0,1,1
1232740,True,0,6 user reviews,6,0,6
1232750,True,0,No user reviews,0,0,0
1232770,True,0,No user reviews,0,0,0
1232780,True,0,1 user reviews,1,0,1
1232800,True,0,No user reviews,0,0,0
1232810,True,0,8 user reviews,8,0,8
1232830,True,0,1 user reviews,1,0,1
1232870,True,0,No user reviews,0,0,0
1232880,True,0,No user reviews,0,0,0
1232890,True,0,No user reviews,0,0,0
1232900,True,0,No user reviews,0,0,0
1232910,True,0,2 user reviews,2,0,2
1232920,True,0,No user reviews,0,0,0
1232940,True,7,Positive,36,3,39
1232980,True,0,No user reviews,0,0,0
1232990,True,0,No user reviews,0,0,0
1233020,True,0,No user reviews,0,0,0
1233030,True,0,1 user reviews,1,0,1
1233040,True,0,No user reviews,0,0,0
1233050,True,0,No user reviews,0,0,0
1233060,True,5,Mixed,90,104,194
1233061,True,4,Mostly Negative,95,182,277
1233062,True,5,Mixed,45,29,74
1233070,True,0,No user reviews,0,0,0
1233080,True,0,No user reviews,0,0,0
1233090,True,0,No user reviews,0,0,0
1233100,True,0,7 user reviews,7,0,7
1233120,True,0,1 user reviews,0,1,1
1233170,True,5,Mixed,12,6,18
1233200,True,0,No user reviews,0,0,0
1233210,True,0,No user reviews,0,0,0
1233220,True,0,9 user reviews,9,0,9
1233230,True,0,5 user reviews,5,0,5
1233240,True,0,1 user reviews,1,0,1
1233250,True,0,5 user reviews,5,0,5
1233260,True,5,Mixed,302,142,444
1233270,True,8,Very Positive,82,7,89
1233280,True,0,1 user reviews,1,0,1
1233290,True,0,No user reviews,0,0,0
1233300,True,0,No user reviews,0,0,0
1233310,True,0,No user reviews,0,0,0
1233320,True,0,No user reviews,0,0,0
1233330,True,0,2 user reviews,2,0,2
1233340,True,0,1 user reviews,1,0,1
1233350,True,5,Mixed,8,4,12
1233360,True,0,No user reviews,0,0,0
1233370,True,0,7 user reviews,3,4,7
1233371,True,5,Mixed,7,5,12
1233380,True,0,8 user reviews,4,4,8
1233390,True,0,No user reviews,0,0,0
1233410,True,0,No user reviews,0,0,0
1233420,True,6,Mostly Positive,7,3,10
1233460,True,0,1 user reviews,1,0,1
1233490,True,0,No user reviews,0,0,0
1233500,True,0,No user reviews,0,0,0
1233510,True,0,No user reviews,0,0,0
1233520,True,0,No user reviews,0,0,0
1233540,True,7,Positive,33,0,33
1233550,True,6,Mostly Positive,262,85,347
1233560,True,0,No user reviews,0,0,0
1233570,True,8,Very Positive,761,164,925
1233580,True,0,3 user reviews,3,0,3
1233590,True,0,No user reviews,0,0,0
1233600,True,0,1 user reviews,0,1,1
1233610,True,0,No user reviews,0,0,0
1233640,True,0,No user reviews,0,0,0
1233650,True,0,No user reviews,0,0,0
1233690,True,7,Positive,43,2,45
1233710,True,5,Mixed,25,20,45
1233720,True,7,Positive,17,2,19
1233730,True,0,No user reviews,0,0,0
1233780,True,6,Mostly Positive,53,17,70
1233790,True,0,No user reviews,0,0,0
1233800,True,8,Very Positive,45,8,53
1233810,True,0,No user reviews,0,0,0
1233820,True,7,Positive,22,3,25
1233840,True,0,5 user reviews,3,2,5
1233850,True,0,7 user reviews,3,4,7
1233860,True,0,No user reviews,0,0,0
1233880,True,8,Very Positive,101,3,104
1233900,True,5,Mixed,13,12,25
1233950,True,8,Very Positive,96,2,98
1233960,True,0,No user reviews,0,0,0
1233990,True,0,1 user reviews,0,1,1
1234030,True,0,1 user reviews,1,0,1
1234070,True,0,No user reviews,0,0,0
1234120,True,0,2 user reviews,1,1,2
1234150,True,0,No user reviews,0,0,0
1234160,True,0,No user reviews,0,0,0
1234170,True,0,No user reviews,0,0,0
1234180,True,0,No user reviews,0,0,0
1234190,True,8,Very Positive,51,9,60
1234200,True,0,No user reviews,0,0,0
1234210,True,0,No user reviews,0,0,0
1234220,True,7,Positive,19,2,21
1234230,True,0,No user reviews,0,0,0
1234240,True,7,Positive,20,2,22
1234260,True,7,Positive,18,2,20
1234270,True,0,1 user reviews,1,0,1
1234280,True,0,No user reviews,0,0,0
1234290,True,0,No user reviews,0,0,0
1234320,True,0,No user reviews,0,0,0
1234340,True,0,No user reviews,0,0,0
1234360,True,0,No user reviews,0,0,0
1234380,True,0,3 user reviews,0,3,3
1234390,True,0,No user reviews,0,0,0
1234391,True,0,No user reviews,0,0,0
1234392,True,0,1 user reviews,0,1,1
1234393,True,0,No user reviews,0,0,0
1234400,True,0,No user reviews,0,0,0
1234410,True,0,No user reviews,0,0,0
1234450,True,5,Mixed,10,15,25
1234460,True,0,No user reviews,0,0,0
1234470,True,0,No user reviews,0,0,0
1234490,True,0,1 user reviews,1,0,1
1234510,True,0,No user reviews,0,0,0
1234520,True,8,Very Positive,285,12,297
1234540,True,0,2 user reviews,2,0,2
1234550,True,6,Mostly Positive,10,4,14
1234560,True,0,No user reviews,0,0,0
1234570,True,0,No user reviews,0,0,0
1234580,True,0,2 user reviews,2,0,2
1234590,True,0,No user reviews,0,0,0
1234600,True,0,No user reviews,0,0,0
1234610,True,0,No user reviews,0,0,0
1234620,True,8,Very Positive,64,7,71
1234630,True,0,No user reviews,0,0,0
1234680,True,0,No user reviews,0,0,0
1234690,True,0,No user reviews,0,0,0
1234700,True,0,5 user reviews,5,0,5
1234710,True,0,No user reviews,0,0,0
1234730,True,0,No user reviews,0,0,0
1234740,True,0,No user reviews,0,0,0
1234750,True,0,5 user reviews,4,1,5
1234760,True,0,4 user reviews,2,2,4
1234780,True,0,No user reviews,0,0,0
1234810,True,0,No user reviews,0,0,0
1234820,True,0,1 user reviews,0,1,1
1234830,True,0,9 user reviews,7,2,9
1234840,True,5,Mixed,7,4,11
1234850,True,0,3 user reviews,3,0,3
1234870,True,0,No user reviews,0,0,0
1234890,True,0,1 user reviews,1,0,1
1234900,True,0,2 user reviews,1,1,2
1234920,True,0,No user reviews,0,0,0
1234930,True,0,1 user reviews,1,0,1
1234940,True,7,Positive,12,0,12
1234950,True,6,Mostly Positive,10,4,14
1234960,True,0,No user reviews,0,0,0
1234970,True,0,No user reviews,0,0,0
1234980,True,0,2 user reviews,1,1,2
1235060,True,0,1 user reviews,1,0,1
1235070,True,0,No user reviews,0,0,0
1235080,True,0,1 user reviews,1,0,1
1235090,True,0,4 user reviews,3,1,4
1235100,True,0,No user reviews,0,0,0
1235110,True,7,Positive,40,4,44
1235120,True,7,Positive,28,4,32
1235130,True,0,3 user reviews,3,0,3
1235140,True,0,No user reviews,0,0,0
1235160,True,0,1 user reviews,1,0,1
1235220,True,0,No user reviews,0,0,0
1235260,True,0,No user reviews,0,0,0
1235320,True,0,No user reviews,0,0,0
1235330,True,0,1 user reviews,1,0,1
1235340,True,0,No user reviews,0,0,0
1235350,True,0,3 user reviews,3,0,3
1235360,True,8,Very Positive,60,3,63
1235370,True,0,No user reviews,0,0,0
1235380,True,0,No user reviews,0,0,0
1235400,True,0,2 user reviews,2,0,2
1235410,True,0,No user reviews,0,0,0
1235430,True,0,No user reviews,0,0,0
1235440,True,0,No user reviews,0,0,0
1235450,True,0,No user reviews,0,0,0
1235460,True,0,8 user reviews,5,3,8
1235480,True,0,2 user reviews,0,2,2
1235510,True,0,No user reviews,0,0,0
1235520,True,0,2 user reviews,1,1,2
1235530,True,0,No user reviews,0,0,0
1235570,True,0,2 user reviews,2,0,2
1235580,True,0,No user reviews,0,0,0
1235600,True,0,No user reviews,0,0,0
1235650,True,0,No user reviews,0,0,0
1235660,True,0,No user reviews,0,0,0
1235670,True,0,No user reviews,0,0,0
1235710,True,0,No user reviews,0,0,0
1235720,True,0,3 user reviews,3,0,3
1235721,True,5,Mixed,6,4,10
1235722,True,0,3 user reviews,1,2,3
1235730,True,0,1 user reviews,1,0,1
1235731,True,0,1 user reviews,1,0,1
1235732,True,0,4 user reviews,3,1,4
1235733,True,0,4 user reviews,3,1,4
1235734,True,0,3 user reviews,3,0,3
1235740,True,0,No user reviews,0,0,0
1235741,True,0,No user reviews,0,0,0
1235742,True,0,No user reviews,0,0,0
1235743,True,0,2 user reviews,1,1,2
1235744,True,0,No user reviews,0,0,0
1235745,True,0,No user reviews,0,0,0
1235746,True,0,2 user reviews,2,0,2
1235747,True,0,1 user reviews,0,1,1
1235750,True,0,No user reviews,0,0,0
1235751,True,0,1 user reviews,1,0,1
1235752,True,0,No user reviews,0,0,0
1235753,True,0,No user reviews,0,0,0
1235754,True,0,No user reviews,0,0,0
1235755,True,0,1 user reviews,0,1,1
1235756,True,0,No user reviews,0,0,0
1235757,True,0,1 user reviews,1,0,1
1235758,True,0,1 user reviews,1,0,1
1235759,True,0,1 user reviews,1,0,1
1235760,True,0,No user reviews,0,0,0
1235761,True,0,No user reviews,0,0,0
1235762,True,0,No user reviews,0,0,0
1235763,True,0,No user reviews,0,0,0
1235764,True,0,No user reviews,0,0,0
1235765,True,0,No user reviews,0,0,0
1235766,True,0,1 user reviews,1,0,1
1235767,True,0,No user reviews,0,0,0
1235770,True,0,1 user reviews,1,0,1
1235780,True,0,No user reviews,0,0,0
1235790,True,0,No user reviews,0,0,0
1235810,True,0,No user reviews,0,0,0
1235830,True,0,No user reviews,0,0,0
1235850,True,0,No user reviews,0,0,0
1235910,True,6,Mostly Positive,7,3,10
1235940,True,0,No user reviews,0,0,0
1235950,True,0,No user reviews,0,0,0
1235960,True,0,No user reviews,0,0,0
1235980,True,0,No user reviews,0,0,0
1235990,True,0,No user reviews,0,0,0
1236000,True,0,3 user reviews,2,1,3
1236010,True,0,No user reviews,0,0,0
1236020,True,0,No user reviews,0,0,0
1236040,True,7,Positive,10,2,12
1236050,True,0,No user reviews,0,0,0
1236070,True,0,No user reviews,0,0,0
1236100,True,0,No user reviews,0,0,0
1236140,True,0,2 user reviews,1,1,2
1236160,True,7,Positive,11,0,11
1236170,True,0,No user reviews,0,0,0
1236180,True,0,No user reviews,0,0,0
1236190,True,7,Positive,9,2,11
1236210,True,0,No user reviews,0,0,0
1236230,True,0,No user reviews,0,0,0
1236240,True,0,No user reviews,0,0,0
1236250,True,0,No user reviews,0,0,0
1236260,True,0,1 user reviews,1,0,1
1236270,True,0,No user reviews,0,0,0
1236320,True,0,4 user reviews,1,3,4
1236330,True,0,1 user reviews,0,1,1
1236350,True,0,No user reviews,0,0,0
1236360,True,5,Mixed,14,9,23
1236400,True,0,5 user reviews,2,3,5
1236450,True,0,1 user reviews,1,0,1
1236460,True,0,No user reviews,0,0,0
1236480,True,0,3 user reviews,1,2,3
1236490,True,0,No user reviews,0,0,0
1236500,True,5,Mixed,17,9,26
1236501,True,0,8 user reviews,6,2,8
1236520,True,0,No user reviews,0,0,0
1236530,True,0,6 user reviews,4,2,6
1236550,True,0,No user reviews,0,0,0
1236560,True,0,No user reviews,0,0,0
1236580,True,0,No user reviews,0,0,0
1236610,True,0,No user reviews,0,0,0
1236620,True,0,No user reviews,0,0,0
1236630,True,0,No user reviews,0,0,0
1236640,True,0,5 user reviews,5,0,5
1236650,True,0,No user reviews,0,0,0
1236660,True,0,No user reviews,0,0,0
1236670,True,0,3 user reviews,2,1,3
1236700,True,7,Positive,43,1,44
1236710,True,0,No user reviews,0,0,0
1236720,True,8,Very Positive,143,17,160
1236760,True,0,5 user reviews,3,2,5
1236790,True,0,1 user reviews,1,0,1
1236810,True,0,4 user reviews,4,0,4
1236820,True,0,No user reviews,0,0,0
1236860,True,0,5 user reviews,5,0,5
1236880,True,0,1 user reviews,1,0,1
1236890,True,7,Positive,16,0,16
1236900,True,0,9 user reviews,8,1,9
1236920,True,0,1 user reviews,0,1,1
1236930,True,0,No user reviews,0,0,0
1236940,True,0,No user reviews,0,0,0
1236960,True,0,1 user reviews,1,0,1
1236990,True,8,Very Positive,686,48,734
1237020,True,0,1 user reviews,1,0,1
1237030,True,0,No user reviews,0,0,0
1237040,True,0,No user reviews,0,0,0
1237050,True,0,No user reviews,0,0,0
1237060,True,0,No user reviews,0,0,0
1237080,True,5,Mixed,16,10,26
1237090,True,0,2 user reviews,2,0,2
1237100,True,0,1 user reviews,1,0,1
1237110,True,0,No user reviews,0,0,0
1237120,True,0,No user reviews,0,0,0
1237160,True,0,No user reviews,0,0,0
1237190,True,0,No user reviews,0,0,0
1237210,True,0,No user reviews,0,0,0
1237220,True,0,6 user reviews,3,3,6
1237230,True,0,No user reviews,0,0,0
1237240,True,0,No user reviews,0,0,0
1237250,True,0,No user reviews,0,0,0
1237260,True,0,3 user reviews,3,0,3
1237270,True,7,Positive,17,3,20
1237310,True,0,No user reviews,0,0,0
1237330,True,0,No user reviews,0,0,0
1237340,True,0,No user reviews,0,0,0
1237350,True,0,No user reviews,0,0,0
1237360,True,0,No user reviews,0,0,0
1237370,True,0,No user reviews,0,0,0
1237410,True,0,1 user reviews,0,1,1
1237420,True,0,2 user reviews,2,0,2
1237430,True,0,8 user reviews,8,0,8
1237450,True,0,No user reviews,0,0,0
1237460,True,0,No user reviews,0,0,0
1237470,True,0,No user reviews,0,0,0
1237480,True,0,1 user reviews,0,1,1
1237490,True,0,7 user reviews,6,1,7
1237510,True,0,No user reviews,0,0,0
1237523,True,0,9 user reviews,8,1,9
1237524,True,0,4 user reviews,4,0,4
1237530,True,7,Positive,10,1,11
1237540,True,5,Mixed,22,14,36
1237550,True,0,No user reviews,0,0,0
1237560,True,0,1 user reviews,1,0,1
1237570,True,0,5 user reviews,4,1,5
1237590,True,0,No user reviews,0,0,0
1237600,True,0,No user reviews,0,0,0
1237610,True,6,Mostly Positive,43,15,58
1237620,True,0,No user reviews,0,0,0
1237630,True,0,2 user reviews,1,1,2
1237650,True,0,No user reviews,0,0,0
1237660,True,0,No user reviews,0,0,0
1237670,True,0,1 user reviews,1,0,1
1237690,True,0,No user reviews,0,0,0
1237700,True,0,1 user reviews,1,0,1
1237720,True,0,5 user reviews,3,2,5
1237721,True,4,Mostly Negative,8,16,24
1237730,True,0,No user reviews,0,0,0
1237760,True,0,3 user reviews,2,1,3
1237770,True,0,2 user reviews,2,0,2
1237780,True,0,No user reviews,0,0,0
1237800,True,0,5 user reviews,3,2,5
1237820,True,0,2 user reviews,1,1,2
1237830,True,6,Mostly Positive,8,3,11
1237840,True,0,1 user reviews,0,1,1
1237850,True,0,No user reviews,0,0,0
1237860,True,0,1 user reviews,0,1,1
1237870,True,0,3 user reviews,3,0,3
1237880,True,0,5 user reviews,4,1,5
1237900,True,0,2 user reviews,2,0,2
1237910,True,0,No user reviews,0,0,0
1237930,True,0,No user reviews,0,0,0
1237940,True,0,No user reviews,0,0,0
1237950,True,8,Very Positive,2953,490,3443
1237970,True,9,Overwhelmingly Positive,13377,505,13882
1237980,True,6,Mostly Positive,154,66,220
1238000,True,6,Mostly Positive,664,180,844
1238011,True,0,No user reviews,0,0,0
1238012,True,0,No user reviews,0,0,0
1238013,True,0,No user reviews,0,0,0
1238014,True,0,No user reviews,0,0,0
1238020,True,5,Mixed,267,138,405
1238030,True,5,Mixed,7,6,13
1238040,True,6,Mostly Positive,215,61,276
1238050,True,5,Mixed,5,7,12
1238060,True,6,Mostly Positive,409,130,539
1238070,True,4,Mostly Negative,7,13,20
1238080,True,5,Mixed,492,323,815
1238090,True,0,5 user reviews,5,0,5
1238100,True,0,4 user reviews,4,0,4
1238101,True,3,Negative,0,27,27
1238102,True,0,1 user reviews,1,0,1
1238103,True,7,Positive,21,3,24
1238104,True,0,4 user reviews,3,1,4
1238105,True,0,4 user reviews,3,1,4
1238120,True,0,No user reviews,0,0,0
1238130,True,0,No user reviews,0,0,0
1238170,True,0,No user reviews,0,0,0
1238180,True,0,No user reviews,0,0,0
1238200,True,0,1 user reviews,1,0,1
1238210,True,0,No user reviews,0,0,0
1238220,True,0,1 user reviews,1,0,1
1238250,True,0,5 user reviews,5,0,5
1238270,True,0,No user reviews,0,0,0
1238280,True,0,No user reviews,0,0,0
1238290,True,0,No user reviews,0,0,0
1238310,True,0,No user reviews,0,0,0
1238320,True,6,Mostly Positive,9,3,12
1238330,True,7,Positive,14,1,15
1238340,True,0,1 user reviews,1,0,1
1238350,True,0,No user reviews,0,0,0
1238360,True,7,Positive,8,2,10
1238381,True,0,No user reviews,0,0,0
1238400,True,0,9 user reviews,7,2,9
1238410,True,0,No user reviews,0,0,0
1238430,True,0,3 user reviews,3,0,3
1238440,True,5,Mixed,97,64,161
1238450,True,0,No user reviews,0,0,0
1238460,True,0,No user reviews,0,0,0
1238470,True,0,No user reviews,0,0,0
1238480,True,0,No user reviews,0,0,0
1238490,True,0,No user reviews,0,0,0
1238520,True,0,5 user reviews,4,1,5
1238530,True,0,No user reviews,0,0,0
1238540,True,0,No user reviews,0,0,0
1238550,True,0,No user reviews,0,0,0
1238570,True,0,No user reviews,0,0,0
1238590,True,0,No user reviews,0,0,0
1238620,True,0,No user reviews,0,0,0
1238630,True,0,1 user reviews,0,1,1
1238640,True,0,No user reviews,0,0,0
1238650,True,0,No user reviews,0,0,0
1238660,True,0,2 user reviews,2,0,2
1238680,True,0,6 user reviews,6,0,6
1238710,True,0,1 user reviews,1,0,1
1238720,True,0,No user reviews,0,0,0
1238730,True,7,Positive,40,0,40
1238750,True,0,No user reviews,0,0,0
1238760,True,7,Positive,15,3,18
1238761,True,0,No user reviews,0,0,0
1238762,True,0,No user reviews,0,0,0
1238770,True,0,No user reviews,0,0,0
1238780,True,0,No user reviews,0,0,0
1238790,True,0,No user reviews,0,0,0
1238810,True,5,Mixed,925,505,1430
1238820,True,5,Mixed,441,412,853
1238830,True,0,No user reviews,0,0,0
1238831,True,0,1 user reviews,0,1,1
1238840,True,6,Mostly Positive,827,220,1047
1238850,True,0,No user reviews,0,0,0
1238851,True,0,2 user reviews,2,0,2
1238860,True,6,Mostly Positive,1820,456,2276
1238871,True,0,5 user reviews,3,2,5
1238880,True,5,Mixed,105,85,190
1238891,True,0,No user reviews,0,0,0
1238920,True,0,No user reviews,0,0,0
1238970,True,0,1 user reviews,1,0,1
1238980,True,0,No user reviews,0,0,0
1238990,True,0,No user reviews,0,0,0
1239000,True,7,Positive,9,2,11
1239010,True,0,4 user reviews,4,0,4
1239020,True,0,No user reviews,0,0,0
1239030,True,0,No user reviews,0,0,0
1239050,True,8,Very Positive,126,13,139
1239060,True,0,No user reviews,0,0,0
1239080,True,0,No user reviews,0,0,0
1239090,True,0,1 user reviews,0,1,1
1239100,True,0,No user reviews,0,0,0
1239110,True,0,1 user reviews,1,0,1
1239120,True,0,1 user reviews,1,0,1
1239130,True,0,5 user reviews,5,0,5
1239140,True,0,No user reviews,0,0,0
1239150,True,0,1 user reviews,1,0,1
1239170,True,0,No user reviews,0,0,0
1239180,True,0,No user reviews,0,0,0
1239190,True,0,No user reviews,0,0,0
1239210,True,0,No user reviews,0,0,0
1239250,True,0,3 user reviews,2,1,3
1239260,True,6,Mostly Positive,20,7,27
1239270,True,0,2 user reviews,1,1,2
1239290,True,0,No user reviews,0,0,0
1239300,True,0,No user reviews,0,0,0
1239310,True,0,No user reviews,0,0,0
1239320,True,0,No user reviews,0,0,0
1239340,True,0,No user reviews,0,0,0
1239360,True,0,No user reviews,0,0,0
1239390,True,0,No user reviews,0,0,0
1239400,True,0,1 user reviews,1,0,1
1239420,True,0,No user reviews,0,0,0
1239430,True,4,Mostly Negative,148,235,383
1239440,True,5,Mixed,51,26,77
1239450,True,7,Positive,38,0,38
1239470,True,0,3 user reviews,3,0,3
1239490,True,0,1 user reviews,1,0,1
1239510,True,0,6 user reviews,6,0,6
1239511,True,0,5 user reviews,5,0,5
1239512,True,0,3 user reviews,3,0,3
1239513,True,0,4 user reviews,4,0,4
1239514,True,7,Positive,13,0,13
1239520,True,5,Mixed,434,565,999
1239580,True,7,Positive,12,1,13
1239590,True,0,2 user reviews,0,2,2
1239600,True,0,No user reviews,0,0,0
1239640,True,0,No user reviews,0,0,0
1239650,True,0,No user reviews,0,0,0
1239660,True,5,Mixed,13,14,27
1239680,True,0,1 user reviews,1,0,1
1239690,True,9,Overwhelmingly Positive,1108,44,1152
1239700,True,8,Very Positive,445,21,466
1239710,True,0,No user reviews,0,0,0
1239720,True,0,No user reviews,0,0,0
1239740,True,0,No user reviews,0,0,0
1239770,True,0,No user reviews,0,0,0
1239780,True,0,No user reviews,0,0,0
1239820,True,0,No user reviews,0,0,0
1239830,True,0,No user reviews,0,0,0
1239870,True,0,No user reviews,0,0,0
1239890,True,0,4 user reviews,4,0,4
1239900,True,0,No user reviews,0,0,0
1239920,True,0,No user reviews,0,0,0
1239930,True,0,No user reviews,0,0,0
1239970,True,0,2 user reviews,1,1,2
1239980,True,0,No user reviews,0,0,0
1239990,True,0,2 user reviews,2,0,2
1240020,True,0,No user reviews,0,0,0
1240040,True,0,2 user reviews,2,0,2
1240050,True,7,Positive,35,8,43
1240090,True,0,3 user reviews,2,1,3
1240100,True,0,1 user reviews,1,0,1
1240120,True,0,No user reviews,0,0,0
1240130,True,0,No user reviews,0,0,0
1240140,True,0,No user reviews,0,0,0
1240151,True,0,No user reviews,0,0,0
1240180,True,0,No user reviews,0,0,0
1240200,True,0,1 user reviews,1,0,1
1240210,True,9,Overwhelmingly Positive,1486,36,1522
1240230,True,8,Very Positive,113,14,127
1240240,True,7,Positive,19,0,19
1240260,True,0,No user reviews,0,0,0
1240270,True,0,No user reviews,0,0,0
1240290,True,0,No user reviews,0,0,0
1240300,True,0,No user reviews,0,0,0
1240301,True,0,No user reviews,0,0,0
1240310,True,0,No user reviews,0,0,0
1240330,True,0,No user reviews,0,0,0
1240340,True,0,No user reviews,0,0,0
1240350,True,0,No user reviews,0,0,0
1240360,True,6,Mostly Positive,9,3,12
1240370,True,0,6 user reviews,6,0,6
1240380,True,0,No user reviews,0,0,0
1240390,True,0,9 user reviews,9,0,9
1240440,True,0,No user reviews,0,0,0
1240460,True,0,No user reviews,0,0,0
1240480,True,0,No user reviews,0,0,0
1240490,True,0,2 user reviews,0,2,2
1240510,True,0,No user reviews,0,0,0
1240530,True,0,No user reviews,0,0,0
1240540,True,0,No user reviews,0,0,0
1240550,True,0,No user reviews,0,0,0
1240580,True,0,No user reviews,0,0,0
1240590,True,0,No user reviews,0,0,0
1240600,True,0,1 user reviews,0,1,1
1240630,True,7,Positive,11,2,13
1240650,True,0,No user reviews,0,0,0
1240670,True,0,No user reviews,0,0,0
1240680,True,0,No user reviews,0,0,0
1240690,True,0,3 user reviews,3,0,3
1240730,True,0,8 user reviews,5,3,8
1240750,True,0,4 user reviews,4,0,4
1240760,True,0,1 user reviews,1,0,1
1240770,True,0,1 user reviews,1,0,1
1240790,True,0,No user reviews,0,0,0
1240810,True,0,No user reviews,0,0,0
1240830,True,0,1 user reviews,0,1,1
1240840,True,0,2 user reviews,2,0,2
1240870,True,0,No user reviews,0,0,0
1240890,True,0,3 user reviews,1,2,3
1240900,True,0,No user reviews,0,0,0
1240910,True,0,No user reviews,0,0,0
1240930,True,0,2 user reviews,2,0,2
1240940,True,0,No user reviews,0,0,0
1240950,True,0,No user reviews,0,0,0
1240960,True,0,No user reviews,0,0,0
1240970,True,0,No user reviews,0,0,0
1240980,True,0,No user reviews,0,0,0
1240990,True,0,No user reviews,0,0,0
1241000,True,0,No user reviews,0,0,0
1241010,True,0,No user reviews,0,0,0
1241020,True,5,Mixed,11,9,20
1241040,True,6,Mostly Positive,47,17,64
1241070,True,0,No user reviews,0,0,0
1241080,True,0,No user reviews,0,0,0
1241090,True,0,No user reviews,0,0,0
1241100,True,5,Mixed,15,7,22
1241110,True,0,3 user reviews,2,1,3
1241140,True,0,3 user reviews,2,1,3
1241160,True,0,No user reviews,0,0,0
1241170,True,0,No user reviews,0,0,0
1241180,True,0,No user reviews,0,0,0
1241190,True,0,No user reviews,0,0,0
1241210,True,0,No user reviews,0,0,0
1241230,True,0,No user reviews,0,0,0
1241240,True,0,No user reviews,0,0,0
1241250,True,0,No user reviews,0,0,0
1241260,True,0,1 user reviews,1,0,1
1241261,True,0,6 user reviews,4,2,6
1241262,True,0,5 user reviews,3,2,5
1241263,True,0,1 user reviews,1,0,1
1241264,True,0,2 user reviews,2,0,2
1241265,True,0,2 user reviews,2,0,2
1241266,True,0,2 user reviews,2,0,2
1241267,True,0,8 user reviews,8,0,8
1241268,True,0,4 user reviews,4,0,4
1241269,True,0,1 user reviews,1,0,1
1241270,True,0,No user reviews,0,0,0
1241271,True,7,Positive,30,1,31
1241272,True,0,1 user reviews,1,0,1
1241273,True,0,1 user reviews,1,0,1
1241274,True,0,1 user reviews,1,0,1
1241275,True,0,6 user reviews,6,0,6
1241276,True,0,3 user reviews,3,0,3
1241277,True,0,3 user reviews,3,0,3
1241278,True,0,2 user reviews,2,0,2
1241279,True,0,4 user reviews,4,0,4
1241280,True,0,1 user reviews,1,0,1
1241281,True,0,1 user reviews,1,0,1
1241282,True,0,1 user reviews,1,0,1
1241283,True,0,2 user reviews,2,0,2
1241284,True,0,3 user reviews,3,0,3
1241285,True,0,1 user reviews,1,0,1
1241286,True,0,2 user reviews,2,0,2
1241287,True,0,4 user reviews,4,0,4
1241288,True,0,2 user reviews,1,1,2
1241289,True,0,No user reviews,0,0,0
1241290,True,0,2 user reviews,2,0,2
1241291,True,0,1 user reviews,1,0,1
1241292,True,0,1 user reviews,1,0,1
1241293,True,0,1 user reviews,1,0,1
1241294,True,0,1 user reviews,1,0,1
1241295,True,0,2 user reviews,1,1,2
1241296,True,0,2 user reviews,2,0,2
1241297,True,0,1 user reviews,1,0,1
1241298,True,0,2 user reviews,2,0,2
1241299,True,0,1 user reviews,1,0,1
1241300,True,0,3 user reviews,3,0,3
1241340,True,0,3 user reviews,1,2,3
1241341,True,0,No user reviews,0,0,0
1241350,True,0,No user reviews,0,0,0
1241351,True,0,No user reviews,0,0,0
1241352,True,0,No user reviews,0,0,0
1241360,True,0,No user reviews,0,0,0
1241370,True,0,No user reviews,0,0,0
1241400,True,0,No user reviews,0,0,0
1241450,True,0,No user reviews,0,0,0
1241490,True,0,No user reviews,0,0,0
1241500,True,0,No user reviews,0,0,0
1241510,True,9,Overwhelmingly Positive,2448,113,2561
1241520,True,8,Very Positive,598,39,637
1241540,True,0,No user reviews,0,0,0
1241550,True,5,Mixed,90,54,144
1241570,True,0,8 user reviews,6,2,8
1241580,True,0,No user reviews,0,0,0
1241590,True,0,No user reviews,0,0,0
1241600,True,0,No user reviews,0,0,0
1241670,True,0,No user reviews,0,0,0
1241680,True,0,No user reviews,0,0,0
1241690,True,0,No user reviews,0,0,0
1241700,True,0,No user reviews,0,0,0
1241710,True,0,No user reviews,0,0,0
1241740,True,0,No user reviews,0,0,0
1241760,True,0,No user reviews,0,0,0
1241780,True,0,1 user reviews,1,0,1
1241810,True,0,No user reviews,0,0,0
1241820,True,0,No user reviews,0,0,0
1241830,True,0,No user reviews,0,0,0
1241850,True,0,No user reviews,0,0,0
1241860,True,0,1 user reviews,1,0,1
1241870,True,0,No user reviews,0,0,0
1241880,True,0,3 user reviews,3,0,3
1241910,True,6,Mostly Positive,31,12,43
1241920,True,0,No user reviews,0,0,0
1241950,True,0,No user reviews,0,0,0
1242620,True,0,No user reviews,0,0,0
1242630,True,0,No user reviews,0,0,0
1242650,True,0,No user reviews,0,0,0
1242670,True,0,5 user reviews,5,0,5
1242680,True,0,1 user reviews,0,1,1
1242690,True,0,No user reviews,0,0,0
1242700,True,0,No user reviews,0,0,0
1242710,True,0,1 user reviews,1,0,1
1242730,True,0,No user reviews,0,0,0
1242740,True,0,7 user reviews,7,0,7
1242741,True,0,No user reviews,0,0,0
1242742,True,0,No user reviews,0,0,0
1242743,True,0,No user reviews,0,0,0
1242744,True,0,No user reviews,0,0,0
1242745,True,0,No user reviews,0,0,0
1242746,True,0,No user reviews,0,0,0
1242747,True,0,No user reviews,0,0,0
1242748,True,0,2 user reviews,2,0,2
1242749,True,7,Positive,14,0,14
1242750,True,0,4 user reviews,4,0,4
1242751,True,0,5 user reviews,5,0,5
1242752,True,0,4 user reviews,4,0,4
1242753,True,7,Positive,45,0,45
1242754,True,7,Positive,35,0,35
1242755,True,0,4 user reviews,4,0,4
1242756,True,7,Positive,24,0,24
1242757,True,0,4 user reviews,4,0,4
1242758,True,0,3 user reviews,3,0,3
1242759,True,0,8 user reviews,8,0,8
1242760,True,0,8 user reviews,7,1,8
1242761,True,0,7 user reviews,7,0,7
1242762,True,0,1 user reviews,1,0,1
1242763,True,0,2 user reviews,2,0,2
1242764,True,0,1 user reviews,1,0,1
1242765,True,0,1 user reviews,1,0,1
1242766,True,0,1 user reviews,1,0,1
1242767,True,0,1 user reviews,1,0,1
1242768,True,0,2 user reviews,2,0,2
1242769,True,0,1 user reviews,1,0,1
1242770,True,0,3 user reviews,3,0,3
1242771,True,0,1 user reviews,1,0,1
1242777,True,0,3 user reviews,3,0,3
1242778,True,7,Positive,9,2,11
1242779,True,0,4 user reviews,4,0,4
1242790,True,0,No user reviews,0,0,0
1242800,True,0,No user reviews,0,0,0
1242810,True,0,No user reviews,0,0,0
1242820,True,0,4 user reviews,3,1,4
1242830,True,0,No user reviews,0,0,0
1242840,True,0,No user reviews,0,0,0
1242850,True,0,1 user reviews,1,0,1
1242910,True,5,Mixed,5,6,11
1242920,True,0,No user reviews,0,0,0
1242960,True,0,5 user reviews,5,0,5
1242970,True,0,1 user reviews,1,0,1
1242980,True,0,No user reviews,0,0,0
1242990,True,0,No user reviews,0,0,0
1243000,True,0,No user reviews,0,0,0
1243010,True,0,No user reviews,0,0,0
1243030,True,0,No user reviews,0,0,0
1243040,True,0,No user reviews,0,0,0
1243050,True,0,No user reviews,0,0,0
1243060,True,0,No user reviews,0,0,0
1243070,True,0,No user reviews,0,0,0
1243100,True,0,4 user reviews,1,3,4
1243130,True,0,No user reviews,0,0,0
1243140,True,0,No user reviews,0,0,0
1243150,True,0,2 user reviews,2,0,2
1243190,True,0,No user reviews,0,0,0
1243200,True,0,No user reviews,0,0,0
1243220,True,8,Very Positive,67,12,79
1243240,True,0,2 user reviews,0,2,2
1243260,True,0,No user reviews,0,0,0
1243270,True,0,3 user reviews,2,1,3
1243290,True,0,3 user reviews,3,0,3
1243310,True,0,No user reviews,0,0,0
1243320,True,0,7 user reviews,2,5,7
1243330,True,0,No user reviews,0,0,0
1243360,True,0,5 user reviews,5,0,5
1243370,True,0,2 user reviews,2,0,2
1243380,True,0,No user reviews,0,0,0
1243390,True,0,1 user reviews,0,1,1
1243400,True,0,No user reviews,0,0,0
1243410,True,0,1 user reviews,1,0,1
1243420,True,6,Mostly Positive,38,14,52
1243450,True,0,1 user reviews,0,1,1
1243520,True,0,No user reviews,0,0,0
1243530,True,0,6 user reviews,6,0,6
1243560,True,0,1 user reviews,1,0,1
1243570,True,0,No user reviews,0,0,0
1243580,True,0,No user reviews,0,0,0
1243640,True,0,No user reviews,0,0,0
1243670,True,8,Very Positive,75,6,81
1243680,True,0,No user reviews,0,0,0
1243681,True,0,No user reviews,0,0,0
1243682,True,0,No user reviews,0,0,0
1243700,True,0,No user reviews,0,0,0
1243710,True,0,4 user reviews,3,1,4
1243720,True,0,No user reviews,0,0,0
1243730,True,6,Mostly Positive,43,13,56
1243750,True,0,4 user reviews,2,2,4
1243770,True,7,Positive,19,0,19
1243780,True,0,No user reviews,0,0,0
1243790,True,7,Positive,13,0,13
1243800,True,0,No user reviews,0,0,0
1243820,True,0,2 user reviews,1,1,2
1243840,True,0,No user reviews,0,0,0
1243841,True,0,No user reviews,0,0,0
1243860,True,0,No user reviews,0,0,0
1243890,True,0,No user reviews,0,0,0
1243930,True,0,2 user reviews,2,0,2
1243960,True,7,Positive,12,0,12
1244020,True,0,No user reviews,0,0,0
1244040,True,7,Positive,29,3,32
1244050,True,0,No user reviews,0,0,0
1244080,True,0,No user reviews,0,0,0
1244090,True,0,No user reviews,0,0,0
1244150,True,0,No user reviews,0,0,0
1244160,True,7,Positive,19,0,19
1244180,True,0,No user reviews,0,0,0
1244190,True,0,6 user reviews,6,0,6
1244210,True,0,1 user reviews,1,0,1
1244230,True,0,2 user reviews,2,0,2
1244250,True,0,2 user reviews,2,0,2
1244260,True,7,Positive,14,0,14
1244270,True,7,Positive,11,0,11
1244300,True,0,1 user reviews,1,0,1
1244310,True,0,No user reviews,0,0,0
1244370,True,0,No user reviews,0,0,0
1244380,True,0,5 user reviews,2,3,5
1244390,True,0,3 user reviews,3,0,3
1244410,True,0,No user reviews,0,0,0
1244450,True,0,No user reviews,0,0,0
1244470,True,0,No user reviews,0,0,0
1244490,True,0,No user reviews,0,0,0
1244510,True,0,1 user reviews,1,0,1
1244520,True,0,No user reviews,0,0,0
1244530,True,0,9 user reviews,9,0,9
1244540,True,0,No user reviews,0,0,0
1244550,True,0,No user reviews,0,0,0
1244560,True,0,3 user reviews,3,0,3
1244600,True,0,No user reviews,0,0,0
1244620,True,0,No user reviews,0,0,0
1244630,True,0,No user reviews,0,0,0
1244640,True,0,No user reviews,0,0,0
1244690,True,0,3 user reviews,3,0,3
1244700,True,0,No user reviews,0,0,0
1244701,True,0,No user reviews,0,0,0
1244710,True,0,No user reviews,0,0,0
1244750,True,0,No user reviews,0,0,0
1244760,True,0,3 user reviews,1,2,3
1244770,True,0,No user reviews,0,0,0
1244780,True,0,No user reviews,0,0,0
1244781,True,4,Mostly Negative,26,47,73
1244800,True,0,No user reviews,0,0,0
1244820,True,0,No user reviews,0,0,0
1244830,True,0,No user reviews,0,0,0
1244840,True,0,1 user reviews,1,0,1
1244850,True,0,2 user reviews,1,1,2
1244860,True,0,3 user reviews,3,0,3
1244870,True,0,No user reviews,0,0,0
1244880,True,0,2 user reviews,2,0,2
1244890,True,0,1 user reviews,1,0,1
1244900,True,0,No user reviews,0,0,0
1244920,True,0,No user reviews,0,0,0
1244930,True,7,Positive,24,2,26
1244940,True,0,No user reviews,0,0,0
1244950,True,6,Mostly Positive,129,49,178
1244960,True,0,No user reviews,0,0,0
1245000,True,0,2 user reviews,2,0,2
1245020,True,0,No user reviews,0,0,0
1245030,True,0,1 user reviews,0,1,1
1245050,True,0,No user reviews,0,0,0
1245060,True,0,No user reviews,0,0,0
1245070,True,0,No user reviews,0,0,0
1245080,True,0,No user reviews,0,0,0
1245090,True,0,8 user reviews,7,1,8
1245100,True,0,No user reviews,0,0,0
1245110,True,0,7 user reviews,7,0,7
1245120,True,0,No user reviews,0,0,0
1245150,True,5,Mixed,166,112,278
1245170,True,0,1 user reviews,0,1,1
1245180,True,0,1 user reviews,0,1,1
1245190,True,0,No user reviews,0,0,0
1245200,True,0,No user reviews,0,0,0
1245220,True,0,No user reviews,0,0,0
1245230,True,0,1 user reviews,0,1,1
1245260,True,7,Positive,8,2,10
1245280,True,0,4 user reviews,2,2,4
1245300,True,0,1 user reviews,1,0,1
1245310,True,0,No user reviews,0,0,0
1245320,True,0,No user reviews,0,0,0
1245330,True,0,No user reviews,0,0,0
1245340,True,0,No user reviews,0,0,0
1245350,True,0,No user reviews,0,0,0
1245360,True,0,No user reviews,0,0,0
1245370,True,0,3 user reviews,3,0,3
1245380,True,0,2 user reviews,1,1,2
1245390,True,0,No user reviews,0,0,0
1245400,True,0,No user reviews,0,0,0
1245430,True,8,Very Positive,121,5,126
1245440,True,0,No user reviews,0,0,0
1245470,True,0,2 user reviews,0,2,2
1245500,True,0,4 user reviews,2,2,4
1245510,True,0,1 user reviews,1,0,1
1245540,True,7,Positive,18,0,18
1245550,True,0,No user reviews,0,0,0
1245560,True,0,No user reviews,0,0,0
1245570,True,0,No user reviews,0,0,0
1245580,True,0,No user reviews,0,0,0
1245590,True,0,No user reviews,0,0,0
1245600,True,0,3 user reviews,2,1,3
1245610,True,0,No user reviews,0,0,0
1245630,True,0,2 user reviews,1,1,2
1245640,True,0,No user reviews,0,0,0
1245660,True,0,3 user reviews,2,1,3
1245670,True,5,Mixed,11,7,18
1245680,True,0,No user reviews,0,0,0
1245700,True,0,No user reviews,0,0,0
1245710,True,0,No user reviews,0,0,0
1245730,True,0,1 user reviews,1,0,1
1245780,True,5,Mixed,36,16,52
1245810,True,0,3 user reviews,3,0,3
1245820,True,0,3 user reviews,3,0,3
1245830,True,0,No user reviews,0,0,0
1245880,True,0,No user reviews,0,0,0
1245900,True,0,4 user reviews,4,0,4
1245910,True,0,5 user reviews,1,4,5
1245920,True,0,No user reviews,0,0,0
1245930,True,0,1 user reviews,0,1,1
1245950,True,6,Mostly Positive,47,18,65
1245960,True,0,No user reviews,0,0,0
1245970,True,0,No user reviews,0,0,0
1245980,True,0,1 user reviews,0,1,1
1246010,True,0,No user reviews,0,0,0
1246020,True,0,No user reviews,0,0,0
1246030,True,0,1 user reviews,1,0,1
1246031,True,0,4 user reviews,3,1,4
1246032,True,0,2 user reviews,2,0,2
1246040,True,0,2 user reviews,2,0,2
1246050,True,0,No user reviews,0,0,0
1246060,True,0,No user reviews,0,0,0
1246110,True,0,No user reviews,0,0,0
1246120,True,0,No user reviews,0,0,0
1246140,True,0,3 user reviews,0,3,3
1246170,True,0,1 user reviews,1,0,1
1246180,True,0,No user reviews,0,0,0
1246181,True,0,No user reviews,0,0,0
1246182,True,0,No user reviews,0,0,0
1246183,True,0,No user reviews,0,0,0
1246184,True,0,No user reviews,0,0,0
1246185,True,0,No user reviews,0,0,0
1246186,True,0,No user reviews,0,0,0
1246187,True,0,No user reviews,0,0,0
1246188,True,0,No user reviews,0,0,0
1246189,True,0,No user reviews,0,0,0
1246200,True,0,No user reviews,0,0,0
1246210,True,0,No user reviews,0,0,0
1246230,True,0,1 user reviews,0,1,1
1246300,True,0,No user reviews,0,0,0
1246310,True,0,No user reviews,0,0,0
1246320,True,0,1 user reviews,1,0,1
1246330,True,0,No user reviews,0,0,0
1246370,True,0,No user reviews,0,0,0
1246390,True,0,No user reviews,0,0,0
1246400,True,0,5 user reviews,4,1,5
1246420,True,0,5 user reviews,4,1,5
1246430,True,0,No user reviews,0,0,0
1246460,True,0,No user reviews,0,0,0
1246490,True,7,Positive,9,2,11
1246500,True,0,No user reviews,0,0,0
1246520,True,5,Mixed,15,21,36
1246530,True,0,No user reviews,0,0,0
1246540,True,0,1 user reviews,1,0,1
1246550,True,0,No user reviews,0,0,0
1246570,True,0,4 user reviews,4,0,4
1246590,True,0,No user reviews,0,0,0
1246591,True,0,No user reviews,0,0,0
1246600,True,0,1 user reviews,1,0,1
1246610,True,0,1 user reviews,0,1,1
1246620,True,0,No user reviews,0,0,0
1246640,True,0,No user reviews,0,0,0
1246650,True,0,No user reviews,0,0,0
1246660,True,0,No user reviews,0,0,0
1246670,True,0,No user reviews,0,0,0
1246680,True,0,No user reviews,0,0,0
1246700,True,0,No user reviews,0,0,0
1246710,True,0,5 user reviews,4,1,5
1246730,True,0,No user reviews,0,0,0
1246740,True,0,No user reviews,0,0,0
1246750,True,0,No user reviews,0,0,0
1246760,True,0,No user reviews,0,0,0
1246780,True,0,4 user reviews,2,2,4
1246810,True,0,No user reviews,0,0,0
1246830,True,0,No user reviews,0,0,0
1246840,True,0,No user reviews,0,0,0
1246841,True,0,No user reviews,0,0,0
1246842,True,0,No user reviews,0,0,0
1246843,True,0,No user reviews,0,0,0
1246890,True,0,No user reviews,0,0,0
1246900,True,0,No user reviews,0,0,0
1246910,True,0,No user reviews,0,0,0
1246920,True,0,No user reviews,0,0,0
1246930,True,0,1 user reviews,1,0,1
1246940,True,0,No user reviews,0,0,0
1246950,True,6,Mostly Positive,10,4,14
1246990,True,0,No user reviews,0,0,0
1247000,True,0,No user reviews,0,0,0
1247010,True,0,5 user reviews,3,2,5
1247020,True,7,Positive,27,2,29
1247030,True,0,2 user reviews,2,0,2
1247040,True,0,4 user reviews,0,4,4
1247050,True,0,No user reviews,0,0,0
1247070,True,0,9 user reviews,7,2,9
1247080,True,0,No user reviews,0,0,0
1247090,True,0,No user reviews,0,0,0
1247100,True,0,No user reviews,0,0,0
1247110,True,0,1 user reviews,1,0,1
1247120,True,0,No user reviews,0,0,0
1247130,True,0,8 user reviews,7,1,8
1247140,True,0,3 user reviews,2,1,3
1247150,True,0,2 user reviews,1,1,2
1247170,True,7,Positive,19,2,21
1247180,True,0,No user reviews,0,0,0
1247190,True,6,Mostly Positive,10,3,13
1247210,True,0,1 user reviews,1,0,1
1247240,True,0,No user reviews,0,0,0
1247250,True,0,2 user reviews,0,2,2
1247270,True,0,7 user reviews,7,0,7
1247280,True,0,No user reviews,0,0,0
1247290,True,0,No user reviews,0,0,0
1247300,True,0,1 user reviews,1,0,1
1247320,True,0,No user reviews,0,0,0
1247340,True,0,8 user reviews,6,2,8
1247360,True,0,No user reviews,0,0,0
1247370,True,7,Positive,26,6,32
1247380,True,0,No user reviews,0,0,0
1247400,True,0,2 user reviews,2,0,2
1247460,True,0,No user reviews,0,0,0
1247480,True,0,No user reviews,0,0,0
1247490,True,0,No user reviews,0,0,0
1247560,True,0,No user reviews,0,0,0
1247570,True,0,No user reviews,0,0,0
1247600,True,0,No user reviews,0,0,0
1247610,True,0,No user reviews,0,0,0
1247611,True,0,No user reviews,0,0,0
1247612,True,0,1 user reviews,1,0,1
1247613,True,0,No user reviews,0,0,0
1247614,True,0,No user reviews,0,0,0
1247620,True,0,1 user reviews,1,0,1
1247640,True,7,Positive,22,4,26
1247650,True,0,No user reviews,0,0,0
1247700,True,0,No user reviews,0,0,0
1247711,True,0,No user reviews,0,0,0
1247720,True,7,Positive,32,3,35
1247730,True,0,2 user reviews,1,1,2
1247740,True,0,No user reviews,0,0,0
1247750,True,4,Mostly Negative,6,20,26
1247760,True,0,7 user reviews,7,0,7
1247830,True,0,4 user reviews,3,1,4
1247860,True,0,No user reviews,0,0,0
1247880,True,0,No user reviews,0,0,0
1247900,True,0,No user reviews,0,0,0
1247901,True,0,No user reviews,0,0,0
1247910,True,0,4 user reviews,3,1,4
1247920,True,0,2 user reviews,2,0,2
1247930,True,0,2 user reviews,1,1,2
1247940,True,7,Positive,28,1,29
1247950,True,0,2 user reviews,0,2,2
1247980,True,0,No user reviews,0,0,0
1247990,True,0,No user reviews,0,0,0
1248020,True,0,No user reviews,0,0,0
1248030,True,0,2 user reviews,2,0,2
1248050,True,0,No user reviews,0,0,0
1248060,True,0,No user reviews,0,0,0
1248070,True,0,No user reviews,0,0,0
1248080,True,0,No user reviews,0,0,0
1248100,True,0,1 user reviews,1,0,1
1248110,True,0,No user reviews,0,0,0
1248120,True,0,No user reviews,0,0,0
1248140,True,7,Positive,12,1,13
1248150,True,0,No user reviews,0,0,0
1248160,True,0,No user reviews,0,0,0
1248180,True,0,3 user reviews,2,1,3
1248181,True,0,No user reviews,0,0,0
1248182,True,0,No user reviews,0,0,0
1248183,True,0,No user reviews,0,0,0
1248200,True,0,No user reviews,0,0,0
1248220,True,0,No user reviews,0,0,0
1248230,True,0,No user reviews,0,0,0
1248240,True,0,No user reviews,0,0,0
1248270,True,0,No user reviews,0,0,0
1248290,True,0,No user reviews,0,0,0
1248310,True,0,No user reviews,0,0,0
1248330,True,0,5 user reviews,5,0,5
1248331,True,0,2 user reviews,1,1,2
1248332,True,0,1 user reviews,1,0,1
1248335,True,0,9 user reviews,4,5,9
1248340,True,0,No user reviews,0,0,0
1248350,True,0,No user reviews,0,0,0
1248360,True,0,No user reviews,0,0,0
1248370,True,0,1 user reviews,1,0,1
1248380,True,8,Very Positive,85,11,96
1248390,True,0,No user reviews,0,0,0
1248410,True,0,No user reviews,0,0,0
1248430,True,8,Very Positive,58,5,63
1248431,True,7,Positive,16,0,16
1248434,True,7,Positive,35,1,36
1248450,True,0,No user reviews,0,0,0
1248460,True,7,Positive,14,0,14
1248470,True,0,No user reviews,0,0,0
1248490,True,0,1 user reviews,1,0,1
1248510,True,0,No user reviews,0,0,0
1248520,True,0,No user reviews,0,0,0
1248530,True,0,No user reviews,0,0,0
1248540,True,0,No user reviews,0,0,0
1248570,True,0,1 user reviews,1,0,1
1248590,True,0,8 user reviews,2,6,8
1248600,True,0,No user reviews,0,0,0
1248650,True,0,No user reviews,0,0,0
1248670,True,0,No user reviews,0,0,0
1248680,True,0,1 user reviews,1,0,1
1248690,True,0,No user reviews,0,0,0
1248710,True,0,3 user reviews,2,1,3
1248730,True,0,No user reviews,0,0,0
1248740,True,0,No user reviews,0,0,0
1248790,True,0,No user reviews,0,0,0
1248800,True,0,6 user reviews,6,0,6
1248810,True,0,No user reviews,0,0,0
1248820,True,0,No user reviews,0,0,0
1248860,True,0,3 user reviews,3,0,3
1248870,True,0,No user reviews,0,0,0
1248880,True,0,1 user reviews,1,0,1
1248900,True,0,No user reviews,0,0,0
1248910,True,0,1 user reviews,1,0,1
1248960,True,0,2 user reviews,2,0,2
1248970,True,0,8 user reviews,7,1,8
1248980,True,0,No user reviews,0,0,0
1248990,True,0,5 user reviews,2,3,5
1249000,True,0,9 user reviews,5,4,9
1249010,True,0,5 user reviews,4,1,5
1249020,True,0,No user reviews,0,0,0
1249030,True,0,No user reviews,0,0,0
1249050,True,0,2 user reviews,2,0,2
1249060,True,0,3 user reviews,2,1,3
1249070,True,0,6 user reviews,6,0,6
1249080,True,0,No user reviews,0,0,0
1249100,True,0,No user reviews,0,0,0
1249110,True,0,6 user reviews,5,1,6
1249130,True,8,Very Positive,151,17,168
1249140,True,0,1 user reviews,1,0,1
1249150,True,0,No user reviews,0,0,0
1249160,True,0,No user reviews,0,0,0
1249170,True,7,Positive,10,0,10
1249200,True,0,No user reviews,0,0,0
1249250,True,0,No user reviews,0,0,0
1249251,True,0,No user reviews,0,0,0
1249260,True,7,Positive,35,3,38
1249280,True,0,2 user reviews,2,0,2
1249290,True,0,2 user reviews,2,0,2
1249300,True,0,No user reviews,0,0,0
1249310,True,0,2 user reviews,2,0,2
1249320,True,0,No user reviews,0,0,0
1249340,True,0,1 user reviews,1,0,1
1249350,True,0,No user reviews,0,0,0
1249360,True,0,No user reviews,0,0,0
1249390,True,0,No user reviews,0,0,0
1249400,True,0,No user reviews,0,0,0
1249410,True,0,5 user reviews,4,1,5
1249420,True,0,No user reviews,0,0,0
1249430,True,0,No user reviews,0,0,0
1249450,True,0,1 user reviews,1,0,1
1249480,True,0,No user reviews,0,0,0
1249500,True,0,8 user reviews,5,3,8
1249510,True,0,8 user reviews,8,0,8
1249520,True,0,No user reviews,0,0,0
1249570,True,0,No user reviews,0,0,0
1249600,True,0,No user reviews,0,0,0
1249620,True,0,1 user reviews,0,1,1
1249630,True,0,No user reviews,0,0,0
1249650,True,0,No user reviews,0,0,0
1249680,True,0,No user reviews,0,0,0
1249730,True,0,No user reviews,0,0,0
1249750,True,0,No user reviews,0,0,0
1249760,True,0,1 user reviews,1,0,1
1249770,True,0,No user reviews,0,0,0
1249780,True,0,No user reviews,0,0,0
1249800,True,7,Positive,42,5,47
1249810,True,0,1 user reviews,1,0,1
1249850,True,0,6 user reviews,4,2,6
1249880,True,0,No user reviews,0,0,0
1249890,True,0,2 user reviews,2,0,2
1249900,True,0,No user reviews,0,0,0
1249901,True,0,No user reviews,0,0,0
1249902,True,0,No user reviews,0,0,0
1249903,True,0,No user reviews,0,0,0
1249920,True,0,No user reviews,0,0,0
1249930,True,0,No user reviews,0,0,0
1249960,True,0,No user reviews,0,0,0
1249970,True,0,No user reviews,0,0,0
1249980,True,0,No user reviews,0,0,0
1249990,True,0,No user reviews,0,0,0
1250000,True,0,No user reviews,0,0,0
1250030,True,0,4 user reviews,4,0,4
1250040,True,0,No user reviews,0,0,0
1250060,True,0,No user reviews,0,0,0
1250070,True,0,3 user reviews,2,1,3
1250090,True,0,No user reviews,0,0,0
1250100,True,7,Positive,14,1,15
1250110,True,0,No user reviews,0,0,0
1250120,True,0,No user reviews,0,0,0
1250130,True,0,No user reviews,0,0,0
1250140,True,0,No user reviews,0,0,0
1250160,True,0,No user reviews,0,0,0
1250170,True,0,1 user reviews,1,0,1
1250180,True,0,5 user reviews,5,0,5
1250190,True,0,No user reviews,0,0,0
1250210,True,0,No user reviews,0,0,0
1250220,True,5,Mixed,16,15,31
1250240,True,0,No user reviews,0,0,0
1250250,True,7,Positive,11,0,11
1250260,True,0,No user reviews,0,0,0
1250270,True,0,No user reviews,0,0,0
1250290,True,0,No user reviews,0,0,0
1250300,True,7,Positive,9,1,10
1250350,True,0,No user reviews,0,0,0
1250410,True,6,Mostly Positive,7821,2673,10494
1250420,True,0,No user reviews,0,0,0
1250440,True,0,No user reviews,0,0,0
1250490,True,0,1 user reviews,1,0,1
1250500,True,0,No user reviews,0,0,0
1250510,True,0,No user reviews,0,0,0
1250520,True,7,Positive,39,2,41
1250540,True,0,No user reviews,0,0,0
1250550,True,0,3 user reviews,2,1,3
1250560,True,8,Very Positive,65,2,67
1250590,True,0,No user reviews,0,0,0
1250610,True,0,No user reviews,0,0,0
1250620,True,0,No user reviews,0,0,0
1250621,True,0,No user reviews,0,0,0
1250622,True,0,No user reviews,0,0,0
1250640,True,0,2 user reviews,1,1,2
1250650,True,6,Mostly Positive,182,72,254
1250660,True,0,No user reviews,0,0,0
1250670,True,0,No user reviews,0,0,0
1250690,True,7,Positive,12,1,13
1250700,True,0,No user reviews,0,0,0
1250710,True,0,No user reviews,0,0,0
1250720,True,0,5 user reviews,4,1,5
1250730,True,0,2 user reviews,1,1,2
1250740,True,0,2 user reviews,2,0,2
1250760,True,0,No user reviews,0,0,0
1250770,True,0,1 user reviews,1,0,1
1250790,True,0,No user reviews,0,0,0
1250810,True,0,No user reviews,0,0,0
1250830,True,0,1 user reviews,1,0,1
1250840,True,0,No user reviews,0,0,0
1250850,True,0,No user reviews,0,0,0
1250860,True,0,No user reviews,0,0,0
1250870,True,0,No user reviews,0,0,0
1250890,True,0,3 user reviews,3,0,3
1250910,True,0,4 user reviews,3,1,4
1250920,True,0,No user reviews,0,0,0
1250940,True,0,No user reviews,0,0,0
1250960,True,0,No user reviews,0,0,0
1250980,True,0,No user reviews,0,0,0
1250990,True,0,1 user reviews,1,0,1
1251000,True,6,Mostly Positive,124,33,157
1251050,True,0,No user reviews,0,0,0
1251060,True,0,No user reviews,0,0,0
1251090,True,0,No user reviews,0,0,0
1251130,True,0,No user reviews,0,0,0
1251180,True,0,No user reviews,0,0,0
1251190,True,0,No user reviews,0,0,0
1251200,True,0,No user reviews,0,0,0
1251210,True,0,No user reviews,0,0,0
1251220,True,0,No user reviews,0,0,0
1251230,True,0,No user reviews,0,0,0
1251240,True,0,No user reviews,0,0,0
1251260,True,0,No user reviews,0,0,0
1251270,True,0,No user reviews,0,0,0
1251290,True,0,2 user reviews,0,2,2
1251300,True,6,Mostly Positive,19,7,26
1251320,True,0,No user reviews,0,0,0
1251350,True,0,3 user reviews,3,0,3
1251380,True,0,1 user reviews,0,1,1
1251400,True,0,No user reviews,0,0,0
1251410,True,5,Mixed,11,6,17
1251420,True,0,No user reviews,0,0,0
1251430,True,0,5 user reviews,3,2,5
1251460,True,0,No user reviews,0,0,0
1251470,True,0,No user reviews,0,0,0
1251490,True,0,No user reviews,0,0,0
1251520,True,0,2 user reviews,2,0,2
1251530,True,0,9 user reviews,8,1,9
1251550,True,0,No user reviews,0,0,0
1251560,True,0,No user reviews,0,0,0
1251570,True,0,No user reviews,0,0,0
1251580,True,0,No user reviews,0,0,0
1251590,True,0,No user reviews,0,0,0
1251610,True,0,No user reviews,0,0,0
1251620,True,0,No user reviews,0,0,0
1251630,True,0,No user reviews,0,0,0
1251640,True,7,Positive,37,1,38
1251650,True,0,No user reviews,0,0,0
1251660,True,0,No user reviews,0,0,0
1251670,True,0,No user reviews,0,0,0
1251680,True,7,Positive,9,2,11
1251690,True,0,No user reviews,0,0,0
1251720,True,0,No user reviews,0,0,0
1251730,True,0,No user reviews,0,0,0
1251750,True,0,No user reviews,0,0,0
1251760,True,0,3 user reviews,1,2,3
1251770,True,0,No user reviews,0,0,0
1251780,True,0,No user reviews,0,0,0
1251790,True,0,No user reviews,0,0,0
1251800,True,0,No user reviews,0,0,0
1251810,True,0,No user reviews,0,0,0
1251820,True,0,No user reviews,0,0,0
1251840,True,0,2 user reviews,0,2,2
1251850,True,0,No user reviews,0,0,0
1251870,True,0,No user reviews,0,0,0
1251910,True,7,Positive,9,1,10
1251930,True,0,No user reviews,0,0,0
1251940,True,0,7 user reviews,7,0,7
1251950,True,0,No user reviews,0,0,0
1251970,True,0,No user reviews,0,0,0
1251980,True,7,Positive,12,3,15
1252010,True,5,Mixed,20,20,40
1252020,True,0,No user reviews,0,0,0
1252030,True,0,No user reviews,0,0,0
1252040,True,0,No user reviews,0,0,0
1252050,True,0,No user reviews,0,0,0
1252080,True,0,5 user reviews,3,2,5
1252100,True,0,4 user reviews,4,0,4
1252110,True,0,No user reviews,0,0,0
1252120,True,0,No user reviews,0,0,0
1252130,True,0,No user reviews,0,0,0
1252160,True,0,2 user reviews,2,0,2
1252170,True,0,4 user reviews,4,0,4
1252180,True,0,No user reviews,0,0,0
1252190,True,0,No user reviews,0,0,0
1252200,True,6,Mostly Positive,99,29,128
1252210,True,0,3 user reviews,3,0,3
1252230,True,0,No user reviews,0,0,0
1252240,True,0,No user reviews,0,0,0
1252260,True,0,No user reviews,0,0,0
1252280,True,0,No user reviews,0,0,0
1252290,True,0,1 user reviews,0,1,1
1252300,True,0,No user reviews,0,0,0
1252310,True,0,No user reviews,0,0,0
1252320,True,7,Positive,19,0,19
1252340,True,0,No user reviews,0,0,0
1252370,True,0,No user reviews,0,0,0
1252390,True,0,No user reviews,0,0,0
1252410,True,7,Positive,11,0,11
1252450,True,0,2 user reviews,2,0,2
1252460,True,0,No user reviews,0,0,0
1252500,True,0,No user reviews,0,0,0
1252510,True,0,No user reviews,0,0,0
1252560,True,7,Positive,25,1,26
1252580,True,0,No user reviews,0,0,0
1252590,True,0,1 user reviews,1,0,1
1252620,True,0,No user reviews,0,0,0
1252630,True,0,No user reviews,0,0,0
1252650,True,0,No user reviews,0,0,0
1252660,True,0,No user reviews,0,0,0
1252680,True,0,No user reviews,0,0,0
1252700,True,0,1 user reviews,1,0,1
1252710,True,8,Very Positive,42,10,52
1252720,True,0,No user reviews,0,0,0
1252730,True,0,4 user reviews,3,1,4
1252740,True,0,No user reviews,0,0,0
1252750,True,8,Very Positive,57,8,65
1252760,True,7,Positive,9,1,10
1252780,True,0,No user reviews,0,0,0
1252810,True,0,No user reviews,0,0,0
1252820,True,0,No user reviews,0,0,0
1252830,True,0,No user reviews,0,0,0
1252850,True,0,No user reviews,0,0,0
1252870,True,8,Very Positive,53,12,65
1252880,True,0,No user reviews,0,0,0
1252881,True,0,No user reviews,0,0,0
1252890,True,0,No user reviews,0,0,0
1252910,True,0,No user reviews,0,0,0
1252920,True,0,1 user reviews,0,1,1
1252980,True,0,2 user reviews,2,0,2
1252990,True,5,Mixed,28,15,43
1253000,True,0,No user reviews,0,0,0
1253020,True,0,No user reviews,0,0,0
1253030,True,0,No user reviews,0,0,0
1253050,True,0,1 user reviews,1,0,1
1253090,True,0,1 user reviews,1,0,1
1253091,True,0,3 user reviews,2,1,3
1253092,True,7,Positive,8,2,10
1253110,True,7,Positive,9,1,10
1253160,True,0,No user reviews,0,0,0
1253180,True,0,2 user reviews,0,2,2
1253230,True,0,No user reviews,0,0,0
1253240,True,0,1 user reviews,1,0,1
1253270,True,0,No user reviews,0,0,0
1253280,True,0,7 user reviews,7,0,7
1253290,True,0,No user reviews,0,0,0
1253310,True,0,No user reviews,0,0,0
1253320,True,0,No user reviews,0,0,0
1253350,True,0,No user reviews,0,0,0
1253390,True,7,Positive,12,1,13
1253400,True,0,No user reviews,0,0,0
1253420,True,0,No user reviews,0,0,0
1253450,True,0,No user reviews,0,0,0
1253460,True,0,2 user reviews,0,2,2
1253520,True,0,No user reviews,0,0,0
1253540,True,0,No user reviews,0,0,0
1253550,True,5,Mixed,11,7,18
1253560,True,0,No user reviews,0,0,0
1253570,True,0,No user reviews,0,0,0
1253580,True,0,6 user reviews,6,0,6
1253620,True,0,3 user reviews,0,3,3
1253660,True,0,No user reviews,0,0,0
1253680,True,6,Mostly Positive,19,5,24
1253690,True,0,No user reviews,0,0,0
1253700,True,0,4 user reviews,1,3,4
1253710,True,0,No user reviews,0,0,0
1253720,True,0,1 user reviews,0,1,1
1253750,True,0,No user reviews,0,0,0
1253751,True,0,No user reviews,0,0,0
1253752,True,0,No user reviews,0,0,0
1253753,True,0,No user reviews,0,0,0
1253754,True,0,No user reviews,0,0,0
1253755,True,0,No user reviews,0,0,0
1253760,True,0,1 user reviews,1,0,1
1253800,True,0,No user reviews,0,0,0
1253820,True,0,2 user reviews,1,1,2
1253830,True,0,No user reviews,0,0,0
1253850,True,0,No user reviews,0,0,0
1253860,True,0,No user reviews,0,0,0
1253870,True,8,Very Positive,321,42,363
1253880,True,0,No user reviews,0,0,0
1253890,True,0,No user reviews,0,0,0
1253900,True,0,5 user reviews,0,5,5
1253920,True,6,Mostly Positive,679,177,856
1253930,True,0,No user reviews,0,0,0
1253940,True,0,5 user reviews,4,1,5
1253950,True,7,Positive,16,0,16
1253960,True,0,No user reviews,0,0,0
1253970,True,0,No user reviews,0,0,0
1253990,True,4,Mostly Negative,43,83,126
1254030,True,0,No user reviews,0,0,0
1254070,True,0,2 user reviews,2,0,2
1254100,True,0,No user reviews,0,0,0
1254110,True,0,No user reviews,0,0,0
1254120,True,0,No user reviews,0,0,0
1254140,True,0,No user reviews,0,0,0
1254150,True,0,5 user reviews,4,1,5
1254160,True,0,4 user reviews,2,2,4
1254170,True,0,No user reviews,0,0,0
1254171,True,0,No user reviews,0,0,0
1254172,True,0,No user reviews,0,0,0
1254173,True,0,No user reviews,0,0,0
1254174,True,0,No user reviews,0,0,0
1254175,True,0,No user reviews,0,0,0
1254176,True,0,No user reviews,0,0,0
1254180,True,7,Positive,11,0,11
1254190,True,0,No user reviews,0,0,0
1254191,True,0,No user reviews,0,0,0
1254192,True,0,No user reviews,0,0,0
1254193,True,0,No user reviews,0,0,0
1254200,True,0,No user reviews,0,0,0
1254210,True,0,No user reviews,0,0,0
1254211,True,0,No user reviews,0,0,0
1254212,True,0,No user reviews,0,0,0
1254213,True,0,No user reviews,0,0,0
1254230,True,0,No user reviews,0,0,0
1254240,True,0,No user reviews,0,0,0
1254270,True,0,No user reviews,0,0,0
1254280,True,0,2 user reviews,1,1,2
1254300,True,0,No user reviews,0,0,0
1254340,True,0,No user reviews,0,0,0
1254350,True,0,5 user reviews,4,1,5
1254360,True,0,No user reviews,0,0,0
1254370,True,8,Very Positive,208,15,223
1254380,True,5,Mixed,6,4,10
1254390,True,0,No user reviews,0,0,0
1254400,True,5,Mixed,55,26,81
1254410,True,0,No user reviews,0,0,0
1254420,True,0,1 user reviews,0,1,1
1254430,True,0,No user reviews,0,0,0
1254440,True,0,No user reviews,0,0,0
1254480,True,0,7 user reviews,4,3,7
1254490,True,0,1 user reviews,0,1,1
1254500,True,7,Positive,17,3,20
1254530,True,0,No user reviews,0,0,0
1254540,True,0,No user reviews,0,0,0
1254550,True,0,No user reviews,0,0,0
1254570,True,5,Mixed,44,21,65
1254590,True,0,1 user reviews,1,0,1
1254600,True,0,No user reviews,0,0,0
1254610,True,0,No user reviews,0,0,0
1254620,True,0,5 user reviews,5,0,5
1254630,True,0,5 user reviews,3,2,5
1254650,True,0,No user reviews,0,0,0
1254670,True,0,No user reviews,0,0,0
1254680,True,0,2 user reviews,1,1,2
1254700,True,0,No user reviews,0,0,0
1254720,True,0,No user reviews,0,0,0
1254730,True,0,No user reviews,0,0,0
1254740,True,0,No user reviews,0,0,0
1254750,True,0,No user reviews,0,0,0
1254770,True,0,No user reviews,0,0,0
1254800,True,0,No user reviews,0,0,0
1254820,True,0,1 user reviews,0,1,1
1254850,True,0,No user reviews,0,0,0
1254851,True,0,No user reviews,0,0,0
1254860,True,0,5 user reviews,4,1,5
1254870,True,7,Positive,27,0,27
1254890,True,0,1 user reviews,1,0,1
1254900,True,0,7 user reviews,5,2,7
1254910,True,0,No user reviews,0,0,0
1254920,True,0,4 user reviews,4,0,4
1254921,True,0,8 user reviews,8,0,8
1254922,True,0,1 user reviews,1,0,1
1254923,True,7,Positive,10,2,12
1254930,True,0,3 user reviews,2,1,3
1254950,True,0,No user reviews,0,0,0
1254960,True,0,No user reviews,0,0,0
1254980,True,0,No user reviews,0,0,0
1254990,True,0,No user reviews,0,0,0
1254991,True,0,No user reviews,0,0,0
1255000,True,7,Positive,24,3,27
1255001,True,0,8 user reviews,8,0,8
1255010,True,0,No user reviews,0,0,0
1255030,True,0,No user reviews,0,0,0
1255040,True,7,Positive,13,1,14
1255050,True,0,7 user reviews,7,0,7
1255060,True,0,No user reviews,0,0,0
1255070,True,0,2 user reviews,2,0,2
1255071,True,0,1 user reviews,1,0,1
1255072,True,0,4 user reviews,4,0,4
1255073,True,0,1 user reviews,1,0,1
1255074,True,0,1 user reviews,1,0,1
1255075,True,0,2 user reviews,2,0,2
1255080,True,0,7 user reviews,5,2,7
1255081,True,0,5 user reviews,4,1,5
1255120,True,0,No user reviews,0,0,0
1255130,True,0,9 user reviews,8,1,9
1255140,True,0,3 user reviews,3,0,3
1255150,True,6,Mostly Positive,24,9,33
1255151,True,8,Very Positive,58,10,68
1255152,True,5,Mixed,40,20,60
1255160,True,0,No user reviews,0,0,0
1255170,True,0,No user reviews,0,0,0
1255190,True,0,No user reviews,0,0,0
1255220,True,4,Mostly Negative,3,7,10
1255230,True,0,No user reviews,0,0,0
1255250,True,0,1 user reviews,0,1,1
1255260,True,0,No user reviews,0,0,0
1255270,True,0,No user reviews,0,0,0
1255280,True,0,No user reviews,0,0,0
1255290,True,0,No user reviews,0,0,0
1255300,True,0,No user reviews,0,0,0
1255310,True,5,Mixed,13,11,24
1255311,True,0,8 user reviews,5,3,8
1255320,True,0,2 user reviews,1,1,2
1255340,True,0,No user reviews,0,0,0
1255341,True,0,No user reviews,0,0,0
1255342,True,0,No user reviews,0,0,0
1255343,True,0,No user reviews,0,0,0
1255344,True,0,No user reviews,0,0,0
1255345,True,0,No user reviews,0,0,0
1255346,True,0,No user reviews,0,0,0
1255347,True,0,No user reviews,0,0,0
1255348,True,0,No user reviews,0,0,0
1255370,True,0,1 user reviews,0,1,1
1255380,True,0,No user reviews,0,0,0
1255390,True,0,No user reviews,0,0,0
1255400,True,0,No user reviews,0,0,0
1255401,True,0,No user reviews,0,0,0
1255410,True,0,No user reviews,0,0,0
1255420,True,0,No user reviews,0,0,0
1255430,True,0,No user reviews,0,0,0
1255440,True,0,No user reviews,0,0,0
1255460,True,0,No user reviews,0,0,0
1255470,True,0,No user reviews,0,0,0
1255490,True,0,1 user reviews,1,0,1
1255520,True,0,2 user reviews,2,0,2
1255550,True,0,No user reviews,0,0,0
1255560,True,0,No user reviews,0,0,0
1255580,True,0,No user reviews,0,0,0
1255640,True,0,No user reviews,0,0,0
1255650,True,7,Positive,10,0,10
1255660,True,0,No user reviews,0,0,0
1255680,True,0,3 user reviews,3,0,3
1255690,True,0,No user reviews,0,0,0
1255720,True,0,No user reviews,0,0,0
1255730,True,0,1 user reviews,0,1,1
1255740,True,0,7 user reviews,6,1,7
1255760,True,0,No user reviews,0,0,0
1255800,True,0,No user reviews,0,0,0
1255810,True,0,No user reviews,0,0,0
1255820,True,0,No user reviews,0,0,0
1255830,True,0,1 user reviews,1,0,1
1255840,True,0,2 user reviews,2,0,2
1255850,True,0,1 user reviews,1,0,1
1255860,True,0,No user reviews,0,0,0
1255870,True,0,2 user reviews,2,0,2
1255880,True,0,2 user reviews,2,0,2
1255890,True,0,No user reviews,0,0,0
1255910,True,0,2 user reviews,2,0,2
1255920,True,0,No user reviews,0,0,0
1255950,True,0,3 user reviews,3,0,3
1255960,True,0,No user reviews,0,0,0
1255970,True,0,No user reviews,0,0,0
1255990,True,6,Mostly Positive,17,5,22
1256030,True,7,Positive,21,3,24
1256040,True,0,3 user reviews,3,0,3
1256050,True,0,No user reviews,0,0,0
1256060,True,0,No user reviews,0,0,0
1256130,True,0,No user reviews,0,0,0
1256160,True,0,No user reviews,0,0,0
1256190,True,0,8 user reviews,5,3,8
1256200,True,0,No user reviews,0,0,0
1256220,True,0,No user reviews,0,0,0
1256230,True,0,No user reviews,0,0,0
1256240,True,0,1 user reviews,0,1,1
1256260,True,0,No user reviews,0,0,0
1256310,True,0,4 user reviews,2,2,4
1256330,True,0,No user reviews,0,0,0
1256340,True,0,No user reviews,0,0,0
1256350,True,0,1 user reviews,0,1,1
1256360,True,0,1 user reviews,1,0,1
1256370,True,0,No user reviews,0,0,0
1256380,True,0,No user reviews,0,0,0
1256400,True,0,No user reviews,0,0,0
1256430,True,0,2 user reviews,2,0,2
1256440,True,0,1 user reviews,1,0,1
1256460,True,0,No user reviews,0,0,0
1256480,True,0,2 user reviews,0,2,2
1256490,True,0,2 user reviews,2,0,2
1256500,True,0,2 user reviews,0,2,2
1256510,True,7,Positive,13,1,14
1256520,True,7,Positive,16,0,16
1256530,True,7,Positive,23,1,24
1256540,True,0,No user reviews,0,0,0
1256550,True,0,No user reviews,0,0,0
1256570,True,0,No user reviews,0,0,0
1256580,True,0,No user reviews,0,0,0
1256590,True,0,No user reviews,0,0,0
1256610,True,7,Positive,14,3,17
1256620,True,0,No user reviews,0,0,0
1256621,True,0,No user reviews,0,0,0
1256650,True,0,No user reviews,0,0,0
1256660,True,7,Positive,11,0,11
1256670,True,8,Very Positive,465,21,486
1256680,True,0,No user reviews,0,0,0
1256690,True,5,Mixed,16,11,27
1256710,True,0,2 user reviews,1,1,2
1256740,True,0,8 user reviews,8,0,8
1256750,True,0,3 user reviews,1,2,3
1256760,True,0,No user reviews,0,0,0
1256770,True,0,1 user reviews,1,0,1
1256800,True,0,No user reviews,0,0,0
1256810,True,0,No user reviews,0,0,0
1256830,True,0,No user reviews,0,0,0
1256840,True,0,No user reviews,0,0,0
1256850,True,0,5 user reviews,1,4,5
1256870,True,0,No user reviews,0,0,0
1256880,True,0,No user reviews,0,0,0
1256900,True,0,No user reviews,0,0,0
1256910,True,0,2 user reviews,2,0,2
1256920,True,7,Positive,9,1,10
1256930,True,0,No user reviews,0,0,0
1256950,True,7,Positive,24,5,29
1256970,True,0,No user reviews,0,0,0
1256980,True,0,No user reviews,0,0,0
1256990,True,0,No user reviews,0,0,0
1257000,True,0,No user reviews,0,0,0
1257010,True,0,No user reviews,0,0,0
1257020,True,0,No user reviews,0,0,0
1257030,True,0,No user reviews,0,0,0
1257170,True,7,Positive,18,2,20
1257190,True,0,2 user reviews,2,0,2
1257200,True,0,No user reviews,0,0,0
1257210,True,7,Positive,9,1,10
1257250,True,0,4 user reviews,4,0,4
1257260,True,0,No user reviews,0,0,0
1257270,True,0,2 user reviews,1,1,2
1257280,True,0,No user reviews,0,0,0
1257290,True,0,No user reviews,0,0,0
1257310,True,0,3 user reviews,0,3,3
1257321,True,0,No user reviews,0,0,0
1257350,True,0,1 user reviews,1,0,1
1257351,True,0,No user reviews,0,0,0
1257352,True,0,No user reviews,0,0,0
1257360,True,8,Very Positive,222,41,263
1257370,True,0,No user reviews,0,0,0
1257410,True,7,Positive,47,2,49
1257420,True,0,No user reviews,0,0,0
1257430,True,7,Positive,13,1,14
1257440,True,7,Positive,12,2,14
1257450,True,0,No user reviews,0,0,0
1257460,True,0,No user reviews,0,0,0
1257480,True,0,No user reviews,0,0,0
1257490,True,0,No user reviews,0,0,0
1257510,True,0,No user reviews,0,0,0
1257520,True,0,No user reviews,0,0,0
1257540,True,0,1 user reviews,1,0,1
1257560,True,0,No user reviews,0,0,0
1257570,True,0,4 user reviews,4,0,4
1257600,True,0,6 user reviews,6,0,6
1257630,True,0,1 user reviews,1,0,1
1257660,True,0,No user reviews,0,0,0
1257670,True,0,3 user reviews,3,0,3
1257680,True,0,No user reviews,0,0,0
1257700,True,0,No user reviews,0,0,0
1257720,True,0,3 user reviews,0,3,3
1257730,True,0,No user reviews,0,0,0
1257740,True,0,2 user reviews,2,0,2
1257741,True,0,No user reviews,0,0,0
1257770,True,0,1 user reviews,1,0,1
1257790,True,0,No user reviews,0,0,0
1257800,True,0,No user reviews,0,0,0
1257810,True,0,7 user reviews,5,2,7
1257830,True,0,No user reviews,0,0,0
1257840,True,0,8 user reviews,4,4,8
1257850,True,0,No user reviews,0,0,0
1257860,True,0,No user reviews,0,0,0
1257870,True,0,No user reviews,0,0,0
1257890,True,0,3 user reviews,3,0,3
1257900,True,0,2 user reviews,1,1,2
1257910,True,0,8 user reviews,7,1,8
1257920,True,0,1 user reviews,1,0,1
1257930,True,0,3 user reviews,2,1,3
1257950,True,0,No user reviews,0,0,0
1257960,True,0,No user reviews,0,0,0
1258000,True,0,3 user reviews,3,0,3
1258020,True,0,6 user reviews,6,0,6
1258040,True,0,2 user reviews,1,1,2
1258060,True,0,4 user reviews,1,3,4
1258070,True,0,2 user reviews,2,0,2
1258080,True,0,No user reviews,0,0,0
1258090,True,0,No user reviews,0,0,0
1258120,True,0,No user reviews,0,0,0
1258140,True,0,3 user reviews,2,1,3
1258154,True,0,No user reviews,0,0,0
1258155,True,0,No user reviews,0,0,0
1258160,True,0,No user reviews,0,0,0
1258170,True,0,No user reviews,0,0,0
1258190,True,7,Positive,19,2,21
1258200,True,0,6 user reviews,3,3,6
1258220,True,0,No user reviews,0,0,0
1258230,True,0,No user reviews,0,0,0
1258280,True,0,1 user reviews,1,0,1
1258290,True,0,No user reviews,0,0,0
1258300,True,0,No user reviews,0,0,0
1258310,True,8,Very Positive,81,1,82
1258320,True,6,Mostly Positive,13341,5203,18544
1258330,True,0,No user reviews,0,0,0
1258340,True,8,Very Positive,51,3,54
1258370,True,0,No user reviews,0,0,0
1258380,True,0,No user reviews,0,0,0
1258410,True,0,No user reviews,0,0,0
1258420,True,0,No user reviews,0,0,0
1258440,True,0,1 user reviews,1,0,1
1258450,True,0,No user reviews,0,0,0
1258460,True,5,Mixed,36,18,54
1258480,True,0,7 user reviews,7,0,7
1258490,True,0,No user reviews,0,0,0
1258500,True,6,Mostly Positive,29,10,39
1258510,True,7,Positive,24,1,25
1258560,True,0,No user reviews,0,0,0
1258580,True,0,3 user reviews,3,0,3
1258590,True,8,Very Positive,87,17,104
1258600,True,0,No user reviews,0,0,0
1258610,True,0,No user reviews,0,0,0
1258620,True,0,1 user reviews,0,1,1
1258630,True,0,No user reviews,0,0,0
1258640,True,0,1 user reviews,0,1,1
1258650,True,0,No user reviews,0,0,0
1258680,True,0,No user reviews,0,0,0
1258690,True,0,No user reviews,0,0,0
1258700,True,0,No user reviews,0,0,0
1258701,True,0,No user reviews,0,0,0
1258710,True,7,Positive,18,3,21
1258730,True,0,9 user reviews,9,0,9
1258740,True,7,Positive,21,0,21
1258770,True,0,No user reviews,0,0,0
1258790,True,0,No user reviews,0,0,0
1258810,True,0,No user reviews,0,0,0
1258830,True,0,No user reviews,0,0,0
1258840,True,0,2 user reviews,2,0,2
1258860,True,0,No user reviews,0,0,0
1258870,True,0,No user reviews,0,0,0
1258880,True,0,No user reviews,0,0,0
1258900,True,0,No user reviews,0,0,0
1258910,True,0,2 user reviews,1,1,2
1258930,True,0,No user reviews,0,0,0
1258950,True,0,No user reviews,0,0,0
1258960,True,0,No user reviews,0,0,0
1258970,True,0,No user reviews,0,0,0
1258980,True,0,5 user reviews,4,1,5
1258990,True,0,No user reviews,0,0,0
1259000,True,0,No user reviews,0,0,0
1259010,True,0,No user reviews,0,0,0
1259050,True,0,No user reviews,0,0,0
1259110,True,0,1 user reviews,1,0,1
1259130,True,6,Mostly Positive,8,3,11
1259140,True,0,No user reviews,0,0,0
1259150,True,0,No user reviews,0,0,0
1259160,True,0,2 user reviews,0,2,2
1259170,True,0,No user reviews,0,0,0
1259180,True,0,No user reviews,0,0,0
1259200,True,0,No user reviews,0,0,0
1259220,True,0,No user reviews,0,0,0
1259230,True,0,No user reviews,0,0,0
1259270,True,0,No user reviews,0,0,0
1259280,True,0,No user reviews,0,0,0
1259290,True,0,1 user reviews,0,1,1
1259300,True,0,No user reviews,0,0,0
1259310,True,0,4 user reviews,4,0,4
1259320,True,0,No user reviews,0,0,0
1259330,True,0,2 user reviews,2,0,2
1259340,True,0,1 user reviews,1,0,1
1259360,True,5,Mixed,252,256,508
1259370,True,0,2 user reviews,2,0,2
1259380,True,7,Positive,28,6,34
1259390,True,0,No user reviews,0,0,0
1259400,True,0,No user reviews,0,0,0
1259410,True,0,No user reviews,0,0,0
1259430,True,0,No user reviews,0,0,0
1259460,True,0,No user reviews,0,0,0
1259470,True,0,1 user reviews,1,0,1
1259480,True,0,1 user reviews,1,0,1
1259490,True,0,No user reviews,0,0,0
1259491,True,0,No user reviews,0,0,0
1259492,True,0,No user reviews,0,0,0
1259493,True,0,No user reviews,0,0,0
1259494,True,0,No user reviews,0,0,0
1259495,True,0,No user reviews,0,0,0
1259496,True,0,No user reviews,0,0,0
1259497,True,0,No user reviews,0,0,0
1259498,True,0,No user reviews,0,0,0
1259499,True,0,No user reviews,0,0,0
1259510,True,7,Positive,13,2,15
1259520,True,0,1 user reviews,0,1,1
1259530,True,7,Positive,23,2,25
1259560,True,8,Very Positive,279,41,320
1259570,True,0,1 user reviews,1,0,1
1259600,True,7,Positive,9,1,10
1259610,True,0,9 user reviews,6,3,9
1259640,True,0,No user reviews,0,0,0
1259650,True,0,2 user reviews,2,0,2
1259680,True,0,No user reviews,0,0,0
1259720,True,0,No user reviews,0,0,0
1259730,True,0,No user reviews,0,0,0
1259740,True,0,No user reviews,0,0,0
1259750,True,5,Mixed,8,8,16
1259790,True,0,No user reviews,0,0,0
1259800,True,0,No user reviews,0,0,0
1259830,True,0,No user reviews,0,0,0
1259840,True,8,Very Positive,133,14,147
1259860,True,0,1 user reviews,1,0,1
1259870,True,0,1 user reviews,1,0,1
1259890,True,0,3 user reviews,3,0,3
1259900,True,0,No user reviews,0,0,0
1259910,True,0,No user reviews,0,0,0
1259930,True,5,Mixed,43,20,63
1259950,True,0,No user reviews,0,0,0
1259960,True,7,Positive,12,0,12
1259970,True,6,Mostly Positive,793,201,994
1259980,True,5,Mixed,180,101,281
1259990,True,0,No user reviews,0,0,0
1260030,True,0,No user reviews,0,0,0
1260070,True,0,1 user reviews,1,0,1
1260110,True,0,No user reviews,0,0,0
1260130,True,0,No user reviews,0,0,0
1260150,True,0,No user reviews,0,0,0
1260160,True,0,1 user reviews,0,1,1
1260170,True,0,2 user reviews,2,0,2
1260200,True,0,No user reviews,0,0,0
1260220,True,0,5 user reviews,5,0,5
1260230,True,0,No user reviews,0,0,0
1260240,True,0,3 user reviews,1,2,3
1260250,True,0,1 user reviews,0,1,1
1260260,True,0,No user reviews,0,0,0
1260270,True,0,No user reviews,0,0,0
1260290,True,0,No user reviews,0,0,0
1260300,True,0,2 user reviews,1,1,2
1260310,True,0,7 user reviews,5,2,7
1260320,True,0,No user reviews,0,0,0
1260340,True,0,No user reviews,0,0,0
1260350,True,0,No user reviews,0,0,0
1260370,True,0,No user reviews,0,0,0
1260390,True,8,Very Positive,64,16,80
1260400,True,0,No user reviews,0,0,0
1260430,True,0,No user reviews,0,0,0
1260440,True,4,Mostly Negative,4,7,11
1260470,True,0,No user reviews,0,0,0
1260490,True,0,3 user reviews,3,0,3
1260510,True,7,Positive,10,0,10
1260520,True,0,No user reviews,0,0,0
1260540,True,0,No user reviews,0,0,0
1260550,True,0,No user reviews,0,0,0
1260560,True,0,No user reviews,0,0,0
1260570,True,0,No user reviews,0,0,0
1260580,True,7,Positive,10,0,10
1260590,True,0,No user reviews,0,0,0
1260620,True,0,2 user reviews,2,0,2
1260630,True,0,No user reviews,0,0,0
1260640,True,0,No user reviews,0,0,0
1260650,True,0,No user reviews,0,0,0
1260670,True,7,Positive,21,2,23
1260680,True,0,2 user reviews,2,0,2
1260690,True,0,2 user reviews,2,0,2
1260700,True,0,8 user reviews,7,1,8
1260710,True,7,Positive,21,4,25
1260720,True,0,1 user reviews,0,1,1
1260760,True,0,No user reviews,0,0,0
1260770,True,0,4 user reviews,3,1,4
1260780,True,0,No user reviews,0,0,0
1260800,True,6,Mostly Positive,13,4,17
1260810,True,7,Positive,18,0,18
1260820,True,8,Very Positive,114,8,122
1260830,True,0,No user reviews,0,0,0
1260840,True,0,2 user reviews,1,1,2
1260860,True,0,4 user reviews,2,2,4
1260870,True,0,No user reviews,0,0,0
1260900,True,0,No user reviews,0,0,0
1260910,True,0,3 user reviews,1,2,3
1260930,True,0,No user reviews,0,0,0
1260940,True,0,No user reviews,0,0,0
1260950,True,0,No user reviews,0,0,0
1260960,True,0,No user reviews,0,0,0
1260970,True,0,No user reviews,0,0,0
1260980,True,0,No user reviews,0,0,0
1261000,True,0,No user reviews,0,0,0
1261010,True,0,8 user reviews,7,1,8
1261020,True,0,2 user reviews,2,0,2
1261040,True,8,Very Positive,186,39,225
1261050,True,0,No user reviews,0,0,0
1261060,True,0,9 user reviews,7,2,9
1261070,True,0,No user reviews,0,0,0
1261090,True,0,4 user reviews,3,1,4
1261120,True,0,3 user reviews,3,0,3
1261130,True,0,6 user reviews,4,2,6
1261160,True,0,No user reviews,0,0,0
1261170,True,0,3 user reviews,3,0,3
1261180,True,0,No user reviews,0,0,0
1261190,True,0,2 user reviews,2,0,2
1261240,True,0,No user reviews,0,0,0
1261250,True,0,2 user reviews,2,0,2
1261280,True,0,1 user reviews,1,0,1
1261290,True,0,No user reviews,0,0,0
1261300,True,0,No user reviews,0,0,0
1261310,True,0,No user reviews,0,0,0
1261330,True,0,No user reviews,0,0,0
1261380,True,0,No user reviews,0,0,0
1261390,True,0,No user reviews,0,0,0
1261420,True,0,No user reviews,0,0,0
1261460,True,0,No user reviews,0,0,0
1261490,True,0,No user reviews,0,0,0
1261500,True,0,2 user reviews,2,0,2
1261510,True,0,1 user reviews,0,1,1
1261520,True,0,9 user reviews,3,6,9
1261530,True,0,No user reviews,0,0,0
1261540,True,0,No user reviews,0,0,0
1261541,True,0,No user reviews,0,0,0
1261542,True,0,No user reviews,0,0,0
1261560,True,0,No user reviews,0,0,0
1261570,True,0,5 user reviews,4,1,5
1261600,True,0,No user reviews,0,0,0
1261630,True,0,4 user reviews,4,0,4
1261640,True,0,9 user reviews,8,1,9
1261650,True,0,No user reviews,0,0,0
1261660,True,0,1 user reviews,1,0,1
1261670,True,7,Positive,8,2,10
1261680,True,0,No user reviews,0,0,0
1261690,True,0,No user reviews,0,0,0
1261691,True,0,No user reviews,0,0,0
1261692,True,0,2 user reviews,2,0,2
1261693,True,0,No user reviews,0,0,0
1261700,True,7,Positive,38,0,38
1261710,True,0,No user reviews,0,0,0
1261711,True,0,No user reviews,0,0,0
1261712,True,0,No user reviews,0,0,0
1261713,True,0,No user reviews,0,0,0
1261714,True,0,No user reviews,0,0,0
1261715,True,0,No user reviews,0,0,0
1261716,True,0,No user reviews,0,0,0
1261717,True,0,No user reviews,0,0,0
1261720,True,0,No user reviews,0,0,0
1261750,True,0,3 user reviews,3,0,3
1261760,True,7,Positive,31,2,33
1261790,True,0,No user reviews,0,0,0
1261800,True,0,No user reviews,0,0,0
1261810,True,0,No user reviews,0,0,0
1261820,True,0,1 user reviews,1,0,1
1261840,True,0,No user reviews,0,0,0
1261860,True,0,4 user reviews,4,0,4
1261861,True,0,No user reviews,0,0,0
1261880,True,5,Mixed,15,11,26
1261890,True,0,No user reviews,0,0,0
1261900,True,0,2 user reviews,2,0,2
1261910,True,7,Positive,14,0,14
1261930,True,0,No user reviews,0,0,0
1261960,True,7,Positive,16,1,17
1261970,True,7,Positive,12,1,13
1261980,True,0,2 user reviews,2,0,2
1261990,True,5,Mixed,8,4,12
1262000,True,0,7 user reviews,6,1,7
1262010,True,0,No user reviews,0,0,0
1262040,True,0,No user reviews,0,0,0
1262060,True,0,6 user reviews,6,0,6
1262070,True,0,1 user reviews,1,0,1
1262080,True,0,No user reviews,0,0,0
1262090,True,0,No user reviews,0,0,0
1262100,True,0,1 user reviews,0,1,1
1262110,True,5,Mixed,7,7,14
1262120,True,0,5 user reviews,3,2,5
1262130,True,0,No user reviews,0,0,0
1262140,True,0,No user reviews,0,0,0
1262170,True,0,No user reviews,0,0,0
1262190,True,0,No user reviews,0,0,0
1262200,True,0,2 user reviews,1,1,2
1262220,True,0,1 user reviews,1,0,1
1262240,True,6,Mostly Positive,284,109,393
1262250,True,0,No user reviews,0,0,0
1262260,True,0,1 user reviews,1,0,1
1262302,True,0,No user reviews,0,0,0
1262303,True,0,No user reviews,0,0,0
1262304,True,0,No user reviews,0,0,0
1262340,True,0,No user reviews,0,0,0
1262341,True,0,No user reviews,0,0,0
1262342,True,0,No user reviews,0,0,0
1262343,True,0,No user reviews,0,0,0
1262344,True,0,No user reviews,0,0,0
1262345,True,0,No user reviews,0,0,0
1262346,True,0,No user reviews,0,0,0
1262347,True,0,No user reviews,0,0,0
1262348,True,0,No user reviews,0,0,0
1262349,True,0,No user reviews,0,0,0
1262350,True,0,No user reviews,0,0,0
1262370,True,0,No user reviews,0,0,0
1262371,True,0,No user reviews,0,0,0
1262372,True,0,No user reviews,0,0,0
1262373,True,0,No user reviews,0,0,0
1262374,True,0,No user reviews,0,0,0
1262375,True,0,No user reviews,0,0,0
1262376,True,0,No user reviews,0,0,0
1262377,True,0,No user reviews,0,0,0
1262378,True,0,No user reviews,0,0,0
1262379,True,0,No user reviews,0,0,0
1262380,True,0,No user reviews,0,0,0
1262390,True,0,No user reviews,0,0,0
1262391,True,0,No user reviews,0,0,0
1262392,True,0,No user reviews,0,0,0
1262393,True,0,No user reviews,0,0,0
1262394,True,0,No user reviews,0,0,0
1262395,True,0,No user reviews,0,0,0
1262396,True,0,No user reviews,0,0,0
1262397,True,0,1 user reviews,0,1,1
1262398,True,0,1 user reviews,0,1,1
1262399,True,0,No user reviews,0,0,0
1262400,True,0,No user reviews,0,0,0
1262401,True,0,No user reviews,0,0,0
1262402,True,0,No user reviews,0,0,0
1262403,True,0,No user reviews,0,0,0
1262404,True,0,No user reviews,0,0,0
1262405,True,0,No user reviews,0,0,0
1262406,True,0,No user reviews,0,0,0
1262407,True,0,No user reviews,0,0,0
1262408,True,0,No user reviews,0,0,0
1262409,True,0,No user reviews,0,0,0
1262410,True,0,1 user reviews,0,1,1
1262411,True,0,No user reviews,0,0,0
1262412,True,0,No user reviews,0,0,0
1262413,True,0,1 user reviews,0,1,1
1262414,True,0,No user reviews,0,0,0
1262415,True,0,No user reviews,0,0,0
1262416,True,0,No user reviews,0,0,0
1262417,True,0,1 user reviews,1,0,1
1262418,True,0,No user reviews,0,0,0
1262419,True,0,No user reviews,0,0,0
1262420,True,0,No user reviews,0,0,0
1262421,True,0,No user reviews,0,0,0
1262422,True,0,No user reviews,0,0,0
1262423,True,0,1 user reviews,1,0,1
1262424,True,0,No user reviews,0,0,0
1262425,True,0,No user reviews,0,0,0
1262426,True,0,No user reviews,0,0,0
1262427,True,0,No user reviews,0,0,0
1262428,True,0,No user reviews,0,0,0
1262429,True,0,No user reviews,0,0,0
1262430,True,0,No user reviews,0,0,0
1262431,True,0,No user reviews,0,0,0
1262432,True,0,No user reviews,0,0,0
1262433,True,0,No user reviews,0,0,0
1262434,True,0,No user reviews,0,0,0
1262435,True,0,No user reviews,0,0,0
1262436,True,0,No user reviews,0,0,0
1262437,True,0,No user reviews,0,0,0
1262438,True,0,No user reviews,0,0,0
1262439,True,0,1 user reviews,1,0,1
1262450,True,0,No user reviews,0,0,0
1262460,True,8,Very Positive,104,17,121
1262470,True,0,4 user reviews,1,3,4
1262480,True,0,No user reviews,0,0,0
1262500,True,0,No user reviews,0,0,0
1262540,True,5,Mixed,590,375,965
1262550,True,0,No user reviews,0,0,0
1262560,True,6,Mostly Positive,424,173,597
1262570,True,0,No user reviews,0,0,0
1262571,True,0,1 user reviews,1,0,1
1262572,True,0,1 user reviews,1,0,1
1262573,True,0,No user reviews,0,0,0
1262580,True,8,Very Positive,352,54,406
1262600,True,5,Mixed,200,88,288
1262610,True,0,No user reviews,0,0,0
1262640,True,5,Mixed,14,7,21
1262660,True,0,No user reviews,0,0,0
1262670,True,5,Mixed,11,8,19
1262680,True,0,No user reviews,0,0,0
1262700,True,0,No user reviews,0,0,0
1262710,True,0,No user reviews,0,0,0
1262720,True,0,No user reviews,0,0,0
1262730,True,0,No user reviews,0,0,0
1262740,True,0,No user reviews,0,0,0
1262741,True,0,No user reviews,0,0,0
1262742,True,0,No user reviews,0,0,0
1262743,True,0,No user reviews,0,0,0
1262760,True,0,No user reviews,0,0,0
1262770,True,0,3 user reviews,1,2,3
1262780,True,0,2 user reviews,2,0,2
1262790,True,0,No user reviews,0,0,0
1262800,True,0,No user reviews,0,0,0
1262820,True,0,1 user reviews,1,0,1
1262830,True,0,1 user reviews,0,1,1
1262880,True,0,No user reviews,0,0,0
1262890,True,0,5 user reviews,5,0,5
1262900,True,0,No user reviews,0,0,0
1262910,True,5,Mixed,10,12,22
1262920,True,0,No user reviews,0,0,0
1262950,True,0,No user reviews,0,0,0
1262980,True,0,No user reviews,0,0,0
1262981,True,0,No user reviews,0,0,0
1263000,True,0,No user reviews,0,0,0
1263020,True,0,No user reviews,0,0,0
1263030,True,0,No user reviews,0,0,0
1263040,True,0,No user reviews,0,0,0
1263050,True,0,No user reviews,0,0,0
1263070,True,6,Mostly Positive,210,82,292
1263080,True,0,5 user reviews,5,0,5
1263090,True,0,No user reviews,0,0,0
1263110,True,0,1 user reviews,0,1,1
1263120,True,0,3 user reviews,2,1,3
1263130,True,0,5 user reviews,1,4,5
1263160,True,8,Very Positive,71,3,74
1263170,True,0,No user reviews,0,0,0
1263200,True,0,7 user reviews,6,1,7
1263220,True,0,No user reviews,0,0,0
1263230,True,0,No user reviews,0,0,0
1263250,True,0,1 user reviews,1,0,1
1263260,True,0,No user reviews,0,0,0
1263270,True,0,No user reviews,0,0,0
1263280,True,0,No user reviews,0,0,0
1263290,True,0,No user reviews,0,0,0
1263300,True,0,No user reviews,0,0,0
1263310,True,0,No user reviews,0,0,0
1263360,True,0,No user reviews,0,0,0
1263370,True,5,Mixed,21,16,37
1263380,True,0,No user reviews,0,0,0
1263410,True,0,3 user reviews,2,1,3
1263450,True,0,No user reviews,0,0,0
1263470,True,0,No user reviews,0,0,0
1263480,True,0,No user reviews,0,0,0
1263490,True,0,3 user reviews,2,1,3
1263500,True,0,No user reviews,0,0,0
1263510,True,0,No user reviews,0,0,0
1263520,True,0,1 user reviews,1,0,1
1263550,True,0,No user reviews,0,0,0
1263590,True,0,No user reviews,0,0,0
1263610,True,0,No user reviews,0,0,0
1263620,True,0,No user reviews,0,0,0
1263630,True,0,No user reviews,0,0,0
1263670,True,0,No user reviews,0,0,0
1263680,True,0,2 user reviews,2,0,2
1263700,True,0,9 user reviews,8,1,9
1263720,True,0,3 user reviews,3,0,3
1263740,True,0,No user reviews,0,0,0
1263760,True,0,No user reviews,0,0,0
1263780,True,0,4 user reviews,0,4,4
1263800,True,0,No user reviews,0,0,0
1263810,True,0,No user reviews,0,0,0
1263820,True,7,Positive,9,1,10
1263830,True,7,Positive,46,1,47
1263840,True,7,Positive,9,2,11
1263870,True,0,No user reviews,0,0,0
1263910,True,0,No user reviews,0,0,0
1263920,True,0,2 user reviews,1,1,2
1263950,True,0,No user reviews,0,0,0
1263990,True,0,No user reviews,0,0,0
1264000,True,0,No user reviews,0,0,0
1264010,True,0,4 user reviews,4,0,4
1264040,True,0,2 user reviews,2,0,2
1264050,True,0,No user reviews,0,0,0
1264070,True,0,No user reviews,0,0,0
1264080,True,0,2 user reviews,1,1,2
1264090,True,0,3 user reviews,3,0,3
1264101,True,0,No user reviews,0,0,0
1264102,True,0,No user reviews,0,0,0
1264103,True,0,No user reviews,0,0,0
1264104,True,0,No user reviews,0,0,0
1264105,True,0,No user reviews,0,0,0
1264106,True,0,No user reviews,0,0,0
1264110,True,0,No user reviews,0,0,0
1264111,True,0,No user reviews,0,0,0
1264112,True,0,No user reviews,0,0,0
1264113,True,0,No user reviews,0,0,0
1264114,True,0,No user reviews,0,0,0
1264140,True,0,No user reviews,0,0,0
1264150,True,0,No user reviews,0,0,0
1264160,True,7,Positive,16,3,19
1264170,True,0,4 user reviews,4,0,4
1264171,True,0,2 user reviews,1,1,2
1264180,True,7,Positive,20,2,22
1264190,True,0,3 user reviews,2,1,3
1264220,True,0,No user reviews,0,0,0
1264230,True,0,No user reviews,0,0,0
1264240,True,0,No user reviews,0,0,0
1264250,True,5,Mixed,189,103,292
1264260,True,0,No user reviews,0,0,0
1264290,True,0,No user reviews,0,0,0
1264310,True,0,1 user reviews,1,0,1
1264340,True,5,Mixed,14,10,24
1264350,True,0,No user reviews,0,0,0
1264390,True,0,No user reviews,0,0,0
1264410,True,0,1 user reviews,1,0,1
1264470,True,0,No user reviews,0,0,0
1264500,True,0,No user reviews,0,0,0
1264510,True,0,1 user reviews,0,1,1
1264520,True,8,Very Positive,110,1,111
1264530,True,0,No user reviews,0,0,0
1264540,True,0,No user reviews,0,0,0
1264550,True,0,No user reviews,0,0,0
1264590,True,0,2 user reviews,1,1,2
1264610,True,0,No user reviews,0,0,0
1264620,True,0,No user reviews,0,0,0
1264630,True,0,1 user reviews,0,1,1
1264640,True,0,1 user reviews,0,1,1
1264670,True,6,Mostly Positive,51,13,64
1264690,True,0,No user reviews,0,0,0
1264700,True,0,1 user reviews,0,1,1
1264710,True,8,Very Positive,56,8,64
1264730,True,0,5 user reviews,5,0,5
1264740,True,0,No user reviews,0,0,0
1264760,True,0,6 user reviews,4,2,6
1264770,True,7,Positive,12,1,13
1264780,True,0,No user reviews,0,0,0
1264790,True,0,No user reviews,0,0,0
1264800,True,0,3 user reviews,1,2,3
1264810,True,0,No user reviews,0,0,0
1264820,True,0,1 user reviews,1,0,1
1264830,True,0,No user reviews,0,0,0
1264840,True,0,No user reviews,0,0,0
1264850,True,0,3 user reviews,3,0,3
1264860,True,0,No user reviews,0,0,0
1264890,True,0,1 user reviews,0,1,1
1264900,True,0,2 user reviews,2,0,2
1264920,True,0,No user reviews,0,0,0
1264930,True,0,6 user reviews,5,1,6
1264940,True,0,No user reviews,0,0,0
1264950,True,0,No user reviews,0,0,0
1264960,True,0,No user reviews,0,0,0
1264970,True,0,No user reviews,0,0,0
1264980,True,0,No user reviews,0,0,0
1264990,True,0,No user reviews,0,0,0
1265030,True,0,8 user reviews,3,5,8
1265060,True,0,No user reviews,0,0,0
1265061,True,0,No user reviews,0,0,0
1265070,True,0,3 user reviews,2,1,3
1265080,True,0,2 user reviews,2,0,2
1265090,True,0,No user reviews,0,0,0
1265100,True,0,No user reviews,0,0,0
1265110,True,0,No user reviews,0,0,0
1265120,True,0,6 user reviews,6,0,6
1265130,True,0,No user reviews,0,0,0
1265140,True,0,2 user reviews,2,0,2
1265170,True,0,2 user reviews,0,2,2
1265200,True,0,5 user reviews,4,1,5
1265220,True,7,Positive,23,2,25
1265230,True,0,No user reviews,0,0,0
1265240,True,0,8 user reviews,7,1,8
1265250,True,0,No user reviews,0,0,0
1265260,True,0,1 user reviews,1,0,1
1265270,True,0,No user reviews,0,0,0
1265280,True,0,No user reviews,0,0,0
1265300,True,0,No user reviews,0,0,0
1265310,True,0,No user reviews,0,0,0
1265330,True,0,No user reviews,0,0,0
1265350,True,0,No user reviews,0,0,0
1265360,True,0,9 user reviews,6,3,9
1265390,True,0,4 user reviews,2,2,4
1265400,True,0,No user reviews,0,0,0
1265410,True,0,6 user reviews,1,5,6
1265440,True,0,No user reviews,0,0,0
1265450,True,0,No user reviews,0,0,0
1265460,True,0,2 user reviews,2,0,2
1265470,True,0,6 user reviews,4,2,6
1265471,True,0,1 user reviews,1,0,1
1265472,True,0,2 user reviews,2,0,2
1265473,True,0,1 user reviews,1,0,1
1265474,True,0,1 user reviews,1,0,1
1265475,True,0,2 user reviews,2,0,2
1265476,True,0,2 user reviews,2,0,2
1265490,True,0,No user reviews,0,0,0
1265500,True,0,No user reviews,0,0,0
1265510,True,0,No user reviews,0,0,0
1265560,True,0,No user reviews,0,0,0
1265570,True,0,1 user reviews,0,1,1
1265580,True,0,1 user reviews,1,0,1
1265600,True,0,No user reviews,0,0,0
1265610,True,0,No user reviews,0,0,0
1265620,True,0,8 user reviews,6,2,8
1265640,True,7,Positive,16,2,18
1265650,True,0,No user reviews,0,0,0
1265660,True,0,No user reviews,0,0,0
1265670,True,0,No user reviews,0,0,0
1265680,True,0,No user reviews,0,0,0
1265690,True,0,5 user reviews,5,0,5
1265700,True,0,No user reviews,0,0,0
1265710,True,0,No user reviews,0,0,0
1265730,True,0,No user reviews,0,0,0
1265760,True,0,No user reviews,0,0,0
1265770,True,0,1 user reviews,1,0,1
1265810,True,0,No user reviews,0,0,0
1265820,True,0,No user reviews,0,0,0
1265840,True,0,No user reviews,0,0,0
1265850,True,7,Positive,38,1,39
1265860,True,5,Mixed,95,62,157
1265870,True,0,4 user reviews,2,2,4
1265880,True,0,No user reviews,0,0,0
1265960,True,0,8 user reviews,5,3,8
1265970,True,0,2 user reviews,2,0,2
1265990,True,0,No user reviews,0,0,0
1266000,True,0,No user reviews,0,0,0
1266010,True,0,No user reviews,0,0,0
1266020,True,0,No user reviews,0,0,0
1266050,True,0,1 user reviews,1,0,1
1266070,True,0,No user reviews,0,0,0
1266100,True,0,No user reviews,0,0,0
1266120,True,0,No user reviews,0,0,0
1266130,True,0,2 user reviews,2,0,2
1266140,True,6,Mostly Positive,8,3,11
1266210,True,0,No user reviews,0,0,0
1266220,True,5,Mixed,40,23,63
1266230,True,0,2 user reviews,2,0,2
1266250,True,0,No user reviews,0,0,0
1266260,True,0,No user reviews,0,0,0
1266370,True,7,Positive,8,2,10
1266380,True,0,3 user reviews,3,0,3
1266390,True,0,No user reviews,0,0,0
1266400,True,0,6 user reviews,5,1,6
1266410,True,0,1 user reviews,1,0,1
1266420,True,7,Positive,13,2,15
1266440,True,0,No user reviews,0,0,0
1266450,True,0,No user reviews,0,0,0
1266470,True,0,No user reviews,0,0,0
1266480,True,0,2 user reviews,2,0,2
1266500,True,0,No user reviews,0,0,0
1266501,True,0,No user reviews,0,0,0
1266502,True,0,No user reviews,0,0,0
1266503,True,0,No user reviews,0,0,0
1266510,True,0,No user reviews,0,0,0
1266520,True,0,No user reviews,0,0,0
1266560,True,0,No user reviews,0,0,0
1266580,True,0,1 user reviews,0,1,1
1266600,True,7,Positive,13,3,16
1266610,True,0,No user reviews,0,0,0
1266620,True,0,No user reviews,0,0,0
1266640,True,0,No user reviews,0,0,0
1266650,True,0,2 user reviews,1,1,2
1266660,True,0,No user reviews,0,0,0
1266670,True,0,1 user reviews,1,0,1
1266680,True,5,Mixed,8,4,12
1266690,True,0,No user reviews,0,0,0
1266710,True,0,No user reviews,0,0,0
1266711,True,0,No user reviews,0,0,0
1266712,True,0,No user reviews,0,0,0
1266713,True,0,No user reviews,0,0,0
1266714,True,0,No user reviews,0,0,0
1266715,True,0,No user reviews,0,0,0
1266716,True,0,No user reviews,0,0,0
1266717,True,0,No user reviews,0,0,0
1266718,True,0,No user reviews,0,0,0
1266719,True,0,No user reviews,0,0,0
1266720,True,0,No user reviews,0,0,0
1266740,True,0,No user reviews,0,0,0
1266750,True,0,No user reviews,0,0,0
1266760,True,0,No user reviews,0,0,0
1266770,True,0,No user reviews,0,0,0
1266800,True,7,Positive,32,2,34
1266820,True,0,No user reviews,0,0,0
1266840,True,0,No user reviews,0,0,0
1266860,True,7,Positive,11,0,11
1266890,True,0,No user reviews,0,0,0
1266900,True,0,No user reviews,0,0,0
1266940,True,0,No user reviews,0,0,0
1266970,True,0,No user reviews,0,0,0
1266980,True,0,No user reviews,0,0,0
1267010,True,0,6 user reviews,4,2,6
1267030,True,0,No user reviews,0,0,0
1267040,True,0,No user reviews,0,0,0
1267060,True,0,No user reviews,0,0,0
1267070,True,0,No user reviews,0,0,0
1267080,True,0,No user reviews,0,0,0
1267090,True,0,No user reviews,0,0,0
1267091,True,0,No user reviews,0,0,0
1267092,True,0,No user reviews,0,0,0
1267093,True,0,No user reviews,0,0,0
1267094,True,0,No user reviews,0,0,0
1267095,True,0,No user reviews,0,0,0
1267097,True,0,No user reviews,0,0,0
1267098,True,0,No user reviews,0,0,0
1267099,True,0,No user reviews,0,0,0
1267100,True,0,No user reviews,0,0,0
1267101,True,0,No user reviews,0,0,0
1267102,True,0,No user reviews,0,0,0
1267103,True,0,No user reviews,0,0,0
1267104,True,0,No user reviews,0,0,0
1267105,True,0,No user reviews,0,0,0
1267106,True,0,No user reviews,0,0,0
1267120,True,0,No user reviews,0,0,0
1267130,True,7,Positive,10,0,10
1267140,True,0,No user reviews,0,0,0
1267150,True,0,No user reviews,0,0,0
1267170,True,0,No user reviews,0,0,0
1267190,True,0,No user reviews,0,0,0
1267200,True,0,No user reviews,0,0,0
1267210,True,0,No user reviews,0,0,0
1267230,True,0,No user reviews,0,0,0
1267240,True,0,No user reviews,0,0,0
1267260,True,0,6 user reviews,6,0,6
1267270,True,0,2 user reviews,2,0,2
1267300,True,0,No user reviews,0,0,0
1267310,True,5,Mixed,15,7,22
1267320,True,0,No user reviews,0,0,0
1267330,True,0,No user reviews,0,0,0
1267340,True,0,2 user reviews,2,0,2
1267341,True,0,No user reviews,0,0,0
1267342,True,0,No user reviews,0,0,0
1267343,True,0,No user reviews,0,0,0
1267344,True,0,No user reviews,0,0,0
1267345,True,0,No user reviews,0,0,0
1267346,True,0,No user reviews,0,0,0
1267360,True,0,No user reviews,0,0,0
1267361,True,0,No user reviews,0,0,0
1267362,True,0,No user reviews,0,0,0
1267363,True,0,No user reviews,0,0,0
1267364,True,0,No user reviews,0,0,0
1267365,True,0,No user reviews,0,0,0
1267370,True,0,4 user reviews,3,1,4
1267380,True,0,No user reviews,0,0,0
1267381,True,0,No user reviews,0,0,0
1267382,True,0,No user reviews,0,0,0
1267383,True,0,No user reviews,0,0,0
1267384,True,0,No user reviews,0,0,0
1267400,True,0,2 user reviews,2,0,2
1267410,True,0,2 user reviews,2,0,2
1267420,True,0,No user reviews,0,0,0
1267430,True,0,No user reviews,0,0,0
1267440,True,0,No user reviews,0,0,0
1267450,True,0,No user reviews,0,0,0
1267460,True,0,No user reviews,0,0,0
1267470,True,8,Very Positive,70,4,74
1267480,True,0,No user reviews,0,0,0
1267490,True,0,No user reviews,0,0,0
1267500,True,0,1 user reviews,1,0,1
1267501,True,0,No user reviews,0,0,0
1267502,True,0,6 user reviews,6,0,6
1267503,True,0,4 user reviews,2,2,4
1267504,True,0,1 user reviews,1,0,1
1267505,True,0,1 user reviews,1,0,1
1267506,True,0,3 user reviews,1,2,3
1267507,True,0,9 user reviews,5,4,9
1267509,True,7,Positive,13,1,14
1267510,True,0,No user reviews,0,0,0
1267520,True,0,No user reviews,0,0,0
1267570,True,0,No user reviews,0,0,0
1267580,True,0,No user reviews,0,0,0
1267590,True,0,8 user reviews,2,6,8
1267591,True,0,4 user reviews,0,4,4
1267592,True,0,6 user reviews,2,4,6
1267593,True,0,4 user reviews,0,4,4
1267594,True,0,6 user reviews,1,5,6
1267600,True,0,No user reviews,0,0,0
1267610,True,0,No user reviews,0,0,0
1267670,True,0,No user reviews,0,0,0
1267680,True,0,No user reviews,0,0,0
1267690,True,0,No user reviews,0,0,0
1267710,True,0,No user reviews,0,0,0
1267770,True,0,No user reviews,0,0,0
1267780,True,0,No user reviews,0,0,0
1267790,True,0,1 user reviews,1,0,1
1267800,True,0,1 user reviews,1,0,1
1267801,True,0,1 user reviews,1,0,1
1267810,True,8,Very Positive,81,6,87
1267830,True,0,7 user reviews,5,2,7
1267860,True,0,6 user reviews,4,2,6
1267870,True,0,8 user reviews,8,0,8
1267880,True,0,No user reviews,0,0,0
1267900,True,0,1 user reviews,0,1,1
1267920,True,0,1 user reviews,1,0,1
1267940,True,0,2 user reviews,1,1,2
1267950,True,0,1 user reviews,1,0,1
1267960,True,0,No user reviews,0,0,0
1268000,True,0,No user reviews,0,0,0
1268010,True,0,No user reviews,0,0,0
1268040,True,6,Mostly Positive,23,7,30
1268050,True,0,No user reviews,0,0,0
1268060,True,0,No user reviews,0,0,0
1268080,True,0,No user reviews,0,0,0
1268090,True,0,No user reviews,0,0,0
1268100,True,0,1 user reviews,1,0,1
1268110,True,8,Very Positive,111,19,130
1268120,True,0,No user reviews,0,0,0
1268130,True,0,No user reviews,0,0,0
1268140,True,0,1 user reviews,1,0,1
1268150,True,0,5 user reviews,3,2,5
1268160,True,0,1 user reviews,0,1,1
1268170,True,0,No user reviews,0,0,0
1268190,True,0,1 user reviews,0,1,1
1268200,True,0,No user reviews,0,0,0
1268210,True,0,No user reviews,0,0,0
1268220,True,0,No user reviews,0,0,0
1268250,True,5,Mixed,10,5,15
1268270,True,0,No user reviews,0,0,0
1268280,True,0,1 user reviews,0,1,1
1268290,True,6,Mostly Positive,9,3,12
1268320,True,0,No user reviews,0,0,0
1268330,True,0,2 user reviews,1,1,2
1268350,True,7,Positive,23,5,28
1268360,True,0,No user reviews,0,0,0
1268370,True,7,Positive,31,2,33
1268380,True,7,Positive,8,2,10
1268390,True,0,No user reviews,0,0,0
1268391,True,0,No user reviews,0,0,0
1268400,True,0,4 user reviews,2,2,4
1268410,True,0,7 user reviews,2,5,7
1268440,True,0,No user reviews,0,0,0
1268450,True,0,No user reviews,0,0,0
1268460,True,0,1 user reviews,1,0,1
1268470,True,0,No user reviews,0,0,0
1268480,True,0,No user reviews,0,0,0
1268500,True,0,No user reviews,0,0,0
1268520,True,0,No user reviews,0,0,0
1268530,True,6,Mostly Positive,9,3,12
1268540,True,0,1 user reviews,1,0,1
1268570,True,0,3 user reviews,1,2,3
1268580,True,0,No user reviews,0,0,0
1268610,True,0,No user reviews,0,0,0
1268620,True,0,No user reviews,0,0,0
1268700,True,0,1 user reviews,1,0,1
1268710,True,0,No user reviews,0,0,0
1268720,True,0,No user reviews,0,0,0
1268730,True,0,No user reviews,0,0,0
1268740,True,0,No user reviews,0,0,0
1268790,True,0,No user reviews,0,0,0
1268800,True,0,No user reviews,0,0,0
1268810,True,0,No user reviews,0,0,0
1268820,True,0,No user reviews,0,0,0
1268821,True,0,No user reviews,0,0,0
1268830,True,0,1 user reviews,1,0,1
1268840,True,0,No user reviews,0,0,0
1268850,True,0,1 user reviews,1,0,1
1268860,True,0,7 user reviews,7,0,7
1268870,True,0,7 user reviews,6,1,7
1268880,True,0,No user reviews,0,0,0
1268890,True,0,No user reviews,0,0,0
1268900,True,0,No user reviews,0,0,0
1268930,True,0,No user reviews,0,0,0
1268940,True,0,No user reviews,0,0,0
1268950,True,0,No user reviews,0,0,0
1268960,True,0,No user reviews,0,0,0
1268970,True,0,No user reviews,0,0,0
1268980,True,0,No user reviews,0,0,0
1268990,True,0,No user reviews,0,0,0
1269000,True,0,No user reviews,0,0,0
1269010,True,0,3 user reviews,3,0,3
1269020,True,0,No user reviews,0,0,0
1269030,True,0,3 user reviews,3,0,3
1269050,True,0,1 user reviews,0,1,1
1269120,True,0,5 user reviews,3,2,5
1269150,True,0,No user reviews,0,0,0
1269160,True,0,No user reviews,0,0,0
1269170,True,0,No user reviews,0,0,0
1269180,True,0,2 user reviews,2,0,2
1269190,True,0,3 user reviews,3,0,3
1269210,True,0,No user reviews,0,0,0
1269220,True,0,1 user reviews,1,0,1
1269221,True,0,1 user reviews,1,0,1
1269230,True,0,No user reviews,0,0,0
1269240,True,0,3 user reviews,3,0,3
1269250,True,0,No user reviews,0,0,0
1269260,True,0,No user reviews,0,0,0
1269300,True,0,No user reviews,0,0,0
1269320,True,0,7 user reviews,5,2,7
1269330,True,0,No user reviews,0,0,0
1269340,True,0,No user reviews,0,0,0
1269350,True,7,Positive,9,2,11
1269360,True,0,1 user reviews,1,0,1
1269370,True,0,No user reviews,0,0,0
1269380,True,0,No user reviews,0,0,0
1269400,True,0,No user reviews,0,0,0
1269430,True,0,No user reviews,0,0,0
1269440,True,0,3 user reviews,3,0,3
1269450,True,0,No user reviews,0,0,0
1269460,True,0,No user reviews,0,0,0
1269470,True,0,No user reviews,0,0,0
1269490,True,0,No user reviews,0,0,0
1269500,True,0,No user reviews,0,0,0
1269510,True,0,No user reviews,0,0,0
1269520,True,0,No user reviews,0,0,0
1269540,True,0,3 user reviews,2,1,3
1269550,True,0,No user reviews,0,0,0
1269560,True,0,3 user reviews,2,1,3
1269590,True,0,6 user reviews,6,0,6
1269600,True,0,No user reviews,0,0,0
1269610,True,0,No user reviews,0,0,0
1269630,True,0,No user reviews,0,0,0
1269640,True,0,No user reviews,0,0,0
1269650,True,0,3 user reviews,1,2,3
1269670,True,0,No user reviews,0,0,0
1269680,True,0,No user reviews,0,0,0
1269700,True,0,No user reviews,0,0,0
1269710,True,0,No user reviews,0,0,0
1269730,True,0,No user reviews,0,0,0
1269742,True,0,No user reviews,0,0,0
1269743,True,0,No user reviews,0,0,0
1269745,True,0,No user reviews,0,0,0
1269746,True,0,No user reviews,0,0,0
1269748,True,0,No user reviews,0,0,0
1269755,True,0,No user reviews,0,0,0
1269770,True,0,No user reviews,0,0,0
1269810,True,6,Mostly Positive,26,10,36
1269820,True,7,Positive,18,1,19
1269830,True,7,Positive,17,4,21
1269840,True,7,Positive,14,1,15
1269850,True,0,No user reviews,0,0,0
1269860,True,0,No user reviews,0,0,0
1269880,True,0,3 user reviews,3,0,3
1269890,True,0,No user reviews,0,0,0
1269900,True,0,No user reviews,0,0,0
1269910,True,0,No user reviews,0,0,0
1269930,True,0,No user reviews,0,0,0
1269940,True,0,1 user reviews,1,0,1
1269950,True,0,No user reviews,0,0,0
1269960,True,0,No user reviews,0,0,0
1269980,True,0,No user reviews,0,0,0
1269990,True,0,No user reviews,0,0,0
1270000,True,0,1 user reviews,1,0,1
1270010,True,5,Mixed,16,12,28
1270030,True,0,No user reviews,0,0,0
1270040,True,0,No user reviews,0,0,0
1270050,True,0,No user reviews,0,0,0
1270060,True,0,No user reviews,0,0,0
1270070,True,0,No user reviews,0,0,0
1270080,True,0,No user reviews,0,0,0
1270100,True,0,1 user reviews,1,0,1
1270120,True,0,No user reviews,0,0,0
1270130,True,0,No user reviews,0,0,0
1270140,True,0,No user reviews,0,0,0
1270180,True,0,No user reviews,0,0,0
1270210,True,0,No user reviews,0,0,0
1270240,True,0,No user reviews,0,0,0
1270250,True,0,1 user reviews,1,0,1
1270260,True,0,No user reviews,0,0,0
1270280,True,0,No user reviews,0,0,0
1270290,True,0,6 user reviews,6,0,6
1270300,True,0,No user reviews,0,0,0
1270320,True,0,No user reviews,0,0,0
1270340,True,7,Positive,47,0,47
1270370,True,0,2 user reviews,1,1,2
1270390,True,0,9 user reviews,9,0,9
1270400,True,0,No user reviews,0,0,0
1270410,True,0,No user reviews,0,0,0
1270420,True,0,No user reviews,0,0,0
1270440,True,0,No user reviews,0,0,0
1270460,True,0,No user reviews,0,0,0
1270470,True,0,No user reviews,0,0,0
1270480,True,0,No user reviews,0,0,0
1270520,True,0,No user reviews,0,0,0
1270530,True,0,No user reviews,0,0,0
1270540,True,5,Mixed,20,13,33
1270570,True,7,Positive,10,0,10
1270590,True,7,Positive,27,1,28
1270600,True,0,No user reviews,0,0,0
1270620,True,7,Positive,11,0,11
1270630,True,0,No user reviews,0,0,0
1270640,True,0,No user reviews,0,0,0
1270650,True,0,2 user reviews,1,1,2
1270680,True,0,No user reviews,0,0,0
1270700,True,0,No user reviews,0,0,0
1270760,True,0,No user reviews,0,0,0
1270770,True,0,No user reviews,0,0,0
1270780,True,0,1 user reviews,1,0,1
1270790,True,0,No user reviews,0,0,0
1270820,True,0,1 user reviews,0,1,1
1270830,True,0,No user reviews,0,0,0
1270840,True,0,2 user reviews,0,2,2
1270850,True,7,Positive,17,1,18
1270860,True,0,1 user reviews,1,0,1
1270870,True,0,3 user reviews,3,0,3
1270930,True,8,Very Positive,47,3,50
1270950,True,0,2 user reviews,2,0,2
1270970,True,0,No user reviews,0,0,0
1270980,True,0,No user reviews,0,0,0
1271030,True,0,No user reviews,0,0,0
1271050,True,0,No user reviews,0,0,0
1271070,True,0,2 user reviews,1,1,2
1271080,True,5,Mixed,7,10,17
1271090,True,0,8 user reviews,8,0,8
1271110,True,0,No user reviews,0,0,0
1271130,True,0,No user reviews,0,0,0
1271131,True,0,No user reviews,0,0,0
1271132,True,0,No user reviews,0,0,0
1271133,True,0,No user reviews,0,0,0
1271140,True,0,No user reviews,0,0,0
1271170,True,0,No user reviews,0,0,0
1271190,True,5,Mixed,14,15,29
1271231,True,0,No user reviews,0,0,0
1271240,True,0,No user reviews,0,0,0
1271250,True,0,No user reviews,0,0,0
1271260,True,0,No user reviews,0,0,0
1271270,True,0,3 user reviews,3,0,3
1271280,True,7,Positive,39,2,41
1271300,True,0,2 user reviews,2,0,2
1271310,True,0,No user reviews,0,0,0
1271330,True,0,1 user reviews,1,0,1
1271340,True,0,No user reviews,0,0,0
1271350,True,0,No user reviews,0,0,0
1271360,True,0,No user reviews,0,0,0
1271370,True,0,No user reviews,0,0,0
1271371,True,0,No user reviews,0,0,0
1271380,True,0,No user reviews,0,0,0
1271400,True,0,No user reviews,0,0,0
1271420,True,0,1 user reviews,0,1,1
1271450,True,0,No user reviews,0,0,0
1271460,True,0,3 user reviews,2,1,3
1271470,True,0,No user reviews,0,0,0
1271490,True,0,No user reviews,0,0,0
1271500,True,0,1 user reviews,0,1,1
1271510,True,0,1 user reviews,1,0,1
1271520,True,0,No user reviews,0,0,0
1271530,True,0,6 user reviews,6,0,6
1271540,True,0,No user reviews,0,0,0
1271570,True,0,No user reviews,0,0,0
1271571,True,0,No user reviews,0,0,0
1271580,True,0,No user reviews,0,0,0
1271600,True,0,4 user reviews,3,1,4
1271620,True,0,4 user reviews,3,1,4
1271630,True,0,5 user reviews,4,1,5
1271670,True,0,9 user reviews,9,0,9
1271671,True,0,7 user reviews,7,0,7
1271680,True,0,1 user reviews,0,1,1
1271690,True,0,No user reviews,0,0,0
1271710,True,8,Very Positive,556,35,591
1271740,True,0,No user reviews,0,0,0
1271750,True,6,Mostly Positive,10,4,14
1271760,True,0,2 user reviews,2,0,2
1271780,True,0,No user reviews,0,0,0
1271792,True,7,Positive,11,1,12
1271793,True,0,No user reviews,0,0,0
1271794,True,0,No user reviews,0,0,0
1271800,True,0,No user reviews,0,0,0
1271820,True,0,No user reviews,0,0,0
1271840,True,0,1 user reviews,1,0,1
1271850,True,0,No user reviews,0,0,0
1271870,True,0,9 user reviews,0,9,9
1271880,True,0,No user reviews,0,0,0
1271900,True,0,No user reviews,0,0,0
1271910,True,0,1 user reviews,1,0,1
1271920,True,0,2 user reviews,1,1,2
1271930,True,0,No user reviews,0,0,0
1271950,True,0,No user reviews,0,0,0
1271980,True,0,5 user reviews,2,3,5
1271990,True,0,1 user reviews,1,0,1
1272000,True,0,No user reviews,0,0,0
1272010,True,0,No user reviews,0,0,0
1272020,True,0,No user reviews,0,0,0
1272030,True,0,No user reviews,0,0,0
1272040,True,0,No user reviews,0,0,0
1272050,True,0,No user reviews,0,0,0
1272060,True,0,2 user reviews,2,0,2
1272070,True,0,No user reviews,0,0,0
1272090,True,0,No user reviews,0,0,0
1272100,True,0,4 user reviews,4,0,4
1272110,True,0,9 user reviews,7,2,9
1272120,True,0,3 user reviews,3,0,3
1272130,True,0,8 user reviews,6,2,8
1272150,True,0,1 user reviews,1,0,1
1272160,True,0,No user reviews,0,0,0
1272170,True,0,No user reviews,0,0,0
1272180,True,0,No user reviews,0,0,0
1272200,True,0,No user reviews,0,0,0
1272210,True,0,1 user reviews,1,0,1
1272240,True,0,2 user reviews,2,0,2
1272270,True,0,No user reviews,0,0,0
1272280,True,0,No user reviews,0,0,0
1272290,True,0,No user reviews,0,0,0
1272300,True,0,No user reviews,0,0,0
1272310,True,0,No user reviews,0,0,0
1272320,True,0,No user reviews,0,0,0
1272330,True,0,1 user reviews,1,0,1
1272340,True,0,No user reviews,0,0,0
1272360,True,0,No user reviews,0,0,0
1272380,True,0,1 user reviews,0,1,1
1272381,True,0,1 user reviews,0,1,1
1272382,True,0,1 user reviews,1,0,1
1272383,True,0,1 user reviews,0,1,1
1272384,True,0,1 user reviews,1,0,1
1272385,True,0,1 user reviews,1,0,1
1272390,True,0,1 user reviews,0,1,1
1272430,True,0,No user reviews,0,0,0
1272440,True,0,2 user reviews,2,0,2
1272450,True,0,3 user reviews,2,1,3
1272460,True,0,No user reviews,0,0,0
1272480,True,0,No user reviews,0,0,0
1272481,True,0,No user reviews,0,0,0
1272490,True,0,No user reviews,0,0,0
1272500,True,0,No user reviews,0,0,0
1272520,True,0,No user reviews,0,0,0
1272530,True,0,2 user reviews,2,0,2
1272580,True,0,No user reviews,0,0,0
1272650,True,0,No user reviews,0,0,0
1272654,True,0,No user reviews,0,0,0
1272657,True,0,2 user reviews,1,1,2
1272660,True,0,No user reviews,0,0,0
1272680,True,0,2 user reviews,2,0,2
1272690,True,0,8 user reviews,7,1,8
1272710,True,0,No user reviews,0,0,0
1272720,True,0,No user reviews,0,0,0
1272730,True,0,No user reviews,0,0,0
1272750,True,0,No user reviews,0,0,0
1272770,True,0,No user reviews,0,0,0
1272790,True,0,1 user reviews,1,0,1
1272810,True,0,No user reviews,0,0,0
1272820,True,0,1 user reviews,0,1,1
1272830,True,0,No user reviews,0,0,0
1272840,True,0,No user reviews,0,0,0
1272850,True,0,1 user reviews,1,0,1
1272860,True,0,4 user reviews,4,0,4
1272880,True,0,No user reviews,0,0,0
1272900,True,0,No user reviews,0,0,0
1272910,True,0,No user reviews,0,0,0
1272920,True,0,2 user reviews,2,0,2
1272960,True,0,No user reviews,0,0,0
1272970,True,0,6 user reviews,5,1,6
1273000,True,0,No user reviews,0,0,0
1273010,True,0,No user reviews,0,0,0
1273020,True,0,3 user reviews,1,2,3
1273030,True,0,No user reviews,0,0,0
1273040,True,0,No user reviews,0,0,0
1273050,True,0,No user reviews,0,0,0
1273051,True,0,No user reviews,0,0,0
1273052,True,0,No user reviews,0,0,0
1273053,True,0,No user reviews,0,0,0
1273054,True,0,No user reviews,0,0,0
1273055,True,0,No user reviews,0,0,0
1273056,True,0,No user reviews,0,0,0
1273060,True,0,No user reviews,0,0,0
1273070,True,0,1 user reviews,1,0,1
1273080,True,0,No user reviews,0,0,0
1273090,True,0,No user reviews,0,0,0
1273100,True,0,No user reviews,0,0,0
1273120,True,0,No user reviews,0,0,0
1273130,True,0,No user reviews,0,0,0
1273140,True,0,No user reviews,0,0,0
1273150,True,0,1 user reviews,1,0,1
1273160,True,0,No user reviews,0,0,0
1273170,True,0,No user reviews,0,0,0
1273180,True,0,3 user reviews,1,2,3
1273190,True,0,No user reviews,0,0,0
1273200,True,0,No user reviews,0,0,0
1273220,True,0,No user reviews,0,0,0
1273250,True,7,Positive,27,0,27
1273270,True,0,No user reviews,0,0,0
1273290,True,0,No user reviews,0,0,0
1273300,True,0,No user reviews,0,0,0
1273320,True,0,6 user reviews,6,0,6
1273380,True,0,1 user reviews,0,1,1
1273390,True,6,Mostly Positive,9,3,12
1273430,True,0,1 user reviews,1,0,1
1273450,True,6,Mostly Positive,16,6,22
1273460,True,0,No user reviews,0,0,0
1273470,True,0,No user reviews,0,0,0
1273490,True,0,No user reviews,0,0,0
1273510,True,0,No user reviews,0,0,0
1273520,True,5,Mixed,8,4,12
1273530,True,0,No user reviews,0,0,0
1273540,True,0,No user reviews,0,0,0
1273550,True,0,No user reviews,0,0,0
1273570,True,0,No user reviews,0,0,0
1273580,True,0,No user reviews,0,0,0
1273590,True,0,7 user reviews,7,0,7
1273600,True,0,No user reviews,0,0,0
1273620,True,0,8 user reviews,5,3,8
1273630,True,0,3 user reviews,3,0,3
1273640,True,0,No user reviews,0,0,0
1273690,True,0,No user reviews,0,0,0
1273710,True,0,No user reviews,0,0,0
1273720,True,0,No user reviews,0,0,0
1273740,True,0,1 user reviews,1,0,1
1273750,True,0,No user reviews,0,0,0
1273780,True,7,Positive,9,1,10
1273790,True,6,Mostly Positive,22,9,31
1273800,True,0,8 user reviews,7,1,8
1273820,True,0,No user reviews,0,0,0
1273830,True,0,No user reviews,0,0,0
1273850,True,0,No user reviews,0,0,0
1273860,True,0,No user reviews,0,0,0
1273870,True,0,3 user reviews,1,2,3
1273880,True,0,No user reviews,0,0,0
1273890,True,0,1 user reviews,1,0,1
1273910,True,0,No user reviews,0,0,0
1273920,True,0,1 user reviews,1,0,1
1273930,True,0,2 user reviews,1,1,2
1273940,True,0,1 user reviews,0,1,1
1273960,True,0,No user reviews,0,0,0
1273961,True,0,No user reviews,0,0,0
1273962,True,0,No user reviews,0,0,0
1273963,True,0,No user reviews,0,0,0
1273970,True,0,4 user reviews,2,2,4
1273971,True,6,Mostly Positive,86,35,121
1274020,True,0,No user reviews,0,0,0
1274050,True,0,No user reviews,0,0,0
1274060,True,0,No user reviews,0,0,0
1274080,True,0,No user reviews,0,0,0
1274090,True,0,No user reviews,0,0,0
1274110,True,0,No user reviews,0,0,0
1274120,True,0,No user reviews,0,0,0
1274130,True,0,No user reviews,0,0,0
1274140,True,0,No user reviews,0,0,0
1274150,True,0,1 user reviews,1,0,1
1274180,True,0,No user reviews,0,0,0
1274190,True,0,1 user reviews,1,0,1
1274200,True,0,No user reviews,0,0,0
1274210,True,0,No user reviews,0,0,0
1274220,True,0,No user reviews,0,0,0
1274250,True,0,1 user reviews,0,1,1
1274280,True,0,No user reviews,0,0,0
1274290,True,0,No user reviews,0,0,0
1274300,True,5,Mixed,19,9,28
1274310,True,0,No user reviews,0,0,0
1274330,True,0,No user reviews,0,0,0
1274340,True,0,1 user reviews,1,0,1
1274360,True,0,No user reviews,0,0,0
1274380,True,0,No user reviews,0,0,0
1274390,True,0,No user reviews,0,0,0
1274400,True,0,1 user reviews,0,1,1
1274410,True,0,No user reviews,0,0,0
1274430,True,0,1 user reviews,1,0,1
1274440,True,0,3 user reviews,3,0,3
1274450,True,0,No user reviews,0,0,0
1274460,True,0,No user reviews,0,0,0
1274470,True,0,No user reviews,0,0,0
1274490,True,6,Mostly Positive,120,31,151
1274500,True,0,No user reviews,0,0,0
1274530,True,0,No user reviews,0,0,0
1274540,True,0,No user reviews,0,0,0
1274550,True,0,No user reviews,0,0,0
1274560,True,0,No user reviews,0,0,0
1274570,True,0,No user reviews,0,0,0
1274590,True,0,No user reviews,0,0,0
1274600,True,0,No user reviews,0,0,0
1274610,True,0,5 user reviews,3,2,5
1274630,True,0,7 user reviews,7,0,7
1274640,True,0,2 user reviews,2,0,2
1274660,True,0,1 user reviews,1,0,1
1274670,True,0,No user reviews,0,0,0
1274680,True,0,No user reviews,0,0,0
1274690,True,0,No user reviews,0,0,0
1274720,True,0,No user reviews,0,0,0
1274730,True,0,No user reviews,0,0,0
1274740,True,0,No user reviews,0,0,0
1274790,True,0,No user reviews,0,0,0
1274800,True,0,No user reviews,0,0,0
1274810,True,0,No user reviews,0,0,0
1274820,True,7,Positive,11,0,11
1274840,True,5,Mixed,6,4,10
1274850,True,0,No user reviews,0,0,0
1274910,True,0,2 user reviews,1,1,2
1274930,True,0,No user reviews,0,0,0
1274940,True,7,Positive,33,4,37
1274950,True,0,No user reviews,0,0,0
1274960,True,0,3 user reviews,0,3,3
1274970,True,0,3 user reviews,3,0,3
1274980,True,0,7 user reviews,6,1,7
1275020,True,0,3 user reviews,3,0,3
1275030,True,0,No user reviews,0,0,0
1275040,True,0,No user reviews,0,0,0
1275050,True,0,No user reviews,0,0,0
1275060,True,0,4 user reviews,4,0,4
1275070,True,0,No user reviews,0,0,0
1275100,True,0,No user reviews,0,0,0
1275140,True,0,No user reviews,0,0,0
1275180,True,0,No user reviews,0,0,0
1275190,True,0,6 user reviews,6,0,6
1275200,True,0,No user reviews,0,0,0
1275210,True,0,No user reviews,0,0,0
1275230,True,0,1 user reviews,0,1,1
1275240,True,0,No user reviews,0,0,0
1275250,True,0,6 user reviews,5,1,6
1275260,True,0,No user reviews,0,0,0
1275290,True,5,Mixed,9,4,13
1275300,True,0,No user reviews,0,0,0
1275320,True,0,1 user reviews,1,0,1
1275330,True,0,2 user reviews,2,0,2
1275350,True,0,No user reviews,0,0,0
1275360,True,0,1 user reviews,0,1,1
1275380,True,0,No user reviews,0,0,0
1275390,True,6,Mostly Positive,7,3,10
1275410,True,0,No user reviews,0,0,0
1275430,True,0,No user reviews,0,0,0
1275440,True,0,No user reviews,0,0,0
1275450,True,0,5 user reviews,1,4,5
1275460,True,0,No user reviews,0,0,0
1275470,True,0,No user reviews,0,0,0
1275490,True,0,No user reviews,0,0,0
1275500,True,0,1 user reviews,0,1,1
1275520,True,0,1 user reviews,1,0,1
1275530,True,0,No user reviews,0,0,0
1275540,True,0,No user reviews,0,0,0
1275570,True,0,3 user reviews,0,3,3
1275580,True,0,1 user reviews,0,1,1
1275590,True,0,No user reviews,0,0,0
1275600,True,0,No user reviews,0,0,0
1275630,True,0,No user reviews,0,0,0
1275640,True,0,No user reviews,0,0,0
1275660,True,0,No user reviews,0,0,0
1275670,True,0,No user reviews,0,0,0
1275730,True,0,4 user reviews,4,0,4
1275760,True,0,No user reviews,0,0,0
1275770,True,7,Positive,16,2,18
1275780,True,0,No user reviews,0,0,0
1275790,True,0,No user reviews,0,0,0
1275800,True,0,No user reviews,0,0,0
1275850,True,0,No user reviews,0,0,0
1275860,True,0,5 user reviews,4,1,5
1275880,True,0,1 user reviews,0,1,1
1275890,True,8,Very Positive,406,14,420
1275900,True,0,No user reviews,0,0,0
1275950,True,0,No user reviews,0,0,0
1275960,True,0,No user reviews,0,0,0
1275970,True,0,5 user reviews,3,2,5
1275980,True,0,5 user reviews,4,1,5
1276010,True,0,No user reviews,0,0,0
1276030,True,0,No user reviews,0,0,0
1276040,True,7,Positive,22,4,26
1276050,True,0,No user reviews,0,0,0
1276060,True,0,No user reviews,0,0,0
1276080,True,0,No user reviews,0,0,0
1276090,True,0,1 user reviews,0,1,1
1276100,True,0,No user reviews,0,0,0
1276110,True,0,No user reviews,0,0,0
1276140,True,0,2 user reviews,1,1,2
1276160,True,0,1 user reviews,1,0,1
1276170,True,0,1 user reviews,1,0,1
1276180,True,0,3 user reviews,3,0,3
1276200,True,0,No user reviews,0,0,0
1276210,True,0,No user reviews,0,0,0
1276220,True,0,No user reviews,0,0,0
1276230,True,0,No user reviews,0,0,0
1276240,True,0,No user reviews,0,0,0
1276250,True,0,No user reviews,0,0,0
1276260,True,0,No user reviews,0,0,0
1276280,True,0,No user reviews,0,0,0
1276290,True,0,No user reviews,0,0,0
1276300,True,0,No user reviews,0,0,0
1276320,True,0,1 user reviews,1,0,1
1276330,True,0,No user reviews,0,0,0
1276340,True,0,1 user reviews,1,0,1
1276350,True,0,2 user reviews,1,1,2
1276360,True,0,No user reviews,0,0,0
1276370,True,0,No user reviews,0,0,0
1276380,True,0,No user reviews,0,0,0
1276400,True,0,No user reviews,0,0,0
1276410,True,0,No user reviews,0,0,0
1276420,True,0,No user reviews,0,0,0
1276430,True,0,5 user reviews,5,0,5
1276440,True,0,No user reviews,0,0,0
1276450,True,0,6 user reviews,5,1,6
1276470,True,8,Very Positive,79,18,97
1276490,True,0,9 user reviews,5,4,9
1276500,True,0,No user reviews,0,0,0
1276501,True,0,No user reviews,0,0,0
1276502,True,0,No user reviews,0,0,0
1276503,True,0,No user reviews,0,0,0
1276510,True,0,No user reviews,0,0,0
1276520,True,0,No user reviews,0,0,0
1276521,True,0,No user reviews,0,0,0
1276522,True,0,No user reviews,0,0,0
1276523,True,0,No user reviews,0,0,0
1276524,True,0,No user reviews,0,0,0
1276525,True,0,No user reviews,0,0,0
1276530,True,0,2 user reviews,2,0,2
1276540,True,0,6 user reviews,4,2,6
1276550,True,0,No user reviews,0,0,0
1276560,True,0,No user reviews,0,0,0
1276580,True,0,No user reviews,0,0,0
1276590,True,0,1 user reviews,0,1,1
1276600,True,0,No user reviews,0,0,0
1276610,True,6,Mostly Positive,54,22,76
1276630,True,0,No user reviews,0,0,0
1276650,True,0,No user reviews,0,0,0
1276660,True,0,No user reviews,0,0,0
1276690,True,0,No user reviews,0,0,0
1276710,True,0,No user reviews,0,0,0
1276720,True,0,6 user reviews,3,3,6
1276730,True,0,No user reviews,0,0,0
1276740,True,0,No user reviews,0,0,0
1276750,True,0,No user reviews,0,0,0
1276770,True,0,No user reviews,0,0,0
1276780,True,0,1 user reviews,1,0,1
1276781,True,0,1 user reviews,1,0,1
1276810,True,0,No user reviews,0,0,0
1276820,True,0,No user reviews,0,0,0
1276850,True,0,No user reviews,0,0,0
1276860,True,0,No user reviews,0,0,0
1276890,True,0,No user reviews,0,0,0
1277090,True,0,2 user reviews,2,0,2
1277100,True,0,No user reviews,0,0,0
1277130,True,0,No user reviews,0,0,0
1277140,True,0,No user reviews,0,0,0
1277160,True,0,No user reviews,0,0,0
1277190,True,0,3 user reviews,3,0,3
1277200,True,0,No user reviews,0,0,0
1277210,True,0,8 user reviews,4,4,8
1277220,True,0,No user reviews,0,0,0
1277260,True,0,No user reviews,0,0,0
1277270,True,0,No user reviews,0,0,0
1277280,True,0,No user reviews,0,0,0
1277290,True,0,No user reviews,0,0,0
1277300,True,0,No user reviews,0,0,0
1277310,True,0,No user reviews,0,0,0
1277320,True,0,1 user reviews,1,0,1
1277340,True,0,No user reviews,0,0,0
1277360,True,0,No user reviews,0,0,0
1277370,True,0,No user reviews,0,0,0
1277380,True,0,No user reviews,0,0,0
1277390,True,0,3 user reviews,1,2,3
1277440,True,0,No user reviews,0,0,0
1277500,True,0,No user reviews,0,0,0
1277510,True,0,No user reviews,0,0,0
1277520,True,0,No user reviews,0,0,0
1277540,True,0,No user reviews,0,0,0
1277550,True,0,No user reviews,0,0,0
1277570,True,7,Positive,17,0,17
1277600,True,0,3 user reviews,3,0,3
1277610,True,0,No user reviews,0,0,0
1277630,True,0,No user reviews,0,0,0
1277640,True,0,No user reviews,0,0,0
1277650,True,0,1 user reviews,1,0,1
1277680,True,0,No user reviews,0,0,0
1277690,True,0,1 user reviews,1,0,1
1277700,True,0,No user reviews,0,0,0
1277710,True,0,4 user reviews,4,0,4
1277780,True,0,No user reviews,0,0,0
1277830,True,0,8 user reviews,7,1,8
1277840,True,0,3 user reviews,3,0,3
1277860,True,0,No user reviews,0,0,0
1277870,True,0,No user reviews,0,0,0
1277880,True,0,No user reviews,0,0,0
1277900,True,0,1 user reviews,1,0,1
1277920,True,0,No user reviews,0,0,0
1277930,True,0,No user reviews,0,0,0
1277950,True,0,5 user reviews,3,2,5
1277960,True,0,No user reviews,0,0,0
1277970,True,0,No user reviews,0,0,0
1277990,True,0,No user reviews,0,0,0
1278000,True,0,1 user reviews,1,0,1
1278040,True,0,2 user reviews,2,0,2
1278060,True,0,No user reviews,0,0,0
1278080,True,0,No user reviews,0,0,0
1278090,True,0,3 user reviews,2,1,3
1278100,True,0,No user reviews,0,0,0
1278110,True,0,1 user reviews,1,0,1
1278120,True,0,No user reviews,0,0,0
1278130,True,0,No user reviews,0,0,0
1278131,True,0,No user reviews,0,0,0
1278133,True,0,1 user reviews,1,0,1
1278134,True,0,No user reviews,0,0,0
1278140,True,0,No user reviews,0,0,0
1278190,True,0,No user reviews,0,0,0
1278200,True,0,8 user reviews,6,2,8
1278210,True,0,6 user reviews,6,0,6
1278230,True,0,3 user reviews,1,2,3
1278240,True,0,3 user reviews,3,0,3
1278250,True,0,1 user reviews,1,0,1
1278270,True,0,6 user reviews,5,1,6
1278280,True,0,No user reviews,0,0,0
1278290,True,0,6 user reviews,6,0,6
1278300,True,0,2 user reviews,2,0,2
1278310,True,0,No user reviews,0,0,0
1278311,True,0,No user reviews,0,0,0
1278312,True,0,No user reviews,0,0,0
1278313,True,0,No user reviews,0,0,0
1278314,True,0,No user reviews,0,0,0
1278315,True,0,No user reviews,0,0,0
1278340,True,0,No user reviews,0,0,0
1278350,True,0,4 user reviews,4,0,4
1278360,True,0,No user reviews,0,0,0
1278370,True,7,Positive,20,4,24
1278380,True,0,No user reviews,0,0,0
1278390,True,0,No user reviews,0,0,0
1278430,True,0,2 user reviews,2,0,2
1278460,True,0,No user reviews,0,0,0
1278471,True,0,No user reviews,0,0,0
1278472,True,0,1 user reviews,1,0,1
1278473,True,0,No user reviews,0,0,0
1278474,True,0,No user reviews,0,0,0
1278475,True,0,No user reviews,0,0,0
1278476,True,0,No user reviews,0,0,0
1278480,True,0,4 user reviews,1,3,4
1278500,True,7,Positive,10,2,12
1278510,True,0,No user reviews,0,0,0
1278520,True,0,No user reviews,0,0,0
1278560,True,0,No user reviews,0,0,0
1278570,True,0,No user reviews,0,0,0
1278580,True,0,No user reviews,0,0,0
1278590,True,0,3 user reviews,3,0,3
1278610,True,0,4 user reviews,4,0,4
1278630,True,0,No user reviews,0,0,0
1278640,True,0,No user reviews,0,0,0
1278650,True,5,Mixed,7,4,11
1278660,True,0,No user reviews,0,0,0
1278670,True,0,No user reviews,0,0,0
1278680,True,0,No user reviews,0,0,0
1278690,True,0,1 user reviews,0,1,1
1278700,True,0,No user reviews,0,0,0
1278710,True,0,2 user reviews,2,0,2
1278720,True,0,No user reviews,0,0,0
1278740,True,0,No user reviews,0,0,0
1278750,True,0,No user reviews,0,0,0
1278760,True,0,No user reviews,0,0,0
1278770,True,6,Mostly Positive,19,5,24
1278780,True,0,No user reviews,0,0,0
1278850,True,0,No user reviews,0,0,0
1278860,True,0,2 user reviews,1,1,2
1278870,True,0,No user reviews,0,0,0
1278880,True,0,No user reviews,0,0,0
1278930,True,0,3 user reviews,1,2,3
1278960,True,0,7 user reviews,7,0,7
1278980,True,0,No user reviews,0,0,0
1278990,True,0,No user reviews,0,0,0
1279000,True,0,No user reviews,0,0,0
1279020,True,0,4 user reviews,4,0,4
1279210,True,0,1 user reviews,1,0,1
1279211,True,0,1 user reviews,1,0,1
1279240,True,0,No user reviews,0,0,0
1279260,True,0,No user reviews,0,0,0
1279270,True,0,No user reviews,0,0,0
1279280,True,0,No user reviews,0,0,0
1279320,True,0,No user reviews,0,0,0
1279330,True,0,No user reviews,0,0,0
1279370,True,0,4 user reviews,4,0,4
1279380,True,0,7 user reviews,7,0,7
1279390,True,0,5 user reviews,3,2,5
1279400,True,0,5 user reviews,3,2,5
1279410,True,0,7 user reviews,7,0,7
1279420,True,0,6 user reviews,6,0,6
1279430,True,0,No user reviews,0,0,0
1279440,True,0,No user reviews,0,0,0
1279450,True,0,3 user reviews,3,0,3
1279460,True,0,No user reviews,0,0,0
1279480,True,0,2 user reviews,2,0,2
1279500,True,0,No user reviews,0,0,0
1279530,True,0,No user reviews,0,0,0
1279540,True,0,No user reviews,0,0,0
1279550,True,0,No user reviews,0,0,0
1279590,True,0,8 user reviews,5,3,8
1279600,True,0,No user reviews,0,0,0
1279610,True,0,No user reviews,0,0,0
1279620,True,0,3 user reviews,3,0,3
1279630,True,6,Mostly Positive,143,40,183
1279670,True,0,No user reviews,0,0,0
1279680,True,0,No user reviews,0,0,0
1279700,True,7,Positive,14,2,16
1279730,True,0,No user reviews,0,0,0
1279740,True,0,1 user reviews,1,0,1
1279770,True,0,2 user reviews,2,0,2
1279780,True,0,No user reviews,0,0,0
1279800,True,0,No user reviews,0,0,0
1279810,True,0,7 user reviews,7,0,7
1279840,True,0,No user reviews,0,0,0
1279850,True,0,No user reviews,0,0,0
1279870,True,0,No user reviews,0,0,0
1279900,True,0,No user reviews,0,0,0
1279960,True,0,No user reviews,0,0,0
1279970,True,0,3 user reviews,3,0,3
1280010,True,5,Mixed,7,4,11
1280020,True,0,No user reviews,0,0,0
1280050,True,0,No user reviews,0,0,0
1280070,True,0,No user reviews,0,0,0
1280080,True,0,No user reviews,0,0,0
1280090,True,0,1 user reviews,0,1,1
1280100,True,0,No user reviews,0,0,0
1280110,True,0,2 user reviews,1,1,2
1280120,True,0,No user reviews,0,0,0
1280121,True,0,1 user reviews,1,0,1
1280123,True,0,No user reviews,0,0,0
1280124,True,0,1 user reviews,1,0,1
1280125,True,0,No user reviews,0,0,0
1280126,True,0,No user reviews,0,0,0
1280127,True,0,No user reviews,0,0,0
1280128,True,0,No user reviews,0,0,0
1280129,True,0,No user reviews,0,0,0
1280140,True,0,No user reviews,0,0,0
1280160,True,0,No user reviews,0,0,0
1280170,True,0,No user reviews,0,0,0
1280180,True,0,No user reviews,0,0,0
1280190,True,0,No user reviews,0,0,0
1280210,True,0,No user reviews,0,0,0
1280220,True,0,No user reviews,0,0,0
1280260,True,7,Positive,22,5,27
1280270,True,0,No user reviews,0,0,0
1280290,True,0,No user reviews,0,0,0
1280300,True,0,No user reviews,0,0,0
1280310,True,0,1 user reviews,1,0,1
1280330,True,0,1 user reviews,0,1,1
1280340,True,0,3 user reviews,1,2,3
1280350,True,0,1 user reviews,0,1,1
1280360,True,0,3 user reviews,0,3,3
1280370,True,6,Mostly Positive,58,24,82
1280380,True,0,No user reviews,0,0,0
1280390,True,0,No user reviews,0,0,0
1280400,True,0,No user reviews,0,0,0
1280420,True,0,6 user reviews,6,0,6
1280440,True,0,No user reviews,0,0,0
1280450,True,0,No user reviews,0,0,0
1280490,True,0,1 user reviews,1,0,1
1280500,True,0,8 user reviews,5,3,8
1280510,True,0,2 user reviews,1,1,2
1280520,True,0,No user reviews,0,0,0
1280550,True,0,4 user reviews,1,3,4
1280570,True,0,No user reviews,0,0,0
1280580,True,0,No user reviews,0,0,0
1280610,True,0,No user reviews,0,0,0
1280630,True,0,5 user reviews,5,0,5
1280640,True,0,7 user reviews,7,0,7
1280660,True,0,No user reviews,0,0,0
1280670,True,0,1 user reviews,1,0,1
1280680,True,0,No user reviews,0,0,0
1280690,True,0,No user reviews,0,0,0
1280700,True,0,No user reviews,0,0,0
1280730,True,0,No user reviews,0,0,0
1280740,True,0,No user reviews,0,0,0
1280750,True,0,No user reviews,0,0,0
1280760,True,0,No user reviews,0,0,0
1280780,True,0,No user reviews,0,0,0
1280800,True,0,No user reviews,0,0,0
1280830,True,0,No user reviews,0,0,0
1280840,True,0,No user reviews,0,0,0
1280850,True,0,No user reviews,0,0,0
1280890,True,0,No user reviews,0,0,0
1280900,True,0,No user reviews,0,0,0
1280910,True,0,2 user reviews,0,2,2
1280930,True,0,No user reviews,0,0,0
1280940,True,0,6 user reviews,5,1,6
1280950,True,0,No user reviews,0,0,0
1280970,True,0,7 user reviews,7,0,7
1280980,True,0,1 user reviews,1,0,1
1280990,True,0,No user reviews,0,0,0
1281000,True,0,No user reviews,0,0,0
1281010,True,0,8 user reviews,8,0,8
1281060,True,0,No user reviews,0,0,0
1281070,True,0,No user reviews,0,0,0
1281080,True,0,No user reviews,0,0,0
1281090,True,0,No user reviews,0,0,0
1281100,True,0,1 user reviews,0,1,1
1281120,True,0,No user reviews,0,0,0
1281130,True,0,No user reviews,0,0,0
1281140,True,0,3 user reviews,3,0,3
1281160,True,0,No user reviews,0,0,0
1281170,True,7,Positive,34,2,36
1281180,True,0,No user reviews,0,0,0
1281190,True,0,No user reviews,0,0,0
1281200,True,8,Very Positive,104,9,113
1281210,True,0,No user reviews,0,0,0
1281220,True,0,No user reviews,0,0,0
1281250,True,0,No user reviews,0,0,0
1281270,True,7,Positive,47,2,49
1281280,True,0,3 user reviews,2,1,3
1281290,True,0,No user reviews,0,0,0
1281310,True,0,9 user reviews,4,5,9
1281320,True,0,No user reviews,0,0,0
1281330,True,0,5 user reviews,5,0,5
1281350,True,0,5 user reviews,5,0,5
1281360,True,0,1 user reviews,1,0,1
1281370,True,0,1 user reviews,1,0,1
1281380,True,0,No user reviews,0,0,0
1281390,True,7,Positive,16,0,16
1281400,True,0,No user reviews,0,0,0
1281410,True,0,2 user reviews,2,0,2
1281420,True,0,No user reviews,0,0,0
1281440,True,0,No user reviews,0,0,0
1281460,True,0,No user reviews,0,0,0
1281470,True,0,No user reviews,0,0,0
1281490,True,0,No user reviews,0,0,0
1281500,True,0,1 user reviews,1,0,1
1281510,True,0,1 user reviews,1,0,1
1281530,True,7,Positive,13,0,13
1281550,True,0,No user reviews,0,0,0
1281570,True,0,No user reviews,0,0,0
1281571,True,0,1 user reviews,1,0,1
1281580,True,0,5 user reviews,5,0,5
1281600,True,0,7 user reviews,4,3,7
1281610,True,0,1 user reviews,1,0,1
1281620,True,0,3 user reviews,2,1,3
1281630,True,6,Mostly Positive,58,23,81
1281640,True,0,No user reviews,0,0,0
1281700,True,0,3 user reviews,2,1,3
1281710,True,0,3 user reviews,0,3,3
1281790,True,7,Positive,35,1,36
1281800,True,0,No user reviews,0,0,0
1281810,True,0,3 user reviews,3,0,3
1281830,True,0,No user reviews,0,0,0
1281860,True,0,No user reviews,0,0,0
1281870,True,0,No user reviews,0,0,0
1281880,True,7,Positive,13,2,15
1281881,True,0,4 user reviews,3,1,4
1281890,True,7,Positive,8,2,10
1281920,True,0,No user reviews,0,0,0
1281930,True,0,No user reviews,0,0,0
1281960,True,0,No user reviews,0,0,0
1281980,True,0,3 user reviews,1,2,3
1281990,True,0,No user reviews,0,0,0
1282000,True,0,No user reviews,0,0,0
1282030,True,0,No user reviews,0,0,0
1282040,True,0,No user reviews,0,0,0
1282070,True,0,No user reviews,0,0,0
1282080,True,0,3 user reviews,3,0,3
1282090,True,7,Positive,13,1,14
1282110,True,0,No user reviews,0,0,0
1282120,True,0,No user reviews,0,0,0
1282140,True,0,7 user reviews,6,1,7
1282160,True,0,No user reviews,0,0,0
1282180,True,0,No user reviews,0,0,0
1282190,True,0,No user reviews,0,0,0
1282200,True,9,Overwhelmingly Positive,810,27,837
1282210,True,8,Very Positive,329,33,362
1282220,True,0,No user reviews,0,0,0
1282240,True,0,No user reviews,0,0,0
1282250,True,0,No user reviews,0,0,0
1282290,True,0,No user reviews,0,0,0
1282310,True,0,No user reviews,0,0,0
1282320,True,0,9 user reviews,9,0,9
1282350,True,7,Positive,9,2,11
1282370,True,0,1 user reviews,1,0,1
1282380,True,0,No user reviews,0,0,0
1282420,True,0,No user reviews,0,0,0
1282440,True,0,No user reviews,0,0,0
1282500,True,0,No user reviews,0,0,0
1282510,True,0,7 user reviews,7,0,7
1282540,True,0,No user reviews,0,0,0
1282550,True,7,Positive,35,1,36
1282580,True,0,No user reviews,0,0,0
1282590,True,6,Mostly Positive,340,115,455
1282600,True,0,No user reviews,0,0,0
1282610,True,0,No user reviews,0,0,0
1282620,True,0,No user reviews,0,0,0
1282630,True,0,No user reviews,0,0,0
1282640,True,0,No user reviews,0,0,0
1282650,True,7,Positive,18,1,19
1282660,True,0,No user reviews,0,0,0
1282680,True,0,No user reviews,0,0,0
1282681,True,0,No user reviews,0,0,0
1282690,True,8,Very Positive,422,85,507
1282700,True,0,No user reviews,0,0,0
1282710,True,0,1 user reviews,1,0,1
1282720,True,0,No user reviews,0,0,0
1282740,True,0,No user reviews,0,0,0
1282760,True,0,No user reviews,0,0,0
1282770,True,0,2 user reviews,0,2,2
1282781,True,0,2 user reviews,0,2,2
1282830,True,0,No user reviews,0,0,0
1282840,True,7,Positive,14,1,15
1282850,True,0,No user reviews,0,0,0
1282880,True,0,1 user reviews,1,0,1
1282890,True,0,6 user reviews,6,0,6
1282900,True,0,6 user reviews,5,1,6
1282920,True,0,No user reviews,0,0,0
1282930,True,0,8 user reviews,7,1,8
1282960,True,5,Mixed,9,11,20
1282980,True,0,No user reviews,0,0,0
1282990,True,0,No user reviews,0,0,0
1283000,True,7,Positive,16,0,16
1283050,True,0,3 user reviews,3,0,3
1283060,True,0,No user reviews,0,0,0
1283070,True,0,2 user reviews,2,0,2
1283090,True,8,Very Positive,65,6,71
1283091,True,8,Very Positive,63,3,66
1283110,True,0,2 user reviews,2,0,2
1283130,True,0,No user reviews,0,0,0
1283140,True,0,No user reviews,0,0,0
1283150,True,0,No user reviews,0,0,0
1283160,True,0,No user reviews,0,0,0
1283161,True,0,No user reviews,0,0,0
1283162,True,0,No user reviews,0,0,0
1283163,True,0,No user reviews,0,0,0
1283164,True,0,No user reviews,0,0,0
1283180,True,0,No user reviews,0,0,0
1283190,True,8,Very Positive,81,19,100
1283200,True,0,No user reviews,0,0,0
1283210,True,0,No user reviews,0,0,0
1283220,True,0,No user reviews,0,0,0
1283230,True,0,No user reviews,0,0,0
1283240,True,0,No user reviews,0,0,0
1283250,True,0,No user reviews,0,0,0
1283260,True,0,No user reviews,0,0,0
1283270,True,0,No user reviews,0,0,0
1283280,True,0,3 user reviews,3,0,3
1283320,True,0,5 user reviews,4,1,5
1283330,True,0,No user reviews,0,0,0
1283340,True,0,No user reviews,0,0,0
1283350,True,0,No user reviews,0,0,0
1283370,True,0,No user reviews,0,0,0
1283380,True,0,No user reviews,0,0,0
1283400,True,0,No user reviews,0,0,0
1283430,True,0,No user reviews,0,0,0
1283440,True,0,2 user reviews,2,0,2
1283450,True,0,No user reviews,0,0,0
1283500,True,7,Positive,18,0,18
1283520,True,0,3 user reviews,2,1,3
1283530,True,0,2 user reviews,2,0,2
1283570,True,0,No user reviews,0,0,0
1283580,True,7,Positive,17,0,17
1283590,True,0,No user reviews,0,0,0
1283610,True,0,No user reviews,0,0,0
1283620,True,0,No user reviews,0,0,0
1283630,True,0,No user reviews,0,0,0
1283640,True,0,No user reviews,0,0,0
1283660,True,0,No user reviews,0,0,0
1283670,True,0,No user reviews,0,0,0
1283680,True,0,1 user reviews,0,1,1
1283710,True,4,Mostly Negative,6,12,18
1283711,True,0,No user reviews,0,0,0
1283720,True,0,1 user reviews,1,0,1
1283740,True,0,No user reviews,0,0,0
1283760,True,0,2 user reviews,0,2,2
1283770,True,0,No user reviews,0,0,0
1283790,True,0,1 user reviews,0,1,1
1283800,True,0,1 user reviews,1,0,1
1283810,True,0,No user reviews,0,0,0
1283820,True,0,3 user reviews,3,0,3
1283830,True,0,No user reviews,0,0,0
1283850,True,0,3 user reviews,3,0,3
1283860,True,0,No user reviews,0,0,0
1283870,True,0,No user reviews,0,0,0
1283890,True,0,5 user reviews,5,0,5
1283900,True,0,No user reviews,0,0,0
1283920,True,0,No user reviews,0,0,0
1283930,True,0,No user reviews,0,0,0
1283960,True,0,6 user reviews,6,0,6
1283970,True,8,Very Positive,67,6,73
1283990,True,0,2 user reviews,1,1,2
1284010,True,0,No user reviews,0,0,0
1284050,True,0,2 user reviews,0,2,2
1284060,True,0,No user reviews,0,0,0
1284080,True,0,7 user reviews,7,0,7
1284100,True,0,No user reviews,0,0,0
1284110,True,0,7 user reviews,7,0,7
1284130,True,0,No user reviews,0,0,0
1284140,True,0,No user reviews,0,0,0
1284150,True,0,9 user reviews,9,0,9
1284160,True,0,No user reviews,0,0,0
1284180,True,0,9 user reviews,9,0,9
1284200,True,0,1 user reviews,1,0,1
1284210,True,0,No user reviews,0,0,0
1284220,True,0,No user reviews,0,0,0
1284230,True,0,No user reviews,0,0,0
1284240,True,0,No user reviews,0,0,0
1284250,True,0,No user reviews,0,0,0
1284260,True,0,2 user reviews,2,0,2
1284270,True,0,No user reviews,0,0,0
1284280,True,7,Positive,16,4,20
1284290,True,0,1 user reviews,1,0,1
1284300,True,0,3 user reviews,1,2,3
1284310,True,0,No user reviews,0,0,0
1284350,True,0,No user reviews,0,0,0
1284380,True,0,No user reviews,0,0,0
1284390,True,0,5 user reviews,2,3,5
1284410,True,0,No user reviews,0,0,0
1284430,True,0,1 user reviews,1,0,1
1284460,True,0,No user reviews,0,0,0
1284480,True,0,2 user reviews,2,0,2
1284500,True,0,No user reviews,0,0,0
1284510,True,0,3 user reviews,3,0,3
1284540,True,0,8 user reviews,8,0,8
1284550,True,7,Positive,23,2,25
1284560,True,0,No user reviews,0,0,0
1284630,True,0,No user reviews,0,0,0
1284640,True,0,No user reviews,0,0,0
1284660,True,0,No user reviews,0,0,0
1284680,True,0,No user reviews,0,0,0
1284690,True,0,No user reviews,0,0,0
1284700,True,0,2 user reviews,1,1,2
1284710,True,0,No user reviews,0,0,0
1284712,True,0,No user reviews,0,0,0
1284720,True,0,No user reviews,0,0,0
1284740,True,0,No user reviews,0,0,0
1284760,True,0,6 user reviews,4,2,6
1284790,True,7,Positive,11,1,12
1284800,True,0,9 user reviews,8,1,9
1284810,True,0,No user reviews,0,0,0
1284820,True,8,Very Positive,123,9,132
1284850,True,0,No user reviews,0,0,0
1284860,True,0,No user reviews,0,0,0
1284870,True,0,No user reviews,0,0,0
1284880,True,0,3 user reviews,3,0,3
1284890,True,0,1 user reviews,1,0,1
1284900,True,0,8 user reviews,8,0,8
1284910,True,0,No user reviews,0,0,0
1284920,True,0,No user reviews,0,0,0
1284921,True,0,No user reviews,0,0,0
1284930,True,0,No user reviews,0,0,0
1284950,True,7,Positive,10,0,10
1284970,True,0,No user reviews,0,0,0
1284990,True,0,No user reviews,0,0,0
1284991,True,0,No user reviews,0,0,0
1284992,True,0,No user reviews,0,0,0
1285000,True,5,Mixed,11,5,16
1285010,True,0,3 user reviews,3,0,3
1285020,True,0,7 user reviews,7,0,7
1285030,True,0,No user reviews,0,0,0
1285040,True,0,No user reviews,0,0,0
1285050,True,0,No user reviews,0,0,0
1285060,True,0,No user reviews,0,0,0
1285070,True,0,1 user reviews,1,0,1
1285080,True,7,Positive,33,0,33
1285090,True,0,6 user reviews,4,2,6
1285120,True,0,No user reviews,0,0,0
1285130,True,0,No user reviews,0,0,0
1285150,True,0,No user reviews,0,0,0
1285160,True,7,Positive,49,0,49
1285170,True,0,No user reviews,0,0,0
1285180,True,0,3 user reviews,3,0,3
1285200,True,0,No user reviews,0,0,0
1285210,True,0,No user reviews,0,0,0
1285270,True,0,No user reviews,0,0,0
1285290,True,0,No user reviews,0,0,0
1285300,True,0,No user reviews,0,0,0
1285310,True,0,1 user reviews,0,1,1
1285330,True,0,No user reviews,0,0,0
1285332,True,0,No user reviews,0,0,0
1285333,True,0,No user reviews,0,0,0
1285334,True,0,No user reviews,0,0,0
1285335,True,0,No user reviews,0,0,0
1285336,True,0,No user reviews,0,0,0
1285337,True,0,No user reviews,0,0,0
1285338,True,0,No user reviews,0,0,0
1285339,True,0,No user reviews,0,0,0
1285340,True,0,No user reviews,0,0,0
1285341,True,0,No user reviews,0,0,0
1285342,True,0,No user reviews,0,0,0
1285343,True,0,No user reviews,0,0,0
1285344,True,0,No user reviews,0,0,0
1285350,True,0,No user reviews,0,0,0
1285390,True,0,4 user reviews,3,1,4
1285440,True,0,No user reviews,0,0,0
1285450,True,0,No user reviews,0,0,0
1285470,True,0,No user reviews,0,0,0
1285490,True,0,No user reviews,0,0,0
1285500,True,0,No user reviews,0,0,0
1285510,True,7,Positive,14,0,14
1285520,True,0,No user reviews,0,0,0
1285530,True,0,2 user reviews,2,0,2
1285540,True,0,No user reviews,0,0,0
1285560,True,6,Mostly Positive,8,3,11
1285570,True,0,No user reviews,0,0,0
1285580,True,0,No user reviews,0,0,0
1285590,True,0,No user reviews,0,0,0
1285591,True,0,No user reviews,0,0,0
1285592,True,0,No user reviews,0,0,0
1285593,True,0,No user reviews,0,0,0
1285600,True,0,2 user reviews,2,0,2
1285610,True,0,2 user reviews,2,0,2
1285620,True,0,No user reviews,0,0,0
1285630,True,0,7 user reviews,7,0,7
1285660,True,0,3 user reviews,3,0,3
1285670,True,9,Overwhelmingly Positive,1146,22,1168
1285680,True,0,No user reviews,0,0,0
1285690,True,0,No user reviews,0,0,0
1285700,True,0,3 user reviews,1,2,3
1285710,True,0,No user reviews,0,0,0
1285740,True,0,1 user reviews,1,0,1
1285750,True,0,No user reviews,0,0,0
1285770,True,0,8 user reviews,8,0,8
1285800,True,0,No user reviews,0,0,0
1285810,True,8,Very Positive,77,5,82
1285820,True,0,No user reviews,0,0,0
1285830,True,0,No user reviews,0,0,0
1285840,True,0,No user reviews,0,0,0
1285850,True,0,7 user reviews,4,3,7
1285870,True,7,Positive,14,0,14
1285880,True,0,No user reviews,0,0,0
1285930,True,0,No user reviews,0,0,0
1285940,True,0,No user reviews,0,0,0
1285960,True,0,No user reviews,0,0,0
1285970,True,0,No user reviews,0,0,0
1285980,True,0,No user reviews,0,0,0
1285990,True,0,No user reviews,0,0,0
1286000,True,0,No user reviews,0,0,0
1286010,True,8,Very Positive,51,0,51
1286030,True,0,No user reviews,0,0,0
1286050,True,0,No user reviews,0,0,0
1286090,True,0,No user reviews,0,0,0
1286100,True,0,No user reviews,0,0,0
1286130,True,0,No user reviews,0,0,0
1286140,True,0,No user reviews,0,0,0
1286150,True,0,1 user reviews,1,0,1
1286160,True,0,1 user reviews,0,1,1
1286170,True,0,1 user reviews,0,1,1
1286180,True,0,6 user reviews,2,4,6
1286190,True,0,No user reviews,0,0,0
1286210,True,0,9 user reviews,9,0,9
1286220,True,0,No user reviews,0,0,0
1286250,True,0,No user reviews,0,0,0
1286251,True,0,No user reviews,0,0,0
1286252,True,0,No user reviews,0,0,0
1286253,True,0,No user reviews,0,0,0
1286254,True,0,No user reviews,0,0,0
1286255,True,0,No user reviews,0,0,0
1286256,True,0,No user reviews,0,0,0
1286280,True,0,No user reviews,0,0,0
1286290,True,0,No user reviews,0,0,0
1286330,True,0,No user reviews,0,0,0
1286340,True,0,9 user reviews,9,0,9
1286350,True,8,Very Positive,1588,148,1736
1286360,True,0,No user reviews,0,0,0
1286370,True,7,Positive,16,1,17
1286400,True,0,3 user reviews,3,0,3
1286420,True,0,No user reviews,0,0,0
1286440,True,0,No user reviews,0,0,0
1286450,True,0,No user reviews,0,0,0
1286470,True,0,4 user reviews,3,1,4
1286480,True,0,No user reviews,0,0,0
1286490,True,0,1 user reviews,0,1,1
1286510,True,0,1 user reviews,1,0,1
1286530,True,0,No user reviews,0,0,0
1286540,True,0,No user reviews,0,0,0
1286560,True,0,No user reviews,0,0,0
1286570,True,0,8 user reviews,1,7,8
1286590,True,0,No user reviews,0,0,0
1286600,True,0,2 user reviews,2,0,2
1286610,True,0,No user reviews,0,0,0
1286630,True,0,No user reviews,0,0,0
1286640,True,0,No user reviews,0,0,0
1286650,True,0,No user reviews,0,0,0
1286670,True,0,No user reviews,0,0,0
1286690,True,0,No user reviews,0,0,0
1286700,True,0,No user reviews,0,0,0
1286710,True,9,Overwhelmingly Positive,546,19,565
1286720,True,0,No user reviews,0,0,0
1286730,True,0,No user reviews,0,0,0
1286740,True,0,No user reviews,0,0,0
1286750,True,0,No user reviews,0,0,0
1286760,True,0,8 user reviews,8,0,8
1286800,True,0,1 user reviews,1,0,1
1286810,True,0,No user reviews,0,0,0
1286820,True,0,No user reviews,0,0,0
1286830,True,7,Positive,46,3,49
1286860,True,0,No user reviews,0,0,0
1286870,True,0,No user reviews,0,0,0
1286880,True,0,No user reviews,0,0,0
1286903,True,0,1 user reviews,1,0,1
1286905,True,0,No user reviews,0,0,0
1286912,True,0,No user reviews,0,0,0
1286913,True,0,No user reviews,0,0,0
1286914,True,0,No user reviews,0,0,0
1286915,True,0,No user reviews,0,0,0
1286916,True,0,No user reviews,0,0,0
1286930,True,0,No user reviews,0,0,0
1286940,True,0,No user reviews,0,0,0
1286950,True,0,5 user reviews,4,1,5
1286960,True,0,1 user reviews,1,0,1
1286980,True,0,4 user reviews,4,0,4
1286990,True,0,No user reviews,0,0,0
1287000,True,6,Mostly Positive,13,4,17
1287020,True,0,3 user reviews,3,0,3
1287050,True,7,Positive,25,0,25
1287051,True,0,4 user reviews,4,0,4
1287052,True,0,4 user reviews,4,0,4
1287053,True,0,2 user reviews,2,0,2
1287054,True,0,1 user reviews,1,0,1
1287055,True,0,2 user reviews,2,0,2
1287056,True,0,8 user reviews,7,1,8
1287057,True,0,3 user reviews,2,1,3
1287058,True,0,7 user reviews,7,0,7
1287059,True,0,8 user reviews,7,1,8
1287060,True,7,Positive,13,0,13
1287061,True,0,3 user reviews,3,0,3
1287062,True,0,2 user reviews,2,0,2
1287063,True,0,1 user reviews,1,0,1
1287064,True,0,2 user reviews,2,0,2
1287065,True,0,1 user reviews,1,0,1
1287066,True,0,1 user reviews,1,0,1
1287067,True,0,2 user reviews,2,0,2
1287068,True,0,1 user reviews,1,0,1
1287069,True,0,1 user reviews,1,0,1
1287070,True,0,2 user reviews,2,0,2
1287071,True,0,2 user reviews,2,0,2
1287072,True,0,2 user reviews,2,0,2
1287073,True,0,1 user reviews,1,0,1
1287074,True,0,1 user reviews,1,0,1
1287075,True,0,3 user reviews,1,2,3
1287076,True,0,1 user reviews,1,0,1
1287081,True,0,1 user reviews,1,0,1
1287082,True,0,6 user reviews,6,0,6
1287083,True,0,5 user reviews,5,0,5
1287100,True,0,No user reviews,0,0,0
1287130,True,0,No user reviews,0,0,0
1287140,True,0,No user reviews,0,0,0
1287150,True,0,No user reviews,0,0,0
1287170,True,0,No user reviews,0,0,0
1287180,True,0,1 user reviews,1,0,1
1287210,True,0,No user reviews,0,0,0
1287230,True,0,No user reviews,0,0,0
1287240,True,0,No user reviews,0,0,0
1287250,True,0,3 user reviews,1,2,3
1287260,True,0,No user reviews,0,0,0
1287280,True,0,No user reviews,0,0,0
1287300,True,0,No user reviews,0,0,0
1287310,True,0,No user reviews,0,0,0
1287320,True,0,No user reviews,0,0,0
1287321,True,0,No user reviews,0,0,0
1287322,True,0,No user reviews,0,0,0
1287323,True,0,No user reviews,0,0,0
1287324,True,0,No user reviews,0,0,0
1287330,True,0,No user reviews,0,0,0
1287370,True,0,No user reviews,0,0,0
1287380,True,0,No user reviews,0,0,0
1287420,True,0,1 user reviews,1,0,1
1287450,True,0,2 user reviews,2,0,2
1287480,True,0,No user reviews,0,0,0
1287490,True,0,No user reviews,0,0,0
1287500,True,0,9 user reviews,9,0,9
1287510,True,0,6 user reviews,6,0,6
1287530,True,0,No user reviews,0,0,0
1287540,True,0,No user reviews,0,0,0
1287570,True,0,No user reviews,0,0,0
1287580,True,0,No user reviews,0,0,0
1287581,True,0,No user reviews,0,0,0
1287582,True,0,No user reviews,0,0,0
1287590,True,6,Mostly Positive,10,3,13
1287600,True,0,7 user reviews,4,3,7
1287601,True,0,3 user reviews,3,0,3
1287710,True,0,1 user reviews,0,1,1
1287720,True,0,No user reviews,0,0,0
1287750,True,0,9 user reviews,5,4,9
1287760,True,0,No user reviews,0,0,0
1287770,True,0,1 user reviews,1,0,1
1287780,True,0,No user reviews,0,0,0
1287790,True,0,No user reviews,0,0,0
1287800,True,0,No user reviews,0,0,0
1287810,True,0,3 user reviews,3,0,3
1287830,True,0,4 user reviews,1,3,4
1287850,True,0,No user reviews,0,0,0
1287860,True,7,Positive,14,0,14
1287880,True,0,1 user reviews,0,1,1
1287890,True,0,No user reviews,0,0,0
1287910,True,0,No user reviews,0,0,0
1287960,True,0,No user reviews,0,0,0
1287970,True,0,1 user reviews,1,0,1
1287990,True,0,No user reviews,0,0,0
1288000,True,5,Mixed,26,13,39
1288010,True,0,No user reviews,0,0,0
1288030,True,0,No user reviews,0,0,0
1288040,True,0,No user reviews,0,0,0
1288050,True,0,1 user reviews,1,0,1
1288070,True,0,8 user reviews,8,0,8
1288080,True,0,No user reviews,0,0,0
1288090,True,0,2 user reviews,2,0,2
1288130,True,0,5 user reviews,5,0,5
1288150,True,0,No user reviews,0,0,0
1288170,True,0,No user reviews,0,0,0
1288240,True,0,4 user reviews,1,3,4
1288260,True,0,No user reviews,0,0,0
1288300,True,0,No user reviews,0,0,0
1288310,True,0,No user reviews,0,0,0
1288330,True,0,No user reviews,0,0,0
1288340,True,0,9 user reviews,3,6,9
1288370,True,0,1 user reviews,0,1,1
1288380,True,0,1 user reviews,0,1,1
1288400,True,0,No user reviews,0,0,0
1288420,True,0,No user reviews,0,0,0
1288430,True,0,No user reviews,0,0,0
1288440,True,0,No user reviews,0,0,0
1288460,True,0,No user reviews,0,0,0
1288490,True,0,No user reviews,0,0,0
1288510,True,0,No user reviews,0,0,0
1288520,True,0,No user reviews,0,0,0
1288540,True,0,No user reviews,0,0,0
1288550,True,0,1 user reviews,1,0,1
1288600,True,0,No user reviews,0,0,0
1288610,True,0,No user reviews,0,0,0
1288630,True,0,1 user reviews,1,0,1
1288650,True,0,No user reviews,0,0,0
1288670,True,0,3 user reviews,2,1,3
1288681,True,0,No user reviews,0,0,0
1288682,True,0,No user reviews,0,0,0
1288683,True,0,No user reviews,0,0,0
1288684,True,0,No user reviews,0,0,0
1288685,True,0,No user reviews,0,0,0
1288720,True,0,No user reviews,0,0,0
1288760,True,0,No user reviews,0,0,0
1288780,True,0,No user reviews,0,0,0
1288810,True,0,No user reviews,0,0,0
1288830,True,0,No user reviews,0,0,0
1288850,True,0,No user reviews,0,0,0
1288880,True,0,No user reviews,0,0,0
1288910,True,0,No user reviews,0,0,0
1288930,True,0,No user reviews,0,0,0
1288940,True,0,No user reviews,0,0,0
1288950,True,0,No user reviews,0,0,0
1288960,True,0,No user reviews,0,0,0
1289010,True,0,No user reviews,0,0,0
1289050,True,0,No user reviews,0,0,0
1289060,True,0,1 user reviews,1,0,1
1289100,True,0,No user reviews,0,0,0
1289110,True,0,No user reviews,0,0,0
1289120,True,0,No user reviews,0,0,0
1289170,True,0,No user reviews,0,0,0
1289180,True,0,No user reviews,0,0,0
1289190,True,0,No user reviews,0,0,0
1289191,True,0,No user reviews,0,0,0
1289234,True,0,No user reviews,0,0,0
1289240,True,0,1 user reviews,1,0,1
1289250,True,0,No user reviews,0,0,0
1289260,True,0,No user reviews,0,0,0
1289280,True,0,No user reviews,0,0,0
1289300,True,0,No user reviews,0,0,0
1289310,True,8,Very Positive,96,1,97
1289330,True,0,7 user reviews,6,1,7
1289340,True,0,No user reviews,0,0,0
1289360,True,0,No user reviews,0,0,0
1289390,True,7,Positive,10,0,10
1289400,True,0,No user reviews,0,0,0
1289440,True,0,7 user reviews,5,2,7
1289460,True,0,No user reviews,0,0,0
1289480,True,0,No user reviews,0,0,0
1289490,True,7,Positive,12,3,15
1289500,True,0,No user reviews,0,0,0
1289510,True,0,No user reviews,0,0,0
1289550,True,0,No user reviews,0,0,0
1289610,True,0,No user reviews,0,0,0
1289630,True,0,No user reviews,0,0,0
1289640,True,8,Very Positive,415,14,429
1289660,True,0,No user reviews,0,0,0
1289670,True,0,3 user reviews,2,1,3
1289690,True,0,1 user reviews,1,0,1
1289700,True,0,No user reviews,0,0,0
1289710,True,0,No user reviews,0,0,0
1289720,True,0,No user reviews,0,0,0
1289740,True,0,No user reviews,0,0,0
1289750,True,0,3 user reviews,3,0,3
1289760,True,0,2 user reviews,2,0,2
1289770,True,0,No user reviews,0,0,0
1289780,True,0,4 user reviews,2,2,4
1289810,True,0,No user reviews,0,0,0
1289850,True,0,1 user reviews,1,0,1
1289890,True,0,No user reviews,0,0,0
1289900,True,0,1 user reviews,0,1,1
1289910,True,0,2 user reviews,2,0,2
1289920,True,0,No user reviews,0,0,0
1289950,True,0,5 user reviews,5,0,5
1289960,True,0,4 user reviews,4,0,4
1289980,True,0,No user reviews,0,0,0
1290000,True,0,No user reviews,0,0,0
1290010,True,0,1 user reviews,1,0,1
1290020,True,0,No user reviews,0,0,0
1290030,True,0,No user reviews,0,0,0
1290040,True,0,1 user reviews,1,0,1
1290060,True,0,No user reviews,0,0,0
1290070,True,6,Mostly Positive,15,5,20
1290090,True,0,No user reviews,0,0,0
1290110,True,0,5 user reviews,3,2,5
1290160,True,0,5 user reviews,3,2,5
1290170,True,8,Very Positive,77,13,90
1290190,True,0,No user reviews,0,0,0
1290200,True,0,7 user reviews,7,0,7
1290210,True,0,No user reviews,0,0,0
1290220,True,8,Very Positive,58,0,58
1290230,True,0,No user reviews,0,0,0
1290240,True,0,No user reviews,0,0,0
1290250,True,7,Positive,15,1,16
1290260,True,0,No user reviews,0,0,0
1290270,True,8,Very Positive,102,15,117
1290280,True,0,No user reviews,0,0,0
1290290,True,7,Positive,8,2,10
1290300,True,0,No user reviews,0,0,0
1290350,True,0,No user reviews,0,0,0
1290380,True,0,No user reviews,0,0,0
1290390,True,0,1 user reviews,1,0,1
1290400,True,0,No user reviews,0,0,0
1290401,True,0,No user reviews,0,0,0
1290402,True,0,No user reviews,0,0,0
1290410,True,0,No user reviews,0,0,0
1290420,True,0,No user reviews,0,0,0
1290422,True,0,No user reviews,0,0,0
1290423,True,0,No user reviews,0,0,0
1290424,True,0,No user reviews,0,0,0
1290460,True,0,7 user reviews,5,2,7
1290470,True,0,No user reviews,0,0,0
1290480,True,0,1 user reviews,1,0,1
1290500,True,0,No user reviews,0,0,0
1290510,True,0,No user reviews,0,0,0
1290520,True,0,No user reviews,0,0,0
1290521,True,0,No user reviews,0,0,0
1290530,True,0,No user reviews,0,0,0
1290531,True,0,No user reviews,0,0,0
1290532,True,0,No user reviews,0,0,0
1290550,True,0,No user reviews,0,0,0
1290580,True,0,No user reviews,0,0,0
1290590,True,0,No user reviews,0,0,0
1290620,True,0,1 user reviews,1,0,1
1290630,True,0,No user reviews,0,0,0
1290650,True,0,No user reviews,0,0,0
1290660,True,0,No user reviews,0,0,0
1290670,True,0,4 user reviews,4,0,4
1290680,True,0,2 user reviews,2,0,2
1290690,True,0,No user reviews,0,0,0
1290700,True,0,No user reviews,0,0,0
1290710,True,0,No user reviews,0,0,0
1290720,True,0,5 user reviews,5,0,5
1290730,True,0,No user reviews,0,0,0
1290750,True,0,No user reviews,0,0,0
1290760,True,0,No user reviews,0,0,0
1290770,True,0,6 user reviews,6,0,6
1290780,True,0,No user reviews,0,0,0
1290790,True,0,6 user reviews,6,0,6
1290800,True,0,No user reviews,0,0,0
1290810,True,0,No user reviews,0,0,0
1290820,True,0,No user reviews,0,0,0
1290830,True,0,No user reviews,0,0,0
1290840,True,0,No user reviews,0,0,0
1290850,True,0,No user reviews,0,0,0
1290870,True,0,No user reviews,0,0,0
1290880,True,0,No user reviews,0,0,0
1290890,True,0,No user reviews,0,0,0
1290910,True,0,No user reviews,0,0,0
1290911,True,0,1 user reviews,1,0,1
1290912,True,0,No user reviews,0,0,0
1290913,True,0,1 user reviews,1,0,1
1290914,True,0,No user reviews,0,0,0
1290915,True,0,No user reviews,0,0,0
1290916,True,0,No user reviews,0,0,0
1290917,True,0,No user reviews,0,0,0
1290918,True,0,No user reviews,0,0,0
1290920,True,0,4 user reviews,4,0,4
1290950,True,0,No user reviews,0,0,0
1290960,True,0,No user reviews,0,0,0
1290970,True,0,No user reviews,0,0,0
1290980,True,0,No user reviews,0,0,0
1291000,True,0,No user reviews,0,0,0
1291010,True,0,No user reviews,0,0,0
1291020,True,0,4 user reviews,4,0,4
1291030,True,0,No user reviews,0,0,0
1291031,True,0,No user reviews,0,0,0
1291032,True,0,No user reviews,0,0,0
1291033,True,0,No user reviews,0,0,0
1291034,True,0,No user reviews,0,0,0
1291035,True,0,No user reviews,0,0,0
1291036,True,0,No user reviews,0,0,0
1291037,True,0,No user reviews,0,0,0
1291038,True,0,No user reviews,0,0,0
1291040,True,0,No user reviews,0,0,0
1291050,True,7,Positive,11,0,11
1291060,True,0,3 user reviews,3,0,3
1291080,True,0,No user reviews,0,0,0
1291090,True,0,3 user reviews,3,0,3
1291100,True,0,No user reviews,0,0,0
1291110,True,0,1 user reviews,0,1,1
1291140,True,0,No user reviews,0,0,0
1291150,True,0,No user reviews,0,0,0
1291170,True,7,Positive,31,4,35
1291180,True,0,No user reviews,0,0,0
1291210,True,0,No user reviews,0,0,0
1291220,True,0,No user reviews,0,0,0
1291230,True,0,No user reviews,0,0,0
1291240,True,0,No user reviews,0,0,0
1291250,True,0,1 user reviews,1,0,1
1291270,True,0,No user reviews,0,0,0
1291280,True,0,No user reviews,0,0,0
1291310,True,0,2 user reviews,2,0,2
1291320,True,0,No user reviews,0,0,0
1291330,True,6,Mostly Positive,17,6,23
1291340,True,9,Overwhelmingly Positive,2744,29,2773
1291360,True,0,No user reviews,0,0,0
1291370,True,0,1 user reviews,1,0,1
1291390,True,0,No user reviews,0,0,0
1291400,True,0,6 user reviews,6,0,6
1291430,True,0,No user reviews,0,0,0
1291470,True,0,No user reviews,0,0,0
1291480,True,0,No user reviews,0,0,0
1291500,True,0,No user reviews,0,0,0
1291530,True,0,No user reviews,0,0,0
1291540,True,7,Positive,19,0,19
1291580,True,0,No user reviews,0,0,0
1291600,True,0,No user reviews,0,0,0
1291610,True,0,3 user reviews,3,0,3
1291620,True,0,No user reviews,0,0,0
1291640,True,0,1 user reviews,1,0,1
1291650,True,0,No user reviews,0,0,0
1291660,True,0,No user reviews,0,0,0
1291670,True,0,No user reviews,0,0,0
1291680,True,0,No user reviews,0,0,0
1291690,True,0,No user reviews,0,0,0
1291700,True,0,No user reviews,0,0,0
1291710,True,0,No user reviews,0,0,0
1291720,True,0,1 user reviews,1,0,1
1291740,True,0,1 user reviews,1,0,1
1291760,True,0,No user reviews,0,0,0
1291780,True,0,No user reviews,0,0,0
1291781,True,0,No user reviews,0,0,0
1291790,True,0,No user reviews,0,0,0
1291800,True,0,No user reviews,0,0,0
1291810,True,0,No user reviews,0,0,0
1291820,True,0,No user reviews,0,0,0
1291830,True,0,3 user reviews,2,1,3
1291860,True,0,No user reviews,0,0,0
1291880,True,0,No user reviews,0,0,0
1291881,True,0,No user reviews,0,0,0
1291882,True,0,No user reviews,0,0,0
1291883,True,0,No user reviews,0,0,0
1291884,True,0,No user reviews,0,0,0
1291885,True,0,No user reviews,0,0,0
1291886,True,0,No user reviews,0,0,0
1291887,True,0,No user reviews,0,0,0
1291888,True,0,No user reviews,0,0,0
1291889,True,0,No user reviews,0,0,0
1291930,True,0,No user reviews,0,0,0
1291940,True,0,No user reviews,0,0,0
1291960,True,0,No user reviews,0,0,0
1291970,True,0,No user reviews,0,0,0
1291990,True,0,No user reviews,0,0,0
1292000,True,0,No user reviews,0,0,0
1292010,True,8,Very Positive,53,6,59
1292020,True,8,Very Positive,101,0,101
1292030,True,0,No user reviews,0,0,0
1292040,True,8,Very Positive,398,69,467
1292050,True,0,1 user reviews,1,0,1
1292060,True,0,No user reviews,0,0,0
1292070,True,0,2 user reviews,2,0,2
1292100,True,0,1 user reviews,1,0,1
1292120,True,0,No user reviews,0,0,0
1292140,True,0,2 user reviews,2,0,2
1292160,True,0,No user reviews,0,0,0
1292170,True,0,9 user reviews,8,1,9
1292180,True,6,Mostly Positive,21,6,27
1292200,True,0,No user reviews,0,0,0
1292220,True,0,1 user reviews,1,0,1
1292230,True,0,No user reviews,0,0,0
1292231,True,0,No user reviews,0,0,0
1292240,True,0,No user reviews,0,0,0
1292250,True,0,8 user reviews,8,0,8
1292260,True,0,No user reviews,0,0,0
1292270,True,0,1 user reviews,1,0,1
1292280,True,0,4 user reviews,3,1,4
1292290,True,0,4 user reviews,3,1,4
1292300,True,0,7 user reviews,7,0,7
1292301,True,0,3 user reviews,3,0,3
1292302,True,0,1 user reviews,1,0,1
1292303,True,0,1 user reviews,1,0,1
1292304,True,0,1 user reviews,1,0,1
1292310,True,0,No user reviews,0,0,0
1292320,True,0,No user reviews,0,0,0
1292330,True,0,No user reviews,0,0,0
1292350,True,0,No user reviews,0,0,0
1292360,True,0,No user reviews,0,0,0
1292370,True,0,No user reviews,0,0,0
1292380,True,0,No user reviews,0,0,0
1292400,True,0,No user reviews,0,0,0
1292410,True,0,No user reviews,0,0,0
1292430,True,0,No user reviews,0,0,0
1292440,True,0,No user reviews,0,0,0
1292460,True,0,No user reviews,0,0,0
1292470,True,0,No user reviews,0,0,0
1292480,True,0,No user reviews,0,0,0
1292490,True,0,9 user reviews,6,3,9
1292500,True,0,No user reviews,0,0,0
1292520,True,0,1 user reviews,1,0,1
1292530,True,0,No user reviews,0,0,0
1292540,True,6,Mostly Positive,30,8,38
1292550,True,0,2 user reviews,2,0,2
1292560,True,0,No user reviews,0,0,0
1292570,True,0,No user reviews,0,0,0
1292590,True,0,No user reviews,0,0,0
1292610,True,0,No user reviews,0,0,0
1292630,True,0,1 user reviews,1,0,1
1292640,True,0,No user reviews,0,0,0
1292660,True,0,No user reviews,0,0,0
1292690,True,8,Very Positive,240,4,244
1292700,True,0,No user reviews,0,0,0
1292710,True,0,No user reviews,0,0,0
1292720,True,0,No user reviews,0,0,0
1292750,True,0,5 user reviews,2,3,5
1292760,True,0,No user reviews,0,0,0
1292770,True,7,Positive,10,0,10
1292780,True,0,No user reviews,0,0,0
1292810,True,0,No user reviews,0,0,0
1292820,True,0,No user reviews,0,0,0
1292830,True,0,No user reviews,0,0,0
1292850,True,0,No user reviews,0,0,0
1292860,True,0,No user reviews,0,0,0
1292870,True,0,No user reviews,0,0,0
1292880,True,0,No user reviews,0,0,0
1292890,True,0,No user reviews,0,0,0
1292910,True,0,No user reviews,0,0,0
1292920,True,0,2 user reviews,2,0,2
1292930,True,0,No user reviews,0,0,0
1292940,True,8,Very Positive,133,0,133
1292950,True,0,No user reviews,0,0,0
1292960,True,0,1 user reviews,1,0,1
1292970,True,0,No user reviews,0,0,0
1292980,True,0,No user reviews,0,0,0
1292990,True,0,No user reviews,0,0,0
1293000,True,0,8 user reviews,8,0,8
1293010,True,0,No user reviews,0,0,0
1293020,True,0,No user reviews,0,0,0
1293030,True,0,No user reviews,0,0,0
1293040,True,0,No user reviews,0,0,0
1293050,True,0,No user reviews,0,0,0
1293080,True,0,No user reviews,0,0,0
1293090,True,0,No user reviews,0,0,0
1293110,True,0,No user reviews,0,0,0
1293120,True,0,No user reviews,0,0,0
1293160,True,0,No user reviews,0,0,0
1293170,True,0,No user reviews,0,0,0
1293180,True,0,No user reviews,0,0,0
1293190,True,0,No user reviews,0,0,0
1293200,True,0,No user reviews,0,0,0
1293210,True,0,No user reviews,0,0,0
1293220,True,0,No user reviews,0,0,0
1293230,True,8,Very Positive,262,27,289
1293240,True,0,No user reviews,0,0,0
1293250,True,0,No user reviews,0,0,0
1293270,True,0,No user reviews,0,0,0
1293280,True,0,9 user reviews,7,2,9
1293290,True,0,No user reviews,0,0,0
1293300,True,0,No user reviews,0,0,0
1293320,True,0,No user reviews,0,0,0
1293330,True,0,No user reviews,0,0,0
1293340,True,0,No user reviews,0,0,0
1293350,True,0,No user reviews,0,0,0
1293360,True,0,No user reviews,0,0,0
1293370,True,0,No user reviews,0,0,0
1293400,True,0,3 user reviews,2,1,3
1293410,True,0,No user reviews,0,0,0
1293420,True,0,No user reviews,0,0,0
1293430,True,0,1 user reviews,0,1,1
1293440,True,0,No user reviews,0,0,0
1293450,True,0,No user reviews,0,0,0
1293470,True,0,No user reviews,0,0,0
1293480,True,0,No user reviews,0,0,0
1293490,True,0,No user reviews,0,0,0
1293510,True,0,No user reviews,0,0,0
1293520,True,7,Positive,25,0,25
1293530,True,0,5 user reviews,3,2,5
1293550,True,0,No user reviews,0,0,0
1293580,True,0,No user reviews,0,0,0
1293590,True,0,No user reviews,0,0,0
1293591,True,0,No user reviews,0,0,0
1293610,True,0,No user reviews,0,0,0
1293620,True,0,4 user reviews,4,0,4
1293650,True,0,No user reviews,0,0,0
1293660,True,0,No user reviews,0,0,0
1293670,True,0,No user reviews,0,0,0
1293700,True,0,No user reviews,0,0,0
1293730,True,0,No user reviews,0,0,0
1293740,True,0,No user reviews,0,0,0
1293760,True,0,No user reviews,0,0,0
1293770,True,0,No user reviews,0,0,0
1293780,True,0,2 user reviews,2,0,2
1293790,True,0,No user reviews,0,0,0
1293810,True,0,No user reviews,0,0,0
1293820,True,8,Very Positive,324,10,334
1293850,True,0,1 user reviews,0,1,1
1293860,True,0,No user reviews,0,0,0
1293870,True,0,1 user reviews,1,0,1
1293880,True,0,No user reviews,0,0,0
1293890,True,0,No user reviews,0,0,0
1293891,True,0,No user reviews,0,0,0
1293892,True,0,No user reviews,0,0,0
1293893,True,0,1 user reviews,0,1,1
1293900,True,7,Positive,18,0,18
1293910,True,0,No user reviews,0,0,0
1293920,True,0,3 user reviews,2,1,3
1293940,True,0,4 user reviews,4,0,4
1293950,True,0,No user reviews,0,0,0
1293970,True,0,No user reviews,0,0,0
1293980,True,0,4 user reviews,2,2,4
1293990,True,7,Positive,14,0,14
1294000,True,0,1 user reviews,1,0,1
1294020,True,0,3 user reviews,3,0,3
1294030,True,0,No user reviews,0,0,0
1294040,True,0,3 user reviews,2,1,3
1294060,True,0,No user reviews,0,0,0
1294100,True,0,No user reviews,0,0,0
1294120,True,0,2 user reviews,2,0,2
1294130,True,0,No user reviews,0,0,0
1294131,True,0,No user reviews,0,0,0
1294140,True,0,No user reviews,0,0,0
1294141,True,0,No user reviews,0,0,0
1294143,True,0,No user reviews,0,0,0
1294150,True,0,No user reviews,0,0,0
1294160,True,0,No user reviews,0,0,0
1294170,True,0,No user reviews,0,0,0
1294220,True,0,No user reviews,0,0,0
1294230,True,7,Positive,15,0,15
1294250,True,0,No user reviews,0,0,0
1294260,True,0,No user reviews,0,0,0
1294280,True,0,5 user reviews,5,0,5
1294290,True,0,No user reviews,0,0,0
1294300,True,0,No user reviews,0,0,0
1294310,True,0,No user reviews,0,0,0
1294320,True,0,No user reviews,0,0,0
1294330,True,0,No user reviews,0,0,0
1294340,True,0,No user reviews,0,0,0
1294360,True,0,No user reviews,0,0,0
1294380,True,0,No user reviews,0,0,0
1294390,True,0,1 user reviews,1,0,1
1294400,True,0,No user reviews,0,0,0
1294410,True,0,No user reviews,0,0,0
1294430,True,0,No user reviews,0,0,0
1294440,True,0,No user reviews,0,0,0
1294460,True,0,1 user reviews,0,1,1
1294480,True,0,No user reviews,0,0,0
1294490,True,0,No user reviews,0,0,0
1294500,True,0,No user reviews,0,0,0
1294530,True,0,No user reviews,0,0,0
1294540,True,0,No user reviews,0,0,0
1294570,True,0,No user reviews,0,0,0
1294580,True,0,No user reviews,0,0,0
1294590,True,0,No user reviews,0,0,0
1294610,True,0,No user reviews,0,0,0
1294620,True,0,No user reviews,0,0,0
1294630,True,0,No user reviews,0,0,0
1294640,True,0,No user reviews,0,0,0
1294650,True,0,No user reviews,0,0,0
1294680,True,4,Mostly Negative,4,11,15
1294690,True,0,No user reviews,0,0,0
1294700,True,0,No user reviews,0,0,0
1294710,True,0,No user reviews,0,0,0
1294720,True,0,No user reviews,0,0,0
1294730,True,0,No user reviews,0,0,0
1294740,True,0,No user reviews,0,0,0
1294750,True,0,5 user reviews,5,0,5
1294760,True,6,Mostly Positive,26,10,36
1294780,True,7,Positive,19,0,19
1294840,True,0,No user reviews,0,0,0
1294850,True,0,No user reviews,0,0,0
1294880,True,0,No user reviews,0,0,0
1294900,True,0,No user reviews,0,0,0
1294910,True,0,No user reviews,0,0,0
1294920,True,0,5 user reviews,2,3,5
1294940,True,0,No user reviews,0,0,0
1294960,True,0,No user reviews,0,0,0
1294970,True,0,4 user reviews,3,1,4
1294980,True,0,No user reviews,0,0,0
1295000,True,0,No user reviews,0,0,0
1295030,True,0,1 user reviews,1,0,1
1295040,True,0,No user reviews,0,0,0
1295050,True,0,No user reviews,0,0,0
1295070,True,0,No user reviews,0,0,0
1295090,True,0,No user reviews,0,0,0
1295100,True,0,No user reviews,0,0,0
1295110,True,0,No user reviews,0,0,0
1295120,True,0,No user reviews,0,0,0
1295130,True,0,3 user reviews,3,0,3
1295140,True,0,No user reviews,0,0,0
1295150,True,0,No user reviews,0,0,0
1295160,True,0,2 user reviews,2,0,2
1295180,True,0,2 user reviews,2,0,2
1295200,True,0,No user reviews,0,0,0
1295210,True,0,No user reviews,0,0,0
1295220,True,0,No user reviews,0,0,0
1295230,True,0,1 user reviews,0,1,1
1295240,True,0,No user reviews,0,0,0
1295250,True,0,No user reviews,0,0,0
1295260,True,0,No user reviews,0,0,0
1295280,True,0,No user reviews,0,0,0
1295300,True,0,2 user reviews,0,2,2
1295310,True,0,No user reviews,0,0,0
1295330,True,0,1 user reviews,1,0,1
1295350,True,7,Positive,13,0,13
1295360,True,0,No user reviews,0,0,0
1295370,True,0,No user reviews,0,0,0
1295390,True,0,No user reviews,0,0,0
1295410,True,0,No user reviews,0,0,0
1295420,True,0,No user reviews,0,0,0
1295440,True,0,No user reviews,0,0,0
1295470,True,0,No user reviews,0,0,0
1295480,True,0,No user reviews,0,0,0
1295490,True,0,No user reviews,0,0,0
1295510,True,0,No user reviews,0,0,0
1295560,True,0,No user reviews,0,0,0
1295570,True,0,No user reviews,0,0,0
1295590,True,0,No user reviews,0,0,0
1295610,True,0,No user reviews,0,0,0
1295650,True,7,Positive,12,3,15
1295670,True,0,No user reviews,0,0,0
1295680,True,0,No user reviews,0,0,0
1295712,True,0,No user reviews,0,0,0
1295713,True,0,No user reviews,0,0,0
1295714,True,0,No user reviews,0,0,0
1295715,True,0,No user reviews,0,0,0
1295716,True,0,No user reviews,0,0,0
1295717,True,0,No user reviews,0,0,0
1295718,True,0,No user reviews,0,0,0
1295719,True,0,No user reviews,0,0,0
1295720,True,0,No user reviews,0,0,0
1295721,True,0,No user reviews,0,0,0
1295722,True,0,No user reviews,0,0,0
1295723,True,0,No user reviews,0,0,0
1295724,True,0,No user reviews,0,0,0
1295725,True,0,No user reviews,0,0,0
1295726,True,0,No user reviews,0,0,0
1295727,True,0,No user reviews,0,0,0
1295740,True,0,No user reviews,0,0,0
1295750,True,0,No user reviews,0,0,0
1295760,True,0,9 user reviews,8,1,9
1295770,True,0,No user reviews,0,0,0
1295780,True,0,No user reviews,0,0,0
1295800,True,0,8 user reviews,7,1,8
1295810,True,0,No user reviews,0,0,0
1295830,True,0,No user reviews,0,0,0
1295860,True,0,2 user reviews,0,2,2
1295880,True,0,1 user reviews,1,0,1
1295890,True,0,2 user reviews,2,0,2
1295900,True,0,No user reviews,0,0,0
1295910,True,0,No user reviews,0,0,0
1295920,True,0,No user reviews,0,0,0
1295940,True,0,No user reviews,0,0,0
1295960,True,0,No user reviews,0,0,0
1295970,True,0,No user reviews,0,0,0
1295980,True,0,No user reviews,0,0,0
1295990,True,0,No user reviews,0,0,0
1296000,True,0,No user reviews,0,0,0
1296180,True,0,1 user reviews,0,1,1
1296190,True,0,No user reviews,0,0,0
1296200,True,0,2 user reviews,1,1,2
1296210,True,0,No user reviews,0,0,0
1296230,True,0,No user reviews,0,0,0
1296240,True,0,No user reviews,0,0,0
1296260,True,0,3 user reviews,1,2,3
1296270,True,0,No user reviews,0,0,0
1296280,True,0,No user reviews,0,0,0
1296290,True,0,9 user reviews,4,5,9
1296310,True,0,No user reviews,0,0,0
1296340,True,0,No user reviews,0,0,0
1296350,True,0,No user reviews,0,0,0
1296370,True,0,1 user reviews,0,1,1
1296400,True,0,No user reviews,0,0,0
1296410,True,0,No user reviews,0,0,0
1296420,True,0,No user reviews,0,0,0
1296430,True,0,2 user reviews,2,0,2
1296440,True,0,No user reviews,0,0,0
1296470,True,0,No user reviews,0,0,0
1296480,True,0,1 user reviews,1,0,1
1296510,True,8,Very Positive,117,17,134
1296530,True,0,No user reviews,0,0,0
1296560,True,0,No user reviews,0,0,0
1296580,True,0,No user reviews,0,0,0
1296590,True,0,No user reviews,0,0,0
1296610,True,0,No user reviews,0,0,0
1296640,True,0,No user reviews,0,0,0
1296650,True,0,No user reviews,0,0,0
1296680,True,0,No user reviews,0,0,0
1296690,True,0,1 user reviews,1,0,1
1296700,True,0,No user reviews,0,0,0
1296710,True,0,No user reviews,0,0,0
1296711,True,0,No user reviews,0,0,0
1296712,True,0,2 user reviews,2,0,2
1296713,True,0,No user reviews,0,0,0
1296714,True,0,No user reviews,0,0,0
1296715,True,0,No user reviews,0,0,0
1296720,True,0,No user reviews,0,0,0
1296740,True,0,No user reviews,0,0,0
1296741,True,0,No user reviews,0,0,0
1296742,True,0,No user reviews,0,0,0
1296743,True,0,No user reviews,0,0,0
1296744,True,0,No user reviews,0,0,0
1296760,True,0,No user reviews,0,0,0
1296761,True,0,No user reviews,0,0,0
1296762,True,0,No user reviews,0,0,0
1296763,True,0,No user reviews,0,0,0
1296770,True,7,Positive,45,1,46
1296780,True,0,No user reviews,0,0,0
1296790,True,0,No user reviews,0,0,0
1296800,True,0,No user reviews,0,0,0
1296810,True,0,No user reviews,0,0,0
1296820,True,0,No user reviews,0,0,0
1296840,True,7,Positive,26,3,29
1296850,True,0,No user reviews,0,0,0
1296860,True,0,5 user reviews,5,0,5
1296880,True,0,1 user reviews,1,0,1
1296900,True,0,2 user reviews,2,0,2
1296910,True,0,No user reviews,0,0,0
1296950,True,0,No user reviews,0,0,0
1296980,True,0,No user reviews,0,0,0
1296990,True,0,No user reviews,0,0,0
1297000,True,0,No user reviews,0,0,0
1297010,True,0,8 user reviews,7,1,8
1297020,True,0,No user reviews,0,0,0
1297050,True,0,No user reviews,0,0,0
1297060,True,0,No user reviews,0,0,0
1297090,True,0,No user reviews,0,0,0
1297100,True,0,No user reviews,0,0,0
1297110,True,0,No user reviews,0,0,0
1297140,True,0,No user reviews,0,0,0
1297150,True,0,No user reviews,0,0,0
1297160,True,8,Very Positive,286,9,295
1297180,True,0,No user reviews,0,0,0
1297190,True,0,No user reviews,0,0,0
1297200,True,0,No user reviews,0,0,0
1297230,True,0,9 user reviews,9,0,9
1297240,True,0,No user reviews,0,0,0
1297250,True,0,No user reviews,0,0,0
1297270,True,0,No user reviews,0,0,0
1297280,True,0,No user reviews,0,0,0
1297290,True,0,No user reviews,0,0,0
1297300,True,0,No user reviews,0,0,0
1297320,True,0,No user reviews,0,0,0
1297330,True,0,No user reviews,0,0,0
1297370,True,0,5 user reviews,1,4,5
1297390,True,5,Mixed,6,4,10
1297410,True,0,No user reviews,0,0,0
1297420,True,0,No user reviews,0,0,0
1297440,True,0,No user reviews,0,0,0
1297460,True,0,3 user reviews,3,0,3
1297470,True,0,9 user reviews,5,4,9
1297480,True,0,No user reviews,0,0,0
1297500,True,0,No user reviews,0,0,0
1297510,True,0,No user reviews,0,0,0
1297520,True,0,No user reviews,0,0,0
1297530,True,0,No user reviews,0,0,0
1297540,True,0,No user reviews,0,0,0
1297560,True,0,No user reviews,0,0,0
1297570,True,0,No user reviews,0,0,0
1297580,True,0,No user reviews,0,0,0
1297600,True,0,4 user reviews,4,0,4
1297610,True,0,No user reviews,0,0,0
1297650,True,0,6 user reviews,4,2,6
1297660,True,0,No user reviews,0,0,0
1297680,True,0,No user reviews,0,0,0
1297690,True,0,No user reviews,0,0,0
1297700,True,0,No user reviews,0,0,0
1297720,True,0,No user reviews,0,0,0
1297730,True,0,No user reviews,0,0,0
1297770,True,0,No user reviews,0,0,0
1297790,True,7,Positive,30,0,30
1297800,True,0,No user reviews,0,0,0
1297810,True,0,No user reviews,0,0,0
1297850,True,0,1 user reviews,1,0,1
1297880,True,0,No user reviews,0,0,0
1297890,True,0,No user reviews,0,0,0
1297940,True,0,No user reviews,0,0,0
1297950,True,0,No user reviews,0,0,0
1297980,True,0,No user reviews,0,0,0
1298000,True,0,No user reviews,0,0,0
1298010,True,0,No user reviews,0,0,0
1298020,True,0,No user reviews,0,0,0
1298030,True,0,No user reviews,0,0,0
1298040,True,0,No user reviews,0,0,0
1298050,True,0,4 user reviews,4,0,4
1298080,True,0,No user reviews,0,0,0
1298090,True,0,1 user reviews,1,0,1
1298100,True,0,2 user reviews,2,0,2
1298110,True,0,No user reviews,0,0,0
1298120,True,0,No user reviews,0,0,0
1298130,True,0,No user reviews,0,0,0
1298140,True,0,No user reviews,0,0,0
1298150,True,0,No user reviews,0,0,0
1298170,True,0,No user reviews,0,0,0
1298180,True,0,1 user reviews,0,1,1
1298200,True,0,No user reviews,0,0,0
1298210,True,0,2 user reviews,2,0,2
1298220,True,0,No user reviews,0,0,0
1298230,True,0,No user reviews,0,0,0
1298250,True,0,No user reviews,0,0,0
1298260,True,0,7 user reviews,7,0,7
1298270,True,0,No user reviews,0,0,0
1298280,True,0,7 user reviews,7,0,7
1298290,True,0,No user reviews,0,0,0
1298310,True,0,8 user reviews,8,0,8
1298320,True,0,3 user reviews,3,0,3
1298330,True,0,No user reviews,0,0,0
1298340,True,0,2 user reviews,2,0,2
1298360,True,0,No user reviews,0,0,0
1298370,True,0,No user reviews,0,0,0
1298380,True,0,No user reviews,0,0,0
1298390,True,0,No user reviews,0,0,0
1298460,True,0,No user reviews,0,0,0
1298470,True,0,No user reviews,0,0,0
1298480,True,0,No user reviews,0,0,0
1298500,True,0,No user reviews,0,0,0
1298510,True,0,2 user reviews,2,0,2
1298520,True,0,1 user reviews,0,1,1
1298530,True,0,No user reviews,0,0,0
1298550,True,0,No user reviews,0,0,0
1298570,True,0,No user reviews,0,0,0
1298580,True,0,No user reviews,0,0,0
1298590,True,8,Very Positive,364,2,366
1298600,True,0,No user reviews,0,0,0
1298620,True,0,No user reviews,0,0,0
1298630,True,0,No user reviews,0,0,0
1298640,True,0,No user reviews,0,0,0
1298650,True,0,No user reviews,0,0,0
1298660,True,0,2 user reviews,2,0,2
1298670,True,0,4 user reviews,4,0,4
1298680,True,0,No user reviews,0,0,0
1298690,True,0,No user reviews,0,0,0
1298700,True,0,No user reviews,0,0,0
1298720,True,0,1 user reviews,1,0,1
1298740,True,0,No user reviews,0,0,0
1298760,True,0,No user reviews,0,0,0
1298780,True,0,No user reviews,0,0,0
1298800,True,0,No user reviews,0,0,0
1298810,True,0,No user reviews,0,0,0
1298820,True,0,3 user reviews,2,1,3
1298830,True,0,No user reviews,0,0,0
1298850,True,0,No user reviews,0,0,0
1298860,True,0,No user reviews,0,0,0
1298870,True,0,No user reviews,0,0,0
1298880,True,0,No user reviews,0,0,0
1298890,True,0,1 user reviews,1,0,1
1298910,True,0,No user reviews,0,0,0
1298920,True,0,No user reviews,0,0,0
1298940,True,0,No user reviews,0,0,0
1298970,True,0,No user reviews,0,0,0
1298980,True,0,No user reviews,0,0,0
1299010,True,0,1 user reviews,1,0,1
1299020,True,0,No user reviews,0,0,0
1299040,True,0,No user reviews,0,0,0
1299050,True,0,No user reviews,0,0,0
1299070,True,0,No user reviews,0,0,0
1299090,True,0,4 user reviews,4,0,4
1299120,True,8,Very Positive,50,1,51
1299150,True,0,No user reviews,0,0,0
1299170,True,0,No user reviews,0,0,0
1299190,True,0,1 user reviews,1,0,1
1299200,True,0,No user reviews,0,0,0
1299220,True,0,No user reviews,0,0,0
1299230,True,0,No user reviews,0,0,0
1299250,True,0,No user reviews,0,0,0
1299260,True,0,No user reviews,0,0,0
1299270,True,0,No user reviews,0,0,0
1299300,True,0,No user reviews,0,0,0
1299320,True,8,Very Positive,190,9,199
1299330,True,0,No user reviews,0,0,0
1299340,True,0,No user reviews,0,0,0
1299350,True,0,No user reviews,0,0,0
1299360,True,0,No user reviews,0,0,0
1299370,True,0,No user reviews,0,0,0
1299400,True,0,No user reviews,0,0,0
1299410,True,0,No user reviews,0,0,0
1299420,True,0,4 user reviews,4,0,4
1299430,True,0,No user reviews,0,0,0
1299440,True,0,No user reviews,0,0,0
1299470,True,0,No user reviews,0,0,0
1299480,True,0,No user reviews,0,0,0
1299490,True,0,No user reviews,0,0,0
1299530,True,8,Very Positive,84,14,98
1299540,True,0,No user reviews,0,0,0
1299570,True,0,No user reviews,0,0,0
1299580,True,0,No user reviews,0,0,0
1299590,True,0,No user reviews,0,0,0
1299600,True,6,Mostly Positive,10,4,14
1299610,True,0,1 user reviews,1,0,1
1299620,True,0,No user reviews,0,0,0
1299630,True,0,No user reviews,0,0,0
1299640,True,0,No user reviews,0,0,0
1299660,True,0,No user reviews,0,0,0
1299680,True,0,No user reviews,0,0,0
1299690,True,0,No user reviews,0,0,0
1299710,True,0,3 user reviews,3,0,3
1299720,True,0,No user reviews,0,0,0
1299730,True,0,No user reviews,0,0,0
1299740,True,0,1 user reviews,1,0,1
1299750,True,0,7 user reviews,6,1,7
1299760,True,0,No user reviews,0,0,0
1299770,True,0,2 user reviews,2,0,2
1299790,True,0,No user reviews,0,0,0
1299810,True,0,No user reviews,0,0,0
1299820,True,0,No user reviews,0,0,0
1299830,True,0,No user reviews,0,0,0
1299840,True,0,6 user reviews,4,2,6
1299890,True,0,1 user reviews,0,1,1
1299900,True,0,No user reviews,0,0,0
1299920,True,0,No user reviews,0,0,0
1299930,True,0,No user reviews,0,0,0
1299950,True,0,No user reviews,0,0,0
1299980,True,0,2 user reviews,0,2,2
1299990,True,0,No user reviews,0,0,0
1300000,True,0,2 user reviews,1,1,2
1300010,True,0,No user reviews,0,0,0
1300040,True,0,No user reviews,0,0,0
1300050,True,0,No user reviews,0,0,0
1300060,True,0,No user reviews,0,0,0
1300110,True,0,1 user reviews,0,1,1
1300120,True,0,No user reviews,0,0,0
1300140,True,0,No user reviews,0,0,0
1300160,True,0,4 user reviews,2,2,4
1300180,True,0,2 user reviews,2,0,2
1300190,True,0,7 user reviews,6,1,7
1300200,True,0,2 user reviews,2,0,2
1300210,True,7,Positive,11,2,13
1300211,True,0,6 user reviews,6,0,6
1300260,True,0,No user reviews,0,0,0
1300270,True,0,6 user reviews,4,2,6
1300290,True,0,No user reviews,0,0,0
1300310,True,0,5 user reviews,4,1,5
1300320,True,0,No user reviews,0,0,0
1300330,True,0,No user reviews,0,0,0
1300340,True,0,No user reviews,0,0,0
1300350,True,0,No user reviews,0,0,0
1300360,True,0,No user reviews,0,0,0
1300370,True,0,No user reviews,0,0,0
1300390,True,7,Positive,15,2,17
1300400,True,0,No user reviews,0,0,0
1300410,True,0,No user reviews,0,0,0
1300430,True,6,Mostly Positive,67,20,87
1300450,True,0,8 user reviews,0,8,8
1300490,True,0,4 user reviews,4,0,4
1300510,True,0,No user reviews,0,0,0
1300530,True,0,No user reviews,0,0,0
1300550,True,0,No user reviews,0,0,0
1300560,True,0,No user reviews,0,0,0
1300570,True,0,2 user reviews,1,1,2
1300580,True,0,1 user reviews,0,1,1
1300590,True,0,No user reviews,0,0,0
1300610,True,0,No user reviews,0,0,0
1300650,True,0,No user reviews,0,0,0
1300660,True,0,No user reviews,0,0,0
1300670,True,0,2 user reviews,2,0,2
1300680,True,0,7 user reviews,2,5,7
1300690,True,0,No user reviews,0,0,0
1300700,True,7,Positive,16,2,18
1300710,True,4,Mostly Negative,81,153,234
1300720,True,0,No user reviews,0,0,0
1300760,True,0,No user reviews,0,0,0
1300770,True,0,2 user reviews,2,0,2
1300780,True,0,No user reviews,0,0,0
1300790,True,0,1 user reviews,0,1,1
1300800,True,0,No user reviews,0,0,0
1300840,True,0,No user reviews,0,0,0
1300850,True,0,5 user reviews,5,0,5
1300851,True,0,4 user reviews,3,1,4
1300860,True,0,No user reviews,0,0,0
1300870,True,0,No user reviews,0,0,0
1300880,True,0,No user reviews,0,0,0
1300890,True,0,No user reviews,0,0,0
1300900,True,0,No user reviews,0,0,0
1300920,True,0,No user reviews,0,0,0
1300930,True,0,No user reviews,0,0,0
1300940,True,0,No user reviews,0,0,0
1300950,True,0,No user reviews,0,0,0
1300960,True,0,3 user reviews,3,0,3
1300980,True,0,No user reviews,0,0,0
1300990,True,0,No user reviews,0,0,0
1301020,True,0,No user reviews,0,0,0
1301021,True,5,Mixed,12,7,19
1301040,True,0,No user reviews,0,0,0
1301050,True,0,No user reviews,0,0,0
1301080,True,0,No user reviews,0,0,0
1301090,True,0,No user reviews,0,0,0
1301100,True,0,4 user reviews,4,0,4
1301220,True,0,No user reviews,0,0,0
1301230,True,0,No user reviews,0,0,0
1301240,True,0,No user reviews,0,0,0
1301250,True,0,3 user reviews,2,1,3
1301260,True,0,1 user reviews,1,0,1
1301270,True,0,No user reviews,0,0,0
1301310,True,0,No user reviews,0,0,0
1301340,True,0,No user reviews,0,0,0
1301350,True,0,No user reviews,0,0,0
1301370,True,0,3 user reviews,3,0,3
1301380,True,0,1 user reviews,1,0,1
1301390,True,0,5 user reviews,4,1,5
1301410,True,0,1 user reviews,1,0,1
1301430,True,0,No user reviews,0,0,0
1301440,True,0,No user reviews,0,0,0
1301450,True,0,No user reviews,0,0,0
1301470,True,0,9 user reviews,9,0,9
1301480,True,5,Mixed,6,4,10
1301490,True,0,No user reviews,0,0,0
1301500,True,0,No user reviews,0,0,0
1301520,True,0,No user reviews,0,0,0
1301540,True,0,2 user reviews,2,0,2
1301560,True,0,No user reviews,0,0,0
1301570,True,0,No user reviews,0,0,0
1301580,True,0,No user reviews,0,0,0
1301590,True,0,No user reviews,0,0,0
1301620,True,0,3 user reviews,2,1,3
1301650,True,0,No user reviews,0,0,0
1301700,True,0,No user reviews,0,0,0
1301710,True,0,No user reviews,0,0,0
1301720,True,0,No user reviews,0,0,0
1301730,True,0,1 user reviews,1,0,1
1301740,True,5,Mixed,17,18,35
1301750,True,0,No user reviews,0,0,0
1301770,True,0,No user reviews,0,0,0
1301800,True,0,No user reviews,0,0,0
1301820,True,0,No user reviews,0,0,0
1301830,True,0,No user reviews,0,0,0
1301850,True,0,No user reviews,0,0,0
1301860,True,0,No user reviews,0,0,0
1301870,True,0,6 user reviews,6,0,6
1301910,True,0,No user reviews,0,0,0
1301930,True,0,No user reviews,0,0,0
1301950,True,0,No user reviews,0,0,0
1301970,True,0,2 user reviews,2,0,2
1301980,True,0,No user reviews,0,0,0
1301990,True,0,No user reviews,0,0,0
1302000,True,0,2 user reviews,0,2,2
1302010,True,0,No user reviews,0,0,0
1302030,True,0,No user reviews,0,0,0
1302040,True,0,No user reviews,0,0,0
1302050,True,7,Positive,14,0,14
1302060,True,0,No user reviews,0,0,0
1302090,True,0,1 user reviews,0,1,1
1302100,True,0,No user reviews,0,0,0
1302110,True,0,No user reviews,0,0,0
1302140,True,0,No user reviews,0,0,0
1302160,True,0,3 user reviews,2,1,3
1302180,True,0,4 user reviews,4,0,4
1302190,True,0,No user reviews,0,0,0
1302200,True,0,No user reviews,0,0,0
1302210,True,0,No user reviews,0,0,0
1302220,True,0,No user reviews,0,0,0
1302230,True,0,No user reviews,0,0,0
1302240,True,0,9 user reviews,9,0,9
1302250,True,0,No user reviews,0,0,0
1302260,True,0,No user reviews,0,0,0
1302270,True,0,No user reviews,0,0,0
1302290,True,0,No user reviews,0,0,0
1302300,True,0,No user reviews,0,0,0
1302310,True,0,No user reviews,0,0,0
1302350,True,0,No user reviews,0,0,0
1302360,True,0,No user reviews,0,0,0
1302380,True,0,1 user reviews,1,0,1
1302390,True,0,No user reviews,0,0,0
1302400,True,0,1 user reviews,1,0,1
1302410,True,0,No user reviews,0,0,0
1302420,True,0,No user reviews,0,0,0
1302430,True,4,Mostly Negative,5,8,13
1302440,True,6,Mostly Positive,14,4,18
1302470,True,0,No user reviews,0,0,0
1302500,True,0,No user reviews,0,0,0
1302510,True,0,2 user reviews,1,1,2
1302520,True,0,No user reviews,0,0,0
1302521,True,0,No user reviews,0,0,0
1302522,True,0,No user reviews,0,0,0
1302530,True,0,No user reviews,0,0,0
1302540,True,0,No user reviews,0,0,0
1302550,True,0,2 user reviews,2,0,2
1302570,True,0,No user reviews,0,0,0
1302590,True,0,No user reviews,0,0,0
1302600,True,0,No user reviews,0,0,0
1302610,True,0,No user reviews,0,0,0
1302620,True,0,No user reviews,0,0,0
1302640,True,0,No user reviews,0,0,0
1302670,True,0,No user reviews,0,0,0
1302700,True,0,1 user reviews,0,1,1
1302720,True,0,No user reviews,0,0,0
1302730,True,0,1 user reviews,1,0,1
1302740,True,0,No user reviews,0,0,0
1302750,True,0,6 user reviews,5,1,6
1302760,True,0,No user reviews,0,0,0
1302770,True,0,No user reviews,0,0,0
1302780,True,6,Mostly Positive,9,3,12
1302800,True,8,Very Positive,120,5,125
1302810,True,0,1 user reviews,1,0,1
1302820,True,0,No user reviews,0,0,0
1302840,True,0,1 user reviews,1,0,1
1302860,True,7,Positive,25,1,26
1302880,True,0,No user reviews,0,0,0
1302920,True,0,No user reviews,0,0,0
1302930,True,5,Mixed,23,12,35
1302970,True,0,No user reviews,0,0,0
1302980,True,0,No user reviews,0,0,0
1302990,True,8,Very Positive,90,3,93
1303000,True,0,No user reviews,0,0,0
1303030,True,0,No user reviews,0,0,0
1303040,True,0,No user reviews,0,0,0
1303050,True,0,No user reviews,0,0,0
1303080,True,0,No user reviews,0,0,0
1303081,True,0,No user reviews,0,0,0
1303082,True,0,No user reviews,0,0,0
1303090,True,0,No user reviews,0,0,0
1303100,True,0,No user reviews,0,0,0
1303120,True,0,No user reviews,0,0,0
1303130,True,0,No user reviews,0,0,0
1303140,True,0,3 user reviews,3,0,3
1303150,True,0,No user reviews,0,0,0
1303160,True,0,No user reviews,0,0,0
1303170,True,0,No user reviews,0,0,0
1303190,True,0,No user reviews,0,0,0
1303191,True,0,1 user reviews,1,0,1
1303192,True,0,No user reviews,0,0,0
1303193,True,0,2 user reviews,2,0,2
1303194,True,0,No user reviews,0,0,0
1303195,True,0,No user reviews,0,0,0
1303196,True,0,1 user reviews,1,0,1
1303197,True,0,No user reviews,0,0,0
1303198,True,0,1 user reviews,1,0,1
1303199,True,0,No user reviews,0,0,0
1303200,True,0,No user reviews,0,0,0
1303201,True,0,No user reviews,0,0,0
1303210,True,0,No user reviews,0,0,0
1303260,True,0,7 user reviews,5,2,7
1303270,True,0,No user reviews,0,0,0
1303280,True,7,Positive,9,2,11
1303290,True,0,No user reviews,0,0,0
1303320,True,0,No user reviews,0,0,0
1303330,True,0,No user reviews,0,0,0
1303340,True,0,No user reviews,0,0,0
1303350,True,0,1 user reviews,1,0,1
1303370,True,0,No user reviews,0,0,0
1303400,True,0,No user reviews,0,0,0
1303420,True,0,2 user reviews,2,0,2
1303430,True,0,No user reviews,0,0,0
1303440,True,0,No user reviews,0,0,0
1303450,True,0,No user reviews,0,0,0
1303460,True,0,No user reviews,0,0,0
1303470,True,0,No user reviews,0,0,0
1303490,True,0,No user reviews,0,0,0
1303510,True,0,No user reviews,0,0,0
1303540,True,0,No user reviews,0,0,0
1303550,True,0,No user reviews,0,0,0
1303570,True,0,No user reviews,0,0,0
1303580,True,0,No user reviews,0,0,0
1303605,True,0,No user reviews,0,0,0
1303620,True,0,No user reviews,0,0,0
1303630,True,0,No user reviews,0,0,0
1303640,True,0,No user reviews,0,0,0
1303660,True,8,Very Positive,54,10,64
1303670,True,0,5 user reviews,5,0,5
1303680,True,0,No user reviews,0,0,0
1303710,True,0,No user reviews,0,0,0
1303720,True,0,No user reviews,0,0,0
1303740,True,8,Very Positive,48,3,51
1303750,True,0,No user reviews,0,0,0
1303760,True,0,No user reviews,0,0,0
1303780,True,0,No user reviews,0,0,0
1303790,True,0,3 user reviews,3,0,3
1303800,True,5,Mixed,14,8,22
1303820,True,0,2 user reviews,1,1,2
1303830,True,0,No user reviews,0,0,0
1303840,True,0,No user reviews,0,0,0
1303860,True,0,No user reviews,0,0,0
1303870,True,0,3 user reviews,2,1,3
1303880,True,0,No user reviews,0,0,0
1303891,True,0,6 user reviews,6,0,6
1303900,True,0,1 user reviews,1,0,1
1303910,True,0,No user reviews,0,0,0
1303920,True,0,No user reviews,0,0,0
1303930,True,0,No user reviews,0,0,0
1303940,True,0,No user reviews,0,0,0
1303950,True,0,No user reviews,0,0,0
1303990,True,7,Positive,37,1,38
1304020,True,0,No user reviews,0,0,0
1304040,True,0,No user reviews,0,0,0
1304050,True,0,No user reviews,0,0,0
1304070,True,0,No user reviews,0,0,0
1304090,True,7,Positive,21,1,22
1304100,True,0,1 user reviews,0,1,1
1304120,True,0,3 user reviews,3,0,3
1304130,True,0,No user reviews,0,0,0
1304140,True,7,Positive,38,2,40
1304150,True,0,6 user reviews,2,4,6
1304160,True,0,No user reviews,0,0,0
1304170,True,0,4 user reviews,4,0,4
1304190,True,0,No user reviews,0,0,0
1304200,True,0,No user reviews,0,0,0
1304220,True,0,4 user reviews,4,0,4
1304230,True,0,No user reviews,0,0,0
1304240,True,0,No user reviews,0,0,0
1304250,True,0,No user reviews,0,0,0
1304270,True,0,No user reviews,0,0,0
1304280,True,0,No user reviews,0,0,0
1304290,True,0,9 user reviews,9,0,9
1304300,True,0,No user reviews,0,0,0
1304310,True,0,2 user reviews,2,0,2
1304320,True,0,No user reviews,0,0,0
1304350,True,0,No user reviews,0,0,0
1304360,True,0,1 user reviews,1,0,1
1304370,True,0,No user reviews,0,0,0
1304380,True,0,No user reviews,0,0,0
1304390,True,0,No user reviews,0,0,0
1304400,True,0,No user reviews,0,0,0
1304411,True,0,1 user reviews,0,1,1
1304412,True,0,1 user reviews,0,1,1
1304413,True,0,1 user reviews,1,0,1
1304414,True,0,No user reviews,0,0,0
1304416,True,0,No user reviews,0,0,0
1304417,True,0,5 user reviews,2,3,5
1304418,True,0,1 user reviews,0,1,1
1304419,True,0,No user reviews,0,0,0
1304420,True,0,No user reviews,0,0,0
1304430,True,0,No user reviews,0,0,0
1304442,True,0,5 user reviews,4,1,5
1304444,True,0,4 user reviews,2,2,4
1304445,True,0,1 user reviews,1,0,1
1304446,True,0,1 user reviews,0,1,1
1304447,True,0,7 user reviews,5,2,7
1304448,True,0,3 user reviews,3,0,3
1304449,True,0,1 user reviews,0,1,1
1304450,True,0,No user reviews,0,0,0
1304460,True,0,2 user reviews,2,0,2
1304461,True,0,2 user reviews,2,0,2
1304462,True,0,1 user reviews,1,0,1
1304463,True,0,No user reviews,0,0,0
1304464,True,0,1 user reviews,1,0,1
1304467,True,5,Mixed,20,22,42
1304468,True,6,Mostly Positive,8,3,11
1304470,True,0,No user reviews,0,0,0
1304520,True,0,No user reviews,0,0,0
1304550,True,7,Positive,42,0,42
1304560,True,0,No user reviews,0,0,0
1304570,True,0,No user reviews,0,0,0
1304580,True,0,No user reviews,0,0,0
1304590,True,0,No user reviews,0,0,0
1304591,True,0,No user reviews,0,0,0
1304600,True,7,Positive,36,2,38
1304601,True,7,Positive,33,8,41
1304610,True,0,No user reviews,0,0,0
1304620,True,4,Mostly Negative,5,8,13
1304640,True,7,Positive,11,2,13
1304660,True,0,No user reviews,0,0,0
1304680,True,0,No user reviews,0,0,0
1304690,True,0,No user reviews,0,0,0
1304730,True,0,No user reviews,0,0,0
1304760,True,0,No user reviews,0,0,0
1304770,True,0,No user reviews,0,0,0
1304780,True,0,No user reviews,0,0,0
1304790,True,0,No user reviews,0,0,0
1304800,True,0,1 user reviews,1,0,1
1304850,True,0,No user reviews,0,0,0
1304860,True,0,No user reviews,0,0,0
1304870,True,0,2 user reviews,1,1,2
1304900,True,0,No user reviews,0,0,0
1304910,True,0,4 user reviews,4,0,4
1304930,True,0,No user reviews,0,0,0
1304950,True,0,No user reviews,0,0,0
1304960,True,0,No user reviews,0,0,0
1304970,True,0,No user reviews,0,0,0
1305000,True,0,No user reviews,0,0,0
1305010,True,0,1 user reviews,1,0,1
1305020,True,0,No user reviews,0,0,0
1305040,True,0,6 user reviews,6,0,6
1305050,True,0,No user reviews,0,0,0
1305060,True,0,9 user reviews,9,0,9
1305080,True,0,No user reviews,0,0,0
1305110,True,0,No user reviews,0,0,0
1305120,True,0,No user reviews,0,0,0
1305160,True,0,No user reviews,0,0,0
1305180,True,0,No user reviews,0,0,0
1305190,True,0,No user reviews,0,0,0
1305220,True,0,1 user reviews,1,0,1
1305260,True,0,No user reviews,0,0,0
1305270,True,0,No user reviews,0,0,0
1305280,True,0,No user reviews,0,0,0
1305310,True,8,Very Positive,47,5,52
1305320,True,0,No user reviews,0,0,0
1305360,True,0,No user reviews,0,0,0
1305370,True,0,2 user reviews,1,1,2
1305380,True,0,No user reviews,0,0,0
1305390,True,0,1 user reviews,1,0,1
1305400,True,0,No user reviews,0,0,0
1305420,True,5,Mixed,52,23,75
1305430,True,0,No user reviews,0,0,0
1305440,True,7,Positive,11,2,13
1305470,True,0,No user reviews,0,0,0
1305480,True,0,No user reviews,0,0,0
1305490,True,0,No user reviews,0,0,0
1305500,True,0,No user reviews,0,0,0
1305530,True,0,No user reviews,0,0,0
1305540,True,0,4 user reviews,2,2,4
1305550,True,0,No user reviews,0,0,0
1305560,True,0,No user reviews,0,0,0
1305570,True,0,No user reviews,0,0,0
1305590,True,0,1 user reviews,1,0,1
1305610,True,0,No user reviews,0,0,0
1305640,True,0,No user reviews,0,0,0
1305660,True,0,6 user reviews,6,0,6
1305670,True,0,No user reviews,0,0,0
1305680,True,0,No user reviews,0,0,0
1305690,True,0,No user reviews,0,0,0
1305700,True,0,No user reviews,0,0,0
1305710,True,0,No user reviews,0,0,0
1305720,True,0,No user reviews,0,0,0
1305730,True,0,No user reviews,0,0,0
1305760,True,7,Positive,13,1,14
1305770,True,0,No user reviews,0,0,0
1305780,True,0,No user reviews,0,0,0
1305790,True,0,No user reviews,0,0,0
1305820,True,0,No user reviews,0,0,0
1305830,True,0,No user reviews,0,0,0
1305880,True,0,No user reviews,0,0,0
1305960,True,0,No user reviews,0,0,0
1305970,True,0,No user reviews,0,0,0
1305980,True,0,No user reviews,0,0,0
1305990,True,0,No user reviews,0,0,0
1306000,True,0,No user reviews,0,0,0
1306001,True,0,No user reviews,0,0,0
1306010,True,0,No user reviews,0,0,0
1306020,True,0,1 user reviews,1,0,1
1306050,True,0,No user reviews,0,0,0
1306080,True,0,No user reviews,0,0,0
1306090,True,0,No user reviews,0,0,0
1306100,True,0,No user reviews,0,0,0
1306110,True,0,No user reviews,0,0,0
1306160,True,0,No user reviews,0,0,0
1306170,True,0,No user reviews,0,0,0
1306180,True,0,No user reviews,0,0,0
1306190,True,0,No user reviews,0,0,0
1306210,True,0,No user reviews,0,0,0
1306230,True,0,No user reviews,0,0,0
1306240,True,0,No user reviews,0,0,0
1306250,True,0,No user reviews,0,0,0
1306260,True,7,Positive,10,1,11
1306270,True,0,No user reviews,0,0,0
1306410,True,0,No user reviews,0,0,0
1306570,True,0,No user reviews,0,0,0
1306580,True,0,No user reviews,0,0,0
1306620,True,7,Positive,38,3,41
1306650,True,0,No user reviews,0,0,0
1306660,True,0,No user reviews,0,0,0
1306700,True,0,No user reviews,0,0,0
1306730,True,5,Mixed,14,16,30
1306750,True,0,No user reviews,0,0,0
1306760,True,0,No user reviews,0,0,0
1306780,True,6,Mostly Positive,21,9,30
1306790,True,7,Positive,12,1,13
1306800,True,0,No user reviews,0,0,0
1306810,True,0,No user reviews,0,0,0
1306830,True,0,No user reviews,0,0,0
1306840,True,0,No user reviews,0,0,0
1306850,True,0,No user reviews,0,0,0
1306860,True,0,3 user reviews,2,1,3
1306900,True,0,2 user reviews,2,0,2
1306910,True,0,No user reviews,0,0,0
1306950,True,0,No user reviews,0,0,0
1306960,True,0,No user reviews,0,0,0
1306970,True,0,No user reviews,0,0,0
1306980,True,0,No user reviews,0,0,0
1306990,True,0,No user reviews,0,0,0
1307000,True,0,No user reviews,0,0,0
1307010,True,0,No user reviews,0,0,0
1307020,True,0,No user reviews,0,0,0
1307040,True,0,No user reviews,0,0,0
1307050,True,0,No user reviews,0,0,0
1307060,True,0,No user reviews,0,0,0
1307070,True,7,Positive,14,0,14
1307080,True,0,No user reviews,0,0,0
1307090,True,0,6 user reviews,5,1,6
1307100,True,0,No user reviews,0,0,0
1307170,True,0,No user reviews,0,0,0
1307200,True,0,No user reviews,0,0,0
1307210,True,0,No user reviews,0,0,0
1307220,True,0,1 user reviews,0,1,1
1307240,True,0,3 user reviews,2,1,3
1307250,True,0,2 user reviews,2,0,2
1307290,True,0,No user reviews,0,0,0
1307300,True,0,No user reviews,0,0,0
1307310,True,0,No user reviews,0,0,0
1307330,True,0,No user reviews,0,0,0
1307350,True,0,No user reviews,0,0,0
1307360,True,0,No user reviews,0,0,0
1307380,True,0,1 user reviews,1,0,1
1307400,True,0,No user reviews,0,0,0
1307410,True,0,No user reviews,0,0,0
1307420,True,0,No user reviews,0,0,0
1307430,True,0,1 user reviews,1,0,1
1307440,True,7,Positive,12,1,13
1307450,True,0,3 user reviews,3,0,3
1307460,True,0,5 user reviews,4,1,5
1307480,True,0,7 user reviews,1,6,7
1307490,True,0,No user reviews,0,0,0
1307510,True,0,No user reviews,0,0,0
1307530,True,0,1 user reviews,1,0,1
1307540,True,0,2 user reviews,0,2,2
1307550,True,8,Very Positive,2139,279,2418
1307560,True,0,No user reviews,0,0,0
1307570,True,0,No user reviews,0,0,0
1307580,True,0,No user reviews,0,0,0
1307590,True,0,No user reviews,0,0,0
1307600,True,5,Mixed,12,11,23
1307610,True,0,No user reviews,0,0,0
1307640,True,0,1 user reviews,1,0,1
1307670,True,0,No user reviews,0,0,0
1307680,True,8,Very Positive,69,14,83
1307690,True,0,No user reviews,0,0,0
1307720,True,0,No user reviews,0,0,0
1307730,True,0,No user reviews,0,0,0
1307740,True,0,No user reviews,0,0,0
1307760,True,0,5 user reviews,3,2,5
1307780,True,0,No user reviews,0,0,0
1307790,True,0,No user reviews,0,0,0
1307800,True,0,No user reviews,0,0,0
1307810,True,0,1 user reviews,1,0,1
1307820,True,0,No user reviews,0,0,0
1307850,True,0,7 user reviews,7,0,7
1307870,True,7,Positive,28,1,29
1307880,True,0,No user reviews,0,0,0
1307890,True,0,No user reviews,0,0,0
1307900,True,0,4 user reviews,3,1,4
1307910,True,0,No user reviews,0,0,0
1307950,True,0,No user reviews,0,0,0
1307960,True,0,No user reviews,0,0,0
1307970,True,0,No user reviews,0,0,0
1308010,True,0,No user reviews,0,0,0
1308020,True,0,No user reviews,0,0,0
1308030,True,0,No user reviews,0,0,0
1308040,True,0,3 user reviews,3,0,3
1308060,True,0,1 user reviews,0,1,1
1308070,True,0,No user reviews,0,0,0
1308090,True,5,Mixed,142,159,301
1308110,True,0,2 user reviews,2,0,2
1308130,True,0,8 user reviews,1,7,8
1308140,True,0,2 user reviews,1,1,2
1308150,True,0,No user reviews,0,0,0
1308160,True,0,No user reviews,0,0,0
1308170,True,0,6 user reviews,4,2,6
1308180,True,5,Mixed,25,20,45
1308181,True,5,Mixed,21,25,46
1308182,True,8,Very Positive,59,9,68
1308183,True,8,Very Positive,59,4,63
1308200,True,0,No user reviews,0,0,0
1308210,True,0,No user reviews,0,0,0
1308240,True,0,6 user reviews,6,0,6
1308250,True,0,8 user reviews,8,0,8
1308260,True,0,No user reviews,0,0,0
1308270,True,0,1 user reviews,0,1,1
1308280,True,0,No user reviews,0,0,0
1308290,True,0,No user reviews,0,0,0
1308310,True,0,No user reviews,0,0,0
1308350,True,0,3 user reviews,2,1,3
1308360,True,0,No user reviews,0,0,0
1308410,True,0,No user reviews,0,0,0
1308430,True,0,No user reviews,0,0,0
1308450,True,0,No user reviews,0,0,0
1308470,True,0,No user reviews,0,0,0
1308500,True,0,No user reviews,0,0,0
1308510,True,0,1 user reviews,1,0,1
1308520,True,0,No user reviews,0,0,0
1308530,True,0,No user reviews,0,0,0
1308540,True,0,No user reviews,0,0,0
1308550,True,0,No user reviews,0,0,0
1308560,True,0,3 user reviews,0,3,3
1308570,True,0,No user reviews,0,0,0
1308630,True,0,No user reviews,0,0,0
1308640,True,0,No user reviews,0,0,0
1308650,True,0,No user reviews,0,0,0
1308660,True,0,No user reviews,0,0,0
1308670,True,0,3 user reviews,2,1,3
1308680,True,0,1 user reviews,1,0,1
1308710,True,0,No user reviews,0,0,0
1308740,True,5,Mixed,6,9,15
1308750,True,0,No user reviews,0,0,0
1308760,True,0,9 user reviews,8,1,9
1308770,True,0,1 user reviews,1,0,1
1308780,True,0,2 user reviews,1,1,2
1308790,True,0,1 user reviews,0,1,1
1308800,True,0,No user reviews,0,0,0
1308840,True,0,No user reviews,0,0,0
1308850,True,0,4 user reviews,4,0,4
1308870,True,0,No user reviews,0,0,0
1308880,True,0,No user reviews,0,0,0
1308890,True,0,No user reviews,0,0,0
1308900,True,0,No user reviews,0,0,0
1308910,True,7,Positive,15,0,15
1308920,True,0,1 user reviews,0,1,1
1308940,True,0,No user reviews,0,0,0
1308950,True,0,2 user reviews,0,2,2
1308960,True,0,No user reviews,0,0,0
1308970,True,0,No user reviews,0,0,0
1308980,True,0,3 user reviews,3,0,3
1309010,True,0,No user reviews,0,0,0
1309020,True,0,No user reviews,0,0,0
1309040,True,0,1 user reviews,1,0,1
1309070,True,0,No user reviews,0,0,0
1309080,True,0,No user reviews,0,0,0
1309100,True,0,No user reviews,0,0,0
1309101,True,0,No user reviews,0,0,0
1309110,True,0,No user reviews,0,0,0
1309120,True,0,No user reviews,0,0,0
1309130,True,7,Positive,28,0,28
1309140,True,0,No user reviews,0,0,0
1309150,True,0,No user reviews,0,0,0
1309151,True,0,No user reviews,0,0,0
1309152,True,0,No user reviews,0,0,0
1309153,True,0,No user reviews,0,0,0
1309154,True,0,No user reviews,0,0,0
1309155,True,0,No user reviews,0,0,0
1309156,True,0,No user reviews,0,0,0
1309159,True,0,No user reviews,0,0,0
1309160,True,0,No user reviews,0,0,0
1309170,True,0,1 user reviews,1,0,1
1309180,True,0,No user reviews,0,0,0
1309200,True,7,Positive,11,0,11
1309220,True,0,No user reviews,0,0,0
1309230,True,0,2 user reviews,2,0,2
1309240,True,0,No user reviews,0,0,0
1309250,True,0,No user reviews,0,0,0
1309280,True,0,No user reviews,0,0,0
1309290,True,7,Positive,10,1,11
1309310,True,0,No user reviews,0,0,0
1309340,True,0,No user reviews,0,0,0
1309350,True,0,1 user reviews,1,0,1
1309410,True,0,8 user reviews,6,2,8
1309430,True,0,1 user reviews,1,0,1
1309440,True,0,7 user reviews,6,1,7
1309480,True,0,No user reviews,0,0,0
1309500,True,0,1 user reviews,1,0,1
1309510,True,0,No user reviews,0,0,0
1309550,True,0,No user reviews,0,0,0
1309560,True,0,No user reviews,0,0,0
1309590,True,0,No user reviews,0,0,0
1309600,True,0,No user reviews,0,0,0
1309620,True,0,No user reviews,0,0,0
1309630,True,0,No user reviews,0,0,0
1309640,True,0,No user reviews,0,0,0
1309670,True,0,No user reviews,0,0,0
1309690,True,0,1 user reviews,0,1,1
1309700,True,0,5 user reviews,2,3,5
1309710,True,0,No user reviews,0,0,0
1309720,True,0,No user reviews,0,0,0
1309730,True,0,No user reviews,0,0,0
1309740,True,0,No user reviews,0,0,0
1309790,True,0,No user reviews,0,0,0
1309800,True,0,No user reviews,0,0,0
1309830,True,0,No user reviews,0,0,0
1309850,True,0,No user reviews,0,0,0
1309860,True,0,5 user reviews,5,0,5
1309870,True,0,No user reviews,0,0,0
1309890,True,0,2 user reviews,1,1,2
1309910,True,0,1 user reviews,1,0,1
1309930,True,0,No user reviews,0,0,0
1309940,True,0,9 user reviews,7,2,9
1309980,True,0,2 user reviews,2,0,2
1310000,True,0,No user reviews,0,0,0
1310010,True,5,Mixed,9,4,13
1310030,True,0,No user reviews,0,0,0
1310050,True,0,5 user reviews,4,1,5
1310060,True,0,No user reviews,0,0,0
1310070,True,0,No user reviews,0,0,0
1310080,True,0,No user reviews,0,0,0
1310090,True,0,No user reviews,0,0,0
1310120,True,0,2 user reviews,2,0,2
1310150,True,0,3 user reviews,0,3,3
1310200,True,0,No user reviews,0,0,0
1310210,True,0,6 user reviews,6,0,6
1310220,True,0,No user reviews,0,0,0
1310230,True,0,1 user reviews,1,0,1
1310240,True,0,No user reviews,0,0,0
1310250,True,0,No user reviews,0,0,0
1310260,True,0,No user reviews,0,0,0
1310270,True,0,No user reviews,0,0,0
1310280,True,0,No user reviews,0,0,0
1310290,True,0,9 user reviews,9,0,9
1310330,True,0,No user reviews,0,0,0
1310350,True,0,No user reviews,0,0,0
1310360,True,0,No user reviews,0,0,0
1310390,True,0,No user reviews,0,0,0
1310400,True,0,No user reviews,0,0,0
1310420,True,0,No user reviews,0,0,0
1310430,True,0,No user reviews,0,0,0
1310440,True,0,No user reviews,0,0,0
1310460,True,8,Very Positive,57,5,62
1310470,True,0,2 user reviews,1,1,2
1310480,True,0,1 user reviews,1,0,1
1310500,True,0,No user reviews,0,0,0
1310510,True,8,Very Positive,109,3,112
1310520,True,0,No user reviews,0,0,0
1310530,True,0,No user reviews,0,0,0
1310540,True,0,No user reviews,0,0,0
1310570,True,0,No user reviews,0,0,0
1310590,True,0,No user reviews,0,0,0
1310600,True,0,No user reviews,0,0,0
1310610,True,0,No user reviews,0,0,0
1310620,True,0,No user reviews,0,0,0
1310640,True,0,No user reviews,0,0,0
1310650,True,0,5 user reviews,4,1,5
1310660,True,0,No user reviews,0,0,0
1310680,True,0,No user reviews,0,0,0
1310690,True,0,5 user reviews,5,0,5
1310700,True,0,No user reviews,0,0,0
1310710,True,0,No user reviews,0,0,0
1310720,True,0,No user reviews,0,0,0
1310730,True,0,No user reviews,0,0,0
1310731,True,0,No user reviews,0,0,0
1310750,True,0,No user reviews,0,0,0
1310770,True,0,No user reviews,0,0,0
1310780,True,0,No user reviews,0,0,0
1310790,True,0,No user reviews,0,0,0
1310800,True,0,No user reviews,0,0,0
1310810,True,0,No user reviews,0,0,0
1310820,True,0,No user reviews,0,0,0
1310840,True,0,No user reviews,0,0,0
1310850,True,0,No user reviews,0,0,0
1310860,True,0,No user reviews,0,0,0
1310880,True,0,No user reviews,0,0,0
1310910,True,8,Very Positive,219,44,263
1310920,True,0,No user reviews,0,0,0
1310930,True,0,No user reviews,0,0,0
1310950,True,0,No user reviews,0,0,0
1310960,True,0,No user reviews,0,0,0
1310970,True,0,No user reviews,0,0,0
1310980,True,0,No user reviews,0,0,0
1311000,True,0,No user reviews,0,0,0
1311010,True,0,No user reviews,0,0,0
1311020,True,0,No user reviews,0,0,0
1311040,True,0,No user reviews,0,0,0
1311050,True,0,No user reviews,0,0,0
1311060,True,0,No user reviews,0,0,0
1311070,True,0,No user reviews,0,0,0
1311080,True,0,No user reviews,0,0,0
1311110,True,0,No user reviews,0,0,0
1311140,True,0,No user reviews,0,0,0
1311150,True,0,5 user reviews,3,2,5
1311160,True,0,No user reviews,0,0,0
1311180,True,0,No user reviews,0,0,0
1311190,True,0,3 user reviews,0,3,3
1311210,True,0,No user reviews,0,0,0
1311220,True,0,2 user reviews,1,1,2
1311240,True,0,No user reviews,0,0,0
1311250,True,0,No user reviews,0,0,0
1311260,True,0,No user reviews,0,0,0
1311300,True,0,No user reviews,0,0,0
1311310,True,6,Mostly Positive,8,3,11
1311320,True,0,No user reviews,0,0,0
1311330,True,0,No user reviews,0,0,0
1311400,True,0,1 user reviews,1,0,1
1311440,True,0,No user reviews,0,0,0
1311450,True,0,No user reviews,0,0,0
1311460,True,0,2 user reviews,2,0,2
1311480,True,0,No user reviews,0,0,0
1311500,True,0,No user reviews,0,0,0
1311510,True,0,8 user reviews,8,0,8
1311540,True,0,5 user reviews,3,2,5
1311610,True,0,No user reviews,0,0,0
1311640,True,0,No user reviews,0,0,0
1311650,True,0,4 user reviews,2,2,4
1311660,True,0,No user reviews,0,0,0
1311670,True,0,3 user reviews,3,0,3
1311690,True,0,No user reviews,0,0,0
1311700,True,0,No user reviews,0,0,0
1311730,True,0,No user reviews,0,0,0
1311740,True,7,Positive,15,3,18
1311750,True,0,No user reviews,0,0,0
1311770,True,0,No user reviews,0,0,0
1311780,True,0,No user reviews,0,0,0
1311790,True,0,No user reviews,0,0,0
1311800,True,0,No user reviews,0,0,0
1311810,True,0,No user reviews,0,0,0
1311820,True,0,No user reviews,0,0,0
1311830,True,0,No user reviews,0,0,0
1311850,True,0,No user reviews,0,0,0
1311860,True,0,No user reviews,0,0,0
1311870,True,0,No user reviews,0,0,0
1311890,True,0,No user reviews,0,0,0
1311900,True,0,No user reviews,0,0,0
1311920,True,0,No user reviews,0,0,0
1311930,True,0,No user reviews,0,0,0
1311950,True,0,No user reviews,0,0,0
1311960,True,0,3 user reviews,3,0,3
1311980,True,0,No user reviews,0,0,0
1311990,True,0,1 user reviews,0,1,1
1312000,True,0,No user reviews,0,0,0
1312010,True,0,3 user reviews,2,1,3
1312030,True,0,No user reviews,0,0,0
1312040,True,7,Positive,13,0,13
1312050,True,0,No user reviews,0,0,0
1312060,True,0,No user reviews,0,0,0
1312070,True,0,1 user reviews,0,1,1
1312100,True,0,No user reviews,0,0,0
1312110,True,0,No user reviews,0,0,0
1312120,True,0,No user reviews,0,0,0
1312150,True,0,No user reviews,0,0,0
1312190,True,0,No user reviews,0,0,0
1312210,True,0,No user reviews,0,0,0
1312220,True,0,No user reviews,0,0,0
1312230,True,0,No user reviews,0,0,0
1312250,True,7,Positive,11,2,13
1312270,True,0,No user reviews,0,0,0
1312280,True,0,No user reviews,0,0,0
1312300,True,0,No user reviews,0,0,0
1312310,True,0,No user reviews,0,0,0
1312330,True,0,No user reviews,0,0,0
1312340,True,0,No user reviews,0,0,0
1312350,True,0,No user reviews,0,0,0
1312380,True,0,No user reviews,0,0,0
1312390,True,0,No user reviews,0,0,0
1312400,True,0,No user reviews,0,0,0
1312410,True,0,No user reviews,0,0,0
1312411,True,0,No user reviews,0,0,0
1312412,True,0,No user reviews,0,0,0
1312413,True,0,No user reviews,0,0,0
1312414,True,0,No user reviews,0,0,0
1312420,True,0,No user reviews,0,0,0
1312450,True,0,No user reviews,0,0,0
1312470,True,0,No user reviews,0,0,0
1312510,True,0,No user reviews,0,0,0
1312520,True,0,No user reviews,0,0,0
1312530,True,0,No user reviews,0,0,0
1312540,True,0,No user reviews,0,0,0
1312560,True,0,No user reviews,0,0,0
1312570,True,0,No user reviews,0,0,0
1312580,True,0,No user reviews,0,0,0
1312590,True,0,No user reviews,0,0,0
1312620,True,0,No user reviews,0,0,0
1312640,True,0,No user reviews,0,0,0
1312650,True,0,No user reviews,0,0,0
1312660,True,0,No user reviews,0,0,0
1312680,True,0,No user reviews,0,0,0
1312690,True,0,No user reviews,0,0,0
1312700,True,0,No user reviews,0,0,0
1312710,True,0,No user reviews,0,0,0
1312720,True,0,No user reviews,0,0,0
1312730,True,0,No user reviews,0,0,0
1312740,True,0,No user reviews,0,0,0
1312760,True,0,1 user reviews,1,0,1
1312770,True,0,No user reviews,0,0,0
1312780,True,0,No user reviews,0,0,0
1312800,True,0,No user reviews,0,0,0
1312810,True,0,No user reviews,0,0,0
1312820,True,0,No user reviews,0,0,0
1312830,True,0,No user reviews,0,0,0
1312850,True,0,No user reviews,0,0,0
1312860,True,0,No user reviews,0,0,0
1312870,True,0,No user reviews,0,0,0
1312880,True,0,No user reviews,0,0,0
1312890,True,0,No user reviews,0,0,0
1312940,True,0,4 user reviews,4,0,4
1312950,True,0,3 user reviews,3,0,3
1312960,True,0,No user reviews,0,0,0
1312970,True,0,No user reviews,0,0,0
1312980,True,0,2 user reviews,1,1,2
1312990,True,5,Mixed,8,5,13
1313000,True,0,No user reviews,0,0,0
1313010,True,0,1 user reviews,1,0,1
1313050,True,6,Mostly Positive,7,3,10
1313080,True,0,No user reviews,0,0,0
1313090,True,0,No user reviews,0,0,0
1313100,True,0,No user reviews,0,0,0
1313110,True,0,No user reviews,0,0,0
1313120,True,0,1 user reviews,1,0,1
1313150,True,0,2 user reviews,1,1,2
1313170,True,0,No user reviews,0,0,0
1313190,True,0,No user reviews,0,0,0
1313200,True,0,No user reviews,0,0,0
1313220,True,0,No user reviews,0,0,0
1313230,True,0,No user reviews,0,0,0
1313250,True,0,No user reviews,0,0,0
1313290,True,0,No user reviews,0,0,0
1313300,True,0,No user reviews,0,0,0
1313310,True,0,4 user reviews,3,1,4
1313320,True,0,No user reviews,0,0,0
1313330,True,0,No user reviews,0,0,0
1313340,True,0,No user reviews,0,0,0
1313350,True,0,No user reviews,0,0,0
1313360,True,0,4 user reviews,0,4,4
1313380,True,0,No user reviews,0,0,0
1313390,True,0,No user reviews,0,0,0
1313400,True,0,2 user reviews,1,1,2
1313410,True,0,No user reviews,0,0,0
1313430,True,0,No user reviews,0,0,0
1313440,True,0,No user reviews,0,0,0
1313450,True,0,No user reviews,0,0,0
1313460,True,0,No user reviews,0,0,0
1313470,True,0,5 user reviews,4,1,5
1313480,True,0,No user reviews,0,0,0
1313490,True,7,Positive,14,0,14
1313500,True,0,No user reviews,0,0,0
1313510,True,0,No user reviews,0,0,0
1313530,True,6,Mostly Positive,15,5,20
1313550,True,0,No user reviews,0,0,0
1313560,True,0,5 user reviews,5,0,5
1313580,True,0,No user reviews,0,0,0
1313600,True,0,No user reviews,0,0,0
1313610,True,0,No user reviews,0,0,0
1313630,True,0,No user reviews,0,0,0
1313640,True,0,3 user reviews,3,0,3
1313650,True,0,No user reviews,0,0,0
1313660,True,0,No user reviews,0,0,0
1313680,True,0,No user reviews,0,0,0
1313690,True,0,No user reviews,0,0,0
1313700,True,0,3 user reviews,3,0,3
1313710,True,0,No user reviews,0,0,0
1313720,True,0,No user reviews,0,0,0
1313730,True,0,No user reviews,0,0,0
1313750,True,0,No user reviews,0,0,0
1313780,True,0,No user reviews,0,0,0
1313790,True,0,No user reviews,0,0,0
1313800,True,0,1 user reviews,0,1,1
1313810,True,7,Positive,14,0,14
1313830,True,0,No user reviews,0,0,0
1313840,True,0,No user reviews,0,0,0
1313850,True,0,No user reviews,0,0,0
1313860,True,6,Mostly Positive,956,302,1258
1313870,True,0,No user reviews,0,0,0
1313880,True,0,No user reviews,0,0,0
1313890,True,0,No user reviews,0,0,0
1313900,True,0,No user reviews,0,0,0
1313920,True,0,No user reviews,0,0,0
1313930,True,0,No user reviews,0,0,0
1313940,True,0,No user reviews,0,0,0
1313970,True,0,1 user reviews,1,0,1
1313980,True,0,No user reviews,0,0,0
1313990,True,0,No user reviews,0,0,0
1314010,True,0,No user reviews,0,0,0
1314020,True,0,No user reviews,0,0,0
1314030,True,0,No user reviews,0,0,0
1314040,True,0,No user reviews,0,0,0
1314060,True,0,No user reviews,0,0,0
1314061,True,0,No user reviews,0,0,0
1314062,True,0,No user reviews,0,0,0
1314090,True,0,1 user reviews,1,0,1
1314100,True,0,No user reviews,0,0,0
1314120,True,0,No user reviews,0,0,0
1314130,True,0,No user reviews,0,0,0
1314140,True,6,Mostly Positive,15,4,19
1314160,True,0,No user reviews,0,0,0
1314170,True,0,No user reviews,0,0,0
1314220,True,0,No user reviews,0,0,0
1314260,True,0,No user reviews,0,0,0
1314270,True,0,1 user reviews,1,0,1
1314280,True,0,No user reviews,0,0,0
1314290,True,0,9 user reviews,8,1,9
1314300,True,7,Positive,27,0,27
1314340,True,0,No user reviews,0,0,0
1314350,True,0,No user reviews,0,0,0
1314360,True,0,No user reviews,0,0,0
1314370,True,0,No user reviews,0,0,0
1314380,True,0,No user reviews,0,0,0
1314390,True,0,No user reviews,0,0,0
1314400,True,0,No user reviews,0,0,0
1314410,True,7,Positive,18,4,22
1314440,True,0,1 user reviews,1,0,1
1314460,True,0,No user reviews,0,0,0
1314470,True,0,9 user reviews,9,0,9
1314480,True,0,No user reviews,0,0,0
1314490,True,0,No user reviews,0,0,0
1314500,True,0,3 user reviews,3,0,3
1314540,True,0,1 user reviews,1,0,1
1314550,True,0,No user reviews,0,0,0
1314560,True,0,No user reviews,0,0,0
1314561,True,0,No user reviews,0,0,0
1314562,True,0,No user reviews,0,0,0
1314563,True,0,No user reviews,0,0,0
1314570,True,0,No user reviews,0,0,0
1314580,True,0,No user reviews,0,0,0
1314590,True,6,Mostly Positive,12,4,16
1314600,True,0,1 user reviews,0,1,1
1314610,True,0,No user reviews,0,0,0
1314620,True,0,4 user reviews,3,1,4
1314630,True,0,7 user reviews,5,2,7
1314640,True,0,No user reviews,0,0,0
1314660,True,0,2 user reviews,2,0,2
1314670,True,0,No user reviews,0,0,0
1314680,True,0,1 user reviews,1,0,1
1314690,True,0,No user reviews,0,0,0
1314720,True,0,No user reviews,0,0,0
1314730,True,0,No user reviews,0,0,0
1314740,True,0,No user reviews,0,0,0
1314750,True,0,No user reviews,0,0,0
1314760,True,0,No user reviews,0,0,0
1314761,True,0,No user reviews,0,0,0
1314762,True,0,No user reviews,0,0,0
1314763,True,0,No user reviews,0,0,0
1314764,True,0,No user reviews,0,0,0
1314765,True,0,No user reviews,0,0,0
1314810,True,0,No user reviews,0,0,0
1314820,True,7,Positive,8,2,10
1314830,True,0,2 user reviews,2,0,2
1314840,True,0,No user reviews,0,0,0
1314850,True,0,No user reviews,0,0,0
1314870,True,0,1 user reviews,1,0,1
1314880,True,0,No user reviews,0,0,0
1314900,True,0,No user reviews,0,0,0
1314910,True,0,No user reviews,0,0,0
1314920,True,0,No user reviews,0,0,0
1314930,True,6,Mostly Positive,19,7,26
1314960,True,0,No user reviews,0,0,0
1314970,True,0,No user reviews,0,0,0
1314980,True,0,9 user reviews,9,0,9
1315000,True,0,No user reviews,0,0,0
1315010,True,0,No user reviews,0,0,0
1315020,True,0,No user reviews,0,0,0
1315040,True,0,1 user reviews,1,0,1
1315060,True,0,No user reviews,0,0,0
1315100,True,0,No user reviews,0,0,0
1315120,True,0,No user reviews,0,0,0
1315130,True,0,No user reviews,0,0,0
1315140,True,0,2 user reviews,0,2,2
1315150,True,0,No user reviews,0,0,0
1315160,True,0,No user reviews,0,0,0
1315180,True,0,No user reviews,0,0,0
1315190,True,0,No user reviews,0,0,0
1315200,True,8,Very Positive,83,15,98
1315210,True,0,No user reviews,0,0,0
1315250,True,0,2 user reviews,2,0,2
1315260,True,0,6 user reviews,6,0,6
1315270,True,0,4 user reviews,3,1,4
1315280,True,0,No user reviews,0,0,0
1315290,True,0,No user reviews,0,0,0
1315300,True,7,Positive,43,0,43
1315320,True,0,No user reviews,0,0,0
1315340,True,0,No user reviews,0,0,0
1315350,True,0,5 user reviews,5,0,5
1315370,True,0,No user reviews,0,0,0
1315380,True,0,No user reviews,0,0,0
1315400,True,0,No user reviews,0,0,0
1315420,True,0,No user reviews,0,0,0
1315450,True,0,No user reviews,0,0,0
1315460,True,0,No user reviews,0,0,0
1315490,True,0,No user reviews,0,0,0
1315500,True,0,No user reviews,0,0,0
1315530,True,0,No user reviews,0,0,0
1315540,True,0,No user reviews,0,0,0
1315550,True,0,No user reviews,0,0,0
1315560,True,0,No user reviews,0,0,0
1315570,True,0,1 user reviews,1,0,1
1315580,True,0,No user reviews,0,0,0
1315590,True,0,No user reviews,0,0,0
1315600,True,0,No user reviews,0,0,0
1315610,True,0,No user reviews,0,0,0
1315620,True,0,No user reviews,0,0,0
1315630,True,0,1 user reviews,1,0,1
1315640,True,0,No user reviews,0,0,0
1315650,True,0,8 user reviews,5,3,8
1315660,True,0,3 user reviews,2,1,3
1315670,True,0,No user reviews,0,0,0
1315680,True,0,No user reviews,0,0,0
1315690,True,0,No user reviews,0,0,0
1315700,True,0,No user reviews,0,0,0
1315710,True,0,3 user reviews,3,0,3
1315760,True,0,No user reviews,0,0,0
1315780,True,0,No user reviews,0,0,0
1315800,True,0,No user reviews,0,0,0
1315801,True,0,No user reviews,0,0,0
1315802,True,0,No user reviews,0,0,0
1315803,True,0,No user reviews,0,0,0
1315804,True,0,No user reviews,0,0,0
1315805,True,0,No user reviews,0,0,0
1315806,True,0,No user reviews,0,0,0
1315807,True,0,2 user reviews,2,0,2
1315808,True,0,1 user reviews,1,0,1
1315809,True,0,4 user reviews,4,0,4
1315810,True,0,1 user reviews,1,0,1
1315820,True,0,No user reviews,0,0,0
1315830,True,0,No user reviews,0,0,0
1315850,True,0,No user reviews,0,0,0
1315860,True,0,5 user reviews,5,0,5
1315870,True,0,3 user reviews,3,0,3
1315871,True,0,4 user reviews,4,0,4
1315872,True,0,No user reviews,0,0,0
1315873,True,0,No user reviews,0,0,0
1315874,True,0,No user reviews,0,0,0
1315875,True,0,No user reviews,0,0,0
1315876,True,0,No user reviews,0,0,0
1315877,True,0,No user reviews,0,0,0
1315878,True,0,No user reviews,0,0,0
1315880,True,0,No user reviews,0,0,0
1315890,True,0,2 user reviews,1,1,2
1315900,True,0,1 user reviews,1,0,1
1315920,True,0,No user reviews,0,0,0
1315970,True,0,No user reviews,0,0,0
1315980,True,0,5 user reviews,5,0,5
1316000,True,0,7 user reviews,3,4,7
1316010,True,0,No user reviews,0,0,0
1316020,True,0,1 user reviews,1,0,1
1316021,True,0,5 user reviews,5,0,5
1316022,True,0,No user reviews,0,0,0
1316023,True,0,No user reviews,0,0,0
1316024,True,0,No user reviews,0,0,0
1316025,True,0,No user reviews,0,0,0
1316026,True,0,No user reviews,0,0,0
1316027,True,0,No user reviews,0,0,0
1316028,True,0,No user reviews,0,0,0
1316029,True,0,1 user reviews,1,0,1
1316050,True,7,Positive,11,0,11
1316060,True,0,1 user reviews,0,1,1
1316070,True,0,1 user reviews,1,0,1
1316071,True,0,No user reviews,0,0,0
1316072,True,0,No user reviews,0,0,0
1316073,True,0,No user reviews,0,0,0
1316074,True,0,No user reviews,0,0,0
1316075,True,0,1 user reviews,1,0,1
1316076,True,0,No user reviews,0,0,0
1316080,True,0,No user reviews,0,0,0
1316100,True,0,No user reviews,0,0,0
1316110,True,0,9 user reviews,9,0,9
1316120,True,0,No user reviews,0,0,0
1316130,True,0,1 user reviews,1,0,1
1316140,True,0,No user reviews,0,0,0
1316141,True,0,2 user reviews,2,0,2
1316142,True,0,No user reviews,0,0,0
1316143,True,0,No user reviews,0,0,0
1316144,True,0,1 user reviews,0,1,1
1316145,True,0,No user reviews,0,0,0
1316146,True,0,No user reviews,0,0,0
1316150,True,0,No user reviews,0,0,0
1316160,True,0,No user reviews,0,0,0
1316200,True,7,Positive,13,1,14
1316220,True,0,No user reviews,0,0,0
1316240,True,0,No user reviews,0,0,0
1316241,True,0,1 user reviews,1,0,1
1316242,True,0,No user reviews,0,0,0
1316250,True,0,No user reviews,0,0,0
1316260,True,0,No user reviews,0,0,0
1316261,True,0,No user reviews,0,0,0
1316262,True,0,No user reviews,0,0,0
1316263,True,0,No user reviews,0,0,0
1316264,True,0,1 user reviews,1,0,1
1316265,True,0,No user reviews,0,0,0
1316270,True,0,No user reviews,0,0,0
1316271,True,0,No user reviews,0,0,0
1316272,True,0,No user reviews,0,0,0
1316273,True,0,1 user reviews,1,0,1
1316274,True,0,1 user reviews,1,0,1
1316275,True,0,No user reviews,0,0,0
1316280,True,0,No user reviews,0,0,0
1316290,True,0,4 user reviews,4,0,4
1316310,True,0,No user reviews,0,0,0
1316320,True,0,No user reviews,0,0,0
1316330,True,0,No user reviews,0,0,0
1316340,True,0,No user reviews,0,0,0
1316350,True,0,No user reviews,0,0,0
1316390,True,8,Very Positive,63,2,65
1316410,True,0,No user reviews,0,0,0
1316420,True,0,No user reviews,0,0,0
1316440,True,0,No user reviews,0,0,0
1316450,True,0,No user reviews,0,0,0
1316470,True,0,No user reviews,0,0,0
1316520,True,0,No user reviews,0,0,0
1316540,True,0,No user reviews,0,0,0
1316550,True,0,2 user reviews,2,0,2
1316560,True,0,No user reviews,0,0,0
1316570,True,0,6 user reviews,5,1,6
1316580,True,0,No user reviews,0,0,0
1316590,True,0,No user reviews,0,0,0
1316600,True,0,1 user reviews,1,0,1
1316610,True,0,No user reviews,0,0,0
1316620,True,0,No user reviews,0,0,0
1316630,True,0,No user reviews,0,0,0
1316640,True,0,No user reviews,0,0,0
1316660,True,0,No user reviews,0,0,0
1316670,True,0,5 user reviews,4,1,5
1316680,True,0,No user reviews,0,0,0
1316690,True,0,No user reviews,0,0,0
1316700,True,7,Positive,37,1,38
1316710,True,0,No user reviews,0,0,0
1316740,True,7,Positive,19,2,21
1316750,True,0,No user reviews,0,0,0
1316760,True,5,Mixed,19,19,38
1316770,True,0,1 user reviews,1,0,1
1316790,True,0,No user reviews,0,0,0
1316800,True,7,Positive,14,1,15
1316810,True,0,No user reviews,0,0,0
1316820,True,0,No user reviews,0,0,0
1316830,True,0,1 user reviews,1,0,1
1316840,True,5,Mixed,93,48,141
1316870,True,0,5 user reviews,3,2,5
1316880,True,0,2 user reviews,2,0,2
1316890,True,0,No user reviews,0,0,0
1316900,True,0,No user reviews,0,0,0
1316920,True,0,No user reviews,0,0,0
1316930,True,0,No user reviews,0,0,0
1316940,True,0,No user reviews,0,0,0
1316950,True,0,No user reviews,0,0,0
1316960,True,0,No user reviews,0,0,0
1316970,True,0,No user reviews,0,0,0
1316980,True,0,No user reviews,0,0,0
1316990,True,0,No user reviews,0,0,0
1317030,True,0,No user reviews,0,0,0
1317050,True,0,No user reviews,0,0,0
1317070,True,0,2 user reviews,2,0,2
1317080,True,0,1 user reviews,0,1,1
1317090,True,0,No user reviews,0,0,0
1317110,True,0,No user reviews,0,0,0
1317120,True,0,No user reviews,0,0,0
1317130,True,0,No user reviews,0,0,0
1317140,True,0,No user reviews,0,0,0
1317160,True,7,Positive,41,0,41
1317170,True,0,No user reviews,0,0,0
1317190,True,0,No user reviews,0,0,0
1317200,True,6,Mostly Positive,17,5,22
1317220,True,0,No user reviews,0,0,0
1317230,True,5,Mixed,49,33,82
1317250,True,6,Mostly Positive,35,12,47
1317260,True,0,No user reviews,0,0,0
1317270,True,0,No user reviews,0,0,0
1317280,True,0,No user reviews,0,0,0
1317300,True,0,No user reviews,0,0,0
1317310,True,0,3 user reviews,3,0,3
1317320,True,0,No user reviews,0,0,0
1317350,True,0,No user reviews,0,0,0
1317360,True,0,No user reviews,0,0,0
1317370,True,0,No user reviews,0,0,0
1317380,True,0,No user reviews,0,0,0
1317410,True,0,No user reviews,0,0,0
1317430,True,0,No user reviews,0,0,0
1317440,True,0,No user reviews,0,0,0
1317470,True,0,No user reviews,0,0,0
1317471,True,0,No user reviews,0,0,0
1317472,True,0,No user reviews,0,0,0
1317473,True,0,No user reviews,0,0,0
1317474,True,0,No user reviews,0,0,0
1317475,True,0,No user reviews,0,0,0
1317476,True,0,No user reviews,0,0,0
1317481,True,0,No user reviews,0,0,0
1317482,True,0,No user reviews,0,0,0
1317483,True,0,No user reviews,0,0,0
1317484,True,0,No user reviews,0,0,0
1317485,True,0,No user reviews,0,0,0
1317486,True,0,No user reviews,0,0,0
1317487,True,0,No user reviews,0,0,0
1317488,True,0,No user reviews,0,0,0
1317489,True,0,No user reviews,0,0,0
1317490,True,0,No user reviews,0,0,0
1317491,True,0,No user reviews,0,0,0
1317493,True,0,No user reviews,0,0,0
1317494,True,0,No user reviews,0,0,0
1317495,True,0,No user reviews,0,0,0
1317500,True,0,No user reviews,0,0,0
1317510,True,0,No user reviews,0,0,0
1317520,True,0,No user reviews,0,0,0
1317540,True,0,No user reviews,0,0,0
1317800,True,0,1 user reviews,0,1,1
1317840,True,0,No user reviews,0,0,0
1317850,True,0,No user reviews,0,0,0
1317870,True,0,No user reviews,0,0,0
1317880,True,0,No user reviews,0,0,0
1317890,True,0,No user reviews,0,0,0
1317910,True,0,No user reviews,0,0,0
1317920,True,0,No user reviews,0,0,0
1317950,True,0,4 user reviews,4,0,4
1317970,True,0,5 user reviews,4,1,5
1317990,True,0,No user reviews,0,0,0
1318000,True,0,1 user reviews,1,0,1
1318010,True,0,No user reviews,0,0,0
1318020,True,0,No user reviews,0,0,0
1318030,True,0,9 user reviews,8,1,9
1318040,True,0,No user reviews,0,0,0
1318070,True,0,No user reviews,0,0,0
1318080,True,0,No user reviews,0,0,0
1318090,True,8,Very Positive,249,13,262
1318110,True,0,3 user reviews,3,0,3
1318130,True,0,1 user reviews,1,0,1
1318140,True,0,No user reviews,0,0,0
1318150,True,0,2 user reviews,0,2,2
1318160,True,0,No user reviews,0,0,0
1318170,True,0,1 user reviews,1,0,1
1318190,True,0,No user reviews,0,0,0
1318210,True,0,No user reviews,0,0,0
1318240,True,0,No user reviews,0,0,0
1318290,True,0,3 user reviews,1,2,3
1318300,True,0,2 user reviews,2,0,2
1318310,True,0,No user reviews,0,0,0
1318320,True,0,No user reviews,0,0,0
1318330,True,0,No user reviews,0,0,0
1318340,True,0,No user reviews,0,0,0
1318350,True,0,No user reviews,0,0,0
1318360,True,0,No user reviews,0,0,0
1318370,True,0,No user reviews,0,0,0
1318380,True,0,No user reviews,0,0,0
1318410,True,0,No user reviews,0,0,0
1318420,True,0,No user reviews,0,0,0
1318430,True,0,No user reviews,0,0,0
1318440,True,0,No user reviews,0,0,0
1318450,True,0,No user reviews,0,0,0
1318460,True,0,No user reviews,0,0,0
1318470,True,0,No user reviews,0,0,0
1318490,True,0,No user reviews,0,0,0
1318530,True,0,No user reviews,0,0,0
1318540,True,0,No user reviews,0,0,0
1318550,True,0,No user reviews,0,0,0
1318560,True,0,7 user reviews,7,0,7
1318610,True,0,No user reviews,0,0,0
1318640,True,0,No user reviews,0,0,0
1318650,True,0,No user reviews,0,0,0
1318690,True,9,Overwhelmingly Positive,1890,47,1937
1318710,True,0,No user reviews,0,0,0
1318720,True,0,No user reviews,0,0,0
1318730,True,0,No user reviews,0,0,0
1318740,True,0,No user reviews,0,0,0
1318760,True,0,No user reviews,0,0,0
1318770,True,0,No user reviews,0,0,0
1318800,True,7,Positive,22,0,22
1318810,True,0,No user reviews,0,0,0
1318820,True,0,No user reviews,0,0,0
1318830,True,0,No user reviews,0,0,0
1318840,True,0,No user reviews,0,0,0
1318850,True,0,No user reviews,0,0,0
1318870,True,0,1 user reviews,1,0,1
1318880,True,0,No user reviews,0,0,0
1318890,True,0,No user reviews,0,0,0
1318900,True,0,No user reviews,0,0,0
1318910,True,0,No user reviews,0,0,0
1318930,True,0,No user reviews,0,0,0
1318940,True,0,No user reviews,0,0,0
1318950,True,0,No user reviews,0,0,0
1318960,True,0,No user reviews,0,0,0
1318980,True,0,No user reviews,0,0,0
1318990,True,0,No user reviews,0,0,0
1319000,True,0,No user reviews,0,0,0
1319020,True,0,No user reviews,0,0,0
1319040,True,0,No user reviews,0,0,0
1319050,True,0,No user reviews,0,0,0
1319070,True,0,No user reviews,0,0,0
1319080,True,0,No user reviews,0,0,0
1319090,True,0,No user reviews,0,0,0
1319100,True,0,No user reviews,0,0,0
1319110,True,0,No user reviews,0,0,0
1319120,True,0,No user reviews,0,0,0
1319160,True,0,No user reviews,0,0,0
1319170,True,0,No user reviews,0,0,0
1319190,True,0,No user reviews,0,0,0
1319210,True,0,No user reviews,0,0,0
1319220,True,0,1 user reviews,1,0,1
1319240,True,0,No user reviews,0,0,0
1319260,True,0,No user reviews,0,0,0
1319270,True,0,No user reviews,0,0,0
1319290,True,0,5 user reviews,3,2,5
1319310,True,0,No user reviews,0,0,0
1319320,True,0,No user reviews,0,0,0
1319340,True,0,No user reviews,0,0,0
1319360,True,0,No user reviews,0,0,0
1319390,True,0,No user reviews,0,0,0
1319400,True,0,No user reviews,0,0,0
1319410,True,0,No user reviews,0,0,0
1319420,True,0,No user reviews,0,0,0
1319430,True,0,No user reviews,0,0,0
1319440,True,0,No user reviews,0,0,0
1319450,True,0,No user reviews,0,0,0
1319460,True,0,No user reviews,0,0,0
1319470,True,0,No user reviews,0,0,0
1319480,True,0,No user reviews,0,0,0
1319490,True,0,No user reviews,0,0,0
1319540,True,0,No user reviews,0,0,0
1319550,True,0,No user reviews,0,0,0
1319560,True,0,No user reviews,0,0,0
1319570,True,0,No user reviews,0,0,0
1319580,True,0,No user reviews,0,0,0
1319600,True,0,No user reviews,0,0,0
1319640,True,0,No user reviews,0,0,0
1319660,True,0,No user reviews,0,0,0
1319690,True,0,2 user reviews,2,0,2
1319720,True,0,No user reviews,0,0,0
1319740,True,0,No user reviews,0,0,0
1319750,True,0,5 user reviews,4,1,5
1319770,True,0,No user reviews,0,0,0
1319790,True,0,No user reviews,0,0,0
1319810,True,0,No user reviews,0,0,0
1319850,True,0,No user reviews,0,0,0
1319860,True,0,No user reviews,0,0,0
1319870,True,0,1 user reviews,0,1,1
1319880,True,0,1 user reviews,1,0,1
1319900,True,0,No user reviews,0,0,0
1319910,True,0,No user reviews,0,0,0
1319990,True,0,No user reviews,0,0,0
1320000,True,0,No user reviews,0,0,0
1320010,True,0,No user reviews,0,0,0
1320030,True,0,No user reviews,0,0,0
1320040,True,0,No user reviews,0,0,0
1320050,True,0,No user reviews,0,0,0
1320070,True,0,No user reviews,0,0,0
1320090,True,0,No user reviews,0,0,0
1320100,True,0,No user reviews,0,0,0
1320130,True,0,No user reviews,0,0,0
1320160,True,0,No user reviews,0,0,0
1320170,True,0,No user reviews,0,0,0
1320180,True,0,No user reviews,0,0,0
1320190,True,0,No user reviews,0,0,0
1320200,True,0,No user reviews,0,0,0
1320210,True,0,No user reviews,0,0,0
1320220,True,0,No user reviews,0,0,0
1320230,True,0,No user reviews,0,0,0
1320240,True,0,3 user reviews,3,0,3
1320270,True,0,No user reviews,0,0,0
1320290,True,0,No user reviews,0,0,0
1320300,True,0,No user reviews,0,0,0
1320330,True,0,No user reviews,0,0,0
1320340,True,0,No user reviews,0,0,0
1320350,True,0,No user reviews,0,0,0
1320370,True,0,No user reviews,0,0,0
1320380,True,0,No user reviews,0,0,0
1320390,True,0,No user reviews,0,0,0
1320400,True,0,2 user reviews,2,0,2
1320450,True,0,No user reviews,0,0,0
1320480,True,0,No user reviews,0,0,0
1320490,True,0,No user reviews,0,0,0
1320500,True,0,No user reviews,0,0,0
1320510,True,0,1 user reviews,1,0,1
1320520,True,0,1 user reviews,1,0,1
1320540,True,0,No user reviews,0,0,0
1320550,True,0,No user reviews,0,0,0
1320570,True,0,No user reviews,0,0,0
1320590,True,0,No user reviews,0,0,0
1320600,True,0,No user reviews,0,0,0
1320610,True,0,No user reviews,0,0,0
1320620,True,0,No user reviews,0,0,0
1320630,True,0,No user reviews,0,0,0
1320660,True,0,No user reviews,0,0,0
1320680,True,0,No user reviews,0,0,0
1320710,True,0,No user reviews,0,0,0
1320720,True,0,No user reviews,0,0,0
1320740,True,0,No user reviews,0,0,0
1320750,True,0,No user reviews,0,0,0
1320800,True,0,No user reviews,0,0,0
1320810,True,0,No user reviews,0,0,0
1320820,True,0,4 user reviews,4,0,4
1320830,True,0,1 user reviews,1,0,1
1320840,True,0,No user reviews,0,0,0
1320850,True,0,8 user reviews,7,1,8
1320860,True,0,No user reviews,0,0,0
1320870,True,0,No user reviews,0,0,0
1320900,True,0,No user reviews,0,0,0
1320920,True,0,No user reviews,0,0,0
1320930,True,0,No user reviews,0,0,0
1320940,True,0,1 user reviews,0,1,1
1320950,True,8,Very Positive,51,8,59
1320960,True,0,No user reviews,0,0,0
1320970,True,0,No user reviews,0,0,0
1320980,True,0,No user reviews,0,0,0
1320990,True,0,2 user reviews,1,1,2
1321000,True,0,No user reviews,0,0,0
1321010,True,0,4 user reviews,4,0,4
1321030,True,0,5 user reviews,5,0,5
1321040,True,0,No user reviews,0,0,0
1321050,True,0,No user reviews,0,0,0
1321060,True,0,No user reviews,0,0,0
1321070,True,8,Very Positive,99,18,117
1321080,True,0,No user reviews,0,0,0
1321100,True,0,No user reviews,0,0,0
1321110,True,0,1 user reviews,1,0,1
1321120,True,0,No user reviews,0,0,0
1321130,True,0,No user reviews,0,0,0
1321140,True,0,No user reviews,0,0,0
1321150,True,0,No user reviews,0,0,0
1321160,True,0,No user reviews,0,0,0
1321190,True,0,No user reviews,0,0,0
1321200,True,0,No user reviews,0,0,0
1321210,True,0,No user reviews,0,0,0
1321230,True,7,Positive,25,0,25
1321240,True,0,No user reviews,0,0,0
1321250,True,0,No user reviews,0,0,0
1321260,True,0,No user reviews,0,0,0
1321270,True,8,Very Positive,56,2,58
1321280,True,0,No user reviews,0,0,0
1321290,True,0,No user reviews,0,0,0
1321300,True,0,No user reviews,0,0,0
1321310,True,0,No user reviews,0,0,0
1321330,True,0,No user reviews,0,0,0
1321340,True,0,No user reviews,0,0,0
1321350,True,0,1 user reviews,1,0,1
1321360,True,0,No user reviews,0,0,0
1321370,True,0,No user reviews,0,0,0
1321380,True,0,No user reviews,0,0,0
1321390,True,0,No user reviews,0,0,0
1321400,True,0,4 user reviews,4,0,4
1321410,True,0,No user reviews,0,0,0
1321420,True,0,No user reviews,0,0,0
1321430,True,0,No user reviews,0,0,0
1321440,True,0,No user reviews,0,0,0
1321450,True,0,No user reviews,0,0,0
1321470,True,0,No user reviews,0,0,0
1321480,True,0,No user reviews,0,0,0
1321490,True,0,No user reviews,0,0,0
1321500,True,0,No user reviews,0,0,0
1321510,True,0,No user reviews,0,0,0
1321520,True,0,No user reviews,0,0,0
1321560,True,0,No user reviews,0,0,0
1321580,True,0,3 user reviews,3,0,3
1321590,True,0,1 user reviews,1,0,1
1321630,True,0,No user reviews,0,0,0
1321640,True,0,No user reviews,0,0,0
1321650,True,0,No user reviews,0,0,0
1321670,True,0,No user reviews,0,0,0
1321680,True,0,No user reviews,0,0,0
1321710,True,0,No user reviews,0,0,0
1321720,True,0,No user reviews,0,0,0
1321730,True,0,No user reviews,0,0,0
1321740,True,0,No user reviews,0,0,0
1321750,True,0,No user reviews,0,0,0
1321760,True,0,1 user reviews,1,0,1
1321770,True,0,6 user reviews,6,0,6
1321820,True,0,No user reviews,0,0,0
1321830,True,0,No user reviews,0,0,0
1321840,True,0,No user reviews,0,0,0
1321850,True,0,No user reviews,0,0,0
1321860,True,0,No user reviews,0,0,0
1321870,True,0,No user reviews,0,0,0
1321890,True,0,No user reviews,0,0,0
1321900,True,0,No user reviews,0,0,0
1321920,True,0,7 user reviews,3,4,7
1321930,True,0,No user reviews,0,0,0
1321950,True,0,No user reviews,0,0,0
1321960,True,0,No user reviews,0,0,0
1322010,True,0,7 user reviews,7,0,7
1322020,True,0,No user reviews,0,0,0
1322080,True,0,1 user reviews,1,0,1
1322090,True,0,No user reviews,0,0,0
1322130,True,0,No user reviews,0,0,0
1322140,True,0,No user reviews,0,0,0
1322150,True,0,No user reviews,0,0,0
1322170,True,7,Positive,37,2,39
1322180,True,0,8 user reviews,8,0,8
1322200,True,0,No user reviews,0,0,0
1322210,True,0,No user reviews,0,0,0
1322230,True,0,No user reviews,0,0,0
1322240,True,0,No user reviews,0,0,0
1322250,True,7,Positive,10,0,10
1322260,True,0,8 user reviews,7,1,8
1322270,True,0,8 user reviews,6,2,8
1322280,True,0,3 user reviews,1,2,3
1322290,True,0,1 user reviews,1,0,1
1322300,True,0,No user reviews,0,0,0
1322310,True,0,7 user reviews,6,1,7
1322320,True,0,No user reviews,0,0,0
1322330,True,0,1 user reviews,1,0,1
1322340,True,0,No user reviews,0,0,0
1322360,True,0,No user reviews,0,0,0
1322380,True,0,No user reviews,0,0,0
1322390,True,0,No user reviews,0,0,0
1322400,True,0,No user reviews,0,0,0
1322420,True,0,No user reviews,0,0,0
1322470,True,0,2 user reviews,2,0,2
1322480,True,0,No user reviews,0,0,0
1322490,True,0,1 user reviews,1,0,1
1322510,True,0,No user reviews,0,0,0
1322511,True,0,No user reviews,0,0,0
1322512,True,0,No user reviews,0,0,0
1322520,True,0,No user reviews,0,0,0
1322540,True,0,No user reviews,0,0,0
1322550,True,0,No user reviews,0,0,0
1322560,True,0,No user reviews,0,0,0
1322570,True,0,No user reviews,0,0,0
1322580,True,0,No user reviews,0,0,0
1322600,True,7,Positive,13,1,14
1322620,True,0,No user reviews,0,0,0
1322630,True,0,No user reviews,0,0,0
1322640,True,7,Positive,18,3,21
1322650,True,8,Very Positive,64,5,69
1322660,True,0,No user reviews,0,0,0
1322670,True,0,No user reviews,0,0,0
1322690,True,0,No user reviews,0,0,0
1322710,True,0,No user reviews,0,0,0
1322720,True,0,No user reviews,0,0,0
1322730,True,0,5 user reviews,4,1,5
1322740,True,0,No user reviews,0,0,0
1322750,True,0,No user reviews,0,0,0
1322760,True,0,No user reviews,0,0,0
1322790,True,0,1 user reviews,1,0,1
1322791,True,0,No user reviews,0,0,0
1322792,True,0,No user reviews,0,0,0
1322793,True,0,1 user reviews,1,0,1
1322794,True,0,1 user reviews,1,0,1
1322795,True,0,No user reviews,0,0,0
1322796,True,0,No user reviews,0,0,0
1322797,True,0,2 user reviews,1,1,2
1322798,True,0,No user reviews,0,0,0
1322800,True,0,No user reviews,0,0,0
1322810,True,0,No user reviews,0,0,0
1322840,True,0,No user reviews,0,0,0
1322850,True,0,No user reviews,0,0,0
1322860,True,0,No user reviews,0,0,0
1322870,True,0,No user reviews,0,0,0
1322880,True,0,No user reviews,0,0,0
1322890,True,0,No user reviews,0,0,0
1322920,True,0,No user reviews,0,0,0
1322930,True,0,No user reviews,0,0,0
1322940,True,0,No user reviews,0,0,0
1322950,True,0,No user reviews,0,0,0
1322980,True,0,No user reviews,0,0,0
1323000,True,7,Positive,20,0,20
1323010,True,0,No user reviews,0,0,0
1323020,True,0,No user reviews,0,0,0
1323040,True,0,No user reviews,0,0,0
1323060,True,0,No user reviews,0,0,0
1323070,True,0,No user reviews,0,0,0
1323080,True,0,No user reviews,0,0,0
1323090,True,0,No user reviews,0,0,0
1323110,True,0,No user reviews,0,0,0
1323120,True,0,No user reviews,0,0,0
1323140,True,0,No user reviews,0,0,0
1323150,True,0,No user reviews,0,0,0
1323160,True,0,No user reviews,0,0,0
1323170,True,0,No user reviews,0,0,0
1323190,True,0,No user reviews,0,0,0
1323200,True,0,No user reviews,0,0,0
1323210,True,0,7 user reviews,6,1,7
1323220,True,0,1 user reviews,1,0,1
1323240,True,0,3 user reviews,1,2,3
1323260,True,0,No user reviews,0,0,0
1323280,True,0,No user reviews,0,0,0
1323290,True,0,No user reviews,0,0,0
1323310,True,0,No user reviews,0,0,0
1323320,True,7,Positive,34,1,35
1323330,True,0,No user reviews,0,0,0
1323340,True,0,No user reviews,0,0,0
1323350,True,0,No user reviews,0,0,0
1323360,True,0,No user reviews,0,0,0
1323370,True,0,No user reviews,0,0,0
1323410,True,0,No user reviews,0,0,0
1323420,True,8,Very Positive,143,16,159
1323430,True,0,No user reviews,0,0,0
1323450,True,0,No user reviews,0,0,0
1323480,True,0,No user reviews,0,0,0
1323500,True,0,No user reviews,0,0,0
1323510,True,0,No user reviews,0,0,0
1323520,True,0,No user reviews,0,0,0
1323540,True,0,No user reviews,0,0,0
1323550,True,0,No user reviews,0,0,0
1323560,True,0,No user reviews,0,0,0
1323570,True,0,No user reviews,0,0,0
1323580,True,0,No user reviews,0,0,0
1323590,True,0,No user reviews,0,0,0
1323600,True,0,8 user reviews,8,0,8
1323610,True,0,5 user reviews,5,0,5
1323620,True,6,Mostly Positive,40,13,53
1323640,True,0,No user reviews,0,0,0
1323650,True,0,No user reviews,0,0,0
1323670,True,0,No user reviews,0,0,0
1323680,True,0,No user reviews,0,0,0
1323690,True,0,No user reviews,0,0,0
1323700,True,0,No user reviews,0,0,0
1323710,True,0,No user reviews,0,0,0
1323720,True,0,No user reviews,0,0,0
1323750,True,0,No user reviews,0,0,0
1323770,True,0,4 user reviews,4,0,4
1323780,True,0,No user reviews,0,0,0
1323800,True,0,No user reviews,0,0,0
1323810,True,0,No user reviews,0,0,0
1323830,True,0,No user reviews,0,0,0
1323850,True,0,No user reviews,0,0,0
1323860,True,0,2 user reviews,1,1,2
1323870,True,0,No user reviews,0,0,0
1323890,True,0,No user reviews,0,0,0
1323900,True,0,No user reviews,0,0,0
1323910,True,0,1 user reviews,1,0,1
1323930,True,0,No user reviews,0,0,0
1323950,True,0,No user reviews,0,0,0
1323970,True,0,No user reviews,0,0,0
1323980,True,0,No user reviews,0,0,0
1324000,True,7,Positive,15,0,15
1324010,True,0,3 user reviews,0,3,3
1324020,True,0,No user reviews,0,0,0
1324030,True,0,7 user reviews,7,0,7
1324040,True,0,1 user reviews,1,0,1
1324060,True,0,3 user reviews,2,1,3
1324070,True,0,No user reviews,0,0,0
1324100,True,0,No user reviews,0,0,0
1324140,True,5,Mixed,7,8,15
1324160,True,6,Mostly Positive,7,3,10
1324190,True,0,No user reviews,0,0,0
1324210,True,0,No user reviews,0,0,0
1324220,True,0,No user reviews,0,0,0
1324230,True,0,No user reviews,0,0,0
1324240,True,0,No user reviews,0,0,0
1324250,True,0,No user reviews,0,0,0
1324260,True,0,No user reviews,0,0,0
1324270,True,0,2 user reviews,1,1,2
1324280,True,0,No user reviews,0,0,0
1324290,True,0,No user reviews,0,0,0
1324300,True,0,No user reviews,0,0,0
1324310,True,0,No user reviews,0,0,0
1324320,True,0,No user reviews,0,0,0
1324360,True,0,7 user reviews,5,2,7
1324390,True,0,No user reviews,0,0,0
1324400,True,0,No user reviews,0,0,0
1324410,True,0,No user reviews,0,0,0
1324420,True,0,9 user reviews,7,2,9
1324430,True,0,No user reviews,0,0,0
1324440,True,0,No user reviews,0,0,0
1324470,True,7,Positive,9,1,10
1324480,True,0,No user reviews,0,0,0
1324490,True,0,1 user reviews,1,0,1
1324510,True,0,No user reviews,0,0,0
1324520,True,0,No user reviews,0,0,0
1324540,True,0,No user reviews,0,0,0
1324560,True,0,No user reviews,0,0,0
1324580,True,0,No user reviews,0,0,0
1324590,True,0,No user reviews,0,0,0
1324600,True,0,No user reviews,0,0,0
1324640,True,0,No user reviews,0,0,0
1324660,True,0,No user reviews,0,0,0
1324670,True,0,No user reviews,0,0,0
1324680,True,0,No user reviews,0,0,0
1324690,True,0,No user reviews,0,0,0
1324700,True,0,No user reviews,0,0,0
1324710,True,0,No user reviews,0,0,0
1324730,True,0,1 user reviews,0,1,1
1324740,True,0,No user reviews,0,0,0
1324741,True,0,No user reviews,0,0,0
1324760,True,0,No user reviews,0,0,0
1324780,True,0,No user reviews,0,0,0
1324800,True,0,No user reviews,0,0,0
1324830,True,0,No user reviews,0,0,0
1324850,True,0,No user reviews,0,0,0
1324860,True,0,No user reviews,0,0,0
1324870,True,0,8 user reviews,8,0,8
1324880,True,0,No user reviews,0,0,0
1324910,True,0,No user reviews,0,0,0
1324920,True,0,No user reviews,0,0,0
1324930,True,0,No user reviews,0,0,0
1324960,True,0,No user reviews,0,0,0
1324970,True,8,Very Positive,278,48,326
1324980,True,0,No user reviews,0,0,0
1324990,True,0,No user reviews,0,0,0
1325000,True,0,No user reviews,0,0,0
1325010,True,0,No user reviews,0,0,0
1325020,True,0,No user reviews,0,0,0
1325030,True,0,1 user reviews,0,1,1
1325040,True,0,No user reviews,0,0,0
1325050,True,0,No user reviews,0,0,0
1325060,True,0,No user reviews,0,0,0
1325080,True,0,No user reviews,0,0,0
1325090,True,0,No user reviews,0,0,0
1325100,True,0,No user reviews,0,0,0
1325110,True,0,No user reviews,0,0,0
1325150,True,0,No user reviews,0,0,0
1325160,True,0,No user reviews,0,0,0
1325220,True,0,No user reviews,0,0,0
1325230,True,0,No user reviews,0,0,0
1325240,True,0,No user reviews,0,0,0
1325250,True,0,No user reviews,0,0,0
1325270,True,0,No user reviews,0,0,0
1325310,True,0,No user reviews,0,0,0
1325330,True,0,No user reviews,0,0,0
1325340,True,0,No user reviews,0,0,0
1325350,True,0,No user reviews,0,0,0
1325360,True,0,No user reviews,0,0,0
1325370,True,0,1 user reviews,1,0,1
1325380,True,0,1 user reviews,1,0,1
1325390,True,0,No user reviews,0,0,0
1325400,True,0,2 user reviews,2,0,2
1325440,True,0,No user reviews,0,0,0
1325460,True,0,No user reviews,0,0,0
1325470,True,0,3 user reviews,3,0,3
1325490,True,0,No user reviews,0,0,0
1325510,True,0,No user reviews,0,0,0
1325520,True,0,1 user reviews,1,0,1
1325590,True,0,No user reviews,0,0,0
1325600,True,0,No user reviews,0,0,0
1325610,True,0,No user reviews,0,0,0
1325630,True,0,No user reviews,0,0,0
1325650,True,0,No user reviews,0,0,0
1325660,True,0,No user reviews,0,0,0
1325670,True,0,No user reviews,0,0,0
1325690,True,0,No user reviews,0,0,0
1325700,True,0,1 user reviews,1,0,1
1325710,True,0,No user reviews,0,0,0
1325730,True,0,2 user reviews,2,0,2
1325740,True,0,No user reviews,0,0,0
1325750,True,0,No user reviews,0,0,0
1325760,True,0,No user reviews,0,0,0
1325770,True,0,No user reviews,0,0,0
1325780,True,0,No user reviews,0,0,0
1325790,True,0,4 user reviews,4,0,4
1325800,True,5,Mixed,28,21,49
1325810,True,0,No user reviews,0,0,0
1325820,True,0,No user reviews,0,0,0
1325830,True,0,No user reviews,0,0,0
1325840,True,0,No user reviews,0,0,0
1325850,True,0,No user reviews,0,0,0
1325870,True,0,3 user reviews,3,0,3
1325900,True,0,No user reviews,0,0,0
1325940,True,0,No user reviews,0,0,0
1325960,True,0,4 user reviews,0,4,4
1325970,True,0,4 user reviews,3,1,4
1325980,True,0,No user reviews,0,0,0
1325990,True,0,No user reviews,0,0,0
1326000,True,7,Positive,19,4,23
1326010,True,0,No user reviews,0,0,0
1326020,True,0,No user reviews,0,0,0
1326040,True,0,No user reviews,0,0,0
1326070,True,0,No user reviews,0,0,0
1326080,True,0,No user reviews,0,0,0
1326090,True,0,No user reviews,0,0,0
1326100,True,0,No user reviews,0,0,0
1326120,True,0,No user reviews,0,0,0
1326130,True,0,No user reviews,0,0,0
1326140,True,0,No user reviews,0,0,0
1326150,True,0,No user reviews,0,0,0
1326160,True,0,No user reviews,0,0,0
1326170,True,0,No user reviews,0,0,0
1326180,True,0,No user reviews,0,0,0
1326200,True,0,No user reviews,0,0,0
1326210,True,0,No user reviews,0,0,0
1326220,True,0,No user reviews,0,0,0
1326230,True,0,No user reviews,0,0,0
1326250,True,0,No user reviews,0,0,0
1326270,True,0,No user reviews,0,0,0
1326280,True,0,No user reviews,0,0,0
1326290,True,0,No user reviews,0,0,0
1326300,True,0,No user reviews,0,0,0
1326310,True,0,No user reviews,0,0,0
1326320,True,0,No user reviews,0,0,0
1326330,True,0,No user reviews,0,0,0
1326350,True,0,No user reviews,0,0,0
1326370,True,0,No user reviews,0,0,0
1326380,True,0,No user reviews,0,0,0
1326390,True,0,No user reviews,0,0,0
1326400,True,0,No user reviews,0,0,0
1326410,True,0,No user reviews,0,0,0
1326430,True,0,No user reviews,0,0,0
1326440,True,0,No user reviews,0,0,0
1326450,True,0,No user reviews,0,0,0
1326460,True,0,No user reviews,0,0,0
1326480,True,0,No user reviews,0,0,0
1326490,True,0,No user reviews,0,0,0
1326530,True,0,No user reviews,0,0,0
1326540,True,0,No user reviews,0,0,0
1326550,True,0,No user reviews,0,0,0
1326560,True,0,No user reviews,0,0,0
1326570,True,0,No user reviews,0,0,0
1326580,True,0,No user reviews,0,0,0
1326590,True,0,No user reviews,0,0,0
1326620,True,0,No user reviews,0,0,0
1326630,True,0,No user reviews,0,0,0
1326650,True,0,No user reviews,0,0,0
1326660,True,0,4 user reviews,4,0,4
1326680,True,0,No user reviews,0,0,0
1326690,True,0,No user reviews,0,0,0
1326700,True,0,No user reviews,0,0,0
1326710,True,0,No user reviews,0,0,0
1326720,True,0,No user reviews,0,0,0
1326730,True,0,No user reviews,0,0,0
1326750,True,0,No user reviews,0,0,0
1326770,True,0,No user reviews,0,0,0
1326790,True,0,No user reviews,0,0,0
1326800,True,0,No user reviews,0,0,0
1326820,True,0,No user reviews,0,0,0
1326840,True,0,No user reviews,0,0,0
1326860,True,0,No user reviews,0,0,0
1326870,True,0,3 user reviews,3,0,3
1326880,True,0,No user reviews,0,0,0
1326900,True,0,No user reviews,0,0,0
1326920,True,0,1 user reviews,1,0,1
1326980,True,0,No user reviews,0,0,0
1327020,True,0,No user reviews,0,0,0
1327030,True,0,No user reviews,0,0,0
1327040,True,0,No user reviews,0,0,0
1327060,True,0,No user reviews,0,0,0
1327070,True,0,No user reviews,0,0,0
1327080,True,0,No user reviews,0,0,0
1327090,True,0,No user reviews,0,0,0
1327100,True,0,1 user reviews,1,0,1
1327110,True,0,No user reviews,0,0,0
1327120,True,0,No user reviews,0,0,0
1327140,True,0,No user reviews,0,0,0
1327160,True,0,No user reviews,0,0,0
1327170,True,0,No user reviews,0,0,0
1327180,True,0,No user reviews,0,0,0
1327200,True,0,No user reviews,0,0,0
1327220,True,0,No user reviews,0,0,0
1327240,True,0,No user reviews,0,0,0
1327250,True,0,No user reviews,0,0,0
1327260,True,0,3 user reviews,1,2,3
1327270,True,0,No user reviews,0,0,0
1327300,True,0,No user reviews,0,0,0
1327310,True,0,No user reviews,0,0,0
1327341,True,7,Positive,17,2,19
1327360,True,0,No user reviews,0,0,0
1327370,True,0,4 user reviews,4,0,4
1327380,True,0,No user reviews,0,0,0
1327390,True,0,3 user reviews,2,1,3
1327410,True,0,No user reviews,0,0,0
1327420,True,0,No user reviews,0,0,0
1327450,True,0,2 user reviews,0,2,2
1327460,True,0,No user reviews,0,0,0
1327480,True,0,No user reviews,0,0,0
1327490,True,0,No user reviews,0,0,0
1327500,True,0,No user reviews,0,0,0
1327520,True,0,No user reviews,0,0,0
1327530,True,0,No user reviews,0,0,0
1327540,True,0,3 user reviews,3,0,3
1327550,True,0,No user reviews,0,0,0
1327560,True,0,No user reviews,0,0,0
1327590,True,0,No user reviews,0,0,0
1327600,True,0,No user reviews,0,0,0
1327620,True,0,No user reviews,0,0,0
1327670,True,0,No user reviews,0,0,0
1327680,True,0,No user reviews,0,0,0
1327690,True,0,No user reviews,0,0,0
1327720,True,0,2 user reviews,2,0,2
1327750,True,0,No user reviews,0,0,0
1327770,True,0,No user reviews,0,0,0
1327790,True,0,No user reviews,0,0,0
1327800,True,0,No user reviews,0,0,0
1327810,True,0,3 user reviews,3,0,3
1327820,True,7,Positive,19,0,19
1327850,True,0,No user reviews,0,0,0
1327860,True,0,No user reviews,0,0,0
1327870,True,0,4 user reviews,4,0,4
1327890,True,0,No user reviews,0,0,0
1327891,True,0,No user reviews,0,0,0
1327900,True,0,No user reviews,0,0,0
1327910,True,0,No user reviews,0,0,0
1327970,True,0,No user reviews,0,0,0
1327990,True,0,No user reviews,0,0,0
1328010,True,0,No user reviews,0,0,0
1328020,True,0,No user reviews,0,0,0
1328030,True,0,No user reviews,0,0,0
1328031,True,0,No user reviews,0,0,0
1328032,True,0,No user reviews,0,0,0
1328050,True,0,No user reviews,0,0,0
1328080,True,0,No user reviews,0,0,0
1328160,True,0,No user reviews,0,0,0
1328170,True,0,8 user reviews,7,1,8
1328180,True,0,No user reviews,0,0,0
1328190,True,0,No user reviews,0,0,0
1328220,True,0,No user reviews,0,0,0
1328240,True,0,No user reviews,0,0,0
1328250,True,0,No user reviews,0,0,0
1328260,True,0,No user reviews,0,0,0
1328290,True,0,No user reviews,0,0,0
1328310,True,0,No user reviews,0,0,0
1328320,True,0,No user reviews,0,0,0
1328340,True,0,No user reviews,0,0,0
1328341,True,0,No user reviews,0,0,0
1328360,True,0,No user reviews,0,0,0
1328370,True,0,No user reviews,0,0,0
1328390,True,0,No user reviews,0,0,0
1328410,True,0,4 user reviews,4,0,4
1328420,True,0,No user reviews,0,0,0
1328421,True,0,1 user reviews,0,1,1
1328430,True,0,No user reviews,0,0,0
1328450,True,0,No user reviews,0,0,0
1328460,True,0,No user reviews,0,0,0
1328470,True,0,1 user reviews,1,0,1
1328490,True,0,No user reviews,0,0,0
1328500,True,0,1 user reviews,1,0,1
1328530,True,0,No user reviews,0,0,0
1328540,True,0,No user reviews,0,0,0
1328550,True,0,No user reviews,0,0,0
1328560,True,0,5 user reviews,5,0,5
1328570,True,7,Positive,15,0,15
1328580,True,0,No user reviews,0,0,0
1328590,True,0,No user reviews,0,0,0
1328600,True,0,No user reviews,0,0,0
1328610,True,0,No user reviews,0,0,0
1328620,True,0,No user reviews,0,0,0
1328640,True,0,No user reviews,0,0,0
1328650,True,0,No user reviews,0,0,0
1328660,True,0,No user reviews,0,0,0
1328680,True,0,No user reviews,0,0,0
1328690,True,0,No user reviews,0,0,0
1328710,True,0,No user reviews,0,0,0
1328720,True,0,No user reviews,0,0,0
1328750,True,0,2 user reviews,2,0,2
1328760,True,0,No user reviews,0,0,0
1328780,True,0,No user reviews,0,0,0
1328800,True,0,No user reviews,0,0,0
1328810,True,0,5 user reviews,5,0,5
1328830,True,0,2 user reviews,2,0,2
1328840,True,0,No user reviews,0,0,0
1328850,True,0,No user reviews,0,0,0
1328870,True,0,No user reviews,0,0,0
1328880,True,0,No user reviews,0,0,0
1328890,True,7,Positive,27,0,27
1328900,True,0,No user reviews,0,0,0
1328910,True,6,Mostly Positive,8,3,11
1328920,True,5,Mixed,8,5,13
1328930,True,0,No user reviews,0,0,0
1328950,True,0,No user reviews,0,0,0
1328960,True,0,No user reviews,0,0,0
1329020,True,0,No user reviews,0,0,0
1329050,True,0,No user reviews,0,0,0
1329060,True,0,No user reviews,0,0,0
1329070,True,0,No user reviews,0,0,0
1329080,True,0,4 user reviews,4,0,4
1329090,True,0,No user reviews,0,0,0
1329110,True,0,No user reviews,0,0,0
1329120,True,0,No user reviews,0,0,0
1329130,True,0,No user reviews,0,0,0
1329140,True,0,No user reviews,0,0,0
1329150,True,0,No user reviews,0,0,0
1329160,True,0,No user reviews,0,0,0
1329180,True,0,No user reviews,0,0,0
1329190,True,0,3 user reviews,3,0,3
1329210,True,0,No user reviews,0,0,0
1329240,True,0,No user reviews,0,0,0
1329250,True,0,No user reviews,0,0,0
1329270,True,0,No user reviews,0,0,0
1329280,True,0,No user reviews,0,0,0
1329310,True,0,No user reviews,0,0,0
1329320,True,0,3 user reviews,2,1,3
1329350,True,0,No user reviews,0,0,0
1329360,True,0,No user reviews,0,0,0
1329380,True,0,No user reviews,0,0,0
1329390,True,0,No user reviews,0,0,0
1329400,True,0,No user reviews,0,0,0
1329410,True,0,No user reviews,0,0,0
1329420,True,0,1 user reviews,1,0,1
1329430,True,0,No user reviews,0,0,0
1329440,True,0,1 user reviews,1,0,1
1329450,True,0,1 user reviews,0,1,1
1329460,True,0,No user reviews,0,0,0
1329470,True,0,2 user reviews,2,0,2
1329480,True,0,No user reviews,0,0,0
1329490,True,0,No user reviews,0,0,0
1329510,True,5,Mixed,46,28,74
1329530,True,0,4 user reviews,1,3,4
1329540,True,8,Very Positive,58,5,63
1329559,True,0,No user reviews,0,0,0
1329560,True,5,Mixed,11,11,22
1329570,True,0,No user reviews,0,0,0
1329571,True,0,No user reviews,0,0,0
1329572,True,0,No user reviews,0,0,0
1329573,True,0,3 user reviews,2,1,3
1329580,True,0,No user reviews,0,0,0
1329590,True,0,2 user reviews,2,0,2
1329600,True,7,Positive,24,5,29
1329630,True,0,1 user reviews,1,0,1
1329650,True,0,No user reviews,0,0,0
1329660,True,0,No user reviews,0,0,0
1329740,True,0,No user reviews,0,0,0
1329780,True,0,No user reviews,0,0,0
1329790,True,0,No user reviews,0,0,0
1329800,True,0,No user reviews,0,0,0
1329810,True,0,No user reviews,0,0,0
1329830,True,0,1 user reviews,0,1,1
1329850,True,0,2 user reviews,0,2,2
1329870,True,0,No user reviews,0,0,0
1329880,True,0,No user reviews,0,0,0
1329900,True,0,No user reviews,0,0,0
1329970,True,0,No user reviews,0,0,0
1329990,True,0,1 user reviews,0,1,1
1330000,True,0,No user reviews,0,0,0
1330010,True,0,2 user reviews,2,0,2
1330040,True,5,Mixed,144,90,234
1330070,True,0,No user reviews,0,0,0
1330080,True,0,No user reviews,0,0,0
1330090,True,0,No user reviews,0,0,0
1330100,True,0,No user reviews,0,0,0
1330110,True,0,No user reviews,0,0,0
1330120,True,0,No user reviews,0,0,0
1330130,True,0,1 user reviews,1,0,1
1330140,True,0,1 user reviews,1,0,1
1330150,True,0,1 user reviews,1,0,1
1330160,True,0,2 user reviews,2,0,2
1330170,True,0,4 user reviews,3,1,4
1330180,True,0,2 user reviews,1,1,2
1330190,True,7,Positive,20,1,21
1330210,True,0,No user reviews,0,0,0
1330211,True,0,No user reviews,0,0,0
1330212,True,0,1 user reviews,1,0,1
1330213,True,0,No user reviews,0,0,0
1330214,True,0,No user reviews,0,0,0
1330215,True,0,No user reviews,0,0,0
1330216,True,0,1 user reviews,1,0,1
1330217,True,0,No user reviews,0,0,0
1330218,True,0,No user reviews,0,0,0
1330219,True,0,No user reviews,0,0,0
1330240,True,0,No user reviews,0,0,0
1330250,True,0,No user reviews,0,0,0
1330290,True,0,No user reviews,0,0,0
1330300,True,0,1 user reviews,1,0,1
1330320,True,0,No user reviews,0,0,0
1330330,True,0,5 user reviews,5,0,5
1330360,True,0,No user reviews,0,0,0
1330370,True,0,No user reviews,0,0,0
1330380,True,0,4 user reviews,4,0,4
1330400,True,0,No user reviews,0,0,0
1330410,True,0,No user reviews,0,0,0
1330420,True,0,9 user reviews,9,0,9
1330430,True,0,No user reviews,0,0,0
1330450,True,0,No user reviews,0,0,0
1330460,True,0,No user reviews,0,0,0
1330470,True,0,No user reviews,0,0,0
1330480,True,7,Positive,12,1,13
1330500,True,0,No user reviews,0,0,0
1330510,True,0,No user reviews,0,0,0
1330550,True,7,Positive,25,0,25
1330560,True,0,No user reviews,0,0,0
1330570,True,0,2 user reviews,2,0,2
1330590,True,0,No user reviews,0,0,0
1330600,True,0,No user reviews,0,0,0
1330602,True,0,No user reviews,0,0,0
1330610,True,0,4 user reviews,3,1,4
1330620,True,0,No user reviews,0,0,0
1330630,True,0,6 user reviews,6,0,6
1330710,True,0,1 user reviews,0,1,1
1330720,True,0,1 user reviews,1,0,1
1330721,True,0,No user reviews,0,0,0
1330730,True,5,Mixed,13,6,19
1330750,True,0,No user reviews,0,0,0
1330760,True,0,1 user reviews,1,0,1
1330770,True,0,No user reviews,0,0,0
1330790,True,0,No user reviews,0,0,0
1330800,True,0,2 user reviews,1,1,2
1330810,True,0,No user reviews,0,0,0
1330820,True,0,No user reviews,0,0,0
1330840,True,0,No user reviews,0,0,0
1330850,True,0,No user reviews,0,0,0
1330890,True,8,Very Positive,50,2,52
1330900,True,0,No user reviews,0,0,0
1330910,True,0,No user reviews,0,0,0
1330920,True,0,1 user reviews,1,0,1
1330930,True,0,No user reviews,0,0,0
1330940,True,0,1 user reviews,1,0,1
1330960,True,0,No user reviews,0,0,0
1330970,True,0,No user reviews,0,0,0
1330990,True,0,No user reviews,0,0,0
1331000,True,0,1 user reviews,1,0,1
1331001,True,0,No user reviews,0,0,0
1331002,True,0,No user reviews,0,0,0
1331010,True,0,No user reviews,0,0,0
1331011,True,0,2 user reviews,2,0,2
1331020,True,0,2 user reviews,2,0,2
1331021,True,0,No user reviews,0,0,0
1331030,True,0,No user reviews,0,0,0
1331040,True,0,No user reviews,0,0,0
1331050,True,0,No user reviews,0,0,0
1331060,True,0,No user reviews,0,0,0
1331070,True,0,No user reviews,0,0,0
1331090,True,0,3 user reviews,3,0,3
1331110,True,0,No user reviews,0,0,0
1331111,True,0,No user reviews,0,0,0
1331112,True,0,No user reviews,0,0,0
1331113,True,0,No user reviews,0,0,0
1331114,True,0,No user reviews,0,0,0
1331115,True,0,No user reviews,0,0,0
1331120,True,0,No user reviews,0,0,0
1331130,True,0,No user reviews,0,0,0
1331140,True,0,No user reviews,0,0,0
1331150,True,0,No user reviews,0,0,0
1331160,True,0,No user reviews,0,0,0
1331170,True,0,No user reviews,0,0,0
1331200,True,0,No user reviews,0,0,0
1331210,True,0,No user reviews,0,0,0
1331220,True,0,1 user reviews,1,0,1
1331221,True,0,3 user reviews,0,3,3
1331240,True,0,No user reviews,0,0,0
1331260,True,0,No user reviews,0,0,0
1331270,True,7,Positive,10,0,10
1331280,True,0,No user reviews,0,0,0
1331290,True,0,No user reviews,0,0,0
1331330,True,0,8 user reviews,6,2,8
1331340,True,0,No user reviews,0,0,0
1331370,True,0,No user reviews,0,0,0
1331390,True,0,No user reviews,0,0,0
1331400,True,0,No user reviews,0,0,0
1331410,True,0,No user reviews,0,0,0
1331420,True,0,No user reviews,0,0,0
1331440,True,0,No user reviews,0,0,0
1331460,True,0,No user reviews,0,0,0
1331470,True,0,No user reviews,0,0,0
1331480,True,0,No user reviews,0,0,0
1331520,True,0,No user reviews,0,0,0
1331530,True,0,No user reviews,0,0,0
1331540,True,0,No user reviews,0,0,0
1331560,True,0,No user reviews,0,0,0
1331590,True,0,No user reviews,0,0,0
1331600,True,0,No user reviews,0,0,0
1331620,True,0,2 user reviews,2,0,2
1331650,True,0,3 user reviews,3,0,3
1331660,True,0,No user reviews,0,0,0
1331670,True,0,No user reviews,0,0,0
1331710,True,0,No user reviews,0,0,0
1331720,True,0,No user reviews,0,0,0
1331730,True,0,No user reviews,0,0,0
1331740,True,0,No user reviews,0,0,0
1331750,True,0,No user reviews,0,0,0
1331760,True,0,No user reviews,0,0,0
1331770,True,0,No user reviews,0,0,0
1331780,True,0,No user reviews,0,0,0
1331790,True,0,No user reviews,0,0,0
1331800,True,0,No user reviews,0,0,0
1331810,True,0,No user reviews,0,0,0
1331820,True,0,No user reviews,0,0,0
1331821,True,0,1 user reviews,1,0,1
1331830,True,0,No user reviews,0,0,0
1331860,True,0,No user reviews,0,0,0
1331880,True,0,No user reviews,0,0,0
1331900,True,0,No user reviews,0,0,0
1331930,True,0,No user reviews,0,0,0
1332010,True,0,No user reviews,0,0,0
1332020,True,0,No user reviews,0,0,0
1332040,True,0,No user reviews,0,0,0
1332120,True,0,2 user reviews,2,0,2
1332150,True,0,No user reviews,0,0,0
1332200,True,0,No user reviews,0,0,0
1332210,True,0,No user reviews,0,0,0
1332230,True,0,No user reviews,0,0,0
1332250,True,0,No user reviews,0,0,0
1332280,True,0,No user reviews,0,0,0
1332290,True,0,No user reviews,0,0,0
1332350,True,0,No user reviews,0,0,0
1332360,True,0,No user reviews,0,0,0
1332370,True,0,No user reviews,0,0,0
1332380,True,0,No user reviews,0,0,0
1332390,True,0,No user reviews,0,0,0
1332400,True,0,No user reviews,0,0,0
1332420,True,0,1 user reviews,0,1,1
1332440,True,0,No user reviews,0,0,0
1332450,True,0,No user reviews,0,0,0
1332470,True,0,No user reviews,0,0,0
1332480,True,0,No user reviews,0,0,0
1332530,True,0,No user reviews,0,0,0
1332540,True,0,1 user reviews,1,0,1
1332550,True,0,No user reviews,0,0,0
1332570,True,0,4 user reviews,3,1,4
1332580,True,0,No user reviews,0,0,0
1332590,True,0,6 user reviews,4,2,6
1332600,True,0,No user reviews,0,0,0
1332610,True,0,2 user reviews,0,2,2
1332620,True,6,Mostly Positive,8,3,11
1332630,True,0,2 user reviews,2,0,2
1332670,True,0,No user reviews,0,0,0
1332680,True,0,No user reviews,0,0,0
1332681,True,0,No user reviews,0,0,0
1332682,True,0,No user reviews,0,0,0
1332683,True,0,No user reviews,0,0,0
1332684,True,0,No user reviews,0,0,0
1332685,True,0,No user reviews,0,0,0
1332690,True,0,No user reviews,0,0,0
1332730,True,0,No user reviews,0,0,0
1332760,True,0,No user reviews,0,0,0
1332790,True,0,No user reviews,0,0,0
1332800,True,0,2 user reviews,2,0,2
1332810,True,0,No user reviews,0,0,0
1332840,True,0,No user reviews,0,0,0
1332850,True,0,No user reviews,0,0,0
1332860,True,7,Positive,22,1,23
1332890,True,7,Positive,9,1,10
1332940,True,0,1 user reviews,1,0,1
1332970,True,7,Positive,24,0,24
1332980,True,0,No user reviews,0,0,0
1333010,True,0,No user reviews,0,0,0
1333020,True,0,5 user reviews,5,0,5
1333030,True,0,No user reviews,0,0,0
1333050,True,0,No user reviews,0,0,0
1333060,True,0,No user reviews,0,0,0
1333070,True,0,No user reviews,0,0,0
1333090,True,0,No user reviews,0,0,0
1333140,True,0,No user reviews,0,0,0
1333173,True,0,4 user reviews,4,0,4
1333174,True,0,No user reviews,0,0,0
1333175,True,0,No user reviews,0,0,0
1333176,True,0,No user reviews,0,0,0
1333177,True,0,No user reviews,0,0,0
1333178,True,0,No user reviews,0,0,0
1333179,True,0,No user reviews,0,0,0
1333190,True,0,5 user reviews,5,0,5
1333210,True,0,No user reviews,0,0,0
1333220,True,5,Mixed,59,86,145
1333270,True,0,No user reviews,0,0,0
1333330,True,6,Mostly Positive,9,3,12
1333340,True,0,No user reviews,0,0,0
1333350,True,0,No user reviews,0,0,0
1333360,True,7,Positive,21,4,25
1333370,True,0,No user reviews,0,0,0
1333380,True,0,No user reviews,0,0,0
1333390,True,0,2 user reviews,2,0,2
1333400,True,0,No user reviews,0,0,0
1333410,True,0,No user reviews,0,0,0
1333420,True,0,No user reviews,0,0,0
1333430,True,0,No user reviews,0,0,0
1333460,True,7,Positive,13,0,13
1333470,True,0,No user reviews,0,0,0
1333480,True,0,No user reviews,0,0,0
1333500,True,0,No user reviews,0,0,0
1333510,True,0,2 user reviews,1,1,2
1333520,True,0,No user reviews,0,0,0
1333540,True,0,1 user reviews,0,1,1
1333550,True,0,No user reviews,0,0,0
1333570,True,0,1 user reviews,1,0,1
1333590,True,0,No user reviews,0,0,0
1333620,True,0,No user reviews,0,0,0
1333640,True,0,No user reviews,0,0,0
1333650,True,0,No user reviews,0,0,0
1333700,True,0,No user reviews,0,0,0
1333740,True,0,No user reviews,0,0,0
1333741,True,0,No user reviews,0,0,0
1333760,True,0,No user reviews,0,0,0
1333770,True,0,No user reviews,0,0,0
1333800,True,0,No user reviews,0,0,0
1333810,True,0,No user reviews,0,0,0
1333820,True,0,No user reviews,0,0,0
1333840,True,0,No user reviews,0,0,0
1333850,True,8,Very Positive,65,2,67
1333860,True,0,2 user reviews,2,0,2
1333870,True,0,No user reviews,0,0,0
1333890,True,7,Positive,15,0,15
1333900,True,0,1 user reviews,1,0,1
1333910,True,0,No user reviews,0,0,0
1333920,True,0,No user reviews,0,0,0
1333930,True,0,No user reviews,0,0,0
1333940,True,0,No user reviews,0,0,0
1333950,True,0,No user reviews,0,0,0
1333960,True,0,No user reviews,0,0,0
1333980,True,0,No user reviews,0,0,0
1333990,True,0,No user reviews,0,0,0
1334000,True,8,Very Positive,67,10,77
1334010,True,6,Mostly Positive,50,14,64
1334020,True,0,3 user reviews,2,1,3
1334030,True,0,No user reviews,0,0,0
1334040,True,6,Mostly Positive,17,5,22
1334050,True,0,No user reviews,0,0,0
1334070,True,0,6 user reviews,3,3,6
1334090,True,0,No user reviews,0,0,0
1334110,True,0,No user reviews,0,0,0
1334120,True,0,No user reviews,0,0,0
1334150,True,0,No user reviews,0,0,0
1334160,True,0,No user reviews,0,0,0
1334170,True,0,No user reviews,0,0,0
1334200,True,0,No user reviews,0,0,0
1334210,True,0,No user reviews,0,0,0
1334230,True,0,No user reviews,0,0,0
1334240,True,0,No user reviews,0,0,0
1334270,True,0,No user reviews,0,0,0
1334300,True,0,9 user reviews,9,0,9
1334310,True,0,No user reviews,0,0,0
1334330,True,0,3 user reviews,3,0,3
1334360,True,0,No user reviews,0,0,0
1334370,True,0,No user reviews,0,0,0
1334380,True,0,No user reviews,0,0,0
1334400,True,0,No user reviews,0,0,0
1334410,True,0,No user reviews,0,0,0
1334420,True,0,No user reviews,0,0,0
1334430,True,0,No user reviews,0,0,0
1334460,True,0,No user reviews,0,0,0
1334480,True,0,No user reviews,0,0,0
1334490,True,0,2 user reviews,2,0,2
1334510,True,0,2 user reviews,2,0,2
1334530,True,0,No user reviews,0,0,0
1334560,True,0,No user reviews,0,0,0
1334580,True,0,No user reviews,0,0,0
1334590,True,8,Very Positive,219,30,249
1334610,True,0,4 user reviews,4,0,4
1334620,True,0,No user reviews,0,0,0
1334630,True,0,No user reviews,0,0,0
1334650,True,0,No user reviews,0,0,0
1334680,True,0,No user reviews,0,0,0
1334700,True,7,Positive,17,0,17
1334710,True,0,No user reviews,0,0,0
1334730,True,0,No user reviews,0,0,0
1334750,True,0,1 user reviews,0,1,1
1334760,True,0,No user reviews,0,0,0
1334770,True,0,No user reviews,0,0,0
1334780,True,0,No user reviews,0,0,0
1334790,True,0,No user reviews,0,0,0
1334791,True,0,No user reviews,0,0,0
1334792,True,0,No user reviews,0,0,0
1334800,True,0,No user reviews,0,0,0
1334830,True,0,2 user reviews,2,0,2
1334840,True,5,Mixed,6,7,13
1334870,True,0,No user reviews,0,0,0
1334890,True,0,No user reviews,0,0,0
1334900,True,0,No user reviews,0,0,0
1334910,True,0,No user reviews,0,0,0
1334930,True,0,No user reviews,0,0,0
1334970,True,0,1 user reviews,1,0,1
1334990,True,0,No user reviews,0,0,0
1335020,True,0,No user reviews,0,0,0
1335030,True,0,No user reviews,0,0,0
1335050,True,0,No user reviews,0,0,0
1335070,True,0,1 user reviews,1,0,1
1335080,True,0,3 user reviews,3,0,3
1335090,True,0,8 user reviews,7,1,8
1335100,True,0,4 user reviews,4,0,4
1335110,True,0,7 user reviews,7,0,7
1335120,True,0,No user reviews,0,0,0
1335130,True,0,No user reviews,0,0,0
1335140,True,0,2 user reviews,2,0,2
1335150,True,0,1 user reviews,1,0,1
1335160,True,0,3 user reviews,3,0,3
1335170,True,0,2 user reviews,2,0,2
1335190,True,0,No user reviews,0,0,0
1335200,True,0,No user reviews,0,0,0
1335210,True,0,No user reviews,0,0,0
1335230,True,0,No user reviews,0,0,0
1335240,True,0,3 user reviews,2,1,3
1335270,True,0,No user reviews,0,0,0
1335290,True,0,9 user reviews,9,0,9
1335300,True,0,2 user reviews,1,1,2
1335340,True,0,No user reviews,0,0,0
1335350,True,0,1 user reviews,1,0,1
1335370,True,0,No user reviews,0,0,0
1335400,True,0,2 user reviews,1,1,2
1335410,True,0,2 user reviews,0,2,2
1335430,True,0,1 user reviews,1,0,1
1335440,True,7,Positive,10,1,11
1335470,True,0,No user reviews,0,0,0
1335480,True,0,No user reviews,0,0,0
1335510,True,0,2 user reviews,1,1,2
1335530,True,0,No user reviews,0,0,0
1335560,True,0,No user reviews,0,0,0
1335580,True,0,No user reviews,0,0,0
1335600,True,0,2 user reviews,2,0,2
1335620,True,0,No user reviews,0,0,0
1335650,True,0,No user reviews,0,0,0
1335680,True,0,No user reviews,0,0,0
1335690,True,0,No user reviews,0,0,0
1335700,True,0,No user reviews,0,0,0
1335740,True,0,No user reviews,0,0,0
1335750,True,0,No user reviews,0,0,0
1335790,True,0,No user reviews,0,0,0
1335800,True,0,No user reviews,0,0,0
1335810,True,7,Positive,16,2,18
1335820,True,0,8 user reviews,8,0,8
1335830,True,0,No user reviews,0,0,0
1335840,True,0,7 user reviews,7,0,7
1335870,True,0,No user reviews,0,0,0
1335880,True,0,4 user reviews,3,1,4
1335890,True,0,No user reviews,0,0,0
1335910,True,0,No user reviews,0,0,0
1335960,True,0,No user reviews,0,0,0
1335970,True,0,3 user reviews,2,1,3
1335980,True,0,No user reviews,0,0,0
1335990,True,0,No user reviews,0,0,0
1336020,True,0,No user reviews,0,0,0
1336040,True,0,1 user reviews,1,0,1
1336050,True,0,No user reviews,0,0,0
1336060,True,7,Positive,37,0,37
1336080,True,0,No user reviews,0,0,0
1336100,True,0,1 user reviews,1,0,1
1336110,True,0,No user reviews,0,0,0
1336120,True,0,No user reviews,0,0,0
1336130,True,0,1 user reviews,0,1,1
1336140,True,0,No user reviews,0,0,0
1336150,True,0,No user reviews,0,0,0
1336160,True,0,2 user reviews,2,0,2
1336170,True,0,1 user reviews,1,0,1
1336210,True,0,No user reviews,0,0,0
1336230,True,0,1 user reviews,1,0,1
1336240,True,0,No user reviews,0,0,0
1336260,True,0,No user reviews,0,0,0
1336270,True,0,No user reviews,0,0,0
1336290,True,0,No user reviews,0,0,0
1336340,True,7,Positive,23,0,23
1336350,True,0,No user reviews,0,0,0
1336380,True,0,No user reviews,0,0,0
1336390,True,0,No user reviews,0,0,0
1336400,True,0,No user reviews,0,0,0
1336410,True,0,No user reviews,0,0,0
1336420,True,0,1 user reviews,1,0,1
1336430,True,7,Positive,22,3,25
1336440,True,0,1 user reviews,1,0,1
1336450,True,0,No user reviews,0,0,0
1336460,True,0,1 user reviews,1,0,1
1336480,True,0,No user reviews,0,0,0
1336481,True,0,1 user reviews,1,0,1
1336482,True,0,4 user reviews,4,0,4
1336483,True,0,No user reviews,0,0,0
1336484,True,0,1 user reviews,1,0,1
1336490,True,0,No user reviews,0,0,0
1336500,True,0,No user reviews,0,0,0
1336540,True,0,No user reviews,0,0,0
1336550,True,0,No user reviews,0,0,0
1336560,True,5,Mixed,23,11,34
1336570,True,0,No user reviews,0,0,0
1336590,True,0,No user reviews,0,0,0
1336610,True,0,No user reviews,0,0,0
1336620,True,0,No user reviews,0,0,0
1336700,True,0,No user reviews,0,0,0
1336710,True,0,No user reviews,0,0,0
1336711,True,0,No user reviews,0,0,0
1336720,True,0,No user reviews,0,0,0
1336740,True,0,No user reviews,0,0,0
1336780,True,0,No user reviews,0,0,0
1336790,True,0,No user reviews,0,0,0
1336800,True,0,No user reviews,0,0,0
1336810,True,0,No user reviews,0,0,0
1336830,True,0,1 user reviews,1,0,1
1336840,True,0,No user reviews,0,0,0
1336850,True,0,No user reviews,0,0,0
1336870,True,0,No user reviews,0,0,0
1336880,True,0,No user reviews,0,0,0
1336900,True,0,No user reviews,0,0,0
1336901,True,0,No user reviews,0,0,0
1336910,True,0,No user reviews,0,0,0
1336930,True,0,No user reviews,0,0,0
1336940,True,0,No user reviews,0,0,0
1336950,True,0,2 user reviews,1,1,2
1336960,True,0,1 user reviews,1,0,1
1336970,True,0,2 user reviews,2,0,2
1337000,True,0,No user reviews,0,0,0
1337010,True,0,No user reviews,0,0,0
1337020,True,0,No user reviews,0,0,0
1337030,True,0,No user reviews,0,0,0
1337040,True,0,No user reviews,0,0,0
1337060,True,0,No user reviews,0,0,0
1337070,True,0,1 user reviews,1,0,1
1337080,True,0,3 user reviews,3,0,3
1337090,True,0,No user reviews,0,0,0
1337091,True,0,No user reviews,0,0,0
1337092,True,0,No user reviews,0,0,0
1337110,True,0,No user reviews,0,0,0
1337170,True,0,1 user reviews,1,0,1
1337180,True,0,No user reviews,0,0,0
1337181,True,0,No user reviews,0,0,0
1337182,True,0,No user reviews,0,0,0
1337200,True,0,No user reviews,0,0,0
1337210,True,0,No user reviews,0,0,0
1337220,True,0,No user reviews,0,0,0
1337240,True,0,No user reviews,0,0,0
1337250,True,0,No user reviews,0,0,0
1337260,True,0,No user reviews,0,0,0
1337270,True,7,Positive,15,1,16
1337280,True,7,Positive,12,0,12
1337300,True,0,No user reviews,0,0,0
1337330,True,0,3 user reviews,3,0,3
1337340,True,0,No user reviews,0,0,0
1337360,True,0,No user reviews,0,0,0
1337430,True,5,Mixed,10,5,15
1337450,True,0,No user reviews,0,0,0
1337460,True,0,1 user reviews,0,1,1
1337470,True,0,No user reviews,0,0,0
1337490,True,0,No user reviews,0,0,0
1337500,True,0,No user reviews,0,0,0
1337510,True,0,No user reviews,0,0,0
1337530,True,0,No user reviews,0,0,0
1337590,True,0,No user reviews,0,0,0
1337600,True,0,No user reviews,0,0,0
1337640,True,0,No user reviews,0,0,0
1337660,True,0,2 user reviews,2,0,2
1337690,True,0,No user reviews,0,0,0
1337700,True,0,No user reviews,0,0,0
1337710,True,0,No user reviews,0,0,0
1337720,True,0,No user reviews,0,0,0
1337750,True,0,No user reviews,0,0,0
1337760,True,0,No user reviews,0,0,0
1337780,True,0,No user reviews,0,0,0
1337810,True,0,No user reviews,0,0,0
1337820,True,0,No user reviews,0,0,0
1337860,True,8,Very Positive,109,7,116
1337870,True,0,1 user reviews,0,1,1
1337880,True,0,No user reviews,0,0,0
1337890,True,0,No user reviews,0,0,0
1337901,True,0,No user reviews,0,0,0
1337902,True,0,No user reviews,0,0,0
1337920,True,0,No user reviews,0,0,0
1337950,True,0,No user reviews,0,0,0
1337960,True,0,No user reviews,0,0,0
1337990,True,0,No user reviews,0,0,0
1338020,True,0,No user reviews,0,0,0
1338030,True,0,No user reviews,0,0,0
1338040,True,0,No user reviews,0,0,0
1338060,True,0,No user reviews,0,0,0
1338070,True,0,No user reviews,0,0,0
1338080,True,0,No user reviews,0,0,0
1338090,True,0,2 user reviews,2,0,2
1338120,True,0,No user reviews,0,0,0
1338130,True,0,6 user reviews,5,1,6
1338140,True,0,No user reviews,0,0,0
1338160,True,0,No user reviews,0,0,0
1338180,True,0,1 user reviews,1,0,1
1338200,True,0,No user reviews,0,0,0
1338220,True,0,No user reviews,0,0,0
1338250,True,0,No user reviews,0,0,0
1338270,True,0,No user reviews,0,0,0
1338300,True,0,No user reviews,0,0,0
1338310,True,0,No user reviews,0,0,0
1338320,True,0,No user reviews,0,0,0
1338330,True,0,No user reviews,0,0,0
1338360,True,0,No user reviews,0,0,0
1338370,True,0,No user reviews,0,0,0
1338390,True,0,6 user reviews,6,0,6
1338400,True,0,No user reviews,0,0,0
1338410,True,0,No user reviews,0,0,0
1338420,True,0,No user reviews,0,0,0
1338430,True,0,No user reviews,0,0,0
1338440,True,0,No user reviews,0,0,0
1338460,True,0,No user reviews,0,0,0
1338470,True,7,Positive,19,2,21
1338490,True,0,No user reviews,0,0,0
1338520,True,0,No user reviews,0,0,0
1338540,True,0,No user reviews,0,0,0
1338560,True,0,1 user reviews,0,1,1
1338570,True,0,2 user reviews,2,0,2
1338620,True,0,No user reviews,0,0,0
1338630,True,6,Mostly Positive,8,3,11
1338640,True,7,Positive,35,1,36
1338650,True,0,No user reviews,0,0,0
1338660,True,0,No user reviews,0,0,0
1338670,True,0,No user reviews,0,0,0
1338690,True,0,No user reviews,0,0,0
1338700,True,0,3 user reviews,3,0,3
1338740,True,0,No user reviews,0,0,0
1338760,True,0,No user reviews,0,0,0
1338770,True,0,No user reviews,0,0,0
1338780,True,0,No user reviews,0,0,0
1338790,True,0,1 user reviews,1,0,1
1338810,True,0,No user reviews,0,0,0
1338830,True,0,No user reviews,0,0,0
1338870,True,0,No user reviews,0,0,0
1338880,True,0,No user reviews,0,0,0
1338890,True,0,No user reviews,0,0,0
1338900,True,0,No user reviews,0,0,0
1338910,True,0,2 user reviews,1,1,2
1338920,True,0,No user reviews,0,0,0
1338930,True,0,No user reviews,0,0,0
1338940,True,0,No user reviews,0,0,0
1338950,True,0,No user reviews,0,0,0
1338960,True,0,No user reviews,0,0,0
1338961,True,0,No user reviews,0,0,0
1338962,True,0,No user reviews,0,0,0
1338963,True,0,No user reviews,0,0,0
1338964,True,0,No user reviews,0,0,0
1338980,True,7,Positive,34,2,36
1339000,True,0,No user reviews,0,0,0
1339010,True,0,No user reviews,0,0,0
1339011,True,0,No user reviews,0,0,0
1339012,True,0,No user reviews,0,0,0
1339030,True,0,1 user reviews,0,1,1
1339060,True,0,No user reviews,0,0,0
1339080,True,0,2 user reviews,1,1,2
1339120,True,0,No user reviews,0,0,0
1339140,True,0,No user reviews,0,0,0
1339170,True,0,1 user reviews,1,0,1
1339180,True,0,7 user reviews,7,0,7
1339190,True,0,No user reviews,0,0,0
1339200,True,0,No user reviews,0,0,0
1339220,True,0,No user reviews,0,0,0
1339260,True,0,No user reviews,0,0,0
1339270,True,0,No user reviews,0,0,0
1339290,True,0,No user reviews,0,0,0
1339310,True,0,No user reviews,0,0,0
1339330,True,0,No user reviews,0,0,0
1339340,True,0,No user reviews,0,0,0
1339350,True,0,1 user reviews,0,1,1
1339360,True,0,No user reviews,0,0,0
1339370,True,0,1 user reviews,1,0,1
1339380,True,0,5 user reviews,5,0,5
1339390,True,0,No user reviews,0,0,0
1339391,True,0,No user reviews,0,0,0
1339400,True,0,No user reviews,0,0,0
1339410,True,0,No user reviews,0,0,0
1339420,True,0,6 user reviews,5,1,6
1339430,True,0,1 user reviews,1,0,1
1339431,True,0,No user reviews,0,0,0
1339432,True,0,No user reviews,0,0,0
1339450,True,0,No user reviews,0,0,0
1339460,True,0,No user reviews,0,0,0
1339470,True,0,No user reviews,0,0,0
1339490,True,0,No user reviews,0,0,0
1339500,True,0,No user reviews,0,0,0
1339520,True,0,No user reviews,0,0,0
1339530,True,0,No user reviews,0,0,0
1339550,True,0,No user reviews,0,0,0
1339560,True,0,No user reviews,0,0,0
1339580,True,0,No user reviews,0,0,0
1339620,True,0,6 user reviews,6,0,6
1339640,True,0,No user reviews,0,0,0
1339650,True,0,3 user reviews,1,2,3
1339660,True,0,1 user reviews,0,1,1
1339670,True,0,1 user reviews,1,0,1
1339680,True,0,No user reviews,0,0,0
1339700,True,0,No user reviews,0,0,0
1339710,True,0,No user reviews,0,0,0
1339740,True,0,No user reviews,0,0,0
1339750,True,0,No user reviews,0,0,0
1339770,True,0,No user reviews,0,0,0
1339771,True,0,No user reviews,0,0,0
1339790,True,0,5 user reviews,3,2,5
1339800,True,0,No user reviews,0,0,0
1339810,True,0,No user reviews,0,0,0
1339820,True,0,1 user reviews,0,1,1
1339830,True,0,No user reviews,0,0,0
1339850,True,0,5 user reviews,5,0,5
1339860,True,0,No user reviews,0,0,0
1339870,True,0,No user reviews,0,0,0
1339880,True,0,1 user reviews,0,1,1
1339890,True,5,Mixed,13,7,20
1339900,True,7,Positive,39,1,40
1339910,True,0,No user reviews,0,0,0
1339920,True,7,Positive,19,1,20
1339930,True,0,No user reviews,0,0,0
1339940,True,0,No user reviews,0,0,0
1339950,True,0,No user reviews,0,0,0
1339990,True,0,No user reviews,0,0,0
1340020,True,0,1 user reviews,1,0,1
1340030,True,0,No user reviews,0,0,0
1340050,True,0,No user reviews,0,0,0
1340060,True,0,No user reviews,0,0,0
1340070,True,0,No user reviews,0,0,0
1340080,True,0,1 user reviews,1,0,1
1340120,True,8,Very Positive,50,2,52
1340130,True,0,No user reviews,0,0,0
1340160,True,0,No user reviews,0,0,0
1340180,True,0,No user reviews,0,0,0
1340190,True,0,No user reviews,0,0,0
1340210,True,0,No user reviews,0,0,0
1340240,True,0,No user reviews,0,0,0
1340260,True,0,No user reviews,0,0,0
1340270,True,0,No user reviews,0,0,0
1340300,True,0,6 user reviews,5,1,6
1340310,True,0,1 user reviews,1,0,1
1340320,True,0,3 user reviews,3,0,3
1340330,True,0,No user reviews,0,0,0
1340350,True,0,No user reviews,0,0,0
1340351,True,0,No user reviews,0,0,0
1340360,True,0,No user reviews,0,0,0
1340400,True,0,1 user reviews,0,1,1
1340410,True,0,No user reviews,0,0,0
1340420,True,0,2 user reviews,2,0,2
1340440,True,0,1 user reviews,0,1,1
1340461,True,0,No user reviews,0,0,0
1340462,True,0,No user reviews,0,0,0
1340463,True,0,No user reviews,0,0,0
1340464,True,0,No user reviews,0,0,0
1340470,True,0,No user reviews,0,0,0
1340490,True,0,1 user reviews,0,1,1
1340500,True,0,No user reviews,0,0,0
1340510,True,0,No user reviews,0,0,0
1340520,True,0,No user reviews,0,0,0
1340530,True,0,No user reviews,0,0,0
1340540,True,0,1 user reviews,1,0,1
1340570,True,0,8 user reviews,7,1,8
1340590,True,0,No user reviews,0,0,0
1340600,True,0,4 user reviews,2,2,4
1340610,True,0,1 user reviews,1,0,1
1340611,True,0,No user reviews,0,0,0
1340612,True,0,No user reviews,0,0,0
1340613,True,0,No user reviews,0,0,0
1340614,True,0,No user reviews,0,0,0
1340615,True,0,No user reviews,0,0,0
1340616,True,0,No user reviews,0,0,0
1340617,True,0,No user reviews,0,0,0
1340640,True,0,No user reviews,0,0,0
1340670,True,0,No user reviews,0,0,0
1340700,True,0,No user reviews,0,0,0
1340710,True,0,No user reviews,0,0,0
1340740,True,0,No user reviews,0,0,0
1340750,True,0,No user reviews,0,0,0
1340760,True,0,No user reviews,0,0,0
1340770,True,0,1 user reviews,1,0,1
1340810,True,0,No user reviews,0,0,0
1340820,True,0,No user reviews,0,0,0
1340850,True,0,1 user reviews,0,1,1
1340860,True,0,No user reviews,0,0,0
1340870,True,0,4 user reviews,4,0,4
1340880,True,0,No user reviews,0,0,0
1340890,True,0,No user reviews,0,0,0
1340910,True,0,No user reviews,0,0,0
1340940,True,0,2 user reviews,2,0,2
1340950,True,0,No user reviews,0,0,0
1340980,True,0,3 user reviews,3,0,3
1341000,True,0,No user reviews,0,0,0
1341020,True,0,No user reviews,0,0,0
1341050,True,0,No user reviews,0,0,0
1341060,True,0,No user reviews,0,0,0
1341080,True,0,3 user reviews,1,2,3
1341090,True,0,No user reviews,0,0,0
1341100,True,0,1 user reviews,1,0,1
1341140,True,0,No user reviews,0,0,0
1341160,True,7,Positive,17,3,20
1341170,True,0,No user reviews,0,0,0
1341180,True,0,No user reviews,0,0,0
1341190,True,7,Positive,10,1,11
1341220,True,7,Positive,34,1,35
1341230,True,0,No user reviews,0,0,0
1341240,True,0,1 user reviews,1,0,1
1341250,True,0,1 user reviews,1,0,1
1341270,True,0,No user reviews,0,0,0
1341280,True,0,No user reviews,0,0,0
1341330,True,0,No user reviews,0,0,0
1341340,True,0,No user reviews,0,0,0
1341350,True,0,No user reviews,0,0,0
1341351,True,0,No user reviews,0,0,0
1341380,True,0,No user reviews,0,0,0
1341400,True,0,No user reviews,0,0,0
1341410,True,0,No user reviews,0,0,0
1341411,True,0,No user reviews,0,0,0
1341412,True,0,No user reviews,0,0,0
1341413,True,0,No user reviews,0,0,0
1341414,True,0,No user reviews,0,0,0
1341440,True,0,No user reviews,0,0,0
1341450,True,0,No user reviews,0,0,0
1341470,True,0,3 user reviews,3,0,3
1341500,True,0,No user reviews,0,0,0
1341520,True,6,Mostly Positive,51,20,71
1341550,True,0,6 user reviews,2,4,6
1341580,True,0,1 user reviews,1,0,1
1341590,True,0,No user reviews,0,0,0
1341620,True,0,2 user reviews,1,1,2
1341630,True,0,1 user reviews,1,0,1
1341640,True,0,4 user reviews,4,0,4
1341650,True,0,No user reviews,0,0,0
1341660,True,0,2 user reviews,1,1,2
1341690,True,0,No user reviews,0,0,0
1341710,True,0,No user reviews,0,0,0
1341720,True,0,2 user reviews,0,2,2
1341730,True,0,No user reviews,0,0,0
1341740,True,0,No user reviews,0,0,0
1341780,True,0,1 user reviews,1,0,1
1341790,True,0,1 user reviews,1,0,1
1341810,True,0,No user reviews,0,0,0
1341830,True,0,No user reviews,0,0,0
1341860,True,0,No user reviews,0,0,0
1341900,True,0,No user reviews,0,0,0
1341910,True,0,No user reviews,0,0,0
1341920,True,0,No user reviews,0,0,0
1341930,True,7,Positive,10,1,11
1341950,True,0,No user reviews,0,0,0
1341960,True,0,8 user reviews,7,1,8
1341970,True,0,No user reviews,0,0,0
1341980,True,0,No user reviews,0,0,0
1341990,True,0,No user reviews,0,0,0
1342040,True,0,No user reviews,0,0,0
1342050,True,0,No user reviews,0,0,0
1342070,True,0,No user reviews,0,0,0
1342130,True,0,2 user reviews,1,1,2
1342150,True,0,No user reviews,0,0,0
1342160,True,0,No user reviews,0,0,0
1342180,True,0,No user reviews,0,0,0
1342190,True,0,No user reviews,0,0,0
1342210,True,0,No user reviews,0,0,0
1342220,True,0,No user reviews,0,0,0
1342270,True,0,1 user reviews,1,0,1
1342280,True,0,No user reviews,0,0,0
1342290,True,7,Positive,11,0,11
1342330,True,0,No user reviews,0,0,0
1342340,True,0,No user reviews,0,0,0
1342350,True,0,No user reviews,0,0,0
1342360,True,0,No user reviews,0,0,0
1342370,True,0,No user reviews,0,0,0
1342420,True,0,No user reviews,0,0,0
1342440,True,0,No user reviews,0,0,0
1342460,True,0,No user reviews,0,0,0
1342480,True,0,7 user reviews,6,1,7
1342500,True,0,4 user reviews,3,1,4
1342510,True,0,No user reviews,0,0,0
1342540,True,0,No user reviews,0,0,0
1342550,True,0,No user reviews,0,0,0
1342560,True,0,No user reviews,0,0,0
1342570,True,0,No user reviews,0,0,0
1342580,True,0,No user reviews,0,0,0
1342600,True,0,2 user reviews,2,0,2
1342610,True,0,No user reviews,0,0,0
1342620,True,8,Very Positive,118,13,131
1342640,True,0,No user reviews,0,0,0
1342670,True,0,No user reviews,0,0,0
1342680,True,0,No user reviews,0,0,0
1342710,True,0,No user reviews,0,0,0
1342711,True,0,No user reviews,0,0,0
1342712,True,0,No user reviews,0,0,0
1342713,True,0,No user reviews,0,0,0
1342720,True,0,No user reviews,0,0,0
1342730,True,0,4 user reviews,4,0,4
1342740,True,7,Positive,42,0,42
1342760,True,0,No user reviews,0,0,0
1342770,True,0,No user reviews,0,0,0
1342780,True,0,No user reviews,0,0,0
1342790,True,0,No user reviews,0,0,0
1342830,True,0,No user reviews,0,0,0
1342831,True,0,No user reviews,0,0,0
1342840,True,0,No user reviews,0,0,0
1342850,True,7,Positive,15,1,16
1342870,True,0,No user reviews,0,0,0
1342880,True,0,No user reviews,0,0,0
1342881,True,0,No user reviews,0,0,0
1342882,True,0,No user reviews,0,0,0
1342883,True,0,No user reviews,0,0,0
1342890,True,0,No user reviews,0,0,0
1342900,True,0,No user reviews,0,0,0
1342910,True,0,No user reviews,0,0,0
1342940,True,0,No user reviews,0,0,0
1342950,True,0,No user reviews,0,0,0
1342980,True,0,No user reviews,0,0,0
1343000,True,0,No user reviews,0,0,0
1343050,True,0,No user reviews,0,0,0
1343060,True,0,No user reviews,0,0,0
1343090,True,7,Positive,17,0,17
1343100,True,0,No user reviews,0,0,0
1343110,True,0,No user reviews,0,0,0
1343130,True,0,8 user reviews,8,0,8
1343140,True,0,No user reviews,0,0,0
1343150,True,7,Positive,12,3,15
1343160,True,0,No user reviews,0,0,0
1343161,True,0,No user reviews,0,0,0
1343170,True,0,No user reviews,0,0,0
1343180,True,0,No user reviews,0,0,0
1343181,True,0,No user reviews,0,0,0
1343182,True,0,No user reviews,0,0,0
1343220,True,0,6 user reviews,6,0,6
1343250,True,0,2 user reviews,2,0,2
1343260,True,7,Positive,11,0,11
1343310,True,0,1 user reviews,1,0,1
1343320,True,0,6 user reviews,6,0,6
1343330,True,0,1 user reviews,0,1,1
1343340,True,0,No user reviews,0,0,0
1343360,True,0,No user reviews,0,0,0
1343390,True,0,2 user reviews,2,0,2
1343400,True,7,Positive,9,2,11
1343410,True,0,1 user reviews,1,0,1
1343450,True,0,No user reviews,0,0,0
1343490,True,0,No user reviews,0,0,0
1343500,True,6,Mostly Positive,263,88,351
1343510,True,0,No user reviews,0,0,0
1343520,True,0,No user reviews,0,0,0
1343530,True,0,No user reviews,0,0,0
1343540,True,0,No user reviews,0,0,0
1343550,True,0,3 user reviews,3,0,3
1343580,True,0,1 user reviews,0,1,1
1343612,True,5,Mixed,253,145,398
1343620,True,0,No user reviews,0,0,0
1343640,True,0,No user reviews,0,0,0
1343650,True,0,No user reviews,0,0,0
1343660,True,0,1 user reviews,1,0,1
1343670,True,0,No user reviews,0,0,0
1343680,True,0,No user reviews,0,0,0
1343690,True,0,No user reviews,0,0,0
1343700,True,0,3 user reviews,3,0,3
1343750,True,0,No user reviews,0,0,0
1343760,True,0,No user reviews,0,0,0
1343770,True,7,Positive,16,4,20
1343780,True,0,No user reviews,0,0,0
1343790,True,0,No user reviews,0,0,0
1343800,True,0,No user reviews,0,0,0
1343830,True,0,No user reviews,0,0,0
1343840,True,0,No user reviews,0,0,0
1343850,True,0,2 user reviews,1,1,2
1343860,True,0,No user reviews,0,0,0
1343880,True,0,No user reviews,0,0,0
1343920,True,7,Positive,14,3,17
1343970,True,0,No user reviews,0,0,0
1343980,True,0,No user reviews,0,0,0
1343990,True,0,3 user reviews,3,0,3
1344000,True,0,No user reviews,0,0,0
1344040,True,0,No user reviews,0,0,0
1344050,True,0,2 user reviews,2,0,2
1344060,True,0,No user reviews,0,0,0
1344070,True,0,4 user reviews,3,1,4
1344100,True,0,No user reviews,0,0,0
1344110,True,0,2 user reviews,1,1,2
1344120,True,0,No user reviews,0,0,0
1344140,True,0,1 user reviews,1,0,1
1344160,True,0,No user reviews,0,0,0
1344170,True,0,No user reviews,0,0,0
1344190,True,0,No user reviews,0,0,0
1344191,True,0,No user reviews,0,0,0
1344192,True,0,No user reviews,0,0,0
1344193,True,0,No user reviews,0,0,0
1344194,True,0,No user reviews,0,0,0
1344280,True,0,No user reviews,0,0,0
1344310,True,0,6 user reviews,4,2,6
1344320,True,0,No user reviews,0,0,0
1344350,True,0,No user reviews,0,0,0
1344420,True,0,No user reviews,0,0,0
1344430,True,0,No user reviews,0,0,0
1344440,True,0,4 user reviews,4,0,4
1344450,True,0,2 user reviews,2,0,2
1344500,True,0,No user reviews,0,0,0
1344520,True,0,2 user reviews,1,1,2
1344530,True,8,Very Positive,56,9,65
1344560,True,0,No user reviews,0,0,0
1344570,True,0,No user reviews,0,0,0
1344580,True,0,1 user reviews,0,1,1
1344600,True,0,1 user reviews,1,0,1
1344610,True,0,No user reviews,0,0,0
1344620,True,0,1 user reviews,1,0,1
1344630,True,0,1 user reviews,0,1,1
1344660,True,0,No user reviews,0,0,0
1344680,True,6,Mostly Positive,176,61,237
1344690,True,0,No user reviews,0,0,0
1344700,True,0,No user reviews,0,0,0
1344740,True,8,Very Positive,79,3,82
1344760,True,0,1 user reviews,1,0,1
1344780,True,0,No user reviews,0,0,0
1344790,True,0,No user reviews,0,0,0
1344800,True,0,No user reviews,0,0,0
1344810,True,0,No user reviews,0,0,0
1344820,True,0,No user reviews,0,0,0
1344830,True,0,1 user reviews,1,0,1
1344840,True,0,No user reviews,0,0,0
1344850,True,0,No user reviews,0,0,0
1344860,True,0,No user reviews,0,0,0
1344870,True,0,3 user reviews,1,2,3
1344880,True,0,No user reviews,0,0,0
1344890,True,0,No user reviews,0,0,0
1344900,True,0,No user reviews,0,0,0
1344930,True,0,No user reviews,0,0,0
1344950,True,0,No user reviews,0,0,0
1344970,True,0,No user reviews,0,0,0
1344980,True,0,No user reviews,0,0,0
1344990,True,0,No user reviews,0,0,0
1345040,True,7,Positive,14,1,15
1345050,True,0,No user reviews,0,0,0
1345060,True,0,No user reviews,0,0,0
1345070,True,0,No user reviews,0,0,0
1345080,True,0,No user reviews,0,0,0
1345110,True,0,No user reviews,0,0,0
1345120,True,0,4 user reviews,3,1,4
1345140,True,0,No user reviews,0,0,0
1345150,True,0,2 user reviews,1,1,2
1345190,True,0,3 user reviews,3,0,3
1345200,True,0,1 user reviews,1,0,1
1345220,True,0,3 user reviews,3,0,3
1345230,True,0,No user reviews,0,0,0
1345231,True,0,No user reviews,0,0,0
1345232,True,0,No user reviews,0,0,0
1345233,True,0,No user reviews,0,0,0
1345240,True,0,1 user reviews,1,0,1
1345280,True,0,No user reviews,0,0,0
1345300,True,0,No user reviews,0,0,0
1345310,True,0,No user reviews,0,0,0
1345320,True,0,No user reviews,0,0,0
1345340,True,0,No user reviews,0,0,0
1345350,True,0,6 user reviews,6,0,6
1345360,True,0,5 user reviews,3,2,5
1345370,True,7,Positive,18,2,20
1345380,True,5,Mixed,12,8,20
1345400,True,0,No user reviews,0,0,0
1345430,True,0,No user reviews,0,0,0
1345440,True,0,No user reviews,0,0,0
1345450,True,0,No user reviews,0,0,0
1345470,True,7,Positive,25,0,25
1345500,True,0,No user reviews,0,0,0
1345510,True,0,No user reviews,0,0,0
1345560,True,0,No user reviews,0,0,0
1345580,True,0,No user reviews,0,0,0
1345610,True,0,2 user reviews,2,0,2
1345620,True,0,No user reviews,0,0,0
1345630,True,0,No user reviews,0,0,0
1345720,True,0,No user reviews,0,0,0
1345740,True,0,No user reviews,0,0,0
1345750,True,0,1 user reviews,1,0,1
1345770,True,0,3 user reviews,1,2,3
1345780,True,0,No user reviews,0,0,0
1345790,True,0,No user reviews,0,0,0
1345800,True,7,Positive,13,0,13
1345810,True,0,No user reviews,0,0,0
1345820,True,0,No user reviews,0,0,0
1345830,True,0,1 user reviews,0,1,1
1345840,True,0,No user reviews,0,0,0
1345920,True,0,No user reviews,0,0,0
1345950,True,0,9 user reviews,9,0,9
1345960,True,0,2 user reviews,2,0,2
1345961,True,0,No user reviews,0,0,0
1345962,True,0,No user reviews,0,0,0
1345970,True,0,No user reviews,0,0,0
1345980,True,0,1 user reviews,1,0,1
1345990,True,5,Mixed,87,67,154
1346030,True,0,No user reviews,0,0,0
1346040,True,0,No user reviews,0,0,0
1346050,True,0,No user reviews,0,0,0
1346060,True,0,No user reviews,0,0,0
1346070,True,5,Mixed,57,50,107
1346080,True,0,No user reviews,0,0,0
1346090,True,7,Positive,17,4,21
1346100,True,0,No user reviews,0,0,0
1346110,True,0,3 user reviews,3,0,3
1346120,True,0,3 user reviews,1,2,3
1346130,True,0,1 user reviews,0,1,1
1346140,True,0,No user reviews,0,0,0
1346150,True,0,No user reviews,0,0,0
1346160,True,0,No user reviews,0,0,0
1346170,True,0,2 user reviews,1,1,2
1346210,True,0,No user reviews,0,0,0
1346220,True,0,No user reviews,0,0,0
1346240,True,7,Positive,19,2,21
1346250,True,0,7 user reviews,7,0,7
1346260,True,0,6 user reviews,4,2,6
1346270,True,0,7 user reviews,5,2,7
1346280,True,0,No user reviews,0,0,0
1346290,True,0,No user reviews,0,0,0
1346300,True,0,No user reviews,0,0,0
1346310,True,0,No user reviews,0,0,0
1346330,True,0,No user reviews,0,0,0
1346350,True,0,No user reviews,0,0,0
1346400,True,0,9 user reviews,7,2,9
1346420,True,0,No user reviews,0,0,0
1346430,True,0,No user reviews,0,0,0
1346490,True,0,No user reviews,0,0,0
1346500,True,0,1 user reviews,1,0,1
1346510,True,0,1 user reviews,1,0,1
1346520,True,0,2 user reviews,2,0,2
1346540,True,0,1 user reviews,1,0,1
1346541,True,0,4 user reviews,3,1,4
1346580,True,0,No user reviews,0,0,0
1346590,True,0,2 user reviews,2,0,2
1346600,True,0,5 user reviews,5,0,5
1346620,True,0,No user reviews,0,0,0
1346630,True,0,7 user reviews,7,0,7
1346640,True,0,No user reviews,0,0,0
1346660,True,0,No user reviews,0,0,0
1346680,True,0,2 user reviews,1,1,2
1346700,True,0,No user reviews,0,0,0
1346730,True,0,No user reviews,0,0,0
1346760,True,0,No user reviews,0,0,0
1346790,True,0,No user reviews,0,0,0
1346800,True,0,7 user reviews,6,1,7
1346810,True,0,No user reviews,0,0,0
1346820,True,0,No user reviews,0,0,0
1346850,True,0,No user reviews,0,0,0
1346860,True,0,1 user reviews,0,1,1
1346870,True,0,1 user reviews,0,1,1
1346880,True,0,No user reviews,0,0,0
1346890,True,0,8 user reviews,5,3,8
1346910,True,0,No user reviews,0,0,0
1346920,True,0,No user reviews,0,0,0
1346930,True,0,1 user reviews,1,0,1
1346960,True,7,Positive,19,3,22
1346970,True,6,Mostly Positive,16,6,22
1346980,True,7,Positive,33,1,34
1347010,True,0,No user reviews,0,0,0
1347070,True,0,No user reviews,0,0,0
1347090,True,6,Mostly Positive,8,3,11
1347100,True,0,No user reviews,0,0,0
1347110,True,0,No user reviews,0,0,0
1347130,True,0,No user reviews,0,0,0
1347140,True,0,No user reviews,0,0,0
1347170,True,0,2 user reviews,2,0,2
1347270,True,0,1 user reviews,1,0,1
1347280,True,0,No user reviews,0,0,0
1347310,True,0,No user reviews,0,0,0
1347340,True,0,No user reviews,0,0,0
1347341,True,0,No user reviews,0,0,0
1347350,True,0,3 user reviews,2,1,3
1347360,True,0,No user reviews,0,0,0
1347370,True,0,No user reviews,0,0,0
1347390,True,0,No user reviews,0,0,0
1347420,True,7,Positive,17,3,20
1347430,True,8,Very Positive,172,34,206
1347450,True,0,1 user reviews,1,0,1
1347460,True,0,1 user reviews,1,0,1
1347490,True,0,No user reviews,0,0,0
1347520,True,0,No user reviews,0,0,0
1347540,True,0,No user reviews,0,0,0
1347580,True,0,No user reviews,0,0,0
1347590,True,0,No user reviews,0,0,0
1347610,True,0,4 user reviews,4,0,4
1347611,True,0,2 user reviews,1,1,2
1347630,True,0,No user reviews,0,0,0
1347640,True,0,3 user reviews,3,0,3
1347690,True,0,No user reviews,0,0,0
1347700,True,0,No user reviews,0,0,0
1347720,True,0,4 user reviews,3,1,4
1347740,True,0,No user reviews,0,0,0
1347750,True,5,Mixed,64,48,112
1347751,True,7,Positive,43,3,46
1347780,True,8,Very Positive,293,11,304
1347800,True,5,Mixed,24,21,45
1347810,True,0,No user reviews,0,0,0
1347830,True,0,No user reviews,0,0,0
1347870,True,0,No user reviews,0,0,0
1347880,True,0,8 user reviews,8,0,8
1347890,True,0,No user reviews,0,0,0
1347910,True,0,No user reviews,0,0,0
1347920,True,0,No user reviews,0,0,0
1347930,True,0,No user reviews,0,0,0
1347960,True,0,No user reviews,0,0,0
1347970,True,0,No user reviews,0,0,0
1347980,True,0,No user reviews,0,0,0
1347990,True,0,No user reviews,0,0,0
1348010,True,0,No user reviews,0,0,0
1348020,True,0,No user reviews,0,0,0
1348030,True,0,2 user reviews,1,1,2
1348040,True,0,No user reviews,0,0,0
1348060,True,0,No user reviews,0,0,0
1348140,True,0,7 user reviews,7,0,7
1348150,True,0,No user reviews,0,0,0
1348160,True,7,Positive,14,0,14
1348180,True,0,No user reviews,0,0,0
1348190,True,0,No user reviews,0,0,0
1348210,True,0,No user reviews,0,0,0
1348220,True,0,No user reviews,0,0,0
1348240,True,0,3 user reviews,3,0,3
1348250,True,0,No user reviews,0,0,0
1348260,True,0,No user reviews,0,0,0
1348270,True,7,Positive,16,1,17
1348300,True,0,4 user reviews,3,1,4
1348310,True,0,No user reviews,0,0,0
1348330,True,0,No user reviews,0,0,0
1348380,True,0,2 user reviews,1,1,2
1348390,True,6,Mostly Positive,8,3,11
1348400,True,0,4 user reviews,4,0,4
1348420,True,0,No user reviews,0,0,0
1348430,True,0,1 user reviews,1,0,1
1348440,True,0,No user reviews,0,0,0
1348470,True,0,1 user reviews,1,0,1
1348480,True,0,No user reviews,0,0,0
1348500,True,0,No user reviews,0,0,0
1348510,True,0,No user reviews,0,0,0
1348520,True,0,No user reviews,0,0,0
1348580,True,0,No user reviews,0,0,0
1348590,True,0,No user reviews,0,0,0
1348600,True,0,No user reviews,0,0,0
1348650,True,0,No user reviews,0,0,0
1348660,True,5,Mixed,258,272,530
1348670,True,5,Mixed,6,6,12
1348680,True,0,No user reviews,0,0,0
1348700,True,0,No user reviews,0,0,0
1348720,True,0,No user reviews,0,0,0
1348740,True,0,No user reviews,0,0,0
1348750,True,0,No user reviews,0,0,0
1348770,True,0,No user reviews,0,0,0
1348780,True,0,No user reviews,0,0,0
1348800,True,0,No user reviews,0,0,0
1348810,True,0,No user reviews,0,0,0
1348850,True,0,No user reviews,0,0,0
1348880,True,0,7 user reviews,0,7,7
1348920,True,6,Mostly Positive,14,4,18
1348930,True,0,No user reviews,0,0,0
1348940,True,0,No user reviews,0,0,0
1348960,True,0,1 user reviews,1,0,1
1348970,True,0,No user reviews,0,0,0
1348980,True,0,5 user reviews,5,0,5
1348990,True,0,No user reviews,0,0,0
1349000,True,0,4 user reviews,4,0,4
1349010,True,0,5 user reviews,5,0,5
1349060,True,7,Positive,21,0,21
1349070,True,0,No user reviews,0,0,0
1349100,True,0,No user reviews,0,0,0
1349120,True,0,No user reviews,0,0,0
1349130,True,0,4 user reviews,4,0,4
1349170,True,0,No user reviews,0,0,0
1349180,True,0,No user reviews,0,0,0
1349230,True,9,Overwhelmingly Positive,973,37,1010
1349240,True,0,No user reviews,0,0,0
1349250,True,0,No user reviews,0,0,0
1349290,True,0,No user reviews,0,0,0
1349300,True,0,No user reviews,0,0,0
1349310,True,0,No user reviews,0,0,0
1349330,True,0,No user reviews,0,0,0
1349340,True,0,No user reviews,0,0,0
1349350,True,0,No user reviews,0,0,0
1349360,True,0,No user reviews,0,0,0
1349370,True,0,No user reviews,0,0,0
1349380,True,0,No user reviews,0,0,0
1349390,True,0,4 user reviews,4,0,4
1349400,True,5,Mixed,42,21,63
1349420,True,0,No user reviews,0,0,0
1349460,True,0,No user reviews,0,0,0
1349480,True,0,No user reviews,0,0,0
1349490,True,0,No user reviews,0,0,0
1349491,True,0,1 user reviews,1,0,1
1349492,True,0,No user reviews,0,0,0
1349520,True,0,No user reviews,0,0,0
1349521,True,0,No user reviews,0,0,0
1349522,True,0,No user reviews,0,0,0
1349523,True,0,No user reviews,0,0,0
1349540,True,0,No user reviews,0,0,0
1349580,True,0,No user reviews,0,0,0
1349600,True,0,No user reviews,0,0,0
1349620,True,0,No user reviews,0,0,0
1349640,True,0,No user reviews,0,0,0
1349680,True,0,No user reviews,0,0,0
1349700,True,0,No user reviews,0,0,0
1349710,True,7,Positive,19,1,20
1349720,True,0,2 user reviews,0,2,2
1349730,True,0,No user reviews,0,0,0
1349740,True,0,3 user reviews,0,3,3
1349760,True,0,No user reviews,0,0,0
1349790,True,0,1 user reviews,1,0,1
1349820,True,0,No user reviews,0,0,0
1349830,True,0,No user reviews,0,0,0
1349840,True,0,No user reviews,0,0,0
1349860,True,0,No user reviews,0,0,0
1349890,True,0,No user reviews,0,0,0
1349900,True,0,No user reviews,0,0,0
1349910,True,0,No user reviews,0,0,0
1349920,True,0,No user reviews,0,0,0
1349940,True,0,4 user reviews,4,0,4
1349960,True,7,Positive,27,5,32
1349970,True,0,No user reviews,0,0,0
1350010,True,0,1 user reviews,0,1,1
1350030,True,0,No user reviews,0,0,0
1350040,True,0,1 user reviews,1,0,1
1350050,True,0,No user reviews,0,0,0
1350060,True,0,1 user reviews,0,1,1
1350080,True,0,No user reviews,0,0,0
1350120,True,0,No user reviews,0,0,0
1350130,True,0,No user reviews,0,0,0
1350170,True,0,1 user reviews,0,1,1
1350200,True,0,No user reviews,0,0,0
1350210,True,0,No user reviews,0,0,0
1350280,True,0,3 user reviews,3,0,3
1350300,True,0,1 user reviews,1,0,1
1350340,True,7,Positive,22,3,25
1350350,True,0,No user reviews,0,0,0
1350390,True,0,No user reviews,0,0,0
1350400,True,0,No user reviews,0,0,0
1350420,True,0,No user reviews,0,0,0
1350430,True,0,No user reviews,0,0,0
1350460,True,0,No user reviews,0,0,0
1350470,True,0,No user reviews,0,0,0
1350480,True,0,2 user reviews,1,1,2
1350500,True,0,No user reviews,0,0,0
1350530,True,0,No user reviews,0,0,0
1350540,True,0,3 user reviews,3,0,3
1350560,True,0,1 user reviews,1,0,1
1350570,True,0,5 user reviews,5,0,5
1350580,True,0,No user reviews,0,0,0
1350590,True,0,No user reviews,0,0,0
1350600,True,0,No user reviews,0,0,0
1350601,True,0,No user reviews,0,0,0
1350602,True,0,No user reviews,0,0,0
1350603,True,0,No user reviews,0,0,0
1350604,True,0,No user reviews,0,0,0
1350610,True,0,No user reviews,0,0,0
1350630,True,0,No user reviews,0,0,0
1350640,True,0,No user reviews,0,0,0
1350660,True,0,1 user reviews,1,0,1
1350680,True,0,No user reviews,0,0,0
1350700,True,0,No user reviews,0,0,0
1350710,True,0,No user reviews,0,0,0
1350750,True,0,No user reviews,0,0,0
1350780,True,0,No user reviews,0,0,0
1350800,True,0,1 user reviews,0,1,1
1350820,True,0,No user reviews,0,0,0
1350830,True,0,No user reviews,0,0,0
1350850,True,0,1 user reviews,1,0,1
1350860,True,0,No user reviews,0,0,0
1350870,True,0,No user reviews,0,0,0
1350880,True,0,No user reviews,0,0,0
1350900,True,0,No user reviews,0,0,0
1350910,True,0,No user reviews,0,0,0
1350920,True,0,1 user reviews,1,0,1
1350930,True,0,No user reviews,0,0,0
1350940,True,0,No user reviews,0,0,0
1350960,True,0,No user reviews,0,0,0
1350970,True,0,No user reviews,0,0,0
1350980,True,0,No user reviews,0,0,0
1350990,True,0,3 user reviews,2,1,3
1351010,True,0,8 user reviews,6,2,8
1351020,True,0,3 user reviews,2,1,3
1351030,True,0,3 user reviews,2,1,3
1351060,True,8,Very Positive,55,7,62
1351070,True,0,No user reviews,0,0,0
1351080,True,0,No user reviews,0,0,0
1351100,True,0,1 user reviews,1,0,1
1351120,True,0,No user reviews,0,0,0
1351140,True,0,No user reviews,0,0,0
1351170,True,0,No user reviews,0,0,0
1351180,True,0,No user reviews,0,0,0
1351200,True,0,No user reviews,0,0,0
1351220,True,0,2 user reviews,1,1,2
1351230,True,0,No user reviews,0,0,0
1351250,True,0,No user reviews,0,0,0
1351260,True,0,6 user reviews,5,1,6
1351261,True,5,Mixed,18,12,30
1351270,True,0,1 user reviews,0,1,1
1351271,True,0,1 user reviews,0,1,1
1351280,True,0,No user reviews,0,0,0
1351290,True,0,1 user reviews,0,1,1
1351300,True,0,1 user reviews,1,0,1
1351310,True,0,1 user reviews,1,0,1
1351320,True,0,No user reviews,0,0,0
1351350,True,0,4 user reviews,4,0,4
1351360,True,7,Positive,12,1,13
1351370,True,0,4 user reviews,2,2,4
1351390,True,0,8 user reviews,8,0,8
1351400,True,7,Positive,11,0,11
1351420,True,0,No user reviews,0,0,0
1351450,True,5,Mixed,18,8,26
1351480,True,0,No user reviews,0,0,0
1351500,True,0,No user reviews,0,0,0
1351550,True,0,3 user reviews,3,0,3
1351560,True,0,3 user reviews,3,0,3
1351600,True,0,No user reviews,0,0,0
1351601,True,0,No user reviews,0,0,0
1351602,True,0,No user reviews,0,0,0
1351603,True,0,No user reviews,0,0,0
1351604,True,0,No user reviews,0,0,0
1351610,True,0,No user reviews,0,0,0
1351630,True,0,No user reviews,0,0,0
1351650,True,0,1 user reviews,1,0,1
1351670,True,0,No user reviews,0,0,0
1351710,True,0,No user reviews,0,0,0
1351720,True,0,1 user reviews,1,0,1
1351760,True,0,No user reviews,0,0,0
1351790,True,0,No user reviews,0,0,0
1351810,True,0,7 user reviews,7,0,7
1351820,True,0,6 user reviews,6,0,6
1351830,True,7,Positive,9,2,11
1351840,True,0,No user reviews,0,0,0
1351860,True,0,9 user reviews,8,1,9
1351861,True,0,2 user reviews,2,0,2
1351870,True,0,No user reviews,0,0,0
1351880,True,0,4 user reviews,1,3,4
1351900,True,7,Positive,17,0,17
1351910,True,0,No user reviews,0,0,0
1351920,True,0,No user reviews,0,0,0
1351940,True,0,No user reviews,0,0,0
1351950,True,7,Positive,18,4,22
1351960,True,0,2 user reviews,2,0,2
1351970,True,0,6 user reviews,5,1,6
1351980,True,0,1 user reviews,1,0,1
1351990,True,0,1 user reviews,0,1,1
1352000,True,0,1 user reviews,0,1,1
1352010,True,0,1 user reviews,0,1,1
1352020,True,7,Positive,24,0,24
1352030,True,0,8 user reviews,8,0,8
1352040,True,0,No user reviews,0,0,0
1352050,True,0,No user reviews,0,0,0
1352070,True,0,No user reviews,0,0,0
1352110,True,0,No user reviews,0,0,0
1352130,True,0,2 user reviews,2,0,2
1352160,True,0,No user reviews,0,0,0
1352170,True,0,No user reviews,0,0,0
1352171,True,0,No user reviews,0,0,0
1352172,True,0,No user reviews,0,0,0
1352173,True,0,No user reviews,0,0,0
1352200,True,0,No user reviews,0,0,0
1352230,True,0,No user reviews,0,0,0
1352300,True,0,No user reviews,0,0,0
1352320,True,0,No user reviews,0,0,0
1352330,True,0,No user reviews,0,0,0
1352340,True,0,No user reviews,0,0,0
1352360,True,0,No user reviews,0,0,0
1352380,True,0,No user reviews,0,0,0
1352390,True,0,No user reviews,0,0,0
1352440,True,0,No user reviews,0,0,0
1352450,True,0,No user reviews,0,0,0
1352470,True,0,No user reviews,0,0,0
1352480,True,0,No user reviews,0,0,0
1352520,True,0,No user reviews,0,0,0
1352530,True,0,No user reviews,0,0,0
1352550,True,0,No user reviews,0,0,0
1352560,True,0,No user reviews,0,0,0
1352581,True,0,7 user reviews,5,2,7
1352582,True,0,5 user reviews,5,0,5
1352583,True,0,9 user reviews,2,7,9
1352584,True,0,5 user reviews,5,0,5
1352590,True,0,1 user reviews,1,0,1
1352640,True,0,No user reviews,0,0,0
1352650,True,0,No user reviews,0,0,0
1352680,True,7,Positive,10,2,12
1352690,True,0,No user reviews,0,0,0
1352720,True,0,No user reviews,0,0,0
1352721,True,0,No user reviews,0,0,0
1352740,True,0,No user reviews,0,0,0
1352750,True,0,No user reviews,0,0,0
1352760,True,0,No user reviews,0,0,0
1352770,True,0,No user reviews,0,0,0
1352780,True,0,No user reviews,0,0,0
1352850,True,0,No user reviews,0,0,0
1352870,True,0,No user reviews,0,0,0
1352880,True,0,No user reviews,0,0,0
1352910,True,0,No user reviews,0,0,0
1352930,True,7,Positive,16,1,17
1352940,True,0,1 user reviews,1,0,1
1352980,True,0,No user reviews,0,0,0
1352990,True,0,No user reviews,0,0,0
1353000,True,0,No user reviews,0,0,0
1353040,True,0,No user reviews,0,0,0
1353050,True,0,1 user reviews,1,0,1
1353060,True,8,Very Positive,217,9,226
1353070,True,0,1 user reviews,1,0,1
1353080,True,7,Positive,12,2,14
1353100,True,0,No user reviews,0,0,0
1353110,True,0,No user reviews,0,0,0
1353120,True,7,Positive,14,0,14
1353130,True,0,1 user reviews,0,1,1
1353140,True,0,No user reviews,0,0,0
1353150,True,0,No user reviews,0,0,0
1353160,True,0,No user reviews,0,0,0
1353170,True,7,Positive,16,1,17
1353180,True,0,2 user reviews,1,1,2
1353210,True,0,No user reviews,0,0,0
1353230,True,0,No user reviews,0,0,0
1353250,True,0,No user reviews,0,0,0
1353260,True,0,No user reviews,0,0,0
1353270,True,0,No user reviews,0,0,0
1353290,True,0,No user reviews,0,0,0
1353300,True,5,Mixed,18,8,26
1353310,True,0,No user reviews,0,0,0
1353320,True,0,No user reviews,0,0,0
1353340,True,0,No user reviews,0,0,0
1353350,True,0,No user reviews,0,0,0
1353370,True,0,No user reviews,0,0,0
1353380,True,0,No user reviews,0,0,0
1353420,True,8,Very Positive,62,9,71
1353470,True,0,1 user reviews,1,0,1
1353480,True,0,No user reviews,0,0,0
1353490,True,0,No user reviews,0,0,0
1353520,True,7,Positive,29,0,29
1353521,True,8,Very Positive,46,4,50
1353540,True,0,No user reviews,0,0,0
1353550,True,0,2 user reviews,2,0,2
1353560,True,0,2 user reviews,2,0,2
1353600,True,0,No user reviews,0,0,0
1353630,True,0,No user reviews,0,0,0
1353650,True,0,No user reviews,0,0,0
1353660,True,0,No user reviews,0,0,0
1353670,True,0,No user reviews,0,0,0
1353680,True,0,No user reviews,0,0,0
1353690,True,0,1 user reviews,1,0,1
1353700,True,0,No user reviews,0,0,0
1353701,True,0,No user reviews,0,0,0
1353710,True,0,1 user reviews,1,0,1
1353730,True,0,No user reviews,0,0,0
1353750,True,0,No user reviews,0,0,0
1353770,True,0,1 user reviews,1,0,1
1353780,True,0,No user reviews,0,0,0
1353790,True,0,No user reviews,0,0,0
1353810,True,0,No user reviews,0,0,0
1353830,True,0,No user reviews,0,0,0
1353840,True,0,No user reviews,0,0,0
1353850,True,0,No user reviews,0,0,0
1353860,True,0,No user reviews,0,0,0
1353870,True,0,1 user reviews,0,1,1
1353880,True,0,1 user reviews,0,1,1
1353900,True,0,9 user reviews,7,2,9
1353920,True,0,No user reviews,0,0,0
1353950,True,0,No user reviews,0,0,0
1353960,True,0,No user reviews,0,0,0
1353980,True,0,3 user reviews,3,0,3
1353990,True,0,1 user reviews,1,0,1
1354000,True,0,1 user reviews,0,1,1
1354010,True,0,4 user reviews,4,0,4
1354020,True,0,No user reviews,0,0,0
1354030,True,0,No user reviews,0,0,0
1354070,True,0,No user reviews,0,0,0
1354080,True,0,2 user reviews,1,1,2
1354100,True,0,6 user reviews,6,0,6
1354110,True,0,1 user reviews,0,1,1
1354111,True,0,No user reviews,0,0,0
1354120,True,0,1 user reviews,1,0,1
1354130,True,0,No user reviews,0,0,0
1354160,True,0,No user reviews,0,0,0
1354200,True,0,No user reviews,0,0,0
1354220,True,0,No user reviews,0,0,0
1354230,True,0,No user reviews,0,0,0
1354240,True,0,No user reviews,0,0,0
1354250,True,0,1 user reviews,1,0,1
1354280,True,0,No user reviews,0,0,0
1354290,True,0,No user reviews,0,0,0
1354300,True,0,No user reviews,0,0,0
1354310,True,0,No user reviews,0,0,0
1354312,True,0,No user reviews,0,0,0
1354320,True,0,No user reviews,0,0,0
1354350,True,0,No user reviews,0,0,0
1354370,True,0,No user reviews,0,0,0
1354380,True,0,No user reviews,0,0,0
1354410,True,0,1 user reviews,0,1,1
1354420,True,0,No user reviews,0,0,0
1354430,True,0,No user reviews,0,0,0
1354431,True,0,No user reviews,0,0,0
1354460,True,0,No user reviews,0,0,0
1354510,True,0,2 user reviews,2,0,2
1354520,True,0,5 user reviews,3,2,5
1354540,True,0,No user reviews,0,0,0
1354560,True,0,No user reviews,0,0,0
1354561,True,0,No user reviews,0,0,0
1354580,True,0,1 user reviews,1,0,1
1354600,True,0,1 user reviews,1,0,1
1354620,True,0,No user reviews,0,0,0
1354630,True,0,No user reviews,0,0,0
1354631,True,0,No user reviews,0,0,0
1354650,True,0,No user reviews,0,0,0
1354670,True,0,No user reviews,0,0,0
1354690,True,0,No user reviews,0,0,0
1354740,True,0,No user reviews,0,0,0
1354741,True,0,No user reviews,0,0,0
1354750,True,0,2 user reviews,2,0,2
1354760,True,7,Positive,21,4,25
1354770,True,0,No user reviews,0,0,0
1354780,True,0,No user reviews,0,0,0
1354790,True,0,1 user reviews,1,0,1
1354800,True,0,No user reviews,0,0,0
1354810,True,0,No user reviews,0,0,0
1354811,True,0,No user reviews,0,0,0
1354812,True,0,No user reviews,0,0,0
1354813,True,0,No user reviews,0,0,0
1354814,True,0,No user reviews,0,0,0
1354815,True,0,No user reviews,0,0,0
1354816,True,0,1 user reviews,1,0,1
1354817,True,0,No user reviews,0,0,0
1354818,True,0,No user reviews,0,0,0
1354819,True,0,1 user reviews,1,0,1
1354830,True,0,No user reviews,0,0,0
1354840,True,0,No user reviews,0,0,0
1354860,True,0,No user reviews,0,0,0
1354861,True,0,No user reviews,0,0,0
1354862,True,0,No user reviews,0,0,0
1354870,True,0,No user reviews,0,0,0
1354880,True,0,No user reviews,0,0,0
1354910,True,0,No user reviews,0,0,0
1354950,True,0,No user reviews,0,0,0
1354960,True,6,Mostly Positive,19,7,26
1354970,True,0,No user reviews,0,0,0
1354990,True,0,No user reviews,0,0,0
1355010,True,0,2 user reviews,1,1,2
1355040,True,0,No user reviews,0,0,0
1355050,True,0,No user reviews,0,0,0
1355060,True,0,No user reviews,0,0,0
1355070,True,0,No user reviews,0,0,0
1355080,True,0,No user reviews,0,0,0
1355130,True,0,No user reviews,0,0,0
1355140,True,7,Positive,8,2,10
1355150,True,0,No user reviews,0,0,0
1355151,True,0,2 user reviews,2,0,2
1355160,True,0,No user reviews,0,0,0
1355180,True,0,No user reviews,0,0,0
1355210,True,0,No user reviews,0,0,0
1355230,True,0,No user reviews,0,0,0
1355240,True,0,No user reviews,0,0,0
1355270,True,0,No user reviews,0,0,0
1355280,True,0,No user reviews,0,0,0
1355281,True,0,No user reviews,0,0,0
1355282,True,0,No user reviews,0,0,0
1355283,True,0,No user reviews,0,0,0
1355290,True,0,No user reviews,0,0,0
1355300,True,0,2 user reviews,1,1,2
1355310,True,0,6 user reviews,6,0,6
1355360,True,0,No user reviews,0,0,0
1355370,True,0,7 user reviews,6,1,7
1355390,True,0,No user reviews,0,0,0
1355400,True,0,No user reviews,0,0,0
1355410,True,0,1 user reviews,1,0,1
1355420,True,0,3 user reviews,3,0,3
1355430,True,0,No user reviews,0,0,0
1355450,True,0,2 user reviews,1,1,2
1355470,True,0,No user reviews,0,0,0
1355500,True,0,No user reviews,0,0,0
1355510,True,0,4 user reviews,3,1,4
1355540,True,0,No user reviews,0,0,0
1355560,True,0,No user reviews,0,0,0
1355570,True,0,8 user reviews,8,0,8
1355590,True,0,No user reviews,0,0,0
1355600,True,0,No user reviews,0,0,0
1355610,True,0,1 user reviews,1,0,1
1355620,True,0,3 user reviews,3,0,3
1355630,True,0,1 user reviews,1,0,1
1355640,True,0,No user reviews,0,0,0
1355650,True,0,No user reviews,0,0,0
1355700,True,0,No user reviews,0,0,0
1355720,True,0,No user reviews,0,0,0
1355730,True,0,No user reviews,0,0,0
1355740,True,0,No user reviews,0,0,0
1355741,True,0,No user reviews,0,0,0
1355750,True,0,No user reviews,0,0,0
1355751,True,0,No user reviews,0,0,0
1355752,True,0,No user reviews,0,0,0
1355753,True,0,No user reviews,0,0,0
1355754,True,0,No user reviews,0,0,0
1355760,True,0,No user reviews,0,0,0
1355780,True,0,No user reviews,0,0,0
1355810,True,0,1 user reviews,1,0,1
1355820,True,0,No user reviews,0,0,0
1355830,True,0,No user reviews,0,0,0
1355840,True,0,No user reviews,0,0,0
1355850,True,0,No user reviews,0,0,0
1355851,True,0,No user reviews,0,0,0
1355852,True,0,No user reviews,0,0,0
1355853,True,0,No user reviews,0,0,0
1355854,True,0,No user reviews,0,0,0
1355855,True,0,No user reviews,0,0,0
1355856,True,0,No user reviews,0,0,0
1355857,True,0,No user reviews,0,0,0
1355858,True,0,No user reviews,0,0,0
1355859,True,0,No user reviews,0,0,0
1355870,True,0,No user reviews,0,0,0
1355871,True,0,No user reviews,0,0,0
1355872,True,0,No user reviews,0,0,0
1355880,True,0,No user reviews,0,0,0
1355890,True,0,No user reviews,0,0,0
1355910,True,0,1 user reviews,0,1,1
1355920,True,0,No user reviews,0,0,0
1355930,True,0,No user reviews,0,0,0
1355940,True,0,No user reviews,0,0,0
1355970,True,0,No user reviews,0,0,0
1355980,True,0,9 user reviews,9,0,9
1355990,True,0,No user reviews,0,0,0
1356000,True,0,No user reviews,0,0,0
1356001,True,0,No user reviews,0,0,0
1356010,True,0,No user reviews,0,0,0
1356030,True,0,No user reviews,0,0,0
1356040,True,0,No user reviews,0,0,0
1356070,True,0,No user reviews,0,0,0
1356080,True,0,No user reviews,0,0,0
1356110,True,0,No user reviews,0,0,0
1356130,True,0,No user reviews,0,0,0
1356140,True,0,No user reviews,0,0,0
1356150,True,0,No user reviews,0,0,0
1356160,True,0,No user reviews,0,0,0
1356180,True,6,Mostly Positive,25,7,32
1356190,True,5,Mixed,6,6,12
1356200,True,0,No user reviews,0,0,0
1356210,True,0,No user reviews,0,0,0
1356220,True,7,Positive,17,3,20
1356221,True,6,Mostly Positive,24,7,31
1356222,True,0,No user reviews,0,0,0
1356230,True,0,No user reviews,0,0,0
1356240,True,0,8 user reviews,3,5,8
1356250,True,0,No user reviews,0,0,0
1356260,True,0,No user reviews,0,0,0
1356270,True,0,No user reviews,0,0,0
1356280,True,0,No user reviews,0,0,0
1356300,True,0,No user reviews,0,0,0
1356330,True,0,No user reviews,0,0,0
1356331,True,0,No user reviews,0,0,0
1356340,True,0,No user reviews,0,0,0
1356360,True,0,1 user reviews,0,1,1
1356370,True,0,No user reviews,0,0,0
1356371,True,0,No user reviews,0,0,0
1356380,True,0,2 user reviews,1,1,2
1356400,True,0,No user reviews,0,0,0
1356410,True,0,3 user reviews,3,0,3
1356411,True,0,5 user reviews,5,0,5
1356420,True,0,No user reviews,0,0,0
1356430,True,0,No user reviews,0,0,0
1356440,True,4,Mostly Negative,6,10,16
1356450,True,0,No user reviews,0,0,0
1356460,True,0,No user reviews,0,0,0
1356470,True,0,No user reviews,0,0,0
1356480,True,7,Positive,31,1,32
1356490,True,0,No user reviews,0,0,0
1356500,True,0,No user reviews,0,0,0
1356510,True,0,No user reviews,0,0,0
1356530,True,0,5 user reviews,5,0,5
1356560,True,0,No user reviews,0,0,0
1356570,True,0,No user reviews,0,0,0
1356580,True,0,No user reviews,0,0,0
1356590,True,0,No user reviews,0,0,0
1356610,True,0,1 user reviews,1,0,1
1356670,True,0,No user reviews,0,0,0
1356710,True,0,5 user reviews,5,0,5
1356730,True,0,1 user reviews,1,0,1
1356731,True,0,1 user reviews,1,0,1
1356732,True,0,2 user reviews,2,0,2
1356733,True,0,1 user reviews,1,0,1
1356760,True,0,4 user reviews,4,0,4
1356790,True,0,No user reviews,0,0,0
1356800,True,0,No user reviews,0,0,0
1356830,True,0,No user reviews,0,0,0
1356850,True,0,No user reviews,0,0,0
1356860,True,0,No user reviews,0,0,0
1356880,True,0,No user reviews,0,0,0
1356890,True,0,1 user reviews,0,1,1
1356900,True,0,No user reviews,0,0,0
1356920,True,0,1 user reviews,1,0,1
1356930,True,0,2 user reviews,1,1,2
1356940,True,0,No user reviews,0,0,0
1356970,True,0,No user reviews,0,0,0
1356980,True,0,No user reviews,0,0,0
1357000,True,0,No user reviews,0,0,0
1357020,True,0,No user reviews,0,0,0
1357040,True,0,No user reviews,0,0,0
1357070,True,5,Mixed,6,6,12
1357080,True,0,No user reviews,0,0,0
1357090,True,0,No user reviews,0,0,0
1357150,True,0,No user reviews,0,0,0
1357160,True,0,No user reviews,0,0,0
1357170,True,0,No user reviews,0,0,0
1357171,True,0,No user reviews,0,0,0
1357180,True,0,No user reviews,0,0,0
1357190,True,0,1 user reviews,0,1,1
1357200,True,0,1 user reviews,1,0,1
1357220,True,0,No user reviews,0,0,0
1357230,True,0,No user reviews,0,0,0
1357250,True,0,No user reviews,0,0,0
1357260,True,0,No user reviews,0,0,0
1357270,True,0,1 user reviews,0,1,1
1357280,True,0,1 user reviews,1,0,1
1357310,True,0,No user reviews,0,0,0
1357311,True,0,No user reviews,0,0,0
1357312,True,0,No user reviews,0,0,0
1357330,True,0,6 user reviews,2,4,6
1357350,True,0,No user reviews,0,0,0
1357400,True,0,No user reviews,0,0,0
1357410,True,0,4 user reviews,4,0,4
1357470,True,0,No user reviews,0,0,0
1357490,True,0,1 user reviews,1,0,1
1357520,True,0,No user reviews,0,0,0
1357540,True,0,No user reviews,0,0,0
1357550,True,0,No user reviews,0,0,0
1357560,True,0,No user reviews,0,0,0
1357570,True,0,No user reviews,0,0,0
1357580,True,0,No user reviews,0,0,0
1357590,True,0,No user reviews,0,0,0
1357610,True,7,Positive,40,7,47
1357640,True,0,No user reviews,0,0,0
1357670,True,8,Very Positive,57,13,70
1357690,True,0,1 user reviews,1,0,1
1357700,True,0,No user reviews,0,0,0
1357710,True,0,No user reviews,0,0,0
1357730,True,0,No user reviews,0,0,0
1357740,True,0,2 user reviews,1,1,2
1357750,True,0,5 user reviews,5,0,5
1357830,True,7,Positive,15,0,15
1357840,True,0,4 user reviews,4,0,4
1357870,True,0,3 user reviews,3,0,3
1357880,True,0,No user reviews,0,0,0
1357890,True,0,No user reviews,0,0,0
1357900,True,0,1 user reviews,1,0,1
1357910,True,0,2 user reviews,2,0,2
1357930,True,0,4 user reviews,4,0,4
1357940,True,4,Mostly Negative,5,9,14
1357950,True,0,No user reviews,0,0,0
1357960,True,0,No user reviews,0,0,0
1357970,True,0,No user reviews,0,0,0
1357990,True,0,No user reviews,0,0,0
1358000,True,0,No user reviews,0,0,0
1358010,True,0,No user reviews,0,0,0
1358020,True,0,No user reviews,0,0,0
1358030,True,7,Positive,15,0,15
1358050,True,0,No user reviews,0,0,0
1358070,True,0,1 user reviews,1,0,1
1358090,True,7,Positive,47,0,47
1358100,True,0,No user reviews,0,0,0
1358110,True,0,No user reviews,0,0,0
1358120,True,0,No user reviews,0,0,0
1358140,True,0,No user reviews,0,0,0
1358150,True,0,No user reviews,0,0,0
1358160,True,0,No user reviews,0,0,0
1358161,True,0,No user reviews,0,0,0
1358162,True,0,No user reviews,0,0,0
1358180,True,0,No user reviews,0,0,0
1358200,True,0,No user reviews,0,0,0
1358220,True,0,No user reviews,0,0,0
1358240,True,0,No user reviews,0,0,0
1358250,True,8,Very Positive,289,11,300
1358260,True,0,No user reviews,0,0,0
1358270,True,0,8 user reviews,3,5,8
1358280,True,0,No user reviews,0,0,0
1358300,True,0,No user reviews,0,0,0
1358320,True,0,No user reviews,0,0,0
1358350,True,0,No user reviews,0,0,0
1358360,True,0,No user reviews,0,0,0
1358430,True,0,1 user reviews,1,0,1
1358470,True,0,No user reviews,0,0,0
1358480,True,0,No user reviews,0,0,0
1358500,True,0,No user reviews,0,0,0
1358510,True,0,No user reviews,0,0,0
1358530,True,0,No user reviews,0,0,0
1358540,True,0,1 user reviews,1,0,1
1358560,True,0,No user reviews,0,0,0
1358570,True,0,3 user reviews,3,0,3
1358590,True,0,No user reviews,0,0,0
1358610,True,0,No user reviews,0,0,0
1358630,True,0,No user reviews,0,0,0
1358640,True,0,2 user reviews,2,0,2
1358650,True,0,2 user reviews,1,1,2
1358720,True,0,No user reviews,0,0,0
1358730,True,0,No user reviews,0,0,0
1358760,True,0,No user reviews,0,0,0
1358770,True,0,No user reviews,0,0,0
1358800,True,0,No user reviews,0,0,0
1358830,True,0,No user reviews,0,0,0
1358860,True,0,No user reviews,0,0,0
1358890,True,0,No user reviews,0,0,0
1358900,True,0,No user reviews,0,0,0
1358930,True,0,No user reviews,0,0,0
1358940,True,0,No user reviews,0,0,0
1358970,True,0,No user reviews,0,0,0
1358980,True,0,No user reviews,0,0,0
1358990,True,0,1 user reviews,1,0,1
1359000,True,0,No user reviews,0,0,0
1359020,True,0,No user reviews,0,0,0
1359050,True,0,No user reviews,0,0,0
1359080,True,0,No user reviews,0,0,0
1359090,True,6,Mostly Positive,601,210,811
1359110,True,0,No user reviews,0,0,0
1359120,True,7,Positive,17,2,19
1359160,True,0,1 user reviews,0,1,1
1359170,True,0,2 user reviews,2,0,2
1359180,True,0,No user reviews,0,0,0
1359200,True,0,No user reviews,0,0,0
1359210,True,0,No user reviews,0,0,0
1359230,True,0,No user reviews,0,0,0
1359240,True,0,No user reviews,0,0,0
1359260,True,0,No user reviews,0,0,0
1359270,True,0,No user reviews,0,0,0
1359280,True,0,3 user reviews,1,2,3
1359290,True,0,No user reviews,0,0,0
1359300,True,0,No user reviews,0,0,0
1359310,True,7,Positive,11,0,11
1359340,True,0,1 user reviews,1,0,1
1359440,True,0,No user reviews,0,0,0
1359450,True,0,No user reviews,0,0,0
1359460,True,0,No user reviews,0,0,0
1359470,True,0,3 user reviews,1,2,3
1359490,True,0,No user reviews,0,0,0
1359520,True,5,Mixed,17,15,32
1359550,True,0,No user reviews,0,0,0
1359560,True,0,No user reviews,0,0,0
1359590,True,0,3 user reviews,3,0,3
1359610,True,0,1 user reviews,0,1,1
1359650,True,8,Very Positive,171,33,204
1359660,True,0,2 user reviews,2,0,2
1359670,True,0,No user reviews,0,0,0
1359720,True,0,No user reviews,0,0,0
1359760,True,0,7 user reviews,7,0,7
1359780,True,0,No user reviews,0,0,0
1359800,True,0,No user reviews,0,0,0
1359820,True,0,3 user reviews,2,1,3
1359840,True,0,1 user reviews,0,1,1
1359850,True,0,1 user reviews,1,0,1
1359870,True,0,7 user reviews,1,6,7
1359880,True,0,No user reviews,0,0,0
1359890,True,0,No user reviews,0,0,0
1359900,True,0,No user reviews,0,0,0
1359910,True,0,1 user reviews,0,1,1
1359920,True,0,No user reviews,0,0,0
1359950,True,0,No user reviews,0,0,0
1359970,True,0,No user reviews,0,0,0
1359980,True,0,No user reviews,0,0,0
1359990,True,0,No user reviews,0,0,0
1360000,True,8,Very Positive,338,42,380
1360010,True,0,No user reviews,0,0,0
1360020,True,0,No user reviews,0,0,0
1360040,True,0,No user reviews,0,0,0
1360060,True,0,No user reviews,0,0,0
1360080,True,0,4 user reviews,4,0,4
1360090,True,0,No user reviews,0,0,0
1360130,True,0,No user reviews,0,0,0
1360140,True,0,No user reviews,0,0,0
1360150,True,0,No user reviews,0,0,0
1360160,True,0,No user reviews,0,0,0
1360190,True,0,No user reviews,0,0,0
1360220,True,0,No user reviews,0,0,0
1360240,True,0,No user reviews,0,0,0
1360250,True,0,No user reviews,0,0,0
1360260,True,0,1 user reviews,1,0,1
1360270,True,0,No user reviews,0,0,0
1360280,True,0,No user reviews,0,0,0
1360290,True,0,2 user reviews,2,0,2
1360300,True,0,No user reviews,0,0,0
1360310,True,0,No user reviews,0,0,0
1360311,True,0,No user reviews,0,0,0
1360312,True,0,No user reviews,0,0,0
1360313,True,0,No user reviews,0,0,0
1360314,True,0,No user reviews,0,0,0
1360315,True,0,No user reviews,0,0,0
1360316,True,0,No user reviews,0,0,0
1360317,True,0,No user reviews,0,0,0
1360318,True,0,No user reviews,0,0,0
1360319,True,0,No user reviews,0,0,0
1360320,True,0,No user reviews,0,0,0
1360321,True,0,No user reviews,0,0,0
1360322,True,0,No user reviews,0,0,0
1360323,True,0,No user reviews,0,0,0
1360324,True,0,No user reviews,0,0,0
1360325,True,0,No user reviews,0,0,0
1360326,True,0,No user reviews,0,0,0
1360327,True,0,No user reviews,0,0,0
1360328,True,0,No user reviews,0,0,0
1360329,True,0,No user reviews,0,0,0
1360330,True,0,No user reviews,0,0,0
1360331,True,0,No user reviews,0,0,0
1360332,True,0,No user reviews,0,0,0
1360333,True,0,No user reviews,0,0,0
1360334,True,0,No user reviews,0,0,0
1360335,True,0,No user reviews,0,0,0
1360340,True,0,No user reviews,0,0,0
1360341,True,0,No user reviews,0,0,0
1360342,True,0,No user reviews,0,0,0
1360343,True,0,No user reviews,0,0,0
1360344,True,0,No user reviews,0,0,0
1360345,True,0,No user reviews,0,0,0
1360346,True,0,No user reviews,0,0,0
1360347,True,0,No user reviews,0,0,0
1360348,True,0,No user reviews,0,0,0
1360349,True,0,No user reviews,0,0,0
1360350,True,0,No user reviews,0,0,0
1360351,True,0,No user reviews,0,0,0
1360352,True,0,No user reviews,0,0,0
1360353,True,0,No user reviews,0,0,0
1360354,True,0,No user reviews,0,0,0
1360355,True,0,No user reviews,0,0,0
1360356,True,0,No user reviews,0,0,0
1360357,True,0,No user reviews,0,0,0
1360360,True,0,1 user reviews,0,1,1
1360370,True,0,No user reviews,0,0,0
1360390,True,0,No user reviews,0,0,0
1360400,True,0,No user reviews,0,0,0
1360430,True,0,No user reviews,0,0,0
1360440,True,0,No user reviews,0,0,0
1360480,True,0,No user reviews,0,0,0
1360490,True,0,No user reviews,0,0,0
1360500,True,0,No user reviews,0,0,0
1360510,True,0,2 user reviews,2,0,2
1360530,True,0,6 user reviews,4,2,6
1360540,True,0,No user reviews,0,0,0
1360550,True,0,No user reviews,0,0,0
1360560,True,0,1 user reviews,0,1,1
1360570,True,0,No user reviews,0,0,0
1360580,True,0,No user reviews,0,0,0
1360620,True,0,No user reviews,0,0,0
1360630,True,0,No user reviews,0,0,0
1360650,True,0,No user reviews,0,0,0
1360660,True,0,No user reviews,0,0,0
1360670,True,0,4 user reviews,3,1,4
1360680,True,0,No user reviews,0,0,0
1360720,True,0,No user reviews,0,0,0
1360760,True,0,No user reviews,0,0,0
1360790,True,0,No user reviews,0,0,0
1360810,True,0,No user reviews,0,0,0
1360820,True,0,No user reviews,0,0,0
1360850,True,0,No user reviews,0,0,0
1360870,True,0,1 user reviews,1,0,1
1360880,True,0,No user reviews,0,0,0
1360890,True,0,No user reviews,0,0,0
1360900,True,0,No user reviews,0,0,0
1360910,True,0,No user reviews,0,0,0
1360920,True,0,No user reviews,0,0,0
1360950,True,0,No user reviews,0,0,0
1360970,True,0,No user reviews,0,0,0
1360980,True,8,Very Positive,125,22,147
1361000,True,8,Very Positive,516,87,603
1361010,True,0,No user reviews,0,0,0
1361020,True,0,4 user reviews,4,0,4
1361030,True,0,No user reviews,0,0,0
1361060,True,0,No user reviews,0,0,0
1361070,True,0,No user reviews,0,0,0
1361080,True,0,No user reviews,0,0,0
1361110,True,8,Very Positive,75,5,80
1361120,True,0,3 user reviews,3,0,3
1361150,True,0,1 user reviews,1,0,1
1361170,True,0,No user reviews,0,0,0
1361180,True,0,1 user reviews,1,0,1
1361190,True,0,3 user reviews,3,0,3
1361200,True,0,No user reviews,0,0,0
1361210,True,0,No user reviews,0,0,0
1361230,True,0,No user reviews,0,0,0
1361240,True,0,No user reviews,0,0,0
1361250,True,0,No user reviews,0,0,0
1361260,True,0,2 user reviews,2,0,2
1361270,True,0,No user reviews,0,0,0
1361280,True,8,Very Positive,120,18,138
1361310,True,0,No user reviews,0,0,0
1361311,True,0,No user reviews,0,0,0
1361330,True,0,No user reviews,0,0,0
1361340,True,0,No user reviews,0,0,0
1361350,True,0,No user reviews,0,0,0
1361360,True,0,No user reviews,0,0,0
1361370,True,0,No user reviews,0,0,0
1361390,True,0,2 user reviews,2,0,2
1361420,True,0,No user reviews,0,0,0
1361430,True,0,1 user reviews,1,0,1
1361440,True,0,1 user reviews,1,0,1
1361450,True,0,No user reviews,0,0,0
1361470,True,0,1 user reviews,1,0,1
1361480,True,0,No user reviews,0,0,0
1361490,True,0,No user reviews,0,0,0
1361500,True,0,No user reviews,0,0,0
1361520,True,0,6 user reviews,6,0,6
1361530,True,0,No user reviews,0,0,0
1361540,True,0,1 user reviews,1,0,1
1361560,True,0,1 user reviews,0,1,1
1361580,True,0,No user reviews,0,0,0
1361590,True,0,No user reviews,0,0,0
1361591,True,0,1 user reviews,0,1,1
1361610,True,0,No user reviews,0,0,0
1361620,True,0,No user reviews,0,0,0
1361630,True,0,No user reviews,0,0,0
1361660,True,0,No user reviews,0,0,0
1361680,True,0,No user reviews,0,0,0
1361700,True,8,Very Positive,458,19,477
1361720,True,0,No user reviews,0,0,0
1361740,True,0,2 user reviews,2,0,2
1361760,True,0,7 user reviews,6,1,7
1361770,True,0,No user reviews,0,0,0
1361790,True,0,No user reviews,0,0,0
1361810,True,0,No user reviews,0,0,0
1361840,True,0,No user reviews,0,0,0
1361860,True,7,Positive,14,3,17
1361870,True,0,No user reviews,0,0,0
1361890,True,0,No user reviews,0,0,0
1361900,True,0,No user reviews,0,0,0
1361920,True,7,Positive,17,2,19
1361930,True,0,No user reviews,0,0,0
1361940,True,0,No user reviews,0,0,0
1361950,True,0,1 user reviews,1,0,1
1361960,True,0,No user reviews,0,0,0
1361980,True,0,No user reviews,0,0,0
1361990,True,0,No user reviews,0,0,0
1362000,True,0,No user reviews,0,0,0
1362040,True,0,No user reviews,0,0,0
1362060,True,0,No user reviews,0,0,0
1362070,True,0,No user reviews,0,0,0
1362080,True,0,No user reviews,0,0,0
1362100,True,0,No user reviews,0,0,0
1362101,True,0,No user reviews,0,0,0
1362102,True,0,No user reviews,0,0,0
1362103,True,0,No user reviews,0,0,0
1362104,True,0,No user reviews,0,0,0
1362105,True,0,No user reviews,0,0,0
1362106,True,0,No user reviews,0,0,0
1362107,True,0,No user reviews,0,0,0
1362108,True,0,No user reviews,0,0,0
1362109,True,0,No user reviews,0,0,0
1362110,True,0,No user reviews,0,0,0
1362111,True,0,No user reviews,0,0,0
1362112,True,0,No user reviews,0,0,0
1362113,True,0,No user reviews,0,0,0
1362114,True,0,No user reviews,0,0,0
1362115,True,0,No user reviews,0,0,0
1362116,True,0,1 user reviews,0,1,1
1362117,True,0,1 user reviews,1,0,1
1362118,True,0,1 user reviews,1,0,1
1362119,True,0,No user reviews,0,0,0
1362120,True,0,No user reviews,0,0,0
1362130,True,0,4 user reviews,3,1,4
1362140,True,0,No user reviews,0,0,0
1362150,True,0,1 user reviews,0,1,1
1362151,True,0,No user reviews,0,0,0
1362152,True,0,No user reviews,0,0,0
1362153,True,0,No user reviews,0,0,0
1362154,True,0,No user reviews,0,0,0
1362155,True,0,No user reviews,0,0,0
1362156,True,0,No user reviews,0,0,0
1362157,True,0,No user reviews,0,0,0
1362158,True,0,No user reviews,0,0,0
1362159,True,0,No user reviews,0,0,0
1362160,True,0,No user reviews,0,0,0
1362161,True,0,No user reviews,0,0,0
1362162,True,0,1 user reviews,0,1,1
1362163,True,0,No user reviews,0,0,0
1362164,True,0,No user reviews,0,0,0
1362165,True,0,No user reviews,0,0,0
1362166,True,0,No user reviews,0,0,0
1362168,True,0,No user reviews,0,0,0
1362169,True,0,No user reviews,0,0,0
1362170,True,0,No user reviews,0,0,0
1362171,True,0,No user reviews,0,0,0
1362172,True,0,No user reviews,0,0,0
1362173,True,0,No user reviews,0,0,0
1362174,True,0,No user reviews,0,0,0
1362175,True,0,No user reviews,0,0,0
1362176,True,0,No user reviews,0,0,0
1362177,True,0,No user reviews,0,0,0
1362178,True,0,No user reviews,0,0,0
1362179,True,0,No user reviews,0,0,0
1362180,True,0,1 user reviews,1,0,1
1362190,True,0,1 user reviews,1,0,1
1362210,True,0,No user reviews,0,0,0
1362220,True,0,No user reviews,0,0,0
1362221,True,0,No user reviews,0,0,0
1362222,True,0,No user reviews,0,0,0
1362223,True,0,No user reviews,0,0,0
1362224,True,0,No user reviews,0,0,0
1362230,True,0,No user reviews,0,0,0
1362260,True,0,No user reviews,0,0,0
1362270,True,0,1 user reviews,1,0,1
1362290,True,0,No user reviews,0,0,0
1362310,True,0,No user reviews,0,0,0
1362330,True,0,4 user reviews,4,0,4
1362340,True,0,No user reviews,0,0,0
1362350,True,0,No user reviews,0,0,0
1362370,True,0,No user reviews,0,0,0
1362390,True,0,No user reviews,0,0,0
1362400,True,0,No user reviews,0,0,0
1362410,True,0,No user reviews,0,0,0
1362420,True,0,No user reviews,0,0,0
1362430,True,5,Mixed,10,6,16
1362450,True,0,1 user reviews,0,1,1
1362460,True,0,3 user reviews,2,1,3
1362470,True,0,No user reviews,0,0,0
1362510,True,0,No user reviews,0,0,0
1362520,True,0,No user reviews,0,0,0
1362580,True,0,No user reviews,0,0,0
1362600,True,0,1 user reviews,1,0,1
1362601,True,0,1 user reviews,1,0,1
1362602,True,0,No user reviews,0,0,0
1362620,True,0,No user reviews,0,0,0
1362640,True,0,No user reviews,0,0,0
1362650,True,0,No user reviews,0,0,0
1362660,True,8,Very Positive,247,58,305
1362670,True,0,1 user reviews,1,0,1
1362700,True,0,2 user reviews,0,2,2
1362720,True,0,1 user reviews,1,0,1
1362730,True,0,No user reviews,0,0,0
1362750,True,0,1 user reviews,1,0,1
1362760,True,0,No user reviews,0,0,0
1362780,True,0,No user reviews,0,0,0
1362790,True,0,No user reviews,0,0,0
1362820,True,0,No user reviews,0,0,0
1362840,True,0,No user reviews,0,0,0
1362850,True,0,No user reviews,0,0,0
1362860,True,0,2 user reviews,2,0,2
1362890,True,0,No user reviews,0,0,0
1362910,True,0,No user reviews,0,0,0
1362930,True,0,No user reviews,0,0,0
1362980,True,0,1 user reviews,0,1,1
1362990,True,0,3 user reviews,0,3,3
1363010,True,0,No user reviews,0,0,0
1363020,True,0,1 user reviews,1,0,1
1363080,True,0,No user reviews,0,0,0
1363090,True,0,1 user reviews,1,0,1
1363120,True,0,No user reviews,0,0,0
1363140,True,0,8 user reviews,7,1,8
1363170,True,0,1 user reviews,1,0,1
1363200,True,0,2 user reviews,2,0,2
1363210,True,0,No user reviews,0,0,0
1363240,True,0,No user reviews,0,0,0
1363250,True,0,1 user reviews,0,1,1
1363270,True,0,No user reviews,0,0,0
1363280,True,0,No user reviews,0,0,0
1363290,True,0,4 user reviews,0,4,4
1363310,True,0,No user reviews,0,0,0
1363350,True,0,No user reviews,0,0,0
1363360,True,0,No user reviews,0,0,0
1363370,True,0,No user reviews,0,0,0
1363390,True,0,1 user reviews,0,1,1
1363400,True,0,No user reviews,0,0,0
1363410,True,0,No user reviews,0,0,0
1363430,True,0,No user reviews,0,0,0
1363450,True,0,3 user reviews,1,2,3
1363470,True,0,No user reviews,0,0,0
1363490,True,0,No user reviews,0,0,0
1363500,True,0,No user reviews,0,0,0
1363560,True,0,4 user reviews,4,0,4
1363600,True,0,7 user reviews,7,0,7
1363620,True,0,No user reviews,0,0,0
1363640,True,0,No user reviews,0,0,0
1363650,True,0,No user reviews,0,0,0
1363660,True,0,6 user reviews,3,3,6
1363680,True,0,No user reviews,0,0,0
1363690,True,0,3 user reviews,2,1,3
1363730,True,0,No user reviews,0,0,0
1363750,True,0,No user reviews,0,0,0
1363770,True,6,Mostly Positive,34,10,44
1363790,True,0,No user reviews,0,0,0
1363810,True,0,No user reviews,0,0,0
1363840,True,0,No user reviews,0,0,0
1363850,True,7,Positive,12,0,12
1363860,True,0,No user reviews,0,0,0
1363880,True,0,1 user reviews,1,0,1
1363910,True,0,No user reviews,0,0,0
1363960,True,0,No user reviews,0,0,0
1363980,True,0,4 user reviews,4,0,4
1364000,True,0,2 user reviews,2,0,2
1364010,True,0,9 user reviews,8,1,9
1364020,True,0,No user reviews,0,0,0
1364030,True,0,1 user reviews,1,0,1
1364032,True,0,1 user reviews,1,0,1
1364033,True,4,Mostly Negative,15,41,56
1364034,True,7,Positive,11,2,13
1364035,True,0,1 user reviews,1,0,1
1364040,True,0,No user reviews,0,0,0
1364080,True,0,No user reviews,0,0,0
1364100,True,0,No user reviews,0,0,0
1364110,True,0,3 user reviews,1,2,3
1364111,True,0,4 user reviews,3,1,4
1364130,True,7,Positive,14,3,17
1364140,True,5,Mixed,34,35,69
1364150,True,0,No user reviews,0,0,0
1364160,True,0,No user reviews,0,0,0
1364170,True,0,No user reviews,0,0,0
1364180,True,0,No user reviews,0,0,0
1364190,True,0,1 user reviews,1,0,1
1364240,True,0,No user reviews,0,0,0
1364280,True,0,No user reviews,0,0,0
1364330,True,0,1 user reviews,1,0,1
1364340,True,0,No user reviews,0,0,0
1364350,True,0,No user reviews,0,0,0
1364360,True,0,No user reviews,0,0,0
1364390,True,0,No user reviews,0,0,0
1364400,True,0,1 user reviews,1,0,1
1364410,True,0,No user reviews,0,0,0
1364430,True,0,1 user reviews,1,0,1
1364440,True,0,No user reviews,0,0,0
1364450,True,0,No user reviews,0,0,0
1364460,True,0,No user reviews,0,0,0
1364470,True,0,2 user reviews,2,0,2
1364480,True,0,No user reviews,0,0,0
1364490,True,0,No user reviews,0,0,0
1364500,True,0,No user reviews,0,0,0
1364510,True,0,No user reviews,0,0,0
1364520,True,0,No user reviews,0,0,0
1364521,True,0,No user reviews,0,0,0
1364530,True,0,No user reviews,0,0,0
1364550,True,0,No user reviews,0,0,0
1364570,True,0,No user reviews,0,0,0
1364580,True,0,No user reviews,0,0,0
1364590,True,0,No user reviews,0,0,0
1364620,True,0,No user reviews,0,0,0
1364650,True,0,No user reviews,0,0,0
1364660,True,0,No user reviews,0,0,0
1364661,True,0,No user reviews,0,0,0
1364662,True,0,No user reviews,0,0,0
1364663,True,0,No user reviews,0,0,0
1364664,True,0,No user reviews,0,0,0
1364690,True,0,No user reviews,0,0,0
1364710,True,0,No user reviews,0,0,0
1364730,True,7,Positive,17,0,17
1364740,True,0,No user reviews,0,0,0
1364750,True,0,No user reviews,0,0,0
1364800,True,0,No user reviews,0,0,0
1364830,True,0,No user reviews,0,0,0
1364840,True,0,5 user reviews,2,3,5
1364880,True,0,No user reviews,0,0,0
1364890,True,0,No user reviews,0,0,0
1364910,True,0,No user reviews,0,0,0
1364920,True,0,No user reviews,0,0,0
1364940,True,0,No user reviews,0,0,0
1364950,True,0,7 user reviews,6,1,7
1364960,True,0,No user reviews,0,0,0
1364971,True,0,3 user reviews,2,1,3
1364980,True,0,9 user reviews,8,1,9
1365000,True,0,No user reviews,0,0,0
1365010,True,7,Positive,19,0,19
1365020,True,0,1 user reviews,1,0,1
1365030,True,7,Positive,21,0,21
1365050,True,0,No user reviews,0,0,0
1365060,True,0,1 user reviews,1,0,1
1365140,True,0,No user reviews,0,0,0
1365380,True,0,No user reviews,0,0,0
1365390,True,0,3 user reviews,2,1,3
1365410,True,0,No user reviews,0,0,0
1365420,True,0,2 user reviews,1,1,2
1365450,True,0,No user reviews,0,0,0
1365490,True,0,5 user reviews,5,0,5
1365510,True,0,No user reviews,0,0,0
1365520,True,0,No user reviews,0,0,0
1365530,True,0,No user reviews,0,0,0
1365550,True,0,2 user reviews,2,0,2
1365560,True,0,5 user reviews,2,3,5
1365580,True,0,No user reviews,0,0,0
1365590,True,0,No user reviews,0,0,0
1365600,True,0,No user reviews,0,0,0
1365620,True,0,4 user reviews,2,2,4
1365630,True,0,2 user reviews,2,0,2
1365640,True,0,No user reviews,0,0,0
1365650,True,0,No user reviews,0,0,0
1365660,True,0,1 user reviews,0,1,1
1365680,True,0,No user reviews,0,0,0
1365700,True,0,1 user reviews,0,1,1
1365710,True,0,No user reviews,0,0,0
1365720,True,0,No user reviews,0,0,0
1365750,True,0,No user reviews,0,0,0
1365780,True,0,No user reviews,0,0,0
1365810,True,0,No user reviews,0,0,0
1365820,True,0,No user reviews,0,0,0
1365870,True,0,No user reviews,0,0,0
1365900,True,0,No user reviews,0,0,0
1365910,True,0,No user reviews,0,0,0
1365930,True,7,Positive,25,0,25
1365940,True,0,No user reviews,0,0,0
1365950,True,0,1 user reviews,1,0,1
1365990,True,0,No user reviews,0,0,0
1366000,True,0,No user reviews,0,0,0
1366010,True,0,No user reviews,0,0,0
1366040,True,0,No user reviews,0,0,0
1366050,True,0,No user reviews,0,0,0
1366060,True,0,No user reviews,0,0,0
1366090,True,0,5 user reviews,5,0,5
1366091,True,8,Very Positive,116,5,121
1366110,True,0,No user reviews,0,0,0
1366120,True,0,No user reviews,0,0,0
1366130,True,0,No user reviews,0,0,0
1366140,True,0,No user reviews,0,0,0
1366150,True,0,7 user reviews,7,0,7
1366160,True,0,No user reviews,0,0,0
1366180,True,0,No user reviews,0,0,0
1366200,True,0,No user reviews,0,0,0
1366220,True,0,No user reviews,0,0,0
1366230,True,0,No user reviews,0,0,0
1366270,True,0,No user reviews,0,0,0
1366290,True,0,No user reviews,0,0,0
1366310,True,0,No user reviews,0,0,0
1366320,True,0,No user reviews,0,0,0
1366360,True,7,Positive,12,0,12
1366370,True,0,No user reviews,0,0,0
1366420,True,0,4 user reviews,3,1,4
1366470,True,0,No user reviews,0,0,0
1366510,True,0,No user reviews,0,0,0
1366530,True,0,No user reviews,0,0,0
1366540,True,0,No user reviews,0,0,0
1366550,True,0,2 user reviews,1,1,2
1366560,True,0,No user reviews,0,0,0
1366570,True,0,2 user reviews,2,0,2
1366600,True,0,No user reviews,0,0,0
1366610,True,0,3 user reviews,3,0,3
1366620,True,0,No user reviews,0,0,0
1366640,True,0,No user reviews,0,0,0
1366650,True,0,No user reviews,0,0,0
1366680,True,0,No user reviews,0,0,0
1366700,True,0,1 user reviews,1,0,1
1366710,True,0,1 user reviews,1,0,1
1366720,True,0,No user reviews,0,0,0
1366740,True,0,No user reviews,0,0,0
1366750,True,0,1 user reviews,1,0,1
1366800,True,0,No user reviews,0,0,0
1366810,True,0,3 user reviews,3,0,3
1366830,True,0,No user reviews,0,0,0
1366840,True,0,No user reviews,0,0,0
1366890,True,0,No user reviews,0,0,0
1366900,True,5,Mixed,40,21,61
1366910,True,0,No user reviews,0,0,0
1366920,True,0,No user reviews,0,0,0
1366930,True,0,No user reviews,0,0,0
1366940,True,0,No user reviews,0,0,0
1366970,True,0,No user reviews,0,0,0
1367000,True,0,No user reviews,0,0,0
1367030,True,0,No user reviews,0,0,0
1367040,True,0,No user reviews,0,0,0
1367050,True,0,No user reviews,0,0,0
1367110,True,0,2 user reviews,2,0,2
1367130,True,0,1 user reviews,1,0,1
1367140,True,0,No user reviews,0,0,0
1367150,True,0,No user reviews,0,0,0
1367180,True,0,No user reviews,0,0,0
1367190,True,0,No user reviews,0,0,0
1367220,True,0,No user reviews,0,0,0
1367230,True,0,1 user reviews,1,0,1
1367250,True,0,3 user reviews,3,0,3
1367270,True,0,No user reviews,0,0,0
1367300,True,0,No user reviews,0,0,0
1367320,True,0,1 user reviews,1,0,1
1367340,True,0,1 user reviews,0,1,1
1367350,True,0,1 user reviews,1,0,1
1367360,True,0,No user reviews,0,0,0
1367380,True,0,No user reviews,0,0,0
1367390,True,0,No user reviews,0,0,0
1367400,True,0,No user reviews,0,0,0
1367420,True,0,No user reviews,0,0,0
1367430,True,0,4 user reviews,3,1,4
1367440,True,0,No user reviews,0,0,0
1367470,True,0,No user reviews,0,0,0
1367480,True,0,1 user reviews,1,0,1
1367500,True,0,No user reviews,0,0,0
1367510,True,0,No user reviews,0,0,0
1367520,True,0,6 user reviews,6,0,6
1367550,True,8,Very Positive,228,17,245
1367570,True,0,No user reviews,0,0,0
1367580,True,0,No user reviews,0,0,0
1367590,True,0,No user reviews,0,0,0
1367610,True,0,No user reviews,0,0,0
1367620,True,0,1 user reviews,0,1,1
1367630,True,0,No user reviews,0,0,0
1367640,True,0,No user reviews,0,0,0
1367650,True,0,No user reviews,0,0,0
1367660,True,0,No user reviews,0,0,0
1367670,True,0,No user reviews,0,0,0
1367690,True,6,Mostly Positive,39,10,49
1367720,True,0,No user reviews,0,0,0
1367740,True,0,No user reviews,0,0,0
1367750,True,0,8 user reviews,6,2,8
1367770,True,0,1 user reviews,1,0,1
1367780,True,0,No user reviews,0,0,0
1367800,True,0,No user reviews,0,0,0
1367801,True,0,No user reviews,0,0,0
1367810,True,0,No user reviews,0,0,0
1367850,True,0,No user reviews,0,0,0
1367860,True,0,No user reviews,0,0,0
1367870,True,0,No user reviews,0,0,0
1367880,True,0,No user reviews,0,0,0
1367890,True,0,No user reviews,0,0,0
1367930,True,0,1 user reviews,1,0,1
1367940,True,0,No user reviews,0,0,0
1367950,True,0,2 user reviews,0,2,2
1367960,True,0,No user reviews,0,0,0
1367970,True,0,2 user reviews,1,1,2
1367980,True,0,No user reviews,0,0,0
1368000,True,0,No user reviews,0,0,0
1368030,True,0,No user reviews,0,0,0
1368040,True,0,No user reviews,0,0,0
1368060,True,0,3 user reviews,1,2,3
1368090,True,0,No user reviews,0,0,0
1368110,True,0,1 user reviews,0,1,1
1368120,True,0,2 user reviews,2,0,2
1368210,True,7,Positive,18,1,19
1368240,True,0,No user reviews,0,0,0
1368250,True,0,No user reviews,0,0,0
1368260,True,0,No user reviews,0,0,0
1368290,True,0,No user reviews,0,0,0
1368330,True,0,No user reviews,0,0,0
1368340,True,0,No user reviews,0,0,0
1368350,True,0,No user reviews,0,0,0
1368360,True,0,No user reviews,0,0,0
1368370,True,0,No user reviews,0,0,0
1368380,True,0,No user reviews,0,0,0
1368390,True,0,No user reviews,0,0,0
1368400,True,0,No user reviews,0,0,0
1368420,True,0,No user reviews,0,0,0
1368430,True,0,No user reviews,0,0,0
1368440,True,0,No user reviews,0,0,0
1368450,True,0,No user reviews,0,0,0
1368460,True,0,No user reviews,0,0,0
1368520,True,0,No user reviews,0,0,0
1368530,True,0,No user reviews,0,0,0
1368560,True,0,1 user reviews,1,0,1
1368570,True,0,1 user reviews,1,0,1
1368572,True,0,No user reviews,0,0,0
1368580,True,0,No user reviews,0,0,0
1368600,True,0,No user reviews,0,0,0
1368610,True,0,No user reviews,0,0,0
1368620,True,0,No user reviews,0,0,0
1368630,True,0,1 user reviews,1,0,1
1368640,True,0,1 user reviews,1,0,1
1368670,True,0,No user reviews,0,0,0
1368680,True,0,No user reviews,0,0,0
1368700,True,0,No user reviews,0,0,0
1368740,True,0,2 user reviews,2,0,2
1368750,True,0,2 user reviews,2,0,2
1368760,True,0,No user reviews,0,0,0
1368770,True,0,5 user reviews,2,3,5
1368790,True,0,No user reviews,0,0,0
1368800,True,0,3 user reviews,1,2,3
1368801,True,0,1 user reviews,1,0,1
1368810,True,5,Mixed,8,5,13
1368820,True,8,Very Positive,67,13,80
1368830,True,0,No user reviews,0,0,0
1368850,True,0,No user reviews,0,0,0
1368860,True,0,No user reviews,0,0,0
1368870,True,0,No user reviews,0,0,0
1368880,True,0,No user reviews,0,0,0
1368920,True,0,No user reviews,0,0,0
1368950,True,0,No user reviews,0,0,0
1368970,True,0,No user reviews,0,0,0
1368980,True,0,No user reviews,0,0,0
1368981,True,0,No user reviews,0,0,0
1368982,True,0,No user reviews,0,0,0
1368983,True,0,No user reviews,0,0,0
1368984,True,0,No user reviews,0,0,0
1369020,True,0,No user reviews,0,0,0
1369100,True,0,No user reviews,0,0,0
1369280,True,0,No user reviews,0,0,0
1369310,True,0,No user reviews,0,0,0
1369320,True,0,No user reviews,0,0,0
1369340,True,8,Very Positive,65,2,67
1369350,True,0,No user reviews,0,0,0
1369370,True,8,Very Positive,102,23,125
1369380,True,0,No user reviews,0,0,0
1369390,True,0,No user reviews,0,0,0
1369400,True,0,No user reviews,0,0,0
1369410,True,0,No user reviews,0,0,0
1369420,True,0,No user reviews,0,0,0
1369430,True,0,No user reviews,0,0,0
1369440,True,0,No user reviews,0,0,0
1369450,True,0,No user reviews,0,0,0
1369451,True,0,No user reviews,0,0,0
1369452,True,0,No user reviews,0,0,0
1369453,True,0,1 user reviews,0,1,1
1369454,True,0,No user reviews,0,0,0
1369455,True,0,No user reviews,0,0,0
1369456,True,0,2 user reviews,0,2,2
1369470,True,0,No user reviews,0,0,0
1369480,True,0,No user reviews,0,0,0
1369490,True,0,No user reviews,0,0,0
1369520,True,0,No user reviews,0,0,0
1369530,True,0,No user reviews,0,0,0
1369560,True,0,2 user reviews,2,0,2
1369570,True,0,No user reviews,0,0,0
1369580,True,0,No user reviews,0,0,0
1369610,True,0,No user reviews,0,0,0
1369630,True,0,No user reviews,0,0,0
1369680,True,0,No user reviews,0,0,0
1369700,True,0,No user reviews,0,0,0
1369720,True,0,No user reviews,0,0,0
1369740,True,0,1 user reviews,1,0,1
1369770,True,0,No user reviews,0,0,0
1369780,True,0,No user reviews,0,0,0
1369800,True,0,No user reviews,0,0,0
1369830,True,0,No user reviews,0,0,0
1369930,True,0,No user reviews,0,0,0
1369940,True,0,No user reviews,0,0,0
1369950,True,0,2 user reviews,2,0,2
1369980,True,0,No user reviews,0,0,0
1369990,True,0,No user reviews,0,0,0
1370000,True,0,No user reviews,0,0,0
1370040,True,0,No user reviews,0,0,0
1370080,True,0,1 user reviews,0,1,1
1370100,True,0,No user reviews,0,0,0
1370130,True,0,No user reviews,0,0,0
1370140,True,0,No user reviews,0,0,0
1370170,True,0,No user reviews,0,0,0
1370180,True,0,No user reviews,0,0,0
1370190,True,0,No user reviews,0,0,0
1370220,True,0,No user reviews,0,0,0
1370230,True,0,1 user reviews,0,1,1
1370240,True,0,No user reviews,0,0,0
1370250,True,0,1 user reviews,1,0,1
1370260,True,0,1 user reviews,1,0,1
1370280,True,0,No user reviews,0,0,0
1370300,True,0,2 user reviews,2,0,2
1370310,True,0,No user reviews,0,0,0
1370370,True,0,No user reviews,0,0,0
1370390,True,0,9 user reviews,9,0,9
1370400,True,0,No user reviews,0,0,0
1370410,True,0,No user reviews,0,0,0
1370420,True,0,No user reviews,0,0,0
1370470,True,0,2 user reviews,0,2,2
1370510,True,0,No user reviews,0,0,0
1370550,True,0,2 user reviews,2,0,2
1370560,True,0,No user reviews,0,0,0
1370570,True,0,No user reviews,0,0,0
1370580,True,0,1 user reviews,0,1,1
1370610,True,0,2 user reviews,1,1,2
1370620,True,0,3 user reviews,3,0,3
1370630,True,0,4 user reviews,4,0,4
1370640,True,0,6 user reviews,6,0,6
1370650,True,0,2 user reviews,1,1,2
1370660,True,0,3 user reviews,2,1,3
1370670,True,0,No user reviews,0,0,0
1370680,True,0,No user reviews,0,0,0
1370710,True,0,No user reviews,0,0,0
1370720,True,0,4 user reviews,3,1,4
1370740,True,0,No user reviews,0,0,0
1370770,True,0,No user reviews,0,0,0
1370780,True,0,No user reviews,0,0,0
1370790,True,0,No user reviews,0,0,0
1370800,True,0,No user reviews,0,0,0
1370810,True,0,No user reviews,0,0,0
1370820,True,0,No user reviews,0,0,0
1370850,True,0,2 user reviews,2,0,2
1370890,True,0,No user reviews,0,0,0
1370900,True,0,No user reviews,0,0,0
1370901,True,0,No user reviews,0,0,0
1370902,True,0,No user reviews,0,0,0
1370930,True,0,No user reviews,0,0,0
1370940,True,0,No user reviews,0,0,0
1370950,True,0,5 user reviews,3,2,5
1370970,True,0,No user reviews,0,0,0
1370980,True,0,No user reviews,0,0,0
1371000,True,0,No user reviews,0,0,0
1371030,True,0,No user reviews,0,0,0
1371040,True,0,1 user reviews,1,0,1
1371050,True,0,No user reviews,0,0,0
1371090,True,0,2 user reviews,1,1,2
1371110,True,0,2 user reviews,2,0,2
1371120,True,0,No user reviews,0,0,0
1371150,True,0,No user reviews,0,0,0
1371160,True,0,1 user reviews,1,0,1
1371170,True,0,No user reviews,0,0,0
1371180,True,0,No user reviews,0,0,0
1371210,True,0,No user reviews,0,0,0
1371220,True,0,3 user reviews,2,1,3
1371230,True,0,No user reviews,0,0,0
1371250,True,0,No user reviews,0,0,0
1371270,True,0,No user reviews,0,0,0
1371280,True,0,No user reviews,0,0,0
1371300,True,0,No user reviews,0,0,0
1371320,True,0,No user reviews,0,0,0
1371330,True,0,No user reviews,0,0,0
1371340,True,0,5 user reviews,1,4,5
1371350,True,0,No user reviews,0,0,0
1371360,True,0,No user reviews,0,0,0
1371380,True,0,No user reviews,0,0,0
1371400,True,7,Positive,13,0,13
1371401,True,0,1 user reviews,1,0,1
1371402,True,0,2 user reviews,2,0,2
1371403,True,0,2 user reviews,2,0,2
1371404,True,7,Positive,10,0,10
1371405,True,0,No user reviews,0,0,0
1371406,True,0,No user reviews,0,0,0
1371407,True,0,5 user reviews,5,0,5
1371408,True,0,2 user reviews,2,0,2
1371409,True,0,1 user reviews,1,0,1
1371420,True,0,2 user reviews,1,1,2
1371421,True,0,1 user reviews,1,0,1
1371422,True,0,1 user reviews,1,0,1
1371423,True,0,1 user reviews,1,0,1
1371424,True,0,1 user reviews,1,0,1
1371425,True,0,2 user reviews,2,0,2
1371426,True,0,1 user reviews,1,0,1
1371427,True,0,2 user reviews,2,0,2
1371428,True,0,1 user reviews,1,0,1
1371429,True,0,1 user reviews,1,0,1
1371460,True,0,No user reviews,0,0,0
1371470,True,0,No user reviews,0,0,0
1371480,True,0,No user reviews,0,0,0
1371500,True,0,No user reviews,0,0,0
1371510,True,0,1 user reviews,0,1,1
1371520,True,0,No user reviews,0,0,0
1371540,True,0,1 user reviews,1,0,1
1371550,True,0,No user reviews,0,0,0
1371570,True,0,No user reviews,0,0,0
1371600,True,0,1 user reviews,0,1,1
1371610,True,0,No user reviews,0,0,0
1371620,True,0,No user reviews,0,0,0
1371630,True,0,No user reviews,0,0,0
1371640,True,0,No user reviews,0,0,0
1371660,True,0,No user reviews,0,0,0
1371690,True,0,No user reviews,0,0,0
1371700,True,0,No user reviews,0,0,0
1371710,True,0,2 user reviews,2,0,2
1371720,True,0,No user reviews,0,0,0
1371730,True,0,2 user reviews,1,1,2
1371740,True,0,No user reviews,0,0,0
1371760,True,0,No user reviews,0,0,0
1371770,True,0,6 user reviews,6,0,6
1371780,True,0,No user reviews,0,0,0
1371790,True,0,No user reviews,0,0,0
1371800,True,0,1 user reviews,1,0,1
1371810,True,0,No user reviews,0,0,0
1371830,True,0,No user reviews,0,0,0
1371840,True,0,No user reviews,0,0,0
1371860,True,0,No user reviews,0,0,0
1371880,True,0,No user reviews,0,0,0
1371900,True,0,No user reviews,0,0,0
1371910,True,0,1 user reviews,1,0,1
1371930,True,0,No user reviews,0,0,0
1371940,True,0,2 user reviews,2,0,2
1372010,True,0,2 user reviews,2,0,2
1372020,True,0,No user reviews,0,0,0
1372021,True,0,No user reviews,0,0,0
1372090,True,0,8 user reviews,3,5,8
1372120,True,0,No user reviews,0,0,0
1372130,True,0,No user reviews,0,0,0
1372180,True,0,3 user reviews,3,0,3
1372210,True,0,No user reviews,0,0,0
1372220,True,0,No user reviews,0,0,0
1372240,True,0,No user reviews,0,0,0
1372260,True,0,No user reviews,0,0,0
1372270,True,0,No user reviews,0,0,0
1372300,True,7,Positive,11,0,11
1372310,True,0,4 user reviews,3,1,4
1372320,True,8,Very Positive,251,3,254
1372340,True,0,No user reviews,0,0,0
1372350,True,0,No user reviews,0,0,0
1372380,True,0,1 user reviews,1,0,1
1372390,True,0,No user reviews,0,0,0
1372400,True,0,No user reviews,0,0,0
1372410,True,0,No user reviews,0,0,0
1372440,True,0,No user reviews,0,0,0
1372450,True,0,No user reviews,0,0,0
1372480,True,0,No user reviews,0,0,0
1372490,True,0,1 user reviews,1,0,1
1372540,True,0,No user reviews,0,0,0
1372550,True,0,6 user reviews,2,4,6
1372560,True,0,No user reviews,0,0,0
1372570,True,0,4 user reviews,4,0,4
1372580,True,0,No user reviews,0,0,0
1372630,True,0,2 user reviews,2,0,2
1372640,True,0,No user reviews,0,0,0
1372650,True,0,No user reviews,0,0,0
1372670,True,0,No user reviews,0,0,0
1372680,True,0,No user reviews,0,0,0
1372690,True,0,No user reviews,0,0,0
1372700,True,0,No user reviews,0,0,0
1372710,True,0,No user reviews,0,0,0
1372740,True,0,No user reviews,0,0,0
1372760,True,0,No user reviews,0,0,0
1372770,True,0,No user reviews,0,0,0
1372780,True,0,No user reviews,0,0,0
1372790,True,0,No user reviews,0,0,0
1372791,True,0,No user reviews,0,0,0
1372800,True,0,No user reviews,0,0,0
1372820,True,0,No user reviews,0,0,0
1372840,True,0,No user reviews,0,0,0
1372870,True,0,No user reviews,0,0,0
1372910,True,0,No user reviews,0,0,0
1372970,True,0,No user reviews,0,0,0
1372980,True,0,No user reviews,0,0,0
1372990,True,0,4 user reviews,3,1,4
1373010,True,0,No user reviews,0,0,0
1373020,True,0,No user reviews,0,0,0
1373080,True,0,2 user reviews,2,0,2
1373100,True,0,No user reviews,0,0,0
1373110,True,0,No user reviews,0,0,0
1373120,True,0,No user reviews,0,0,0
1373130,True,0,No user reviews,0,0,0
1373150,True,0,No user reviews,0,0,0
1373160,True,0,No user reviews,0,0,0
1373170,True,0,3 user reviews,3,0,3
1373180,True,0,2 user reviews,2,0,2
1373220,True,5,Mixed,39,17,56
1373230,True,0,No user reviews,0,0,0
1373240,True,0,No user reviews,0,0,0
1373260,True,0,No user reviews,0,0,0
1373270,True,0,No user reviews,0,0,0
1373280,True,0,No user reviews,0,0,0
1373290,True,0,No user reviews,0,0,0
1373300,True,0,No user reviews,0,0,0
1373310,True,0,No user reviews,0,0,0
1373320,True,0,No user reviews,0,0,0
1373330,True,0,No user reviews,0,0,0
1373340,True,0,1 user reviews,1,0,1
1373370,True,0,No user reviews,0,0,0
1373380,True,0,2 user reviews,2,0,2
1373410,True,0,No user reviews,0,0,0
1373420,True,0,No user reviews,0,0,0
1373430,True,6,Mostly Positive,31,8,39
1373440,True,0,5 user reviews,5,0,5
1373450,True,0,No user reviews,0,0,0
1373500,True,0,No user reviews,0,0,0
1373530,True,0,No user reviews,0,0,0
1373570,True,0,No user reviews,0,0,0
1373580,True,0,No user reviews,0,0,0
1373600,True,0,No user reviews,0,0,0
1373630,True,0,3 user reviews,3,0,3
1373660,True,0,No user reviews,0,0,0
1373700,True,0,2 user reviews,2,0,2
1373710,True,0,No user reviews,0,0,0
1373730,True,0,No user reviews,0,0,0
1373740,True,0,4 user reviews,2,2,4
1373750,True,0,No user reviews,0,0,0
1373760,True,0,1 user reviews,1,0,1
1373770,True,0,No user reviews,0,0,0
1373780,True,0,4 user reviews,3,1,4
1373810,True,0,1 user reviews,0,1,1
1373820,True,0,3 user reviews,3,0,3
1373830,True,0,No user reviews,0,0,0
1373860,True,0,No user reviews,0,0,0
1373870,True,0,7 user reviews,6,1,7
1373890,True,0,No user reviews,0,0,0
1373920,True,0,No user reviews,0,0,0
1373930,True,0,No user reviews,0,0,0
1373950,True,0,No user reviews,0,0,0
1373960,True,0,No user reviews,0,0,0
1373980,True,0,No user reviews,0,0,0
1374010,True,0,No user reviews,0,0,0
1374040,True,0,No user reviews,0,0,0
1374050,True,7,Positive,10,0,10
1374090,True,0,No user reviews,0,0,0
1374150,True,0,No user reviews,0,0,0
1374170,True,0,No user reviews,0,0,0
1374180,True,0,No user reviews,0,0,0
1374190,True,0,No user reviews,0,0,0
1374200,True,0,6 user reviews,6,0,6
1374210,True,0,No user reviews,0,0,0
1374220,True,0,No user reviews,0,0,0
1374260,True,0,No user reviews,0,0,0
1374280,True,0,No user reviews,0,0,0
1374290,True,7,Positive,23,1,24
1374330,True,0,No user reviews,0,0,0
1374340,True,6,Mostly Positive,7,3,10
1374370,True,0,No user reviews,0,0,0
1374380,True,0,No user reviews,0,0,0
1374400,True,0,No user reviews,0,0,0
1374410,True,0,No user reviews,0,0,0
1374420,True,0,No user reviews,0,0,0
1374430,True,0,No user reviews,0,0,0
1374440,True,0,No user reviews,0,0,0
1374460,True,0,No user reviews,0,0,0
1374470,True,0,5 user reviews,4,1,5
1374500,True,0,1 user reviews,1,0,1
1374520,True,0,No user reviews,0,0,0
1374530,True,0,No user reviews,0,0,0
1374590,True,0,No user reviews,0,0,0
1374620,True,0,No user reviews,0,0,0
1374630,True,0,1 user reviews,1,0,1
1374640,True,0,No user reviews,0,0,0
1374650,True,0,No user reviews,0,0,0
1374660,True,0,No user reviews,0,0,0
1374700,True,0,No user reviews,0,0,0
1374710,True,0,No user reviews,0,0,0
1374720,True,7,Positive,34,6,40
1374730,True,0,No user reviews,0,0,0
1374731,True,0,No user reviews,0,0,0
1374732,True,0,No user reviews,0,0,0
1374733,True,0,No user reviews,0,0,0
1374734,True,0,No user reviews,0,0,0
1374735,True,0,No user reviews,0,0,0
1374740,True,0,3 user reviews,0,3,3
1374750,True,0,No user reviews,0,0,0
1374780,True,0,No user reviews,0,0,0
1374810,True,0,No user reviews,0,0,0
1374820,True,0,4 user reviews,2,2,4
1374860,True,0,No user reviews,0,0,0
1374890,True,0,No user reviews,0,0,0
1374900,True,0,3 user reviews,3,0,3
1374920,True,0,No user reviews,0,0,0
1374940,True,0,2 user reviews,2,0,2
1374980,True,0,No user reviews,0,0,0
1374990,True,0,No user reviews,0,0,0
1375000,True,0,No user reviews,0,0,0
1375020,True,0,No user reviews,0,0,0
1375030,True,0,No user reviews,0,0,0
1375040,True,0,No user reviews,0,0,0
1375090,True,0,No user reviews,0,0,0
1375100,True,0,No user reviews,0,0,0
1375110,True,0,No user reviews,0,0,0
1375120,True,0,No user reviews,0,0,0
1375160,True,0,No user reviews,0,0,0
1375190,True,0,1 user reviews,0,1,1
1375200,True,0,No user reviews,0,0,0
1375220,True,0,No user reviews,0,0,0
1375250,True,0,2 user reviews,2,0,2
1375270,True,0,3 user reviews,3,0,3
1375300,True,0,No user reviews,0,0,0
1375350,True,0,No user reviews,0,0,0
1375360,True,5,Mixed,7,6,13
1375361,True,0,4 user reviews,2,2,4
1375362,True,0,6 user reviews,3,3,6
1375363,True,5,Mixed,5,7,12
1375364,True,0,6 user reviews,4,2,6
1375365,True,0,2 user reviews,2,0,2
1375366,True,0,4 user reviews,3,1,4
1375367,True,0,2 user reviews,2,0,2
1375368,True,0,5 user reviews,1,4,5
1375369,True,0,5 user reviews,2,3,5
1375370,True,0,8 user reviews,3,5,8
1375420,True,0,No user reviews,0,0,0
1375430,True,0,No user reviews,0,0,0
1375440,True,0,No user reviews,0,0,0
1375450,True,0,5 user reviews,5,0,5
1375460,True,0,No user reviews,0,0,0
1375470,True,0,No user reviews,0,0,0
1375471,True,0,No user reviews,0,0,0
1375480,True,0,No user reviews,0,0,0
1375510,True,0,1 user reviews,1,0,1
1375520,True,0,1 user reviews,0,1,1
1375530,True,0,No user reviews,0,0,0
1375540,True,0,No user reviews,0,0,0
1375550,True,0,No user reviews,0,0,0
1375560,True,0,3 user reviews,3,0,3
1375590,True,0,No user reviews,0,0,0
1375600,True,0,No user reviews,0,0,0
1375610,True,0,3 user reviews,3,0,3
1375640,True,0,No user reviews,0,0,0
1375650,True,0,4 user reviews,4,0,4
1375670,True,0,No user reviews,0,0,0
1375680,True,0,No user reviews,0,0,0
1375690,True,0,2 user reviews,2,0,2
1375700,True,0,No user reviews,0,0,0
1375740,True,0,No user reviews,0,0,0
1375750,True,0,No user reviews,0,0,0
1375760,True,0,No user reviews,0,0,0
1375780,True,0,No user reviews,0,0,0
1375800,True,0,No user reviews,0,0,0
1375810,True,0,1 user reviews,1,0,1
1375820,True,0,No user reviews,0,0,0
1375850,True,0,No user reviews,0,0,0
1375870,True,6,Mostly Positive,13,4,17
1375880,True,0,3 user reviews,3,0,3
1375890,True,0,No user reviews,0,0,0
1375920,True,0,1 user reviews,1,0,1
1375930,True,0,3 user reviews,2,1,3
1375940,True,0,No user reviews,0,0,0
1375950,True,0,No user reviews,0,0,0
1375970,True,0,No user reviews,0,0,0
1375980,True,0,No user reviews,0,0,0
1376000,True,0,No user reviews,0,0,0
1376010,True,0,2 user reviews,1,1,2
1376020,True,0,No user reviews,0,0,0
1376040,True,0,5 user reviews,3,2,5
1376050,True,0,No user reviews,0,0,0
1376060,True,0,2 user reviews,2,0,2
1376070,True,0,No user reviews,0,0,0
1376090,True,0,No user reviews,0,0,0
1376100,True,0,No user reviews,0,0,0
1376130,True,0,No user reviews,0,0,0
1376140,True,0,No user reviews,0,0,0
1376170,True,0,No user reviews,0,0,0
1376180,True,0,No user reviews,0,0,0
1376190,True,0,No user reviews,0,0,0
1376220,True,0,2 user reviews,2,0,2
1376240,True,0,No user reviews,0,0,0
1376250,True,0,No user reviews,0,0,0
1376260,True,0,No user reviews,0,0,0
1376270,True,0,1 user reviews,1,0,1
1376280,True,0,No user reviews,0,0,0
1376290,True,0,No user reviews,0,0,0
1376300,True,0,2 user reviews,2,0,2
1376310,True,0,No user reviews,0,0,0
1376330,True,0,No user reviews,0,0,0
1376340,True,0,No user reviews,0,0,0
1376350,True,0,1 user reviews,1,0,1
1376360,True,0,3 user reviews,2,1,3
1376370,True,0,No user reviews,0,0,0
1376380,True,0,No user reviews,0,0,0
1376400,True,0,No user reviews,0,0,0
1376410,True,0,No user reviews,0,0,0
1376420,True,0,No user reviews,0,0,0
1376440,True,0,No user reviews,0,0,0
1376470,True,0,2 user reviews,0,2,2
1376480,True,0,No user reviews,0,0,0
1376490,True,0,No user reviews,0,0,0
1376500,True,0,No user reviews,0,0,0
1376510,True,0,No user reviews,0,0,0
1376520,True,0,6 user reviews,6,0,6
1376530,True,0,No user reviews,0,0,0
1376550,True,0,No user reviews,0,0,0
1376570,True,0,1 user reviews,1,0,1
1376590,True,0,No user reviews,0,0,0
1376600,True,0,No user reviews,0,0,0
1376630,True,0,No user reviews,0,0,0
1376640,True,0,5 user reviews,5,0,5
1376680,True,0,No user reviews,0,0,0
1376690,True,0,2 user reviews,2,0,2
1376720,True,0,No user reviews,0,0,0
1376730,True,0,No user reviews,0,0,0
1376750,True,0,No user reviews,0,0,0
1376760,True,0,No user reviews,0,0,0
1376770,True,0,No user reviews,0,0,0
1376780,True,0,No user reviews,0,0,0
1376800,True,0,No user reviews,0,0,0
1376820,True,0,1 user reviews,1,0,1
1376830,True,0,7 user reviews,6,1,7
1376840,True,0,No user reviews,0,0,0
1376870,True,0,No user reviews,0,0,0
1376890,True,0,No user reviews,0,0,0
1376900,True,0,No user reviews,0,0,0
1376910,True,0,No user reviews,0,0,0
1376920,True,0,2 user reviews,0,2,2
1376930,True,0,No user reviews,0,0,0
1376940,True,0,3 user reviews,3,0,3
1376950,True,0,No user reviews,0,0,0
1376970,True,0,No user reviews,0,0,0
1376971,True,0,No user reviews,0,0,0
1376972,True,0,No user reviews,0,0,0
1376973,True,0,No user reviews,0,0,0
1376974,True,0,No user reviews,0,0,0
1377000,True,0,No user reviews,0,0,0
1377010,True,0,No user reviews,0,0,0
1377030,True,0,No user reviews,0,0,0
1377060,True,0,No user reviews,0,0,0
1377080,True,0,4 user reviews,4,0,4
1377090,True,0,No user reviews,0,0,0
1377100,True,0,2 user reviews,2,0,2
1377110,True,0,No user reviews,0,0,0
1377120,True,0,No user reviews,0,0,0
1377140,True,0,2 user reviews,0,2,2
1377150,True,0,No user reviews,0,0,0
1377160,True,0,No user reviews,0,0,0
1377200,True,0,No user reviews,0,0,0
1377210,True,0,No user reviews,0,0,0
1377220,True,0,No user reviews,0,0,0
1377240,True,0,3 user reviews,3,0,3
1377260,True,7,Positive,45,2,47
1377280,True,0,2 user reviews,1,1,2
1377300,True,0,No user reviews,0,0,0
1377320,True,0,No user reviews,0,0,0
1377330,True,0,3 user reviews,3,0,3
1377340,True,0,No user reviews,0,0,0
1377350,True,0,No user reviews,0,0,0
1377360,True,7,Positive,37,1,38
1377370,True,0,No user reviews,0,0,0
1377380,True,8,Very Positive,797,120,917
1377400,True,0,No user reviews,0,0,0
1377420,True,0,1 user reviews,1,0,1
1377430,True,0,No user reviews,0,0,0
1377450,True,0,No user reviews,0,0,0
1377460,True,0,No user reviews,0,0,0
1377530,True,0,7 user reviews,7,0,7
1377540,True,7,Positive,35,5,40
1377550,True,0,No user reviews,0,0,0
1377560,True,0,No user reviews,0,0,0
1377570,True,0,No user reviews,0,0,0
1377580,True,0,No user reviews,0,0,0
1377590,True,0,3 user reviews,2,1,3
1377600,True,0,No user reviews,0,0,0
1377650,True,0,6 user reviews,6,0,6
1377660,True,0,No user reviews,0,0,0
1377670,True,0,No user reviews,0,0,0
1377680,True,0,2 user reviews,2,0,2
1377690,True,0,2 user reviews,2,0,2
1377710,True,0,No user reviews,0,0,0
1377720,True,0,No user reviews,0,0,0
1377730,True,0,No user reviews,0,0,0
1377740,True,0,No user reviews,0,0,0
1377750,True,0,No user reviews,0,0,0
1377780,True,0,No user reviews,0,0,0
1377790,True,0,No user reviews,0,0,0
1377830,True,0,No user reviews,0,0,0
1377850,True,0,3 user reviews,2,1,3
1377860,True,0,No user reviews,0,0,0
1377870,True,0,No user reviews,0,0,0
1377880,True,0,No user reviews,0,0,0
1377900,True,0,3 user reviews,3,0,3
1377910,True,0,No user reviews,0,0,0
1377920,True,0,2 user reviews,2,0,2
1377930,True,0,3 user reviews,3,0,3
1377950,True,0,No user reviews,0,0,0
1377960,True,0,No user reviews,0,0,0
1377970,True,0,1 user reviews,1,0,1
1377980,True,0,No user reviews,0,0,0
1378010,True,0,No user reviews,0,0,0
1378040,True,0,No user reviews,0,0,0
1378080,True,0,No user reviews,0,0,0
1378100,True,0,No user reviews,0,0,0
1378120,True,0,1 user reviews,1,0,1
1378130,True,0,No user reviews,0,0,0
1378140,True,0,7 user reviews,6,1,7
1378170,True,0,8 user reviews,5,3,8
1378180,True,0,No user reviews,0,0,0
1378190,True,0,No user reviews,0,0,0
1378191,True,0,No user reviews,0,0,0
1378192,True,0,No user reviews,0,0,0
1378193,True,0,No user reviews,0,0,0
1378194,True,0,No user reviews,0,0,0
1378195,True,0,1 user reviews,1,0,1
1378196,True,0,No user reviews,0,0,0
1378197,True,0,No user reviews,0,0,0
1378198,True,0,No user reviews,0,0,0
1378200,True,0,No user reviews,0,0,0
1378230,True,0,No user reviews,0,0,0
1378250,True,0,1 user reviews,1,0,1
1378270,True,0,No user reviews,0,0,0
1378280,True,0,No user reviews,0,0,0
1378290,True,8,Very Positive,116,16,132
1378300,True,0,No user reviews,0,0,0
1378320,True,0,1 user reviews,0,1,1
1378330,True,0,6 user reviews,6,0,6
1378340,True,0,No user reviews,0,0,0
1378341,True,0,No user reviews,0,0,0
1378342,True,0,No user reviews,0,0,0
1378343,True,0,No user reviews,0,0,0
1378344,True,0,No user reviews,0,0,0
1378350,True,0,No user reviews,0,0,0
1378360,True,0,No user reviews,0,0,0
1378370,True,0,No user reviews,0,0,0
1378390,True,0,No user reviews,0,0,0
1378420,True,0,No user reviews,0,0,0
1378430,True,0,No user reviews,0,0,0
1378440,True,0,No user reviews,0,0,0
1378450,True,0,No user reviews,0,0,0
1378460,True,0,No user reviews,0,0,0
1378470,True,0,No user reviews,0,0,0
1378490,True,0,No user reviews,0,0,0
1378510,True,0,No user reviews,0,0,0
1378520,True,0,No user reviews,0,0,0
1378530,True,0,No user reviews,0,0,0
1378540,True,0,No user reviews,0,0,0
1378560,True,0,2 user reviews,2,0,2
1378580,True,0,No user reviews,0,0,0
1378600,True,0,No user reviews,0,0,0
1378610,True,0,No user reviews,0,0,0
1378620,True,0,No user reviews,0,0,0
1378640,True,0,No user reviews,0,0,0
1378650,True,0,5 user reviews,4,1,5
1378660,True,0,No user reviews,0,0,0
1378680,True,0,No user reviews,0,0,0
1378690,True,0,No user reviews,0,0,0
1378700,True,0,3 user reviews,1,2,3
1378720,True,0,No user reviews,0,0,0
1378730,True,0,No user reviews,0,0,0
1378740,True,0,No user reviews,0,0,0
1378750,True,0,No user reviews,0,0,0
1378760,True,0,1 user reviews,1,0,1
1378770,True,0,No user reviews,0,0,0
1378780,True,0,No user reviews,0,0,0
1378800,True,0,No user reviews,0,0,0
1378810,True,0,1 user reviews,0,1,1
1378820,True,0,1 user reviews,1,0,1
1378840,True,0,1 user reviews,1,0,1
1378850,True,0,1 user reviews,0,1,1
1378860,True,6,Mostly Positive,9,3,12
1378870,True,0,No user reviews,0,0,0
1378890,True,0,No user reviews,0,0,0
1378940,True,0,5 user reviews,5,0,5
1378960,True,0,No user reviews,0,0,0
1378970,True,0,No user reviews,0,0,0
1378980,True,0,No user reviews,0,0,0
1379010,True,0,No user reviews,0,0,0
1379020,True,8,Very Positive,166,9,175
1379040,True,0,No user reviews,0,0,0
1379050,True,0,No user reviews,0,0,0
1379070,True,0,No user reviews,0,0,0
1379080,True,0,No user reviews,0,0,0
1379090,True,0,No user reviews,0,0,0
1379100,True,0,No user reviews,0,0,0
1379110,True,7,Positive,15,3,18
1379130,True,0,No user reviews,0,0,0
1379150,True,0,1 user reviews,0,1,1
1379160,True,0,No user reviews,0,0,0
1379170,True,0,3 user reviews,3,0,3
1379180,True,0,No user reviews,0,0,0
1379200,True,7,Positive,9,2,11
1379220,True,0,No user reviews,0,0,0
1379221,True,0,No user reviews,0,0,0
1379222,True,0,1 user reviews,1,0,1
1379250,True,0,No user reviews,0,0,0
1379261,True,0,No user reviews,0,0,0
1379270,True,0,No user reviews,0,0,0
1379280,True,0,No user reviews,0,0,0
1379300,True,0,No user reviews,0,0,0
1379310,True,0,No user reviews,0,0,0
1379311,True,0,No user reviews,0,0,0
1379330,True,0,1 user reviews,1,0,1
1379340,True,0,No user reviews,0,0,0
1379350,True,0,No user reviews,0,0,0
1379370,True,0,2 user reviews,2,0,2
1379380,True,7,Positive,12,0,12
1379390,True,0,No user reviews,0,0,0
1379420,True,0,1 user reviews,1,0,1
1379440,True,0,No user reviews,0,0,0
1379450,True,0,1 user reviews,1,0,1
1379460,True,0,No user reviews,0,0,0
1379470,True,0,1 user reviews,1,0,1
1379480,True,0,No user reviews,0,0,0
1379550,True,0,No user reviews,0,0,0
1379570,True,0,1 user reviews,1,0,1
1379580,True,0,No user reviews,0,0,0
1379590,True,0,No user reviews,0,0,0
1379600,True,0,No user reviews,0,0,0
1379630,True,0,No user reviews,0,0,0
1379640,True,0,No user reviews,0,0,0
1379660,True,0,9 user reviews,9,0,9
1379670,True,0,No user reviews,0,0,0
1379680,True,0,No user reviews,0,0,0
1379690,True,0,No user reviews,0,0,0
1379700,True,0,No user reviews,0,0,0
1379720,True,0,No user reviews,0,0,0
1379740,True,0,No user reviews,0,0,0
1379800,True,0,No user reviews,0,0,0
1379830,True,0,No user reviews,0,0,0
1379840,True,0,No user reviews,0,0,0
1379860,True,0,No user reviews,0,0,0
1379870,True,0,No user reviews,0,0,0
1379900,True,0,No user reviews,0,0,0
1379910,True,0,No user reviews,0,0,0
1379920,True,0,No user reviews,0,0,0
1379930,True,5,Mixed,21,12,33
1379940,True,0,No user reviews,0,0,0
1379950,True,0,No user reviews,0,0,0
1379960,True,0,No user reviews,0,0,0
1379970,True,5,Mixed,10,8,18
1379980,True,0,No user reviews,0,0,0
1380010,True,7,Positive,22,1,23
1380020,True,0,No user reviews,0,0,0
1380021,True,0,No user reviews,0,0,0
1380022,True,0,No user reviews,0,0,0
1380023,True,0,No user reviews,0,0,0
1380024,True,0,No user reviews,0,0,0
1380025,True,0,No user reviews,0,0,0
1380030,True,0,1 user reviews,1,0,1
1380040,True,0,3 user reviews,3,0,3
1380080,True,0,No user reviews,0,0,0
1380090,True,0,No user reviews,0,0,0
1380100,True,0,No user reviews,0,0,0
1380110,True,0,1 user reviews,0,1,1
1380120,True,0,No user reviews,0,0,0
1380140,True,0,No user reviews,0,0,0
1380150,True,0,No user reviews,0,0,0
1380170,True,0,2 user reviews,2,0,2
1380210,True,0,No user reviews,0,0,0
1380220,True,0,No user reviews,0,0,0
1380240,True,0,No user reviews,0,0,0
1380250,True,0,1 user reviews,0,1,1
1380260,True,0,2 user reviews,2,0,2
1380270,True,0,No user reviews,0,0,0
1380290,True,0,No user reviews,0,0,0
1380310,True,0,No user reviews,0,0,0
1380320,True,0,No user reviews,0,0,0
1380340,True,0,No user reviews,0,0,0
1380360,True,0,2 user reviews,2,0,2
1380390,True,8,Very Positive,133,4,137
1380400,True,0,No user reviews,0,0,0
1380430,True,0,No user reviews,0,0,0
1380470,True,0,No user reviews,0,0,0
1380490,True,0,No user reviews,0,0,0
1380500,True,0,No user reviews,0,0,0
1380510,True,0,No user reviews,0,0,0
1380520,True,0,No user reviews,0,0,0
1380550,True,0,No user reviews,0,0,0
1380570,True,0,No user reviews,0,0,0
1380580,True,0,No user reviews,0,0,0
1380590,True,0,No user reviews,0,0,0
1380600,True,0,No user reviews,0,0,0
1380620,True,0,7 user reviews,2,5,7
1380630,True,0,No user reviews,0,0,0
1380640,True,0,No user reviews,0,0,0
1380650,True,0,No user reviews,0,0,0
1380660,True,0,No user reviews,0,0,0
1380720,True,0,No user reviews,0,0,0
1380760,True,0,No user reviews,0,0,0
1380780,True,0,No user reviews,0,0,0
1380820,True,0,1 user reviews,1,0,1
1380840,True,0,4 user reviews,4,0,4
1380850,True,0,No user reviews,0,0,0
1380860,True,0,No user reviews,0,0,0
1380870,True,0,No user reviews,0,0,0
1380890,True,0,No user reviews,0,0,0
1380910,True,0,No user reviews,0,0,0
1380920,True,0,No user reviews,0,0,0
1380930,True,0,No user reviews,0,0,0
1380950,True,0,No user reviews,0,0,0
1380960,True,0,No user reviews,0,0,0
1380980,True,0,No user reviews,0,0,0
1380990,True,0,No user reviews,0,0,0
1381070,True,0,8 user reviews,7,1,8
1381140,True,0,No user reviews,0,0,0
1381150,True,0,1 user reviews,0,1,1
1381160,True,0,No user reviews,0,0,0
1381170,True,0,No user reviews,0,0,0
1381180,True,0,No user reviews,0,0,0
1381250,True,0,No user reviews,0,0,0
1381260,True,0,No user reviews,0,0,0
1381270,True,0,No user reviews,0,0,0
1381280,True,0,1 user reviews,1,0,1
1381290,True,0,8 user reviews,7,1,8
1381300,True,0,No user reviews,0,0,0
1381330,True,0,No user reviews,0,0,0
1381340,True,0,No user reviews,0,0,0
1381350,True,0,No user reviews,0,0,0
1381370,True,0,No user reviews,0,0,0
1381390,True,0,No user reviews,0,0,0
1381410,True,0,No user reviews,0,0,0
1381420,True,0,No user reviews,0,0,0
1381450,True,0,No user reviews,0,0,0
1381460,True,0,No user reviews,0,0,0
1381480,True,0,3 user reviews,1,2,3
1381500,True,0,4 user reviews,4,0,4
1381520,True,0,No user reviews,0,0,0
1381530,True,0,No user reviews,0,0,0
1381540,True,0,No user reviews,0,0,0
1381570,True,0,No user reviews,0,0,0
1381580,True,0,No user reviews,0,0,0
1381590,True,0,No user reviews,0,0,0
1381610,True,0,2 user reviews,0,2,2
1381620,True,0,No user reviews,0,0,0
1381630,True,0,No user reviews,0,0,0
1381640,True,0,4 user reviews,4,0,4
1381690,True,0,1 user reviews,0,1,1
1381700,True,0,No user reviews,0,0,0
1381720,True,0,No user reviews,0,0,0
1381730,True,0,No user reviews,0,0,0
1381750,True,0,No user reviews,0,0,0
1381770,True,0,1 user reviews,1,0,1
1381780,True,0,No user reviews,0,0,0
1381790,True,0,1 user reviews,1,0,1
1381791,True,0,1 user reviews,1,0,1
1381800,True,0,1 user reviews,1,0,1
1381820,True,0,No user reviews,0,0,0
1381850,True,0,No user reviews,0,0,0
1381860,True,0,1 user reviews,1,0,1
1381870,True,0,No user reviews,0,0,0
1381880,True,0,5 user reviews,5,0,5
1381890,True,0,No user reviews,0,0,0
1381900,True,0,No user reviews,0,0,0
1381910,True,0,No user reviews,0,0,0
1381920,True,0,No user reviews,0,0,0
1381940,True,0,No user reviews,0,0,0
1381960,True,0,No user reviews,0,0,0
1381980,True,7,Positive,40,5,45
1382020,True,0,No user reviews,0,0,0
1382040,True,0,2 user reviews,0,2,2
1382050,True,0,No user reviews,0,0,0
1382060,True,0,No user reviews,0,0,0
1382140,True,7,Positive,10,0,10
1382150,True,0,No user reviews,0,0,0
1382180,True,0,1 user reviews,1,0,1
1382200,True,0,No user reviews,0,0,0
1382210,True,5,Mixed,11,5,16
1382220,True,6,Mostly Positive,10,3,13
1382230,True,0,No user reviews,0,0,0
1382241,True,5,Mixed,11,7,18
1382260,True,0,No user reviews,0,0,0
1382290,True,0,No user reviews,0,0,0
1382310,True,0,No user reviews,0,0,0
1382320,True,0,No user reviews,0,0,0
1382340,True,0,No user reviews,0,0,0
1382350,True,0,No user reviews,0,0,0
1382370,True,0,4 user reviews,4,0,4
1382380,True,0,No user reviews,0,0,0
1382390,True,0,No user reviews,0,0,0
1382400,True,0,No user reviews,0,0,0
1382420,True,0,No user reviews,0,0,0
1382440,True,0,No user reviews,0,0,0
1382450,True,0,No user reviews,0,0,0
1382470,True,0,No user reviews,0,0,0
1382490,True,0,No user reviews,0,0,0
1382520,True,0,No user reviews,0,0,0
1382530,True,0,7 user reviews,4,3,7
1382550,True,0,No user reviews,0,0,0
1382560,True,0,4 user reviews,4,0,4
1382580,True,0,No user reviews,0,0,0
1382590,True,0,No user reviews,0,0,0
1382591,True,0,No user reviews,0,0,0
1382592,True,0,No user reviews,0,0,0
1382593,True,0,No user reviews,0,0,0
1382600,True,0,No user reviews,0,0,0
1382610,True,0,No user reviews,0,0,0
1382611,True,0,No user reviews,0,0,0
1382612,True,0,No user reviews,0,0,0
1382613,True,0,No user reviews,0,0,0
1382630,True,0,No user reviews,0,0,0
1382670,True,0,No user reviews,0,0,0
1382700,True,0,1 user reviews,1,0,1
1382710,True,0,No user reviews,0,0,0
1382730,True,0,4 user reviews,4,0,4
1382740,True,0,No user reviews,0,0,0
1382760,True,0,No user reviews,0,0,0
1382770,True,0,No user reviews,0,0,0
1382780,True,0,No user reviews,0,0,0
1382800,True,0,No user reviews,0,0,0
1382820,True,0,No user reviews,0,0,0
1382840,True,0,7 user reviews,4,3,7
1382860,True,0,No user reviews,0,0,0
1382890,True,0,No user reviews,0,0,0
1382900,True,0,No user reviews,0,0,0
1382910,True,0,No user reviews,0,0,0
1382920,True,0,1 user reviews,0,1,1
1382930,True,0,No user reviews,0,0,0
1382940,True,0,9 user reviews,7,2,9
1382960,True,0,No user reviews,0,0,0
1382980,True,0,No user reviews,0,0,0
1383000,True,0,No user reviews,0,0,0
1383010,True,0,1 user reviews,1,0,1
1383030,True,0,6 user reviews,1,5,6
1383050,True,7,Positive,31,2,33
1383060,True,0,No user reviews,0,0,0
1383120,True,0,1 user reviews,0,1,1
1383130,True,0,No user reviews,0,0,0
1383140,True,0,No user reviews,0,0,0
1383170,True,0,1 user reviews,1,0,1
1383180,True,0,6 user reviews,6,0,6
1383200,True,0,No user reviews,0,0,0
1383210,True,0,No user reviews,0,0,0
1383220,True,0,No user reviews,0,0,0
1383230,True,0,4 user reviews,3,1,4
1383260,True,0,No user reviews,0,0,0
1383270,True,0,No user reviews,0,0,0
1383280,True,0,No user reviews,0,0,0
1383290,True,0,No user reviews,0,0,0
1383310,True,0,No user reviews,0,0,0
1383320,True,0,No user reviews,0,0,0
1383340,True,0,3 user reviews,2,1,3
1383350,True,0,No user reviews,0,0,0
1383360,True,0,No user reviews,0,0,0
1383370,True,0,No user reviews,0,0,0
1383380,True,0,No user reviews,0,0,0
1383400,True,0,No user reviews,0,0,0
1383410,True,0,2 user reviews,2,0,2
1383420,True,0,No user reviews,0,0,0
1383440,True,0,No user reviews,0,0,0
1383450,True,0,2 user reviews,1,1,2
1383460,True,0,No user reviews,0,0,0
1383480,True,0,No user reviews,0,0,0
1383490,True,0,No user reviews,0,0,0
1383500,True,0,No user reviews,0,0,0
1383510,True,0,No user reviews,0,0,0
1383530,True,0,No user reviews,0,0,0
1383560,True,0,No user reviews,0,0,0
1383590,True,0,No user reviews,0,0,0
1383600,True,0,No user reviews,0,0,0
1383610,True,0,No user reviews,0,0,0
1383630,True,7,Positive,18,1,19
1383660,True,0,No user reviews,0,0,0
1383670,True,0,No user reviews,0,0,0
1383690,True,0,No user reviews,0,0,0
1383710,True,0,No user reviews,0,0,0
1383720,True,7,Positive,19,0,19
1383730,True,0,No user reviews,0,0,0
1383740,True,0,6 user reviews,5,1,6
1383770,True,0,No user reviews,0,0,0
1383780,True,0,2 user reviews,0,2,2
1383790,True,0,No user reviews,0,0,0
1383791,True,0,No user reviews,0,0,0
1383792,True,0,No user reviews,0,0,0
1383802,True,0,No user reviews,0,0,0
1383803,True,0,No user reviews,0,0,0
1383804,True,0,No user reviews,0,0,0
1383820,True,0,No user reviews,0,0,0
1383830,True,0,1 user reviews,1,0,1
1383850,True,0,1 user reviews,1,0,1
1383880,True,7,Positive,11,0,11
1383900,True,0,1 user reviews,1,0,1
1383920,True,0,3 user reviews,3,0,3
1383930,True,0,No user reviews,0,0,0
1383950,True,0,No user reviews,0,0,0
1383960,True,0,No user reviews,0,0,0
1383990,True,0,6 user reviews,1,5,6
1384000,True,0,No user reviews,0,0,0
1384010,True,0,No user reviews,0,0,0
1384030,True,0,No user reviews,0,0,0
1384050,True,0,No user reviews,0,0,0
1384060,True,0,No user reviews,0,0,0
1384090,True,0,1 user reviews,1,0,1
1384100,True,0,No user reviews,0,0,0
1384110,True,0,No user reviews,0,0,0
1384130,True,0,No user reviews,0,0,0
1384140,True,0,No user reviews,0,0,0
1384150,True,0,No user reviews,0,0,0
1384230,True,0,No user reviews,0,0,0
1384240,True,0,No user reviews,0,0,0
1384270,True,0,No user reviews,0,0,0
1384280,True,0,No user reviews,0,0,0
1384290,True,0,No user reviews,0,0,0
1384320,True,0,No user reviews,0,0,0
1384330,True,0,No user reviews,0,0,0
1384340,True,0,No user reviews,0,0,0
1384350,True,0,No user reviews,0,0,0
1384380,True,0,1 user reviews,1,0,1
1384390,True,0,4 user reviews,2,2,4
1384400,True,0,No user reviews,0,0,0
1384410,True,0,No user reviews,0,0,0
1384440,True,0,1 user reviews,0,1,1
1384450,True,0,No user reviews,0,0,0
1384460,True,0,No user reviews,0,0,0
1384470,True,0,No user reviews,0,0,0
1384480,True,0,1 user reviews,1,0,1
1384490,True,0,No user reviews,0,0,0
1384500,True,0,1 user reviews,1,0,1
1384510,True,0,No user reviews,0,0,0
1384520,True,0,No user reviews,0,0,0
1384540,True,0,7 user reviews,4,3,7
1384550,True,0,No user reviews,0,0,0
1384570,True,0,No user reviews,0,0,0
1384610,True,0,No user reviews,0,0,0
1384620,True,0,No user reviews,0,0,0
1384630,True,5,Mixed,37,23,60
1384640,True,0,No user reviews,0,0,0
1384670,True,0,1 user reviews,1,0,1
1384680,True,0,No user reviews,0,0,0
1384700,True,7,Positive,9,2,11
1384730,True,0,No user reviews,0,0,0
1384740,True,0,No user reviews,0,0,0
1384760,True,0,No user reviews,0,0,0
1384770,True,8,Very Positive,275,34,309
1384780,True,0,7 user reviews,7,0,7
1384790,True,0,8 user reviews,4,4,8
1384820,True,0,No user reviews,0,0,0
1384840,True,0,No user reviews,0,0,0
1384850,True,0,No user reviews,0,0,0
1384870,True,0,No user reviews,0,0,0
1384880,True,0,No user reviews,0,0,0
1384890,True,0,No user reviews,0,0,0
1384910,True,0,No user reviews,0,0,0
1384960,True,7,Positive,13,1,14
1384970,True,0,No user reviews,0,0,0
1384990,True,0,No user reviews,0,0,0
1385000,True,0,No user reviews,0,0,0
1385010,True,0,No user reviews,0,0,0
1385020,True,0,No user reviews,0,0,0
1385040,True,0,No user reviews,0,0,0
1385050,True,0,1 user reviews,1,0,1
1385060,True,0,No user reviews,0,0,0
1385070,True,0,No user reviews,0,0,0
1385090,True,0,1 user reviews,0,1,1
1385100,True,0,No user reviews,0,0,0
1385110,True,4,Mostly Negative,6,10,16
1385180,True,0,No user reviews,0,0,0
1385190,True,0,No user reviews,0,0,0
1385200,True,0,No user reviews,0,0,0
1385210,True,0,No user reviews,0,0,0
1385230,True,0,No user reviews,0,0,0
1385240,True,0,No user reviews,0,0,0
1385280,True,0,No user reviews,0,0,0
1385290,True,0,No user reviews,0,0,0
1385310,True,0,No user reviews,0,0,0
1385320,True,0,No user reviews,0,0,0
1385350,True,0,No user reviews,0,0,0
1385360,True,0,No user reviews,0,0,0
1385370,True,0,No user reviews,0,0,0
1385380,True,0,No user reviews,0,0,0
1385400,True,0,No user reviews,0,0,0
1385460,True,0,No user reviews,0,0,0
1385470,True,0,No user reviews,0,0,0
1385480,True,0,1 user reviews,0,1,1
1385490,True,0,No user reviews,0,0,0
1385510,True,0,No user reviews,0,0,0
1385520,True,0,No user reviews,0,0,0
1385540,True,0,No user reviews,0,0,0
1385570,True,0,1 user reviews,1,0,1
1385580,True,0,No user reviews,0,0,0
1385590,True,0,No user reviews,0,0,0
1385620,True,0,No user reviews,0,0,0
1385650,True,0,No user reviews,0,0,0
1385670,True,0,3 user reviews,3,0,3
1385690,True,0,No user reviews,0,0,0
1385700,True,0,No user reviews,0,0,0
1385730,True,7,Positive,19,0,19
1385740,True,0,No user reviews,0,0,0
1385750,True,0,No user reviews,0,0,0
1385760,True,0,1 user reviews,0,1,1
1385780,True,0,4 user reviews,3,1,4
1385790,True,0,No user reviews,0,0,0
1385810,True,0,3 user reviews,3,0,3
1385820,True,0,No user reviews,0,0,0
1385830,True,0,No user reviews,0,0,0
1385840,True,0,No user reviews,0,0,0
1385850,True,0,3 user reviews,3,0,3
1385860,True,0,No user reviews,0,0,0
1385870,True,0,No user reviews,0,0,0
1385880,True,0,No user reviews,0,0,0
1385920,True,0,No user reviews,0,0,0
1385930,True,0,2 user reviews,0,2,2
1385931,True,0,No user reviews,0,0,0
1385950,True,0,No user reviews,0,0,0
1385960,True,0,5 user reviews,5,0,5
1385970,True,0,3 user reviews,2,1,3
1385980,True,0,No user reviews,0,0,0
1385990,True,0,1 user reviews,1,0,1
1386000,True,0,No user reviews,0,0,0
1386010,True,0,No user reviews,0,0,0
1386020,True,0,No user reviews,0,0,0
1386040,True,0,No user reviews,0,0,0
1386070,True,0,No user reviews,0,0,0
1386090,True,0,No user reviews,0,0,0
1386110,True,0,No user reviews,0,0,0
1386120,True,0,No user reviews,0,0,0
1386140,True,0,No user reviews,0,0,0
1386160,True,0,No user reviews,0,0,0
1386190,True,0,2 user reviews,2,0,2
1386200,True,0,5 user reviews,5,0,5
1386210,True,0,No user reviews,0,0,0
1386220,True,0,No user reviews,0,0,0
1386240,True,0,No user reviews,0,0,0
1386250,True,0,No user reviews,0,0,0
1386260,True,0,No user reviews,0,0,0
1386270,True,0,No user reviews,0,0,0
1386280,True,0,No user reviews,0,0,0
1386300,True,0,No user reviews,0,0,0
1386320,True,0,No user reviews,0,0,0
1386330,True,0,2 user reviews,1,1,2
1386360,True,0,No user reviews,0,0,0
1386370,True,0,No user reviews,0,0,0
1386390,True,0,No user reviews,0,0,0
1386420,True,0,No user reviews,0,0,0
1386440,True,7,Positive,15,2,17
1386460,True,0,No user reviews,0,0,0
1386470,True,0,No user reviews,0,0,0
1386500,True,0,No user reviews,0,0,0
1386510,True,0,No user reviews,0,0,0
1386530,True,0,No user reviews,0,0,0
1386540,True,0,3 user reviews,3,0,3
1386550,True,0,No user reviews,0,0,0
1386560,True,0,No user reviews,0,0,0
1386600,True,7,Positive,11,0,11
1386610,True,0,1 user reviews,1,0,1
1386611,True,0,2 user reviews,2,0,2
1386612,True,0,4 user reviews,4,0,4
1386613,True,0,No user reviews,0,0,0
1386614,True,0,No user reviews,0,0,0
1386615,True,0,No user reviews,0,0,0
1386616,True,0,No user reviews,0,0,0
1386620,True,0,No user reviews,0,0,0
1386630,True,0,No user reviews,0,0,0
1386640,True,0,No user reviews,0,0,0
1386660,True,0,No user reviews,0,0,0
1386680,True,0,No user reviews,0,0,0
1386690,True,0,No user reviews,0,0,0
1386700,True,0,1 user reviews,1,0,1
1386710,True,0,2 user reviews,2,0,2
1386730,True,7,Positive,29,1,30
1386740,True,0,No user reviews,0,0,0
1386770,True,0,No user reviews,0,0,0
1386780,True,0,No user reviews,0,0,0
1386790,True,0,No user reviews,0,0,0
1386810,True,0,1 user reviews,1,0,1
1386820,True,0,No user reviews,0,0,0
1386830,True,0,No user reviews,0,0,0
1386840,True,0,2 user reviews,1,1,2
1386870,True,0,No user reviews,0,0,0
1386900,True,0,No user reviews,0,0,0
1386910,True,0,2 user reviews,1,1,2
1386930,True,0,1 user reviews,1,0,1
1386950,True,0,No user reviews,0,0,0
1386960,True,0,No user reviews,0,0,0
1386980,True,5,Mixed,17,17,34
1386990,True,0,5 user reviews,4,1,5
1387000,True,0,No user reviews,0,0,0
1387010,True,0,5 user reviews,5,0,5
1387030,True,0,4 user reviews,4,0,4
1387060,True,0,4 user reviews,3,1,4
1387105,True,0,No user reviews,0,0,0
1387110,True,0,No user reviews,0,0,0
1387150,True,0,3 user reviews,2,1,3
1387170,True,0,5 user reviews,3,2,5
1387190,True,0,No user reviews,0,0,0
1387200,True,0,No user reviews,0,0,0
1387250,True,0,1 user reviews,1,0,1
1387290,True,5,Mixed,10,8,18
1387310,True,0,No user reviews,0,0,0
1387320,True,0,No user reviews,0,0,0
1387330,True,0,No user reviews,0,0,0
1387340,True,0,1 user reviews,1,0,1
1387350,True,0,No user reviews,0,0,0
1387380,True,0,No user reviews,0,0,0
1387390,True,0,No user reviews,0,0,0
1387400,True,0,No user reviews,0,0,0
1387410,True,0,No user reviews,0,0,0
1387430,True,0,No user reviews,0,0,0
1387450,True,0,No user reviews,0,0,0
1387460,True,0,No user reviews,0,0,0
1387470,True,0,No user reviews,0,0,0
1387480,True,0,No user reviews,0,0,0
1387500,True,0,No user reviews,0,0,0
1387510,True,0,No user reviews,0,0,0
1387540,True,0,No user reviews,0,0,0
1387550,True,0,No user reviews,0,0,0
1387560,True,0,1 user reviews,1,0,1
1387570,True,0,No user reviews,0,0,0
1387580,True,0,No user reviews,0,0,0
1387590,True,0,No user reviews,0,0,0
1387610,True,0,5 user reviews,4,1,5
1387620,True,0,1 user reviews,1,0,1
1387640,True,0,No user reviews,0,0,0
1387660,True,0,No user reviews,0,0,0
1387670,True,0,No user reviews,0,0,0
1387680,True,0,No user reviews,0,0,0
1387690,True,0,No user reviews,0,0,0
1387700,True,0,No user reviews,0,0,0
1387710,True,0,No user reviews,0,0,0
1387720,True,0,No user reviews,0,0,0
1387730,True,0,No user reviews,0,0,0
1387740,True,0,No user reviews,0,0,0
1387750,True,0,No user reviews,0,0,0
1387760,True,0,No user reviews,0,0,0
1387830,True,0,2 user reviews,0,2,2
1387850,True,0,1 user reviews,0,1,1
1387870,True,0,No user reviews,0,0,0
1387890,True,0,No user reviews,0,0,0
1387900,True,0,No user reviews,0,0,0
1387910,True,0,No user reviews,0,0,0
1387920,True,0,No user reviews,0,0,0
1387921,True,0,No user reviews,0,0,0
1387940,True,0,No user reviews,0,0,0
1387950,True,0,No user reviews,0,0,0
1387960,True,0,No user reviews,0,0,0
1387970,True,0,No user reviews,0,0,0
1387980,True,0,1 user reviews,1,0,1
1387990,True,0,No user reviews,0,0,0
1388010,True,0,No user reviews,0,0,0
1388030,True,0,2 user reviews,1,1,2
1388090,True,0,2 user reviews,2,0,2
1388110,True,0,No user reviews,0,0,0
1388120,True,0,No user reviews,0,0,0
1388130,True,0,1 user reviews,0,1,1
1388140,True,0,No user reviews,0,0,0
1388150,True,0,No user reviews,0,0,0
1388160,True,0,6 user reviews,6,0,6
1388170,True,0,No user reviews,0,0,0
1388230,True,0,4 user reviews,4,0,4
1388260,True,0,No user reviews,0,0,0
1388270,True,0,No user reviews,0,0,0
1388290,True,0,No user reviews,0,0,0
1388310,True,0,2 user reviews,2,0,2
1388330,True,0,No user reviews,0,0,0
1388350,True,0,No user reviews,0,0,0
1388360,True,0,No user reviews,0,0,0
1388370,True,5,Mixed,6,4,10
1388380,True,0,2 user reviews,0,2,2
1388390,True,0,1 user reviews,1,0,1
1388430,True,0,No user reviews,0,0,0
1388440,True,0,No user reviews,0,0,0
1388490,True,0,1 user reviews,0,1,1
1388500,True,0,No user reviews,0,0,0
1388570,True,0,No user reviews,0,0,0
1388610,True,0,No user reviews,0,0,0
1388620,True,0,No user reviews,0,0,0
1388630,True,0,No user reviews,0,0,0
1388650,True,0,No user reviews,0,0,0
1388670,True,0,No user reviews,0,0,0
1388680,True,0,No user reviews,0,0,0
1388690,True,0,No user reviews,0,0,0
1388700,True,0,No user reviews,0,0,0
1388720,True,0,No user reviews,0,0,0
1388730,True,0,1 user reviews,1,0,1
1388760,True,0,1 user reviews,1,0,1
1388770,True,0,No user reviews,0,0,0
1388790,True,0,No user reviews,0,0,0
1388800,True,0,No user reviews,0,0,0
1388820,True,0,No user reviews,0,0,0
1388840,True,0,No user reviews,0,0,0
1388860,True,0,2 user reviews,2,0,2
1388890,True,0,No user reviews,0,0,0
1388900,True,0,No user reviews,0,0,0
1388910,True,0,No user reviews,0,0,0
1388940,True,0,No user reviews,0,0,0
1388980,True,0,No user reviews,0,0,0
1389010,True,0,2 user reviews,2,0,2
1389030,True,0,No user reviews,0,0,0
1389040,True,0,No user reviews,0,0,0
1389060,True,0,No user reviews,0,0,0
1389070,True,0,4 user reviews,4,0,4
1389090,True,0,No user reviews,0,0,0
1389120,True,0,No user reviews,0,0,0
1389150,True,0,No user reviews,0,0,0
1389160,True,0,No user reviews,0,0,0
1389170,True,0,No user reviews,0,0,0
1389180,True,0,No user reviews,0,0,0
1389190,True,0,No user reviews,0,0,0
1389200,True,0,No user reviews,0,0,0
1389220,True,0,No user reviews,0,0,0
1389250,True,0,No user reviews,0,0,0
1389260,True,0,No user reviews,0,0,0
1389270,True,0,3 user reviews,3,0,3
1389290,True,0,1 user reviews,1,0,1
1389300,True,0,No user reviews,0,0,0
1389310,True,0,No user reviews,0,0,0
1389340,True,0,No user reviews,0,0,0
1389370,True,0,No user reviews,0,0,0
1389380,True,0,No user reviews,0,0,0
1389400,True,0,No user reviews,0,0,0
1389410,True,0,No user reviews,0,0,0
1389420,True,0,No user reviews,0,0,0
1389430,True,0,No user reviews,0,0,0
1389440,True,0,No user reviews,0,0,0
1389470,True,0,1 user reviews,0,1,1
1389490,True,0,No user reviews,0,0,0
1389491,True,0,No user reviews,0,0,0
1389510,True,0,No user reviews,0,0,0
1389530,True,0,No user reviews,0,0,0
1389540,True,0,No user reviews,0,0,0
1389550,True,0,No user reviews,0,0,0
1389560,True,7,Positive,14,0,14
1389580,True,0,No user reviews,0,0,0
1389590,True,0,No user reviews,0,0,0
1389610,True,7,Positive,11,0,11
1389630,True,0,No user reviews,0,0,0
1389650,True,0,No user reviews,0,0,0
1389660,True,0,No user reviews,0,0,0
1389680,True,6,Mostly Positive,13,5,18
1389700,True,0,5 user reviews,5,0,5
1389710,True,0,No user reviews,0,0,0
1389730,True,0,No user reviews,0,0,0
1389740,True,0,No user reviews,0,0,0
1389750,True,0,3 user reviews,3,0,3
1389770,True,0,No user reviews,0,0,0
1389800,True,0,No user reviews,0,0,0
1389820,True,0,No user reviews,0,0,0
1389830,True,0,No user reviews,0,0,0
1389850,True,0,No user reviews,0,0,0
1389880,True,0,No user reviews,0,0,0
1389890,True,7,Positive,19,0,19
1389900,True,0,No user reviews,0,0,0
1389910,True,0,No user reviews,0,0,0
1389911,True,0,1 user reviews,1,0,1
1389940,True,0,No user reviews,0,0,0
1389980,True,0,No user reviews,0,0,0
1390000,True,0,No user reviews,0,0,0
1390010,True,8,Very Positive,73,12,85
1390040,True,0,1 user reviews,1,0,1
1390060,True,0,No user reviews,0,0,0
1390070,True,0,No user reviews,0,0,0
1390080,True,0,No user reviews,0,0,0
1390100,True,0,No user reviews,0,0,0
1390110,True,0,6 user reviews,6,0,6
1390130,True,0,3 user reviews,3,0,3
1390131,True,0,1 user reviews,1,0,1
1390132,True,0,1 user reviews,1,0,1
1390150,True,0,No user reviews,0,0,0
1390190,True,0,No user reviews,0,0,0
1390210,True,0,No user reviews,0,0,0
1390211,True,0,3 user reviews,3,0,3
1390213,True,0,No user reviews,0,0,0
1390214,True,0,No user reviews,0,0,0
1390240,True,0,No user reviews,0,0,0
1390300,True,7,Positive,15,0,15
1390330,True,0,No user reviews,0,0,0
1390340,True,0,4 user reviews,1,3,4
1390350,True,0,No user reviews,0,0,0
1390370,True,0,No user reviews,0,0,0
1390380,True,0,No user reviews,0,0,0
1390410,True,0,No user reviews,0,0,0
1390480,True,0,No user reviews,0,0,0
1390490,True,7,Positive,11,1,12
1390520,True,0,No user reviews,0,0,0
1390550,True,0,No user reviews,0,0,0
1390560,True,0,No user reviews,0,0,0
1390580,True,0,No user reviews,0,0,0
1390590,True,0,No user reviews,0,0,0
1390610,True,0,No user reviews,0,0,0
1390620,True,0,No user reviews,0,0,0
1390650,True,0,No user reviews,0,0,0
1390660,True,0,No user reviews,0,0,0
1390670,True,0,No user reviews,0,0,0
1390680,True,0,No user reviews,0,0,0
1390710,True,0,1 user reviews,0,1,1
1390740,True,7,Positive,33,8,41
1390750,True,0,No user reviews,0,0,0
1390760,True,0,No user reviews,0,0,0
1390770,True,7,Positive,14,0,14
1390780,True,0,No user reviews,0,0,0
1390810,True,0,No user reviews,0,0,0
1390830,True,0,No user reviews,0,0,0
1390840,True,7,Positive,35,2,37
1390850,True,0,No user reviews,0,0,0
1390870,True,0,No user reviews,0,0,0
1390880,True,0,No user reviews,0,0,0
1390900,True,0,No user reviews,0,0,0
1390920,True,0,No user reviews,0,0,0
1390930,True,0,No user reviews,0,0,0
1390940,True,0,No user reviews,0,0,0
1390950,True,0,No user reviews,0,0,0
1390970,True,0,No user reviews,0,0,0
1391000,True,0,No user reviews,0,0,0
1391010,True,0,No user reviews,0,0,0
1391030,True,0,No user reviews,0,0,0
1391060,True,0,No user reviews,0,0,0
1391070,True,0,No user reviews,0,0,0
1391090,True,0,No user reviews,0,0,0
1391130,True,0,No user reviews,0,0,0
1391160,True,0,No user reviews,0,0,0
1391220,True,0,No user reviews,0,0,0
1391230,True,0,No user reviews,0,0,0
1391250,True,0,No user reviews,0,0,0
1391280,True,4,Mostly Negative,4,7,11
1391290,True,0,No user reviews,0,0,0
1391320,True,0,No user reviews,0,0,0
1391340,True,0,No user reviews,0,0,0
1391350,True,0,No user reviews,0,0,0
1391380,True,0,No user reviews,0,0,0
1391400,True,0,4 user reviews,2,2,4
1391430,True,0,No user reviews,0,0,0
1391440,True,0,No user reviews,0,0,0
1391450,True,0,7 user reviews,6,1,7
1391480,True,0,No user reviews,0,0,0
1391540,True,0,No user reviews,0,0,0
1391570,True,0,No user reviews,0,0,0
1391600,True,0,No user reviews,0,0,0
1391610,True,0,No user reviews,0,0,0
1391620,True,0,No user reviews,0,0,0
1391630,True,0,1 user reviews,1,0,1
1391650,True,0,No user reviews,0,0,0
1391680,True,0,No user reviews,0,0,0
1391690,True,0,No user reviews,0,0,0
1391720,True,0,No user reviews,0,0,0
1391740,True,0,No user reviews,0,0,0
1391770,True,0,No user reviews,0,0,0
1391780,True,0,No user reviews,0,0,0
1391790,True,0,3 user reviews,2,1,3
1391800,True,0,5 user reviews,3,2,5
1391810,True,0,No user reviews,0,0,0
1391820,True,0,No user reviews,0,0,0
1391830,True,0,No user reviews,0,0,0
1391840,True,0,No user reviews,0,0,0
1391850,True,0,No user reviews,0,0,0
1391860,True,0,No user reviews,0,0,0
1391870,True,0,No user reviews,0,0,0
1391880,True,0,No user reviews,0,0,0
1391890,True,0,No user reviews,0,0,0
1391900,True,0,No user reviews,0,0,0
1391910,True,0,No user reviews,0,0,0
1391920,True,0,No user reviews,0,0,0
1391930,True,0,No user reviews,0,0,0
1391940,True,0,No user reviews,0,0,0
1391950,True,0,No user reviews,0,0,0
1391960,True,0,2 user reviews,2,0,2
1391990,True,0,No user reviews,0,0,0
1392000,True,0,No user reviews,0,0,0
1392010,True,0,No user reviews,0,0,0
1392020,True,0,No user reviews,0,0,0
1392030,True,0,6 user reviews,4,2,6
1392040,True,0,No user reviews,0,0,0
1392050,True,0,No user reviews,0,0,0
1392060,True,0,No user reviews,0,0,0
1392070,True,0,No user reviews,0,0,0
1392080,True,0,1 user reviews,1,0,1
1392100,True,0,No user reviews,0,0,0
1392110,True,0,No user reviews,0,0,0
1392120,True,0,No user reviews,0,0,0
1392130,True,0,2 user reviews,2,0,2
1392140,True,0,No user reviews,0,0,0
1392160,True,0,No user reviews,0,0,0
1392170,True,6,Mostly Positive,7,3,10
1392180,True,0,No user reviews,0,0,0
1392190,True,0,2 user reviews,0,2,2
1392210,True,0,No user reviews,0,0,0
1392220,True,0,No user reviews,0,0,0
1392240,True,0,No user reviews,0,0,0
1392250,True,0,No user reviews,0,0,0
1392270,True,0,No user reviews,0,0,0
1392271,True,0,No user reviews,0,0,0
1392280,True,0,No user reviews,0,0,0
1392410,True,0,No user reviews,0,0,0
1392430,True,0,1 user reviews,0,1,1
1392440,True,0,No user reviews,0,0,0
1392450,True,0,No user reviews,0,0,0
1392460,True,0,No user reviews,0,0,0
1392480,True,0,No user reviews,0,0,0
1392490,True,0,3 user reviews,3,0,3
1392500,True,0,No user reviews,0,0,0
1392510,True,0,No user reviews,0,0,0
1392520,True,0,No user reviews,0,0,0
1392540,True,0,No user reviews,0,0,0
1392560,True,0,No user reviews,0,0,0
1392570,True,0,No user reviews,0,0,0
1392590,True,0,No user reviews,0,0,0
1392600,True,0,9 user reviews,8,1,9
1392610,True,0,No user reviews,0,0,0
1392620,True,0,No user reviews,0,0,0
1392630,True,0,No user reviews,0,0,0
1392640,True,0,No user reviews,0,0,0
1392650,True,0,No user reviews,0,0,0
1392660,True,0,No user reviews,0,0,0
1392670,True,0,No user reviews,0,0,0
1392690,True,0,No user reviews,0,0,0
1392700,True,5,Mixed,12,8,20
1392750,True,0,No user reviews,0,0,0
1392760,True,0,5 user reviews,3,2,5
1392770,True,0,No user reviews,0,0,0
1392780,True,0,No user reviews,0,0,0
1392790,True,0,1 user reviews,1,0,1
1392810,True,0,No user reviews,0,0,0
1392820,True,8,Very Positive,145,4,149
1392830,True,0,No user reviews,0,0,0
1392850,True,0,No user reviews,0,0,0
1392870,True,0,No user reviews,0,0,0
1392880,True,0,No user reviews,0,0,0
1392890,True,0,No user reviews,0,0,0
1392900,True,0,No user reviews,0,0,0
1392930,True,0,No user reviews,0,0,0
1392950,True,0,No user reviews,0,0,0
1392980,True,0,No user reviews,0,0,0
1392990,True,0,No user reviews,0,0,0
1393000,True,0,No user reviews,0,0,0
1393010,True,0,No user reviews,0,0,0
1393020,True,0,No user reviews,0,0,0
1393040,True,0,No user reviews,0,0,0
1393080,True,0,1 user reviews,1,0,1
1393100,True,0,No user reviews,0,0,0
1393110,True,0,5 user reviews,4,1,5
1393120,True,0,8 user reviews,8,0,8
1393150,True,0,No user reviews,0,0,0
1393180,True,0,No user reviews,0,0,0
1393190,True,0,No user reviews,0,0,0
1393210,True,0,No user reviews,0,0,0
1393220,True,0,1 user reviews,0,1,1
1393270,True,0,No user reviews,0,0,0
1393310,True,0,No user reviews,0,0,0
1393320,True,0,No user reviews,0,0,0
1393340,True,0,No user reviews,0,0,0
1393350,True,0,5 user reviews,5,0,5
1393360,True,0,No user reviews,0,0,0
1393410,True,7,Positive,16,4,20
1393420,True,0,No user reviews,0,0,0
1393430,True,0,No user reviews,0,0,0
1393440,True,0,No user reviews,0,0,0
1393460,True,0,No user reviews,0,0,0
1393470,True,0,No user reviews,0,0,0
1393480,True,0,2 user reviews,2,0,2
1393490,True,0,No user reviews,0,0,0
1393500,True,7,Positive,17,1,18
1393510,True,0,No user reviews,0,0,0
1393550,True,0,No user reviews,0,0,0
1393560,True,0,No user reviews,0,0,0
1393570,True,0,No user reviews,0,0,0
1393580,True,0,No user reviews,0,0,0
1393590,True,0,No user reviews,0,0,0
1393591,True,0,No user reviews,0,0,0
1393600,True,0,No user reviews,0,0,0
1393610,True,0,No user reviews,0,0,0
1393630,True,0,No user reviews,0,0,0
1393640,True,0,No user reviews,0,0,0
1393650,True,0,No user reviews,0,0,0
1393660,True,0,No user reviews,0,0,0
1393690,True,0,No user reviews,0,0,0
1393700,True,0,No user reviews,0,0,0
1393720,True,0,No user reviews,0,0,0
1393730,True,0,No user reviews,0,0,0
1393740,True,0,No user reviews,0,0,0
1393750,True,0,No user reviews,0,0,0
1393770,True,0,No user reviews,0,0,0
1393780,True,0,1 user reviews,1,0,1
1393790,True,0,1 user reviews,1,0,1
1393800,True,0,4 user reviews,2,2,4
1393810,True,0,No user reviews,0,0,0
1393820,True,7,Positive,18,0,18
1393830,True,0,No user reviews,0,0,0
1393850,True,0,1 user reviews,0,1,1
1393870,True,0,No user reviews,0,0,0
1393890,True,0,No user reviews,0,0,0
1393910,True,0,No user reviews,0,0,0
1393930,True,0,1 user reviews,0,1,1
1393960,True,0,No user reviews,0,0,0
1393970,True,0,1 user reviews,1,0,1
1394020,True,0,No user reviews,0,0,0
1394040,True,0,No user reviews,0,0,0
1394060,True,0,2 user reviews,0,2,2
1394080,True,0,No user reviews,0,0,0
1394090,True,0,No user reviews,0,0,0
1394100,True,0,No user reviews,0,0,0
1394130,True,0,No user reviews,0,0,0
1394140,True,0,4 user reviews,3,1,4
1394150,True,0,No user reviews,0,0,0
1394160,True,7,Positive,12,1,13
1394200,True,0,No user reviews,0,0,0
1394210,True,0,1 user reviews,0,1,1
1394220,True,0,No user reviews,0,0,0
1394230,True,0,No user reviews,0,0,0
1394232,True,0,No user reviews,0,0,0
1394240,True,0,No user reviews,0,0,0
1394270,True,0,No user reviews,0,0,0
1394300,True,0,No user reviews,0,0,0
1394310,True,0,No user reviews,0,0,0
1394340,True,0,No user reviews,0,0,0
1394350,True,0,No user reviews,0,0,0
1394400,True,0,No user reviews,0,0,0
1394410,True,0,1 user reviews,1,0,1
1394420,True,0,No user reviews,0,0,0
1394440,True,0,No user reviews,0,0,0
1394480,True,0,No user reviews,0,0,0
1394490,True,0,No user reviews,0,0,0
1394500,True,0,No user reviews,0,0,0
1394510,True,0,No user reviews,0,0,0
1394520,True,7,Positive,17,1,18
1394530,True,0,No user reviews,0,0,0
1394540,True,0,No user reviews,0,0,0
1394560,True,0,No user reviews,0,0,0
1394570,True,0,No user reviews,0,0,0
1394580,True,0,No user reviews,0,0,0
1394600,True,0,5 user reviews,5,0,5
1394640,True,0,No user reviews,0,0,0
1394670,True,0,No user reviews,0,0,0
1394680,True,0,1 user reviews,1,0,1
1394690,True,0,No user reviews,0,0,0
1394700,True,0,1 user reviews,1,0,1
1394710,True,0,No user reviews,0,0,0
1394730,True,0,No user reviews,0,0,0
1394750,True,0,No user reviews,0,0,0
1394760,True,0,No user reviews,0,0,0
1394770,True,0,No user reviews,0,0,0
1394800,True,5,Mixed,53,37,90
1394820,True,0,No user reviews,0,0,0
1394830,True,0,7 user reviews,7,0,7
1394840,True,0,No user reviews,0,0,0
1394850,True,0,No user reviews,0,0,0
1394870,True,0,No user reviews,0,0,0
1394880,True,0,2 user reviews,2,0,2
1394890,True,7,Positive,10,1,11
1394910,True,0,No user reviews,0,0,0
1394950,True,0,8 user reviews,5,3,8
1394960,True,0,No user reviews,0,0,0
1394980,True,0,1 user reviews,1,0,1
1394990,True,0,No user reviews,0,0,0
1395000,True,0,1 user reviews,0,1,1
1395010,True,0,No user reviews,0,0,0
1395020,True,0,No user reviews,0,0,0
1395050,True,0,No user reviews,0,0,0
1395060,True,0,No user reviews,0,0,0
1395080,True,0,1 user reviews,1,0,1
1395100,True,0,3 user reviews,3,0,3
1395110,True,0,No user reviews,0,0,0
1395120,True,0,No user reviews,0,0,0
1395130,True,0,No user reviews,0,0,0
1395140,True,0,No user reviews,0,0,0
1395170,True,0,3 user reviews,2,1,3
1395180,True,0,No user reviews,0,0,0
1395190,True,0,No user reviews,0,0,0
1395210,True,0,No user reviews,0,0,0
1395230,True,0,No user reviews,0,0,0
1395250,True,0,No user reviews,0,0,0
1395270,True,0,No user reviews,0,0,0
1395280,True,0,2 user reviews,1,1,2
1395300,True,0,No user reviews,0,0,0
1395310,True,0,No user reviews,0,0,0
1395330,True,0,No user reviews,0,0,0
1395340,True,0,No user reviews,0,0,0
1395350,True,0,No user reviews,0,0,0
1395400,True,0,No user reviews,0,0,0
1395410,True,0,No user reviews,0,0,0
1395420,True,0,2 user reviews,1,1,2
1395450,True,0,No user reviews,0,0,0
1395470,True,0,1 user reviews,1,0,1
1395510,True,0,No user reviews,0,0,0
1395540,True,7,Positive,19,1,20
1395550,True,0,No user reviews,0,0,0
1395560,True,7,Positive,27,4,31
1395590,True,0,1 user reviews,1,0,1
1395620,True,0,No user reviews,0,0,0
1395630,True,0,No user reviews,0,0,0
1395650,True,0,No user reviews,0,0,0
1395660,True,0,No user reviews,0,0,0
1395710,True,0,No user reviews,0,0,0
1395720,True,0,1 user reviews,1,0,1
1395730,True,0,8 user reviews,8,0,8
1395760,True,0,No user reviews,0,0,0
1395780,True,0,No user reviews,0,0,0
1395800,True,0,No user reviews,0,0,0
1395801,True,0,No user reviews,0,0,0
1395802,True,0,No user reviews,0,0,0
1395803,True,0,No user reviews,0,0,0
1395804,True,0,No user reviews,0,0,0
1395805,True,0,No user reviews,0,0,0
1395806,True,0,No user reviews,0,0,0
1395807,True,0,No user reviews,0,0,0
1395808,True,0,No user reviews,0,0,0
1395809,True,0,No user reviews,0,0,0
1395820,True,0,No user reviews,0,0,0
1395830,True,0,No user reviews,0,0,0
1395850,True,0,1 user reviews,1,0,1
1395880,True,0,No user reviews,0,0,0
1395890,True,0,No user reviews,0,0,0
1395900,True,0,No user reviews,0,0,0
1395910,True,0,No user reviews,0,0,0
1395920,True,0,No user reviews,0,0,0
1395950,True,0,3 user reviews,2,1,3
1395970,True,0,No user reviews,0,0,0
1396010,True,0,No user reviews,0,0,0
1396020,True,0,No user reviews,0,0,0
1396040,True,0,No user reviews,0,0,0
1396050,True,0,No user reviews,0,0,0
1396090,True,0,No user reviews,0,0,0
1396140,True,0,No user reviews,0,0,0
1396160,True,0,No user reviews,0,0,0
1396170,True,0,No user reviews,0,0,0
1396200,True,0,No user reviews,0,0,0
1396220,True,0,No user reviews,0,0,0
1396240,True,0,No user reviews,0,0,0
1396260,True,7,Positive,11,2,13
1396270,True,0,No user reviews,0,0,0
1396310,True,0,No user reviews,0,0,0
1396320,True,0,No user reviews,0,0,0
1396350,True,0,1 user reviews,1,0,1
1396360,True,0,No user reviews,0,0,0
1396380,True,0,2 user reviews,1,1,2
1396400,True,0,No user reviews,0,0,0
1396410,True,0,No user reviews,0,0,0
1396420,True,0,1 user reviews,0,1,1
1396430,True,0,No user reviews,0,0,0
1396440,True,0,No user reviews,0,0,0
1396450,True,0,No user reviews,0,0,0
1396480,True,0,No user reviews,0,0,0
1396490,True,0,No user reviews,0,0,0
1396570,True,0,1 user reviews,1,0,1
1396580,True,0,1 user reviews,0,1,1
1396610,True,0,1 user reviews,1,0,1
1396620,True,0,No user reviews,0,0,0
1396630,True,0,No user reviews,0,0,0
1396670,True,0,No user reviews,0,0,0
1396750,True,0,No user reviews,0,0,0
1396780,True,0,No user reviews,0,0,0
1396800,True,0,No user reviews,0,0,0
1396820,True,0,No user reviews,0,0,0
1396840,True,0,No user reviews,0,0,0
1396860,True,0,No user reviews,0,0,0
1396870,True,0,No user reviews,0,0,0
1396900,True,0,No user reviews,0,0,0
1396920,True,0,No user reviews,0,0,0
1396930,True,0,1 user reviews,0,1,1
1396940,True,0,No user reviews,0,0,0
1396950,True,0,No user reviews,0,0,0
1396970,True,0,No user reviews,0,0,0
1396980,True,0,No user reviews,0,0,0
1397010,True,0,No user reviews,0,0,0
1397020,True,0,No user reviews,0,0,0
1397030,True,8,Very Positive,83,2,85
1397040,True,0,No user reviews,0,0,0
1397050,True,0,1 user reviews,1,0,1
1397080,True,0,No user reviews,0,0,0
1397090,True,0,No user reviews,0,0,0
1397100,True,0,No user reviews,0,0,0
1397110,True,0,6 user reviews,6,0,6
1397120,True,0,No user reviews,0,0,0
1397130,True,0,No user reviews,0,0,0
1397140,True,0,No user reviews,0,0,0
1397150,True,0,No user reviews,0,0,0
1397160,True,0,No user reviews,0,0,0
1397170,True,5,Mixed,6,4,10
1397200,True,0,No user reviews,0,0,0
1397220,True,0,No user reviews,0,0,0
1397230,True,0,1 user reviews,1,0,1
1397240,True,0,9 user reviews,9,0,9
1397250,True,0,1 user reviews,1,0,1
1397270,True,0,No user reviews,0,0,0
1397280,True,0,4 user reviews,4,0,4
1397290,True,0,No user reviews,0,0,0
1397310,True,0,No user reviews,0,0,0
1397320,True,0,No user reviews,0,0,0
1397350,True,0,4 user reviews,4,0,4
1397360,True,0,No user reviews,0,0,0
1397400,True,0,No user reviews,0,0,0
1397410,True,0,No user reviews,0,0,0
1397420,True,0,No user reviews,0,0,0
1397430,True,0,No user reviews,0,0,0
1397470,True,0,6 user reviews,6,0,6
1397480,True,0,No user reviews,0,0,0
1397490,True,5,Mixed,9,5,14
1397530,True,0,No user reviews,0,0,0
1397540,True,0,4 user reviews,4,0,4
1397610,True,0,No user reviews,0,0,0
1397620,True,0,No user reviews,0,0,0
1397670,True,0,No user reviews,0,0,0
1397680,True,0,No user reviews,0,0,0
1397690,True,0,1 user reviews,0,1,1
1397700,True,0,No user reviews,0,0,0
1397710,True,0,No user reviews,0,0,0
1397720,True,0,2 user reviews,2,0,2
1397730,True,0,No user reviews,0,0,0
1397760,True,0,No user reviews,0,0,0
1397780,True,0,No user reviews,0,0,0
1397800,True,0,No user reviews,0,0,0
1397810,True,0,1 user reviews,1,0,1
1397850,True,0,No user reviews,0,0,0
1397880,True,0,No user reviews,0,0,0
1397920,True,0,No user reviews,0,0,0
1397940,True,0,No user reviews,0,0,0
1397950,True,0,No user reviews,0,0,0
1397960,True,0,1 user reviews,1,0,1
1397980,True,0,No user reviews,0,0,0
1397990,True,0,No user reviews,0,0,0
1398030,True,0,No user reviews,0,0,0
1398050,True,0,2 user reviews,2,0,2
1398060,True,0,No user reviews,0,0,0
1398080,True,0,No user reviews,0,0,0
1398090,True,0,No user reviews,0,0,0
1398100,True,0,No user reviews,0,0,0
1398120,True,0,1 user reviews,0,1,1
1398130,True,0,No user reviews,0,0,0
1398140,True,0,No user reviews,0,0,0
1398150,True,0,No user reviews,0,0,0
1398160,True,0,No user reviews,0,0,0
1398180,True,0,7 user reviews,6,1,7
1398200,True,0,No user reviews,0,0,0
1398210,True,0,No user reviews,0,0,0
1398220,True,0,No user reviews,0,0,0
1398240,True,0,No user reviews,0,0,0
1398250,True,0,No user reviews,0,0,0
1398270,True,0,5 user reviews,5,0,5
1398290,True,0,No user reviews,0,0,0
1398320,True,0,1 user reviews,0,1,1
1398390,True,0,1 user reviews,1,0,1
1398400,True,0,No user reviews,0,0,0
1398440,True,0,No user reviews,0,0,0
1398460,True,0,No user reviews,0,0,0
1398470,True,0,No user reviews,0,0,0
1398490,True,0,No user reviews,0,0,0
1398500,True,0,No user reviews,0,0,0
1398510,True,0,No user reviews,0,0,0
1398520,True,0,No user reviews,0,0,0
1398570,True,0,7 user reviews,6,1,7
1398580,True,0,No user reviews,0,0,0
1398590,True,0,No user reviews,0,0,0
1398600,True,0,No user reviews,0,0,0
1398610,True,0,No user reviews,0,0,0
1398620,True,0,No user reviews,0,0,0
1398640,True,0,No user reviews,0,0,0
1398740,True,0,No user reviews,0,0,0
1398750,True,0,1 user reviews,1,0,1
1398770,True,0,6 user reviews,6,0,6
1398780,True,0,No user reviews,0,0,0
1398790,True,0,2 user reviews,2,0,2
1398820,True,0,2 user reviews,2,0,2
1398830,True,0,No user reviews,0,0,0
1398860,True,0,No user reviews,0,0,0
1398890,True,0,No user reviews,0,0,0
1398900,True,0,No user reviews,0,0,0
1398920,True,0,No user reviews,0,0,0
1398950,True,0,No user reviews,0,0,0
1398990,True,0,No user reviews,0,0,0
1399010,True,0,No user reviews,0,0,0
1399020,True,0,1 user reviews,1,0,1
1399030,True,0,No user reviews,0,0,0
1399040,True,0,1 user reviews,1,0,1
1399090,True,0,No user reviews,0,0,0
1399140,True,0,9 user reviews,7,2,9
1399150,True,0,1 user reviews,1,0,1
1399180,True,0,No user reviews,0,0,0
1399210,True,0,No user reviews,0,0,0
1399230,True,0,No user reviews,0,0,0
1399250,True,0,No user reviews,0,0,0
1399290,True,0,No user reviews,0,0,0
1399300,True,0,2 user reviews,2,0,2
1399310,True,0,No user reviews,0,0,0
1399350,True,0,No user reviews,0,0,0
1399370,True,6,Mostly Positive,33,10,43
1399380,True,0,6 user reviews,6,0,6
1399400,True,0,1 user reviews,1,0,1
1399420,True,0,2 user reviews,2,0,2
1399440,True,0,No user reviews,0,0,0
1399450,True,0,No user reviews,0,0,0
1399460,True,0,1 user reviews,0,1,1
1399480,True,0,3 user reviews,2,1,3
1399490,True,0,1 user reviews,1,0,1
1399500,True,0,3 user reviews,3,0,3
1399510,True,0,No user reviews,0,0,0
1399520,True,0,No user reviews,0,0,0
1399540,True,0,No user reviews,0,0,0
1399560,True,0,No user reviews,0,0,0
1399590,True,0,4 user reviews,3,1,4
1399610,True,0,1 user reviews,1,0,1
1399620,True,0,No user reviews,0,0,0
1399630,True,0,No user reviews,0,0,0
1399650,True,0,No user reviews,0,0,0
1399660,True,7,Positive,24,0,24
1399680,True,0,No user reviews,0,0,0
1399740,True,0,No user reviews,0,0,0
1399750,True,0,No user reviews,0,0,0
1399760,True,0,No user reviews,0,0,0
1399770,True,0,No user reviews,0,0,0
1399790,True,0,2 user reviews,2,0,2
1399791,True,0,No user reviews,0,0,0
1399810,True,0,No user reviews,0,0,0
1399820,True,0,No user reviews,0,0,0
1399830,True,0,No user reviews,0,0,0
1399850,True,0,3 user reviews,3,0,3
1399890,True,0,No user reviews,0,0,0
1399910,True,0,2 user reviews,2,0,2
1399920,True,0,No user reviews,0,0,0
1399940,True,0,No user reviews,0,0,0
1399950,True,0,No user reviews,0,0,0
1399960,True,7,Positive,14,2,16
1399970,True,0,No user reviews,0,0,0
1399990,True,0,No user reviews,0,0,0
1400000,True,0,No user reviews,0,0,0
1400030,True,0,No user reviews,0,0,0
1400040,True,0,No user reviews,0,0,0
1400050,True,0,No user reviews,0,0,0
1400051,True,0,1 user reviews,0,1,1
1400060,True,0,No user reviews,0,0,0
1400070,True,0,No user reviews,0,0,0
1400100,True,0,2 user reviews,0,2,2
1400110,True,0,No user reviews,0,0,0
1400140,True,0,No user reviews,0,0,0
1400150,True,0,3 user reviews,2,1,3
1400160,True,0,No user reviews,0,0,0
1400170,True,0,No user reviews,0,0,0
1400180,True,0,6 user reviews,4,2,6
1400190,True,0,4 user reviews,4,0,4
1400200,True,0,3 user reviews,2,1,3
1400210,True,0,4 user reviews,4,0,4
1400260,True,0,7 user reviews,7,0,7
1400270,True,0,No user reviews,0,0,0
1400280,True,0,No user reviews,0,0,0
1400290,True,0,No user reviews,0,0,0
1400300,True,0,7 user reviews,6,1,7
1400301,True,7,Positive,10,0,10
1400302,True,0,5 user reviews,5,0,5
1400307,True,0,No user reviews,0,0,0
1400308,True,0,No user reviews,0,0,0
1400309,True,0,No user reviews,0,0,0
1400320,True,0,No user reviews,0,0,0
1400350,True,0,No user reviews,0,0,0
1400360,True,0,1 user reviews,0,1,1
1400370,True,0,No user reviews,0,0,0
1400380,True,0,No user reviews,0,0,0
1400390,True,0,No user reviews,0,0,0
1400400,True,0,No user reviews,0,0,0
1400410,True,0,No user reviews,0,0,0
1400420,True,0,No user reviews,0,0,0
1400440,True,0,No user reviews,0,0,0
1400460,True,0,No user reviews,0,0,0
1400470,True,0,No user reviews,0,0,0
1400480,True,0,No user reviews,0,0,0
1400490,True,0,No user reviews,0,0,0
1400500,True,0,No user reviews,0,0,0
1400510,True,0,1 user reviews,1,0,1
1400520,True,0,No user reviews,0,0,0
1400530,True,0,No user reviews,0,0,0
1400551,True,0,No user reviews,0,0,0
1400570,True,0,No user reviews,0,0,0
1400590,True,0,1 user reviews,1,0,1
1400600,True,0,No user reviews,0,0,0
1400610,True,0,No user reviews,0,0,0
1400620,True,0,No user reviews,0,0,0
1400630,True,0,No user reviews,0,0,0
1400650,True,0,1 user reviews,0,1,1
1400680,True,0,1 user reviews,1,0,1
1400720,True,0,2 user reviews,2,0,2
1400740,True,0,No user reviews,0,0,0
1400770,True,0,No user reviews,0,0,0
1400860,True,0,No user reviews,0,0,0
1400870,True,0,No user reviews,0,0,0
1400900,True,0,4 user reviews,3,1,4
1400910,True,0,No user reviews,0,0,0
1400920,True,0,1 user reviews,1,0,1
1400930,True,0,No user reviews,0,0,0
1400940,True,0,No user reviews,0,0,0
1400980,True,0,No user reviews,0,0,0
1401020,True,0,No user reviews,0,0,0
1401070,True,0,No user reviews,0,0,0
1401080,True,0,No user reviews,0,0,0
1401130,True,0,No user reviews,0,0,0
1401140,True,0,No user reviews,0,0,0
1401150,True,6,Mostly Positive,7,3,10
1401170,True,0,No user reviews,0,0,0
1401180,True,0,No user reviews,0,0,0
1401190,True,0,No user reviews,0,0,0
1401220,True,0,No user reviews,0,0,0
1401260,True,0,No user reviews,0,0,0
1401310,True,0,No user reviews,0,0,0
1401320,True,0,No user reviews,0,0,0
1401340,True,0,No user reviews,0,0,0
1401350,True,0,No user reviews,0,0,0
1401360,True,0,1 user reviews,1,0,1
1401370,True,0,No user reviews,0,0,0
1401450,True,0,8 user reviews,8,0,8
1401451,True,0,6 user reviews,5,1,6
1401452,True,7,Positive,12,1,13
1401470,True,0,No user reviews,0,0,0
1401490,True,5,Mixed,13,12,25
1401520,True,0,No user reviews,0,0,0
1401530,True,0,No user reviews,0,0,0
1401540,True,0,No user reviews,0,0,0
1401550,True,0,No user reviews,0,0,0
1401600,True,0,No user reviews,0,0,0
1401610,True,0,No user reviews,0,0,0
1401620,True,0,No user reviews,0,0,0
1401630,True,0,No user reviews,0,0,0
1401660,True,0,No user reviews,0,0,0
1401670,True,0,1 user reviews,1,0,1
1401680,True,0,No user reviews,0,0,0
1401750,True,0,No user reviews,0,0,0
1401760,True,0,No user reviews,0,0,0
1401770,True,0,No user reviews,0,0,0
1401840,True,6,Mostly Positive,9,3,12
1401850,True,0,No user reviews,0,0,0
1401860,True,8,Very Positive,82,5,87
1401861,True,0,No user reviews,0,0,0
1401870,True,0,No user reviews,0,0,0
1401880,True,0,5 user reviews,5,0,5
1401890,True,0,No user reviews,0,0,0
1401900,True,0,No user reviews,0,0,0
1401920,True,0,No user reviews,0,0,0
1401940,True,0,No user reviews,0,0,0
1401960,True,0,No user reviews,0,0,0
1401970,True,0,No user reviews,0,0,0
1401990,True,0,No user reviews,0,0,0
1402000,True,0,No user reviews,0,0,0
1402010,True,0,No user reviews,0,0,0
1402020,True,0,No user reviews,0,0,0
1402030,True,0,No user reviews,0,0,0
1402040,True,0,No user reviews,0,0,0
1402060,True,0,No user reviews,0,0,0
1402070,True,0,No user reviews,0,0,0
1402090,True,7,Positive,9,2,11
1402100,True,0,No user reviews,0,0,0
1402140,True,0,No user reviews,0,0,0
1402150,True,0,No user reviews,0,0,0
1402170,True,0,1 user reviews,1,0,1
1402180,True,0,No user reviews,0,0,0
1402210,True,0,No user reviews,0,0,0
1402220,True,0,No user reviews,0,0,0
1402240,True,0,No user reviews,0,0,0
1402260,True,0,No user reviews,0,0,0
1402300,True,0,No user reviews,0,0,0
1402310,True,0,No user reviews,0,0,0
1402320,True,0,No user reviews,0,0,0
1402330,True,0,No user reviews,0,0,0
1402340,True,0,No user reviews,0,0,0
1402350,True,0,No user reviews,0,0,0
1402360,True,0,No user reviews,0,0,0
1402380,True,0,1 user reviews,1,0,1
1402390,True,0,No user reviews,0,0,0
1402400,True,0,No user reviews,0,0,0
1402410,True,0,8 user reviews,6,2,8
1402420,True,0,No user reviews,0,0,0
1402460,True,0,No user reviews,0,0,0
1402470,True,0,No user reviews,0,0,0
1402490,True,0,No user reviews,0,0,0
1402560,True,0,No user reviews,0,0,0
1402570,True,0,No user reviews,0,0,0
1402580,True,0,No user reviews,0,0,0
1402590,True,0,No user reviews,0,0,0
1402600,True,0,No user reviews,0,0,0
1402620,True,0,No user reviews,0,0,0
1402630,True,0,4 user reviews,4,0,4
1402640,True,0,2 user reviews,2,0,2
1402650,True,0,No user reviews,0,0,0
1402680,True,0,No user reviews,0,0,0
1402690,True,0,No user reviews,0,0,0
1402710,True,0,No user reviews,0,0,0
1402720,True,0,No user reviews,0,0,0
1402730,True,0,No user reviews,0,0,0
1402740,True,0,No user reviews,0,0,0
1402750,True,0,No user reviews,0,0,0
1402790,True,0,1 user reviews,1,0,1
1402810,True,0,No user reviews,0,0,0
1402820,True,0,No user reviews,0,0,0
1402840,True,0,No user reviews,0,0,0
1402860,True,0,No user reviews,0,0,0
1402880,True,0,No user reviews,0,0,0
1402890,True,0,No user reviews,0,0,0
1402900,True,0,No user reviews,0,0,0
1402920,True,0,7 user reviews,3,4,7
1402930,True,0,3 user reviews,2,1,3
1403010,True,0,1 user reviews,1,0,1
1403070,True,0,No user reviews,0,0,0
1403090,True,0,3 user reviews,3,0,3
1403110,True,0,3 user reviews,3,0,3
1403130,True,0,1 user reviews,1,0,1
1403180,True,0,No user reviews,0,0,0
1403190,True,7,Positive,17,1,18
1403200,True,0,No user reviews,0,0,0
1403220,True,0,No user reviews,0,0,0
1403230,True,0,No user reviews,0,0,0
1403250,True,0,No user reviews,0,0,0
1403260,True,0,No user reviews,0,0,0
1403280,True,0,No user reviews,0,0,0
1403290,True,0,No user reviews,0,0,0
1403350,True,0,3 user reviews,3,0,3
1403360,True,0,No user reviews,0,0,0
1403370,True,0,No user reviews,0,0,0
1403380,True,0,No user reviews,0,0,0
1403400,True,0,No user reviews,0,0,0
1403410,True,0,No user reviews,0,0,0
1403420,True,0,No user reviews,0,0,0
1403440,True,0,No user reviews,0,0,0
1403450,True,0,No user reviews,0,0,0
1403460,True,0,No user reviews,0,0,0
1403470,True,0,No user reviews,0,0,0
1403490,True,0,No user reviews,0,0,0
1403500,True,0,No user reviews,0,0,0
1403510,True,0,No user reviews,0,0,0
1403520,True,0,No user reviews,0,0,0
1403540,True,0,1 user reviews,0,1,1
1403550,True,0,No user reviews,0,0,0
1403560,True,0,No user reviews,0,0,0
1403570,True,0,No user reviews,0,0,0
1403590,True,0,No user reviews,0,0,0
1403600,True,0,No user reviews,0,0,0
1403620,True,0,No user reviews,0,0,0
1403630,True,0,1 user reviews,1,0,1
1403650,True,0,No user reviews,0,0,0
1403670,True,0,No user reviews,0,0,0
1403680,True,0,1 user reviews,0,1,1
1403690,True,0,No user reviews,0,0,0
1403710,True,0,No user reviews,0,0,0
1403720,True,0,No user reviews,0,0,0
1403730,True,0,No user reviews,0,0,0
1403740,True,0,No user reviews,0,0,0
1403750,True,0,No user reviews,0,0,0
1403770,True,0,No user reviews,0,0,0
1403780,True,0,No user reviews,0,0,0
1403800,True,0,No user reviews,0,0,0
1403830,True,0,8 user reviews,8,0,8
1403840,True,0,1 user reviews,1,0,1
1403850,True,0,No user reviews,0,0,0
1403860,True,0,No user reviews,0,0,0
1403870,True,0,No user reviews,0,0,0
1403880,True,0,No user reviews,0,0,0
1403890,True,0,5 user reviews,5,0,5
1403900,True,0,No user reviews,0,0,0
1403910,True,0,No user reviews,0,0,0
1403920,True,0,No user reviews,0,0,0
1403930,True,0,No user reviews,0,0,0
1403950,True,0,No user reviews,0,0,0
1403960,True,0,No user reviews,0,0,0
1403970,True,0,No user reviews,0,0,0
1403990,True,0,No user reviews,0,0,0
1404000,True,0,No user reviews,0,0,0
1404010,True,0,No user reviews,0,0,0
1404020,True,0,No user reviews,0,0,0
1404030,True,0,No user reviews,0,0,0
1404050,True,0,4 user reviews,4,0,4
1404060,True,0,No user reviews,0,0,0
1404070,True,0,2 user reviews,2,0,2
1404080,True,0,No user reviews,0,0,0
1404090,True,0,7 user reviews,7,0,7
1404100,True,0,No user reviews,0,0,0
1404130,True,0,9 user reviews,9,0,9
1404140,True,0,No user reviews,0,0,0
1404150,True,0,9 user reviews,9,0,9
1404160,True,0,No user reviews,0,0,0
1404180,True,0,No user reviews,0,0,0
1404190,True,7,Positive,10,0,10
1404200,True,0,No user reviews,0,0,0
1404230,True,0,No user reviews,0,0,0
1404231,True,0,No user reviews,0,0,0
1404240,True,0,No user reviews,0,0,0
1404300,True,0,No user reviews,0,0,0
1404330,True,0,No user reviews,0,0,0
1404360,True,7,Positive,15,0,15
1404370,True,0,No user reviews,0,0,0
1404420,True,0,No user reviews,0,0,0
1404440,True,0,No user reviews,0,0,0
1404460,True,0,No user reviews,0,0,0
1404470,True,0,No user reviews,0,0,0
1404520,True,0,No user reviews,0,0,0
1404530,True,7,Positive,17,0,17
1404550,True,0,1 user reviews,0,1,1
1404620,True,0,No user reviews,0,0,0
1404640,True,0,No user reviews,0,0,0
1404641,True,0,No user reviews,0,0,0
1404650,True,0,No user reviews,0,0,0
1404670,True,0,No user reviews,0,0,0
1404690,True,0,No user reviews,0,0,0
1404710,True,0,No user reviews,0,0,0
1404750,True,0,No user reviews,0,0,0
1404760,True,0,No user reviews,0,0,0
1404770,True,0,No user reviews,0,0,0
1404790,True,0,No user reviews,0,0,0
1404810,True,0,No user reviews,0,0,0
1404850,True,0,No user reviews,0,0,0
1404860,True,0,No user reviews,0,0,0
1404870,True,0,No user reviews,0,0,0
1404880,True,0,No user reviews,0,0,0
1404900,True,0,No user reviews,0,0,0
1404901,True,0,No user reviews,0,0,0
1404910,True,0,No user reviews,0,0,0
1404930,True,0,No user reviews,0,0,0
1404950,True,0,8 user reviews,8,0,8
1404960,True,0,No user reviews,0,0,0
1404970,True,0,2 user reviews,2,0,2
1404980,True,7,Positive,13,0,13
1405030,True,0,No user reviews,0,0,0
1405050,True,0,No user reviews,0,0,0
1405080,True,0,No user reviews,0,0,0
1405090,True,0,No user reviews,0,0,0
1405120,True,0,No user reviews,0,0,0
1405130,True,0,No user reviews,0,0,0
1405160,True,0,No user reviews,0,0,0
1405170,True,0,1 user reviews,1,0,1
1405180,True,0,No user reviews,0,0,0
1405190,True,0,No user reviews,0,0,0
1405210,True,0,No user reviews,0,0,0
1405211,True,0,No user reviews,0,0,0
1405212,True,0,No user reviews,0,0,0
1405213,True,0,No user reviews,0,0,0
1405214,True,0,No user reviews,0,0,0
1405215,True,0,No user reviews,0,0,0
1405216,True,0,No user reviews,0,0,0
1405217,True,0,No user reviews,0,0,0
1405218,True,0,No user reviews,0,0,0
1405219,True,0,No user reviews,0,0,0
1405220,True,0,2 user reviews,2,0,2
1405230,True,0,No user reviews,0,0,0
1405240,True,0,2 user reviews,0,2,2
1405241,True,7,Positive,8,2,10
1405250,True,0,No user reviews,0,0,0
1405260,True,0,No user reviews,0,0,0
1405270,True,0,No user reviews,0,0,0
1405290,True,0,No user reviews,0,0,0
1405300,True,0,No user reviews,0,0,0
1405320,True,0,No user reviews,0,0,0
1405370,True,0,No user reviews,0,0,0
1405380,True,0,No user reviews,0,0,0
1405400,True,0,No user reviews,0,0,0
1405401,True,0,No user reviews,0,0,0
1405410,True,0,No user reviews,0,0,0
1405440,True,7,Positive,15,0,15
1405460,True,0,No user reviews,0,0,0
1405470,True,0,No user reviews,0,0,0
1405490,True,0,No user reviews,0,0,0
1405500,True,0,No user reviews,0,0,0
1405510,True,0,No user reviews,0,0,0
1405520,True,0,No user reviews,0,0,0
1405530,True,0,No user reviews,0,0,0
1405540,True,0,No user reviews,0,0,0
1405541,True,0,No user reviews,0,0,0
1405542,True,0,No user reviews,0,0,0
1405543,True,0,No user reviews,0,0,0
1405550,True,0,No user reviews,0,0,0
1405551,True,0,No user reviews,0,0,0
1405552,True,0,No user reviews,0,0,0
1405553,True,0,No user reviews,0,0,0
1405554,True,0,No user reviews,0,0,0
1405555,True,0,No user reviews,0,0,0
1405556,True,0,No user reviews,0,0,0
1405557,True,0,No user reviews,0,0,0
1405560,True,0,No user reviews,0,0,0
1405570,True,0,No user reviews,0,0,0
1405580,True,0,No user reviews,0,0,0
1405590,True,0,No user reviews,0,0,0
1405600,True,0,No user reviews,0,0,0
1405610,True,0,1 user reviews,1,0,1
1405620,True,0,No user reviews,0,0,0
1405630,True,0,No user reviews,0,0,0
1405640,True,0,No user reviews,0,0,0
1405650,True,0,3 user reviews,3,0,3
1405660,True,7,Positive,8,2,10
1405670,True,0,No user reviews,0,0,0
1405690,True,0,No user reviews,0,0,0
1405710,True,0,No user reviews,0,0,0
1405720,True,0,No user reviews,0,0,0
1405730,True,0,No user reviews,0,0,0
1405740,True,0,No user reviews,0,0,0
1405750,True,0,No user reviews,0,0,0
1405770,True,0,No user reviews,0,0,0
1405780,True,0,No user reviews,0,0,0
1405790,True,0,No user reviews,0,0,0
1405840,True,0,No user reviews,0,0,0
1405850,True,0,No user reviews,0,0,0
1405860,True,0,No user reviews,0,0,0
1405870,True,0,No user reviews,0,0,0
1405871,True,0,No user reviews,0,0,0
1405872,True,0,No user reviews,0,0,0
1405873,True,0,No user reviews,0,0,0
1405874,True,0,No user reviews,0,0,0
1405875,True,0,1 user reviews,1,0,1
1405880,True,0,No user reviews,0,0,0
1405900,True,0,No user reviews,0,0,0
1405910,True,0,No user reviews,0,0,0
1405920,True,0,No user reviews,0,0,0
1405950,True,0,No user reviews,0,0,0
1405960,True,0,1 user reviews,1,0,1
1405970,True,0,No user reviews,0,0,0
1405980,True,0,1 user reviews,0,1,1
1405990,True,0,1 user reviews,1,0,1
1406000,True,0,No user reviews,0,0,0
1406010,True,0,2 user reviews,2,0,2
1406020,True,0,No user reviews,0,0,0
1406030,True,0,No user reviews,0,0,0
1406040,True,0,No user reviews,0,0,0
1406050,True,0,No user reviews,0,0,0
1406060,True,0,No user reviews,0,0,0
1406070,True,0,No user reviews,0,0,0
1406080,True,0,No user reviews,0,0,0
1406090,True,0,No user reviews,0,0,0
1406100,True,0,No user reviews,0,0,0
1406110,True,0,1 user reviews,1,0,1
1406130,True,0,No user reviews,0,0,0
1406140,True,0,8 user reviews,8,0,8
1406150,True,0,No user reviews,0,0,0
1406160,True,0,No user reviews,0,0,0
1406180,True,0,No user reviews,0,0,0
1406190,True,0,No user reviews,0,0,0
1406200,True,0,No user reviews,0,0,0
1406220,True,0,No user reviews,0,0,0
1406230,True,0,No user reviews,0,0,0
1406240,True,0,No user reviews,0,0,0
1406260,True,0,No user reviews,0,0,0
1406270,True,0,6 user reviews,6,0,6
1406280,True,0,No user reviews,0,0,0
1406330,True,0,No user reviews,0,0,0
1406350,True,0,2 user reviews,2,0,2
1406380,True,0,No user reviews,0,0,0
1406450,True,0,No user reviews,0,0,0
1406460,True,0,No user reviews,0,0,0
1406480,True,0,No user reviews,0,0,0
1406500,True,0,No user reviews,0,0,0
1406560,True,0,No user reviews,0,0,0
1406570,True,0,No user reviews,0,0,0
1406610,True,0,4 user reviews,1,3,4
1406670,True,0,No user reviews,0,0,0
1406690,True,0,7 user reviews,7,0,7
1406740,True,0,No user reviews,0,0,0
1406750,True,0,No user reviews,0,0,0
1406770,True,0,No user reviews,0,0,0
1406780,True,0,No user reviews,0,0,0
1406790,True,0,No user reviews,0,0,0
1406840,True,0,1 user reviews,1,0,1
1406850,True,0,No user reviews,0,0,0
1406860,True,0,No user reviews,0,0,0
1406870,True,0,No user reviews,0,0,0
1406900,True,0,1 user reviews,1,0,1
1406930,True,0,No user reviews,0,0,0
1406940,True,0,No user reviews,0,0,0
1406970,True,0,No user reviews,0,0,0
1406980,True,0,No user reviews,0,0,0
1406990,True,0,No user reviews,0,0,0
1407010,True,0,No user reviews,0,0,0
1407020,True,0,No user reviews,0,0,0
1407050,True,0,No user reviews,0,0,0
1407060,True,0,5 user reviews,4,1,5
1407080,True,0,No user reviews,0,0,0
1407110,True,0,No user reviews,0,0,0
1407150,True,0,No user reviews,0,0,0
1407160,True,0,No user reviews,0,0,0
1407180,True,0,No user reviews,0,0,0
1407210,True,0,No user reviews,0,0,0
1407220,True,0,No user reviews,0,0,0
1407230,True,0,No user reviews,0,0,0
1407240,True,0,1 user reviews,1,0,1
1407250,True,0,No user reviews,0,0,0
1407260,True,0,No user reviews,0,0,0
1407270,True,0,No user reviews,0,0,0
1407290,True,0,1 user reviews,1,0,1
1407340,True,0,No user reviews,0,0,0
1407400,True,0,No user reviews,0,0,0
1407420,True,0,No user reviews,0,0,0
1407430,True,0,No user reviews,0,0,0
1407450,True,0,No user reviews,0,0,0
1407460,True,0,No user reviews,0,0,0
1407510,True,0,No user reviews,0,0,0
1407520,True,0,No user reviews,0,0,0
1407530,True,0,1 user reviews,0,1,1
1407540,True,0,No user reviews,0,0,0
1407570,True,0,No user reviews,0,0,0
1407620,True,0,No user reviews,0,0,0
1407650,True,0,No user reviews,0,0,0
1407700,True,0,No user reviews,0,0,0
1407701,True,0,No user reviews,0,0,0
1407740,True,0,No user reviews,0,0,0
1407760,True,0,No user reviews,0,0,0
1407770,True,0,No user reviews,0,0,0
1407790,True,0,No user reviews,0,0,0
1407800,True,0,No user reviews,0,0,0
1407850,True,0,No user reviews,0,0,0
1407860,True,0,No user reviews,0,0,0
1407870,True,0,1 user reviews,1,0,1
1407900,True,0,No user reviews,0,0,0
1407930,True,0,No user reviews,0,0,0
1407940,True,0,No user reviews,0,0,0
1407950,True,0,No user reviews,0,0,0
1407980,True,0,No user reviews,0,0,0
1408000,True,0,1 user reviews,0,1,1
1408010,True,0,No user reviews,0,0,0
1408020,True,6,Mostly Positive,118,38,156
1408050,True,0,No user reviews,0,0,0
1408060,True,0,8 user reviews,8,0,8
1408100,True,0,No user reviews,0,0,0
1408110,True,0,No user reviews,0,0,0
1408160,True,0,No user reviews,0,0,0
1408180,True,0,No user reviews,0,0,0
1408181,True,0,No user reviews,0,0,0
1408182,True,0,No user reviews,0,0,0
1408183,True,0,No user reviews,0,0,0
1408184,True,0,No user reviews,0,0,0
1408185,True,0,No user reviews,0,0,0
1408186,True,0,No user reviews,0,0,0
1408187,True,0,No user reviews,0,0,0
1408188,True,0,No user reviews,0,0,0
1408189,True,0,No user reviews,0,0,0
1408190,True,0,No user reviews,0,0,0
1408200,True,0,2 user reviews,0,2,2
1408220,True,0,No user reviews,0,0,0
1408230,True,0,No user reviews,0,0,0
1408260,True,0,8 user reviews,8,0,8
1408270,True,0,No user reviews,0,0,0
1408280,True,0,No user reviews,0,0,0
1408290,True,0,No user reviews,0,0,0
1408300,True,0,No user reviews,0,0,0
1408310,True,0,No user reviews,0,0,0
1408320,True,0,No user reviews,0,0,0
1408330,True,0,No user reviews,0,0,0
1408350,True,0,1 user reviews,1,0,1
1408370,True,0,No user reviews,0,0,0
1408380,True,0,No user reviews,0,0,0
1408400,True,0,No user reviews,0,0,0
1408410,True,0,2 user reviews,2,0,2
1408420,True,0,No user reviews,0,0,0
1408430,True,0,No user reviews,0,0,0
1408440,True,0,No user reviews,0,0,0
1408450,True,0,No user reviews,0,0,0
1408460,True,0,No user reviews,0,0,0
1408470,True,0,No user reviews,0,0,0
1408480,True,0,No user reviews,0,0,0
1408490,True,0,No user reviews,0,0,0
1408510,True,0,No user reviews,0,0,0
1408520,True,0,No user reviews,0,0,0
1408550,True,0,No user reviews,0,0,0
1408570,True,0,No user reviews,0,0,0
1408580,True,0,No user reviews,0,0,0
1408590,True,0,No user reviews,0,0,0
1408630,True,0,3 user reviews,2,1,3
1408640,True,0,1 user reviews,1,0,1
1408650,True,0,No user reviews,0,0,0
1408670,True,0,No user reviews,0,0,0
1408690,True,0,No user reviews,0,0,0
1408700,True,0,1 user reviews,1,0,1
1408710,True,0,No user reviews,0,0,0
1408730,True,0,No user reviews,0,0,0
1408740,True,0,No user reviews,0,0,0
1408750,True,0,No user reviews,0,0,0
1408770,True,0,No user reviews,0,0,0
1408780,True,0,No user reviews,0,0,0
1408790,True,0,No user reviews,0,0,0
1408800,True,0,No user reviews,0,0,0
1408810,True,0,No user reviews,0,0,0
1408860,True,0,No user reviews,0,0,0
1408870,True,0,No user reviews,0,0,0
1408880,True,0,No user reviews,0,0,0
1408910,True,0,No user reviews,0,0,0
1408950,True,0,4 user reviews,4,0,4
1408960,True,0,1 user reviews,1,0,1
1408980,True,0,No user reviews,0,0,0
1408990,True,0,No user reviews,0,0,0
1409000,True,7,Positive,8,2,10
1409030,True,0,No user reviews,0,0,0
1409060,True,0,No user reviews,0,0,0
1409070,True,0,No user reviews,0,0,0
1409080,True,0,No user reviews,0,0,0
1409110,True,0,No user reviews,0,0,0
1409120,True,0,No user reviews,0,0,0
1409140,True,7,Positive,21,3,24
1409141,True,7,Positive,16,0,16
1409142,True,7,Positive,36,2,38
1409143,True,7,Positive,32,7,39
1409200,True,0,No user reviews,0,0,0
1409220,True,0,No user reviews,0,0,0
1409221,True,0,No user reviews,0,0,0
1409222,True,0,No user reviews,0,0,0
1409223,True,0,No user reviews,0,0,0
1409224,True,0,No user reviews,0,0,0
1409225,True,0,No user reviews,0,0,0
1409226,True,0,No user reviews,0,0,0
1409227,True,0,No user reviews,0,0,0
1409228,True,0,No user reviews,0,0,0
1409229,True,0,No user reviews,0,0,0
1409250,True,0,1 user reviews,1,0,1
1409260,True,0,No user reviews,0,0,0
1409270,True,0,No user reviews,0,0,0
1409280,True,0,No user reviews,0,0,0
1409300,True,0,No user reviews,0,0,0
1409310,True,0,1 user reviews,1,0,1
1409320,True,0,1 user reviews,1,0,1
1409330,True,0,1 user reviews,1,0,1
1409370,True,0,No user reviews,0,0,0
1409380,True,0,No user reviews,0,0,0
1409410,True,0,No user reviews,0,0,0
1409460,True,0,No user reviews,0,0,0
1409470,True,0,No user reviews,0,0,0
1409510,True,0,No user reviews,0,0,0
1409570,True,0,No user reviews,0,0,0
1409580,True,0,No user reviews,0,0,0
1409590,True,0,No user reviews,0,0,0
1409600,True,0,No user reviews,0,0,0
1409610,True,0,No user reviews,0,0,0
1409630,True,0,No user reviews,0,0,0
1409640,True,0,4 user reviews,4,0,4
1409670,True,0,No user reviews,0,0,0
1409680,True,0,2 user reviews,2,0,2
1409690,True,0,No user reviews,0,0,0
1409700,True,0,No user reviews,0,0,0
1409710,True,0,No user reviews,0,0,0
1409720,True,0,No user reviews,0,0,0
1409721,True,0,1 user reviews,1,0,1
1409730,True,7,Positive,15,3,18
1409740,True,7,Positive,12,3,15
1409750,True,0,No user reviews,0,0,0
1409760,True,0,No user reviews,0,0,0
1409790,True,0,No user reviews,0,0,0
1409830,True,0,No user reviews,0,0,0
1409840,True,0,No user reviews,0,0,0
1409850,True,0,No user reviews,0,0,0
1409860,True,0,No user reviews,0,0,0
1409910,True,0,No user reviews,0,0,0
1409920,True,0,No user reviews,0,0,0
1409930,True,0,1 user reviews,0,1,1
1410010,True,0,No user reviews,0,0,0
1410050,True,0,No user reviews,0,0,0
1410070,True,0,No user reviews,0,0,0
1410080,True,0,3 user reviews,2,1,3
1410090,True,0,No user reviews,0,0,0
1410110,True,0,No user reviews,0,0,0
1410130,True,0,No user reviews,0,0,0
1410140,True,0,No user reviews,0,0,0
1410160,True,0,No user reviews,0,0,0
1410170,True,0,No user reviews,0,0,0
1410190,True,0,No user reviews,0,0,0
1410200,True,0,No user reviews,0,0,0
1410210,True,0,1 user reviews,0,1,1
1410220,True,0,No user reviews,0,0,0
1410320,True,0,No user reviews,0,0,0
1410330,True,0,No user reviews,0,0,0
1410340,True,0,No user reviews,0,0,0
1410350,True,0,No user reviews,0,0,0
1410370,True,0,No user reviews,0,0,0
1410380,True,0,1 user reviews,1,0,1
1410430,True,0,No user reviews,0,0,0
1410490,True,0,No user reviews,0,0,0
1410500,True,0,1 user reviews,1,0,1
1410510,True,0,No user reviews,0,0,0
1410520,True,0,No user reviews,0,0,0
1410580,True,0,3 user reviews,2,1,3
1410590,True,0,No user reviews,0,0,0
1410600,True,0,No user reviews,0,0,0
1410620,True,0,No user reviews,0,0,0
1410650,True,0,No user reviews,0,0,0
1410680,True,0,No user reviews,0,0,0
1410690,True,0,No user reviews,0,0,0
1410700,True,0,No user reviews,0,0,0
1410710,True,8,Very Positive,218,50,268
1410760,True,0,No user reviews,0,0,0
1410780,True,0,No user reviews,0,0,0
1410790,True,0,1 user reviews,1,0,1
1410820,True,0,No user reviews,0,0,0
1410900,True,0,No user reviews,0,0,0
1410910,True,0,No user reviews,0,0,0
1410930,True,0,No user reviews,0,0,0
1410940,True,0,No user reviews,0,0,0
1410970,True,0,No user reviews,0,0,0
1410990,True,0,No user reviews,0,0,0
1411000,True,0,No user reviews,0,0,0
1411030,True,0,No user reviews,0,0,0
1411040,True,0,No user reviews,0,0,0
1411060,True,0,No user reviews,0,0,0
1411070,True,0,No user reviews,0,0,0
1411080,True,0,1 user reviews,1,0,1
1411090,True,0,No user reviews,0,0,0
1411100,True,0,No user reviews,0,0,0
1411110,True,0,No user reviews,0,0,0
1411120,True,0,No user reviews,0,0,0
1411140,True,0,No user reviews,0,0,0
1411150,True,0,No user reviews,0,0,0
1411160,True,0,No user reviews,0,0,0
1411170,True,0,2 user reviews,1,1,2
1411200,True,0,No user reviews,0,0,0
1411210,True,0,No user reviews,0,0,0
1411250,True,0,No user reviews,0,0,0
1411260,True,0,No user reviews,0,0,0
1411300,True,0,No user reviews,0,0,0
1411310,True,0,No user reviews,0,0,0
1411330,True,0,No user reviews,0,0,0
1411360,True,0,No user reviews,0,0,0
1411380,True,0,No user reviews,0,0,0
1411390,True,0,No user reviews,0,0,0
1411400,True,0,No user reviews,0,0,0
1411410,True,0,1 user reviews,1,0,1
1411420,True,0,2 user reviews,2,0,2
1411430,True,0,No user reviews,0,0,0
1411490,True,0,1 user reviews,0,1,1
1411510,True,0,No user reviews,0,0,0
1411520,True,0,No user reviews,0,0,0
1411530,True,0,No user reviews,0,0,0
1411540,True,0,No user reviews,0,0,0
1411550,True,0,No user reviews,0,0,0
1411600,True,0,No user reviews,0,0,0
1411610,True,0,No user reviews,0,0,0
1411620,True,0,No user reviews,0,0,0
1411630,True,0,No user reviews,0,0,0
1411660,True,0,No user reviews,0,0,0
1411670,True,0,No user reviews,0,0,0
1411680,True,0,No user reviews,0,0,0
1411690,True,0,No user reviews,0,0,0
1411710,True,0,No user reviews,0,0,0
1411750,True,0,No user reviews,0,0,0
1411760,True,0,No user reviews,0,0,0
1411770,True,0,No user reviews,0,0,0
1411790,True,0,No user reviews,0,0,0
1411800,True,0,No user reviews,0,0,0
1411840,True,0,1 user reviews,1,0,1
1411850,True,0,No user reviews,0,0,0
1411860,True,0,3 user reviews,2,1,3
1411870,True,0,No user reviews,0,0,0
1411880,True,0,1 user reviews,0,1,1
1411890,True,0,No user reviews,0,0,0
1411900,True,0,No user reviews,0,0,0
1411910,True,0,No user reviews,0,0,0
1411920,True,0,No user reviews,0,0,0
1411930,True,0,No user reviews,0,0,0
1411940,True,0,No user reviews,0,0,0
1411960,True,0,No user reviews,0,0,0
1412000,True,0,4 user reviews,1,3,4
1412040,True,0,5 user reviews,4,1,5
1412050,True,0,No user reviews,0,0,0
1412060,True,0,No user reviews,0,0,0
1412080,True,0,No user reviews,0,0,0
1412090,True,0,No user reviews,0,0,0
1412120,True,0,No user reviews,0,0,0
1412140,True,0,No user reviews,0,0,0
1412170,True,0,No user reviews,0,0,0
1412180,True,0,No user reviews,0,0,0
1412190,True,0,No user reviews,0,0,0
1412200,True,0,No user reviews,0,0,0
1412220,True,0,No user reviews,0,0,0
1412230,True,0,No user reviews,0,0,0
1412240,True,0,No user reviews,0,0,0
1412250,True,0,No user reviews,0,0,0
1412280,True,0,No user reviews,0,0,0
1412281,True,0,No user reviews,0,0,0
1412282,True,0,No user reviews,0,0,0
1412283,True,0,No user reviews,0,0,0
1412300,True,0,1 user reviews,1,0,1
1412310,True,0,No user reviews,0,0,0
1412320,True,0,No user reviews,0,0,0
1412330,True,0,No user reviews,0,0,0
1412350,True,0,No user reviews,0,0,0
1412370,True,0,No user reviews,0,0,0
1412380,True,0,No user reviews,0,0,0
1412420,True,0,No user reviews,0,0,0
1412430,True,0,No user reviews,0,0,0
1412440,True,0,No user reviews,0,0,0
1412450,True,0,2 user reviews,2,0,2
1412470,True,0,No user reviews,0,0,0
1412490,True,0,No user reviews,0,0,0
1412500,True,0,No user reviews,0,0,0
1412510,True,0,No user reviews,0,0,0
1412520,True,0,4 user reviews,4,0,4
1412530,True,0,9 user reviews,7,2,9
1412540,True,0,No user reviews,0,0,0
1412560,True,0,No user reviews,0,0,0
1412590,True,0,No user reviews,0,0,0
1412610,True,0,2 user reviews,2,0,2
1412630,True,0,2 user reviews,2,0,2
1412640,True,0,No user reviews,0,0,0
1412660,True,0,9 user reviews,9,0,9
1412680,True,0,No user reviews,0,0,0
1412690,True,0,1 user reviews,1,0,1
1412700,True,0,No user reviews,0,0,0
1412710,True,0,No user reviews,0,0,0
1412730,True,0,No user reviews,0,0,0
1412750,True,0,No user reviews,0,0,0
1412760,True,0,No user reviews,0,0,0
1412780,True,6,Mostly Positive,60,16,76
1412790,True,0,No user reviews,0,0,0
1412800,True,0,No user reviews,0,0,0
1412830,True,0,No user reviews,0,0,0
1412850,True,0,No user reviews,0,0,0
1412870,True,0,No user reviews,0,0,0
1412880,True,0,No user reviews,0,0,0
1412900,True,0,1 user reviews,1,0,1
1412920,True,0,No user reviews,0,0,0
1412930,True,0,No user reviews,0,0,0
1412940,True,0,No user reviews,0,0,0
1412980,True,0,4 user reviews,4,0,4
1413010,True,0,7 user reviews,5,2,7
1413020,True,7,Positive,20,2,22
1413060,True,0,No user reviews,0,0,0
1413070,True,0,9 user reviews,6,3,9
1413080,True,0,No user reviews,0,0,0
1413130,True,0,No user reviews,0,0,0
1413170,True,0,1 user reviews,1,0,1
1413210,True,0,3 user reviews,3,0,3
1413230,True,0,1 user reviews,1,0,1
1413240,True,0,2 user reviews,2,0,2
1413250,True,0,No user reviews,0,0,0
1413260,True,0,No user reviews,0,0,0
1413280,True,0,No user reviews,0,0,0
1413300,True,0,2 user reviews,2,0,2
1413310,True,0,No user reviews,0,0,0
1413340,True,0,No user reviews,0,0,0
1413350,True,0,1 user reviews,1,0,1
1413370,True,0,No user reviews,0,0,0
1413410,True,0,No user reviews,0,0,0
1413440,True,0,No user reviews,0,0,0
1413450,True,7,Positive,19,3,22
1413470,True,0,No user reviews,0,0,0
1413490,True,0,No user reviews,0,0,0
1413500,True,0,1 user reviews,1,0,1
1413510,True,0,No user reviews,0,0,0
1413520,True,0,1 user reviews,1,0,1
1413530,True,0,No user reviews,0,0,0
1413540,True,0,No user reviews,0,0,0
1413550,True,0,No user reviews,0,0,0
1413560,True,0,1 user reviews,1,0,1
1413580,True,0,No user reviews,0,0,0
1413590,True,0,No user reviews,0,0,0
1413620,True,0,No user reviews,0,0,0
1413630,True,0,2 user reviews,2,0,2
1413640,True,0,No user reviews,0,0,0
1413650,True,0,No user reviews,0,0,0
1413660,True,0,No user reviews,0,0,0
1413670,True,0,No user reviews,0,0,0
1413690,True,0,No user reviews,0,0,0
1413700,True,0,No user reviews,0,0,0
1413750,True,0,No user reviews,0,0,0
1413780,True,0,No user reviews,0,0,0
1413790,True,0,6 user reviews,5,1,6
1413800,True,0,1 user reviews,1,0,1
1413810,True,0,No user reviews,0,0,0
1413820,True,0,No user reviews,0,0,0
1413880,True,0,No user reviews,0,0,0
1413890,True,0,1 user reviews,0,1,1
1413900,True,0,No user reviews,0,0,0
1413920,True,0,No user reviews,0,0,0
1413930,True,0,No user reviews,0,0,0
1414020,True,0,No user reviews,0,0,0
1414050,True,5,Mixed,6,5,11
1414060,True,0,1 user reviews,1,0,1
1414070,True,0,No user reviews,0,0,0
1414080,True,0,No user reviews,0,0,0
1414090,True,0,No user reviews,0,0,0
1414100,True,0,No user reviews,0,0,0
1414130,True,0,No user reviews,0,0,0
1414131,True,0,No user reviews,0,0,0
1414170,True,0,No user reviews,0,0,0
1414180,True,0,No user reviews,0,0,0
1414190,True,0,No user reviews,0,0,0
1414200,True,0,No user reviews,0,0,0
1414210,True,0,No user reviews,0,0,0
1414220,True,0,No user reviews,0,0,0
1414240,True,0,No user reviews,0,0,0
1414270,True,0,No user reviews,0,0,0
1414280,True,0,No user reviews,0,0,0
1414290,True,0,No user reviews,0,0,0
1414300,True,0,No user reviews,0,0,0
1414320,True,0,No user reviews,0,0,0
1414330,True,0,No user reviews,0,0,0
1414340,True,0,No user reviews,0,0,0
1414370,True,0,No user reviews,0,0,0
1414380,True,0,No user reviews,0,0,0
1414450,True,0,No user reviews,0,0,0
1414460,True,0,No user reviews,0,0,0
1414470,True,0,No user reviews,0,0,0
1414480,True,0,1 user reviews,1,0,1
1414490,True,0,No user reviews,0,0,0
1414500,True,0,1 user reviews,0,1,1
1414540,True,0,No user reviews,0,0,0
1414570,True,0,No user reviews,0,0,0
1414590,True,0,No user reviews,0,0,0
1414600,True,0,No user reviews,0,0,0
1414640,True,0,No user reviews,0,0,0
1414680,True,0,1 user reviews,1,0,1
1414690,True,0,1 user reviews,1,0,1
1414700,True,0,No user reviews,0,0,0
1414710,True,0,No user reviews,0,0,0
1414720,True,0,4 user reviews,4,0,4
1414770,True,0,No user reviews,0,0,0
1414790,True,0,No user reviews,0,0,0
1414800,True,0,No user reviews,0,0,0
1414810,True,0,No user reviews,0,0,0
1414820,True,0,2 user reviews,1,1,2
1414840,True,0,3 user reviews,3,0,3
1414860,True,0,No user reviews,0,0,0
1414870,True,0,No user reviews,0,0,0
1414900,True,0,No user reviews,0,0,0
1414910,True,0,No user reviews,0,0,0
1414920,True,0,No user reviews,0,0,0
1414930,True,0,No user reviews,0,0,0
1414990,True,0,4 user reviews,4,0,4
1415010,True,0,No user reviews,0,0,0
1415020,True,0,No user reviews,0,0,0
1415030,True,0,No user reviews,0,0,0
1415040,True,0,No user reviews,0,0,0
1415060,True,0,No user reviews,0,0,0
1415110,True,0,1 user reviews,1,0,1
1415140,True,0,7 user reviews,6,1,7
1415200,True,0,No user reviews,0,0,0
1415250,True,0,7 user reviews,7,0,7
1415270,True,0,No user reviews,0,0,0
1415280,True,0,No user reviews,0,0,0
1415290,True,0,No user reviews,0,0,0
1415300,True,0,No user reviews,0,0,0
1415320,True,0,No user reviews,0,0,0
1415330,True,0,No user reviews,0,0,0
1415340,True,0,No user reviews,0,0,0
1415370,True,0,3 user reviews,2,1,3
1415410,True,0,No user reviews,0,0,0
1415420,True,0,3 user reviews,3,0,3
1415470,True,0,No user reviews,0,0,0
1415480,True,0,2 user reviews,1,1,2
1415490,True,0,No user reviews,0,0,0
1415500,True,0,No user reviews,0,0,0
1415510,True,7,Positive,10,0,10
1415530,True,0,3 user reviews,0,3,3
1415550,True,0,No user reviews,0,0,0
1415590,True,0,No user reviews,0,0,0
1415600,True,0,No user reviews,0,0,0
1415610,True,0,No user reviews,0,0,0
1415620,True,0,No user reviews,0,0,0
1415630,True,0,2 user reviews,2,0,2
1415640,True,0,No user reviews,0,0,0
1415660,True,0,No user reviews,0,0,0
1415670,True,0,No user reviews,0,0,0
1415691,True,7,Positive,45,4,49
1415700,True,7,Positive,16,0,16
1415750,True,0,4 user reviews,4,0,4
1415830,True,0,2 user reviews,1,1,2
1415870,True,0,No user reviews,0,0,0
1415900,True,0,No user reviews,0,0,0
1415940,True,0,No user reviews,0,0,0
1415950,True,0,No user reviews,0,0,0
1415970,True,0,No user reviews,0,0,0
1416000,True,0,6 user reviews,6,0,6
1416010,True,0,No user reviews,0,0,0
1416020,True,0,No user reviews,0,0,0
1416090,True,0,1 user reviews,1,0,1
1416120,True,0,No user reviews,0,0,0
1416130,True,0,No user reviews,0,0,0
1416150,True,0,No user reviews,0,0,0
1416160,True,0,No user reviews,0,0,0
1416170,True,0,No user reviews,0,0,0
1416180,True,0,No user reviews,0,0,0
1416190,True,0,No user reviews,0,0,0
1416200,True,0,No user reviews,0,0,0
1416210,True,0,1 user reviews,1,0,1
1416220,True,0,No user reviews,0,0,0
1416230,True,7,Positive,14,1,15
1416240,True,0,No user reviews,0,0,0
1416250,True,0,No user reviews,0,0,0
1416290,True,0,No user reviews,0,0,0
1416300,True,0,No user reviews,0,0,0
1416310,True,0,No user reviews,0,0,0
1416320,True,0,No user reviews,0,0,0
1416340,True,0,No user reviews,0,0,0
1416350,True,0,No user reviews,0,0,0
1416360,True,0,No user reviews,0,0,0
1416370,True,0,No user reviews,0,0,0
1416430,True,0,1 user reviews,1,0,1
1416450,True,0,3 user reviews,2,1,3
1416460,True,0,No user reviews,0,0,0
1416480,True,0,No user reviews,0,0,0
1416520,True,0,No user reviews,0,0,0
1416560,True,0,No user reviews,0,0,0
1416590,True,0,No user reviews,0,0,0
1416600,True,0,No user reviews,0,0,0
1416620,True,0,No user reviews,0,0,0
1416630,True,0,No user reviews,0,0,0
1416640,True,0,No user reviews,0,0,0
1416660,True,0,No user reviews,0,0,0
1416690,True,0,3 user reviews,3,0,3
1416700,True,0,No user reviews,0,0,0
1416710,True,0,1 user reviews,0,1,1
1416720,True,0,No user reviews,0,0,0
1416730,True,0,No user reviews,0,0,0
1416740,True,0,No user reviews,0,0,0
1416760,True,0,No user reviews,0,0,0
1416770,True,0,No user reviews,0,0,0
1416790,True,0,No user reviews,0,0,0
1416820,True,0,No user reviews,0,0,0
1416840,True,0,No user reviews,0,0,0
1416850,True,0,1 user reviews,1,0,1
1416880,True,0,No user reviews,0,0,0
1416900,True,0,No user reviews,0,0,0
1416930,True,0,No user reviews,0,0,0
1416960,True,0,No user reviews,0,0,0
1416980,True,0,No user reviews,0,0,0
1416990,True,0,No user reviews,0,0,0
1417010,True,0,No user reviews,0,0,0
1417090,True,0,No user reviews,0,0,0
1417100,True,0,No user reviews,0,0,0
1417170,True,0,No user reviews,0,0,0
1417190,True,0,No user reviews,0,0,0
1417230,True,0,1 user reviews,1,0,1
1417250,True,0,1 user reviews,0,1,1
1417260,True,7,Positive,23,0,23
1417270,True,0,1 user reviews,1,0,1
1417280,True,0,No user reviews,0,0,0
1417290,True,0,No user reviews,0,0,0
1417310,True,0,No user reviews,0,0,0
1417340,True,0,1 user reviews,1,0,1
1417360,True,0,No user reviews,0,0,0
1417410,True,0,No user reviews,0,0,0
1417420,True,0,4 user reviews,3,1,4
1417430,True,0,No user reviews,0,0,0
1417440,True,0,No user reviews,0,0,0
1417450,True,0,No user reviews,0,0,0
1417460,True,0,No user reviews,0,0,0
1417470,True,0,No user reviews,0,0,0
1417480,True,0,No user reviews,0,0,0
1417490,True,0,No user reviews,0,0,0
1417500,True,6,Mostly Positive,12,4,16
1417510,True,0,No user reviews,0,0,0
1417530,True,0,No user reviews,0,0,0
1417540,True,0,8 user reviews,8,0,8
1417560,True,0,No user reviews,0,0,0
1417580,True,0,1 user reviews,1,0,1
1417590,True,0,No user reviews,0,0,0
1417600,True,7,Positive,16,4,20
1417610,True,0,4 user reviews,3,1,4
1417630,True,0,No user reviews,0,0,0
1417640,True,0,1 user reviews,1,0,1
1417650,True,0,No user reviews,0,0,0
1417670,True,0,7 user reviews,6,1,7
1417680,True,0,1 user reviews,0,1,1
1417690,True,0,No user reviews,0,0,0
1417710,True,0,No user reviews,0,0,0
1417720,True,7,Positive,16,0,16
1417740,True,0,No user reviews,0,0,0
1417770,True,0,1 user reviews,1,0,1
1417800,True,0,No user reviews,0,0,0
1417840,True,0,No user reviews,0,0,0
1417850,True,0,No user reviews,0,0,0
1417880,True,0,No user reviews,0,0,0
1417920,True,0,No user reviews,0,0,0
1417940,True,0,No user reviews,0,0,0
1417960,True,0,No user reviews,0,0,0
1417980,True,0,No user reviews,0,0,0
1418000,True,0,No user reviews,0,0,0
1418010,True,0,4 user reviews,4,0,4
1418070,True,0,No user reviews,0,0,0
1418080,True,0,No user reviews,0,0,0
1418090,True,0,4 user reviews,4,0,4
1418120,True,0,No user reviews,0,0,0
1418130,True,0,No user reviews,0,0,0
1418140,True,0,No user reviews,0,0,0
1418150,True,0,No user reviews,0,0,0
1418160,True,0,No user reviews,0,0,0
1418170,True,0,4 user reviews,2,2,4
1418200,True,0,No user reviews,0,0,0
1418240,True,0,No user reviews,0,0,0
1418260,True,0,No user reviews,0,0,0
1418290,True,0,No user reviews,0,0,0
1418300,True,0,1 user reviews,1,0,1
1418310,True,7,Positive,10,1,11
1418320,True,0,No user reviews,0,0,0
1418330,True,0,1 user reviews,1,0,1
1418350,True,0,No user reviews,0,0,0
1418360,True,0,No user reviews,0,0,0
1418370,True,0,No user reviews,0,0,0
1418380,True,0,No user reviews,0,0,0
1418400,True,0,1 user reviews,1,0,1
1418410,True,0,No user reviews,0,0,0
1418420,True,0,No user reviews,0,0,0
1418430,True,0,No user reviews,0,0,0
1418440,True,0,No user reviews,0,0,0
1418460,True,0,4 user reviews,4,0,4
1418480,True,0,No user reviews,0,0,0
1418490,True,0,1 user reviews,1,0,1
1418500,True,0,No user reviews,0,0,0
1418520,True,0,No user reviews,0,0,0
1418530,True,0,No user reviews,0,0,0
1418550,True,0,No user reviews,0,0,0
1418560,True,0,No user reviews,0,0,0
1418570,True,7,Positive,10,0,10
1418600,True,0,No user reviews,0,0,0
1418610,True,0,No user reviews,0,0,0
1418640,True,0,No user reviews,0,0,0
1418650,True,0,No user reviews,0,0,0
1418660,True,0,No user reviews,0,0,0
1418670,True,0,No user reviews,0,0,0
1418680,True,0,3 user reviews,3,0,3
1418720,True,7,Positive,16,1,17
1418770,True,0,No user reviews,0,0,0
1418790,True,0,No user reviews,0,0,0
1418800,True,0,No user reviews,0,0,0
1418820,True,0,No user reviews,0,0,0
1418860,True,0,2 user reviews,2,0,2
1418910,True,0,No user reviews,0,0,0
1418920,True,0,No user reviews,0,0,0
1418930,True,0,No user reviews,0,0,0
1418940,True,0,No user reviews,0,0,0
1418950,True,0,No user reviews,0,0,0
1418980,True,7,Positive,16,0,16
1419010,True,0,No user reviews,0,0,0
1419060,True,0,No user reviews,0,0,0
1419070,True,0,No user reviews,0,0,0
1419080,True,0,No user reviews,0,0,0
1419090,True,0,No user reviews,0,0,0
1419100,True,0,No user reviews,0,0,0
1419110,True,0,1 user reviews,1,0,1
1419120,True,0,No user reviews,0,0,0
1419121,True,0,No user reviews,0,0,0
1419122,True,0,No user reviews,0,0,0
1419140,True,0,No user reviews,0,0,0
1419150,True,0,No user reviews,0,0,0
1419190,True,0,3 user reviews,2,1,3
1419200,True,0,1 user reviews,0,1,1
1419210,True,0,No user reviews,0,0,0
1419220,True,0,No user reviews,0,0,0
1419240,True,0,No user reviews,0,0,0
1419250,True,0,No user reviews,0,0,0
1419270,True,0,No user reviews,0,0,0
1419310,True,0,No user reviews,0,0,0
1419320,True,0,No user reviews,0,0,0
1419370,True,0,1 user reviews,1,0,1
1419380,True,0,No user reviews,0,0,0
1419400,True,0,No user reviews,0,0,0
1419420,True,0,No user reviews,0,0,0
1419430,True,0,No user reviews,0,0,0
1419440,True,0,No user reviews,0,0,0
1419480,True,0,3 user reviews,3,0,3
1419490,True,0,No user reviews,0,0,0
1419540,True,0,No user reviews,0,0,0
1419580,True,0,No user reviews,0,0,0
1419670,True,0,No user reviews,0,0,0
1419710,True,0,No user reviews,0,0,0
1419720,True,0,No user reviews,0,0,0
1419730,True,7,Positive,23,3,26
1419740,True,0,No user reviews,0,0,0
1419770,True,0,No user reviews,0,0,0
1419790,True,0,No user reviews,0,0,0
1419810,True,0,No user reviews,0,0,0
1419820,True,0,No user reviews,0,0,0
1419830,True,0,No user reviews,0,0,0
1419840,True,0,No user reviews,0,0,0
1419870,True,0,No user reviews,0,0,0
1419880,True,0,No user reviews,0,0,0
1419900,True,0,1 user reviews,0,1,1
1419940,True,0,No user reviews,0,0,0
1419950,True,0,No user reviews,0,0,0
1419960,True,0,No user reviews,0,0,0
1420030,True,0,No user reviews,0,0,0
1420050,True,0,No user reviews,0,0,0
1420060,True,0,No user reviews,0,0,0
1420070,True,0,No user reviews,0,0,0
1420071,True,0,No user reviews,0,0,0
1420100,True,0,No user reviews,0,0,0
1420110,True,0,No user reviews,0,0,0
1420140,True,0,No user reviews,0,0,0
1420160,True,0,No user reviews,0,0,0
1420250,True,0,No user reviews,0,0,0
1420320,True,0,No user reviews,0,0,0
1420330,True,0,2 user reviews,2,0,2
1420360,True,0,No user reviews,0,0,0
1420370,True,0,No user reviews,0,0,0
1420380,True,0,No user reviews,0,0,0
1420390,True,0,1 user reviews,1,0,1
1420410,True,0,No user reviews,0,0,0
1420420,True,0,No user reviews,0,0,0
1420470,True,0,No user reviews,0,0,0
1420471,True,0,No user reviews,0,0,0
1420490,True,0,No user reviews,0,0,0
1420510,True,0,No user reviews,0,0,0
1420520,True,0,No user reviews,0,0,0
1420540,True,0,No user reviews,0,0,0
1420580,True,0,No user reviews,0,0,0
1420620,True,0,No user reviews,0,0,0
1420630,True,0,No user reviews,0,0,0
1420640,True,0,No user reviews,0,0,0
1420670,True,0,No user reviews,0,0,0
1420690,True,0,1 user reviews,1,0,1
1420710,True,0,No user reviews,0,0,0
1420720,True,0,No user reviews,0,0,0
1420730,True,0,No user reviews,0,0,0
1420740,True,7,Positive,21,4,25
1420830,True,7,Positive,32,1,33
1420850,True,0,No user reviews,0,0,0
1420860,True,0,No user reviews,0,0,0
1420870,True,0,No user reviews,0,0,0
1420880,True,0,No user reviews,0,0,0
1420890,True,0,1 user reviews,0,1,1
1420930,True,0,No user reviews,0,0,0
1420940,True,0,No user reviews,0,0,0
1420950,True,0,4 user reviews,4,0,4
1420960,True,0,1 user reviews,1,0,1
1420970,True,0,No user reviews,0,0,0
1420980,True,0,No user reviews,0,0,0
1420990,True,0,No user reviews,0,0,0
1421010,True,0,No user reviews,0,0,0
1421020,True,0,3 user reviews,3,0,3
1421040,True,0,No user reviews,0,0,0
1421050,True,0,No user reviews,0,0,0
1421060,True,0,No user reviews,0,0,0
1421070,True,0,No user reviews,0,0,0
1421090,True,0,No user reviews,0,0,0
1421100,True,0,No user reviews,0,0,0
1421110,True,0,No user reviews,0,0,0
1421120,True,0,1 user reviews,1,0,1
1421130,True,0,No user reviews,0,0,0
1421150,True,0,No user reviews,0,0,0
1421160,True,0,No user reviews,0,0,0
1421190,True,0,No user reviews,0,0,0
1421230,True,0,No user reviews,0,0,0
1421280,True,0,No user reviews,0,0,0
1421310,True,0,1 user reviews,0,1,1
1421320,True,0,1 user reviews,1,0,1
1421370,True,0,No user reviews,0,0,0
1421420,True,0,No user reviews,0,0,0
1421460,True,0,No user reviews,0,0,0
1421480,True,0,7 user reviews,7,0,7
1421500,True,0,No user reviews,0,0,0
1421560,True,0,No user reviews,0,0,0
1421580,True,0,1 user reviews,1,0,1
1421630,True,0,No user reviews,0,0,0
1421640,True,0,No user reviews,0,0,0
1421650,True,0,No user reviews,0,0,0
1421651,True,0,No user reviews,0,0,0
1421652,True,0,No user reviews,0,0,0
1421653,True,0,No user reviews,0,0,0
1421680,True,0,No user reviews,0,0,0
1421690,True,0,No user reviews,0,0,0
1421760,True,0,No user reviews,0,0,0
1421770,True,0,No user reviews,0,0,0
1421780,True,0,No user reviews,0,0,0
1421781,True,0,No user reviews,0,0,0
1421782,True,0,No user reviews,0,0,0
1421783,True,0,No user reviews,0,0,0
1421784,True,0,No user reviews,0,0,0
1421785,True,0,No user reviews,0,0,0
1421786,True,0,No user reviews,0,0,0
1421787,True,0,No user reviews,0,0,0
1421788,True,0,No user reviews,0,0,0
1421790,True,0,No user reviews,0,0,0
1421800,True,0,No user reviews,0,0,0
1421801,True,0,No user reviews,0,0,0
1421802,True,0,No user reviews,0,0,0
1421803,True,0,No user reviews,0,0,0
1421804,True,0,No user reviews,0,0,0
1421805,True,0,No user reviews,0,0,0
1421806,True,0,No user reviews,0,0,0
1421807,True,0,No user reviews,0,0,0
1421808,True,0,No user reviews,0,0,0
1421809,True,0,No user reviews,0,0,0
1421810,True,0,No user reviews,0,0,0
1421811,True,0,No user reviews,0,0,0
1421812,True,0,No user reviews,0,0,0
1421813,True,0,No user reviews,0,0,0
1421814,True,0,No user reviews,0,0,0
1421830,True,0,No user reviews,0,0,0
1421831,True,0,No user reviews,0,0,0
1421832,True,0,No user reviews,0,0,0
1421833,True,0,No user reviews,0,0,0
1421834,True,0,No user reviews,0,0,0
1421835,True,0,No user reviews,0,0,0
1421836,True,0,No user reviews,0,0,0
1421837,True,0,No user reviews,0,0,0
1421838,True,0,No user reviews,0,0,0
1421839,True,0,No user reviews,0,0,0
1421840,True,0,No user reviews,0,0,0
1421841,True,0,No user reviews,0,0,0
1421842,True,0,No user reviews,0,0,0
1421843,True,0,No user reviews,0,0,0
1421844,True,0,No user reviews,0,0,0
1421845,True,0,No user reviews,0,0,0
1421846,True,0,No user reviews,0,0,0
1421847,True,0,No user reviews,0,0,0
1421848,True,0,No user reviews,0,0,0
1421849,True,0,No user reviews,0,0,0
1421850,True,0,No user reviews,0,0,0
1421851,True,0,No user reviews,0,0,0
1421852,True,0,No user reviews,0,0,0
1421853,True,0,No user reviews,0,0,0
1421854,True,0,No user reviews,0,0,0
1421855,True,0,No user reviews,0,0,0
1421856,True,0,No user reviews,0,0,0
1421857,True,0,No user reviews,0,0,0
1421858,True,0,No user reviews,0,0,0
1421859,True,0,No user reviews,0,0,0
1421860,True,0,No user reviews,0,0,0
1421861,True,0,No user reviews,0,0,0
1421862,True,0,No user reviews,0,0,0
1421863,True,0,No user reviews,0,0,0
1421864,True,0,No user reviews,0,0,0
1421865,True,0,No user reviews,0,0,0
1421866,True,0,No user reviews,0,0,0
1421867,True,0,No user reviews,0,0,0
1421868,True,0,No user reviews,0,0,0
1421870,True,0,No user reviews,0,0,0
1421871,True,0,No user reviews,0,0,0
1421872,True,0,No user reviews,0,0,0
1421873,True,0,No user reviews,0,0,0
1421874,True,0,No user reviews,0,0,0
1421875,True,0,No user reviews,0,0,0
1421876,True,0,No user reviews,0,0,0
1421877,True,0,No user reviews,0,0,0
1421878,True,0,No user reviews,0,0,0
1421880,True,0,No user reviews,0,0,0
1421881,True,0,No user reviews,0,0,0
1421882,True,0,No user reviews,0,0,0
1421883,True,0,No user reviews,0,0,0
1421884,True,0,No user reviews,0,0,0
1421885,True,0,No user reviews,0,0,0
1421886,True,0,No user reviews,0,0,0
1421887,True,0,No user reviews,0,0,0
1421888,True,0,No user reviews,0,0,0
1421890,True,0,No user reviews,0,0,0
1421891,True,0,No user reviews,0,0,0
1421892,True,0,No user reviews,0,0,0
1421893,True,0,No user reviews,0,0,0
1421894,True,0,No user reviews,0,0,0
1421895,True,0,No user reviews,0,0,0
1421896,True,0,No user reviews,0,0,0
1421897,True,0,No user reviews,0,0,0
1421898,True,0,No user reviews,0,0,0
1421910,True,0,No user reviews,0,0,0
1421911,True,0,No user reviews,0,0,0
1421912,True,0,No user reviews,0,0,0
1421913,True,0,No user reviews,0,0,0
1421914,True,0,No user reviews,0,0,0
1421915,True,0,No user reviews,0,0,0
1421950,True,0,No user reviews,0,0,0
1421960,True,0,No user reviews,0,0,0
1421990,True,0,No user reviews,0,0,0
1422020,True,0,No user reviews,0,0,0
1422030,True,0,No user reviews,0,0,0
1422050,True,0,No user reviews,0,0,0
1422060,True,0,No user reviews,0,0,0
1422070,True,0,No user reviews,0,0,0
1422080,True,0,2 user reviews,1,1,2
1422090,True,0,4 user reviews,4,0,4
1422130,True,0,No user reviews,0,0,0
1422140,True,0,No user reviews,0,0,0
1422150,True,0,No user reviews,0,0,0
1422170,True,0,No user reviews,0,0,0
1422190,True,0,No user reviews,0,0,0
1422200,True,0,4 user reviews,4,0,4
1422210,True,7,Positive,12,0,12
1422240,True,0,3 user reviews,3,0,3
1422250,True,0,No user reviews,0,0,0
1422260,True,0,No user reviews,0,0,0
1422300,True,0,No user reviews,0,0,0
1422310,True,0,No user reviews,0,0,0
1422320,True,0,No user reviews,0,0,0
1422350,True,0,No user reviews,0,0,0
1422360,True,0,No user reviews,0,0,0
1422380,True,0,No user reviews,0,0,0
1422470,True,0,No user reviews,0,0,0
1422520,True,0,No user reviews,0,0,0
1422530,True,0,No user reviews,0,0,0
1422540,True,0,No user reviews,0,0,0
1422550,True,0,No user reviews,0,0,0
1422580,True,0,No user reviews,0,0,0
1422600,True,0,No user reviews,0,0,0
1422610,True,0,No user reviews,0,0,0
1422620,True,0,No user reviews,0,0,0
1422630,True,0,No user reviews,0,0,0
1422670,True,0,No user reviews,0,0,0
1422680,True,0,1 user reviews,1,0,1
1422720,True,0,No user reviews,0,0,0
1422740,True,0,1 user reviews,1,0,1
1422750,True,7,Positive,16,3,19
1422780,True,0,No user reviews,0,0,0
1422790,True,0,No user reviews,0,0,0
1422800,True,0,No user reviews,0,0,0
1422810,True,0,2 user reviews,1,1,2
1422820,True,0,No user reviews,0,0,0
1422830,True,0,No user reviews,0,0,0
1422870,True,0,No user reviews,0,0,0
1422880,True,0,No user reviews,0,0,0
1422890,True,0,No user reviews,0,0,0
1422900,True,0,No user reviews,0,0,0
1422910,True,0,No user reviews,0,0,0
1422920,True,0,No user reviews,0,0,0
1422950,True,0,No user reviews,0,0,0
1423040,True,0,No user reviews,0,0,0
1423060,True,0,No user reviews,0,0,0
1423070,True,0,No user reviews,0,0,0
1423090,True,0,No user reviews,0,0,0
1423130,True,0,No user reviews,0,0,0
1423140,True,0,No user reviews,0,0,0
1423180,True,0,No user reviews,0,0,0
1423200,True,0,2 user reviews,1,1,2
1423210,True,0,No user reviews,0,0,0
1423240,True,0,No user reviews,0,0,0
1423241,True,0,No user reviews,0,0,0
1423242,True,0,No user reviews,0,0,0
1423243,True,0,No user reviews,0,0,0
1423244,True,0,No user reviews,0,0,0
1423245,True,0,No user reviews,0,0,0
1423246,True,0,No user reviews,0,0,0
1423247,True,0,No user reviews,0,0,0
1423248,True,0,No user reviews,0,0,0
1423249,True,0,No user reviews,0,0,0
1423250,True,0,No user reviews,0,0,0
1423251,True,0,No user reviews,0,0,0
1423260,True,0,No user reviews,0,0,0
1423270,True,0,No user reviews,0,0,0
1423320,True,0,No user reviews,0,0,0
1423360,True,0,1 user reviews,1,0,1
1423370,True,0,No user reviews,0,0,0
1423390,True,0,No user reviews,0,0,0
1423400,True,0,No user reviews,0,0,0
1423410,True,0,No user reviews,0,0,0
1423420,True,0,No user reviews,0,0,0
1423440,True,0,1 user reviews,1,0,1
1423460,True,0,No user reviews,0,0,0
1423480,True,0,No user reviews,0,0,0
1423490,True,0,No user reviews,0,0,0
1423500,True,0,1 user reviews,0,1,1
1423510,True,0,No user reviews,0,0,0
1423520,True,0,No user reviews,0,0,0
1423530,True,0,No user reviews,0,0,0
1423540,True,0,1 user reviews,1,0,1
1423580,True,0,No user reviews,0,0,0
1423590,True,0,No user reviews,0,0,0
1423610,True,0,1 user reviews,0,1,1
1423620,True,0,No user reviews,0,0,0
1423640,True,0,No user reviews,0,0,0
1423650,True,0,No user reviews,0,0,0
1423680,True,0,1 user reviews,1,0,1
1423700,True,0,No user reviews,0,0,0
1423710,True,0,No user reviews,0,0,0
1423720,True,0,No user reviews,0,0,0
1423750,True,0,No user reviews,0,0,0
1423760,True,0,No user reviews,0,0,0
1423770,True,0,No user reviews,0,0,0
1423780,True,0,1 user reviews,1,0,1
1423790,True,0,No user reviews,0,0,0
1423800,True,0,No user reviews,0,0,0
1423820,True,0,No user reviews,0,0,0
1423830,True,0,1 user reviews,1,0,1
1423840,True,0,No user reviews,0,0,0
1423850,True,0,No user reviews,0,0,0
1423880,True,0,No user reviews,0,0,0
1423900,True,0,8 user reviews,7,1,8
1423970,True,0,No user reviews,0,0,0
1423980,True,0,No user reviews,0,0,0
1424000,True,0,No user reviews,0,0,0
1424010,True,0,No user reviews,0,0,0
1424020,True,0,1 user reviews,1,0,1
1424050,True,0,No user reviews,0,0,0
1424060,True,0,No user reviews,0,0,0
1424070,True,0,No user reviews,0,0,0
1424080,True,0,No user reviews,0,0,0
1424090,True,0,No user reviews,0,0,0
1424120,True,0,1 user reviews,1,0,1
1424140,True,0,No user reviews,0,0,0
1424160,True,0,No user reviews,0,0,0
1424230,True,0,No user reviews,0,0,0
1424240,True,0,No user reviews,0,0,0
1424260,True,0,No user reviews,0,0,0
1424270,True,0,2 user reviews,2,0,2
1424280,True,0,No user reviews,0,0,0
1424290,True,0,No user reviews,0,0,0
1424300,True,0,No user reviews,0,0,0
1424310,True,0,1 user reviews,0,1,1
1424350,True,0,9 user reviews,9,0,9
1424360,True,0,No user reviews,0,0,0
1424380,True,0,2 user reviews,2,0,2
1424390,True,0,No user reviews,0,0,0
1424400,True,0,No user reviews,0,0,0
1424410,True,0,No user reviews,0,0,0
1424420,True,0,No user reviews,0,0,0
1424460,True,0,No user reviews,0,0,0
1424490,True,0,No user reviews,0,0,0
1424500,True,0,3 user reviews,3,0,3
1424520,True,0,No user reviews,0,0,0
1424570,True,0,No user reviews,0,0,0
1424580,True,0,No user reviews,0,0,0
1424590,True,0,No user reviews,0,0,0
1424600,True,0,No user reviews,0,0,0
1424610,True,0,No user reviews,0,0,0
1424630,True,0,5 user reviews,5,0,5
1424640,True,0,No user reviews,0,0,0
1424650,True,0,No user reviews,0,0,0
1424670,True,0,No user reviews,0,0,0
1424700,True,0,1 user reviews,0,1,1
1424710,True,0,No user reviews,0,0,0
1424760,True,0,No user reviews,0,0,0
1424770,True,0,9 user reviews,7,2,9
1424780,True,0,No user reviews,0,0,0
1424790,True,0,No user reviews,0,0,0
1424810,True,0,No user reviews,0,0,0
1424830,True,0,1 user reviews,1,0,1
1424850,True,0,No user reviews,0,0,0
1424880,True,0,No user reviews,0,0,0
1424890,True,0,No user reviews,0,0,0
1424900,True,0,No user reviews,0,0,0
1424920,True,0,No user reviews,0,0,0
1424940,True,0,No user reviews,0,0,0
1424950,True,0,No user reviews,0,0,0
1424960,True,0,No user reviews,0,0,0
1424980,True,8,Very Positive,261,23,284
1425010,True,0,No user reviews,0,0,0
1425020,True,0,No user reviews,0,0,0
1425030,True,0,No user reviews,0,0,0
1425040,True,0,No user reviews,0,0,0
1425060,True,0,No user reviews,0,0,0
1425090,True,0,No user reviews,0,0,0
1425110,True,0,2 user reviews,1,1,2
1425120,True,0,2 user reviews,2,0,2
1425140,True,0,4 user reviews,4,0,4
1425160,True,0,No user reviews,0,0,0
1425170,True,0,No user reviews,0,0,0
1425180,True,0,No user reviews,0,0,0
1425210,True,0,No user reviews,0,0,0
1425220,True,0,No user reviews,0,0,0
1425240,True,0,No user reviews,0,0,0
1425250,True,0,1 user reviews,1,0,1
1425270,True,0,No user reviews,0,0,0
1425280,True,0,5 user reviews,5,0,5
1425290,True,0,1 user reviews,1,0,1
1425300,True,0,3 user reviews,1,2,3
1425310,True,0,No user reviews,0,0,0
1425360,True,0,No user reviews,0,0,0
1425380,True,7,Positive,21,0,21
1425390,True,0,1 user reviews,1,0,1
1425400,True,0,No user reviews,0,0,0
1425430,True,0,4 user reviews,3,1,4
1425450,True,0,2 user reviews,2,0,2
1425520,True,0,No user reviews,0,0,0
1425530,True,0,No user reviews,0,0,0
1425550,True,0,No user reviews,0,0,0
1425570,True,0,No user reviews,0,0,0
1425610,True,0,No user reviews,0,0,0
1425620,True,0,No user reviews,0,0,0
1425640,True,0,No user reviews,0,0,0
1425650,True,0,No user reviews,0,0,0
1425680,True,0,No user reviews,0,0,0
1425690,True,0,No user reviews,0,0,0
1425720,True,0,1 user reviews,0,1,1
1425760,True,0,No user reviews,0,0,0
1425770,True,0,No user reviews,0,0,0
1425790,True,0,No user reviews,0,0,0
1425830,True,0,No user reviews,0,0,0
1425840,True,0,No user reviews,0,0,0
1425860,True,0,No user reviews,0,0,0
1425880,True,0,No user reviews,0,0,0
1425900,True,0,No user reviews,0,0,0
1425920,True,0,No user reviews,0,0,0
1425950,True,0,No user reviews,0,0,0
1425990,True,0,No user reviews,0,0,0
1426020,True,0,No user reviews,0,0,0
1426030,True,0,No user reviews,0,0,0
1426050,True,0,No user reviews,0,0,0
1426060,True,0,No user reviews,0,0,0
1426090,True,0,7 user reviews,5,2,7
1426110,True,0,No user reviews,0,0,0
1426120,True,0,No user reviews,0,0,0
1426130,True,0,No user reviews,0,0,0
1426150,True,0,No user reviews,0,0,0
1426160,True,0,2 user reviews,2,0,2
1426190,True,0,1 user reviews,1,0,1
1426230,True,0,No user reviews,0,0,0
1426240,True,6,Mostly Positive,98,41,139
1426280,True,6,Mostly Positive,7,3,10
1426300,True,0,No user reviews,0,0,0
1426310,True,0,No user reviews,0,0,0
1426330,True,0,No user reviews,0,0,0
1426350,True,0,No user reviews,0,0,0
1426380,True,0,No user reviews,0,0,0
1426400,True,0,No user reviews,0,0,0
1426420,True,0,No user reviews,0,0,0
1426480,True,0,No user reviews,0,0,0
1426510,True,0,No user reviews,0,0,0
1426520,True,0,No user reviews,0,0,0
1426550,True,0,No user reviews,0,0,0
1426660,True,0,No user reviews,0,0,0
1426740,True,0,No user reviews,0,0,0
1426750,True,0,No user reviews,0,0,0
1426770,True,0,No user reviews,0,0,0
1426800,True,0,No user reviews,0,0,0
1426810,True,0,No user reviews,0,0,0
1426870,True,0,No user reviews,0,0,0
1426880,True,0,2 user reviews,0,2,2
1426900,True,0,No user reviews,0,0,0
1426910,True,5,Mixed,186,117,303
1426920,True,0,No user reviews,0,0,0
1426921,True,0,No user reviews,0,0,0
1426930,True,0,No user reviews,0,0,0
1426950,True,0,No user reviews,0,0,0
1426980,True,0,No user reviews,0,0,0
1426990,True,0,No user reviews,0,0,0
1427000,True,0,No user reviews,0,0,0
1427010,True,0,No user reviews,0,0,0
1427020,True,0,No user reviews,0,0,0
1427030,True,0,No user reviews,0,0,0
1427040,True,0,No user reviews,0,0,0
1427100,True,0,No user reviews,0,0,0
1427110,True,0,No user reviews,0,0,0
1427120,True,0,No user reviews,0,0,0
1427140,True,0,No user reviews,0,0,0
1427150,True,0,No user reviews,0,0,0
1427170,True,0,No user reviews,0,0,0
1427180,True,0,No user reviews,0,0,0
1427190,True,0,No user reviews,0,0,0
1427220,True,0,No user reviews,0,0,0
1427221,True,0,No user reviews,0,0,0
1427230,True,0,No user reviews,0,0,0
1427250,True,0,No user reviews,0,0,0
1427260,True,0,No user reviews,0,0,0
1427280,True,0,No user reviews,0,0,0
1427290,True,0,2 user reviews,1,1,2
1427310,True,0,No user reviews,0,0,0
1427330,True,0,No user reviews,0,0,0
1427360,True,0,No user reviews,0,0,0
1427370,True,0,No user reviews,0,0,0
1427380,True,0,No user reviews,0,0,0
1427400,True,0,No user reviews,0,0,0
1427420,True,0,No user reviews,0,0,0
1427430,True,0,No user reviews,0,0,0
1427470,True,0,No user reviews,0,0,0
1427480,True,0,No user reviews,0,0,0
1427490,True,0,No user reviews,0,0,0
1427500,True,0,No user reviews,0,0,0
1427540,True,0,No user reviews,0,0,0
1427590,True,0,No user reviews,0,0,0
1427591,True,0,No user reviews,0,0,0
1427592,True,0,No user reviews,0,0,0
1427610,True,0,No user reviews,0,0,0
1427620,True,0,No user reviews,0,0,0
1427640,True,0,No user reviews,0,0,0
1427680,True,0,No user reviews,0,0,0
1427700,True,0,No user reviews,0,0,0
1427710,True,0,No user reviews,0,0,0
1427720,True,0,No user reviews,0,0,0
1427740,True,0,No user reviews,0,0,0
1427750,True,0,2 user reviews,2,0,2
1427760,True,0,No user reviews,0,0,0
1427770,True,0,No user reviews,0,0,0
1427780,True,0,No user reviews,0,0,0
1427810,True,0,No user reviews,0,0,0
1427850,True,0,No user reviews,0,0,0
1427860,True,0,No user reviews,0,0,0
1427880,True,0,No user reviews,0,0,0
1427890,True,0,No user reviews,0,0,0
1428000,True,0,No user reviews,0,0,0
1428010,True,0,No user reviews,0,0,0
1428020,True,0,No user reviews,0,0,0
1428021,True,0,No user reviews,0,0,0
1428022,True,0,No user reviews,0,0,0
1428023,True,0,No user reviews,0,0,0
1428024,True,0,No user reviews,0,0,0
1428030,True,0,No user reviews,0,0,0
1428040,True,0,No user reviews,0,0,0
1428050,True,0,No user reviews,0,0,0
1428110,True,0,5 user reviews,1,4,5
1428120,True,0,No user reviews,0,0,0
1428121,True,0,No user reviews,0,0,0
1428130,True,0,No user reviews,0,0,0
1428140,True,0,No user reviews,0,0,0
1428160,True,0,1 user reviews,0,1,1
1428220,True,0,4 user reviews,4,0,4
1428250,True,0,No user reviews,0,0,0
1428270,True,0,No user reviews,0,0,0
1428280,True,0,No user reviews,0,0,0
1428290,True,0,No user reviews,0,0,0
1428310,True,8,Very Positive,239,8,247
1428320,True,0,No user reviews,0,0,0
1428330,True,0,1 user reviews,1,0,1
1428340,True,0,No user reviews,0,0,0
1428350,True,0,No user reviews,0,0,0
1428380,True,0,No user reviews,0,0,0
1428420,True,0,No user reviews,0,0,0
1428430,True,0,No user reviews,0,0,0
1428440,True,0,No user reviews,0,0,0
1428450,True,0,No user reviews,0,0,0
1428460,True,7,Positive,32,0,32
1428470,True,0,No user reviews,0,0,0
1428480,True,0,No user reviews,0,0,0
1428510,True,0,No user reviews,0,0,0
1428520,True,0,No user reviews,0,0,0
1428560,True,0,No user reviews,0,0,0
1428580,True,0,2 user reviews,1,1,2
1428610,True,0,No user reviews,0,0,0
1428620,True,0,No user reviews,0,0,0
1428630,True,0,No user reviews,0,0,0
1428640,True,0,No user reviews,0,0,0
1428680,True,0,No user reviews,0,0,0
1428690,True,0,No user reviews,0,0,0
1428710,True,0,No user reviews,0,0,0
1428720,True,0,No user reviews,0,0,0
1428780,True,0,No user reviews,0,0,0
1428790,True,0,No user reviews,0,0,0
1428820,True,7,Positive,39,5,44
1428830,True,0,No user reviews,0,0,0
1428840,True,0,4 user reviews,4,0,4
1428850,True,0,No user reviews,0,0,0
1428890,True,0,No user reviews,0,0,0
1428910,True,0,No user reviews,0,0,0
1428920,True,0,No user reviews,0,0,0
1428930,True,0,No user reviews,0,0,0
1428940,True,0,No user reviews,0,0,0
1428980,True,0,4 user reviews,4,0,4
1429010,True,0,1 user reviews,1,0,1
1429050,True,0,No user reviews,0,0,0
1429090,True,0,No user reviews,0,0,0
1429100,True,0,No user reviews,0,0,0
1429110,True,0,No user reviews,0,0,0
1429120,True,0,No user reviews,0,0,0
1429130,True,0,No user reviews,0,0,0
1429150,True,0,No user reviews,0,0,0
1429160,True,0,No user reviews,0,0,0
1429210,True,0,No user reviews,0,0,0
1429220,True,0,No user reviews,0,0,0
1429250,True,0,No user reviews,0,0,0
1429260,True,0,No user reviews,0,0,0
1429270,True,0,1 user reviews,1,0,1
1429280,True,0,No user reviews,0,0,0
1429290,True,0,No user reviews,0,0,0
1429300,True,0,1 user reviews,0,1,1
1429400,True,0,1 user reviews,1,0,1
1429420,True,0,No user reviews,0,0,0
1429430,True,0,No user reviews,0,0,0
1429440,True,0,No user reviews,0,0,0
1429460,True,0,No user reviews,0,0,0
1429480,True,7,Positive,10,0,10
1429560,True,0,No user reviews,0,0,0
1429590,True,0,No user reviews,0,0,0
1429610,True,0,No user reviews,0,0,0
1429620,True,0,No user reviews,0,0,0
1429640,True,0,No user reviews,0,0,0
1429650,True,0,No user reviews,0,0,0
1429670,True,0,No user reviews,0,0,0
1429680,True,0,No user reviews,0,0,0
1429690,True,0,No user reviews,0,0,0
1429740,True,0,No user reviews,0,0,0
1429770,True,0,No user reviews,0,0,0
1429780,True,0,No user reviews,0,0,0
1429860,True,0,No user reviews,0,0,0
1429870,True,0,No user reviews,0,0,0
1429900,True,0,No user reviews,0,0,0
1429920,True,0,No user reviews,0,0,0
1429930,True,0,No user reviews,0,0,0
1429940,True,0,No user reviews,0,0,0
1429950,True,0,No user reviews,0,0,0
1429990,True,0,No user reviews,0,0,0
1430000,True,0,No user reviews,0,0,0
1430010,True,0,No user reviews,0,0,0
1430040,True,0,1 user reviews,1,0,1
1430070,True,0,3 user reviews,1,2,3
1430080,True,0,No user reviews,0,0,0
1430100,True,0,No user reviews,0,0,0
1430110,True,0,No user reviews,0,0,0
1430120,True,0,2 user reviews,2,0,2
1430130,True,0,No user reviews,0,0,0
1430140,True,0,1 user reviews,1,0,1
1430160,True,0,No user reviews,0,0,0
1430200,True,0,1 user reviews,1,0,1
1430240,True,0,No user reviews,0,0,0
1430260,True,0,No user reviews,0,0,0
1430300,True,0,No user reviews,0,0,0
1430310,True,0,No user reviews,0,0,0
1430320,True,0,No user reviews,0,0,0
1430340,True,0,No user reviews,0,0,0
1430350,True,0,No user reviews,0,0,0
1430370,True,0,No user reviews,0,0,0
1430420,True,8,Very Positive,94,1,95
1430430,True,0,No user reviews,0,0,0
1430490,True,0,No user reviews,0,0,0
1430510,True,0,No user reviews,0,0,0
1430520,True,0,No user reviews,0,0,0
1430550,True,0,No user reviews,0,0,0
1430560,True,0,No user reviews,0,0,0
1430580,True,0,No user reviews,0,0,0
1430610,True,8,Very Positive,66,0,66
1430650,True,0,No user reviews,0,0,0
1430660,True,0,No user reviews,0,0,0
1430700,True,0,No user reviews,0,0,0
1430740,True,0,3 user reviews,1,2,3
1430750,True,0,No user reviews,0,0,0
1430760,True,0,No user reviews,0,0,0
1430770,True,0,No user reviews,0,0,0
1430780,True,0,No user reviews,0,0,0
1430820,True,0,1 user reviews,1,0,1
1430830,True,0,No user reviews,0,0,0
1430840,True,0,No user reviews,0,0,0
1430850,True,0,No user reviews,0,0,0
1430860,True,0,No user reviews,0,0,0
1430870,True,0,No user reviews,0,0,0
1430940,True,7,Positive,14,1,15
1430960,True,0,No user reviews,0,0,0
1430980,True,0,2 user reviews,0,2,2
1430990,True,7,Positive,12,0,12
1431000,True,0,No user reviews,0,0,0
1431020,True,0,No user reviews,0,0,0
1431030,True,7,Positive,14,2,16
1431040,True,0,No user reviews,0,0,0
1431080,True,0,No user reviews,0,0,0
1431090,True,0,No user reviews,0,0,0
1431100,True,0,No user reviews,0,0,0
1431150,True,0,No user reviews,0,0,0
1431180,True,0,No user reviews,0,0,0
1431190,True,7,Positive,10,0,10
1431200,True,0,No user reviews,0,0,0
1431210,True,0,1 user reviews,1,0,1
1431220,True,0,5 user reviews,5,0,5
1431230,True,0,No user reviews,0,0,0
1431240,True,0,No user reviews,0,0,0
1431260,True,0,No user reviews,0,0,0
1431310,True,0,No user reviews,0,0,0
1431330,True,0,No user reviews,0,0,0
1431360,True,0,No user reviews,0,0,0
1431370,True,0,No user reviews,0,0,0
1431380,True,0,No user reviews,0,0,0
1431390,True,0,No user reviews,0,0,0
1431420,True,0,6 user reviews,6,0,6
1431450,True,0,No user reviews,0,0,0
1431470,True,0,No user reviews,0,0,0
1431500,True,0,No user reviews,0,0,0
1431520,True,0,No user reviews,0,0,0
1431550,True,0,No user reviews,0,0,0
1431560,True,0,No user reviews,0,0,0
1431580,True,0,No user reviews,0,0,0
1431600,True,0,No user reviews,0,0,0
1431610,True,0,No user reviews,0,0,0
1431620,True,0,1 user reviews,0,1,1
1431630,True,0,No user reviews,0,0,0
1431640,True,0,No user reviews,0,0,0
1431660,True,0,No user reviews,0,0,0
1431670,True,0,No user reviews,0,0,0
1431690,True,0,No user reviews,0,0,0
1431702,True,0,1 user reviews,1,0,1
1431710,True,0,1 user reviews,1,0,1
1431730,True,0,No user reviews,0,0,0
1431750,True,0,No user reviews,0,0,0
1431770,True,0,No user reviews,0,0,0
1431780,True,0,9 user reviews,9,0,9
1431790,True,0,No user reviews,0,0,0
1431810,True,0,No user reviews,0,0,0
1431820,True,0,No user reviews,0,0,0
1431840,True,0,1 user reviews,1,0,1
1431910,True,0,No user reviews,0,0,0
1431930,True,0,No user reviews,0,0,0
1431960,True,0,No user reviews,0,0,0
1432000,True,0,No user reviews,0,0,0
1432010,True,0,No user reviews,0,0,0
1432030,True,0,No user reviews,0,0,0
1432040,True,0,No user reviews,0,0,0
1432200,True,0,No user reviews,0,0,0
1432240,True,0,No user reviews,0,0,0
1432270,True,7,Positive,28,2,30
1432280,True,0,No user reviews,0,0,0
1432290,True,0,No user reviews,0,0,0
1432310,True,0,No user reviews,0,0,0
1432330,True,0,No user reviews,0,0,0
1432340,True,0,No user reviews,0,0,0
1432350,True,0,No user reviews,0,0,0
1432370,True,0,No user reviews,0,0,0
1432380,True,0,No user reviews,0,0,0
1432390,True,0,No user reviews,0,0,0
1432400,True,0,2 user reviews,2,0,2
1432450,True,0,No user reviews,0,0,0
1432460,True,0,No user reviews,0,0,0
1432470,True,0,7 user reviews,7,0,7
1432480,True,0,No user reviews,0,0,0
1432500,True,0,No user reviews,0,0,0
1432530,True,0,No user reviews,0,0,0
1432540,True,0,No user reviews,0,0,0
1432570,True,0,No user reviews,0,0,0
1432590,True,0,No user reviews,0,0,0
1432600,True,0,No user reviews,0,0,0
1432610,True,0,No user reviews,0,0,0
1432620,True,0,No user reviews,0,0,0
1432630,True,0,No user reviews,0,0,0
1432650,True,0,7 user reviews,7,0,7
1432670,True,0,No user reviews,0,0,0
1432680,True,0,No user reviews,0,0,0
1432690,True,0,No user reviews,0,0,0
1432700,True,0,No user reviews,0,0,0
1432710,True,0,No user reviews,0,0,0
1432720,True,0,No user reviews,0,0,0
1432730,True,0,No user reviews,0,0,0
1432740,True,0,No user reviews,0,0,0
1432750,True,7,Positive,10,0,10
1432760,True,0,No user reviews,0,0,0
1432790,True,0,No user reviews,0,0,0
1432800,True,0,No user reviews,0,0,0
1432820,True,0,No user reviews,0,0,0
1432830,True,0,No user reviews,0,0,0
1432850,True,0,No user reviews,0,0,0
1432870,True,0,No user reviews,0,0,0
1432880,True,0,No user reviews,0,0,0
1432900,True,0,No user reviews,0,0,0
1432920,True,0,No user reviews,0,0,0
1432930,True,0,No user reviews,0,0,0
1432940,True,0,1 user reviews,0,1,1
1432960,True,0,No user reviews,0,0,0
1432990,True,0,No user reviews,0,0,0
1433060,True,0,No user reviews,0,0,0
1433090,True,0,No user reviews,0,0,0
1433100,True,0,No user reviews,0,0,0
1433150,True,0,No user reviews,0,0,0
1433160,True,0,No user reviews,0,0,0
1433200,True,0,No user reviews,0,0,0
1433210,True,0,No user reviews,0,0,0
1433220,True,0,No user reviews,0,0,0
1433230,True,0,No user reviews,0,0,0
1433240,True,0,No user reviews,0,0,0
1433260,True,0,No user reviews,0,0,0
1433310,True,0,No user reviews,0,0,0
1433320,True,0,5 user reviews,5,0,5
1433330,True,0,No user reviews,0,0,0
1433360,True,0,No user reviews,0,0,0
1433370,True,0,No user reviews,0,0,0
1433380,True,0,No user reviews,0,0,0
1433420,True,0,No user reviews,0,0,0
1433430,True,0,7 user reviews,7,0,7
1433440,True,0,No user reviews,0,0,0
1433460,True,0,No user reviews,0,0,0
1433470,True,0,No user reviews,0,0,0
1433510,True,0,No user reviews,0,0,0
1433540,True,0,No user reviews,0,0,0
1433570,True,0,No user reviews,0,0,0
1433580,True,0,No user reviews,0,0,0
1433582,True,0,No user reviews,0,0,0
1433590,True,0,No user reviews,0,0,0
1433600,True,0,No user reviews,0,0,0
1433601,True,0,No user reviews,0,0,0
1433602,True,0,No user reviews,0,0,0
1433604,True,0,No user reviews,0,0,0
1433605,True,0,No user reviews,0,0,0
1433630,True,0,No user reviews,0,0,0
1433640,True,0,No user reviews,0,0,0
1433650,True,0,No user reviews,0,0,0
1433660,True,0,No user reviews,0,0,0
1433670,True,0,No user reviews,0,0,0
1433710,True,0,No user reviews,0,0,0
1433720,True,0,No user reviews,0,0,0
1433730,True,0,No user reviews,0,0,0
1433760,True,0,No user reviews,0,0,0
1433770,True,0,No user reviews,0,0,0
1433780,True,0,No user reviews,0,0,0
1433790,True,0,No user reviews,0,0,0
1433800,True,0,No user reviews,0,0,0
1433810,True,0,No user reviews,0,0,0
1433820,True,0,No user reviews,0,0,0
1433890,True,7,Positive,13,0,13
1433910,True,0,No user reviews,0,0,0
1433920,True,0,No user reviews,0,0,0
1433930,True,0,1 user reviews,1,0,1
1433940,True,0,No user reviews,0,0,0
1433950,True,0,2 user reviews,2,0,2
1433970,True,0,No user reviews,0,0,0
1433980,True,0,No user reviews,0,0,0
1434000,True,0,No user reviews,0,0,0
1434010,True,0,No user reviews,0,0,0
1434100,True,0,No user reviews,0,0,0
1434110,True,0,No user reviews,0,0,0
1434140,True,0,No user reviews,0,0,0
1434160,True,0,No user reviews,0,0,0
1434210,True,0,No user reviews,0,0,0
1434220,True,0,No user reviews,0,0,0
1434230,True,0,No user reviews,0,0,0
1434240,True,0,No user reviews,0,0,0
1434250,True,0,No user reviews,0,0,0
1434280,True,0,No user reviews,0,0,0
1434281,True,0,No user reviews,0,0,0
1434282,True,0,No user reviews,0,0,0
1434283,True,0,No user reviews,0,0,0
1434284,True,0,No user reviews,0,0,0
1434285,True,0,No user reviews,0,0,0
1434286,True,0,No user reviews,0,0,0
1434287,True,0,No user reviews,0,0,0
1434288,True,0,No user reviews,0,0,0
1434289,True,0,No user reviews,0,0,0
1434290,True,0,No user reviews,0,0,0
1434300,True,0,No user reviews,0,0,0
1434340,True,0,No user reviews,0,0,0
1434360,True,0,No user reviews,0,0,0
1434400,True,0,No user reviews,0,0,0
1434420,True,0,No user reviews,0,0,0
1434450,True,0,No user reviews,0,0,0
1434470,True,0,No user reviews,0,0,0
1434480,True,0,No user reviews,0,0,0
1434510,True,0,No user reviews,0,0,0
1434550,True,0,No user reviews,0,0,0
1434560,True,0,No user reviews,0,0,0
1434570,True,0,No user reviews,0,0,0
1434580,True,0,No user reviews,0,0,0
1434590,True,0,No user reviews,0,0,0
1434600,True,0,No user reviews,0,0,0
1434620,True,0,1 user reviews,0,1,1
1434640,True,0,No user reviews,0,0,0
1434680,True,0,No user reviews,0,0,0
1434700,True,0,No user reviews,0,0,0
1434710,True,0,No user reviews,0,0,0
1434720,True,0,3 user reviews,2,1,3
1434730,True,0,No user reviews,0,0,0
1434740,True,0,No user reviews,0,0,0
1434780,True,0,No user reviews,0,0,0
1434870,True,0,No user reviews,0,0,0
1434880,True,0,2 user reviews,2,0,2
1434890,True,0,No user reviews,0,0,0
1434910,True,0,No user reviews,0,0,0
1434920,True,0,No user reviews,0,0,0
1435020,True,0,No user reviews,0,0,0
1435030,True,0,No user reviews,0,0,0
1435050,True,0,No user reviews,0,0,0
1435060,True,0,No user reviews,0,0,0
1435090,True,0,No user reviews,0,0,0
1435120,True,0,No user reviews,0,0,0
1435130,True,0,No user reviews,0,0,0
1435140,True,0,No user reviews,0,0,0
1435160,True,0,No user reviews,0,0,0
1435190,True,0,No user reviews,0,0,0
1435200,True,0,No user reviews,0,0,0
1435230,True,0,No user reviews,0,0,0
1435260,True,0,No user reviews,0,0,0
1435290,True,0,No user reviews,0,0,0
1435310,True,0,No user reviews,0,0,0
1435330,True,0,No user reviews,0,0,0
1435340,True,0,No user reviews,0,0,0
1435350,True,0,No user reviews,0,0,0
1435360,True,0,No user reviews,0,0,0
1435380,True,0,No user reviews,0,0,0
1435390,True,0,No user reviews,0,0,0
1435410,True,0,No user reviews,0,0,0
1435420,True,0,1 user reviews,0,1,1
1435430,True,0,No user reviews,0,0,0
1435440,True,0,No user reviews,0,0,0
1435470,True,0,No user reviews,0,0,0
1435480,True,0,6 user reviews,3,3,6
1435510,True,0,1 user reviews,1,0,1
1435540,True,0,No user reviews,0,0,0
1435560,True,0,No user reviews,0,0,0
1435570,True,0,No user reviews,0,0,0
1435610,True,0,No user reviews,0,0,0
1435630,True,0,No user reviews,0,0,0
1435650,True,0,3 user reviews,3,0,3
1435660,True,0,2 user reviews,2,0,2
1435680,True,0,2 user reviews,2,0,2
1435690,True,0,3 user reviews,2,1,3
1435740,True,0,No user reviews,0,0,0
1435760,True,0,No user reviews,0,0,0
1435770,True,0,No user reviews,0,0,0
1435830,True,0,No user reviews,0,0,0
1435840,True,0,No user reviews,0,0,0
1435890,True,0,No user reviews,0,0,0
1435900,True,0,No user reviews,0,0,0
1435930,True,0,No user reviews,0,0,0
1435980,True,0,No user reviews,0,0,0
1436000,True,0,No user reviews,0,0,0
1436010,True,0,No user reviews,0,0,0
1436020,True,0,No user reviews,0,0,0
1436030,True,0,No user reviews,0,0,0
1436040,True,0,No user reviews,0,0,0
1436060,True,0,No user reviews,0,0,0
1436130,True,0,No user reviews,0,0,0
1436140,True,0,No user reviews,0,0,0
1436180,True,0,No user reviews,0,0,0
1436190,True,0,3 user reviews,3,0,3
1436220,True,0,No user reviews,0,0,0
1436230,True,0,No user reviews,0,0,0
1436250,True,0,No user reviews,0,0,0
1436260,True,0,No user reviews,0,0,0
1436270,True,0,No user reviews,0,0,0
1436280,True,0,No user reviews,0,0,0
1436330,True,0,No user reviews,0,0,0
1436350,True,0,No user reviews,0,0,0
1436360,True,0,No user reviews,0,0,0
1436380,True,0,No user reviews,0,0,0
1436390,True,0,No user reviews,0,0,0
1436410,True,0,No user reviews,0,0,0
1436430,True,0,No user reviews,0,0,0
1436440,True,0,No user reviews,0,0,0
1436450,True,0,No user reviews,0,0,0
1436460,True,0,No user reviews,0,0,0
1436490,True,0,7 user reviews,7,0,7
1436500,True,0,No user reviews,0,0,0
1436560,True,0,No user reviews,0,0,0
1436570,True,0,2 user reviews,1,1,2
1436590,True,0,No user reviews,0,0,0
1436600,True,0,No user reviews,0,0,0
1436620,True,0,No user reviews,0,0,0
1436630,True,0,No user reviews,0,0,0
1436650,True,0,No user reviews,0,0,0
1436670,True,0,No user reviews,0,0,0
1436680,True,0,No user reviews,0,0,0
1436690,True,0,No user reviews,0,0,0
1436710,True,0,1 user reviews,1,0,1
1436720,True,0,No user reviews,0,0,0
1436730,True,0,No user reviews,0,0,0
1436740,True,0,No user reviews,0,0,0
1436800,True,0,No user reviews,0,0,0
1436810,True,0,No user reviews,0,0,0
1436820,True,0,No user reviews,0,0,0
1436850,True,0,2 user reviews,2,0,2
1436870,True,0,No user reviews,0,0,0
1436910,True,0,No user reviews,0,0,0
1436920,True,0,No user reviews,0,0,0
1436930,True,0,1 user reviews,1,0,1
1436940,True,0,No user reviews,0,0,0
1437050,True,0,No user reviews,0,0,0
1437070,True,0,No user reviews,0,0,0
1437071,True,0,No user reviews,0,0,0
1437072,True,0,No user reviews,0,0,0
1437073,True,0,No user reviews,0,0,0
1437074,True,0,No user reviews,0,0,0
1437075,True,0,No user reviews,0,0,0
1437100,True,0,No user reviews,0,0,0
1437110,True,0,No user reviews,0,0,0
1437120,True,0,No user reviews,0,0,0
1437140,True,0,No user reviews,0,0,0
1437170,True,0,3 user reviews,2,1,3
1437210,True,0,No user reviews,0,0,0
1437220,True,0,No user reviews,0,0,0
1437230,True,0,No user reviews,0,0,0
1437260,True,0,No user reviews,0,0,0
1437270,True,0,No user reviews,0,0,0
1437290,True,0,No user reviews,0,0,0
1437300,True,0,No user reviews,0,0,0
1437310,True,0,No user reviews,0,0,0
1437330,True,0,No user reviews,0,0,0
1437331,True,0,No user reviews,0,0,0
1437340,True,0,No user reviews,0,0,0
1437360,True,0,No user reviews,0,0,0
1437410,True,0,4 user reviews,4,0,4
1437420,True,0,7 user reviews,7,0,7
1437430,True,0,No user reviews,0,0,0
1437440,True,0,No user reviews,0,0,0
1437470,True,0,No user reviews,0,0,0
1437480,True,0,1 user reviews,1,0,1
1437490,True,0,No user reviews,0,0,0
1437500,True,8,Very Positive,53,2,55
1437510,True,0,No user reviews,0,0,0
1437520,True,0,No user reviews,0,0,0
1437530,True,0,No user reviews,0,0,0
1437540,True,0,No user reviews,0,0,0
1437590,True,0,No user reviews,0,0,0
1437600,True,0,No user reviews,0,0,0
1437610,True,0,No user reviews,0,0,0
1437611,True,0,No user reviews,0,0,0
1437630,True,0,No user reviews,0,0,0
1437650,True,0,1 user reviews,1,0,1
1437670,True,0,No user reviews,0,0,0
1437680,True,0,No user reviews,0,0,0
1437700,True,0,1 user reviews,1,0,1
1437710,True,0,No user reviews,0,0,0
1437720,True,0,No user reviews,0,0,0
1437730,True,0,No user reviews,0,0,0
1437740,True,0,No user reviews,0,0,0
1437770,True,0,No user reviews,0,0,0
1437800,True,0,No user reviews,0,0,0
1437810,True,0,1 user reviews,1,0,1
1437900,True,0,No user reviews,0,0,0
1437910,True,0,No user reviews,0,0,0
1437920,True,0,No user reviews,0,0,0
1437930,True,0,No user reviews,0,0,0
1437940,True,0,No user reviews,0,0,0
1437980,True,0,No user reviews,0,0,0
1438000,True,0,1 user reviews,0,1,1
1438010,True,0,No user reviews,0,0,0
1438020,True,0,6 user reviews,6,0,6
1438030,True,0,No user reviews,0,0,0
1438050,True,0,2 user reviews,2,0,2
1438060,True,0,No user reviews,0,0,0
1438080,True,0,No user reviews,0,0,0
1438090,True,0,No user reviews,0,0,0
1438100,True,0,No user reviews,0,0,0
1438110,True,0,No user reviews,0,0,0
1438150,True,0,No user reviews,0,0,0
1438160,True,0,No user reviews,0,0,0
1438170,True,0,No user reviews,0,0,0
1438190,True,0,No user reviews,0,0,0
1438200,True,0,No user reviews,0,0,0
1438260,True,6,Mostly Positive,12,4,16
1438280,True,0,No user reviews,0,0,0
1438300,True,0,No user reviews,0,0,0
1438310,True,0,No user reviews,0,0,0
1438320,True,0,No user reviews,0,0,0
1438360,True,0,No user reviews,0,0,0
1438380,True,0,No user reviews,0,0,0
1438400,True,0,No user reviews,0,0,0
1438420,True,0,No user reviews,0,0,0
1438460,True,0,No user reviews,0,0,0
1438490,True,0,No user reviews,0,0,0
1438500,True,0,No user reviews,0,0,0
1438520,True,0,No user reviews,0,0,0
1438540,True,0,No user reviews,0,0,0
1438550,True,0,No user reviews,0,0,0
1438560,True,0,No user reviews,0,0,0
1438580,True,0,No user reviews,0,0,0
1438600,True,0,No user reviews,0,0,0
1438640,True,0,No user reviews,0,0,0
1438670,True,0,No user reviews,0,0,0
1438690,True,0,No user reviews,0,0,0
1438710,True,0,No user reviews,0,0,0
1438720,True,0,No user reviews,0,0,0
1438730,True,0,No user reviews,0,0,0
1438740,True,0,No user reviews,0,0,0
1438750,True,0,No user reviews,0,0,0
1438760,True,0,No user reviews,0,0,0
1438770,True,0,No user reviews,0,0,0
1438790,True,0,No user reviews,0,0,0
1438820,True,0,No user reviews,0,0,0
1438830,True,0,No user reviews,0,0,0
1438840,True,0,No user reviews,0,0,0
1438850,True,0,No user reviews,0,0,0
1438870,True,0,No user reviews,0,0,0
1438880,True,0,No user reviews,0,0,0
1438890,True,0,No user reviews,0,0,0
1438900,True,0,No user reviews,0,0,0
1438910,True,0,No user reviews,0,0,0
1438920,True,0,No user reviews,0,0,0
1438950,True,0,No user reviews,0,0,0
1438980,True,0,4 user reviews,4,0,4
1438990,True,0,No user reviews,0,0,0
1439000,True,0,3 user reviews,2,1,3
1439001,True,0,No user reviews,0,0,0
1439020,True,0,No user reviews,0,0,0
1439030,True,0,No user reviews,0,0,0
1439050,True,0,No user reviews,0,0,0
1439060,True,0,2 user reviews,2,0,2
1439080,True,0,No user reviews,0,0,0
1439090,True,0,1 user reviews,0,1,1
1439100,True,0,No user reviews,0,0,0
1439110,True,0,No user reviews,0,0,0
1439120,True,0,No user reviews,0,0,0
1439130,True,0,No user reviews,0,0,0
1439140,True,0,No user reviews,0,0,0
1439200,True,0,No user reviews,0,0,0
1439230,True,0,No user reviews,0,0,0
1439250,True,0,No user reviews,0,0,0
1439320,True,0,No user reviews,0,0,0
1439360,True,0,No user reviews,0,0,0
1439410,True,0,No user reviews,0,0,0
1439430,True,7,Positive,10,0,10
1439460,True,0,No user reviews,0,0,0
1439510,True,0,No user reviews,0,0,0
1439550,True,0,No user reviews,0,0,0
1439560,True,0,No user reviews,0,0,0
1439580,True,0,No user reviews,0,0,0
1439640,True,0,No user reviews,0,0,0
1439650,True,0,No user reviews,0,0,0
1439670,True,0,No user reviews,0,0,0
1439700,True,0,No user reviews,0,0,0
1439720,True,0,No user reviews,0,0,0
1439721,True,0,No user reviews,0,0,0
1439722,True,0,No user reviews,0,0,0
1439723,True,0,No user reviews,0,0,0
1439724,True,0,No user reviews,0,0,0
1439725,True,0,No user reviews,0,0,0
1439730,True,0,No user reviews,0,0,0
1439770,True,0,No user reviews,0,0,0
1439800,True,0,No user reviews,0,0,0
1439820,True,0,No user reviews,0,0,0
1439830,True,0,No user reviews,0,0,0
1439840,True,0,No user reviews,0,0,0
1439850,True,0,No user reviews,0,0,0
1439870,True,0,No user reviews,0,0,0
1439880,True,0,No user reviews,0,0,0
1439890,True,0,No user reviews,0,0,0
1439900,True,0,No user reviews,0,0,0
1439910,True,0,No user reviews,0,0,0
1439920,True,0,No user reviews,0,0,0
1439940,True,0,No user reviews,0,0,0
1439960,True,0,No user reviews,0,0,0
1440000,True,0,No user reviews,0,0,0
1440020,True,0,No user reviews,0,0,0
1440030,True,0,No user reviews,0,0,0
1440060,True,0,No user reviews,0,0,0
1440080,True,0,No user reviews,0,0,0
1440110,True,0,No user reviews,0,0,0
1440120,True,0,No user reviews,0,0,0
1440130,True,0,9 user reviews,8,1,9
1440170,True,0,No user reviews,0,0,0
1440180,True,0,No user reviews,0,0,0
1440200,True,0,No user reviews,0,0,0
1440250,True,0,No user reviews,0,0,0
1440270,True,0,No user reviews,0,0,0
1440280,True,0,1 user reviews,1,0,1
1440290,True,0,No user reviews,0,0,0
1440330,True,0,No user reviews,0,0,0
1440350,True,0,No user reviews,0,0,0
1440370,True,0,No user reviews,0,0,0
1440400,True,0,No user reviews,0,0,0
1440460,True,0,No user reviews,0,0,0
1440480,True,0,No user reviews,0,0,0
1440490,True,0,No user reviews,0,0,0
1440530,True,0,No user reviews,0,0,0
1440540,True,0,No user reviews,0,0,0
1440580,True,0,No user reviews,0,0,0
1440590,True,0,No user reviews,0,0,0
1440610,True,0,No user reviews,0,0,0
1440650,True,0,No user reviews,0,0,0
1440660,True,0,No user reviews,0,0,0
1440670,True,0,No user reviews,0,0,0
1440690,True,0,No user reviews,0,0,0
1440710,True,0,No user reviews,0,0,0
1440750,True,0,No user reviews,0,0,0
1440760,True,0,No user reviews,0,0,0
1440770,True,0,No user reviews,0,0,0
1440780,True,0,2 user reviews,2,0,2
1440810,True,0,No user reviews,0,0,0
1440820,True,0,No user reviews,0,0,0
1440850,True,0,No user reviews,0,0,0
1440870,True,6,Mostly Positive,9,3,12
1440890,True,0,No user reviews,0,0,0
1440900,True,0,No user reviews,0,0,0
1440960,True,0,No user reviews,0,0,0
1440970,True,0,No user reviews,0,0,0
1441010,True,0,No user reviews,0,0,0
1441030,True,0,No user reviews,0,0,0
1441070,True,0,No user reviews,0,0,0
1441080,True,0,No user reviews,0,0,0
1441090,True,0,No user reviews,0,0,0
1441100,True,0,No user reviews,0,0,0
1441120,True,0,No user reviews,0,0,0
1441130,True,0,No user reviews,0,0,0
1441150,True,0,No user reviews,0,0,0
1441170,True,0,No user reviews,0,0,0
1441180,True,0,8 user reviews,7,1,8
1441220,True,0,No user reviews,0,0,0
1441260,True,0,No user reviews,0,0,0
1441270,True,0,No user reviews,0,0,0
1441280,True,0,No user reviews,0,0,0
1441290,True,0,No user reviews,0,0,0
1441310,True,0,No user reviews,0,0,0
1441340,True,0,No user reviews,0,0,0
1441380,True,0,No user reviews,0,0,0
1441390,True,0,No user reviews,0,0,0
1441400,True,0,No user reviews,0,0,0
1441420,True,0,No user reviews,0,0,0
1441450,True,0,No user reviews,0,0,0
1441490,True,0,No user reviews,0,0,0
1441500,True,0,No user reviews,0,0,0
1441510,True,0,No user reviews,0,0,0
1441530,True,0,No user reviews,0,0,0
1441540,True,0,No user reviews,0,0,0
1441570,True,0,No user reviews,0,0,0
1441580,True,0,No user reviews,0,0,0
1441590,True,0,1 user reviews,1,0,1
1441600,True,0,No user reviews,0,0,0
1441620,True,0,No user reviews,0,0,0
1441640,True,0,No user reviews,0,0,0
1441660,True,0,No user reviews,0,0,0
1441680,True,0,No user reviews,0,0,0
1441690,True,0,No user reviews,0,0,0
1441700,True,0,No user reviews,0,0,0
1441780,True,0,No user reviews,0,0,0
1441810,True,0,No user reviews,0,0,0
1441820,True,0,No user reviews,0,0,0
1441830,True,0,No user reviews,0,0,0
1441860,True,0,No user reviews,0,0,0
1441910,True,0,No user reviews,0,0,0
1441920,True,0,No user reviews,0,0,0
1441930,True,0,No user reviews,0,0,0
1441940,True,0,No user reviews,0,0,0
1441960,True,0,No user reviews,0,0,0
1441980,True,0,No user reviews,0,0,0
1442000,True,0,No user reviews,0,0,0
1442030,True,0,No user reviews,0,0,0
1442060,True,0,No user reviews,0,0,0
1442070,True,0,No user reviews,0,0,0
1442100,True,0,No user reviews,0,0,0
1442110,True,0,No user reviews,0,0,0
1442180,True,0,No user reviews,0,0,0
1442190,True,0,No user reviews,0,0,0
1442200,True,0,No user reviews,0,0,0
1442210,True,0,No user reviews,0,0,0
1442220,True,0,No user reviews,0,0,0
1442240,True,0,No user reviews,0,0,0
1442260,True,0,No user reviews,0,0,0
1442280,True,0,No user reviews,0,0,0
1442281,True,0,No user reviews,0,0,0
1442300,True,0,No user reviews,0,0,0
1442310,True,0,No user reviews,0,0,0
1442320,True,0,No user reviews,0,0,0
1442330,True,0,No user reviews,0,0,0
1442340,True,0,No user reviews,0,0,0
1442350,True,0,No user reviews,0,0,0
1442370,True,0,No user reviews,0,0,0
1442380,True,0,No user reviews,0,0,0
1442390,True,0,2 user reviews,1,1,2
1442400,True,0,No user reviews,0,0,0
1442420,True,0,No user reviews,0,0,0
1442430,True,0,No user reviews,0,0,0
1442440,True,0,No user reviews,0,0,0
1442450,True,0,No user reviews,0,0,0
1442460,True,0,No user reviews,0,0,0
1442480,True,0,No user reviews,0,0,0
1442500,True,0,No user reviews,0,0,0
1442520,True,0,No user reviews,0,0,0
1442560,True,0,No user reviews,0,0,0
1442570,True,0,No user reviews,0,0,0
1442580,True,0,No user reviews,0,0,0
1442600,True,0,No user reviews,0,0,0
1442630,True,0,No user reviews,0,0,0
1442690,True,0,No user reviews,0,0,0
1442730,True,0,No user reviews,0,0,0
1442731,True,0,No user reviews,0,0,0
1442732,True,0,No user reviews,0,0,0
1442733,True,0,No user reviews,0,0,0
1442734,True,0,No user reviews,0,0,0
1442735,True,0,No user reviews,0,0,0
1442736,True,0,No user reviews,0,0,0
1442737,True,0,No user reviews,0,0,0
1442738,True,0,No user reviews,0,0,0
1442739,True,0,No user reviews,0,0,0
1442760,True,0,No user reviews,0,0,0
1442770,True,0,No user reviews,0,0,0
1442790,True,0,No user reviews,0,0,0
1442810,True,0,1 user reviews,1,0,1
1442811,True,0,No user reviews,0,0,0
1442820,True,0,No user reviews,0,0,0
1442830,True,0,No user reviews,0,0,0
1442850,True,0,No user reviews,0,0,0
1442860,True,0,No user reviews,0,0,0
1442900,True,0,No user reviews,0,0,0
1442920,True,0,No user reviews,0,0,0
1442960,True,0,No user reviews,0,0,0
1443030,True,0,No user reviews,0,0,0
1443120,True,0,No user reviews,0,0,0
1443140,True,0,No user reviews,0,0,0
1443160,True,0,2 user reviews,2,0,2
1443190,True,0,No user reviews,0,0,0
1443230,True,0,No user reviews,0,0,0
1443260,True,0,4 user reviews,4,0,4
1443300,True,0,No user reviews,0,0,0
1443330,True,0,No user reviews,0,0,0
1443360,True,0,5 user reviews,3,2,5
1443370,True,0,No user reviews,0,0,0
1443390,True,0,No user reviews,0,0,0
1443400,True,0,No user reviews,0,0,0
1443430,True,8,Very Positive,76,3,79
1443450,True,0,No user reviews,0,0,0
1443470,True,0,No user reviews,0,0,0
1443480,True,0,No user reviews,0,0,0
1443490,True,0,No user reviews,0,0,0
1443520,True,0,No user reviews,0,0,0
1443530,True,0,No user reviews,0,0,0
1443531,True,0,No user reviews,0,0,0
1443532,True,0,No user reviews,0,0,0
1443533,True,0,No user reviews,0,0,0
1443630,True,0,No user reviews,0,0,0
1443640,True,0,1 user reviews,1,0,1
1443650,True,0,No user reviews,0,0,0
1443670,True,0,No user reviews,0,0,0
1443770,True,0,1 user reviews,1,0,1
1443800,True,0,No user reviews,0,0,0
1443810,True,0,No user reviews,0,0,0
1443820,True,0,No user reviews,0,0,0
1443870,True,0,No user reviews,0,0,0
1443900,True,0,1 user reviews,0,1,1
1443950,True,0,No user reviews,0,0,0
1443970,True,0,2 user reviews,1,1,2
1443980,True,0,No user reviews,0,0,0
1443990,True,0,No user reviews,0,0,0
1444020,True,0,No user reviews,0,0,0
1444090,True,7,Positive,27,0,27
1444100,True,0,No user reviews,0,0,0
1444110,True,0,No user reviews,0,0,0
1444140,True,0,1 user reviews,0,1,1
1444170,True,0,No user reviews,0,0,0
1444200,True,0,No user reviews,0,0,0
1444201,True,0,No user reviews,0,0,0
1444202,True,0,No user reviews,0,0,0
1444203,True,0,No user reviews,0,0,0
1444280,True,0,No user reviews,0,0,0
1444300,True,0,No user reviews,0,0,0
1444320,True,7,Positive,16,0,16
1444330,True,0,No user reviews,0,0,0
1444340,True,0,No user reviews,0,0,0
1444350,True,0,No user reviews,0,0,0
1444360,True,0,No user reviews,0,0,0
1444370,True,0,No user reviews,0,0,0
1444380,True,0,No user reviews,0,0,0
1444400,True,0,No user reviews,0,0,0
1444430,True,0,No user reviews,0,0,0
1444440,True,0,No user reviews,0,0,0
1444460,True,0,No user reviews,0,0,0
1444490,True,0,No user reviews,0,0,0
1444500,True,0,No user reviews,0,0,0
1444520,True,0,No user reviews,0,0,0
1444540,True,0,No user reviews,0,0,0
1444580,True,0,No user reviews,0,0,0
1444610,True,0,No user reviews,0,0,0
1444670,True,0,No user reviews,0,0,0
1444700,True,0,No user reviews,0,0,0
1444730,True,0,4 user reviews,4,0,4
1444740,True,0,No user reviews,0,0,0
1444760,True,0,No user reviews,0,0,0
1444800,True,0,No user reviews,0,0,0
1444820,True,0,No user reviews,0,0,0
1444860,True,0,No user reviews,0,0,0
1444870,True,0,No user reviews,0,0,0
1444890,True,0,5 user reviews,5,0,5
1444930,True,0,No user reviews,0,0,0
1444950,True,0,1 user reviews,0,1,1
1444960,True,0,No user reviews,0,0,0
1445010,True,0,No user reviews,0,0,0
1445050,True,0,No user reviews,0,0,0
1445070,True,0,No user reviews,0,0,0
1445110,True,0,No user reviews,0,0,0
1445120,True,0,3 user reviews,2,1,3
1445170,True,0,No user reviews,0,0,0
1445180,True,0,2 user reviews,2,0,2
1445190,True,0,No user reviews,0,0,0
1445200,True,0,No user reviews,0,0,0
1445210,True,0,No user reviews,0,0,0
1445220,True,0,No user reviews,0,0,0
1445310,True,0,No user reviews,0,0,0
1445350,True,0,No user reviews,0,0,0
1445360,True,0,No user reviews,0,0,0
1445380,True,0,No user reviews,0,0,0
1445400,True,0,3 user reviews,3,0,3
1445410,True,0,No user reviews,0,0,0
1445450,True,0,No user reviews,0,0,0
1445460,True,0,No user reviews,0,0,0
1445480,True,0,No user reviews,0,0,0
1445500,True,0,No user reviews,0,0,0
1445540,True,0,No user reviews,0,0,0
1445580,True,0,No user reviews,0,0,0
1445630,True,0,No user reviews,0,0,0
1445640,True,0,No user reviews,0,0,0
1445670,True,0,No user reviews,0,0,0
1445710,True,0,No user reviews,0,0,0
1445720,True,0,No user reviews,0,0,0
1445750,True,0,No user reviews,0,0,0
1445770,True,0,No user reviews,0,0,0
1445800,True,0,7 user reviews,7,0,7
1445870,True,0,No user reviews,0,0,0
1445970,True,0,No user reviews,0,0,0
1446000,True,0,1 user reviews,1,0,1
1446020,True,0,No user reviews,0,0,0
1446090,True,0,No user reviews,0,0,0
1446100,True,0,No user reviews,0,0,0
1446120,True,0,No user reviews,0,0,0
1446190,True,0,No user reviews,0,0,0
1446230,True,0,No user reviews,0,0,0
1446310,True,0,No user reviews,0,0,0
1446330,True,0,No user reviews,0,0,0
1446350,True,0,No user reviews,0,0,0
1446360,True,0,No user reviews,0,0,0
1446370,True,0,No user reviews,0,0,0
1446420,True,0,No user reviews,0,0,0
1446470,True,0,No user reviews,0,0,0
1446490,True,0,1 user reviews,1,0,1
1446510,True,0,No user reviews,0,0,0
1446570,True,0,No user reviews,0,0,0
1446640,True,0,No user reviews,0,0,0
1446740,True,0,No user reviews,0,0,0
1446760,True,0,No user reviews,0,0,0
1446770,True,0,No user reviews,0,0,0
1446820,True,0,No user reviews,0,0,0
1446830,True,0,No user reviews,0,0,0
1446860,True,0,No user reviews,0,0,0
1446910,True,0,No user reviews,0,0,0
1446960,True,0,No user reviews,0,0,0
1446970,True,0,No user reviews,0,0,0
1446980,True,0,No user reviews,0,0,0
1447020,True,0,No user reviews,0,0,0
1447050,True,0,No user reviews,0,0,0
1447060,True,0,2 user reviews,2,0,2
1447070,True,0,1 user reviews,1,0,1
1447080,True,0,No user reviews,0,0,0
1447160,True,0,No user reviews,0,0,0
1447210,True,0,No user reviews,0,0,0
1447220,True,0,No user reviews,0,0,0
1447240,True,0,No user reviews,0,0,0
1447270,True,0,No user reviews,0,0,0
1447320,True,0,No user reviews,0,0,0
1447360,True,0,No user reviews,0,0,0
1447400,True,0,No user reviews,0,0,0
1447410,True,0,No user reviews,0,0,0
1447440,True,0,No user reviews,0,0,0
1447450,True,0,No user reviews,0,0,0
1447490,True,0,No user reviews,0,0,0
1447540,True,0,No user reviews,0,0,0
1447570,True,0,No user reviews,0,0,0
1447660,True,0,No user reviews,0,0,0
1447680,True,0,No user reviews,0,0,0
1447720,True,0,No user reviews,0,0,0
1447730,True,0,No user reviews,0,0,0
1447830,True,0,No user reviews,0,0,0
1447840,True,0,No user reviews,0,0,0
1447850,True,0,No user reviews,0,0,0
1447870,True,0,No user reviews,0,0,0
1447900,True,0,No user reviews,0,0,0
1447920,True,0,No user reviews,0,0,0
1447930,True,0,No user reviews,0,0,0
1448030,True,0,No user reviews,0,0,0
1448050,True,0,No user reviews,0,0,0
1448070,True,0,No user reviews,0,0,0
1448100,True,0,No user reviews,0,0,0
1448101,True,0,No user reviews,0,0,0
1448110,True,0,No user reviews,0,0,0
1448210,True,0,No user reviews,0,0,0
1448220,True,0,No user reviews,0,0,0
1448290,True,0,No user reviews,0,0,0
1448300,True,0,No user reviews,0,0,0
1448380,True,0,No user reviews,0,0,0
1448400,True,0,No user reviews,0,0,0
1448420,True,0,No user reviews,0,0,0
1448480,True,0,No user reviews,0,0,0
1448500,True,0,No user reviews,0,0,0
1448590,True,0,No user reviews,0,0,0
1448650,True,0,No user reviews,0,0,0
1448660,True,0,No user reviews,0,0,0
1448670,True,0,No user reviews,0,0,0
1448680,True,0,1 user reviews,1,0,1
1448720,True,0,No user reviews,0,0,0
1448750,True,0,No user reviews,0,0,0
1448850,True,0,No user reviews,0,0,0
1448900,True,0,No user reviews,0,0,0
1448920,True,0,No user reviews,0,0,0
1448930,True,0,No user reviews,0,0,0
1448940,True,0,No user reviews,0,0,0
1448950,True,0,No user reviews,0,0,0
1449080,True,0,No user reviews,0,0,0
1449120,True,0,No user reviews,0,0,0
1449140,True,0,No user reviews,0,0,0
1449300,True,0,No user reviews,0,0,0
1449340,True,0,No user reviews,0,0,0
1449370,True,0,No user reviews,0,0,0
1449380,True,0,No user reviews,0,0,0
1449390,True,0,No user reviews,0,0,0
1449400,True,0,No user reviews,0,0,0
1449430,True,0,No user reviews,0,0,0
1449470,True,0,No user reviews,0,0,0
1449510,True,0,No user reviews,0,0,0
1449550,True,0,No user reviews,0,0,0
1449580,True,0,No user reviews,0,0,0
1449610,True,0,No user reviews,0,0,0
1449720,True,0,No user reviews,0,0,0
1449750,True,0,No user reviews,0,0,0
1449780,True,0,No user reviews,0,0,0
1449800,True,0,No user reviews,0,0,0
1449820,True,0,No user reviews,0,0,0
1449860,True,0,No user reviews,0,0,0
1449870,True,0,No user reviews,0,0,0
1449930,True,0,No user reviews,0,0,0
1449940,True,0,No user reviews,0,0,0
1449980,True,0,No user reviews,0,0,0
1450010,True,0,No user reviews,0,0,0
1450030,True,0,No user reviews,0,0,0
1450040,True,0,No user reviews,0,0,0
1450070,True,0,No user reviews,0,0,0
1450140,True,0,No user reviews,0,0,0
1450220,True,5,Mixed,11,6,17
1450240,True,0,No user reviews,0,0,0
1450310,True,0,No user reviews,0,0,0
1450330,True,0,No user reviews,0,0,0
1450370,True,0,No user reviews,0,0,0
1450410,True,0,No user reviews,0,0,0
1450440,True,0,No user reviews,0,0,0
1450450,True,0,No user reviews,0,0,0
1450490,True,0,No user reviews,0,0,0
1450510,True,0,No user reviews,0,0,0
1450530,True,0,No user reviews,0,0,0
1450540,True,0,No user reviews,0,0,0
1450550,True,0,No user reviews,0,0,0
1450610,True,0,No user reviews,0,0,0
1450630,True,0,No user reviews,0,0,0
1450660,True,0,No user reviews,0,0,0
1450680,True,0,No user reviews,0,0,0
1450700,True,0,3 user reviews,3,0,3
1450720,True,0,No user reviews,0,0,0
1450750,True,0,No user reviews,0,0,0
1450760,True,0,No user reviews,0,0,0
1450820,True,0,No user reviews,0,0,0
1450840,True,0,No user reviews,0,0,0
1451040,True,0,No user reviews,0,0,0
1451110,True,0,No user reviews,0,0,0
1451170,True,0,No user reviews,0,0,0
1451270,True,0,No user reviews,0,0,0
1451300,True,0,No user reviews,0,0,0
1451310,True,0,No user reviews,0,0,0
1451370,True,0,No user reviews,0,0,0
1451410,True,0,No user reviews,0,0,0
1451440,True,0,No user reviews,0,0,0
1451490,True,0,No user reviews,0,0,0
1451520,True,0,No user reviews,0,0,0
1451560,True,0,No user reviews,0,0,0
1451580,True,0,No user reviews,0,0,0
1451620,True,0,No user reviews,0,0,0
1451650,True,0,No user reviews,0,0,0
1451720,True,0,No user reviews,0,0,0
1451770,True,0,No user reviews,0,0,0
1451800,True,0,No user reviews,0,0,0
1451850,True,0,No user reviews,0,0,0
1451890,True,0,No user reviews,0,0,0
1451910,True,0,No user reviews,0,0,0
1452000,True,0,No user reviews,0,0,0
1452040,True,0,No user reviews,0,0,0
1452050,True,0,No user reviews,0,0,0
1452110,True,0,No user reviews,0,0,0
1452140,True,0,No user reviews,0,0,0
1452150,True,0,3 user reviews,3,0,3
1452210,True,0,No user reviews,0,0,0
1452220,True,0,No user reviews,0,0,0
1452260,True,0,No user reviews,0,0,0
1452270,True,0,No user reviews,0,0,0
1452300,True,0,No user reviews,0,0,0
1452340,True,0,No user reviews,0,0,0
1452360,True,0,No user reviews,0,0,0
1452440,True,0,No user reviews,0,0,0
1452480,True,0,No user reviews,0,0,0
1452560,True,0,No user reviews,0,0,0
1452570,True,0,No user reviews,0,0,0
1452580,True,0,No user reviews,0,0,0
1452590,True,0,No user reviews,0,0,0
1452610,True,0,No user reviews,0,0,0
1452620,True,0,No user reviews,0,0,0
1452700,True,0,No user reviews,0,0,0
1452710,True,0,No user reviews,0,0,0
1452740,True,0,No user reviews,0,0,0
1452750,True,0,No user reviews,0,0,0
1452770,True,0,No user reviews,0,0,0
1452860,True,0,No user reviews,0,0,0
1452930,True,0,No user reviews,0,0,0
1453000,True,0,No user reviews,0,0,0
1453030,True,0,No user reviews,0,0,0
1453060,True,0,No user reviews,0,0,0
1453070,True,0,No user reviews,0,0,0
1453100,True,0,No user reviews,0,0,0
1453180,True,0,No user reviews,0,0,0
1453290,True,0,No user reviews,0,0,0
1453440,True,0,No user reviews,0,0,0
1453450,True,0,No user reviews,0,0,0
1453460,True,0,No user reviews,0,0,0
1453500,True,0,No user reviews,0,0,0
1453510,True,0,No user reviews,0,0,0
1453580,True,0,No user reviews,0,0,0
1453581,True,0,No user reviews,0,0,0
1453582,True,0,No user reviews,0,0,0
1453583,True,0,No user reviews,0,0,0
1453584,True,0,No user reviews,0,0,0
1453585,True,0,No user reviews,0,0,0
1453590,True,0,No user reviews,0,0,0
1453600,True,0,No user reviews,0,0,0
1453610,True,0,No user reviews,0,0,0
1453840,True,0,No user reviews,0,0,0
1453880,True,0,No user reviews,0,0,0
1453940,True,0,No user reviews,0,0,0
1453990,True,0,No user reviews,0,0,0
1454070,True,0,No user reviews,0,0,0
1454110,True,0,No user reviews,0,0,0
1454140,True,0,No user reviews,0,0,0
1454240,True,0,No user reviews,0,0,0
1454320,True,0,No user reviews,0,0,0
1454340,True,0,No user reviews,0,0,0
1454510,True,0,No user reviews,0,0,0
1454920,True,0,3 user reviews,3,0,3
1455010,True,0,No user reviews,0,0,0
1455060,True,0,No user reviews,0,0,0
1455090,True,0,No user reviews,0,0,0
1455160,True,0,No user reviews,0,0,0
1455260,True,0,No user reviews,0,0,0
1455420,True,0,No user reviews,0,0,0
1455430,True,0,No user reviews,0,0,0
1455480,True,0,No user reviews,0,0,0
1455570,True,0,No user reviews,0,0,0
1455600,True,0,No user reviews,0,0,0
1455940,True,0,No user reviews,0,0,0
1455960,True,0,No user reviews,0,0,0
1455981,True,0,No user reviews,0,0,0
1455982,True,0,No user reviews,0,0,0
1456070,True,0,No user reviews,0,0,0
1456110,True,0,No user reviews,0,0,0
1456111,True,0,No user reviews,0,0,0
1456112,True,0,No user reviews,0,0,0
1456113,True,0,No user reviews,0,0,0
1456114,True,0,No user reviews,0,0,0
1456115,True,0,No user reviews,0,0,0
1456160,True,0,No user reviews,0,0,0
1456240,True,0,No user reviews,0,0,0
1456430,True,0,No user reviews,0,0,0
1456450,True,0,No user reviews,0,0,0
1456530,True,0,No user reviews,0,0,0
1456550,True,0,No user reviews,0,0,0
1456850,True,0,No user reviews,0,0,0
1457260,True,0,No user reviews,0,0,0
1457270,True,0,No user reviews,0,0,0
2028850,True,5,Mixed,19,10,29
