app_id,status,review_score,review_score_desc,total_positive,total_negative,total_reviews
5,True,0,No user reviews,0,0,0
7,True,0,No user reviews,0,0,0
8,True,0,No user reviews,0,0,0
10,True,9,Overwhelmingly Positive,19908,753,20661
20,True,8,Very Positive,1889,385,2274
30,True,8,Very Positive,1169,169,1338
40,True,8,Very Positive,548,131,679
50,True,9,Overwhelmingly Positive,4047,192,4239
60,True,8,Very Positive,1420,284,1704
70,True,9,Overwhelmingly Positive,18643,735,19378
80,True,8,Very Positive,3777,420,4197
90,True,0,No user reviews,0,0,0
92,True,0,No user reviews,0,0,0
100,True,8,Very Positive,293,22,315
130,True,8,Very Positive,2897,311,3208
150,True,0,No user reviews,0,0,0
205,True,0,No user reviews,0,0,0
210,True,0,No user reviews,0,0,0
211,True,0,No user reviews,0,0,0
215,True,0,No user reviews,0,0,0
218,True,0,No user reviews,0,0,0
219,True,0,No user reviews,0,0,0
220,True,9,Overwhelmingly Positive,34040,1123,35163
240,True,9,Overwhelmingly Positive,24541,1192,25733
260,True,0,No user reviews,0,0,0
280,True,6,Mostly Positive,2535,971,3506
300,True,8,Very Positive,3995,472,4467
304,True,0,No user reviews,0,0,0
310,True,0,No user reviews,0,0,0
320,True,8,Very Positive,2178,317,2495
340,True,8,Very Positive,2639,418,3057
360,True,6,Mostly Positive,684,230,914
364,True,0,No user reviews,0,0,0
380,True,8,Very Positive,4391,255,4646
400,True,9,Overwhelmingly Positive,30233,452,30685
410,True,0,No user reviews,0,0,0
420,True,9,Overwhelmingly Positive,7486,317,7803
440,True,8,Very Positive,5318,413,5731
456,True,0,No user reviews,0,0,0
457,True,0,No user reviews,0,0,0
458,True,0,No user reviews,0,0,0
459,True,0,No user reviews,0,0,0
480,True,0,No user reviews,0,0,0
500,True,8,Very Positive,8025,469,8494
510,True,0,No user reviews,0,0,0
513,True,0,No user reviews,0,0,0
520,True,0,No user reviews,0,0,0
530,True,0,No user reviews,0,0,0
540,True,0,No user reviews,0,0,0
550,True,9,Overwhelmingly Positive,85465,2697,88162
560,True,0,No user reviews,0,0,0
563,True,0,No user reviews,0,0,0
564,True,0,No user reviews,0,0,0
565,True,0,No user reviews,0,0,0
570,True,8,Very Positive,5506,653,6159
575,True,0,No user reviews,0,0,0
576,True,0,No user reviews,0,0,0
581,True,0,No user reviews,0,0,0
582,True,0,No user reviews,0,0,0
583,True,0,No user reviews,0,0,0
584,True,0,No user reviews,0,0,0
585,True,0,No user reviews,0,0,0
586,True,0,No user reviews,0,0,0
590,True,0,No user reviews,0,0,0
620,True,9,Overwhelmingly Positive,74754,861,75615
629,True,0,No user reviews,0,0,0
630,True,8,Very Positive,123,7,130
635,True,0,No user reviews,0,0,0
640,True,0,No user reviews,0,0,0
644,True,0,No user reviews,0,0,0
650,True,0,No user reviews,0,0,0
651,True,0,No user reviews,0,0,0
652,True,0,No user reviews,0,0,0
653,True,0,No user reviews,0,0,0
654,True,0,No user reviews,0,0,0
659,True,0,No user reviews,0,0,0
660,True,0,1 user reviews,1,0,1
669,True,0,No user reviews,0,0,0
730,True,8,Very Positive,815676,110706,926382
740,True,0,No user reviews,0,0,0
745,True,0,No user reviews,0,0,0
753,True,0,No user reviews,0,0,0
754,True,0,No user reviews,0,0,0
755,True,0,No user reviews,0,0,0
756,True,0,No user reviews,0,0,0
760,True,0,No user reviews,0,0,0
761,True,0,No user reviews,0,0,0
764,True,0,No user reviews,0,0,0
765,True,0,No user reviews,0,0,0
767,True,0,No user reviews,0,0,0
852,True,0,No user reviews,0,0,0
854,True,0,No user reviews,0,0,0
900,True,0,No user reviews,0,0,0
901,True,0,No user reviews,0,0,0
902,True,0,No user reviews,0,0,0
903,True,0,No user reviews,0,0,0
904,True,0,No user reviews,0,0,0
905,True,0,No user reviews,0,0,0
906,True,0,No user reviews,0,0,0
907,True,0,No user reviews,0,0,0
908,True,0,No user reviews,0,0,0
909,True,0,No user reviews,0,0,0
912,True,0,No user reviews,0,0,0
913,True,0,No user reviews,0,0,0
914,True,0,No user reviews,0,0,0
915,True,0,No user reviews,0,0,0
916,True,0,No user reviews,0,0,0
917,True,0,No user reviews,0,0,0
918,True,0,No user reviews,0,0,0
919,True,0,No user reviews,0,0,0
920,True,0,No user reviews,0,0,0
921,True,0,No user reviews,0,0,0
922,True,0,No user reviews,0,0,0
923,True,0,No user reviews,0,0,0
924,True,0,No user reviews,0,0,0
925,True,0,No user reviews,0,0,0
926,True,0,No user reviews,0,0,0
927,True,0,No user reviews,0,0,0
928,True,0,No user reviews,0,0,0
929,True,0,No user reviews,0,0,0
930,True,0,No user reviews,0,0,0
931,True,0,No user reviews,0,0,0
932,True,0,No user reviews,0,0,0
933,True,0,No user reviews,0,0,0
934,True,0,No user reviews,0,0,0
935,True,0,No user reviews,0,0,0
936,True,0,No user reviews,0,0,0
937,True,0,No user reviews,0,0,0
938,True,0,No user reviews,0,0,0
939,True,0,No user reviews,0,0,0
940,True,0,No user reviews,0,0,0
941,True,0,No user reviews,0,0,0
942,True,0,No user reviews,0,0,0
943,True,0,No user reviews,0,0,0
944,True,0,No user reviews,0,0,0
945,True,0,No user reviews,0,0,0
946,True,0,No user reviews,0,0,0
947,True,0,No user reviews,0,0,0
948,True,0,No user reviews,0,0,0
949,True,0,No user reviews,0,0,0
950,True,0,No user reviews,0,0,0
951,True,0,No user reviews,0,0,0
953,True,0,No user reviews,0,0,0
954,True,0,No user reviews,0,0,0
955,True,0,No user reviews,0,0,0
956,True,0,No user reviews,0,0,0
957,True,0,No user reviews,0,0,0
958,True,0,No user reviews,0,0,0
959,True,0,No user reviews,0,0,0
960,True,0,No user reviews,0,0,0
961,True,0,No user reviews,0,0,0
962,True,0,No user reviews,0,0,0
963,True,0,No user reviews,0,0,0
964,True,0,No user reviews,0,0,0
965,True,0,No user reviews,0,0,0
966,True,0,No user reviews,0,0,0
967,True,0,No user reviews,0,0,0
968,True,0,No user reviews,0,0,0
969,True,0,No user reviews,0,0,0
970,True,0,No user reviews,0,0,0
971,True,0,No user reviews,0,0,0
972,True,0,No user reviews,0,0,0
973,True,0,No user reviews,0,0,0
974,True,0,No user reviews,0,0,0
975,True,0,No user reviews,0,0,0
976,True,0,No user reviews,0,0,0
977,True,0,No user reviews,0,0,0
978,True,0,No user reviews,0,0,0
979,True,0,No user reviews,0,0,0
980,True,0,No user reviews,0,0,0
981,True,0,No user reviews,0,0,0
982,True,0,No user reviews,0,0,0
983,True,0,No user reviews,0,0,0
984,True,0,No user reviews,0,0,0
985,True,0,No user reviews,0,0,0
986,True,0,No user reviews,0,0,0
987,True,0,No user reviews,0,0,0
988,True,0,No user reviews,0,0,0
989,True,0,No user reviews,0,0,0
990,True,0,No user reviews,0,0,0
991,True,0,No user reviews,0,0,0
992,True,0,No user reviews,0,0,0
994,True,0,No user reviews,0,0,0
995,True,0,No user reviews,0,0,0
996,True,0,No user reviews,0,0,0
997,True,0,No user reviews,0,0,0
998,True,0,No user reviews,0,0,0
999,True,0,No user reviews,0,0,0
1001,True,0,No user reviews,0,0,0
1002,True,6,Mostly Positive,18,5,23
1003,True,0,No user reviews,0,0,0
1007,True,0,No user reviews,0,0,0
1200,True,8,Very Positive,503,86,589
1210,True,0,No user reviews,0,0,0
1213,True,0,No user reviews,0,0,0
1220,True,0,No user reviews,0,0,0
1230,True,8,Very Positive,53,9,62
1240,True,0,No user reviews,0,0,0
1250,True,9,Overwhelmingly Positive,18679,710,19389
1255,True,0,No user reviews,0,0,0
1256,True,7,Positive,21,3,24
1257,True,7,Positive,27,2,29
1259,True,0,No user reviews,0,0,0
1260,True,0,No user reviews,0,0,0
1270,True,0,No user reviews,0,0,0
1273,True,0,No user reviews,0,0,0
1280,True,8,Very Positive,549,58,607
1290,True,0,No user reviews,0,0,0
1300,True,8,Very Positive,206,34,240
1306,True,0,No user reviews,0,0,0
1313,True,8,Very Positive,56,14,70
1317,True,0,No user reviews,0,0,0
1320,True,0,No user reviews,0,0,0
1500,True,6,Mostly Positive,276,79,355
1502,True,0,No user reviews,0,0,0
1504,True,0,No user reviews,0,0,0
1507,True,0,No user reviews,0,0,0
1510,True,8,Very Positive,997,105,1102
1520,True,8,Very Positive,1429,214,1643
1522,True,0,No user reviews,0,0,0
1523,True,0,No user reviews,0,0,0
1525,True,0,No user reviews,0,0,0
1528,True,0,No user reviews,0,0,0
1530,True,8,Very Positive,208,31,239
1532,True,0,No user reviews,0,0,0
1535,True,0,No user reviews,0,0,0
1540,True,0,No user reviews,0,0,0
1600,True,6,Mostly Positive,118,44,162
1610,True,8,Very Positive,115,20,135
1620,True,0,No user reviews,0,0,0
1630,True,6,Mostly Positive,192,53,245
1635,True,0,No user reviews,0,0,0
1640,True,6,Mostly Positive,250,99,349
1645,True,0,No user reviews,0,0,0
1670,True,5,Mixed,70,47,117
1690,True,5,Mixed,158,73,231
1700,True,8,Very Positive,376,74,450
1710,True,0,No user reviews,0,0,0
1840,True,8,Very Positive,189,13,202
1900,True,5,Mixed,153,109,262
1920,True,0,No user reviews,0,0,0
1930,True,5,Mixed,712,309,1021
2100,True,8,Very Positive,2303,230,2533
2110,True,0,No user reviews,0,0,0
2114,True,0,No user reviews,0,0,0
2115,True,0,No user reviews,0,0,0
2120,True,0,No user reviews,0,0,0
2130,True,0,5 user reviews,5,0,5
2145,True,0,No user reviews,0,0,0
2150,True,0,No user reviews,0,0,0
2200,True,9,Overwhelmingly Positive,1017,50,1067
2210,True,8,Very Positive,564,118,682
2270,True,8,Very Positive,1221,74,1295
2280,True,8,Very Positive,4454,246,4700
2290,True,8,Very Positive,452,78,530
2300,True,8,Very Positive,2200,168,2368
2310,True,9,Overwhelmingly Positive,2584,130,2714
2320,True,8,Very Positive,1181,103,1284
2330,True,8,Very Positive,60,14,74
2340,True,5,Mixed,38,38,76
2350,True,6,Mostly Positive,83,23,106
2360,True,8,Very Positive,220,31,251
2370,True,6,Mostly Positive,56,17,73
2390,True,8,Very Positive,356,24,380
2400,True,8,Very Positive,1514,266,1780
2403,True,0,No user reviews,0,0,0
2410,True,0,No user reviews,0,0,0
2413,True,0,No user reviews,0,0,0
2420,True,5,Mixed,162,90,252
2430,True,0,No user reviews,0,0,0
2450,True,6,Mostly Positive,330,118,448
2460,True,0,No user reviews,0,0,0
2500,True,6,Mostly Positive,355,103,458
2505,True,0,No user reviews,0,0,0
2510,True,0,No user reviews,0,0,0
2520,True,5,Mixed,29,27,56
2525,True,0,2 user reviews,1,1,2
2530,True,0,No user reviews,0,0,0
2540,True,5,Mixed,63,54,117
2545,True,0,2 user reviews,0,2,2
2550,True,0,2 user reviews,0,2,2
2570,True,2,Very Negative,7,71,78
2590,True,5,Mixed,221,155,376
2600,True,8,Very Positive,5672,300,5972
2610,True,8,Very Positive,531,73,604
2620,True,8,Very Positive,1197,71,1268
2625,True,0,No user reviews,0,0,0
2630,True,8,Very Positive,1681,151,1832
2635,True,0,No user reviews,0,0,0
2640,True,8,Very Positive,404,55,459
2645,True,0,No user reviews,0,0,0
2680,True,0,No user reviews,0,0,0
2690,True,0,1 user reviews,1,0,1
2700,True,8,Very Positive,2442,280,2722
2710,True,8,Very Positive,122,22,144
2720,True,7,Positive,13,1,14
2724,True,0,No user reviews,0,0,0
2725,True,0,No user reviews,0,0,0
2726,True,0,No user reviews,0,0,0
2730,True,0,No user reviews,0,0,0
2740,True,0,No user reviews,0,0,0
2760,True,8,Very Positive,183,8,191
2767,True,0,No user reviews,0,0,0
2768,True,0,No user reviews,0,0,0
2770,True,0,No user reviews,0,0,0
2780,True,6,Mostly Positive,82,33,115
2790,True,0,1 user reviews,1,0,1
2800,True,6,Mostly Positive,107,31,138
2810,True,5,Mixed,132,66,198
2820,True,8,Very Positive,762,136,898
2826,True,0,No user reviews,0,0,0
2827,True,0,No user reviews,0,0,0
2840,True,5,Mixed,76,34,110
2850,True,6,Mostly Positive,21,9,30
2860,True,0,No user reviews,0,0,0
2870,True,4,Mostly Negative,1195,2135,3330
2900,True,6,Mostly Positive,63,18,81
2910,True,8,Very Positive,125,27,152
2920,True,6,Mostly Positive,32,11,43
2930,True,0,1 user reviews,1,0,1
2950,True,0,No user reviews,0,0,0
2990,True,8,Very Positive,1632,117,1749
3000,True,6,Mostly Positive,33,12,45
3010,True,6,Mostly Positive,87,26,113
3020,True,6,Mostly Positive,347,119,466
3030,True,0,No user reviews,0,0,0
3040,True,0,No user reviews,0,0,0
3050,True,6,Mostly Positive,51,15,66
3130,True,6,Mostly Positive,122,32,154
3150,True,0,2 user reviews,1,1,2
3160,True,0,3 user reviews,3,0,3
3170,True,8,Very Positive,205,27,232
3190,True,0,No user reviews,0,0,0
3200,True,7,Positive,41,3,44
3205,True,0,No user reviews,0,0,0
3210,True,0,No user reviews,0,0,0
3220,True,5,Mixed,37,40,77
3230,True,4,Mostly Negative,20,62,82
3260,True,5,Mixed,129,104,233
3270,True,5,Mixed,123,61,184
3273,True,0,No user reviews,0,0,0
3280,True,0,No user reviews,0,0,0
3300,True,8,Very Positive,167,10,177
3302,True,0,No user reviews,0,0,0
3310,True,8,Very Positive,242,19,261
3312,True,0,No user reviews,0,0,0
3320,True,9,Overwhelmingly Positive,1504,50,1554
3322,True,0,1 user reviews,1,0,1
3330,True,8,Very Positive,370,39,409
3332,True,0,No user reviews,0,0,0
3340,True,6,Mostly Positive,30,9,39
3342,True,0,No user reviews,0,0,0
3350,True,8,Very Positive,64,11,75
3352,True,0,No user reviews,0,0,0
3360,True,7,Positive,33,2,35
3362,True,0,No user reviews,0,0,0
3370,True,7,Positive,37,3,40
3372,True,0,No user reviews,0,0,0
3380,True,8,Very Positive,72,5,77
3382,True,0,No user reviews,0,0,0
3390,True,8,Very Positive,266,11,277
3392,True,0,No user reviews,0,0,0
3400,True,7,Positive,28,2,30
3402,True,0,No user reviews,0,0,0
3410,True,6,Mostly Positive,66,27,93
3412,True,0,No user reviews,0,0,0
3420,True,7,Positive,12,1,13
3422,True,0,No user reviews,0,0,0
3430,True,8,Very Positive,53,2,55
3432,True,0,No user reviews,0,0,0
3442,True,0,No user reviews,0,0,0
3450,True,8,Very Positive,104,26,130
3452,True,0,No user reviews,0,0,0
3460,True,0,9 user reviews,9,0,9
3462,True,0,No user reviews,0,0,0
3470,True,8,Very Positive,69,3,72
3472,True,0,No user reviews,0,0,0
3480,True,9,Overwhelmingly Positive,1308,48,1356
3482,True,0,No user reviews,0,0,0
3483,True,0,No user reviews,0,0,0
3490,True,7,Positive,11,2,13
3492,True,0,No user reviews,0,0,0
3500,True,5,Mixed,9,4,13
3502,True,0,No user reviews,0,0,0
3510,True,7,Positive,25,6,31
3512,True,0,No user reviews,0,0,0
3520,True,6,Mostly Positive,13,4,17
3522,True,0,No user reviews,0,0,0
3530,True,7,Positive,30,5,35
3532,True,0,No user reviews,0,0,0
3540,True,8,Very Positive,379,23,402
3542,True,0,No user reviews,0,0,0
3560,True,8,Very Positive,122,24,146
3562,True,0,No user reviews,0,0,0
3570,True,6,Mostly Positive,8,3,11
3572,True,0,No user reviews,0,0,0
3580,True,7,Positive,18,2,20
3582,True,0,No user reviews,0,0,0
3590,True,9,Overwhelmingly Positive,11630,325,11955
3592,True,0,No user reviews,0,0,0
3599,True,0,No user reviews,0,0,0
3600,True,6,Mostly Positive,43,13,56
3602,True,0,No user reviews,0,0,0
3610,True,7,Positive,12,2,14
3612,True,0,No user reviews,0,0,0
3620,True,8,Very Positive,286,16,302
3622,True,0,No user reviews,0,0,0
3629,True,0,No user reviews,0,0,0
3630,True,7,Positive,31,3,34
3632,True,0,No user reviews,0,0,0
3640,True,0,No user reviews,0,0,0
3642,True,0,No user reviews,0,0,0
3650,True,0,No user reviews,0,0,0
3652,True,0,No user reviews,0,0,0
3700,True,6,Mostly Positive,485,202,687
3710,True,8,Very Positive,464,64,528
3720,True,9,Overwhelmingly Positive,1795,85,1880
3730,True,8,Very Positive,1008,142,1150
3750,True,0,No user reviews,0,0,0
3800,True,8,Very Positive,183,44,227
3810,True,6,Mostly Positive,206,77,283
3820,True,5,Mixed,122,72,194
3830,True,9,Overwhelmingly Positive,4314,163,4477
3838,True,0,3 user reviews,3,0,3
3839,True,0,3 user reviews,3,0,3
3840,True,0,No user reviews,0,0,0
3850,True,0,No user reviews,0,0,0
3900,True,8,Very Positive,973,73,1046
3910,True,8,Very Positive,1862,164,2026
3920,True,8,Very Positive,2345,138,2483
3960,True,5,Mixed,42,43,85
3970,True,0,4 user reviews,4,0,4
3980,True,6,Mostly Positive,187,73,260
3990,True,8,Very Positive,102,10,112
4000,True,9,Overwhelmingly Positive,256769,8925,265694
4010,True,0,No user reviews,0,0,0
4020,True,0,No user reviews,0,0,0
4100,True,5,Mixed,5,5,10
4102,True,0,No user reviews,0,0,0
4200,True,0,No user reviews,0,0,0
4206,True,0,No user reviews,0,0,0
4207,True,0,No user reviews,0,0,0
4210,True,0,No user reviews,0,0,0
4230,True,7,Positive,29,4,33
4240,True,0,No user reviews,0,0,0
4260,True,0,No user reviews,0,0,0
4270,True,0,No user reviews,0,0,0
4280,True,0,No user reviews,0,0,0
4290,True,0,1 user reviews,1,0,1
4300,True,6,Mostly Positive,17,5,22
4310,True,0,No user reviews,0,0,0
4320,True,0,4 user reviews,2,2,4
4329,True,0,No user reviews,0,0,0
4330,True,0,No user reviews,0,0,0
4400,True,0,No user reviews,0,0,0
4410,True,0,No user reviews,0,0,0
4420,True,5,Mixed,25,30,55
4440,True,0,No user reviews,0,0,0
4450,True,0,No user reviews,0,0,0
4460,True,5,Mixed,38,25,63
4470,True,5,Mixed,20,10,30
4480,True,0,No user reviews,0,0,0
4500,True,8,Very Positive,5827,331,6158
4520,True,5,Mixed,66,30,96
4530,True,5,Mixed,48,24,72
4540,True,8,Very Positive,615,110,725
4550,True,8,Very Positive,873,66,939
4560,True,8,Very Positive,1911,135,2046
4570,True,9,Overwhelmingly Positive,2163,103,2266
4580,True,9,Overwhelmingly Positive,2257,82,2339
4590,True,0,No user reviews,0,0,0
4600,True,0,No user reviews,0,0,0
4610,True,0,No user reviews,0,0,0
4700,True,9,Overwhelmingly Positive,8230,383,8613
4710,True,0,No user reviews,0,0,0
4720,True,8,Very Positive,726,119,845
4720,True,8,Very Positive,726,120,846
4730,True,0,No user reviews,0,0,0
4760,True,8,Very Positive,5778,345,6123
4770,True,5,Mixed,235,105,340
4780,True,8,Very Positive,414,14,428
4790,True,0,No user reviews,0,0,0
4800,True,8,Very Positive,71,12,83
4808,True,0,No user reviews,0,0,0
4810,True,0,No user reviews,0,0,0
4820,True,0,No user reviews,0,0,0
4830,True,7,Positive,35,0,35
4850,True,8,Very Positive,369,50,419
4856,True,0,1 user reviews,0,1,1
4870,True,8,Very Positive,50,12,62
4880,True,6,Mostly Positive,66,24,90
4890,True,5,Mixed,105,52,157
4900,True,8,Very Positive,64,8,72
4910,True,0,No user reviews,0,0,0
4920,True,8,Very Positive,3913,640,4553
4930,True,0,No user reviews,0,0,0
4931,True,0,No user reviews,0,0,0
4932,True,0,No user reviews,0,0,0
4940,True,0,No user reviews,0,0,0
5000,True,0,No user reviews,0,0,0
5001,True,0,No user reviews,0,0,0
5002,True,0,No user reviews,0,0,0
5003,True,0,No user reviews,0,0,0
5004,True,0,No user reviews,0,0,0
5005,True,0,No user reviews,0,0,0
5006,True,0,No user reviews,0,0,0
5007,True,0,No user reviews,0,0,0
5008,True,0,No user reviews,0,0,0
5009,True,0,No user reviews,0,0,0
5010,True,0,No user reviews,0,0,0
5011,True,0,No user reviews,0,0,0
5012,True,0,No user reviews,0,0,0
5013,True,0,No user reviews,0,0,0
5014,True,0,No user reviews,0,0,0
5015,True,0,No user reviews,0,0,0
5016,True,0,No user reviews,0,0,0
5017,True,0,No user reviews,0,0,0
5018,True,0,No user reviews,0,0,0
5019,True,0,No user reviews,0,0,0
5020,True,0,No user reviews,0,0,0
5021,True,0,No user reviews,0,0,0
5022,True,0,No user reviews,0,0,0
5023,True,0,No user reviews,0,0,0
5024,True,0,No user reviews,0,0,0
5025,True,0,No user reviews,0,0,0
5026,True,0,No user reviews,0,0,0
5027,True,0,No user reviews,0,0,0
5028,True,0,No user reviews,0,0,0
5030,True,0,No user reviews,0,0,0
5031,True,0,No user reviews,0,0,0
5032,True,0,No user reviews,0,0,0
5033,True,0,No user reviews,0,0,0
5034,True,0,No user reviews,0,0,0
5035,True,0,No user reviews,0,0,0
5036,True,0,No user reviews,0,0,0
5037,True,0,No user reviews,0,0,0
5038,True,0,No user reviews,0,0,0
5039,True,0,No user reviews,0,0,0
5040,True,0,No user reviews,0,0,0
5041,True,0,No user reviews,0,0,0
5042,True,0,No user reviews,0,0,0
5043,True,0,No user reviews,0,0,0
5044,True,0,No user reviews,0,0,0
5045,True,0,No user reviews,0,0,0
5046,True,0,No user reviews,0,0,0
5047,True,0,No user reviews,0,0,0
5048,True,0,No user reviews,0,0,0
5049,True,0,No user reviews,0,0,0
5050,True,0,No user reviews,0,0,0
5051,True,0,No user reviews,0,0,0
5052,True,0,No user reviews,0,0,0
5053,True,0,No user reviews,0,0,0
5054,True,0,No user reviews,0,0,0
5055,True,0,No user reviews,0,0,0
5056,True,0,No user reviews,0,0,0
5057,True,0,No user reviews,0,0,0
5058,True,0,No user reviews,0,0,0
5059,True,0,No user reviews,0,0,0
5060,True,0,No user reviews,0,0,0
5061,True,0,No user reviews,0,0,0
5062,True,0,No user reviews,0,0,0
5063,True,0,No user reviews,0,0,0
5064,True,0,No user reviews,0,0,0
5066,True,0,No user reviews,0,0,0
5067,True,0,No user reviews,0,0,0
5068,True,0,No user reviews,0,0,0
5069,True,0,No user reviews,0,0,0
5070,True,0,No user reviews,0,0,0
5071,True,0,No user reviews,0,0,0
5072,True,0,No user reviews,0,0,0
5073,True,0,No user reviews,0,0,0
5074,True,0,No user reviews,0,0,0
5075,True,0,No user reviews,0,0,0
5076,True,0,No user reviews,0,0,0
5077,True,0,No user reviews,0,0,0
5078,True,0,No user reviews,0,0,0
5079,True,0,No user reviews,0,0,0
5080,True,0,No user reviews,0,0,0
5081,True,0,No user reviews,0,0,0
5082,True,0,No user reviews,0,0,0
5083,True,0,No user reviews,0,0,0
5084,True,0,No user reviews,0,0,0
5085,True,0,No user reviews,0,0,0
5086,True,0,No user reviews,0,0,0
5087,True,0,No user reviews,0,0,0
5088,True,0,No user reviews,0,0,0
5089,True,0,No user reviews,0,0,0
5090,True,0,No user reviews,0,0,0
5091,True,0,No user reviews,0,0,0
5092,True,0,No user reviews,0,0,0
5093,True,0,No user reviews,0,0,0
5094,True,0,No user reviews,0,0,0
5095,True,0,No user reviews,0,0,0
5096,True,0,No user reviews,0,0,0
5097,True,0,No user reviews,0,0,0
5098,True,0,No user reviews,0,0,0
5099,True,0,No user reviews,0,0,0
5100,True,0,No user reviews,0,0,0
5101,True,0,No user reviews,0,0,0
5102,True,0,No user reviews,0,0,0
5103,True,0,No user reviews,0,0,0
5104,True,0,No user reviews,0,0,0
5105,True,0,No user reviews,0,0,0
5106,True,0,No user reviews,0,0,0
5107,True,0,No user reviews,0,0,0
5108,True,0,No user reviews,0,0,0
5109,True,0,No user reviews,0,0,0
5111,True,0,No user reviews,0,0,0
5112,True,0,No user reviews,0,0,0
5113,True,0,No user reviews,0,0,0
5114,True,0,No user reviews,0,0,0
5115,True,0,No user reviews,0,0,0
5116,True,0,No user reviews,0,0,0
5117,True,0,No user reviews,0,0,0
5118,True,0,No user reviews,0,0,0
5119,True,0,No user reviews,0,0,0
5120,True,0,No user reviews,0,0,0
5121,True,0,No user reviews,0,0,0
5122,True,0,No user reviews,0,0,0
5123,True,0,No user reviews,0,0,0
5124,True,0,No user reviews,0,0,0
5125,True,0,No user reviews,0,0,0
5126,True,0,No user reviews,0,0,0
5127,True,0,No user reviews,0,0,0
5128,True,0,No user reviews,0,0,0
5129,True,0,No user reviews,0,0,0
5130,True,0,No user reviews,0,0,0
5131,True,0,No user reviews,0,0,0
5132,True,0,No user reviews,0,0,0
5133,True,0,No user reviews,0,0,0
5134,True,0,No user reviews,0,0,0
5135,True,0,No user reviews,0,0,0
5136,True,0,No user reviews,0,0,0
5137,True,0,No user reviews,0,0,0
5138,True,0,No user reviews,0,0,0
5139,True,0,No user reviews,0,0,0
5140,True,0,No user reviews,0,0,0
5141,True,0,No user reviews,0,0,0
5142,True,0,No user reviews,0,0,0
5143,True,0,No user reviews,0,0,0
5144,True,0,No user reviews,0,0,0
5145,True,0,No user reviews,0,0,0
5146,True,0,No user reviews,0,0,0
5147,True,0,No user reviews,0,0,0
5149,True,0,No user reviews,0,0,0
5150,True,0,No user reviews,0,0,0
5151,True,0,No user reviews,0,0,0
5152,True,0,No user reviews,0,0,0
5153,True,0,No user reviews,0,0,0
5154,True,0,No user reviews,0,0,0
5155,True,0,No user reviews,0,0,0
5157,True,0,No user reviews,0,0,0
5158,True,0,No user reviews,0,0,0
5159,True,0,No user reviews,0,0,0
5160,True,0,No user reviews,0,0,0
5161,True,0,No user reviews,0,0,0
5162,True,0,No user reviews,0,0,0
5163,True,0,No user reviews,0,0,0
5164,True,0,No user reviews,0,0,0
5165,True,0,No user reviews,0,0,0
5166,True,0,No user reviews,0,0,0
5167,True,0,No user reviews,0,0,0
5168,True,0,No user reviews,0,0,0
5169,True,0,No user reviews,0,0,0
5170,True,0,No user reviews,0,0,0
5172,True,0,No user reviews,0,0,0
5173,True,0,No user reviews,0,0,0
5174,True,0,No user reviews,0,0,0
5175,True,0,No user reviews,0,0,0
5177,True,0,No user reviews,0,0,0
5178,True,0,No user reviews,0,0,0
5179,True,0,No user reviews,0,0,0
5180,True,0,No user reviews,0,0,0
5181,True,0,No user reviews,0,0,0
5182,True,0,No user reviews,0,0,0
5183,True,0,No user reviews,0,0,0
5184,True,0,No user reviews,0,0,0
5185,True,0,No user reviews,0,0,0
5186,True,0,No user reviews,0,0,0
5187,True,0,No user reviews,0,0,0
5188,True,0,No user reviews,0,0,0
5189,True,0,No user reviews,0,0,0
5190,True,0,No user reviews,0,0,0
5191,True,0,No user reviews,0,0,0
5192,True,0,No user reviews,0,0,0
5193,True,0,No user reviews,0,0,0
5194,True,0,No user reviews,0,0,0
5195,True,0,No user reviews,0,0,0
5196,True,0,No user reviews,0,0,0
5197,True,0,No user reviews,0,0,0
5198,True,0,No user reviews,0,0,0
5199,True,0,No user reviews,0,0,0
5200,True,0,No user reviews,0,0,0
5201,True,0,No user reviews,0,0,0
5202,True,0,No user reviews,0,0,0
5203,True,0,No user reviews,0,0,0
5204,True,0,No user reviews,0,0,0
5205,True,0,No user reviews,0,0,0
5206,True,0,No user reviews,0,0,0
5207,True,0,No user reviews,0,0,0
5208,True,0,No user reviews,0,0,0
5209,True,0,No user reviews,0,0,0
5210,True,0,No user reviews,0,0,0
5211,True,0,No user reviews,0,0,0
5212,True,0,No user reviews,0,0,0
5213,True,0,No user reviews,0,0,0
5214,True,0,No user reviews,0,0,0
5215,True,0,No user reviews,0,0,0
5216,True,0,No user reviews,0,0,0
5217,True,0,No user reviews,0,0,0
5218,True,0,No user reviews,0,0,0
5219,True,0,No user reviews,0,0,0
5220,True,0,No user reviews,0,0,0
5221,True,0,No user reviews,0,0,0
5222,True,0,No user reviews,0,0,0
5223,True,0,No user reviews,0,0,0
5227,True,0,No user reviews,0,0,0
5231,True,0,No user reviews,0,0,0
5232,True,0,No user reviews,0,0,0
5233,True,0,No user reviews,0,0,0
5234,True,0,No user reviews,0,0,0
5235,True,0,No user reviews,0,0,0
5236,True,0,No user reviews,0,0,0
5237,True,0,No user reviews,0,0,0
5238,True,0,No user reviews,0,0,0
5239,True,0,No user reviews,0,0,0
5240,True,0,No user reviews,0,0,0
5241,True,0,No user reviews,0,0,0
5242,True,0,No user reviews,0,0,0
5243,True,0,No user reviews,0,0,0
5244,True,0,No user reviews,0,0,0
5245,True,0,No user reviews,0,0,0
5246,True,0,No user reviews,0,0,0
5247,True,0,No user reviews,0,0,0
5248,True,0,No user reviews,0,0,0
5249,True,0,No user reviews,0,0,0
5250,True,0,No user reviews,0,0,0
5251,True,0,No user reviews,0,0,0
5252,True,0,No user reviews,0,0,0
5253,True,0,No user reviews,0,0,0
5254,True,0,No user reviews,0,0,0
5255,True,0,No user reviews,0,0,0
5256,True,0,No user reviews,0,0,0
5257,True,0,No user reviews,0,0,0
5258,True,0,No user reviews,0,0,0
5259,True,0,No user reviews,0,0,0
5260,True,0,No user reviews,0,0,0
5261,True,0,No user reviews,0,0,0
5262,True,0,No user reviews,0,0,0
5263,True,0,No user reviews,0,0,0
5265,True,0,No user reviews,0,0,0
5266,True,0,No user reviews,0,0,0
5267,True,0,No user reviews,0,0,0
5268,True,0,No user reviews,0,0,0
5269,True,0,No user reviews,0,0,0
5270,True,0,No user reviews,0,0,0
5271,True,0,No user reviews,0,0,0
5272,True,0,No user reviews,0,0,0
5273,True,0,No user reviews,0,0,0
5274,True,0,No user reviews,0,0,0
5275,True,0,No user reviews,0,0,0
5276,True,0,No user reviews,0,0,0
5277,True,0,No user reviews,0,0,0
5278,True,0,No user reviews,0,0,0
5279,True,0,No user reviews,0,0,0
5280,True,0,No user reviews,0,0,0
5281,True,0,No user reviews,0,0,0
5282,True,0,No user reviews,0,0,0
5283,True,0,No user reviews,0,0,0
5284,True,0,No user reviews,0,0,0
5285,True,0,No user reviews,0,0,0
5286,True,0,No user reviews,0,0,0
5287,True,0,No user reviews,0,0,0
5288,True,0,No user reviews,0,0,0
5289,True,0,No user reviews,0,0,0
5290,True,0,No user reviews,0,0,0
5291,True,0,No user reviews,0,0,0
5292,True,0,No user reviews,0,0,0
5293,True,0,No user reviews,0,0,0
5294,True,0,No user reviews,0,0,0
5295,True,0,No user reviews,0,0,0
5296,True,0,No user reviews,0,0,0
5297,True,0,No user reviews,0,0,0
5298,True,0,No user reviews,0,0,0
5299,True,0,No user reviews,0,0,0
5300,True,0,No user reviews,0,0,0
5301,True,0,No user reviews,0,0,0
5303,True,0,No user reviews,0,0,0
5304,True,0,No user reviews,0,0,0
5305,True,0,No user reviews,0,0,0
5306,True,0,No user reviews,0,0,0
5309,True,0,No user reviews,0,0,0
5310,True,0,No user reviews,0,0,0
5311,True,0,No user reviews,0,0,0
5312,True,0,No user reviews,0,0,0
5315,True,0,No user reviews,0,0,0
5316,True,0,No user reviews,0,0,0
5317,True,0,No user reviews,0,0,0
5319,True,0,No user reviews,0,0,0
5320,True,0,No user reviews,0,0,0
5321,True,0,No user reviews,0,0,0
5322,True,0,No user reviews,0,0,0
5323,True,0,No user reviews,0,0,0
5324,True,0,No user reviews,0,0,0
5325,True,0,No user reviews,0,0,0
5326,True,0,No user reviews,0,0,0
5327,True,0,No user reviews,0,0,0
5328,True,0,No user reviews,0,0,0
5329,True,0,No user reviews,0,0,0
5330,True,0,No user reviews,0,0,0
5331,True,0,No user reviews,0,0,0
5332,True,0,No user reviews,0,0,0
5333,True,0,No user reviews,0,0,0
5334,True,0,No user reviews,0,0,0
5335,True,0,No user reviews,0,0,0
5337,True,0,No user reviews,0,0,0
5338,True,0,No user reviews,0,0,0
5339,True,0,No user reviews,0,0,0
5340,True,0,No user reviews,0,0,0
5341,True,0,No user reviews,0,0,0
5342,True,0,No user reviews,0,0,0
5343,True,0,No user reviews,0,0,0
5344,True,0,No user reviews,0,0,0
5345,True,0,No user reviews,0,0,0
5346,True,0,No user reviews,0,0,0
5347,True,0,No user reviews,0,0,0
5348,True,0,No user reviews,0,0,0
5349,True,0,No user reviews,0,0,0
5350,True,0,No user reviews,0,0,0
5351,True,0,No user reviews,0,0,0
5353,True,0,No user reviews,0,0,0
5360,True,0,No user reviews,0,0,0
5361,True,0,No user reviews,0,0,0
5362,True,0,No user reviews,0,0,0
5363,True,0,No user reviews,0,0,0
5364,True,0,No user reviews,0,0,0
5365,True,0,No user reviews,0,0,0
5366,True,0,No user reviews,0,0,0
5367,True,0,No user reviews,0,0,0
5368,True,0,No user reviews,0,0,0
5369,True,0,No user reviews,0,0,0
5370,True,0,No user reviews,0,0,0
5371,True,0,No user reviews,0,0,0
5372,True,0,No user reviews,0,0,0
5374,True,0,No user reviews,0,0,0
5375,True,0,No user reviews,0,0,0
5376,True,0,No user reviews,0,0,0
5377,True,0,No user reviews,0,0,0
5378,True,0,No user reviews,0,0,0
5379,True,0,No user reviews,0,0,0
5386,True,0,No user reviews,0,0,0
5387,True,0,No user reviews,0,0,0
5388,True,0,No user reviews,0,0,0
5389,True,0,No user reviews,0,0,0
5390,True,0,No user reviews,0,0,0
5391,True,0,No user reviews,0,0,0
5392,True,0,No user reviews,0,0,0
5394,True,0,No user reviews,0,0,0
5395,True,0,No user reviews,0,0,0
5396,True,0,No user reviews,0,0,0
5397,True,0,No user reviews,0,0,0
5398,True,0,No user reviews,0,0,0
5399,True,0,No user reviews,0,0,0
5400,True,0,No user reviews,0,0,0
5401,True,0,No user reviews,0,0,0
5402,True,0,No user reviews,0,0,0
5404,True,0,No user reviews,0,0,0
5405,True,0,No user reviews,0,0,0
5406,True,0,No user reviews,0,0,0
5409,True,0,No user reviews,0,0,0
5410,True,0,No user reviews,0,0,0
5411,True,0,No user reviews,0,0,0
5414,True,0,No user reviews,0,0,0
5415,True,0,No user reviews,0,0,0
5416,True,0,No user reviews,0,0,0
5418,True,0,No user reviews,0,0,0
5419,True,0,No user reviews,0,0,0
5420,True,0,No user reviews,0,0,0
5422,True,0,No user reviews,0,0,0
5424,True,0,No user reviews,0,0,0
5426,True,0,No user reviews,0,0,0
5427,True,0,No user reviews,0,0,0
5428,True,0,No user reviews,0,0,0
5430,True,0,No user reviews,0,0,0
5433,True,0,No user reviews,0,0,0
5434,True,0,No user reviews,0,0,0
5435,True,0,No user reviews,0,0,0
5445,True,0,No user reviews,0,0,0
5446,True,0,No user reviews,0,0,0
5447,True,0,No user reviews,0,0,0
5449,True,0,No user reviews,0,0,0
5450,True,0,No user reviews,0,0,0
5451,True,0,No user reviews,0,0,0
5453,True,0,No user reviews,0,0,0
5455,True,0,No user reviews,0,0,0
5456,True,0,No user reviews,0,0,0
5457,True,0,No user reviews,0,0,0
5459,True,0,No user reviews,0,0,0
5460,True,0,No user reviews,0,0,0
5461,True,0,No user reviews,0,0,0
5462,True,0,No user reviews,0,0,0
5463,True,0,No user reviews,0,0,0
5464,True,0,No user reviews,0,0,0
5465,True,0,No user reviews,0,0,0
5467,True,0,No user reviews,0,0,0
5468,True,0,No user reviews,0,0,0
5470,True,0,No user reviews,0,0,0
5471,True,0,No user reviews,0,0,0
5472,True,0,No user reviews,0,0,0
5473,True,0,No user reviews,0,0,0
5474,True,0,No user reviews,0,0,0
5475,True,0,No user reviews,0,0,0
5476,True,0,No user reviews,0,0,0
5477,True,0,No user reviews,0,0,0
5478,True,0,No user reviews,0,0,0
5479,True,0,No user reviews,0,0,0
5480,True,0,No user reviews,0,0,0
5481,True,0,No user reviews,0,0,0
5483,True,0,No user reviews,0,0,0
5484,True,0,No user reviews,0,0,0
5486,True,0,No user reviews,0,0,0
5487,True,0,No user reviews,0,0,0
5488,True,0,No user reviews,0,0,0
5489,True,0,No user reviews,0,0,0
5492,True,0,No user reviews,0,0,0
5494,True,0,No user reviews,0,0,0
5495,True,0,No user reviews,0,0,0
5496,True,0,No user reviews,0,0,0
5497,True,0,No user reviews,0,0,0
5499,True,0,No user reviews,0,0,0
5500,True,0,No user reviews,0,0,0
5501,True,0,No user reviews,0,0,0
5502,True,0,No user reviews,0,0,0
5503,True,0,No user reviews,0,0,0
5504,True,0,No user reviews,0,0,0
5505,True,0,No user reviews,0,0,0
5507,True,0,No user reviews,0,0,0
5510,True,0,No user reviews,0,0,0
5511,True,0,No user reviews,0,0,0
5512,True,0,No user reviews,0,0,0
5513,True,0,No user reviews,0,0,0
5514,True,0,No user reviews,0,0,0
5515,True,0,No user reviews,0,0,0
5516,True,0,No user reviews,0,0,0
5517,True,0,No user reviews,0,0,0
5518,True,0,No user reviews,0,0,0
5519,True,0,No user reviews,0,0,0
5520,True,0,No user reviews,0,0,0
5521,True,0,No user reviews,0,0,0
5522,True,0,No user reviews,0,0,0
5523,True,0,No user reviews,0,0,0
5524,True,0,No user reviews,0,0,0
5525,True,0,No user reviews,0,0,0
5526,True,0,No user reviews,0,0,0
5527,True,0,No user reviews,0,0,0
5529,True,0,No user reviews,0,0,0
5530,True,0,No user reviews,0,0,0
5531,True,0,No user reviews,0,0,0
5532,True,0,No user reviews,0,0,0
5533,True,0,No user reviews,0,0,0
5534,True,0,No user reviews,0,0,0
5535,True,0,No user reviews,0,0,0
5536,True,0,No user reviews,0,0,0
5537,True,0,No user reviews,0,0,0
5538,True,0,No user reviews,0,0,0
5539,True,0,No user reviews,0,0,0
5540,True,0,No user reviews,0,0,0
5541,True,0,No user reviews,0,0,0
5542,True,0,No user reviews,0,0,0
5543,True,0,No user reviews,0,0,0
5544,True,0,No user reviews,0,0,0
5545,True,0,No user reviews,0,0,0
5546,True,0,No user reviews,0,0,0
5547,True,0,No user reviews,0,0,0
5549,True,0,No user reviews,0,0,0
5550,True,0,No user reviews,0,0,0
5551,True,0,No user reviews,0,0,0
5552,True,0,No user reviews,0,0,0
5553,True,0,No user reviews,0,0,0
5554,True,0,No user reviews,0,0,0
5555,True,0,No user reviews,0,0,0
5556,True,0,No user reviews,0,0,0
5557,True,0,No user reviews,0,0,0
5558,True,0,No user reviews,0,0,0
5559,True,0,No user reviews,0,0,0
5560,True,0,No user reviews,0,0,0
5561,True,0,No user reviews,0,0,0
5562,True,0,No user reviews,0,0,0
5563,True,0,No user reviews,0,0,0
5564,True,0,No user reviews,0,0,0
5565,True,0,No user reviews,0,0,0
5566,True,0,No user reviews,0,0,0
5567,True,0,No user reviews,0,0,0
5568,True,0,No user reviews,0,0,0
5569,True,0,No user reviews,0,0,0
5570,True,0,No user reviews,0,0,0
5571,True,0,No user reviews,0,0,0
5572,True,0,No user reviews,0,0,0
5573,True,0,No user reviews,0,0,0
5574,True,0,No user reviews,0,0,0
5575,True,0,No user reviews,0,0,0
5576,True,0,No user reviews,0,0,0
5577,True,0,No user reviews,0,0,0
5578,True,0,No user reviews,0,0,0
5579,True,0,No user reviews,0,0,0
5580,True,0,No user reviews,0,0,0
5581,True,0,No user reviews,0,0,0
5582,True,0,No user reviews,0,0,0
5583,True,0,No user reviews,0,0,0
5584,True,0,No user reviews,0,0,0
5585,True,0,No user reviews,0,0,0
5586,True,0,No user reviews,0,0,0
5587,True,0,No user reviews,0,0,0
5588,True,0,No user reviews,0,0,0
5589,True,0,No user reviews,0,0,0
5590,True,0,No user reviews,0,0,0
5591,True,0,No user reviews,0,0,0
5592,True,0,No user reviews,0,0,0
5593,True,0,No user reviews,0,0,0
5594,True,0,No user reviews,0,0,0
5595,True,0,No user reviews,0,0,0
5596,True,0,No user reviews,0,0,0
5597,True,0,No user reviews,0,0,0
5598,True,0,No user reviews,0,0,0
5599,True,0,No user reviews,0,0,0
5600,True,0,No user reviews,0,0,0
5601,True,0,No user reviews,0,0,0
5602,True,0,No user reviews,0,0,0
5603,True,0,No user reviews,0,0,0
5604,True,0,No user reviews,0,0,0
5605,True,0,No user reviews,0,0,0
5606,True,0,No user reviews,0,0,0
5607,True,0,No user reviews,0,0,0
5608,True,0,No user reviews,0,0,0
5609,True,0,No user reviews,0,0,0
5610,True,0,No user reviews,0,0,0
5611,True,0,No user reviews,0,0,0
5612,True,0,No user reviews,0,0,0
5613,True,0,No user reviews,0,0,0
5614,True,0,No user reviews,0,0,0
5615,True,0,No user reviews,0,0,0
5616,True,0,No user reviews,0,0,0
5617,True,0,No user reviews,0,0,0
5618,True,0,No user reviews,0,0,0
5619,True,0,No user reviews,0,0,0
5620,True,0,No user reviews,0,0,0
5621,True,0,No user reviews,0,0,0
5622,True,0,No user reviews,0,0,0
5623,True,0,No user reviews,0,0,0
5626,True,0,No user reviews,0,0,0
5627,True,0,No user reviews,0,0,0
5628,True,0,No user reviews,0,0,0
5629,True,0,No user reviews,0,0,0
5630,True,0,No user reviews,0,0,0
5631,True,0,No user reviews,0,0,0
5632,True,0,No user reviews,0,0,0
5633,True,0,No user reviews,0,0,0
5634,True,0,No user reviews,0,0,0
5635,True,0,No user reviews,0,0,0
5636,True,0,No user reviews,0,0,0
5637,True,0,No user reviews,0,0,0
5638,True,0,No user reviews,0,0,0
5639,True,0,No user reviews,0,0,0
5640,True,0,No user reviews,0,0,0
5641,True,0,No user reviews,0,0,0
5642,True,0,No user reviews,0,0,0
5643,True,0,No user reviews,0,0,0
5644,True,0,No user reviews,0,0,0
5645,True,0,No user reviews,0,0,0
5646,True,0,No user reviews,0,0,0
5647,True,0,No user reviews,0,0,0
5648,True,0,No user reviews,0,0,0
5649,True,0,No user reviews,0,0,0
5650,True,0,No user reviews,0,0,0
5651,True,0,No user reviews,0,0,0
5652,True,0,No user reviews,0,0,0
5653,True,0,No user reviews,0,0,0
5654,True,0,No user reviews,0,0,0
5655,True,0,No user reviews,0,0,0
5656,True,0,No user reviews,0,0,0
5657,True,0,No user reviews,0,0,0
5658,True,0,No user reviews,0,0,0
5659,True,0,No user reviews,0,0,0
5660,True,0,No user reviews,0,0,0
5661,True,0,No user reviews,0,0,0
5662,True,0,No user reviews,0,0,0
5663,True,0,No user reviews,0,0,0
5664,True,0,No user reviews,0,0,0
5665,True,0,No user reviews,0,0,0
5666,True,0,No user reviews,0,0,0
5667,True,0,No user reviews,0,0,0
5668,True,0,No user reviews,0,0,0
5669,True,0,No user reviews,0,0,0
5670,True,0,No user reviews,0,0,0
5671,True,0,No user reviews,0,0,0
5672,True,0,No user reviews,0,0,0
5673,True,0,No user reviews,0,0,0
5674,True,0,No user reviews,0,0,0
5675,True,0,No user reviews,0,0,0
5676,True,0,No user reviews,0,0,0
5677,True,0,No user reviews,0,0,0
5678,True,0,No user reviews,0,0,0
5679,True,0,No user reviews,0,0,0
5680,True,0,No user reviews,0,0,0
5681,True,0,No user reviews,0,0,0
5682,True,0,No user reviews,0,0,0
5683,True,0,No user reviews,0,0,0
5684,True,0,No user reviews,0,0,0
5685,True,0,No user reviews,0,0,0
5686,True,0,No user reviews,0,0,0
5687,True,0,No user reviews,0,0,0
5688,True,0,No user reviews,0,0,0
5689,True,0,No user reviews,0,0,0
5690,True,0,No user reviews,0,0,0
5691,True,0,No user reviews,0,0,0
5692,True,0,No user reviews,0,0,0
5693,True,0,No user reviews,0,0,0
5694,True,0,No user reviews,0,0,0
5695,True,0,No user reviews,0,0,0
5696,True,0,No user reviews,0,0,0
5697,True,0,No user reviews,0,0,0
5698,True,0,No user reviews,0,0,0
5699,True,0,No user reviews,0,0,0
5700,True,0,No user reviews,0,0,0
5701,True,0,No user reviews,0,0,0
5702,True,0,No user reviews,0,0,0
5703,True,0,No user reviews,0,0,0
5706,True,0,No user reviews,0,0,0
5707,True,0,No user reviews,0,0,0
5708,True,0,No user reviews,0,0,0
5709,True,0,No user reviews,0,0,0
5710,True,0,No user reviews,0,0,0
5711,True,0,No user reviews,0,0,0
5712,True,0,No user reviews,0,0,0
5713,True,0,No user reviews,0,0,0
5714,True,0,No user reviews,0,0,0
5715,True,0,No user reviews,0,0,0
5716,True,0,No user reviews,0,0,0
5717,True,0,No user reviews,0,0,0
5718,True,0,No user reviews,0,0,0
5719,True,0,No user reviews,0,0,0
5720,True,0,No user reviews,0,0,0
5721,True,0,No user reviews,0,0,0
5722,True,0,No user reviews,0,0,0
5724,True,0,No user reviews,0,0,0
5725,True,0,No user reviews,0,0,0
5726,True,0,No user reviews,0,0,0
5727,True,0,No user reviews,0,0,0
5728,True,0,No user reviews,0,0,0
5729,True,0,No user reviews,0,0,0
5730,True,0,No user reviews,0,0,0
5731,True,0,No user reviews,0,0,0
5732,True,0,No user reviews,0,0,0
5734,True,0,No user reviews,0,0,0
5735,True,0,No user reviews,0,0,0
5736,True,0,No user reviews,0,0,0
5737,True,0,No user reviews,0,0,0
5738,True,0,No user reviews,0,0,0
5739,True,0,No user reviews,0,0,0
5740,True,0,No user reviews,0,0,0
5741,True,0,No user reviews,0,0,0
5742,True,0,No user reviews,0,0,0
5743,True,0,No user reviews,0,0,0
5744,True,0,No user reviews,0,0,0
5745,True,0,No user reviews,0,0,0
5746,True,0,No user reviews,0,0,0
5747,True,0,No user reviews,0,0,0
5748,True,0,No user reviews,0,0,0
5749,True,0,No user reviews,0,0,0
5750,True,0,No user reviews,0,0,0
5751,True,0,No user reviews,0,0,0
5752,True,0,No user reviews,0,0,0
5753,True,0,No user reviews,0,0,0
5754,True,0,No user reviews,0,0,0
5755,True,0,No user reviews,0,0,0
5756,True,0,No user reviews,0,0,0
5757,True,0,No user reviews,0,0,0
5758,True,0,No user reviews,0,0,0
5759,True,0,No user reviews,0,0,0
5760,True,0,No user reviews,0,0,0
5761,True,0,No user reviews,0,0,0
5762,True,0,No user reviews,0,0,0
5763,True,0,No user reviews,0,0,0
5764,True,0,No user reviews,0,0,0
5765,True,0,No user reviews,0,0,0
5766,True,0,No user reviews,0,0,0
5767,True,0,No user reviews,0,0,0
5768,True,0,No user reviews,0,0,0
5769,True,0,No user reviews,0,0,0
5770,True,0,No user reviews,0,0,0
5771,True,0,No user reviews,0,0,0
5772,True,0,No user reviews,0,0,0
5773,True,0,No user reviews,0,0,0
5774,True,0,No user reviews,0,0,0
5775,True,0,No user reviews,0,0,0
5776,True,0,No user reviews,0,0,0
5777,True,0,No user reviews,0,0,0
5778,True,0,No user reviews,0,0,0
5779,True,0,No user reviews,0,0,0
5780,True,0,No user reviews,0,0,0
5781,True,0,No user reviews,0,0,0
5782,True,0,No user reviews,0,0,0
5783,True,0,No user reviews,0,0,0
5784,True,0,No user reviews,0,0,0
5785,True,0,No user reviews,0,0,0
5786,True,0,No user reviews,0,0,0
5787,True,0,No user reviews,0,0,0
5788,True,0,No user reviews,0,0,0
5789,True,0,No user reviews,0,0,0
5790,True,0,No user reviews,0,0,0
5791,True,0,No user reviews,0,0,0
5793,True,0,No user reviews,0,0,0
5794,True,0,No user reviews,0,0,0
5795,True,0,No user reviews,0,0,0
5796,True,0,No user reviews,0,0,0
5797,True,0,No user reviews,0,0,0
5798,True,0,No user reviews,0,0,0
5799,True,0,No user reviews,0,0,0
5801,True,0,No user reviews,0,0,0
5802,True,0,No user reviews,0,0,0
5803,True,0,No user reviews,0,0,0
5804,True,0,No user reviews,0,0,0
5805,True,0,No user reviews,0,0,0
5806,True,0,No user reviews,0,0,0
5807,True,0,No user reviews,0,0,0
5808,True,0,No user reviews,0,0,0
5809,True,0,No user reviews,0,0,0
5810,True,0,No user reviews,0,0,0
5811,True,0,No user reviews,0,0,0
5812,True,0,No user reviews,0,0,0
5813,True,0,No user reviews,0,0,0
5814,True,0,No user reviews,0,0,0
5815,True,0,No user reviews,0,0,0
5816,True,0,No user reviews,0,0,0
5817,True,0,No user reviews,0,0,0
5818,True,0,No user reviews,0,0,0
5819,True,0,No user reviews,0,0,0
5820,True,0,No user reviews,0,0,0
5821,True,0,No user reviews,0,0,0
5822,True,0,No user reviews,0,0,0
5823,True,0,No user reviews,0,0,0
5824,True,0,No user reviews,0,0,0
5825,True,0,No user reviews,0,0,0
5826,True,0,No user reviews,0,0,0
5827,True,0,No user reviews,0,0,0
5828,True,0,No user reviews,0,0,0
5829,True,0,No user reviews,0,0,0
5830,True,0,No user reviews,0,0,0
5831,True,0,No user reviews,0,0,0
5832,True,0,No user reviews,0,0,0
5833,True,0,No user reviews,0,0,0
5834,True,0,No user reviews,0,0,0
5835,True,0,No user reviews,0,0,0
5836,True,0,No user reviews,0,0,0
5837,True,0,No user reviews,0,0,0
5838,True,0,No user reviews,0,0,0
5839,True,0,No user reviews,0,0,0
5840,True,0,No user reviews,0,0,0
5841,True,0,No user reviews,0,0,0
5842,True,0,No user reviews,0,0,0
5843,True,0,No user reviews,0,0,0
5844,True,0,No user reviews,0,0,0
5845,True,0,No user reviews,0,0,0
5846,True,0,No user reviews,0,0,0
5847,True,0,No user reviews,0,0,0
5848,True,0,No user reviews,0,0,0
5849,True,0,No user reviews,0,0,0
5850,True,0,No user reviews,0,0,0
5851,True,0,No user reviews,0,0,0
5852,True,0,No user reviews,0,0,0
5853,True,0,No user reviews,0,0,0
5854,True,0,No user reviews,0,0,0
5855,True,0,No user reviews,0,0,0
5856,True,0,No user reviews,0,0,0
5857,True,0,No user reviews,0,0,0
5858,True,0,No user reviews,0,0,0
5859,True,0,No user reviews,0,0,0
5860,True,0,No user reviews,0,0,0
5861,True,0,No user reviews,0,0,0
5862,True,0,No user reviews,0,0,0
5863,True,0,No user reviews,0,0,0
5864,True,0,No user reviews,0,0,0
5865,True,0,No user reviews,0,0,0
5866,True,0,No user reviews,0,0,0
5867,True,0,No user reviews,0,0,0
5868,True,0,No user reviews,0,0,0
5869,True,0,No user reviews,0,0,0
5870,True,0,No user reviews,0,0,0
5871,True,0,No user reviews,0,0,0
5872,True,0,No user reviews,0,0,0
5873,True,0,No user reviews,0,0,0
5874,True,0,No user reviews,0,0,0
5875,True,0,No user reviews,0,0,0
5876,True,0,No user reviews,0,0,0
5877,True,0,No user reviews,0,0,0
5878,True,0,No user reviews,0,0,0
5879,True,0,No user reviews,0,0,0
5880,True,0,No user reviews,0,0,0
5881,True,0,No user reviews,0,0,0
5882,True,0,No user reviews,0,0,0
5883,True,0,No user reviews,0,0,0
5884,True,0,No user reviews,0,0,0
5885,True,0,No user reviews,0,0,0
5886,True,0,No user reviews,0,0,0
5887,True,0,No user reviews,0,0,0
5888,True,0,No user reviews,0,0,0
5889,True,0,No user reviews,0,0,0
5890,True,0,No user reviews,0,0,0
5891,True,0,No user reviews,0,0,0
5894,True,0,No user reviews,0,0,0
5895,True,0,No user reviews,0,0,0
5896,True,0,No user reviews,0,0,0
5897,True,0,No user reviews,0,0,0
5898,True,0,No user reviews,0,0,0
5899,True,0,No user reviews,0,0,0
5900,True,0,No user reviews,0,0,0
5901,True,0,No user reviews,0,0,0
5902,True,0,No user reviews,0,0,0
5903,True,0,No user reviews,0,0,0
5904,True,0,No user reviews,0,0,0
5905,True,0,No user reviews,0,0,0
5906,True,0,No user reviews,0,0,0
5907,True,0,No user reviews,0,0,0
5908,True,0,No user reviews,0,0,0
5909,True,0,No user reviews,0,0,0
5910,True,0,No user reviews,0,0,0
5911,True,0,No user reviews,0,0,0
5912,True,0,No user reviews,0,0,0
5913,True,0,No user reviews,0,0,0
5914,True,0,No user reviews,0,0,0
5915,True,0,No user reviews,0,0,0
5916,True,0,No user reviews,0,0,0
5917,True,0,No user reviews,0,0,0
5918,True,0,No user reviews,0,0,0
5921,True,0,No user reviews,0,0,0
5922,True,0,No user reviews,0,0,0
5926,True,0,No user reviews,0,0,0
5927,True,0,No user reviews,0,0,0
5928,True,0,No user reviews,0,0,0
5929,True,0,No user reviews,0,0,0
5930,True,0,No user reviews,0,0,0
5931,True,0,No user reviews,0,0,0
5932,True,0,No user reviews,0,0,0
5933,True,0,No user reviews,0,0,0
5934,True,0,No user reviews,0,0,0
5935,True,0,No user reviews,0,0,0
5936,True,0,No user reviews,0,0,0
5937,True,0,No user reviews,0,0,0
5938,True,0,No user reviews,0,0,0
5939,True,0,No user reviews,0,0,0
5940,True,0,No user reviews,0,0,0
5941,True,0,No user reviews,0,0,0
5942,True,0,No user reviews,0,0,0
5943,True,0,No user reviews,0,0,0
5944,True,0,No user reviews,0,0,0
5945,True,0,No user reviews,0,0,0
5946,True,0,No user reviews,0,0,0
5947,True,0,No user reviews,0,0,0
5949,True,0,No user reviews,0,0,0
5950,True,0,No user reviews,0,0,0
5951,True,0,No user reviews,0,0,0
5952,True,0,No user reviews,0,0,0
5954,True,0,No user reviews,0,0,0
5955,True,0,No user reviews,0,0,0
5956,True,0,No user reviews,0,0,0
5957,True,0,No user reviews,0,0,0
5958,True,0,No user reviews,0,0,0
5959,True,0,No user reviews,0,0,0
5960,True,0,No user reviews,0,0,0
5961,True,0,No user reviews,0,0,0
5962,True,0,No user reviews,0,0,0
5963,True,0,No user reviews,0,0,0
5964,True,0,No user reviews,0,0,0
5965,True,0,No user reviews,0,0,0
5966,True,0,No user reviews,0,0,0
5967,True,0,No user reviews,0,0,0
5968,True,0,No user reviews,0,0,0
5969,True,0,No user reviews,0,0,0
5970,True,0,No user reviews,0,0,0
5971,True,0,No user reviews,0,0,0
5972,True,0,No user reviews,0,0,0
5973,True,0,No user reviews,0,0,0
5974,True,0,No user reviews,0,0,0
5975,True,0,No user reviews,0,0,0
5976,True,0,No user reviews,0,0,0
5977,True,0,No user reviews,0,0,0
5979,True,0,No user reviews,0,0,0
5980,True,0,No user reviews,0,0,0
5981,True,0,No user reviews,0,0,0
5982,True,0,No user reviews,0,0,0
5983,True,0,No user reviews,0,0,0
5984,True,0,No user reviews,0,0,0
5985,True,0,No user reviews,0,0,0
5986,True,0,No user reviews,0,0,0
5987,True,0,No user reviews,0,0,0
5988,True,0,No user reviews,0,0,0
5989,True,0,No user reviews,0,0,0
5990,True,0,No user reviews,0,0,0
5991,True,0,No user reviews,0,0,0
5992,True,0,No user reviews,0,0,0
5993,True,0,No user reviews,0,0,0
5994,True,0,No user reviews,0,0,0
5995,True,0,No user reviews,0,0,0
5996,True,0,No user reviews,0,0,0
6000,True,8,Very Positive,5335,281,5616
6010,True,8,Very Positive,502,29,531
6020,True,9,Overwhelmingly Positive,4819,240,5059
6030,True,8,Very Positive,1650,165,1815
6040,True,8,Very Positive,449,44,493
6060,True,8,Very Positive,24929,1573,26502
6080,True,8,Very Positive,314,21,335
6090,True,8,Very Positive,104,7,111
6100,True,7,Positive,27,6,33
6110,True,0,No user reviews,0,0,0
6120,True,8,Very Positive,482,85,567
6122,True,0,No user reviews,0,0,0
6129,True,0,No user reviews,0,0,0
6130,True,0,No user reviews,0,0,0
6200,True,8,Very Positive,648,86,734
6210,True,6,Mostly Positive,58,23,81
6220,True,8,Very Positive,687,70,757
6230,True,0,No user reviews,0,0,0
6250,True,8,Very Positive,275,68,343
6260,True,0,1 user reviews,1,0,1
6270,True,5,Mixed,31,43,74
6290,True,0,No user reviews,0,0,0
6300,True,8,Very Positive,455,89,544
6310,True,8,Very Positive,863,80,943
6320,True,0,No user reviews,0,0,0
6330,True,0,No user reviews,0,0,0
6340,True,0,3 user reviews,3,0,3
6350,True,0,No user reviews,0,0,0
6360,True,0,No user reviews,0,0,0
6370,True,0,4 user reviews,4,0,4
6400,True,8,Very Positive,57,9,66
6410,True,0,No user reviews,0,0,0
6420,True,8,Very Positive,358,56,414
6510,True,6,Mostly Positive,271,96,367
6520,True,0,No user reviews,0,0,0
6530,True,0,No user reviews,0,0,0
6540,True,0,No user reviews,0,0,0
6550,True,5,Mixed,455,504,959
6570,True,5,Mixed,27,26,53
6580,True,0,No user reviews,0,0,0
6590,True,0,No user reviews,0,0,0
6600,True,5,Mixed,27,29,56
6610,True,0,No user reviews,0,0,0
6700,True,0,No user reviews,0,0,0
6720,True,0,No user reviews,0,0,0
6800,True,8,Very Positive,629,88,717
6810,True,8,Very Positive,168,35,203
6820,True,0,No user reviews,0,0,0
6830,True,8,Very Positive,544,126,670
6840,True,5,Mixed,129,120,249
6850,True,8,Very Positive,658,147,805
6860,True,8,Very Positive,3654,235,3889
6870,True,6,Mostly Positive,188,69,257
6880,True,5,Mixed,753,450,1203
6900,True,5,Mixed,574,313,887
6910,True,9,Overwhelmingly Positive,5622,267,5889
6920,True,5,Mixed,549,376,925
6930,True,0,No user reviews,0,0,0
6940,True,0,No user reviews,0,0,0
6950,True,0,No user reviews,0,0,0
6980,True,8,Very Positive,856,176,1032
7000,True,8,Very Positive,845,127,972
7010,True,6,Mostly Positive,150,52,202
7020,True,8,Very Positive,157,9,166
7030,True,0,No user reviews,0,0,0
7050,True,0,No user reviews,0,0,0
7060,True,5,Mixed,7,4,11
7080,True,0,No user reviews,0,0,0
7110,True,6,Mostly Positive,760,273,1033
7200,True,8,Very Positive,599,39,638
7203,True,0,No user reviews,0,0,0
7210,True,5,Mixed,119,64,183
7220,True,5,Mixed,34,39,73
7230,True,0,No user reviews,0,0,0
7240,True,0,No user reviews,0,0,0
7250,True,0,No user reviews,0,0,0
7260,True,5,Mixed,33,30,63
7270,True,0,No user reviews,0,0,0
7280,True,0,No user reviews,0,0,0
7290,True,0,No user reviews,0,0,0
7340,True,0,9 user reviews,7,2,9
7400,True,0,No user reviews,0,0,0
7410,True,0,No user reviews,0,0,0
7420,True,0,No user reviews,0,0,0
7430,True,0,No user reviews,0,0,0
7440,True,0,No user reviews,0,0,0
7450,True,0,No user reviews,0,0,0
7470,True,0,No user reviews,0,0,0
7490,True,0,No user reviews,0,0,0
7500,True,7,Positive,24,0,24
7510,True,5,Mixed,254,232,486
7520,True,5,Mixed,934,868,1802
7530,True,4,Mostly Negative,37,58,95
7600,True,5,Mixed,721,337,1058
7610,True,8,Very Positive,395,95,490
7620,True,8,Very Positive,496,62,558
7630,True,0,No user reviews,0,0,0
7650,True,8,Very Positive,299,23,322
7660,True,8,Very Positive,353,44,397
7670,True,8,Very Positive,9060,587,9647
7700,True,0,No user reviews,0,0,0
7710,True,0,No user reviews,0,0,0
7730,True,5,Mixed,36,32,68
7740,True,0,No user reviews,0,0,0
7760,True,9,Overwhelmingly Positive,1666,55,1721
7770,True,5,Mixed,78,87,165
7780,True,0,No user reviews,0,0,0
7790,True,0,No user reviews,0,0,0
7800,True,7,Positive,25,2,27
7810,True,0,No user reviews,0,0,0
7820,True,0,No user reviews,0,0,0
7830,True,8,Very Positive,735,138,873
7840,True,5,Mixed,14,16,30
7850,True,8,Very Positive,91,5,96
7860,True,5,Mixed,234,101,335
7870,True,0,8 user reviews,8,0,8
7880,True,0,1 user reviews,1,0,1
7890,True,0,No user reviews,0,0,0
7900,True,0,No user reviews,0,0,0
7910,True,0,1 user reviews,1,0,1
7920,True,0,No user reviews,0,0,0
7930,True,0,No user reviews,0,0,0
7940,True,8,Very Positive,5268,494,5762
7950,True,0,No user reviews,0,0,0
7980,True,0,2 user reviews,1,1,2
7990,True,0,2 user reviews,1,1,2
8000,True,8,Very Positive,1044,254,1298
8009,True,0,No user reviews,0,0,0
8010,True,0,No user reviews,0,0,0
8030,True,0,No user reviews,0,0,0
8040,True,7,Positive,12,1,13
8060,True,7,Positive,35,7,42
8070,True,0,No user reviews,0,0,0
8080,True,5,Mixed,427,304,731
8090,True,0,No user reviews,0,0,0
8100,True,5,Mixed,45,57,102
8110,True,0,No user reviews,0,0,0
8140,True,6,Mostly Positive,794,302,1096
8142,True,0,No user reviews,0,0,0
8150,True,0,No user reviews,0,0,0
8160,True,5,Mixed,15,12,27
8169,True,0,No user reviews,0,0,0
8170,True,5,Mixed,639,362,1001
8179,True,0,No user reviews,0,0,0
8180,True,0,No user reviews,0,0,0
8190,True,8,Very Positive,14693,1234,15927
8199,True,0,No user reviews,0,0,0
8200,True,8,Very Positive,216,26,242
8210,True,7,Positive,30,1,31
8220,True,7,Positive,22,2,24
8230,True,0,9 user reviews,9,0,9
8240,True,7,Positive,26,1,27
8250,True,7,Positive,22,0,22
8260,True,8,Very Positive,61,5,66
8270,True,7,Positive,18,4,22
8280,True,7,Positive,19,1,20
8290,True,7,Positive,23,0,23
8300,True,7,Positive,16,2,18
8310,True,5,Mixed,35,20,55
8320,True,5,Mixed,18,8,26
8330,True,5,Mixed,24,16,40
8340,True,8,Very Positive,176,10,186
8350,True,7,Positive,9,2,11
8360,True,0,8 user reviews,7,1,8
8370,True,0,8 user reviews,7,1,8
8380,True,0,7 user reviews,6,1,7
8400,True,8,Very Positive,490,47,537
8500,True,8,Very Positive,3572,751,4323
8510,True,0,No user reviews,0,0,0
8600,True,8,Very Positive,362,38,400
8610,True,0,No user reviews,0,0,0
8620,True,0,No user reviews,0,0,0
8630,True,0,No user reviews,0,0,0
8640,True,0,No user reviews,0,0,0
8650,True,0,No user reviews,0,0,0
8660,True,7,Positive,21,2,23
8662,True,0,No user reviews,0,0,0
8670,True,0,No user reviews,0,0,0
8680,True,0,No user reviews,0,0,0
8690,True,0,4 user reviews,3,1,4
8700,True,0,No user reviews,0,0,0
8710,True,0,No user reviews,0,0,0
8720,True,0,No user reviews,0,0,0
8730,True,0,No user reviews,0,0,0
8740,True,0,No user reviews,0,0,0
8750,True,0,No user reviews,0,0,0
8760,True,0,No user reviews,0,0,0
8770,True,0,No user reviews,0,0,0
8790,True,8,Very Positive,89,6,95
8800,True,9,Overwhelmingly Positive,1291,48,1339
8804,True,0,No user reviews,0,0,0
8820,True,0,No user reviews,0,0,0
8830,True,0,No user reviews,0,0,0
8840,True,0,3 user reviews,2,1,3
8850,True,8,Very Positive,3871,521,4392
8859,True,0,No user reviews,0,0,0
8870,True,8,Very Positive,32559,2106,34665
8880,True,5,Mixed,159,103,262
8890,True,8,Very Positive,101,15,116
8900,True,0,No user reviews,0,0,0
8910,True,0,No user reviews,0,0,0
8930,True,9,Overwhelmingly Positive,59911,2500,62411
8950,True,0,No user reviews,0,0,0
8955,True,0,No user reviews,0,0,0
8970,True,5,Mixed,21,11,32
8980,True,8,Very Positive,9468,680,10148
8989,True,0,No user reviews,0,0,0
8990,True,8,Very Positive,172,34,206
9000,True,8,Very Positive,177,28,205
9010,True,8,Very Positive,2028,187,2215
9030,True,8,Very Positive,124,12,136
9040,True,8,Very Positive,183,13,196
9050,True,8,Very Positive,2087,276,2363
9060,True,6,Mostly Positive,167,44,211
9070,True,8,Very Positive,255,40,295
9080,True,0,No user reviews,0,0,0
9090,True,0,No user reviews,0,0,0
9100,True,0,No user reviews,0,0,0
9120,True,0,No user reviews,0,0,0
9130,True,0,No user reviews,0,0,0
9160,True,6,Mostly Positive,218,59,277
9180,True,8,Very Positive,704,46,750
9200,True,6,Mostly Positive,3714,1463,5177
9219,True,0,No user reviews,0,0,0
9240,True,0,No user reviews,0,0,0
9241,True,0,No user reviews,0,0,0
9300,True,0,No user reviews,0,0,0
9310,True,8,Very Positive,413,47,460
9320,True,0,No user reviews,0,0,0
9330,True,0,No user reviews,0,0,0
9340,True,8,Very Positive,268,31,299
9350,True,8,Very Positive,559,82,641
9360,True,0,No user reviews,0,0,0
9370,True,0,No user reviews,0,0,0
9400,True,0,5 user reviews,3,2,5
9420,True,9,Overwhelmingly Positive,2949,103,3052
9440,True,0,No user reviews,0,0,0
9450,True,9,Overwhelmingly Positive,3533,182,3715
9460,True,5,Mixed,195,116,311
9480,True,6,Mostly Positive,3476,1040,4516
9500,True,5,Mixed,63,34,97
9510,True,0,No user reviews,0,0,0
9710,True,5,Mixed,17,24,41
9730,True,4,Mostly Negative,35,62,97
9740,True,7,Positive,26,4,30
9760,True,6,Mostly Positive,92,25,117
9800,True,5,Mixed,170,73,243
9810,True,0,No user reviews,0,0,0
9850,True,5,Mixed,25,21,46
9860,True,8,Very Positive,163,12,175
9870,True,8,Very Positive,955,65,1020
9880,True,5,Mixed,82,62,144
9885,True,0,No user reviews,0,0,0
9890,True,0,No user reviews,0,0,0
9900,True,6,Mostly Positive,460,161,621
9905,True,0,No user reviews,0,0,0
9906,True,0,No user reviews,0,0,0
9907,True,0,No user reviews,0,0,0
9908,True,5,Mixed,20,10,30
9910,True,0,No user reviews,0,0,0
9920,True,0,No user reviews,0,0,0
9932,True,0,No user reviews,0,0,0
9933,True,0,No user reviews,0,0,0
9940,True,8,Very Positive,427,96,523
9942,True,0,No user reviews,0,0,0
9949,True,0,No user reviews,0,0,0
9950,True,0,No user reviews,0,0,0
9960,True,5,Mixed,7,8,15
9970,True,4,Mostly Negative,4,15,19
9980,True,5,Mixed,29,14,43
9985,True,0,No user reviews,0,0,0
9990,True,5,Mixed,27,40,67
9992,True,0,No user reviews,0,0,0
9998,True,0,No user reviews,0,0,0
10000,True,0,8 user reviews,8,0,8
10010,True,0,No user reviews,0,0,0
10030,True,0,No user reviews,0,0,0
10040,True,0,No user reviews,0,0,0
10050,True,0,No user reviews,0,0,0
10080,True,0,9 user reviews,9,0,9
10090,True,8,Very Positive,19096,1210,20306
10100,True,8,Very Positive,96,24,120
10110,True,8,Very Positive,119,27,146
10120,True,5,Mixed,10,15,25
10130,True,6,Mostly Positive,284,106,390
10140,True,5,Mixed,44,24,68
10150,True,6,Mostly Positive,1803,600,2403
10159,True,0,No user reviews,0,0,0
10170,True,7,Positive,32,1,33
10180,True,8,Very Positive,8537,1002,9539
10190,True,8,Very Positive,1487,131,1618
10195,True,5,Mixed,26,18,44
10196,True,5,Mixed,15,19,34
10197,True,0,No user reviews,0,0,0
10199,True,0,No user reviews,0,0,0
10220,True,4,Mostly Negative,239,538,777
10230,True,4,Mostly Negative,19,47,66
10240,True,5,Mixed,9,6,15
10250,True,5,Mixed,10,13,23
10260,True,0,9 user reviews,4,5,9
10270,True,5,Mixed,108,100,208
10400,True,0,No user reviews,0,0,0
10410,True,0,No user reviews,0,0,0
10420,True,0,No user reviews,0,0,0
10430,True,8,Very Positive,41,9,50
10440,True,0,No user reviews,0,0,0
10460,True,5,Mixed,30,27,57
10470,True,0,No user reviews,0,0,0
10480,True,0,No user reviews,0,0,0
10490,True,0,No user reviews,0,0,0
10500,True,8,Very Positive,5823,785,6608
10510,True,0,No user reviews,0,0,0
10519,True,0,No user reviews,0,0,0
10520,True,0,No user reviews,0,0,0
10540,True,0,1 user reviews,1,0,1
10545,True,0,No user reviews,0,0,0
10546,True,0,No user reviews,0,0,0
10560,True,0,No user reviews,0,0,0
10570,True,0,No user reviews,0,0,0
10590,True,0,No user reviews,0,0,0
10600,True,7,Positive,36,4,40
10601,True,0,No user reviews,0,0,0
10602,True,0,No user reviews,0,0,0
10603,True,0,No user reviews,0,0,0
10604,True,7,Positive,32,8,40
10605,True,0,No user reviews,0,0,0
10606,True,5,Mixed,36,26,62
10607,True,6,Mostly Positive,42,13,55
10608,True,7,Positive,16,1,17
10609,True,0,No user reviews,0,0,0
10620,True,0,No user reviews,0,0,0
10630,True,0,No user reviews,0,0,0
10640,True,0,No user reviews,0,0,0
10650,True,0,5 user reviews,3,2,5
10660,True,0,No user reviews,0,0,0
10680,True,8,Very Positive,3894,550,4444
10690,True,0,2 user reviews,2,0,2
10695,True,5,Mixed,14,7,21
10696,True,0,No user reviews,0,0,0
10697,True,6,Mostly Positive,12,4,16
10699,True,0,No user reviews,0,0,0
10700,True,0,No user reviews,0,0,0
11000,True,0,No user reviews,0,0,0
11020,True,8,Very Positive,45,7,52
11040,True,5,Mixed,69,30,99
11050,True,5,Mixed,46,23,69
11060,True,0,1 user reviews,0,1,1
11070,True,0,No user reviews,0,0,0
11080,True,0,No user reviews,0,0,0
11090,True,0,No user reviews,0,0,0
11120,True,0,No user reviews,0,0,0
11130,True,2,Very Negative,9,58,67
11140,True,6,Mostly Positive,104,42,146
11150,True,5,Mixed,64,45,109
11170,True,7,Positive,14,3,17
11172,True,0,No user reviews,0,0,0
11179,True,0,No user reviews,0,0,0
11180,True,4,Mostly Negative,29,66,95
11190,True,6,Mostly Positive,173,63,236
11200,True,5,Mixed,134,90,224
11202,True,0,No user reviews,0,0,0
11220,True,0,No user reviews,0,0,0
11230,True,5,Mixed,78,39,117
11240,True,5,Mixed,173,147,320
11250,True,0,6 user reviews,4,2,6
11260,True,5,Mixed,38,43,81
11270,True,0,No user reviews,0,0,0
11280,True,8,Very Positive,381,36,417
11330,True,8,Very Positive,223,51,274
11340,True,6,Mostly Positive,170,56,226
11350,True,0,No user reviews,0,0,0
11360,True,6,Mostly Positive,149,58,207
11370,True,5,Mixed,68,58,126
11390,True,5,Mixed,204,173,377
11420,True,8,Very Positive,140,13,153
11424,True,0,No user reviews,0,0,0
11440,True,7,Positive,26,2,28
11450,True,8,Very Positive,1313,130,1443
11460,True,0,No user reviews,0,0,0
11470,True,0,No user reviews,0,0,0
11480,True,6,Mostly Positive,121,31,152
11500,True,0,2 user reviews,1,1,2
11520,True,0,No user reviews,0,0,0
11550,True,7,Positive,15,0,15
11560,True,5,Mixed,23,16,39
11590,True,5,Mixed,69,100,169
11600,True,0,No user reviews,0,0,0
11602,True,0,No user reviews,0,0,0
11603,True,0,No user reviews,0,0,0
11604,True,0,No user reviews,0,0,0
11605,True,0,No user reviews,0,0,0
11610,True,5,Mixed,12,15,27
11900,True,6,Mostly Positive,33,9,42
11910,True,0,No user reviews,0,0,0
11920,True,6,Mostly Positive,9,3,12
12100,True,8,Very Positive,2234,409,2643
12110,True,8,Very Positive,4543,541,5084
12120,True,8,Very Positive,12482,1752,14234
12130,True,5,Mixed,490,261,751
12140,True,8,Very Positive,2688,343,3031
12150,True,8,Very Positive,1686,118,1804
12170,True,6,Mostly Positive,94,27,121
12180,True,8,Very Positive,78,11,89
12190,True,0,3 user reviews,3,0,3
12200,True,6,Mostly Positive,4701,1179,5880
12210,True,5,Mixed,15294,8454,23748
12219,True,0,No user reviews,0,0,0
12230,True,0,No user reviews,0,0,0
12240,True,8,Very Positive,4544,541,5085
12250,True,7,Positive,37,1,38
12260,True,0,No user reviews,0,0,0
12300,True,0,No user reviews,0,0,0
12310,True,6,Mostly Positive,34,12,46
12320,True,6,Mostly Positive,550,173,723
12330,True,8,Very Positive,201,48,249
12340,True,5,Mixed,28,17,45
12360,True,8,Very Positive,697,171,868
12364,True,0,No user reviews,0,0,0
12370,True,7,Positive,27,4,31
12380,True,0,1 user reviews,1,0,1
12390,True,5,Mixed,34,31,65
12392,True,0,No user reviews,0,0,0
12400,True,0,No user reviews,0,0,0
12420,True,3,Negative,5,25,30
12430,True,4,Mostly Negative,13,52,65
12440,True,5,Mixed,10,13,23
12450,True,5,Mixed,9,7,16
12460,True,5,Mixed,41,32,73
12470,True,5,Mixed,107,52,159
12480,True,5,Mixed,32,41,73
12500,True,8,Very Positive,410,62,472
12510,True,2,Very Negative,15,81,96
12520,True,6,Mostly Positive,157,54,211
12530,True,6,Mostly Positive,19,5,24
12540,True,7,Positive,9,1,10
12550,True,5,Mixed,4,6,10
12560,True,5,Mixed,11,16,27
12570,True,0,5 user reviews,4,1,5
12580,True,0,2 user reviews,1,1,2
12590,True,5,Mixed,20,12,32
12600,True,3,Negative,3,18,21
12630,True,0,7 user reviews,4,3,7
12640,True,6,Mostly Positive,114,36,150
12650,True,0,2 user reviews,0,2,2
12660,True,0,4 user reviews,3,1,4
12670,True,0,5 user reviews,2,3,5
12690,True,6,Mostly Positive,80,21,101
12710,True,8,Very Positive,471,39,510
12720,True,0,No user reviews,0,0,0
12750,True,8,Very Positive,964,151,1115
12770,True,6,Mostly Positive,87,34,121
12790,True,5,Mixed,51,55,106
12799,True,0,No user reviews,0,0,0
12800,True,8,Very Positive,75,6,81
12810,True,8,Very Positive,946,193,1139
12819,True,0,No user reviews,0,0,0
12820,True,0,No user reviews,0,0,0
12830,True,5,Mixed,364,225,589
12840,True,8,Very Positive,244,13,257
12849,True,0,No user reviews,0,0,0
12850,True,0,No user reviews,0,0,0
12860,True,0,2 user reviews,2,0,2
12880,True,0,No user reviews,0,0,0
12890,True,0,No user reviews,0,0,0
12900,True,9,Overwhelmingly Positive,5176,235,5411
12910,True,0,No user reviews,0,0,0
13000,True,7,Positive,34,3,37
13010,True,0,No user reviews,0,0,0
13120,True,0,No user reviews,0,0,0
13140,True,0,7 user reviews,3,4,7
13180,True,0,No user reviews,0,0,0
13200,True,5,Mixed,131,65,196
13210,True,8,Very Positive,926,148,1074
13230,True,9,Overwhelmingly Positive,1574,44,1618
13240,True,9,Overwhelmingly Positive,1570,46,1616
13250,True,8,Very Positive,579,36,615
13260,True,0,No user reviews,0,0,0
13500,True,8,Very Positive,404,90,494
13510,True,5,Mixed,51,29,80
13520,True,6,Mostly Positive,1653,465,2118
13530,True,6,Mostly Positive,234,89,323
13540,True,6,Mostly Positive,259,81,340
13560,True,8,Very Positive,727,110,837
13570,True,8,Very Positive,1547,124,1671
13580,True,4,Mostly Negative,182,370,552
13600,True,8,Very Positive,627,116,743
13620,True,7,Positive,35,2,37
13630,True,7,Positive,36,4,40
13640,True,5,Mixed,29,31,60
13650,True,0,No user reviews,0,0,0
13660,True,0,No user reviews,0,0,0
13700,True,7,Positive,10,2,12
15000,True,5,Mixed,64,60,124
15060,True,0,2 user reviews,2,0,2
15080,True,6,Mostly Positive,175,46,221
15100,True,8,Very Positive,3124,756,3880
15120,True,8,Very Positive,1840,296,2136
15130,True,8,Very Positive,1045,190,1235
15140,True,0,4 user reviews,1,3,4
15150,True,7,Positive,37,8,45
15160,True,5,Mixed,34,16,50
15170,True,8,Very Positive,557,110,667
15190,True,8,Very Positive,421,79,500
15200,True,6,Mostly Positive,258,105,363
15210,True,8,Very Positive,660,118,778
15220,True,5,Mixed,10,12,22
15240,True,8,Very Positive,84,14,98
15260,True,0,2 user reviews,2,0,2
15270,True,8,Very Positive,167,35,202
15280,True,0,No user reviews,0,0,0
15290,True,0,2 user reviews,1,1,2
15300,True,8,Very Positive,499,27,526
15310,True,6,Mostly Positive,55,22,77
15320,True,8,Very Positive,970,110,1080
15330,True,0,No user reviews,0,0,0
15350,True,0,5 user reviews,3,2,5
15360,True,0,No user reviews,0,0,0
15370,True,8,Very Positive,368,33,401
15380,True,8,Very Positive,44,10,54
15390,True,8,Very Positive,572,72,644
15396,True,0,No user reviews,0,0,0
15400,True,6,Mostly Positive,61,17,78
15500,True,6,Mostly Positive,284,91,375
15510,True,0,No user reviews,0,0,0
15520,True,8,Very Positive,424,84,508
15522,True,0,4 user reviews,2,2,4
15529,True,0,No user reviews,0,0,0
15530,True,0,No user reviews,0,0,0
15540,True,4,Mostly Negative,111,289,400
15550,True,0,No user reviews,0,0,0
15560,True,8,Very Positive,309,52,361
15620,True,8,Very Positive,2095,327,2422
15640,True,0,No user reviews,0,0,0
15660,True,0,No user reviews,0,0,0
15669,True,0,No user reviews,0,0,0
15680,True,0,No user reviews,0,0,0
15700,True,8,Very Positive,883,86,969
15710,True,9,Overwhelmingly Positive,547,22,569
15720,True,0,No user reviews,0,0,0
15730,True,0,No user reviews,0,0,0
15740,True,6,Mostly Positive,387,120,507
15750,True,8,Very Positive,650,103,753
15800,True,0,2 user reviews,1,1,2
15810,True,0,No user reviews,0,0,0
15900,True,6,Mostly Positive,12,4,16
15902,True,0,No user reviews,0,0,0
15910,True,0,8 user reviews,6,2,8
15912,True,0,No user reviews,0,0,0
15920,True,3,Negative,2,10,12
15922,True,0,No user reviews,0,0,0
15930,True,7,Positive,21,2,23
15932,True,0,No user reviews,0,0,0
15940,True,0,2 user reviews,2,0,2
15942,True,0,No user reviews,0,0,0
15952,True,0,No user reviews,0,0,0
15960,True,5,Mixed,8,5,13
15962,True,0,No user reviews,0,0,0
15970,True,5,Mixed,13,8,21
15972,True,0,No user reviews,0,0,0
15980,True,0,No user reviews,0,0,0
15982,True,0,No user reviews,0,0,0
15990,True,0,5 user reviews,5,0,5
15992,True,0,No user reviews,0,0,0
16000,True,0,5 user reviews,2,3,5
16002,True,0,No user reviews,0,0,0
16020,True,0,7 user reviews,5,2,7
16022,True,0,No user reviews,0,0,0
16030,True,7,Positive,10,1,11
16032,True,0,No user reviews,0,0,0
16040,True,5,Mixed,8,5,13
16042,True,0,No user reviews,0,0,0
16060,True,5,Mixed,7,6,13
16062,True,0,No user reviews,0,0,0
16090,True,0,No user reviews,0,0,0
16098,True,0,No user reviews,0,0,0
16100,True,7,Positive,30,7,37
16110,True,7,Positive,19,2,21
16120,True,8,Very Positive,52,5,57
16130,True,7,Positive,36,5,41
16140,True,0,No user reviews,0,0,0
16150,True,0,No user reviews,0,0,0
16160,True,0,No user reviews,0,0,0
16170,True,0,No user reviews,0,0,0
16180,True,7,Positive,41,8,49
16190,True,0,No user reviews,0,0,0
16200,True,6,Mostly Positive,20,6,26
16210,True,0,No user reviews,0,0,0
16300,True,8,Very Positive,80,7,87
16420,True,0,No user reviews,0,0,0
16450,True,8,Very Positive,1114,243,1357
16465,True,5,Mixed,45,22,67
16470,True,0,No user reviews,0,0,0
16475,True,0,No user reviews,0,0,0
16479,True,0,No user reviews,0,0,0
16480,True,0,No user reviews,0,0,0
16500,True,0,8 user reviews,6,2,8
16510,True,0,No user reviews,0,0,0
16600,True,8,Very Positive,116,28,144
16610,True,0,No user reviews,0,0,0
16620,True,5,Mixed,18,12,30
16630,True,0,No user reviews,0,0,0
16700,True,8,Very Positive,90,5,95
16710,True,6,Mostly Positive,115,49,164
16720,True,5,Mixed,471,363,834
16730,True,5,Mixed,503,440,943
16810,True,8,Very Positive,343,60,403
16830,True,0,No user reviews,0,0,0
16860,True,5,Mixed,13,10,23
16861,True,5,Mixed,15,7,22
16862,True,5,Mixed,15,11,26
16863,True,6,Mostly Positive,14,4,18
16864,True,0,No user reviews,0,0,0
16865,True,0,No user reviews,0,0,0
16866,True,7,Positive,21,5,26
16867,True,7,Positive,29,6,35
16868,True,8,Very Positive,48,5,53
16870,True,8,Very Positive,157,19,176
16871,True,0,No user reviews,0,0,0
16872,True,0,No user reviews,0,0,0
16879,True,0,No user reviews,0,0,0
16900,True,8,Very Positive,1002,167,1169
17000,True,0,No user reviews,0,0,0
17020,True,6,Mostly Positive,207,66,273
17030,True,0,No user reviews,0,0,0
17040,True,0,No user reviews,0,0,0
17050,True,0,No user reviews,0,0,0
17080,True,5,Mixed,24,17,41
17095,True,7,Positive,11,0,11
17096,True,0,No user reviews,0,0,0
17097,True,5,Mixed,6,9,15
17100,True,8,Very Positive,164,34,198
17110,True,0,No user reviews,0,0,0
17120,True,8,Very Positive,54,12,66
17140,True,6,Mostly Positive,86,28,114
17180,True,7,Positive,16,4,20
17210,True,0,No user reviews,0,0,0
17220,True,0,No user reviews,0,0,0
17300,True,8,Very Positive,3385,826,4211
17310,True,0,No user reviews,0,0,0
17311,True,0,No user reviews,0,0,0
17312,True,0,No user reviews,0,0,0
17330,True,8,Very Positive,803,163,966
17340,True,0,7 user reviews,7,0,7
17390,True,8,Very Positive,12620,1513,14133
17400,True,0,1 user reviews,1,0,1
17410,True,8,Very Positive,8587,1349,9936
17420,True,0,5 user reviews,4,1,5
17430,True,5,Mixed,1247,577,1824
17440,True,8,Very Positive,411,72,483
17450,True,8,Very Positive,2257,205,2462
17460,True,8,Very Positive,7709,466,8175
17470,True,8,Very Positive,5040,646,5686
17480,True,8,Very Positive,2177,532,2709
17500,True,7,Positive,23,3,26
17505,True,0,No user reviews,0,0,0
17510,True,7,Positive,12,2,14
17515,True,0,No user reviews,0,0,0
17520,True,7,Positive,36,3,39
17525,True,0,No user reviews,0,0,0
17530,True,0,1 user reviews,1,0,1
17535,True,0,No user reviews,0,0,0
17550,True,0,4 user reviews,4,0,4
17555,True,0,No user reviews,0,0,0
17570,True,8,Very Positive,50,3,53
17575,True,0,No user reviews,0,0,0
17580,True,0,1 user reviews,1,0,1
17585,True,0,No user reviews,0,0,0
17590,True,0,No user reviews,0,0,0
17595,True,0,No user reviews,0,0,0
17600,True,0,No user reviews,0,0,0
17700,True,6,Mostly Positive,10,3,13
17705,True,0,No user reviews,0,0,0
17710,True,6,Mostly Positive,680,189,869
17714,True,0,No user reviews,0,0,0
17730,True,0,1 user reviews,1,0,1
17740,True,6,Mostly Positive,11,3,14
17750,True,0,No user reviews,0,0,0
17760,True,0,No user reviews,0,0,0
17790,True,0,No user reviews,0,0,0
17800,True,0,No user reviews,0,0,0
17810,True,0,No user reviews,0,0,0
18000,True,8,Very Positive,249,22,271
18010,True,0,No user reviews,0,0,0
18020,True,8,Very Positive,85,14,99
18030,True,0,No user reviews,0,0,0
18040,True,8,Very Positive,261,17,278
18049,True,0,No user reviews,0,0,0
18050,True,8,Very Positive,62,10,72
18052,True,0,No user reviews,0,0,0
18053,True,0,No user reviews,0,0,0
18059,True,0,No user reviews,0,0,0
18060,True,0,No user reviews,0,0,0
18061,True,0,No user reviews,0,0,0
18070,True,6,Mostly Positive,66,21,87
18080,True,0,3 user reviews,3,0,3
18081,True,0,No user reviews,0,0,0
18100,True,0,No user reviews,0,0,0
18110,True,8,Very Positive,213,26,239
18112,True,0,No user reviews,0,0,0
18119,True,0,No user reviews,0,0,0
18120,True,6,Mostly Positive,90,30,120
18300,True,6,Mostly Positive,166,53,219
18310,True,0,No user reviews,0,0,0
18400,True,5,Mixed,35,26,61
18403,True,0,No user reviews,0,0,0
18407,True,0,4 user reviews,2,2,4
18408,True,0,2 user reviews,1,1,2
18420,True,7,Positive,33,6,39
18430,True,0,No user reviews,0,0,0
18440,True,0,No user reviews,0,0,0
18450,True,0,2 user reviews,2,0,2
18460,True,0,2 user reviews,2,0,2
18470,True,5,Mixed,19,9,28
18480,True,5,Mixed,12,8,20
18490,True,7,Positive,38,7,45
18500,True,9,Overwhelmingly Positive,2441,76,2517
18507,True,0,No user reviews,0,0,0
18508,True,0,4 user reviews,4,0,4
18509,True,0,1 user reviews,1,0,1
18510,True,0,No user reviews,0,0,0
18520,True,0,2 user reviews,1,1,2
18521,True,0,1 user reviews,1,0,1
18522,True,7,Positive,21,1,22
18523,True,0,7 user reviews,7,0,7
18530,True,0,No user reviews,0,0,0
18531,True,0,No user reviews,0,0,0
18532,True,0,No user reviews,0,0,0
18533,True,0,No user reviews,0,0,0
18534,True,0,No user reviews,0,0,0
18600,True,7,Positive,8,2,10
18610,True,0,No user reviews,0,0,0
18700,True,6,Mostly Positive,122,47,169
18709,True,0,No user reviews,0,0,0
18710,True,0,No user reviews,0,0,0
18800,True,0,No user reviews,0,0,0
18820,True,8,Very Positive,135,33,168
19000,True,5,Mixed,200,225,425
19020,True,5,Mixed,8,5,13
19030,True,5,Mixed,47,21,68
19060,True,0,No user reviews,0,0,0
19080,True,0,7 user reviews,1,6,7
19090,True,7,Positive,10,0,10
19200,True,6,Mostly Positive,135,52,187
19210,True,0,No user reviews,0,0,0
19320,True,0,3 user reviews,2,1,3
19330,True,0,No user reviews,0,0,0
19500,True,3,Negative,4,38,42
19510,True,0,No user reviews,0,0,0
19680,True,8,Very Positive,3107,488,3595
19800,True,8,Very Positive,224,43,267
19810,True,7,Positive,18,3,21
19830,True,8,Very Positive,648,52,700
19840,True,0,No user reviews,0,0,0
19890,True,0,No user reviews,0,0,0
19900,True,6,Mostly Positive,3774,1105,4879
19910,True,0,No user reviews,0,0,0
19930,True,6,Mostly Positive,88,33,121
19940,True,0,No user reviews,0,0,0
19950,True,0,No user reviews,0,0,0
19960,True,0,No user reviews,0,0,0
19970,True,0,No user reviews,0,0,0
19980,True,6,Mostly Positive,610,172,782
19989,True,0,No user reviews,0,0,0
19990,True,0,No user reviews,0,0,0
19999,True,0,No user reviews,0,0,0
20004,True,0,No user reviews,0,0,0
20005,True,0,No user reviews,0,0,0
20200,True,0,7 user reviews,1,6,7
20202,True,0,No user reviews,0,0,0
20400,True,0,No user reviews,0,0,0
20500,True,8,Very Positive,3220,316,3536
20509,True,0,No user reviews,0,0,0
20510,True,8,Very Positive,1856,408,2264
20520,True,0,No user reviews,0,0,0
20530,True,8,Very Positive,851,128,979
20540,True,8,Very Positive,565,34,599
20550,True,5,Mixed,200,189,389
20560,True,0,No user reviews,0,0,0
20570,True,8,Very Positive,551,61,612
20589,True,0,No user reviews,0,0,0
20590,True,7,Positive,14,0,14
20700,True,8,Very Positive,47,11,58
20710,True,8,Very Positive,47,9,56
20720,True,0,No user reviews,0,0,0
20730,True,0,No user reviews,0,0,0
20820,True,8,Very Positive,344,14,358
20828,True,0,7 user reviews,7,0,7
20840,True,7,Positive,10,0,10
20900,True,8,Very Positive,14028,2509,16537
20902,True,0,1 user reviews,1,0,1
20920,True,8,Very Positive,15609,2185,17794
20929,True,0,No user reviews,0,0,0
20930,True,0,No user reviews,0,0,0
21000,True,8,Very Positive,831,183,1014
21010,True,5,Mixed,100,59,159
21019,True,0,No user reviews,0,0,0
21020,True,0,No user reviews,0,0,0
21030,True,5,Mixed,35,19,54
21039,True,0,No user reviews,0,0,0
21040,True,0,No user reviews,0,0,0
21070,True,0,2 user reviews,1,1,2
21080,True,0,3 user reviews,2,1,3
21089,True,0,No user reviews,0,0,0
21090,True,8,Very Positive,3366,211,3577
21100,True,5,Mixed,1101,648,1749
21110,True,8,Very Positive,94,15,109
21120,True,8,Very Positive,56,8,64
21130,True,6,Mostly Positive,1017,275,1292
21140,True,0,2 user reviews,2,0,2
21150,True,0,No user reviews,0,0,0
21160,True,0,No user reviews,0,0,0
21170,True,8,Very Positive,129,19,148
21180,True,0,No user reviews,0,0,0
21200,True,0,3 user reviews,3,0,3
21201,True,0,1 user reviews,1,0,1
21202,True,0,No user reviews,0,0,0
21204,True,0,1 user reviews,1,0,1
21205,True,0,No user reviews,0,0,0
21206,True,0,No user reviews,0,0,0
21207,True,0,No user reviews,0,0,0
21209,True,0,1 user reviews,1,0,1
21210,True,0,1 user reviews,1,0,1
21212,True,0,1 user reviews,1,0,1
21213,True,0,1 user reviews,1,0,1
21214,True,0,1 user reviews,1,0,1
21215,True,0,1 user reviews,1,0,1
21216,True,0,No user reviews,0,0,0
21217,True,0,No user reviews,0,0,0
21218,True,0,No user reviews,0,0,0
21219,True,0,No user reviews,0,0,0
21220,True,0,No user reviews,0,0,0
21221,True,0,No user reviews,0,0,0
21222,True,0,1 user reviews,1,0,1
21223,True,0,No user reviews,0,0,0
21224,True,0,No user reviews,0,0,0
21300,True,7,Positive,17,4,21
21310,True,0,No user reviews,0,0,0
21400,True,0,3 user reviews,2,1,3
21410,True,0,No user reviews,0,0,0
21500,True,0,6 user reviews,3,3,6
21510,True,0,No user reviews,0,0,0
21600,True,4,Mostly Negative,51,94,145
21610,True,0,2 user reviews,2,0,2
21612,True,0,No user reviews,0,0,0
21620,True,0,1 user reviews,0,1,1
21630,True,0,No user reviews,0,0,0
21640,True,6,Mostly Positive,45,14,59
21649,True,0,No user reviews,0,0,0
21650,True,0,No user reviews,0,0,0
21660,True,5,Mixed,182,87,269
21669,True,0,No user reviews,0,0,0
21670,True,6,Mostly Positive,303,117,420
21679,True,0,No user reviews,0,0,0
21680,True,6,Mostly Positive,266,101,367
21690,True,8,Very Positive,3817,756,4573
21699,True,0,No user reviews,0,0,0
21730,True,5,Mixed,7,4,11
21750,True,0,1 user reviews,1,0,1
21760,True,6,Mostly Positive,286,105,391
21780,True,8,Very Positive,227,35,262
21800,True,6,Mostly Positive,231,71,302
21809,True,0,No user reviews,0,0,0
21900,True,6,Mostly Positive,79,28,107
21909,True,0,No user reviews,0,0,0
21910,True,8,Very Positive,294,50,344
21920,True,0,1 user reviews,1,0,1
21929,True,0,No user reviews,0,0,0
21930,True,0,No user reviews,0,0,0
21940,True,0,No user reviews,0,0,0
21950,True,0,1 user reviews,1,0,1
21960,True,0,No user reviews,0,0,0
21963,True,0,No user reviews,0,0,0
21964,True,0,No user reviews,0,0,0
21970,True,8,Very Positive,787,75,862
21979,True,0,No user reviews,0,0,0
21980,True,6,Mostly Positive,625,159,784
21989,True,0,No user reviews,0,0,0
21990,True,0,1 user reviews,1,0,1
21995,True,0,5 user reviews,4,1,5
21996,True,7,Positive,9,2,11
21999,True,0,No user reviews,0,0,0
22000,True,8,Very Positive,1573,136,1709
22010,True,0,No user reviews,0,0,0
22100,True,8,Very Positive,1482,137,1619
22110,True,0,No user reviews,0,0,0
22120,True,8,Very Positive,942,64,1006
22130,True,8,Very Positive,153,34,187
22140,True,5,Mixed,167,162,329
22150,True,0,No user reviews,0,0,0
22160,True,0,No user reviews,0,0,0
22170,True,0,No user reviews,0,0,0
22180,True,8,Very Positive,1061,134,1195
22200,True,8,Very Positive,987,136,1123
22208,True,0,No user reviews,0,0,0
22220,True,0,No user reviews,0,0,0
22230,True,8,Very Positive,1350,113,1463
22300,True,6,Mostly Positive,4970,1476,6446
22309,True,0,No user reviews,0,0,0
22310,True,6,Mostly Positive,334,127,461
22319,True,0,No user reviews,0,0,0
22320,True,9,Overwhelmingly Positive,8513,435,8948
22330,True,9,Overwhelmingly Positive,14815,669,15484
22333,True,0,No user reviews,0,0,0
22340,True,5,Mixed,750,424,1174
22350,True,5,Mixed,748,589,1337
22359,True,0,No user reviews,0,0,0
22360,True,0,No user reviews,0,0,0
22361,True,0,6 user reviews,5,1,6
22362,True,0,No user reviews,0,0,0
22363,True,0,7 user reviews,7,0,7
22364,True,0,7 user reviews,7,0,7
22365,True,0,No user reviews,0,0,0
22370,True,6,Mostly Positive,12097,3423,15520
22380,True,9,Overwhelmingly Positive,63997,2416,66413
22400,True,7,Positive,31,5,36
22410,True,8,Very Positive,54,13,67
22420,True,7,Positive,24,3,27
22430,True,6,Mostly Positive,24,10,34
22440,True,7,Positive,28,6,34
22449,True,0,No user reviews,0,0,0
22450,True,5,Mixed,261,114,375
22456,True,0,No user reviews,0,0,0
22460,True,0,No user reviews,0,0,0
22465,True,0,No user reviews,0,0,0
22470,True,8,Very Positive,279,45,324
22475,True,0,No user reviews,0,0,0
22480,True,0,No user reviews,0,0,0
22490,True,6,Mostly Positive,618,261,879
22500,True,8,Very Positive,96,15,111
22510,True,0,1 user reviews,0,1,1
22520,True,0,1 user reviews,0,1,1
22521,True,0,1 user reviews,1,0,1
22600,True,8,Very Positive,1043,223,1266
22610,True,6,Mostly Positive,241,82,323
22618,True,0,No user reviews,0,0,0
22620,True,0,No user reviews,0,0,0
22630,True,0,5 user reviews,4,1,5
22631,True,0,6 user reviews,4,2,6
22632,True,0,6 user reviews,5,1,6
22633,True,0,5 user reviews,4,1,5
22634,True,0,4 user reviews,4,0,4
22635,True,0,No user reviews,0,0,0
22636,True,0,No user reviews,0,0,0
22637,True,0,No user reviews,0,0,0
22638,True,0,No user reviews,0,0,0
22639,True,0,No user reviews,0,0,0
22640,True,0,No user reviews,0,0,0
22641,True,0,No user reviews,0,0,0
22642,True,0,No user reviews,0,0,0
22650,True,6,Mostly Positive,80,30,110
22658,True,0,No user reviews,0,0,0
22660,True,0,No user reviews,0,0,0
22670,True,5,Mixed,74,33,107
22678,True,0,No user reviews,0,0,0
22680,True,0,No user reviews,0,0,0
22690,True,0,No user reviews,0,0,0
22700,True,0,No user reviews,0,0,0
22800,True,0,No user reviews,0,0,0
22803,True,0,1 user reviews,1,0,1
22805,True,0,No user reviews,0,0,0
22812,True,0,No user reviews,0,0,0
22813,True,0,1 user reviews,1,0,1
22814,True,0,No user reviews,0,0,0
22815,True,0,1 user reviews,1,0,1
22816,True,0,No user reviews,0,0,0
22817,True,0,No user reviews,0,0,0
22818,True,0,No user reviews,0,0,0
22819,True,0,No user reviews,0,0,0
22821,True,0,1 user reviews,1,0,1
22825,True,0,No user reviews,0,0,0
22835,True,0,No user reviews,0,0,0
22845,True,0,1 user reviews,1,0,1
22870,True,0,No user reviews,0,0,0
22875,True,0,No user reviews,0,0,0
22880,True,0,No user reviews,0,0,0
22885,True,0,No user reviews,0,0,0
22888,True,0,No user reviews,0,0,0
22889,True,0,No user reviews,0,0,0
22890,True,0,No user reviews,0,0,0
22891,True,0,No user reviews,0,0,0
22892,True,0,No user reviews,0,0,0
22893,True,0,No user reviews,0,0,0
22894,True,0,No user reviews,0,0,0
22895,True,0,No user reviews,0,0,0
22896,True,0,No user reviews,0,0,0
23100,True,0,3 user reviews,2,1,3
23110,True,0,No user reviews,0,0,0
23120,True,8,Very Positive,68,14,82
23130,True,0,3 user reviews,3,0,3
23140,True,7,Positive,14,1,15
23150,True,6,Mostly Positive,7,3,10
23160,True,0,No user reviews,0,0,0
23170,True,0,No user reviews,0,0,0
23180,True,0,No user reviews,0,0,0
23200,True,5,Mixed,36,20,56
23300,True,6,Mostly Positive,31,10,41
23310,True,6,Mostly Positive,1268,333,1601
23319,True,0,No user reviews,0,0,0
23320,True,0,No user reviews,0,0,0
23330,True,0,No user reviews,0,0,0
23340,True,0,No user reviews,0,0,0
23350,True,0,No user reviews,0,0,0
23360,True,0,No user reviews,0,0,0
23380,True,5,Mixed,70,41,111
23390,True,0,9 user reviews,8,1,9
23400,True,8,Very Positive,81,20,101
23410,True,0,No user reviews,0,0,0
23420,True,5,Mixed,77,45,122
23440,True,0,No user reviews,0,0,0
23450,True,6,Mostly Positive,204,72,276
23455,True,0,No user reviews,0,0,0
23460,True,6,Mostly Positive,54,15,69
23469,True,0,No user reviews,0,0,0
23470,True,0,No user reviews,0,0,0
23480,True,0,No user reviews,0,0,0
23490,True,8,Very Positive,329,37,366
23500,True,5,Mixed,89,115,204
23510,True,0,4 user reviews,4,0,4
23520,True,0,No user reviews,0,0,0
23530,True,8,Very Positive,457,60,517
23550,True,0,No user reviews,0,0,0
23551,True,0,No user reviews,0,0,0
23552,True,0,No user reviews,0,0,0
23553,True,0,No user reviews,0,0,0
23600,True,8,Very Positive,48,10,58
23610,True,0,No user reviews,0,0,0
23700,True,5,Mixed,45,27,72
24010,True,5,Mixed,4800,2337,7137
24012,True,4,Mostly Negative,5,10,15
24021,True,8,Very Positive,45,6,51
24022,True,0,No user reviews,0,0,0
24023,True,0,No user reviews,0,0,0
24024,True,0,No user reviews,0,0,0
24025,True,0,No user reviews,0,0,0
24026,True,0,No user reviews,0,0,0
24027,True,0,No user reviews,0,0,0
24028,True,0,4 user reviews,1,3,4
24029,True,6,Mostly Positive,9,3,12
24030,True,0,No user reviews,0,0,0
24031,True,0,No user reviews,0,0,0
24032,True,0,No user reviews,0,0,0
24033,True,0,No user reviews,0,0,0
24034,True,0,No user reviews,0,0,0
24035,True,0,No user reviews,0,0,0
24036,True,5,Mixed,8,9,17
24037,True,0,No user reviews,0,0,0
24038,True,0,No user reviews,0,0,0
24039,True,0,No user reviews,0,0,0
24040,True,0,No user reviews,0,0,0
24041,True,0,No user reviews,0,0,0
24042,True,0,No user reviews,0,0,0
24043,True,0,No user reviews,0,0,0
24044,True,0,No user reviews,0,0,0
24045,True,0,No user reviews,0,0,0
24046,True,0,No user reviews,0,0,0
24047,True,0,No user reviews,0,0,0
24048,True,0,No user reviews,0,0,0
24049,True,0,No user reviews,0,0,0
24050,True,0,No user reviews,0,0,0
24051,True,0,No user reviews,0,0,0
24052,True,0,No user reviews,0,0,0
24053,True,0,No user reviews,0,0,0
24054,True,0,No user reviews,0,0,0
24055,True,5,Mixed,7,4,11
24056,True,0,No user reviews,0,0,0
24057,True,0,No user reviews,0,0,0
24058,True,0,No user reviews,0,0,0
24059,True,0,No user reviews,0,0,0
24060,True,0,No user reviews,0,0,0
24061,True,0,No user reviews,0,0,0
24062,True,0,No user reviews,0,0,0
24063,True,0,No user reviews,0,0,0
24064,True,0,No user reviews,0,0,0
24065,True,5,Mixed,11,16,27
24066,True,0,No user reviews,0,0,0
24067,True,0,No user reviews,0,0,0
24068,True,0,No user reviews,0,0,0
24069,True,0,No user reviews,0,0,0
24070,True,0,4 user reviews,3,1,4
24071,True,0,No user reviews,0,0,0
24072,True,0,No user reviews,0,0,0
24073,True,0,No user reviews,0,0,0
24074,True,0,No user reviews,0,0,0
24075,True,0,9 user reviews,8,1,9
24076,True,0,No user reviews,0,0,0
24077,True,0,No user reviews,0,0,0
24078,True,0,No user reviews,0,0,0
24079,True,0,No user reviews,0,0,0
24080,True,0,No user reviews,0,0,0
24081,True,0,1 user reviews,1,0,1
24082,True,6,Mostly Positive,11,4,15
24083,True,5,Mixed,34,22,56
24084,True,0,No user reviews,0,0,0
24085,True,0,No user reviews,0,0,0
24086,True,0,No user reviews,0,0,0
24087,True,0,No user reviews,0,0,0
24088,True,0,No user reviews,0,0,0
24089,True,0,No user reviews,0,0,0
24090,True,0,No user reviews,0,0,0
24091,True,0,No user reviews,0,0,0
24092,True,0,No user reviews,0,0,0
24093,True,0,No user reviews,0,0,0
24094,True,0,No user reviews,0,0,0
24095,True,7,Positive,19,4,23
24096,True,7,Positive,21,5,26
24097,True,0,No user reviews,0,0,0
24098,True,0,No user reviews,0,0,0
24099,True,0,No user reviews,0,0,0
24100,True,0,No user reviews,0,0,0
24110,True,0,1 user reviews,1,0,1
24120,True,0,1 user reviews,1,0,1
24130,True,0,No user reviews,0,0,0
24135,True,0,No user reviews,0,0,0
24140,True,0,No user reviews,0,0,0
24150,True,0,3 user reviews,3,0,3
24170,True,0,7 user reviews,6,1,7
24180,True,0,No user reviews,0,0,0
24190,True,0,No user reviews,0,0,0
24200,True,5,Mixed,72,39,111
24208,True,0,No user reviews,0,0,0
24209,True,0,No user reviews,0,0,0
24210,True,0,No user reviews,0,0,0
24220,True,0,2 user reviews,1,1,2
24230,True,0,No user reviews,0,0,0
24240,True,8,Very Positive,6624,582,7206
24400,True,5,Mixed,176,82,258
24410,True,5,Mixed,8,8,16
24420,True,8,Very Positive,320,36,356
24422,True,0,No user reviews,0,0,0
24430,True,0,No user reviews,0,0,0
24440,True,0,3 user reviews,1,2,3
24441,True,0,2 user reviews,1,1,2
24447,True,0,3 user reviews,2,1,3
24448,True,0,No user reviews,0,0,0
24449,True,0,5 user reviews,2,3,5
24451,True,0,No user reviews,0,0,0
24460,True,4,Mostly Negative,6,11,17
24470,True,5,Mixed,20,10,30
24480,True,5,Mixed,95,84,179
24483,True,0,No user reviews,0,0,0
24486,True,0,No user reviews,0,0,0
24487,True,0,No user reviews,0,0,0
24488,True,0,7 user reviews,6,1,7
24496,True,0,No user reviews,0,0,0
24500,True,6,Mostly Positive,26,10,36
24509,True,0,No user reviews,0,0,0
24600,True,0,1 user reviews,1,0,1
24610,True,0,No user reviews,0,0,0
24620,True,0,No user reviews,0,0,0
24630,True,0,1 user reviews,1,0,1
24634,True,0,No user reviews,0,0,0
24635,True,0,No user reviews,0,0,0
24637,True,0,No user reviews,0,0,0
24640,True,0,8 user reviews,3,5,8
24650,True,5,Mixed,10,6,16
24660,True,5,Mixed,7,4,11
24670,True,5,Mixed,346,149,495
24673,True,0,No user reviews,0,0,0
24674,True,0,No user reviews,0,0,0
24675,True,0,No user reviews,0,0,0
24676,True,0,1 user reviews,1,0,1
24677,True,0,1 user reviews,1,0,1
24678,True,0,No user reviews,0,0,0
24679,True,0,1 user reviews,0,1,1
24700,True,0,1 user reviews,1,0,1
24710,True,0,No user reviews,0,0,0
24720,True,8,Very Positive,1482,217,1699
24760,True,0,No user reviews,0,0,0
24770,True,0,No user reviews,0,0,0
24780,True,6,Mostly Positive,2379,684,3063
24790,True,8,Very Positive,1588,219,1807
24800,True,8,Very Positive,534,94,628
24810,True,8,Very Positive,844,50,894
24820,True,0,No user reviews,0,0,0
24830,True,0,No user reviews,0,0,0
24840,True,6,Mostly Positive,998,266,1264
24850,True,0,1 user reviews,1,0,1
24859,True,0,No user reviews,0,0,0
24860,True,8,Very Positive,846,84,930
24870,True,5,Mixed,438,220,658
24920,True,0,No user reviews,0,0,0
24932,True,0,No user reviews,0,0,0
24934,True,0,No user reviews,0,0,0
24935,True,0,No user reviews,0,0,0
24936,True,0,No user reviews,0,0,0
24937,True,0,No user reviews,0,0,0
24938,True,0,No user reviews,0,0,0
24939,True,0,No user reviews,0,0,0
24950,True,0,No user reviews,0,0,0
24960,True,8,Very Positive,9245,1492,10737
24962,True,0,No user reviews,0,0,0
24963,True,8,Very Positive,60,12,72
24969,True,0,No user reviews,0,0,0
24980,True,8,Very Positive,7294,457,7751
24992,True,0,No user reviews,0,0,0
24993,True,0,No user reviews,0,0,0
24994,True,0,No user reviews,0,0,0
24995,True,0,No user reviews,0,0,0
24996,True,0,No user reviews,0,0,0
24997,True,0,No user reviews,0,0,0
24998,True,0,No user reviews,0,0,0
24999,True,0,No user reviews,0,0,0
25000,True,6,Mostly Positive,2210,592,2802
25010,True,8,Very Positive,141,20,161
25300,True,0,No user reviews,0,0,0
25310,True,0,No user reviews,0,0,0
25320,True,0,No user reviews,0,0,0
25330,True,0,No user reviews,0,0,0
25340,True,0,No user reviews,0,0,0
25350,True,0,No user reviews,0,0,0
25360,True,0,No user reviews,0,0,0
25370,True,0,No user reviews,0,0,0
25380,True,0,No user reviews,0,0,0
25390,True,0,No user reviews,0,0,0
25500,True,5,Mixed,32,45,77
25510,True,0,No user reviews,0,0,0
25600,True,8,Very Positive,73,14,87
25610,True,0,No user reviews,0,0,0
25620,True,7,Positive,38,7,45
25700,True,8,Very Positive,111,18,129
25710,True,0,No user reviews,0,0,0
25730,True,0,No user reviews,0,0,0
25740,True,0,No user reviews,0,0,0
25750,True,0,No user reviews,0,0,0
25751,True,0,No user reviews,0,0,0
25752,True,0,No user reviews,0,0,0
25753,True,0,No user reviews,0,0,0
25754,True,0,No user reviews,0,0,0
25755,True,0,No user reviews,0,0,0
25756,True,0,No user reviews,0,0,0
25757,True,0,No user reviews,0,0,0
25758,True,0,1 user reviews,1,0,1
25759,True,0,1 user reviews,1,0,1
25760,True,0,No user reviews,0,0,0
25761,True,0,No user reviews,0,0,0
25762,True,0,No user reviews,0,0,0
25763,True,0,No user reviews,0,0,0
25764,True,0,No user reviews,0,0,0
25765,True,0,No user reviews,0,0,0
25800,True,8,Very Positive,677,99,776
25806,True,7,Positive,13,1,14
25808,True,7,Positive,16,0,16
25809,True,0,2 user reviews,1,1,2
25810,True,0,2 user reviews,1,1,2
25811,True,0,3 user reviews,2,1,3
25812,True,0,5 user reviews,2,3,5
25813,True,0,5 user reviews,2,3,5
25814,True,0,3 user reviews,2,1,3
25815,True,0,2 user reviews,1,1,2
25816,True,0,2 user reviews,2,0,2
25817,True,0,2 user reviews,1,1,2
25830,True,8,Very Positive,679,63,742
25840,True,0,2 user reviews,2,0,2
25850,True,6,Mostly Positive,39,13,52
25860,True,0,2 user reviews,1,1,2
25870,True,0,No user reviews,0,0,0
25879,True,0,No user reviews,0,0,0
25880,True,0,No user reviews,0,0,0
25890,True,6,Mostly Positive,1817,516,2333
25892,True,0,4 user reviews,1,3,4
25893,True,0,No user reviews,0,0,0
25896,True,0,4 user reviews,1,3,4
25897,True,0,4 user reviews,1,3,4
25898,True,0,2 user reviews,1,1,2
25899,True,0,4 user reviews,2,2,4
25900,True,8,Very Positive,502,70,572
25910,True,8,Very Positive,101,23,124
25920,True,0,3 user reviews,3,0,3
25930,True,5,Mixed,41,28,69
25939,True,0,No user reviews,0,0,0
25940,True,0,1 user reviews,1,0,1
25960,True,0,2 user reviews,0,2,2
25962,True,0,8 user reviews,5,3,8
25980,True,5,Mixed,236,138,374
25989,True,0,No user reviews,0,0,0
25990,True,8,Very Positive,248,10,258
26000,True,8,Very Positive,96,18,114
26005,True,0,5 user reviews,3,2,5
26006,True,0,2 user reviews,2,0,2
26007,True,0,3 user reviews,3,0,3
26009,True,0,No user reviews,0,0,0
26010,True,0,No user reviews,0,0,0
26100,True,0,No user reviews,0,0,0
26110,True,0,No user reviews,0,0,0
26120,True,0,No user reviews,0,0,0
26130,True,0,No user reviews,0,0,0
26140,True,0,No user reviews,0,0,0
26160,True,0,No user reviews,0,0,0
26170,True,0,No user reviews,0,0,0
26180,True,0,No user reviews,0,0,0
26300,True,4,Mostly Negative,11,20,31
26500,True,8,Very Positive,166,21,187
26510,True,0,No user reviews,0,0,0
26700,True,0,No user reviews,0,0,0
26710,True,0,No user reviews,0,0,0
26720,True,0,No user reviews,0,0,0
26800,True,8,Very Positive,2421,196,2617
26803,True,0,2 user reviews,2,0,2
26810,True,0,No user reviews,0,0,0
26900,True,8,Very Positive,91,10,101
26910,True,0,No user reviews,0,0,0
27000,True,6,Mostly Positive,301,109,410
27020,True,5,Mixed,101,87,188
27030,True,0,No user reviews,0,0,0
27040,True,0,No user reviews,0,0,0
27050,True,5,Mixed,33,34,67
27200,True,0,9 user reviews,7,2,9
27220,True,0,5 user reviews,5,0,5
27240,True,0,No user reviews,0,0,0
27300,True,7,Positive,13,3,16
27400,True,6,Mostly Positive,65,22,87
27610,True,0,No user reviews,0,0,0
27800,True,6,Mostly Positive,34,11,45
27810,True,8,Very Positive,44,8,52
27900,True,4,Mostly Negative,39,67,106
27910,True,0,No user reviews,0,0,0
27920,True,5,Mixed,39,44,83
27930,True,0,No user reviews,0,0,0
27940,True,4,Mostly Negative,64,132,196
28000,True,5,Mixed,892,577,1469
28010,True,0,7 user reviews,6,1,7
28011,True,0,7 user reviews,6,1,7
28012,True,0,7 user reviews,5,2,7
28013,True,0,No user reviews,0,0,0
28014,True,0,No user reviews,0,0,0
28015,True,0,No user reviews,0,0,0
28017,True,0,No user reviews,0,0,0
28019,True,0,No user reviews,0,0,0
28020,True,0,No user reviews,0,0,0
28050,True,9,Overwhelmingly Positive,2822,22,2844
28060,True,0,3 user reviews,3,0,3
28061,True,0,4 user reviews,4,0,4
28110,True,0,No user reviews,0,0,0
29017,True,0,No user reviews,0,0,0
29100,True,0,No user reviews,0,0,0
29110,True,0,No user reviews,0,0,0
29120,True,0,5 user reviews,5,0,5
29130,True,8,Very Positive,57,6,63
29140,True,0,No user reviews,0,0,0
29150,True,0,No user reviews,0,0,0
29160,True,5,Mixed,58,25,83
29170,True,0,No user reviews,0,0,0
29180,True,8,Very Positive,248,34,282
29200,True,0,No user reviews,0,0,0
29500,True,0,No user reviews,0,0,0
29520,True,0,No user reviews,0,0,0
29530,True,0,No user reviews,0,0,0
29540,True,0,5 user reviews,5,0,5
29550,True,0,No user reviews,0,0,0
29560,True,0,No user reviews,0,0,0
29570,True,7,Positive,28,1,29
29580,True,0,No user reviews,0,0,0
29590,True,0,No user reviews,0,0,0
29600,True,0,5 user reviews,5,0,5
29610,True,0,No user reviews,0,0,0
29620,True,7,Positive,28,1,29
29630,True,0,No user reviews,0,0,0
29640,True,7,Positive,9,2,11
29650,True,0,1 user reviews,0,1,1
29660,True,0,No user reviews,0,0,0
29670,True,0,No user reviews,0,0,0
29680,True,0,6 user reviews,6,0,6
29690,True,0,No user reviews,0,0,0
29700,True,0,1 user reviews,1,0,1
29710,True,0,No user reviews,0,0,0
29720,True,8,Very Positive,152,3,155
29800,True,6,Mostly Positive,994,282,1276
29900,True,8,Very Positive,125,27,152
30000,True,0,No user reviews,0,0,0
30010,True,0,No user reviews,0,0,0
30040,True,0,No user reviews,0,0,0
31100,True,0,9 user reviews,8,1,9
31109,True,0,No user reviews,0,0,0
31110,True,0,2 user reviews,2,0,2
31120,True,0,2 user reviews,2,0,2
31130,True,0,2 user reviews,2,0,2
31139,True,0,No user reviews,0,0,0
31160,True,0,No user reviews,0,0,0
31170,True,8,Very Positive,243,34,277
31180,True,7,Positive,19,3,22
31189,True,0,No user reviews,0,0,0
31190,True,7,Positive,21,2,23
31199,True,0,No user reviews,0,0,0
31200,True,6,Mostly Positive,17,5,22
31209,True,0,No user reviews,0,0,0
31210,True,7,Positive,24,3,27
31219,True,0,No user reviews,0,0,0
31220,True,8,Very Positive,158,12,170
31229,True,0,No user reviews,0,0,0
31230,True,7,Positive,14,2,16
31240,True,7,Positive,12,1,13
31250,True,7,Positive,12,1,13
31260,True,7,Positive,14,1,15
31270,True,8,Very Positive,738,111,849
31280,True,8,Very Positive,3767,566,4333
31290,True,8,Very Positive,692,83,775
31300,True,3,Negative,4,17,21
31410,True,8,Very Positive,201,7,208
31419,True,0,No user reviews,0,0,0
31420,True,0,3 user reviews,3,0,3
31500,True,0,1 user reviews,1,0,1
31700,True,8,Very Positive,155,25,180
31710,True,0,No user reviews,0,0,0
31713,True,0,No user reviews,0,0,0
31720,True,0,No user reviews,0,0,0
31740,True,0,No user reviews,0,0,0
31800,True,6,Mostly Positive,26,10,36
31810,True,8,Very Positive,95,6,101
31820,True,8,Very Positive,56,7,63
31830,True,8,Very Positive,101,9,110
31840,True,8,Very Positive,66,7,73
31850,True,8,Very Positive,70,5,75
31860,True,8,Very Positive,48,6,54
31870,True,5,Mixed,14,8,22
31880,True,8,Very Positive,62,5,67
31890,True,8,Very Positive,47,7,54
31900,True,6,Mostly Positive,32,11,43
31910,True,6,Mostly Positive,47,12,59
31920,True,8,Very Positive,40,10,50
31930,True,6,Mostly Positive,45,19,64
31940,True,0,No user reviews,0,0,0
31950,True,0,No user reviews,0,0,0
31960,True,0,No user reviews,0,0,0
31970,True,0,No user reviews,0,0,0
31989,True,0,No user reviews,0,0,0
31990,True,0,No user reviews,0,0,0
32000,True,3,Negative,0,13,13
32010,True,0,No user reviews,0,0,0
32110,True,7,Positive,13,1,14
32117,True,0,No user reviews,0,0,0
32120,True,0,4 user reviews,2,2,4
32127,True,0,No user reviews,0,0,0
32130,True,0,No user reviews,0,0,0
32135,True,0,No user reviews,0,0,0
32140,True,6,Mostly Positive,32,10,42
32150,True,8,Very Positive,256,4,260
32159,True,0,No user reviews,0,0,0
32160,True,8,Very Positive,66,7,73
32162,True,0,No user reviews,0,0,0
32200,True,6,Mostly Positive,49,18,67
32210,True,0,No user reviews,0,0,0
32310,True,6,Mostly Positive,86,25,111
32330,True,8,Very Positive,345,67,412
32340,True,8,Very Positive,248,29,277
32350,True,5,Mixed,132,135,267
32360,True,9,Overwhelmingly Positive,1538,61,1599
32370,True,8,Very Positive,12234,1331,13565
32380,True,6,Mostly Positive,619,231,850
32390,True,5,Mixed,260,163,423
32400,True,8,Very Positive,1074,127,1201
32410,True,5,Mixed,18,9,27
32420,True,4,Mostly Negative,96,200,296
32430,True,5,Mixed,1676,822,2498
32440,True,9,Overwhelmingly Positive,5735,251,5986
32450,True,8,Very Positive,157,39,196
32460,True,8,Very Positive,769,52,821
32469,True,8,Very Positive,769,52,821
32470,True,9,Overwhelmingly Positive,11115,336,11451
32472,True,0,No user reviews,0,0,0
32500,True,5,Mixed,1017,883,1900
32510,True,8,Very Positive,1187,112,1299
32610,True,5,Mixed,33,26,59
32620,True,8,Very Positive,153,21,174
32630,True,8,Very Positive,122,19,141
32640,True,8,Very Positive,74,9,83
32650,True,5,Mixed,32,16,48
32660,True,7,Positive,26,6,32
32670,True,8,Very Positive,143,12,155
32680,True,8,Very Positive,116,16,132
32690,True,0,7 user reviews,5,2,7
32700,True,0,4 user reviews,3,1,4
32710,True,5,Mixed,16,13,29
32720,True,6,Mostly Positive,26,9,35
32730,True,5,Mixed,30,25,55
32740,True,6,Mostly Positive,20,8,28
32750,True,8,Very Positive,79,10,89
32760,True,8,Very Positive,107,11,118
32770,True,8,Very Positive,104,9,113
32800,True,6,Mostly Positive,996,338,1334
32830,True,0,No user reviews,0,0,0
32831,True,0,No user reviews,0,0,0
32832,True,0,No user reviews,0,0,0
32833,True,0,No user reviews,0,0,0
32834,True,0,No user reviews,0,0,0
32900,True,6,Mostly Positive,81,26,107
33100,True,8,Very Positive,190,26,216
33110,True,6,Mostly Positive,48,20,68
33120,True,8,Very Positive,204,20,224
33130,True,8,Very Positive,115,19,134
33140,True,0,No user reviews,0,0,0
33150,True,0,No user reviews,0,0,0
33160,True,0,No user reviews,0,0,0
33170,True,0,No user reviews,0,0,0
33180,True,6,Mostly Positive,74,20,94
33190,True,0,No user reviews,0,0,0
33219,True,0,No user reviews,0,0,0
33220,True,5,Mixed,840,378,1218
33229,True,5,Mixed,840,378,1218
33230,True,8,Very Positive,6426,1254,7680
33242,True,0,No user reviews,0,0,0
33245,True,0,No user reviews,0,0,0
33246,True,0,No user reviews,0,0,0
33259,True,0,No user reviews,0,0,0
33260,True,5,Mixed,6,6,12
33270,True,0,No user reviews,0,0,0
33280,True,7,Positive,14,0,14
33287,True,0,No user reviews,0,0,0
33288,True,0,No user reviews,0,0,0
33289,True,0,No user reviews,0,0,0
33290,True,0,No user reviews,0,0,0
33310,True,0,No user reviews,0,0,0
33320,True,5,Mixed,322,142,464
33325,True,0,No user reviews,0,0,0
33326,True,0,No user reviews,0,0,0
33349,True,0,No user reviews,0,0,0
33359,True,0,No user reviews,0,0,0
33360,True,0,No user reviews,0,0,0
33361,True,0,No user reviews,0,0,0
33362,True,0,No user reviews,0,0,0
33370,True,0,No user reviews,0,0,0
33371,True,0,No user reviews,0,0,0
33372,True,7,Positive,12,3,15
33390,True,6,Mostly Positive,10,3,13
33400,True,0,No user reviews,0,0,0
33420,True,5,Mixed,55,65,120
33428,True,0,No user reviews,0,0,0
33435,True,0,No user reviews,0,0,0
33436,True,0,No user reviews,0,0,0
33446,True,0,No user reviews,0,0,0
33447,True,0,No user reviews,0,0,0
33448,True,0,No user reviews,0,0,0
33456,True,0,No user reviews,0,0,0
33457,True,0,No user reviews,0,0,0
33460,True,5,Mixed,953,608,1561
33500,True,0,No user reviews,0,0,0
33510,True,0,No user reviews,0,0,0
33520,True,8,Very Positive,263,34,297
33530,True,7,Positive,28,6,34
33540,True,4,Mostly Negative,4,10,14
33549,True,0,No user reviews,0,0,0
33550,True,4,Mostly Negative,4,10,14
33559,True,0,No user reviews,0,0,0
33560,True,0,No user reviews,0,0,0
33570,True,6,Mostly Positive,200,60,260
33580,True,5,Mixed,45,21,66
33600,True,8,Very Positive,194,32,226
33610,True,5,Mixed,110,78,188
33620,True,8,Very Positive,118,21,139
33630,True,0,No user reviews,0,0,0
33650,True,8,Very Positive,164,26,190
33660,True,5,Mixed,11,6,17
33670,True,5,Mixed,71,67,138
33680,True,8,Very Positive,639,64,703
33700,True,0,No user reviews,0,0,0
33710,True,0,5 user reviews,4,1,5
33720,True,7,Positive,10,1,11
33730,True,6,Mostly Positive,41,13,54
33740,True,0,3 user reviews,3,0,3
33750,True,4,Mostly Negative,5,17,22
33760,True,0,5 user reviews,1,4,5
33770,True,8,Very Positive,92,23,115
33780,True,6,Mostly Positive,10,4,14
33790,True,0,9 user reviews,6,3,9
33900,True,8,Very Positive,1347,260,1607
33905,True,0,No user reviews,0,0,0
33909,True,0,No user reviews,0,0,0
33910,True,5,Mixed,68,47,115
33919,True,0,No user reviews,0,0,0
33920,True,0,No user reviews,0,0,0
33930,True,8,Very Positive,7720,594,8314
33934,True,6,Mostly Positive,49,16,65
33935,True,0,No user reviews,0,0,0
33936,True,0,No user reviews,0,0,0
33950,True,7,Positive,34,2,36
33960,True,0,No user reviews,0,0,0
33970,True,0,No user reviews,0,0,0
33980,True,5,Mixed,37,36,73
33990,True,5,Mixed,50,58,108
34000,True,0,1 user reviews,1,0,1
34009,True,0,No user reviews,0,0,0
34010,True,8,Very Positive,1844,361,2205
34019,True,0,No user reviews,0,0,0
34030,True,8,Very Positive,3874,421,4295
34039,True,0,No user reviews,0,0,0
34049,True,0,No user reviews,0,0,0
34050,True,0,1 user reviews,1,0,1
34110,True,0,No user reviews,0,0,0
34120,True,0,No user reviews,0,0,0
34170,True,0,No user reviews,0,0,0
34171,True,0,No user reviews,0,0,0
34172,True,0,No user reviews,0,0,0
34173,True,0,No user reviews,0,0,0
34174,True,7,Positive,20,1,21
34175,True,0,No user reviews,0,0,0
34176,True,0,No user reviews,0,0,0
34177,True,0,No user reviews,0,0,0
34178,True,7,Positive,18,2,20
34179,True,7,Positive,31,3,34
34180,True,0,2 user reviews,1,1,2
34184,True,0,No user reviews,0,0,0
34189,True,0,No user reviews,0,0,0
34190,True,8,Very Positive,413,91,504
34200,True,0,No user reviews,0,0,0
34220,True,7,Positive,32,0,32
34229,True,0,No user reviews,0,0,0
34250,True,0,No user reviews,0,0,0
34270,True,8,Very Positive,1891,339,2230
34272,True,0,6 user reviews,6,0,6
34273,True,0,4 user reviews,4,0,4
34274,True,0,2 user reviews,2,0,2
34275,True,0,3 user reviews,3,0,3
34276,True,0,4 user reviews,3,1,4
34277,True,0,2 user reviews,2,0,2
34278,True,0,6 user reviews,6,0,6
34279,True,0,3 user reviews,3,0,3
34280,True,0,4 user reviews,4,0,4
34281,True,0,3 user reviews,3,0,3
34282,True,0,4 user reviews,4,0,4
34283,True,0,2 user reviews,1,1,2
34284,True,0,3 user reviews,3,0,3
34285,True,0,3 user reviews,2,1,3
34286,True,0,5 user reviews,5,0,5
34287,True,0,3 user reviews,2,1,3
34288,True,0,2 user reviews,2,0,2
34289,True,0,5 user reviews,5,0,5
34310,True,0,2 user reviews,1,1,2
34311,True,0,2 user reviews,2,0,2
34312,True,0,2 user reviews,2,0,2
34313,True,0,5 user reviews,5,0,5
34314,True,0,2 user reviews,1,1,2
34315,True,0,2 user reviews,2,0,2
34316,True,0,2 user reviews,2,0,2
34317,True,0,3 user reviews,2,1,3
34318,True,0,2 user reviews,2,0,2
34319,True,0,2 user reviews,2,0,2
34330,True,8,Very Positive,11179,1031,12210
34342,True,7,Positive,20,2,22
34343,True,5,Mixed,25,13,38
34344,True,0,No user reviews,0,0,0
34345,True,0,9 user reviews,7,2,9
34346,True,0,No user reviews,0,0,0
34347,True,0,No user reviews,0,0,0
34348,True,7,Positive,15,0,15
34350,True,0,No user reviews,0,0,0
34390,True,0,No user reviews,0,0,0
34400,True,0,No user reviews,0,0,0
34410,True,8,Very Positive,99,23,122
34420,True,5,Mixed,14,17,31
34440,True,7,Positive,23,2,25
34450,True,0,5 user reviews,5,0,5
34460,True,7,Positive,25,0,25
34470,True,0,No user reviews,0,0,0
34490,True,0,No user reviews,0,0,0
34491,True,0,No user reviews,0,0,0
34492,True,0,No user reviews,0,0,0
34493,True,0,No user reviews,0,0,0
34494,True,0,No user reviews,0,0,0
34495,True,0,No user reviews,0,0,0
34496,True,0,No user reviews,0,0,0
34497,True,0,No user reviews,0,0,0
34498,True,0,No user reviews,0,0,0
34500,True,6,Mostly Positive,17,5,22
34510,True,0,No user reviews,0,0,0
34600,True,5,Mixed,76,43,119
34609,True,0,No user reviews,0,0,0
34610,True,0,No user reviews,0,0,0
34611,True,0,No user reviews,0,0,0
34612,True,0,No user reviews,0,0,0
34613,True,0,No user reviews,0,0,0
34614,True,0,No user reviews,0,0,0
34615,True,0,No user reviews,0,0,0
34616,True,0,No user reviews,0,0,0
34620,True,0,No user reviews,0,0,0
34630,True,0,9 user reviews,7,2,9
34640,True,7,Positive,15,1,16
34650,True,0,3 user reviews,3,0,3
34660,True,0,No user reviews,0,0,0
34670,True,0,1 user reviews,1,0,1
34680,True,0,No user reviews,0,0,0
34800,True,6,Mostly Positive,20,8,28
34810,True,6,Mostly Positive,48,13,61
34820,True,6,Mostly Positive,129,35,164
34830,True,5,Mixed,564,533,1097
34841,True,6,Mostly Positive,9,3,12
34842,True,7,Positive,16,0,16
34850,True,0,No user reviews,0,0,0
34860,True,0,2 user reviews,2,0,2
34870,True,5,Mixed,1764,951,2715
34880,True,0,No user reviews,0,0,0
34900,True,8,Very Positive,4012,993,5005
34910,True,0,3 user reviews,2,1,3
34920,True,2,Very Negative,12,56,68
34930,True,0,No user reviews,0,0,0
35000,True,8,Very Positive,605,99,704
35010,True,0,3 user reviews,1,2,3
35019,True,0,No user reviews,0,0,0
35020,True,0,No user reviews,0,0,0
35030,True,6,Mostly Positive,21,8,29
35040,True,0,No user reviews,0,0,0
35050,True,0,2 user reviews,2,0,2
35060,True,0,No user reviews,0,0,0
35070,True,5,Mixed,46,27,73
35080,True,5,Mixed,26,14,40
35081,True,0,No user reviews,0,0,0
35082,True,0,No user reviews,0,0,0
35083,True,5,Mixed,19,14,33
35084,True,0,No user reviews,0,0,0
35085,True,0,No user reviews,0,0,0
35086,True,0,No user reviews,0,0,0
35087,True,0,No user reviews,0,0,0
35088,True,0,No user reviews,0,0,0
35089,True,6,Mostly Positive,13,5,18
35090,True,7,Positive,21,4,25
35091,True,7,Positive,37,3,40
35092,True,0,No user reviews,0,0,0
35093,True,0,No user reviews,0,0,0
35094,True,0,No user reviews,0,0,0
35095,True,0,No user reviews,0,0,0
35096,True,0,No user reviews,0,0,0
35097,True,0,No user reviews,0,0,0
35098,True,0,No user reviews,0,0,0
35099,True,0,No user reviews,0,0,0
35100,True,0,No user reviews,0,0,0
35101,True,7,Positive,36,9,45
35102,True,7,Positive,34,4,38
35103,True,0,No user reviews,0,0,0
35110,True,0,1 user reviews,1,0,1
35130,True,8,Very Positive,1062,93,1155
35134,True,0,No user reviews,0,0,0
35135,True,7,Positive,9,2,11
35136,True,7,Positive,8,2,10
35137,True,0,6 user reviews,3,3,6
35138,True,0,6 user reviews,3,3,6
35140,True,9,Overwhelmingly Positive,8198,373,8571
35150,True,0,No user reviews,0,0,0
35300,True,5,Mixed,22,11,33
35310,True,7,Positive,26,5,31
35320,True,6,Mostly Positive,48,17,65
35417,True,7,Positive,12,1,13
35418,True,0,No user reviews,0,0,0
35419,True,7,Positive,14,2,16
35420,True,5,Mixed,102,143,245
35425,True,7,Positive,12,1,13
35426,True,0,No user reviews,0,0,0
35427,True,0,No user reviews,0,0,0
35428,True,0,No user reviews,0,0,0
35429,True,0,4 user reviews,3,1,4
35450,True,8,Very Positive,9713,602,10315
35460,True,6,Mostly Positive,338,105,443
35470,True,0,No user reviews,0,0,0
35480,True,6,Mostly Positive,293,84,377
35485,True,0,No user reviews,0,0,0
35490,True,0,No user reviews,0,0,0
35500,True,5,Mixed,12,9,21
35509,True,0,No user reviews,0,0,0
35510,True,5,Mixed,6,4,10
35600,True,5,Mixed,29,29,58
35700,True,8,Very Positive,3276,189,3465
35709,True,0,No user reviews,0,0,0
35710,True,0,No user reviews,0,0,0
35720,True,9,Overwhelmingly Positive,4695,231,4926
35723,True,0,No user reviews,0,0,0
35725,True,7,Positive,9,1,10
35800,True,8,Very Positive,44,7,51
36000,True,5,Mixed,92,68,160
36100,True,8,Very Positive,52,1,53
36110,True,0,6 user reviews,6,0,6
36120,True,0,7 user reviews,7,0,7
36130,True,0,5 user reviews,4,1,5
36140,True,0,5 user reviews,3,2,5
36150,True,7,Positive,10,0,10
36160,True,0,2 user reviews,2,0,2
36170,True,0,1 user reviews,1,0,1
36180,True,5,Mixed,28,15,43
36190,True,0,3 user reviews,2,1,3
36200,True,0,2 user reviews,1,1,2
36210,True,6,Mostly Positive,11,3,14
36240,True,0,7 user reviews,6,1,7
36270,True,6,Mostly Positive,8,3,11
36280,True,0,2 user reviews,2,0,2
36290,True,0,1 user reviews,1,0,1
36300,True,6,Mostly Positive,14,4,18
36310,True,7,Positive,14,1,15
36320,True,0,5 user reviews,1,4,5
36340,True,0,No user reviews,0,0,0
36350,True,0,No user reviews,0,0,0
36360,True,0,No user reviews,0,0,0
36370,True,0,No user reviews,0,0,0
36630,True,0,No user reviews,0,0,0
36632,True,0,No user reviews,0,0,0
36633,True,0,No user reviews,0,0,0
36700,True,6,Mostly Positive,12,4,16
36710,True,0,No user reviews,0,0,0
36900,True,0,3 user reviews,0,3,3
36909,True,0,No user reviews,0,0,0
36910,True,3,Negative,2,9,11
36919,True,0,No user reviews,0,0,0
36920,True,0,No user reviews,0,0,0
36930,True,0,No user reviews,0,0,0
37000,True,8,Very Positive,364,79,443
37010,True,5,Mixed,51,43,94
37030,True,6,Mostly Positive,70,19,89
37100,True,6,Mostly Positive,45,19,64
37110,True,0,No user reviews,0,0,0
37200,True,0,6 user reviews,5,1,6
37210,True,5,Mixed,51,35,86
37220,True,6,Mostly Positive,30,10,40
37230,True,0,7 user reviews,3,4,7
37240,True,4,Mostly Negative,28,71,99
37250,True,0,1 user reviews,1,0,1
37260,True,8,Very Positive,48,3,51
37270,True,7,Positive,17,1,18
37280,True,6,Mostly Positive,11,4,15
37290,True,0,6 user reviews,5,1,6
37300,True,5,Mixed,8,6,14
37310,True,4,Mostly Negative,4,9,13
37320,True,0,5 user reviews,2,3,5
37330,True,0,3 user reviews,3,0,3
37340,True,0,6 user reviews,5,1,6
37350,True,0,2 user reviews,2,0,2
37360,True,0,5 user reviews,3,2,5
37370,True,0,4 user reviews,3,1,4
37380,True,0,7 user reviews,3,4,7
37390,True,7,Positive,15,1,16
37400,True,8,Very Positive,308,44,352
37410,True,0,No user reviews,0,0,0
37420,True,5,Mixed,7,4,11
37500,True,6,Mostly Positive,17,7,24
37510,True,0,No user reviews,0,0,0
37600,True,8,Very Positive,372,34,406
37700,True,6,Mostly Positive,140,54,194
37708,True,0,No user reviews,0,0,0
37709,True,0,No user reviews,0,0,0
37710,True,0,No user reviews,0,0,0
37800,True,5,Mixed,23,10,33
37810,True,0,No user reviews,0,0,0
37900,True,0,2 user reviews,2,0,2
37910,True,0,No user reviews,0,0,0
37920,True,0,1 user reviews,1,0,1
37930,True,0,No user reviews,0,0,0
37940,True,0,1 user reviews,1,0,1
37950,True,0,No user reviews,0,0,0
37960,True,7,Positive,18,3,21
37970,True,0,6 user reviews,6,0,6
37980,True,0,5 user reviews,5,0,5
37990,True,0,2 user reviews,2,0,2
38000,True,7,Positive,17,3,20
38010,True,0,No user reviews,0,0,0
38020,True,0,3 user reviews,3,0,3
38030,True,0,No user reviews,0,0,0
38040,True,0,No user reviews,0,0,0
38050,True,0,1 user reviews,1,0,1
38060,True,0,3 user reviews,3,0,3
38070,True,0,7 user reviews,7,0,7
38080,True,7,Positive,16,1,17
38090,True,0,4 user reviews,4,0,4
38100,True,0,2 user reviews,2,0,2
38110,True,0,6 user reviews,4,2,6
38120,True,0,9 user reviews,8,1,9
38130,True,7,Positive,17,1,18
38140,True,0,5 user reviews,5,0,5
38150,True,0,3 user reviews,2,1,3
38160,True,0,1 user reviews,1,0,1
38170,True,7,Positive,13,1,14
38180,True,0,1 user reviews,1,0,1
38185,True,7,Positive,26,2,28
38190,True,0,5 user reviews,3,2,5
38200,True,0,1 user reviews,1,0,1
38209,True,0,No user reviews,0,0,0
38210,True,6,Mostly Positive,98,29,127
38220,True,5,Mixed,40,20,60
38229,True,0,No user reviews,0,0,0
38230,True,5,Mixed,38,50,88
38240,True,0,5 user reviews,3,2,5
38400,True,8,Very Positive,4062,279,4341
38410,True,8,Very Positive,3488,244,3732
38420,True,8,Very Positive,664,161,825
38430,True,6,Mostly Positive,134,37,171
38440,True,8,Very Positive,273,25,298
38450,True,6,Mostly Positive,97,28,125
38460,True,6,Mostly Positive,57,16,73
38480,True,4,Mostly Negative,23,40,63
38490,True,5,Mixed,24,17,41
38530,True,0,9 user reviews,9,0,9
38600,True,8,Very Positive,763,77,840
38700,True,8,Very Positive,578,92,670
38710,True,0,No user reviews,0,0,0
38720,True,8,Very Positive,441,56,497
38730,True,0,No user reviews,0,0,0
38740,True,8,Very Positive,687,61,748
38743,True,0,No user reviews,0,0,0
38750,True,0,No user reviews,0,0,0
38800,True,0,No user reviews,0,0,0
38810,True,0,No user reviews,0,0,0
38820,True,0,No user reviews,0,0,0
38830,True,5,Mixed,10,10,20
38900,True,5,Mixed,41,42,83
38910,True,0,No user reviews,0,0,0
38920,True,0,No user reviews,0,0,0
38921,True,0,No user reviews,0,0,0
38922,True,0,No user reviews,0,0,0
38923,True,0,No user reviews,0,0,0
38924,True,0,1 user reviews,1,0,1
38925,True,0,No user reviews,0,0,0
38926,True,0,No user reviews,0,0,0
38927,True,0,No user reviews,0,0,0
39000,True,8,Very Positive,125,21,146
39100,True,0,No user reviews,0,0,0
39110,True,6,Mostly Positive,96,26,122
39120,True,6,Mostly Positive,542,189,731
39122,True,0,No user reviews,0,0,0
39123,True,0,No user reviews,0,0,0
39124,True,0,No user reviews,0,0,0
39125,True,0,No user reviews,0,0,0
39126,True,0,No user reviews,0,0,0
39127,True,0,No user reviews,0,0,0
39128,True,0,No user reviews,0,0,0
39129,True,0,No user reviews,0,0,0
39130,True,0,No user reviews,0,0,0
39140,True,8,Very Positive,8956,814,9770
39150,True,8,Very Positive,3023,496,3519
39160,True,5,Mixed,467,418,885
39180,True,0,No user reviews,0,0,0
39181,True,0,No user reviews,0,0,0
39182,True,0,No user reviews,0,0,0
39183,True,0,No user reviews,0,0,0
39184,True,0,No user reviews,0,0,0
39185,True,0,No user reviews,0,0,0
39189,True,0,No user reviews,0,0,0
39190,True,6,Mostly Positive,911,290,1201
39200,True,5,Mixed,519,234,753
39210,True,8,Very Positive,16716,2265,18981
39230,True,0,No user reviews,0,0,0
39250,True,7,Positive,24,2,26
39251,True,0,No user reviews,0,0,0
39260,True,7,Positive,10,0,10
39261,True,0,No user reviews,0,0,0
39270,True,7,Positive,21,1,22
39300,True,0,No user reviews,0,0,0
39310,True,0,No user reviews,0,0,0
39320,True,0,No user reviews,0,0,0
39330,True,0,No user reviews,0,0,0
39350,True,0,No user reviews,0,0,0
39360,True,0,No user reviews,0,0,0
39370,True,0,No user reviews,0,0,0
39380,True,0,No user reviews,0,0,0
39500,True,5,Mixed,739,364,1103
39510,True,8,Very Positive,962,203,1165
39520,True,5,Mixed,75,51,126
39530,True,8,Very Positive,261,43,304
39540,True,6,Mostly Positive,342,100,442
39550,True,5,Mixed,157,101,258
39560,True,4,Mostly Negative,34,80,114
39570,True,0,No user reviews,0,0,0
39580,True,0,No user reviews,0,0,0
39590,True,0,No user reviews,0,0,0
39600,True,0,No user reviews,0,0,0
39610,True,0,1 user reviews,1,0,1
39620,True,0,No user reviews,0,0,0
39630,True,5,Mixed,64,28,92
39640,True,6,Mostly Positive,44,16,60
39650,True,5,Mixed,155,84,239
39660,True,5,Mixed,48,28,76
39670,True,6,Mostly Positive,266,104,370
39680,True,6,Mostly Positive,1028,274,1302
39690,True,5,Mixed,257,225,482
39710,True,0,7 user reviews,5,2,7
39800,True,8,Very Positive,980,105,1085
39810,True,0,No user reviews,0,0,0
39900,True,5,Mixed,10,5,15
40000,True,7,Positive,12,0,12
40002,True,0,No user reviews,0,0,0
40003,True,0,No user reviews,0,0,0
40004,True,0,No user reviews,0,0,0
40005,True,0,No user reviews,0,0,0
40006,True,0,No user reviews,0,0,0
40100,True,8,Very Positive,2560,453,3013
40120,True,0,No user reviews,0,0,0
40125,True,0,No user reviews,0,0,0
40130,True,0,No user reviews,0,0,0
40131,True,0,No user reviews,0,0,0
40132,True,0,No user reviews,0,0,0
40133,True,0,No user reviews,0,0,0
40134,True,0,No user reviews,0,0,0
40135,True,8,Very Positive,130,9,139
40136,True,0,No user reviews,0,0,0
40140,True,0,No user reviews,0,0,0
40200,True,0,9 user reviews,6,3,9
40210,True,0,6 user reviews,6,0,6
40230,True,0,No user reviews,0,0,0
40300,True,8,Very Positive,1090,251,1341
40309,True,0,No user reviews,0,0,0
40310,True,0,No user reviews,0,0,0
40320,True,7,Positive,37,6,43
40330,True,8,Very Positive,57,13,70
40340,True,6,Mostly Positive,30,12,42
40350,True,8,Very Positive,113,17,130
40360,True,0,No user reviews,0,0,0
40370,True,0,3 user reviews,3,0,3
40380,True,6,Mostly Positive,243,73,316
40390,True,6,Mostly Positive,485,168,653
40391,True,0,8 user reviews,5,3,8
40392,True,0,8 user reviews,7,1,8
40393,True,0,7 user reviews,5,2,7
40400,True,8,Very Positive,678,98,776
40403,True,0,3 user reviews,3,0,3
40406,True,0,4 user reviews,3,1,4
40407,True,0,5 user reviews,5,0,5
40408,True,0,3 user reviews,3,0,3
40410,True,0,No user reviews,0,0,0
40420,True,6,Mostly Positive,48,18,66
40430,True,0,No user reviews,0,0,0
40500,True,4,Mostly Negative,5,9,14
40510,True,0,No user reviews,0,0,0
40700,True,8,Very Positive,2077,120,2197
40703,True,0,9 user reviews,8,1,9
40709,True,0,No user reviews,0,0,0
40710,True,0,No user reviews,0,0,0
40720,True,8,Very Positive,241,53,294
40800,True,8,Very Positive,8970,540,9510
40809,True,0,No user reviews,0,0,0
40810,True,0,No user reviews,0,0,0
40920,True,0,4 user reviews,2,2,4
40930,True,8,Very Positive,204,31,235
40940,True,4,Mostly Negative,82,186,268
40950,True,8,Very Positive,1444,103,1547
40960,True,8,Very Positive,704,103,807
40970,True,9,Overwhelmingly Positive,2267,82,2349
40980,True,8,Very Positive,307,68,375
40990,True,8,Very Positive,930,140,1070
41000,True,8,Very Positive,1506,128,1634
41005,True,0,No user reviews,0,0,0
41009,True,0,No user reviews,0,0,0
41010,True,8,Very Positive,460,21,481
41014,True,8,Very Positive,57,7,64
41015,True,0,No user reviews,0,0,0
41017,True,0,No user reviews,0,0,0
41018,True,0,No user reviews,0,0,0
41019,True,0,7 user reviews,4,3,7
41020,True,0,No user reviews,0,0,0
41030,True,0,No user reviews,0,0,0
41040,True,0,No user reviews,0,0,0
41045,True,0,No user reviews,0,0,0
41046,True,0,No user reviews,0,0,0
41050,True,9,Overwhelmingly Positive,610,31,641
41060,True,8,Very Positive,255,18,273
41070,True,8,Very Positive,3998,594,4592
41073,True,0,No user reviews,0,0,0
41074,True,6,Mostly Positive,54,16,70
41080,True,0,No user reviews,0,0,0
41090,True,0,No user reviews,0,0,0
41100,True,8,Very Positive,190,25,215
41110,True,0,No user reviews,0,0,0
41210,True,8,Very Positive,333,25,358
41220,True,0,No user reviews,0,0,0
41300,True,8,Very Positive,441,24,465
41310,True,0,No user reviews,0,0,0
41400,True,4,Mostly Negative,5,12,17
41500,True,8,Very Positive,2289,190,2479
41509,True,0,No user reviews,0,0,0
41510,True,0,No user reviews,0,0,0
41520,True,0,No user reviews,0,0,0
41600,True,5,Mixed,30,34,64
41610,True,0,No user reviews,0,0,0
41660,True,0,7 user reviews,3,4,7
41670,True,0,No user reviews,0,0,0
41680,True,0,7 user reviews,1,6,7
41690,True,0,No user reviews,0,0,0
41700,True,9,Overwhelmingly Positive,5076,252,5328
41710,True,0,No user reviews,0,0,0
41720,True,0,No user reviews,0,0,0
41730,True,6,Mostly Positive,35,10,45
41740,True,8,Very Positive,127,27,154
41760,True,0,No user reviews,0,0,0
41800,True,8,Very Positive,313,73,386
41802,True,0,1 user reviews,1,0,1
41803,True,0,1 user reviews,1,0,1
41804,True,0,1 user reviews,1,0,1
41805,True,0,No user reviews,0,0,0
41807,True,0,No user reviews,0,0,0
41808,True,0,No user reviews,0,0,0
41809,True,0,No user reviews,0,0,0
41810,True,0,No user reviews,0,0,0
41813,True,0,No user reviews,0,0,0
41814,True,0,1 user reviews,0,1,1
41815,True,0,No user reviews,0,0,0
41816,True,0,2 user reviews,1,1,2
41817,True,0,1 user reviews,1,0,1
41900,True,6,Mostly Positive,353,103,456
42000,True,0,7 user reviews,4,3,7
42110,True,0,No user reviews,0,0,0
42120,True,6,Mostly Positive,367,148,515
42129,True,0,No user reviews,0,0,0
42140,True,5,Mixed,57,35,92
42147,True,0,No user reviews,0,0,0
42160,True,5,Mixed,587,363,950
42170,True,5,Mixed,195,150,345
42180,True,0,No user reviews,0,0,0
42190,True,0,No user reviews,0,0,0
42200,True,6,Mostly Positive,31,8,39
42210,True,6,Mostly Positive,83,32,115
42220,True,8,Very Positive,75,11,86
42230,True,5,Mixed,35,16,51
42300,True,0,No user reviews,0,0,0
42320,True,0,No user reviews,0,0,0
42500,True,5,Mixed,86,54,140
42510,True,0,No user reviews,0,0,0
42520,True,0,No user reviews,0,0,0
42521,True,0,No user reviews,0,0,0
42640,True,8,Very Positive,225,4,229
42660,True,0,No user reviews,0,0,0
42670,True,8,Very Positive,1822,163,1985
42680,True,8,Very Positive,2752,560,3312
42690,True,0,2 user reviews,1,1,2
42695,True,0,8 user reviews,7,1,8
42696,True,7,Positive,10,0,10
42697,True,7,Positive,10,2,12
42698,True,0,5 user reviews,5,0,5
42699,True,0,No user reviews,0,0,0
42700,True,8,Very Positive,4240,599,4839
42710,True,8,Very Positive,291,27,318
42715,True,0,No user reviews,0,0,0
42716,True,7,Positive,31,7,38
42717,True,0,No user reviews,0,0,0
42718,True,6,Mostly Positive,40,12,52
42719,True,8,Very Positive,135,18,153
42720,True,0,No user reviews,0,0,0
42722,True,6,Mostly Positive,27,7,34
42723,True,0,No user reviews,0,0,0
42729,True,0,No user reviews,0,0,0
42730,True,7,Positive,16,1,17
42740,True,0,No user reviews,0,0,0
42749,True,0,No user reviews,0,0,0
42750,True,0,No user reviews,0,0,0
42800,True,0,1 user reviews,0,1,1
42810,True,6,Mostly Positive,39,15,54
42820,True,0,2 user reviews,0,2,2
42830,True,0,No user reviews,0,0,0
42840,True,0,No user reviews,0,0,0
42841,True,0,No user reviews,0,0,0
42842,True,0,No user reviews,0,0,0
42843,True,0,No user reviews,0,0,0
42844,True,0,No user reviews,0,0,0
42845,True,0,No user reviews,0,0,0
42846,True,0,No user reviews,0,0,0
42847,True,0,No user reviews,0,0,0
42848,True,0,No user reviews,0,0,0
42849,True,0,No user reviews,0,0,0
42850,True,8,Very Positive,121,23,144
42860,True,0,No user reviews,0,0,0
42870,True,0,No user reviews,0,0,0
42881,True,0,1 user reviews,1,0,1
42890,True,8,Very Positive,311,35,346
42900,True,0,1 user reviews,1,0,1
42901,True,0,No user reviews,0,0,0
42902,True,0,1 user reviews,1,0,1
42903,True,0,4 user reviews,4,0,4
42904,True,0,9 user reviews,4,5,9
42905,True,0,1 user reviews,1,0,1
42910,True,8,Very Positive,6186,814,7000
42914,True,0,No user reviews,0,0,0
42916,True,0,No user reviews,0,0,0
42917,True,0,No user reviews,0,0,0
42918,True,8,Very Positive,47,9,56
42919,True,0,No user reviews,0,0,0
42920,True,4,Mostly Negative,21,33,54
42925,True,0,No user reviews,0,0,0
42926,True,0,No user reviews,0,0,0
42929,True,0,No user reviews,0,0,0
42930,True,0,5 user reviews,4,1,5
42940,True,0,7 user reviews,5,2,7
42950,True,0,9 user reviews,8,1,9
42960,True,8,Very Positive,4595,392,4987
42964,True,7,Positive,13,2,15
42965,True,0,7 user reviews,6,1,7
42966,True,5,Mixed,6,4,10
42967,True,0,2 user reviews,2,0,2
42968,True,6,Mostly Positive,26,9,35
42980,True,6,Mostly Positive,60,23,83
42990,True,4,Mostly Negative,174,290,464
43000,True,5,Mixed,191,137,328
43005,True,0,2 user reviews,0,2,2
43006,True,0,2 user reviews,0,2,2
43011,True,0,1 user reviews,0,1,1
43012,True,0,No user reviews,0,0,0
43013,True,0,2 user reviews,1,1,2
43014,True,0,2 user reviews,1,1,2
43015,True,0,No user reviews,0,0,0
43016,True,0,No user reviews,0,0,0
43100,True,6,Mostly Positive,69,20,89
43110,True,8,Very Positive,2736,207,2943
43120,True,0,No user reviews,0,0,0
43129,True,0,No user reviews,0,0,0
43140,True,0,No user reviews,0,0,0
43160,True,8,Very Positive,3792,277,4069
43190,True,8,Very Positive,183,33,216
43210,True,0,No user reviews,0,0,0
43500,True,4,Mostly Negative,24,49,73
43600,True,8,Very Positive,85,12,97
44000,True,0,No user reviews,0,0,0
44100,True,8,Very Positive,53,10,63
44110,True,0,No user reviews,0,0,0
44205,True,0,No user reviews,0,0,0
44300,True,0,No user reviews,0,0,0
44320,True,5,Mixed,626,321,947
44340,True,5,Mixed,230,189,419
44350,True,6,Mostly Positive,2069,676,2745
44360,True,5,Mixed,104,46,150
44600,True,5,Mixed,18,14,32
44620,True,0,3 user reviews,3,0,3
44630,True,0,No user reviews,0,0,0
44650,True,0,7 user reviews,5,2,7
44660,True,7,Positive,9,1,10
44670,True,0,5 user reviews,5,0,5
44680,True,0,2 user reviews,2,0,2
44690,True,8,Very Positive,78,13,91
44720,True,0,No user reviews,0,0,0
45000,True,8,Very Positive,193,12,205
45010,True,0,No user reviews,0,0,0
45100,True,8,Very Positive,433,90,523
45200,True,7,Positive,11,0,11
45300,True,5,Mixed,198,108,306
45302,True,4,Mostly Negative,4,8,12
45310,True,0,No user reviews,0,0,0
45400,True,8,Very Positive,290,23,313
45410,True,5,Mixed,23,23,46
45420,True,0,1 user reviews,0,1,1
45430,True,0,No user reviews,0,0,0
45450,True,8,Very Positive,131,12,143
45460,True,0,No user reviews,0,0,0
45700,True,8,Very Positive,681,79,760
45710,True,5,Mixed,136,128,264
45720,True,5,Mixed,80,64,144
45730,True,5,Mixed,63,82,145
45740,True,6,Mostly Positive,1366,435,1801
45750,True,5,Mixed,724,352,1076
45760,True,8,Very Positive,3132,401,3533
45770,True,8,Very Positive,721,166,887
45772,True,0,No user reviews,0,0,0
45773,True,5,Mixed,11,15,26
45774,True,4,Mostly Negative,4,11,15
45775,True,4,Mostly Negative,6,18,24
45776,True,4,Mostly Negative,7,14,21
45777,True,0,No user reviews,0,0,0
45778,True,0,No user reviews,0,0,0
45790,True,0,2 user reviews,1,1,2
45791,True,0,2 user reviews,2,0,2
45792,True,0,1 user reviews,1,0,1
45793,True,0,2 user reviews,2,0,2
45794,True,0,No user reviews,0,0,0
45795,True,0,2 user reviews,1,1,2
45796,True,0,2 user reviews,1,1,2
45797,True,0,1 user reviews,1,0,1
45798,True,0,No user reviews,0,0,0
45900,True,3,Negative,2,11,13
46000,True,5,Mixed,46,22,68
46010,True,0,No user reviews,0,0,0
46200,True,5,Mixed,11,10,21
46210,True,0,2 user reviews,2,0,2
46220,True,0,2 user reviews,1,1,2
46230,True,0,7 user reviews,3,4,7
46250,True,6,Mostly Positive,74,26,100
46260,True,6,Mostly Positive,86,34,120
46270,True,5,Mixed,59,32,91
46280,True,4,Mostly Negative,11,28,39
46290,True,5,Mixed,47,42,89
46320,True,0,1 user reviews,1,0,1
46330,True,7,Positive,45,0,45
46340,True,5,Mixed,39,19,58
46342,True,0,2 user reviews,1,1,2
46350,True,5,Mixed,10,15,25
46360,True,5,Mixed,32,20,52
46362,True,0,No user reviews,0,0,0
46370,True,5,Mixed,65,53,118
46380,True,5,Mixed,14,21,35
46390,True,0,No user reviews,0,0,0
46400,True,5,Mixed,44,64,108
46410,True,5,Mixed,75,35,110
46420,True,5,Mixed,83,48,131
46430,True,6,Mostly Positive,36,14,50
46440,True,4,Mostly Negative,40,93,133
46450,True,5,Mixed,103,91,194
46460,True,8,Very Positive,177,33,210
46470,True,0,No user reviews,0,0,0
46480,True,8,Very Positive,227,48,275
46490,True,5,Mixed,67,85,152
46500,True,8,Very Positive,699,132,831
46510,True,8,Very Positive,277,54,331
46520,True,5,Mixed,42,31,73
46523,True,0,No user reviews,0,0,0
46540,True,4,Mostly Negative,85,158,243
46550,True,5,Mixed,49,53,102
46560,True,5,Mixed,176,140,316
46570,True,5,Mixed,40,52,92
46600,True,6,Mostly Positive,26,9,35
46610,True,0,No user reviews,0,0,0
46700,True,4,Mostly Negative,4,16,20
46710,True,5,Mixed,9,10,19
46720,True,4,Mostly Negative,3,9,12
46730,True,4,Mostly Negative,9,28,37
46740,True,4,Mostly Negative,10,32,42
46750,True,5,Mixed,74,49,123
46760,True,0,5 user reviews,2,3,5
46770,True,8,Very Positive,147,34,181
46790,True,5,Mixed,18,12,30
46792,True,0,No user reviews,0,0,0
46830,True,0,9 user reviews,4,5,9
46840,True,0,2 user reviews,0,2,2
46850,True,6,Mostly Positive,17,7,24
47000,True,8,Very Positive,259,51,310
47010,True,0,No user reviews,0,0,0
47110,True,0,7 user reviews,5,2,7
47120,True,0,1 user reviews,1,0,1
47130,True,0,7 user reviews,6,1,7
47400,True,4,Mostly Negative,306,1009,1315
47410,True,5,Mixed,52,28,80
47420,True,0,No user reviews,0,0,0
47421,True,0,No user reviews,0,0,0
47422,True,0,No user reviews,0,0,0
47423,True,0,No user reviews,0,0,0
47424,True,0,No user reviews,0,0,0
47425,True,0,No user reviews,0,0,0
47426,True,0,No user reviews,0,0,0
47430,True,0,No user reviews,0,0,0
47500,True,0,9 user reviews,7,2,9
47520,True,0,3 user reviews,2,1,3
47530,True,0,No user reviews,0,0,0
47540,True,8,Very Positive,183,42,225
47570,True,0,2 user reviews,2,0,2
47700,True,1,Overwhelmingly Negative,205,1274,1479
47720,True,0,No user reviews,0,0,0
47721,True,0,No user reviews,0,0,0
47722,True,0,No user reviews,0,0,0
47723,True,0,No user reviews,0,0,0
47730,True,7,Positive,41,2,43
47749,True,0,No user reviews,0,0,0
47760,True,0,No user reviews,0,0,0
47770,True,0,No user reviews,0,0,0
47780,True,8,Very Positive,4734,275,5009
47790,True,6,Mostly Positive,790,242,1032
47799,True,0,No user reviews,0,0,0
47810,True,8,Very Positive,8631,824,9455
47815,True,0,No user reviews,0,0,0
47830,True,7,Positive,10,1,11
47842,True,0,No user reviews,0,0,0
47843,True,0,No user reviews,0,0,0
47844,True,0,No user reviews,0,0,0
47850,True,0,1 user reviews,0,1,1
47870,True,6,Mostly Positive,3597,1113,4710
47880,True,8,Very Positive,149,2,151
47889,True,0,No user reviews,0,0,0
47890,True,8,Very Positive,10834,1850,12684
47892,True,6,Mostly Positive,37,10,47
47893,True,7,Positive,35,3,38
47894,True,8,Very Positive,51,7,58
47895,True,5,Mixed,6,5,11
47896,True,6,Mostly Positive,8,3,11
47897,True,0,8 user reviews,7,1,8
47898,True,8,Very Positive,41,9,50
47899,True,5,Mixed,5,7,12
47900,True,8,Very Positive,120,12,132
47911,True,0,No user reviews,0,0,0
47912,True,0,No user reviews,0,0,0
47920,True,5,Mixed,493,368,861
47930,True,8,Very Positive,162,36,198
47931,True,7,Positive,10,2,12
47932,True,5,Mixed,18,13,31
47933,True,0,No user reviews,0,0,0
47934,True,0,No user reviews,0,0,0
47935,True,0,No user reviews,0,0,0
47936,True,0,No user reviews,0,0,0
47940,True,0,No user reviews,0,0,0
48000,True,8,Very Positive,6610,518,7128
48010,True,0,No user reviews,0,0,0
48110,True,4,Mostly Negative,424,642,1066
48120,True,5,Mixed,30,29,59
48124,True,0,No user reviews,0,0,0
48127,True,0,No user reviews,0,0,0
48128,True,0,No user reviews,0,0,0
48129,True,0,No user reviews,0,0,0
48131,True,0,No user reviews,0,0,0
48132,True,0,No user reviews,0,0,0
48136,True,0,No user reviews,0,0,0
48137,True,0,No user reviews,0,0,0
48138,True,0,No user reviews,0,0,0
48140,True,0,No user reviews,0,0,0
48150,True,0,4 user reviews,4,0,4
48160,True,4,Mostly Negative,48,83,131
48165,True,0,No user reviews,0,0,0
48166,True,0,No user reviews,0,0,0
48167,True,0,1 user reviews,1,0,1
48173,True,0,No user reviews,0,0,0
48180,True,4,Mostly Negative,48,83,131
48185,True,0,No user reviews,0,0,0
48186,True,0,No user reviews,0,0,0
48187,True,0,1 user reviews,0,1,1
48190,True,8,Very Positive,3192,510,3702
48195,True,0,No user reviews,0,0,0
48196,True,0,No user reviews,0,0,0
48197,True,0,No user reviews,0,0,0
48198,True,0,No user reviews,0,0,0
48210,True,0,No user reviews,0,0,0
48218,True,0,No user reviews,0,0,0
48219,True,0,No user reviews,0,0,0
48220,True,4,Mostly Negative,1086,1836,2922
48224,True,0,No user reviews,0,0,0
48225,True,0,No user reviews,0,0,0
48226,True,0,No user reviews,0,0,0
48227,True,0,No user reviews,0,0,0
48228,True,0,No user reviews,0,0,0
48231,True,0,5 user reviews,1,4,5
48232,True,0,3 user reviews,1,2,3
48233,True,0,No user reviews,0,0,0
48234,True,0,No user reviews,0,0,0
48240,True,5,Mixed,3152,2607,5759
48258,True,0,No user reviews,0,0,0
48259,True,0,No user reviews,0,0,0
48260,True,0,No user reviews,0,0,0
48280,True,0,No user reviews,0,0,0
48700,True,9,Overwhelmingly Positive,43749,1009,44758
48705,True,8,Very Positive,1487,151,1638
48710,True,0,No user reviews,0,0,0
48720,True,8,Very Positive,2109,489,2598
48800,True,5,Mixed,356,405,761
48802,True,0,5 user reviews,5,0,5
48803,True,6,Mostly Positive,13,5,18
48804,True,0,3 user reviews,2,1,3
48805,True,0,5 user reviews,3,2,5
48806,True,6,Mostly Positive,10,3,13
48810,True,0,No user reviews,0,0,0
48830,True,0,No user reviews,0,0,0
48900,True,7,Positive,33,4,37
48950,True,8,Very Positive,211,30,241
49000,True,6,Mostly Positive,25,10,35
49300,True,5,Mixed,33,41,74
49310,True,0,2 user reviews,2,0,2
49311,True,0,4 user reviews,4,0,4
49312,True,0,No user reviews,0,0,0
49313,True,0,No user reviews,0,0,0
49314,True,0,No user reviews,0,0,0
49315,True,0,No user reviews,0,0,0
49320,True,5,Mixed,20,12,32
49330,True,5,Mixed,44,27,71
49337,True,0,2 user reviews,1,1,2
49340,True,0,No user reviews,0,0,0
49400,True,8,Very Positive,80,3,83
49402,True,0,No user reviews,0,0,0
49403,True,0,No user reviews,0,0,0
49404,True,0,No user reviews,0,0,0
49406,True,0,No user reviews,0,0,0
49407,True,0,No user reviews,0,0,0
49408,True,0,No user reviews,0,0,0
49409,True,0,No user reviews,0,0,0
49410,True,0,No user reviews,0,0,0
49411,True,0,No user reviews,0,0,0
49412,True,0,No user reviews,0,0,0
49413,True,0,No user reviews,0,0,0
49414,True,0,No user reviews,0,0,0
49415,True,0,No user reviews,0,0,0
49416,True,0,No user reviews,0,0,0
49417,True,0,No user reviews,0,0,0
49418,True,0,No user reviews,0,0,0
49419,True,0,No user reviews,0,0,0
49421,True,0,No user reviews,0,0,0
49422,True,0,No user reviews,0,0,0
49423,True,0,No user reviews,0,0,0
49424,True,0,No user reviews,0,0,0
49425,True,0,No user reviews,0,0,0
49426,True,0,No user reviews,0,0,0
49427,True,0,No user reviews,0,0,0
49428,True,0,No user reviews,0,0,0
49429,True,0,No user reviews,0,0,0
49430,True,0,No user reviews,0,0,0
49431,True,0,No user reviews,0,0,0
49432,True,0,No user reviews,0,0,0
49433,True,0,No user reviews,0,0,0
49434,True,0,No user reviews,0,0,0
49435,True,0,No user reviews,0,0,0
49436,True,0,No user reviews,0,0,0
49437,True,0,No user reviews,0,0,0
49438,True,0,No user reviews,0,0,0
49439,True,0,No user reviews,0,0,0
49440,True,0,No user reviews,0,0,0
49441,True,0,No user reviews,0,0,0
49442,True,0,No user reviews,0,0,0
49443,True,0,No user reviews,0,0,0
49460,True,0,No user reviews,0,0,0
49470,True,8,Very Positive,493,72,565
49473,True,0,3 user reviews,3,0,3
49474,True,0,2 user reviews,2,0,2
49475,True,0,4 user reviews,2,2,4
49476,True,0,3 user reviews,2,1,3
49477,True,0,No user reviews,0,0,0
49478,True,0,No user reviews,0,0,0
49479,True,0,No user reviews,0,0,0
49480,True,0,No user reviews,0,0,0
49490,True,0,1 user reviews,1,0,1
49491,True,0,1 user reviews,1,0,1
49492,True,0,1 user reviews,1,0,1
49493,True,0,1 user reviews,1,0,1
49494,True,0,1 user reviews,1,0,1
49495,True,0,1 user reviews,1,0,1
49496,True,0,1 user reviews,1,0,1
49497,True,0,1 user reviews,1,0,1
49498,True,0,1 user reviews,1,0,1
49499,True,0,1 user reviews,1,0,1
49520,True,9,Overwhelmingly Positive,81948,3388,85336
49536,True,0,No user reviews,0,0,0
49537,True,0,No user reviews,0,0,0
49538,True,0,No user reviews,0,0,0
49540,True,5,Mixed,1463,1430,2893
49600,True,9,Overwhelmingly Positive,3107,161,3268
49604,True,8,Very Positive,53,4,57
49605,True,0,No user reviews,0,0,0
49610,True,0,No user reviews,0,0,0
49700,True,0,2 user reviews,1,1,2
49800,True,4,Mostly Negative,65,116,181
49810,True,8,Very Positive,48,10,58
49900,True,5,Mixed,94,46,140
50000,True,8,Very Positive,115,6,121
50010,True,0,No user reviews,0,0,0
50100,True,0,No user reviews,0,0,0
50110,True,6,Mostly Positive,156,49,205
50120,True,0,7 user reviews,5,2,7
50130,True,8,Very Positive,7264,638,7902
50140,True,0,No user reviews,0,0,0
50141,True,0,No user reviews,0,0,0
50142,True,0,No user reviews,0,0,0
50148,True,0,No user reviews,0,0,0
50149,True,0,No user reviews,0,0,0
50203,True,0,No user reviews,0,0,0
50204,True,0,No user reviews,0,0,0
50205,True,0,No user reviews,0,0,0
50206,True,0,No user reviews,0,0,0
50207,True,0,No user reviews,0,0,0
50208,True,0,No user reviews,0,0,0
50209,True,0,No user reviews,0,0,0
50212,True,0,No user reviews,0,0,0
50213,True,0,No user reviews,0,0,0
50214,True,0,No user reviews,0,0,0
50215,True,0,No user reviews,0,0,0
50219,True,0,No user reviews,0,0,0
50233,True,0,No user reviews,0,0,0
50234,True,0,No user reviews,0,0,0
50235,True,0,No user reviews,0,0,0
50236,True,0,No user reviews,0,0,0
50237,True,0,No user reviews,0,0,0
50238,True,0,No user reviews,0,0,0
50239,True,0,No user reviews,0,0,0
50253,True,0,No user reviews,0,0,0
50254,True,0,No user reviews,0,0,0
50255,True,0,No user reviews,0,0,0
50256,True,0,No user reviews,0,0,0
50257,True,0,No user reviews,0,0,0
50258,True,0,No user reviews,0,0,0
50259,True,0,No user reviews,0,0,0
50273,True,0,No user reviews,0,0,0
50274,True,0,No user reviews,0,0,0
50275,True,0,No user reviews,0,0,0
50276,True,0,No user reviews,0,0,0
50277,True,0,No user reviews,0,0,0
50278,True,0,No user reviews,0,0,0
50279,True,0,No user reviews,0,0,0
50280,True,0,1 user reviews,1,0,1
50300,True,8,Very Positive,10191,788,10979
50310,True,0,9 user reviews,9,0,9
50400,True,0,5 user reviews,4,1,5
50409,True,0,No user reviews,0,0,0
50410,True,0,No user reviews,0,0,0
50411,True,0,No user reviews,0,0,0
50412,True,0,No user reviews,0,0,0
50413,True,0,No user reviews,0,0,0
50414,True,0,No user reviews,0,0,0
50415,True,0,No user reviews,0,0,0
50416,True,0,No user reviews,0,0,0
50417,True,0,No user reviews,0,0,0
50430,True,0,No user reviews,0,0,0
50431,True,0,No user reviews,0,0,0
50432,True,0,No user reviews,0,0,0
50433,True,0,No user reviews,0,0,0
50434,True,0,No user reviews,0,0,0
50435,True,0,No user reviews,0,0,0
50436,True,0,No user reviews,0,0,0
50437,True,0,No user reviews,0,0,0
50438,True,0,No user reviews,0,0,0
50439,True,0,No user reviews,0,0,0
50440,True,0,No user reviews,0,0,0
50470,True,0,No user reviews,0,0,0
50471,True,0,No user reviews,0,0,0
50510,True,4,Mostly Negative,27,42,69
50513,True,0,No user reviews,0,0,0
50620,True,8,Very Positive,2380,337,2717
50640,True,0,No user reviews,0,0,0
50650,True,8,Very Positive,1579,225,1804
50800,True,0,No user reviews,0,0,0
50820,True,6,Mostly Positive,16,5,21
50830,True,0,No user reviews,0,0,0
50900,True,0,1 user reviews,1,0,1
50910,True,7,Positive,13,0,13
50920,True,5,Mixed,9,4,13
50930,True,0,5 user reviews,1,4,5
50940,True,0,5 user reviews,4,1,5
50960,True,7,Positive,18,4,22
50970,True,5,Mixed,16,7,23
50980,True,7,Positive,15,3,18
50990,True,7,Positive,29,1,30
51000,True,6,Mostly Positive,14,6,20
51010,True,5,Mixed,38,17,55
51020,True,0,6 user reviews,6,0,6
51030,True,0,4 user reviews,4,0,4
51040,True,0,No user reviews,0,0,0
51060,True,8,Very Positive,57,10,67
51100,True,5,Mixed,30,19,49
52003,True,0,No user reviews,0,0,0
55000,True,8,Very Positive,135,22,157
55010,True,0,No user reviews,0,0,0
55020,True,0,2 user reviews,1,1,2
55030,True,0,No user reviews,0,0,0
55040,True,8,Very Positive,651,80,731
55050,True,0,No user reviews,0,0,0
55100,True,5,Mixed,836,581,1417
55110,True,5,Mixed,656,334,990
55112,True,0,No user reviews,0,0,0
55113,True,0,No user reviews,0,0,0
55114,True,0,No user reviews,0,0,0
55115,True,5,Mixed,11,14,25
55130,True,0,No user reviews,0,0,0
55140,True,8,Very Positive,789,150,939
55150,True,8,Very Positive,4073,282,4355
55162,True,0,No user reviews,0,0,0
55163,True,0,No user reviews,0,0,0
55164,True,0,No user reviews,0,0,0
55180,True,0,No user reviews,0,0,0
55182,True,0,No user reviews,0,0,0
55190,True,0,No user reviews,0,0,0
55203,True,0,3 user reviews,0,3,3
55204,True,0,1 user reviews,1,0,1
55205,True,7,Positive,14,2,16
55206,True,0,No user reviews,0,0,0
55207,True,0,No user reviews,0,0,0
55208,True,0,No user reviews,0,0,0
55210,True,0,No user reviews,0,0,0
55215,True,0,No user reviews,0,0,0
55216,True,0,No user reviews,0,0,0
55217,True,0,No user reviews,0,0,0
55218,True,0,No user reviews,0,0,0
55220,True,0,No user reviews,0,0,0
55221,True,0,No user reviews,0,0,0
55222,True,0,No user reviews,0,0,0
55223,True,0,No user reviews,0,0,0
55230,True,8,Very Positive,13821,776,14597
55280,True,0,No user reviews,0,0,0
55290,True,0,No user reviews,0,0,0
55340,True,7,Positive,11,1,12
55341,True,0,5 user reviews,5,0,5
55342,True,0,No user reviews,0,0,0
55343,True,0,6 user reviews,5,1,6
55344,True,0,7 user reviews,7,0,7
55345,True,7,Positive,9,2,11
55346,True,0,No user reviews,0,0,0
55347,True,5,Mixed,12,8,20
55348,True,5,Mixed,10,9,19
55349,True,0,No user reviews,0,0,0
55370,True,0,No user reviews,0,0,0
55380,True,7,Positive,30,5,35
55381,True,7,Positive,37,6,43
55382,True,5,Mixed,30,20,50
55383,True,0,No user reviews,0,0,0
55384,True,0,No user reviews,0,0,0
55385,True,6,Mostly Positive,14,4,18
55386,True,5,Mixed,10,15,25
55387,True,7,Positive,17,4,21
55388,True,5,Mixed,18,9,27
55389,True,7,Positive,21,4,25
55390,True,4,Mostly Negative,11,39,50
55391,True,5,Mixed,9,11,20
55392,True,6,Mostly Positive,15,4,19
55393,True,5,Mixed,15,11,26
55394,True,4,Mostly Negative,20,41,61
55395,True,5,Mixed,10,6,16
55396,True,6,Mostly Positive,17,7,24
55397,True,5,Mixed,11,9,20
55398,True,5,Mixed,23,13,36
55399,True,6,Mostly Positive,19,6,25
55400,True,5,Mixed,15,7,22
55409,True,0,No user reviews,0,0,0
55410,True,0,No user reviews,0,0,0
55470,True,0,6 user reviews,6,0,6
55471,True,0,9 user reviews,9,0,9
55472,True,7,Positive,10,2,12
55473,True,0,6 user reviews,6,0,6
55475,True,7,Positive,9,2,11
55476,True,0,3 user reviews,3,0,3
56400,True,8,Very Positive,2739,287,3026
56431,True,0,2 user reviews,2,0,2
56432,True,0,2 user reviews,2,0,2
56433,True,0,2 user reviews,2,0,2
56434,True,0,3 user reviews,3,0,3
56435,True,0,1 user reviews,1,0,1
56436,True,0,7 user reviews,5,2,7
56437,True,8,Very Positive,2739,287,3026
56438,True,7,Positive,15,0,15
56439,True,0,No user reviews,0,0,0
56460,True,0,No user reviews,0,0,0
56479,True,0,No user reviews,0,0,0
56480,True,0,4 user reviews,4,0,4
56481,True,0,3 user reviews,2,1,3
56482,True,0,3 user reviews,3,0,3
56483,True,0,1 user reviews,1,0,1
56484,True,0,1 user reviews,1,0,1
56485,True,0,3 user reviews,3,0,3
56486,True,0,No user reviews,0,0,0
56487,True,0,4 user reviews,4,0,4
56488,True,0,3 user reviews,3,0,3
56489,True,7,Positive,8,2,10
56490,True,0,No user reviews,0,0,0
56491,True,0,No user reviews,0,0,0
56492,True,0,No user reviews,0,0,0
56493,True,5,Mixed,9,4,13
56536,True,0,4 user reviews,4,0,4
56537,True,0,No user reviews,0,0,0
56538,True,0,2 user reviews,2,0,2
57000,True,8,Very Positive,56,8,64
57010,True,0,No user reviews,0,0,0
57200,True,8,Very Positive,185,19,204
57210,True,0,No user reviews,0,0,0
57300,True,9,Overwhelmingly Positive,8861,372,9233
57310,True,0,No user reviews,0,0,0
57400,True,9,Overwhelmingly Positive,1025,12,1037
57419,True,0,No user reviews,0,0,0
57500,True,0,No user reviews,0,0,0
57505,True,0,No user reviews,0,0,0
57506,True,0,No user reviews,0,0,0
57510,True,0,No user reviews,0,0,0
57515,True,0,No user reviews,0,0,0
57516,True,0,No user reviews,0,0,0
57517,True,0,No user reviews,0,0,0
57518,True,0,No user reviews,0,0,0
57600,True,8,Very Positive,185,4,189
57610,True,0,No user reviews,0,0,0
57620,True,5,Mixed,79,58,137
57630,True,0,No user reviews,0,0,0
57640,True,8,Very Positive,584,43,627
57650,True,5,Mixed,136,189,325
57655,True,0,2 user reviews,2,0,2
57656,True,0,2 user reviews,2,0,2
57680,True,5,Mixed,143,62,205
57690,True,8,Very Positive,3844,371,4215
57695,True,7,Positive,11,0,11
57696,True,7,Positive,12,2,14
57697,True,7,Positive,13,0,13
57700,True,6,Mostly Positive,50,20,70
57710,True,0,No user reviews,0,0,0
57720,True,0,No user reviews,0,0,0
57730,True,5,Mixed,50,34,84
57740,True,5,Mixed,282,139,421
57750,True,0,No user reviews,0,0,0
57800,True,4,Mostly Negative,26,48,74
57900,True,5,Mixed,1621,889,2510
57910,True,0,No user reviews,0,0,0
57919,True,0,No user reviews,0,0,0
57920,True,0,No user reviews,0,0,0
57921,True,0,No user reviews,0,0,0
57922,True,0,No user reviews,0,0,0
57923,True,6,Mostly Positive,11,4,15
57924,True,0,No user reviews,0,0,0
57925,True,6,Mostly Positive,23,6,29
57940,True,0,No user reviews,0,0,0
57970,True,0,No user reviews,0,0,0
57980,True,0,No user reviews,0,0,0
58200,True,8,Very Positive,140,21,161
58220,True,0,No user reviews,0,0,0
58230,True,7,Positive,27,2,29
58240,True,0,No user reviews,0,0,0
58300,True,6,Mostly Positive,16,6,22
58310,True,0,No user reviews,0,0,0
58400,True,4,Mostly Negative,17,37,54
58410,True,0,No user reviews,0,0,0
58510,True,6,Mostly Positive,70,22,92
58520,True,6,Mostly Positive,377,98,475
58529,True,0,No user reviews,0,0,0
58540,True,8,Very Positive,179,5,184
58550,True,4,Mostly Negative,66,168,234
58560,True,8,Very Positive,71,14,85
58570,True,8,Very Positive,165,41,206
58580,True,0,No user reviews,0,0,0
58600,True,0,No user reviews,0,0,0
58610,True,6,Mostly Positive,837,281,1118
58643,True,0,8 user reviews,5,3,8
58645,True,0,4 user reviews,3,1,4
58646,True,0,3 user reviews,2,1,3
58648,True,0,3 user reviews,2,1,3
60340,True,6,Mostly Positive,7,3,10
60350,True,7,Positive,24,2,26
60600,True,4,Mostly Negative,3,8,11
60602,True,0,No user reviews,0,0,0
60610,True,0,No user reviews,0,0,0
60700,True,4,Mostly Negative,7,13,20
60800,True,5,Mixed,35,43,78
60810,True,0,No user reviews,0,0,0
61000,True,7,Positive,35,3,38
61010,True,8,Very Positive,77,2,79
61100,True,6,Mostly Positive,58,16,74
61220,True,5,Mixed,32,36,68
61230,True,0,1 user reviews,1,0,1
61310,True,7,Positive,30,6,36
61500,True,6,Mostly Positive,248,84,332
61510,True,6,Mostly Positive,72,22,94
61520,True,8,Very Positive,185,22,207
61530,True,0,No user reviews,0,0,0
61600,True,8,Very Positive,167,7,174
61700,True,8,Very Positive,581,107,688
61710,True,0,5 user reviews,3,2,5
61720,True,0,No user reviews,0,0,0
61730,True,8,Very Positive,147,10,157
61800,True,0,No user reviews,0,0,0
61810,True,0,No user reviews,0,0,0
61820,True,0,No user reviews,0,0,0
61830,True,0,No user reviews,0,0,0
62000,True,8,Very Positive,274,26,300
62100,True,8,Very Positive,403,20,423
62109,True,0,No user reviews,0,0,0
63000,True,8,Very Positive,297,52,349
63003,True,0,1 user reviews,1,0,1
63004,True,0,1 user reviews,1,0,1
63005,True,0,No user reviews,0,0,0
63010,True,0,No user reviews,0,0,0
63110,True,5,Mixed,48,27,75
63200,True,8,Very Positive,482,117,599
63209,True,0,No user reviews,0,0,0
63210,True,0,No user reviews,0,0,0
63211,True,0,No user reviews,0,0,0
63212,True,0,No user reviews,0,0,0
63213,True,0,No user reviews,0,0,0
63220,True,0,No user reviews,0,0,0
63230,True,0,No user reviews,0,0,0
63380,True,8,Very Positive,1919,286,2205
63391,True,0,No user reviews,0,0,0
63392,True,0,No user reviews,0,0,0
63398,True,6,Mostly Positive,15,5,20
63399,True,6,Mostly Positive,14,6,20
63500,True,8,Very Positive,167,16,183
63600,True,5,Mixed,120,70,190
63610,True,8,Very Positive,414,83,497
63620,True,6,Mostly Positive,49,13,62
63630,True,6,Mostly Positive,20,6,26
63640,True,6,Mostly Positive,19,6,25
63650,True,8,Very Positive,71,17,88
63660,True,6,Mostly Positive,259,67,326
63700,True,8,Very Positive,380,85,465
63710,True,8,Very Positive,897,140,1037
63800,True,5,Mixed,118,87,205
63802,True,0,1 user reviews,1,0,1
63803,True,0,No user reviews,0,0,0
63900,True,6,Mostly Positive,47,13,60
63910,True,8,Very Positive,247,20,267
63919,True,0,No user reviews,0,0,0
63920,True,0,No user reviews,0,0,0
63930,True,0,No user reviews,0,0,0
63940,True,5,Mixed,201,158,359
63942,True,0,No user reviews,0,0,0
63950,True,5,Mixed,234,122,356
63953,True,0,No user reviews,0,0,0
63958,True,0,No user reviews,0,0,0
63959,True,0,No user reviews,0,0,0
63960,True,4,Mostly Negative,29,49,78
64000,True,8,Very Positive,1341,185,1526
64002,True,0,No user reviews,0,0,0
64005,True,0,4 user reviews,2,2,4
64008,True,0,No user reviews,0,0,0
64009,True,0,No user reviews,0,0,0
64013,True,0,9 user reviews,7,2,9
64014,True,0,3 user reviews,2,1,3
64015,True,0,No user reviews,0,0,0
64016,True,0,3 user reviews,2,1,3
64017,True,0,7 user reviews,5,2,7
64030,True,0,No user reviews,0,0,0
65070,True,5,Mixed,24,24,48
65080,True,5,Mixed,29,16,45
65090,True,0,No user reviews,0,0,0
65100,True,0,6 user reviews,6,0,6
65110,True,0,No user reviews,0,0,0
65120,True,0,No user reviews,0,0,0
65200,True,4,Mostly Negative,20,35,55
65210,True,0,No user reviews,0,0,0
65211,True,0,No user reviews,0,0,0
65212,True,0,No user reviews,0,0,0
65213,True,0,No user reviews,0,0,0
65214,True,0,No user reviews,0,0,0
65215,True,6,Mostly Positive,8,3,11
65216,True,7,Positive,25,2,27
65217,True,5,Mixed,27,15,42
65218,True,8,Very Positive,46,5,51
65219,True,0,No user reviews,0,0,0
65220,True,0,No user reviews,0,0,0
65221,True,0,No user reviews,0,0,0
65222,True,0,No user reviews,0,0,0
65223,True,0,No user reviews,0,0,0
65224,True,5,Mixed,11,8,19
65225,True,0,No user reviews,0,0,0
65226,True,0,7 user reviews,5,2,7
65227,True,0,1 user reviews,1,0,1
65228,True,0,9 user reviews,8,1,9
65229,True,6,Mostly Positive,13,5,18
65230,True,0,No user reviews,0,0,0
65231,True,5,Mixed,23,13,36
65232,True,5,Mixed,32,31,63
65233,True,6,Mostly Positive,24,9,33
65234,True,0,No user reviews,0,0,0
65235,True,0,1 user reviews,1,0,1
65236,True,0,No user reviews,0,0,0
65237,True,0,1 user reviews,1,0,1
65238,True,0,No user reviews,0,0,0
65239,True,5,Mixed,20,26,46
65240,True,0,No user reviews,0,0,0
65241,True,0,1 user reviews,1,0,1
65242,True,7,Positive,12,1,13
65243,True,7,Positive,11,0,11
65244,True,7,Positive,22,3,25
65245,True,0,No user reviews,0,0,0
65246,True,4,Mostly Negative,5,13,18
65247,True,7,Positive,14,3,17
65248,True,0,No user reviews,0,0,0
65249,True,0,4 user reviews,2,2,4
65250,True,0,7 user reviews,4,3,7
65251,True,0,No user reviews,0,0,0
65252,True,7,Positive,14,2,16
65253,True,7,Positive,24,2,26
65254,True,0,5 user reviews,3,2,5
65255,True,6,Mostly Positive,27,7,34
65256,True,0,7 user reviews,4,3,7
65257,True,0,No user reviews,0,0,0
65258,True,0,6 user reviews,4,2,6
65259,True,7,Positive,15,1,16
65260,True,0,1 user reviews,1,0,1
65270,True,8,Very Positive,126,22,148
65300,True,8,Very Positive,766,42,808
65302,True,0,9 user reviews,9,0,9
65400,True,8,Very Positive,80,11,91
65410,True,0,No user reviews,0,0,0
65500,True,5,Mixed,32,30,62
65520,True,0,No user reviews,0,0,0
65530,True,5,Mixed,34,18,52
65540,True,6,Mostly Positive,924,267,1191
65560,True,5,Mixed,59,85,144
65600,True,4,Mostly Negative,64,107,171
65610,True,5,Mixed,59,74,133
65700,True,8,Very Positive,133,15,148
65720,True,8,Very Positive,112,23,135
65730,True,5,Mixed,133,90,223
65733,True,0,5 user reviews,2,3,5
65734,True,0,3 user reviews,3,0,3
65735,True,0,1 user reviews,1,0,1
65740,True,5,Mixed,180,234,414
65760,True,0,No user reviews,0,0,0
65770,True,0,No user reviews,0,0,0
65780,True,6,Mostly Positive,204,73,277
65790,True,8,Very Positive,614,78,692
65800,True,8,Very Positive,5456,460,5916
65810,True,0,No user reviews,0,0,0
65811,True,0,No user reviews,0,0,0
65900,True,0,No user reviews,0,0,0
65920,True,8,Very Positive,115,16,131
65930,True,5,Mixed,1580,923,2503
65950,True,7,Positive,28,1,29
65959,True,0,No user reviews,0,0,0
65980,True,5,Mixed,4602,3927,8529
66000,True,4,Mostly Negative,7,22,29
66001,True,4,Mostly Negative,3,10,13
66002,True,5,Mixed,22,15,37
67000,True,6,Mostly Positive,264,80,344
67010,True,0,No user reviews,0,0,0
67100,True,0,No user reviews,0,0,0
67210,True,0,No user reviews,0,0,0
67250,True,0,No user reviews,0,0,0
67310,True,0,No user reviews,0,0,0
67350,True,0,No user reviews,0,0,0
67370,True,8,Very Positive,2041,283,2324
67379,True,0,No user reviews,0,0,0
67684,True,0,No user reviews,0,0,0
70000,True,8,Very Positive,3869,551,4420
70004,True,0,No user reviews,0,0,0
70010,True,0,No user reviews,0,0,0
70100,True,5,Mixed,146,74,220
70110,True,5,Mixed,39,31,70
70120,True,4,Mostly Negative,31,97,128
70130,True,0,No user reviews,0,0,0
70140,True,0,No user reviews,0,0,0
70200,True,6,Mostly Positive,35,9,44
70210,True,6,Mostly Positive,56,15,71
70220,True,0,No user reviews,0,0,0
70230,True,0,No user reviews,0,0,0
70300,True,9,Overwhelmingly Positive,3029,103,3132
70310,True,0,No user reviews,0,0,0
70400,True,9,Overwhelmingly Positive,4295,153,4448
70410,True,0,No user reviews,0,0,0
70420,True,6,Mostly Positive,318,100,418
70430,True,0,No user reviews,0,0,0
70500,True,7,Positive,19,3,22
70510,True,0,No user reviews,0,0,0
70600,True,8,Very Positive,724,130,854
70603,True,0,No user reviews,0,0,0
70604,True,0,No user reviews,0,0,0
70605,True,0,No user reviews,0,0,0
70606,True,0,No user reviews,0,0,0
70607,True,0,No user reviews,0,0,0
70608,True,0,No user reviews,0,0,0
70609,True,0,No user reviews,0,0,0
70610,True,0,No user reviews,0,0,0
70611,True,0,No user reviews,0,0,0
70615,True,0,No user reviews,0,0,0
70616,True,0,7 user reviews,5,2,7
70617,True,0,5 user reviews,4,1,5
70620,True,8,Very Positive,126,20,146
70631,True,0,No user reviews,0,0,0
70640,True,8,Very Positive,142,23,165
70650,True,6,Mostly Positive,42,18,60
70660,True,5,Mixed,47,25,72
70900,True,8,Very Positive,174,26,200
70910,True,0,No user reviews,0,0,0
71000,True,6,Mostly Positive,247,77,324
71110,True,0,2 user reviews,2,0,2
71111,True,0,3 user reviews,3,0,3
71112,True,0,5 user reviews,4,1,5
71113,True,7,Positive,17,2,19
71114,True,0,3 user reviews,3,0,3
71115,True,0,4 user reviews,2,2,4
71116,True,0,6 user reviews,6,0,6
71117,True,0,4 user reviews,4,0,4
71118,True,0,4 user reviews,4,0,4
71119,True,0,4 user reviews,4,0,4
71120,True,0,9 user reviews,9,0,9
71160,True,0,4 user reviews,4,0,4
71161,True,0,2 user reviews,2,0,2
71162,True,7,Positive,13,0,13
71163,True,7,Positive,9,1,10
71164,True,0,6 user reviews,6,0,6
71165,True,0,7 user reviews,7,0,7
71166,True,0,5 user reviews,5,0,5
71167,True,0,2 user reviews,2,0,2
71168,True,0,3 user reviews,3,0,3
71230,True,8,Very Positive,607,119,726
71240,True,8,Very Positive,173,21,194
71250,True,8,Very Positive,2880,340,3220
71260,True,8,Very Positive,345,49,394
71270,True,8,Very Positive,100,0,100
71275,True,0,No user reviews,0,0,0
71280,True,0,No user reviews,0,0,0
71300,True,0,No user reviews,0,0,0
71310,True,0,No user reviews,0,0,0
71320,True,0,No user reviews,0,0,0
71340,True,8,Very Positive,5135,402,5537
71390,True,6,Mostly Positive,68,25,93
71400,True,0,No user reviews,0,0,0
71410,True,0,No user reviews,0,0,0
71420,True,0,9 user reviews,8,1,9
72000,True,8,Very Positive,194,35,229
72200,True,8,Very Positive,1398,330,1728
72300,True,5,Mixed,39,23,62
72310,True,0,No user reviews,0,0,0
72400,True,6,Mostly Positive,54,17,71
72410,True,0,No user reviews,0,0,0
72510,True,0,No user reviews,0,0,0
72520,True,0,No user reviews,0,0,0
72530,True,0,No user reviews,0,0,0
72701,True,0,No user reviews,0,0,0
72705,True,0,No user reviews,0,0,0
72709,True,0,4 user reviews,3,1,4
72713,True,0,No user reviews,0,0,0
72730,True,5,Mixed,970,534,1504
72740,True,8,Very Positive,582,119,701
72750,True,8,Very Positive,673,72,745
72760,True,8,Very Positive,475,43,518
72770,True,0,4 user reviews,2,2,4
72771,True,8,Very Positive,582,119,701
72772,True,0,9 user reviews,7,2,9
72773,True,0,2 user reviews,1,1,2
72774,True,0,3 user reviews,2,1,3
72780,True,0,No user reviews,0,0,0
72840,True,8,Very Positive,295,17,312
72850,True,8,Very Positive,88209,7433,95642
72869,True,0,No user reviews,0,0,0
72900,True,5,Mixed,70,38,108
72902,True,0,2 user reviews,1,1,2
72903,True,0,No user reviews,0,0,0
72904,True,0,No user reviews,0,0,0
72905,True,0,No user reviews,0,0,0
72906,True,0,No user reviews,0,0,0
72907,True,0,No user reviews,0,0,0
72910,True,0,No user reviews,0,0,0
73000,True,0,No user reviews,0,0,0
73010,True,6,Mostly Positive,227,89,316
73012,True,0,1 user reviews,1,0,1
73013,True,0,1 user reviews,1,0,1
73014,True,0,1 user reviews,0,1,1
73016,True,0,No user reviews,0,0,0
73017,True,0,No user reviews,0,0,0
73018,True,0,No user reviews,0,0,0
73019,True,0,No user reviews,0,0,0
73020,True,6,Mostly Positive,346,139,485
73030,True,7,Positive,17,4,21
73031,True,7,Positive,20,3,23
73032,True,0,No user reviews,0,0,0
73033,True,0,6 user reviews,4,2,6
73034,True,0,No user reviews,0,0,0
73035,True,0,9 user reviews,6,3,9
73036,True,0,8 user reviews,5,3,8
73037,True,5,Mixed,7,4,11
73038,True,0,No user reviews,0,0,0
73039,True,0,3 user reviews,3,0,3
73040,True,0,No user reviews,0,0,0
73041,True,0,6 user reviews,2,4,6
73050,True,0,No user reviews,0,0,0
73054,True,0,8 user reviews,6,2,8
73055,True,0,No user reviews,0,0,0
73056,True,0,No user reviews,0,0,0
73057,True,0,6 user reviews,6,0,6
73058,True,4,Mostly Negative,10,23,33
73059,True,0,No user reviews,0,0,0
73060,True,4,Mostly Negative,9,26,35
73071,True,0,2 user reviews,1,1,2
73088,True,0,No user reviews,0,0,0
73089,True,0,No user reviews,0,0,0
73091,True,0,6 user reviews,4,2,6
73092,True,0,4 user reviews,3,1,4
73093,True,5,Mixed,9,6,15
73094,True,0,No user reviews,0,0,0
73095,True,0,3 user reviews,3,0,3
73096,True,0,2 user reviews,2,0,2
73097,True,0,4 user reviews,4,0,4
73098,True,0,2 user reviews,2,0,2
73099,True,0,No user reviews,0,0,0
73108,True,0,No user reviews,0,0,0
73109,True,0,No user reviews,0,0,0
73110,True,0,No user reviews,0,0,0
73115,True,0,8 user reviews,5,3,8
73118,True,0,No user reviews,0,0,0
73119,True,0,3 user reviews,2,1,3
73120,True,0,5 user reviews,5,0,5
73121,True,0,No user reviews,0,0,0
73170,True,8,Very Positive,623,72,695
73179,True,0,No user reviews,0,0,0
73180,True,0,No user reviews,0,0,0
73181,True,0,No user reviews,0,0,0
73182,True,0,No user reviews,0,0,0
73183,True,0,5 user reviews,4,1,5
73184,True,0,No user reviews,0,0,0
73185,True,0,No user reviews,0,0,0
73186,True,0,No user reviews,0,0,0
73187,True,0,1 user reviews,1,0,1
73188,True,0,No user reviews,0,0,0
73190,True,5,Mixed,28,30,58
73192,True,0,No user reviews,0,0,0
73193,True,0,1 user reviews,1,0,1
73194,True,0,No user reviews,0,0,0
73195,True,0,2 user reviews,2,0,2
73210,True,5,Mixed,117,66,183
73220,True,5,Mixed,69,36,105
73230,True,8,Very Positive,134,2,136
78000,True,9,Overwhelmingly Positive,1338,70,1408
78002,True,0,No user reviews,0,0,0
80000,True,4,Mostly Negative,17,65,82
80010,True,0,1 user reviews,0,1,1
80020,True,0,No user reviews,0,0,0
80200,True,6,Mostly Positive,229,60,289
80202,True,0,1 user reviews,1,0,1
80204,True,0,1 user reviews,1,0,1
80205,True,0,No user reviews,0,0,0
80206,True,0,No user reviews,0,0,0
80207,True,0,1 user reviews,1,0,1
80222,True,0,No user reviews,0,0,0
80300,True,7,Positive,37,7,44
80310,True,8,Very Positive,612,81,693
80330,True,8,Very Positive,573,74,647
80340,True,8,Very Positive,234,22,256
80350,True,8,Very Positive,193,9,202
80360,True,8,Very Positive,208,6,214
80400,True,0,No user reviews,0,0,0
80401,True,0,No user reviews,0,0,0
80402,True,0,No user reviews,0,0,0
80403,True,0,No user reviews,0,0,0
80404,True,0,No user reviews,0,0,0
80405,True,0,No user reviews,0,0,0
80406,True,0,No user reviews,0,0,0
80407,True,0,No user reviews,0,0,0
80408,True,0,No user reviews,0,0,0
80409,True,0,No user reviews,0,0,0
80410,True,0,No user reviews,0,0,0
80411,True,0,No user reviews,0,0,0
80412,True,0,No user reviews,0,0,0
80413,True,0,No user reviews,0,0,0
80414,True,0,No user reviews,0,0,0
80415,True,0,No user reviews,0,0,0
80416,True,0,No user reviews,0,0,0
80417,True,0,No user reviews,0,0,0
80418,True,0,No user reviews,0,0,0
80419,True,0,No user reviews,0,0,0
80420,True,0,No user reviews,0,0,0
80421,True,0,No user reviews,0,0,0
80422,True,0,No user reviews,0,0,0
80423,True,0,No user reviews,0,0,0
80424,True,0,No user reviews,0,0,0
80425,True,0,No user reviews,0,0,0
80426,True,0,No user reviews,0,0,0
80427,True,0,No user reviews,0,0,0
80428,True,0,No user reviews,0,0,0
80429,True,0,No user reviews,0,0,0
80430,True,0,No user reviews,0,0,0
80431,True,0,No user reviews,0,0,0
80432,True,0,No user reviews,0,0,0
80433,True,0,No user reviews,0,0,0
80434,True,0,No user reviews,0,0,0
80435,True,0,No user reviews,0,0,0
80436,True,0,No user reviews,0,0,0
80437,True,0,No user reviews,0,0,0
80438,True,0,No user reviews,0,0,0
80439,True,0,No user reviews,0,0,0
80440,True,0,No user reviews,0,0,0
80441,True,0,No user reviews,0,0,0
80442,True,0,No user reviews,0,0,0
80443,True,0,No user reviews,0,0,0
80444,True,0,No user reviews,0,0,0
80445,True,0,No user reviews,0,0,0
80446,True,0,No user reviews,0,0,0
80447,True,0,No user reviews,0,0,0
80448,True,0,No user reviews,0,0,0
80449,True,0,No user reviews,0,0,0
80450,True,0,No user reviews,0,0,0
80451,True,0,No user reviews,0,0,0
80452,True,0,No user reviews,0,0,0
80453,True,0,No user reviews,0,0,0
80454,True,0,No user reviews,0,0,0
80455,True,0,No user reviews,0,0,0
80456,True,0,No user reviews,0,0,0
80457,True,0,No user reviews,0,0,0
80458,True,0,No user reviews,0,0,0
80459,True,0,No user reviews,0,0,0
80460,True,0,No user reviews,0,0,0
80461,True,0,No user reviews,0,0,0
80462,True,0,No user reviews,0,0,0
80463,True,0,No user reviews,0,0,0
80464,True,0,No user reviews,0,0,0
80465,True,0,No user reviews,0,0,0
80466,True,0,No user reviews,0,0,0
80467,True,0,No user reviews,0,0,0
80468,True,0,No user reviews,0,0,0
80469,True,0,No user reviews,0,0,0
80470,True,0,No user reviews,0,0,0
80471,True,0,No user reviews,0,0,0
80472,True,0,No user reviews,0,0,0
80473,True,0,No user reviews,0,0,0
80474,True,0,No user reviews,0,0,0
80475,True,0,No user reviews,0,0,0
80476,True,0,No user reviews,0,0,0
80477,True,0,No user reviews,0,0,0
80478,True,0,No user reviews,0,0,0
80485,True,0,No user reviews,0,0,0
80486,True,0,No user reviews,0,0,0
80487,True,0,No user reviews,0,0,0
80488,True,0,No user reviews,0,0,0
80489,True,0,No user reviews,0,0,0
80490,True,0,No user reviews,0,0,0
80491,True,0,No user reviews,0,0,0
80492,True,0,No user reviews,0,0,0
80493,True,0,No user reviews,0,0,0
80494,True,0,No user reviews,0,0,0
80495,True,0,No user reviews,0,0,0
80496,True,0,No user reviews,0,0,0
80497,True,0,No user reviews,0,0,0
80498,True,0,No user reviews,0,0,0
80500,True,0,No user reviews,0,0,0
80501,True,0,No user reviews,0,0,0
80502,True,0,No user reviews,0,0,0
80503,True,0,No user reviews,0,0,0
80504,True,0,No user reviews,0,0,0
80505,True,0,No user reviews,0,0,0
80506,True,0,No user reviews,0,0,0
80507,True,0,No user reviews,0,0,0
80508,True,0,No user reviews,0,0,0
80509,True,0,No user reviews,0,0,0
80510,True,0,No user reviews,0,0,0
80511,True,0,No user reviews,0,0,0
80512,True,0,No user reviews,0,0,0
80513,True,0,No user reviews,0,0,0
80514,True,0,No user reviews,0,0,0
80515,True,0,No user reviews,0,0,0
80516,True,0,No user reviews,0,0,0
80517,True,0,No user reviews,0,0,0
80518,True,0,No user reviews,0,0,0
80519,True,0,No user reviews,0,0,0
80520,True,0,No user reviews,0,0,0
80521,True,0,No user reviews,0,0,0
80522,True,0,No user reviews,0,0,0
80523,True,0,No user reviews,0,0,0
80524,True,0,No user reviews,0,0,0
80525,True,0,No user reviews,0,0,0
80526,True,0,No user reviews,0,0,0
80527,True,0,No user reviews,0,0,0
80528,True,0,No user reviews,0,0,0
80529,True,0,No user reviews,0,0,0
80530,True,0,No user reviews,0,0,0
80531,True,0,No user reviews,0,0,0
80532,True,0,No user reviews,0,0,0
80533,True,0,No user reviews,0,0,0
80534,True,0,No user reviews,0,0,0
80535,True,0,No user reviews,0,0,0
80536,True,0,No user reviews,0,0,0
80537,True,0,No user reviews,0,0,0
80538,True,0,No user reviews,0,0,0
80539,True,0,No user reviews,0,0,0
80540,True,0,No user reviews,0,0,0
80541,True,0,No user reviews,0,0,0
80542,True,0,No user reviews,0,0,0
80543,True,0,No user reviews,0,0,0
80544,True,0,No user reviews,0,0,0
80545,True,0,No user reviews,0,0,0
80546,True,0,No user reviews,0,0,0
80547,True,0,No user reviews,0,0,0
80548,True,0,No user reviews,0,0,0
80549,True,0,No user reviews,0,0,0
80550,True,0,No user reviews,0,0,0
80551,True,0,No user reviews,0,0,0
80552,True,0,No user reviews,0,0,0
80553,True,0,No user reviews,0,0,0
80554,True,0,No user reviews,0,0,0
80555,True,0,No user reviews,0,0,0
80556,True,0,No user reviews,0,0,0
80557,True,0,No user reviews,0,0,0
80558,True,0,No user reviews,0,0,0
80559,True,0,No user reviews,0,0,0
80560,True,0,No user reviews,0,0,0
80561,True,0,No user reviews,0,0,0
80562,True,0,No user reviews,0,0,0
80563,True,0,No user reviews,0,0,0
80564,True,0,No user reviews,0,0,0
80565,True,0,No user reviews,0,0,0
80566,True,0,No user reviews,0,0,0
80567,True,0,No user reviews,0,0,0
80568,True,0,No user reviews,0,0,0
80569,True,0,No user reviews,0,0,0
80570,True,0,No user reviews,0,0,0
80571,True,0,No user reviews,0,0,0
80572,True,0,No user reviews,0,0,0
80573,True,0,No user reviews,0,0,0
80574,True,0,No user reviews,0,0,0
80575,True,0,No user reviews,0,0,0
80576,True,0,No user reviews,0,0,0
80577,True,0,No user reviews,0,0,0
80578,True,0,No user reviews,0,0,0
80579,True,0,No user reviews,0,0,0
80580,True,0,No user reviews,0,0,0
80581,True,0,No user reviews,0,0,0
80582,True,0,No user reviews,0,0,0
80583,True,0,No user reviews,0,0,0
80584,True,0,No user reviews,0,0,0
80585,True,0,No user reviews,0,0,0
80586,True,0,No user reviews,0,0,0
80589,True,0,No user reviews,0,0,0
80590,True,0,No user reviews,0,0,0
80591,True,0,No user reviews,0,0,0
80592,True,0,No user reviews,0,0,0
80593,True,0,No user reviews,0,0,0
80594,True,0,No user reviews,0,0,0
80595,True,0,No user reviews,0,0,0
80596,True,0,No user reviews,0,0,0
80597,True,0,No user reviews,0,0,0
80598,True,0,No user reviews,0,0,0
80599,True,0,No user reviews,0,0,0
80600,True,0,No user reviews,0,0,0
80601,True,0,No user reviews,0,0,0
80602,True,0,No user reviews,0,0,0
80603,True,0,No user reviews,0,0,0
80604,True,0,No user reviews,0,0,0
80605,True,0,No user reviews,0,0,0
80606,True,0,No user reviews,0,0,0
80607,True,0,No user reviews,0,0,0
80608,True,0,No user reviews,0,0,0
80609,True,0,No user reviews,0,0,0
80610,True,0,No user reviews,0,0,0
80611,True,0,No user reviews,0,0,0
80612,True,0,No user reviews,0,0,0
80613,True,0,No user reviews,0,0,0
80614,True,0,No user reviews,0,0,0
80615,True,0,No user reviews,0,0,0
80616,True,0,No user reviews,0,0,0
80617,True,0,No user reviews,0,0,0
80618,True,0,No user reviews,0,0,0
80619,True,0,No user reviews,0,0,0
80620,True,0,No user reviews,0,0,0
80621,True,0,No user reviews,0,0,0
80622,True,0,No user reviews,0,0,0
80623,True,0,No user reviews,0,0,0
80624,True,0,No user reviews,0,0,0
80625,True,0,No user reviews,0,0,0
80626,True,0,No user reviews,0,0,0
80627,True,0,No user reviews,0,0,0
80628,True,0,No user reviews,0,0,0
80629,True,0,No user reviews,0,0,0
80630,True,0,No user reviews,0,0,0
80631,True,0,No user reviews,0,0,0
80632,True,0,No user reviews,0,0,0
80633,True,0,No user reviews,0,0,0
80634,True,0,No user reviews,0,0,0
80635,True,0,No user reviews,0,0,0
80636,True,0,No user reviews,0,0,0
80637,True,0,No user reviews,0,0,0
80638,True,0,No user reviews,0,0,0
80639,True,0,No user reviews,0,0,0
80640,True,0,No user reviews,0,0,0
80641,True,0,No user reviews,0,0,0
80642,True,0,No user reviews,0,0,0
80643,True,0,No user reviews,0,0,0
80644,True,0,No user reviews,0,0,0
80648,True,0,No user reviews,0,0,0
80649,True,0,No user reviews,0,0,0
80650,True,0,No user reviews,0,0,0
80651,True,0,No user reviews,0,0,0
80652,True,0,No user reviews,0,0,0
80653,True,0,No user reviews,0,0,0
80654,True,0,No user reviews,0,0,0
80655,True,0,No user reviews,0,0,0
80656,True,0,No user reviews,0,0,0
80657,True,0,No user reviews,0,0,0
80658,True,0,No user reviews,0,0,0
80659,True,0,No user reviews,0,0,0
80660,True,0,No user reviews,0,0,0
80661,True,0,No user reviews,0,0,0
80662,True,0,No user reviews,0,0,0
80663,True,0,No user reviews,0,0,0
80664,True,0,No user reviews,0,0,0
80665,True,0,No user reviews,0,0,0
80666,True,0,No user reviews,0,0,0
80667,True,0,No user reviews,0,0,0
80668,True,0,No user reviews,0,0,0
80669,True,0,No user reviews,0,0,0
80670,True,0,No user reviews,0,0,0
80671,True,0,No user reviews,0,0,0
80672,True,0,No user reviews,0,0,0
80673,True,0,No user reviews,0,0,0
80674,True,0,No user reviews,0,0,0
80675,True,0,No user reviews,0,0,0
80676,True,0,No user reviews,0,0,0
80677,True,0,No user reviews,0,0,0
80679,True,0,No user reviews,0,0,0
80680,True,0,No user reviews,0,0,0
80681,True,0,No user reviews,0,0,0
80682,True,0,No user reviews,0,0,0
80683,True,0,No user reviews,0,0,0
80684,True,0,No user reviews,0,0,0
80685,True,0,No user reviews,0,0,0
80686,True,0,No user reviews,0,0,0
80687,True,0,No user reviews,0,0,0
80688,True,0,No user reviews,0,0,0
80689,True,0,No user reviews,0,0,0
80690,True,0,No user reviews,0,0,0
80691,True,0,No user reviews,0,0,0
80692,True,0,No user reviews,0,0,0
80694,True,0,No user reviews,0,0,0
80696,True,0,No user reviews,0,0,0
80697,True,0,No user reviews,0,0,0
80698,True,0,No user reviews,0,0,0
80699,True,0,No user reviews,0,0,0
80700,True,0,No user reviews,0,0,0
80702,True,0,No user reviews,0,0,0
80703,True,0,No user reviews,0,0,0
80704,True,0,No user reviews,0,0,0
80705,True,0,No user reviews,0,0,0
80706,True,0,No user reviews,0,0,0
80707,True,0,No user reviews,0,0,0
80708,True,0,No user reviews,0,0,0
80709,True,0,No user reviews,0,0,0
80710,True,0,No user reviews,0,0,0
80720,True,0,No user reviews,0,0,0
80721,True,0,No user reviews,0,0,0
80722,True,0,No user reviews,0,0,0
80723,True,0,No user reviews,0,0,0
80724,True,0,No user reviews,0,0,0
80725,True,0,No user reviews,0,0,0
80726,True,0,No user reviews,0,0,0
80727,True,0,No user reviews,0,0,0
80728,True,0,No user reviews,0,0,0
80729,True,0,No user reviews,0,0,0
80730,True,0,No user reviews,0,0,0
80731,True,0,No user reviews,0,0,0
80732,True,0,No user reviews,0,0,0
80733,True,0,No user reviews,0,0,0
80734,True,0,No user reviews,0,0,0
80735,True,0,No user reviews,0,0,0
80736,True,0,No user reviews,0,0,0
80737,True,0,No user reviews,0,0,0
80738,True,0,No user reviews,0,0,0
80739,True,0,No user reviews,0,0,0
80740,True,0,No user reviews,0,0,0
80741,True,0,No user reviews,0,0,0
80742,True,0,No user reviews,0,0,0
80745,True,0,No user reviews,0,0,0
80746,True,0,No user reviews,0,0,0
80747,True,0,No user reviews,0,0,0
80748,True,0,No user reviews,0,0,0
80749,True,0,No user reviews,0,0,0
80750,True,0,No user reviews,0,0,0
80751,True,0,No user reviews,0,0,0
80752,True,0,No user reviews,0,0,0
80753,True,0,No user reviews,0,0,0
80754,True,0,No user reviews,0,0,0
80755,True,0,No user reviews,0,0,0
80756,True,0,No user reviews,0,0,0
80757,True,0,No user reviews,0,0,0
80758,True,0,No user reviews,0,0,0
80759,True,0,No user reviews,0,0,0
80760,True,0,No user reviews,0,0,0
80761,True,0,No user reviews,0,0,0
80762,True,0,No user reviews,0,0,0
80763,True,0,No user reviews,0,0,0
80764,True,0,No user reviews,0,0,0
80765,True,0,No user reviews,0,0,0
80766,True,0,No user reviews,0,0,0
80767,True,0,No user reviews,0,0,0
80768,True,0,No user reviews,0,0,0
80769,True,0,No user reviews,0,0,0
80770,True,0,No user reviews,0,0,0
80771,True,0,No user reviews,0,0,0
80773,True,0,No user reviews,0,0,0
80774,True,0,No user reviews,0,0,0
80775,True,0,No user reviews,0,0,0
80776,True,0,No user reviews,0,0,0
80777,True,0,No user reviews,0,0,0
80778,True,0,No user reviews,0,0,0
80779,True,0,No user reviews,0,0,0
80780,True,0,No user reviews,0,0,0
80781,True,0,No user reviews,0,0,0
80782,True,0,No user reviews,0,0,0
80783,True,0,No user reviews,0,0,0
80784,True,0,No user reviews,0,0,0
80785,True,0,No user reviews,0,0,0
80786,True,0,No user reviews,0,0,0
80787,True,0,No user reviews,0,0,0
80788,True,0,No user reviews,0,0,0
80790,True,0,No user reviews,0,0,0
80791,True,0,No user reviews,0,0,0
80792,True,0,No user reviews,0,0,0
80793,True,0,No user reviews,0,0,0
80794,True,0,No user reviews,0,0,0
80795,True,0,No user reviews,0,0,0
80796,True,0,No user reviews,0,0,0
80797,True,0,No user reviews,0,0,0
80798,True,0,No user reviews,0,0,0
80799,True,0,No user reviews,0,0,0
80800,True,0,No user reviews,0,0,0
80801,True,0,No user reviews,0,0,0
80802,True,0,No user reviews,0,0,0
80803,True,0,No user reviews,0,0,0
80804,True,0,No user reviews,0,0,0
80805,True,0,No user reviews,0,0,0
80806,True,0,No user reviews,0,0,0
80807,True,0,No user reviews,0,0,0
80808,True,0,No user reviews,0,0,0
80809,True,0,No user reviews,0,0,0
80810,True,0,No user reviews,0,0,0
80811,True,0,No user reviews,0,0,0
80812,True,0,No user reviews,0,0,0
80813,True,0,No user reviews,0,0,0
80814,True,0,No user reviews,0,0,0
80815,True,0,No user reviews,0,0,0
80816,True,0,No user reviews,0,0,0
80817,True,0,No user reviews,0,0,0
80819,True,0,No user reviews,0,0,0
80820,True,0,No user reviews,0,0,0
80821,True,0,No user reviews,0,0,0
80822,True,0,No user reviews,0,0,0
80823,True,0,No user reviews,0,0,0
80824,True,0,No user reviews,0,0,0
80825,True,0,No user reviews,0,0,0
80826,True,0,No user reviews,0,0,0
80827,True,0,No user reviews,0,0,0
80828,True,0,No user reviews,0,0,0
80829,True,0,No user reviews,0,0,0
80830,True,0,No user reviews,0,0,0
80831,True,0,No user reviews,0,0,0
80832,True,0,No user reviews,0,0,0
80833,True,0,No user reviews,0,0,0
80834,True,0,No user reviews,0,0,0
80835,True,0,No user reviews,0,0,0
80836,True,0,No user reviews,0,0,0
80837,True,0,No user reviews,0,0,0
80838,True,0,No user reviews,0,0,0
80839,True,0,No user reviews,0,0,0
80840,True,0,No user reviews,0,0,0
80841,True,0,No user reviews,0,0,0
80842,True,0,No user reviews,0,0,0
80843,True,0,No user reviews,0,0,0
80844,True,0,No user reviews,0,0,0
80849,True,0,No user reviews,0,0,0
80850,True,0,No user reviews,0,0,0
80851,True,0,No user reviews,0,0,0
80852,True,0,No user reviews,0,0,0
80853,True,0,No user reviews,0,0,0
80854,True,0,No user reviews,0,0,0
80855,True,0,No user reviews,0,0,0
80856,True,0,No user reviews,0,0,0
80857,True,0,No user reviews,0,0,0
80858,True,0,No user reviews,0,0,0
80859,True,0,No user reviews,0,0,0
80860,True,0,No user reviews,0,0,0
80861,True,0,No user reviews,0,0,0
80862,True,0,No user reviews,0,0,0
80863,True,0,No user reviews,0,0,0
80864,True,0,No user reviews,0,0,0
80865,True,0,No user reviews,0,0,0
80866,True,0,No user reviews,0,0,0
80867,True,0,No user reviews,0,0,0
80868,True,0,No user reviews,0,0,0
80869,True,0,No user reviews,0,0,0
80870,True,0,No user reviews,0,0,0
80871,True,0,No user reviews,0,0,0
80872,True,0,No user reviews,0,0,0
80873,True,0,No user reviews,0,0,0
80874,True,0,No user reviews,0,0,0
80875,True,0,No user reviews,0,0,0
80876,True,0,No user reviews,0,0,0
80877,True,0,No user reviews,0,0,0
80878,True,0,No user reviews,0,0,0
80879,True,0,No user reviews,0,0,0
80880,True,0,No user reviews,0,0,0
80881,True,0,No user reviews,0,0,0
80882,True,0,No user reviews,0,0,0
80883,True,0,No user reviews,0,0,0
80884,True,0,No user reviews,0,0,0
80885,True,0,No user reviews,0,0,0
80886,True,0,No user reviews,0,0,0
80887,True,0,No user reviews,0,0,0
80888,True,0,No user reviews,0,0,0
80889,True,0,No user reviews,0,0,0
80890,True,0,No user reviews,0,0,0
80891,True,0,No user reviews,0,0,0
80892,True,0,No user reviews,0,0,0
80893,True,0,No user reviews,0,0,0
80894,True,0,No user reviews,0,0,0
80895,True,0,No user reviews,0,0,0
80896,True,0,No user reviews,0,0,0
80897,True,0,No user reviews,0,0,0
80898,True,0,No user reviews,0,0,0
80900,True,0,No user reviews,0,0,0
80901,True,0,No user reviews,0,0,0
80902,True,0,No user reviews,0,0,0
80903,True,0,No user reviews,0,0,0
80904,True,0,No user reviews,0,0,0
80905,True,0,No user reviews,0,0,0
80906,True,0,No user reviews,0,0,0
80907,True,0,No user reviews,0,0,0
80908,True,0,No user reviews,0,0,0
80909,True,0,No user reviews,0,0,0
80910,True,0,No user reviews,0,0,0
80911,True,0,No user reviews,0,0,0
80912,True,0,No user reviews,0,0,0
80913,True,0,No user reviews,0,0,0
80914,True,0,No user reviews,0,0,0
80915,True,0,No user reviews,0,0,0
80916,True,0,No user reviews,0,0,0
80917,True,0,No user reviews,0,0,0
80918,True,0,No user reviews,0,0,0
80919,True,0,No user reviews,0,0,0
80920,True,0,No user reviews,0,0,0
80921,True,0,No user reviews,0,0,0
80922,True,0,No user reviews,0,0,0
80923,True,0,No user reviews,0,0,0
80924,True,0,No user reviews,0,0,0
80925,True,0,No user reviews,0,0,0
80926,True,0,No user reviews,0,0,0
80927,True,0,No user reviews,0,0,0
80928,True,0,No user reviews,0,0,0
80929,True,0,No user reviews,0,0,0
80930,True,0,No user reviews,0,0,0
80931,True,0,No user reviews,0,0,0
80932,True,0,No user reviews,0,0,0
80933,True,0,No user reviews,0,0,0
80934,True,0,No user reviews,0,0,0
80936,True,0,No user reviews,0,0,0
80937,True,0,No user reviews,0,0,0
80938,True,0,No user reviews,0,0,0
80939,True,0,No user reviews,0,0,0
80940,True,0,No user reviews,0,0,0
80941,True,0,No user reviews,0,0,0
80942,True,0,No user reviews,0,0,0
80943,True,0,No user reviews,0,0,0
80944,True,0,No user reviews,0,0,0
80945,True,0,No user reviews,0,0,0
80946,True,0,No user reviews,0,0,0
80947,True,0,No user reviews,0,0,0
80948,True,0,No user reviews,0,0,0
80949,True,0,No user reviews,0,0,0
80950,True,0,No user reviews,0,0,0
80951,True,0,No user reviews,0,0,0
80952,True,0,No user reviews,0,0,0
80953,True,0,No user reviews,0,0,0
80954,True,0,No user reviews,0,0,0
80955,True,0,No user reviews,0,0,0
80956,True,0,No user reviews,0,0,0
80957,True,0,No user reviews,0,0,0
80958,True,0,No user reviews,0,0,0
80959,True,0,No user reviews,0,0,0
80960,True,0,No user reviews,0,0,0
80961,True,0,No user reviews,0,0,0
80962,True,0,No user reviews,0,0,0
80963,True,0,No user reviews,0,0,0
80964,True,0,No user reviews,0,0,0
80965,True,0,No user reviews,0,0,0
80966,True,0,No user reviews,0,0,0
80967,True,0,No user reviews,0,0,0
80968,True,0,No user reviews,0,0,0
80969,True,0,No user reviews,0,0,0
80970,True,0,No user reviews,0,0,0
80971,True,0,No user reviews,0,0,0
80972,True,0,No user reviews,0,0,0
80973,True,0,No user reviews,0,0,0
80974,True,0,No user reviews,0,0,0
80975,True,0,No user reviews,0,0,0
80976,True,0,No user reviews,0,0,0
80977,True,0,No user reviews,0,0,0
80978,True,0,No user reviews,0,0,0
80979,True,0,No user reviews,0,0,0
80980,True,0,No user reviews,0,0,0
80981,True,0,No user reviews,0,0,0
80982,True,0,No user reviews,0,0,0
80983,True,0,No user reviews,0,0,0
80984,True,0,No user reviews,0,0,0
80985,True,0,No user reviews,0,0,0
80986,True,0,No user reviews,0,0,0
80987,True,0,No user reviews,0,0,0
80988,True,0,No user reviews,0,0,0
80989,True,0,No user reviews,0,0,0
80990,True,0,No user reviews,0,0,0
80991,True,0,No user reviews,0,0,0
80992,True,0,No user reviews,0,0,0
80993,True,0,No user reviews,0,0,0
80994,True,0,No user reviews,0,0,0
80995,True,0,No user reviews,0,0,0
80996,True,0,No user reviews,0,0,0
80997,True,0,No user reviews,0,0,0
80998,True,0,No user reviews,0,0,0
80999,True,0,No user reviews,0,0,0
81000,True,0,No user reviews,0,0,0
81001,True,0,No user reviews,0,0,0
81002,True,0,No user reviews,0,0,0
81003,True,0,No user reviews,0,0,0
81004,True,0,No user reviews,0,0,0
81005,True,0,No user reviews,0,0,0
81006,True,0,No user reviews,0,0,0
81007,True,0,No user reviews,0,0,0
81008,True,0,No user reviews,0,0,0
81009,True,0,No user reviews,0,0,0
81010,True,0,No user reviews,0,0,0
81011,True,0,No user reviews,0,0,0
81012,True,0,No user reviews,0,0,0
81013,True,0,No user reviews,0,0,0
81014,True,0,No user reviews,0,0,0
81015,True,0,No user reviews,0,0,0
81016,True,0,No user reviews,0,0,0
81017,True,0,No user reviews,0,0,0
81018,True,0,No user reviews,0,0,0
81019,True,0,No user reviews,0,0,0
81020,True,0,No user reviews,0,0,0
81021,True,0,No user reviews,0,0,0
81022,True,0,No user reviews,0,0,0
81023,True,0,No user reviews,0,0,0
81024,True,0,No user reviews,0,0,0
81025,True,0,No user reviews,0,0,0
81026,True,0,No user reviews,0,0,0
81027,True,0,No user reviews,0,0,0
81028,True,0,No user reviews,0,0,0
81029,True,0,No user reviews,0,0,0
81030,True,0,No user reviews,0,0,0
81031,True,0,No user reviews,0,0,0
81032,True,0,No user reviews,0,0,0
81033,True,0,No user reviews,0,0,0
81034,True,0,No user reviews,0,0,0
81035,True,0,No user reviews,0,0,0
81036,True,0,No user reviews,0,0,0
81037,True,0,No user reviews,0,0,0
81038,True,0,No user reviews,0,0,0
81039,True,0,No user reviews,0,0,0
81040,True,0,No user reviews,0,0,0
81041,True,0,No user reviews,0,0,0
81042,True,0,No user reviews,0,0,0
81043,True,0,No user reviews,0,0,0
81044,True,0,No user reviews,0,0,0
81045,True,0,No user reviews,0,0,0
81046,True,0,No user reviews,0,0,0
81047,True,0,No user reviews,0,0,0
81048,True,0,No user reviews,0,0,0
81049,True,0,No user reviews,0,0,0
81050,True,0,No user reviews,0,0,0
81051,True,0,No user reviews,0,0,0
81052,True,0,No user reviews,0,0,0
81053,True,0,No user reviews,0,0,0
81054,True,0,No user reviews,0,0,0
81055,True,0,No user reviews,0,0,0
81056,True,0,No user reviews,0,0,0
81057,True,0,No user reviews,0,0,0
81058,True,0,No user reviews,0,0,0
81059,True,0,No user reviews,0,0,0
81060,True,0,No user reviews,0,0,0
81061,True,0,No user reviews,0,0,0
81062,True,0,No user reviews,0,0,0
81063,True,0,No user reviews,0,0,0
81064,True,0,No user reviews,0,0,0
81065,True,0,No user reviews,0,0,0
81066,True,0,No user reviews,0,0,0
81067,True,0,No user reviews,0,0,0
81068,True,0,No user reviews,0,0,0
81069,True,0,No user reviews,0,0,0
81070,True,0,No user reviews,0,0,0
81071,True,0,No user reviews,0,0,0
81072,True,0,No user reviews,0,0,0
81073,True,0,No user reviews,0,0,0
81074,True,0,No user reviews,0,0,0
81075,True,0,No user reviews,0,0,0
81076,True,0,No user reviews,0,0,0
81077,True,0,No user reviews,0,0,0
81078,True,0,No user reviews,0,0,0
81079,True,0,No user reviews,0,0,0
81080,True,0,No user reviews,0,0,0
81081,True,0,No user reviews,0,0,0
81082,True,0,No user reviews,0,0,0
81083,True,0,No user reviews,0,0,0
81084,True,0,No user reviews,0,0,0
81085,True,0,No user reviews,0,0,0
81086,True,0,No user reviews,0,0,0
81087,True,0,No user reviews,0,0,0
81090,True,0,No user reviews,0,0,0
81091,True,0,No user reviews,0,0,0
81092,True,0,No user reviews,0,0,0
81093,True,0,No user reviews,0,0,0
81094,True,0,No user reviews,0,0,0
81096,True,0,No user reviews,0,0,0
81097,True,0,No user reviews,0,0,0
81098,True,0,No user reviews,0,0,0
81099,True,0,No user reviews,0,0,0
81100,True,0,No user reviews,0,0,0
81101,True,0,No user reviews,0,0,0
81102,True,0,No user reviews,0,0,0
81103,True,0,No user reviews,0,0,0
81104,True,0,No user reviews,0,0,0
81105,True,0,No user reviews,0,0,0
81106,True,0,No user reviews,0,0,0
81107,True,0,No user reviews,0,0,0
81110,True,0,No user reviews,0,0,0
81111,True,0,No user reviews,0,0,0
81112,True,0,No user reviews,0,0,0
81113,True,0,No user reviews,0,0,0
81114,True,0,No user reviews,0,0,0
81115,True,0,No user reviews,0,0,0
81116,True,0,No user reviews,0,0,0
81117,True,0,No user reviews,0,0,0
81118,True,0,No user reviews,0,0,0
81119,True,0,No user reviews,0,0,0
81120,True,0,No user reviews,0,0,0
81121,True,0,No user reviews,0,0,0
81122,True,0,No user reviews,0,0,0
81123,True,0,No user reviews,0,0,0
81124,True,0,No user reviews,0,0,0
81125,True,0,No user reviews,0,0,0
81126,True,0,No user reviews,0,0,0
81127,True,0,No user reviews,0,0,0
81128,True,0,No user reviews,0,0,0
81129,True,0,No user reviews,0,0,0
81130,True,0,No user reviews,0,0,0
81131,True,0,No user reviews,0,0,0
81132,True,0,No user reviews,0,0,0
81133,True,0,No user reviews,0,0,0
81134,True,0,No user reviews,0,0,0
81135,True,0,No user reviews,0,0,0
81136,True,0,No user reviews,0,0,0
81137,True,0,No user reviews,0,0,0
81138,True,0,No user reviews,0,0,0
81139,True,0,No user reviews,0,0,0
81140,True,0,No user reviews,0,0,0
81141,True,0,No user reviews,0,0,0
81142,True,0,No user reviews,0,0,0
81143,True,0,No user reviews,0,0,0
81144,True,0,No user reviews,0,0,0
81146,True,0,No user reviews,0,0,0
81148,True,0,No user reviews,0,0,0
81149,True,0,No user reviews,0,0,0
81150,True,0,No user reviews,0,0,0
81151,True,0,No user reviews,0,0,0
81152,True,0,No user reviews,0,0,0
81153,True,0,No user reviews,0,0,0
81154,True,0,No user reviews,0,0,0
81155,True,0,No user reviews,0,0,0
81156,True,0,No user reviews,0,0,0
81157,True,0,No user reviews,0,0,0
81158,True,0,No user reviews,0,0,0
81159,True,0,No user reviews,0,0,0
81160,True,0,No user reviews,0,0,0
81161,True,0,No user reviews,0,0,0
81162,True,0,No user reviews,0,0,0
81163,True,0,No user reviews,0,0,0
81164,True,0,No user reviews,0,0,0
81165,True,0,No user reviews,0,0,0
81166,True,0,No user reviews,0,0,0
81167,True,0,No user reviews,0,0,0
81168,True,0,No user reviews,0,0,0
81169,True,0,No user reviews,0,0,0
81170,True,0,No user reviews,0,0,0
81171,True,0,No user reviews,0,0,0
81172,True,0,No user reviews,0,0,0
81173,True,0,No user reviews,0,0,0
81174,True,0,No user reviews,0,0,0
81175,True,0,No user reviews,0,0,0
81176,True,0,No user reviews,0,0,0
81177,True,0,No user reviews,0,0,0
81178,True,0,No user reviews,0,0,0
81179,True,0,No user reviews,0,0,0
81180,True,0,No user reviews,0,0,0
81181,True,0,No user reviews,0,0,0
81182,True,0,No user reviews,0,0,0
81183,True,0,No user reviews,0,0,0
81184,True,0,No user reviews,0,0,0
81185,True,0,No user reviews,0,0,0
81186,True,0,No user reviews,0,0,0
81187,True,0,No user reviews,0,0,0
81188,True,0,No user reviews,0,0,0
81189,True,0,No user reviews,0,0,0
81190,True,0,No user reviews,0,0,0
81191,True,0,No user reviews,0,0,0
81192,True,0,No user reviews,0,0,0
81193,True,0,No user reviews,0,0,0
81194,True,0,No user reviews,0,0,0
81195,True,0,No user reviews,0,0,0
81196,True,0,No user reviews,0,0,0
81197,True,0,No user reviews,0,0,0
81198,True,0,No user reviews,0,0,0
81199,True,0,No user reviews,0,0,0
81200,True,0,No user reviews,0,0,0
81201,True,0,No user reviews,0,0,0
81202,True,0,No user reviews,0,0,0
81203,True,0,No user reviews,0,0,0
81204,True,0,No user reviews,0,0,0
81205,True,0,No user reviews,0,0,0
81206,True,0,No user reviews,0,0,0
81207,True,0,No user reviews,0,0,0
81208,True,0,No user reviews,0,0,0
81209,True,0,No user reviews,0,0,0
81210,True,0,No user reviews,0,0,0
81211,True,0,No user reviews,0,0,0
81212,True,0,No user reviews,0,0,0
81213,True,0,No user reviews,0,0,0
81214,True,0,No user reviews,0,0,0
81215,True,0,No user reviews,0,0,0
81216,True,0,No user reviews,0,0,0
81217,True,0,No user reviews,0,0,0
81218,True,0,No user reviews,0,0,0
81219,True,0,No user reviews,0,0,0
81220,True,0,No user reviews,0,0,0
81221,True,0,No user reviews,0,0,0
81222,True,0,No user reviews,0,0,0
81223,True,0,No user reviews,0,0,0
81224,True,0,No user reviews,0,0,0
81225,True,0,No user reviews,0,0,0
81226,True,0,No user reviews,0,0,0
81227,True,0,No user reviews,0,0,0
81228,True,0,No user reviews,0,0,0
81229,True,0,No user reviews,0,0,0
81230,True,0,No user reviews,0,0,0
81231,True,0,No user reviews,0,0,0
81232,True,0,No user reviews,0,0,0
81233,True,0,No user reviews,0,0,0
81234,True,0,No user reviews,0,0,0
81235,True,0,No user reviews,0,0,0
81236,True,0,No user reviews,0,0,0
81237,True,0,No user reviews,0,0,0
81238,True,0,No user reviews,0,0,0
81239,True,0,No user reviews,0,0,0
81240,True,0,No user reviews,0,0,0
81241,True,0,No user reviews,0,0,0
81242,True,0,No user reviews,0,0,0
81243,True,0,No user reviews,0,0,0
81244,True,0,No user reviews,0,0,0
81245,True,0,No user reviews,0,0,0
81246,True,0,No user reviews,0,0,0
81247,True,0,No user reviews,0,0,0
81248,True,0,No user reviews,0,0,0
81249,True,0,No user reviews,0,0,0
81250,True,0,No user reviews,0,0,0
81251,True,0,No user reviews,0,0,0
81252,True,0,No user reviews,0,0,0
81253,True,0,No user reviews,0,0,0
81254,True,0,No user reviews,0,0,0
81255,True,0,No user reviews,0,0,0
81256,True,0,No user reviews,0,0,0
81257,True,0,No user reviews,0,0,0
81258,True,0,No user reviews,0,0,0
81259,True,0,No user reviews,0,0,0
81260,True,0,No user reviews,0,0,0
81261,True,0,No user reviews,0,0,0
81262,True,0,No user reviews,0,0,0
81263,True,0,No user reviews,0,0,0
81264,True,0,No user reviews,0,0,0
81265,True,0,No user reviews,0,0,0
81266,True,0,No user reviews,0,0,0
81267,True,0,No user reviews,0,0,0
81268,True,0,No user reviews,0,0,0
81269,True,0,No user reviews,0,0,0
81270,True,0,No user reviews,0,0,0
81271,True,0,No user reviews,0,0,0
81272,True,0,No user reviews,0,0,0
81273,True,0,No user reviews,0,0,0
81274,True,0,No user reviews,0,0,0
81275,True,0,No user reviews,0,0,0
81276,True,0,No user reviews,0,0,0
81277,True,0,No user reviews,0,0,0
81278,True,0,No user reviews,0,0,0
81279,True,0,No user reviews,0,0,0
81280,True,0,No user reviews,0,0,0
81281,True,0,No user reviews,0,0,0
81282,True,0,No user reviews,0,0,0
81283,True,0,No user reviews,0,0,0
81284,True,0,No user reviews,0,0,0
81285,True,0,No user reviews,0,0,0
81286,True,0,No user reviews,0,0,0
81287,True,0,No user reviews,0,0,0
81288,True,0,No user reviews,0,0,0
81289,True,0,No user reviews,0,0,0
81290,True,0,No user reviews,0,0,0
81291,True,0,No user reviews,0,0,0
81292,True,0,No user reviews,0,0,0
81293,True,0,No user reviews,0,0,0
81294,True,0,No user reviews,0,0,0
81295,True,0,No user reviews,0,0,0
81296,True,0,No user reviews,0,0,0
81297,True,0,No user reviews,0,0,0
81298,True,0,No user reviews,0,0,0
81299,True,0,No user reviews,0,0,0
81300,True,0,No user reviews,0,0,0
81301,True,0,No user reviews,0,0,0
81302,True,0,No user reviews,0,0,0
81303,True,0,No user reviews,0,0,0
81304,True,0,No user reviews,0,0,0
81305,True,0,No user reviews,0,0,0
81306,True,0,No user reviews,0,0,0
81307,True,0,No user reviews,0,0,0
81308,True,0,No user reviews,0,0,0
81309,True,0,No user reviews,0,0,0
81310,True,0,No user reviews,0,0,0
81311,True,0,No user reviews,0,0,0
81312,True,0,No user reviews,0,0,0
81313,True,0,No user reviews,0,0,0
81314,True,0,No user reviews,0,0,0
81315,True,0,No user reviews,0,0,0
81316,True,0,No user reviews,0,0,0
81317,True,0,No user reviews,0,0,0
81318,True,0,No user reviews,0,0,0
81319,True,0,No user reviews,0,0,0
81320,True,0,No user reviews,0,0,0
81321,True,0,No user reviews,0,0,0
81322,True,0,No user reviews,0,0,0
81323,True,0,No user reviews,0,0,0
81324,True,0,No user reviews,0,0,0
81325,True,0,No user reviews,0,0,0
81326,True,0,No user reviews,0,0,0
81327,True,0,No user reviews,0,0,0
81328,True,0,No user reviews,0,0,0
81329,True,0,No user reviews,0,0,0
81330,True,0,No user reviews,0,0,0
81331,True,0,No user reviews,0,0,0
81332,True,0,No user reviews,0,0,0
81333,True,0,No user reviews,0,0,0
81334,True,0,No user reviews,0,0,0
81335,True,0,No user reviews,0,0,0
81336,True,0,No user reviews,0,0,0
81337,True,0,No user reviews,0,0,0
81338,True,0,No user reviews,0,0,0
81339,True,0,No user reviews,0,0,0
81340,True,0,No user reviews,0,0,0
81341,True,0,No user reviews,0,0,0
81342,True,0,No user reviews,0,0,0
81343,True,0,No user reviews,0,0,0
81344,True,0,No user reviews,0,0,0
81345,True,0,No user reviews,0,0,0
81346,True,0,No user reviews,0,0,0
81347,True,0,No user reviews,0,0,0
81348,True,0,No user reviews,0,0,0
81349,True,0,No user reviews,0,0,0
81350,True,0,No user reviews,0,0,0
81351,True,0,No user reviews,0,0,0
81352,True,0,No user reviews,0,0,0
81353,True,0,No user reviews,0,0,0
81354,True,0,No user reviews,0,0,0
81355,True,0,No user reviews,0,0,0
81356,True,0,No user reviews,0,0,0
81357,True,0,No user reviews,0,0,0
81358,True,0,No user reviews,0,0,0
81359,True,0,No user reviews,0,0,0
81360,True,0,No user reviews,0,0,0
81361,True,0,No user reviews,0,0,0
81362,True,0,No user reviews,0,0,0
81363,True,0,No user reviews,0,0,0
81364,True,0,No user reviews,0,0,0
81365,True,0,No user reviews,0,0,0
81366,True,0,No user reviews,0,0,0
81367,True,0,No user reviews,0,0,0
81368,True,0,No user reviews,0,0,0
81369,True,0,No user reviews,0,0,0
81370,True,0,No user reviews,0,0,0
81371,True,0,No user reviews,0,0,0
81372,True,0,No user reviews,0,0,0
81373,True,0,No user reviews,0,0,0
81374,True,0,No user reviews,0,0,0
81375,True,0,No user reviews,0,0,0
81376,True,0,No user reviews,0,0,0
81377,True,0,No user reviews,0,0,0
81378,True,0,No user reviews,0,0,0
81379,True,0,No user reviews,0,0,0
81380,True,0,No user reviews,0,0,0
81381,True,0,No user reviews,0,0,0
81382,True,0,No user reviews,0,0,0
81383,True,0,No user reviews,0,0,0
81384,True,0,No user reviews,0,0,0
81385,True,0,No user reviews,0,0,0
81386,True,0,No user reviews,0,0,0
81387,True,0,No user reviews,0,0,0
81388,True,0,No user reviews,0,0,0
81389,True,0,No user reviews,0,0,0
81390,True,0,No user reviews,0,0,0
81391,True,0,No user reviews,0,0,0
81392,True,0,No user reviews,0,0,0
81393,True,0,No user reviews,0,0,0
81395,True,0,No user reviews,0,0,0
81396,True,0,No user reviews,0,0,0
81397,True,0,No user reviews,0,0,0
81398,True,0,No user reviews,0,0,0
81399,True,0,No user reviews,0,0,0
81400,True,0,No user reviews,0,0,0
81401,True,0,No user reviews,0,0,0
81402,True,0,No user reviews,0,0,0
81403,True,0,No user reviews,0,0,0
81404,True,0,No user reviews,0,0,0
81405,True,0,No user reviews,0,0,0
81406,True,0,No user reviews,0,0,0
81407,True,0,No user reviews,0,0,0
81408,True,0,No user reviews,0,0,0
81409,True,0,No user reviews,0,0,0
81410,True,0,No user reviews,0,0,0
81411,True,0,No user reviews,0,0,0
81412,True,0,No user reviews,0,0,0
81413,True,0,No user reviews,0,0,0
81414,True,0,No user reviews,0,0,0
81415,True,0,No user reviews,0,0,0
81416,True,0,No user reviews,0,0,0
81417,True,0,No user reviews,0,0,0
81418,True,0,No user reviews,0,0,0
81419,True,0,No user reviews,0,0,0
81420,True,0,No user reviews,0,0,0
81421,True,0,No user reviews,0,0,0
81422,True,0,No user reviews,0,0,0
81423,True,0,No user reviews,0,0,0
81424,True,0,No user reviews,0,0,0
81425,True,0,No user reviews,0,0,0
81426,True,0,No user reviews,0,0,0
81427,True,0,No user reviews,0,0,0
81428,True,0,No user reviews,0,0,0
81429,True,0,No user reviews,0,0,0
81430,True,0,No user reviews,0,0,0
81431,True,0,No user reviews,0,0,0
81432,True,0,No user reviews,0,0,0
81433,True,0,No user reviews,0,0,0
81434,True,0,No user reviews,0,0,0
81435,True,0,No user reviews,0,0,0
81436,True,0,No user reviews,0,0,0
81437,True,0,No user reviews,0,0,0
81438,True,0,No user reviews,0,0,0
81439,True,0,No user reviews,0,0,0
81440,True,0,No user reviews,0,0,0
81441,True,0,No user reviews,0,0,0
81442,True,0,No user reviews,0,0,0
81443,True,0,No user reviews,0,0,0
81444,True,0,No user reviews,0,0,0
81445,True,0,No user reviews,0,0,0
81446,True,0,No user reviews,0,0,0
81447,True,0,No user reviews,0,0,0
81448,True,0,No user reviews,0,0,0
81449,True,0,No user reviews,0,0,0
81450,True,0,No user reviews,0,0,0
81451,True,0,No user reviews,0,0,0
81452,True,0,No user reviews,0,0,0
81453,True,0,No user reviews,0,0,0
81454,True,0,No user reviews,0,0,0
81455,True,0,No user reviews,0,0,0
81456,True,0,No user reviews,0,0,0
81457,True,0,No user reviews,0,0,0
81458,True,0,No user reviews,0,0,0
81459,True,0,No user reviews,0,0,0
81460,True,0,No user reviews,0,0,0
81461,True,0,No user reviews,0,0,0
81462,True,0,No user reviews,0,0,0
81463,True,0,No user reviews,0,0,0
81464,True,0,No user reviews,0,0,0
81465,True,0,No user reviews,0,0,0
81466,True,0,No user reviews,0,0,0
81467,True,0,No user reviews,0,0,0
81468,True,0,No user reviews,0,0,0
81469,True,0,No user reviews,0,0,0
81470,True,0,No user reviews,0,0,0
81471,True,0,No user reviews,0,0,0
81472,True,0,No user reviews,0,0,0
81473,True,0,No user reviews,0,0,0
81474,True,0,No user reviews,0,0,0
81475,True,0,No user reviews,0,0,0
81476,True,0,No user reviews,0,0,0
81477,True,0,No user reviews,0,0,0
81478,True,0,No user reviews,0,0,0
81479,True,0,No user reviews,0,0,0
81480,True,0,No user reviews,0,0,0
81481,True,0,No user reviews,0,0,0
81482,True,0,No user reviews,0,0,0
81483,True,0,No user reviews,0,0,0
81484,True,0,No user reviews,0,0,0
81485,True,0,No user reviews,0,0,0
81486,True,0,No user reviews,0,0,0
81487,True,0,No user reviews,0,0,0
81488,True,0,No user reviews,0,0,0
81489,True,0,No user reviews,0,0,0
81490,True,0,No user reviews,0,0,0
81491,True,0,No user reviews,0,0,0
81492,True,0,No user reviews,0,0,0
81493,True,0,No user reviews,0,0,0
81494,True,0,No user reviews,0,0,0
81495,True,0,No user reviews,0,0,0
81496,True,0,No user reviews,0,0,0
81497,True,0,No user reviews,0,0,0
81498,True,0,No user reviews,0,0,0
81499,True,0,No user reviews,0,0,0
81500,True,0,No user reviews,0,0,0
81501,True,0,No user reviews,0,0,0
81502,True,0,No user reviews,0,0,0
81503,True,0,No user reviews,0,0,0
81504,True,0,No user reviews,0,0,0
81505,True,0,No user reviews,0,0,0
81506,True,0,No user reviews,0,0,0
81507,True,0,No user reviews,0,0,0
81508,True,0,No user reviews,0,0,0
81509,True,0,No user reviews,0,0,0
81510,True,0,No user reviews,0,0,0
81511,True,0,No user reviews,0,0,0
81512,True,0,No user reviews,0,0,0
81513,True,0,No user reviews,0,0,0
81514,True,0,No user reviews,0,0,0
81515,True,0,No user reviews,0,0,0
81516,True,0,No user reviews,0,0,0
81517,True,0,No user reviews,0,0,0
81518,True,0,No user reviews,0,0,0
81519,True,0,No user reviews,0,0,0
81520,True,0,No user reviews,0,0,0
81521,True,0,No user reviews,0,0,0
81522,True,0,No user reviews,0,0,0
81523,True,0,No user reviews,0,0,0
81524,True,0,No user reviews,0,0,0
81525,True,0,No user reviews,0,0,0
81526,True,0,No user reviews,0,0,0
81527,True,0,No user reviews,0,0,0
81528,True,0,No user reviews,0,0,0
81529,True,0,No user reviews,0,0,0
81530,True,0,No user reviews,0,0,0
81531,True,0,No user reviews,0,0,0
81532,True,0,No user reviews,0,0,0
81533,True,0,No user reviews,0,0,0
81534,True,0,No user reviews,0,0,0
81535,True,0,No user reviews,0,0,0
81536,True,0,No user reviews,0,0,0
81537,True,0,No user reviews,0,0,0
81538,True,0,No user reviews,0,0,0
81539,True,0,No user reviews,0,0,0
81540,True,0,No user reviews,0,0,0
81541,True,0,No user reviews,0,0,0
81542,True,0,No user reviews,0,0,0
81543,True,0,No user reviews,0,0,0
81544,True,0,No user reviews,0,0,0
81545,True,0,No user reviews,0,0,0
81546,True,0,No user reviews,0,0,0
81547,True,0,No user reviews,0,0,0
81548,True,0,No user reviews,0,0,0
81549,True,0,No user reviews,0,0,0
81550,True,0,No user reviews,0,0,0
81551,True,0,No user reviews,0,0,0
81552,True,0,No user reviews,0,0,0
81553,True,0,No user reviews,0,0,0
81554,True,0,No user reviews,0,0,0
81555,True,0,No user reviews,0,0,0
81556,True,0,No user reviews,0,0,0
81557,True,0,No user reviews,0,0,0
81558,True,0,No user reviews,0,0,0
81559,True,0,No user reviews,0,0,0
81560,True,0,No user reviews,0,0,0
81561,True,0,No user reviews,0,0,0
81562,True,0,No user reviews,0,0,0
81563,True,0,No user reviews,0,0,0
81564,True,0,No user reviews,0,0,0
81565,True,0,No user reviews,0,0,0
81566,True,0,No user reviews,0,0,0
81567,True,0,No user reviews,0,0,0
81568,True,0,No user reviews,0,0,0
81569,True,0,No user reviews,0,0,0
81570,True,0,No user reviews,0,0,0
81571,True,0,No user reviews,0,0,0
81572,True,0,No user reviews,0,0,0
81573,True,0,No user reviews,0,0,0
81574,True,0,No user reviews,0,0,0
81575,True,0,No user reviews,0,0,0
81576,True,0,No user reviews,0,0,0
81577,True,0,No user reviews,0,0,0
81578,True,0,No user reviews,0,0,0
81579,True,0,No user reviews,0,0,0
81580,True,0,No user reviews,0,0,0
81581,True,0,No user reviews,0,0,0
81582,True,0,No user reviews,0,0,0
81583,True,0,No user reviews,0,0,0
81584,True,0,No user reviews,0,0,0
81585,True,0,No user reviews,0,0,0
81586,True,0,No user reviews,0,0,0
81587,True,0,No user reviews,0,0,0
81588,True,0,No user reviews,0,0,0
81589,True,0,No user reviews,0,0,0
81590,True,0,No user reviews,0,0,0
81591,True,0,No user reviews,0,0,0
81592,True,0,No user reviews,0,0,0
81593,True,0,No user reviews,0,0,0
81594,True,0,No user reviews,0,0,0
81595,True,0,No user reviews,0,0,0
81596,True,0,No user reviews,0,0,0
81597,True,0,No user reviews,0,0,0
81598,True,0,No user reviews,0,0,0
81599,True,0,No user reviews,0,0,0
81600,True,0,No user reviews,0,0,0
81601,True,0,No user reviews,0,0,0
81602,True,0,No user reviews,0,0,0
81603,True,0,No user reviews,0,0,0
81604,True,0,No user reviews,0,0,0
81605,True,0,No user reviews,0,0,0
81606,True,0,No user reviews,0,0,0
81607,True,0,No user reviews,0,0,0
81608,True,0,No user reviews,0,0,0
81609,True,0,No user reviews,0,0,0
81610,True,0,No user reviews,0,0,0
81611,True,0,No user reviews,0,0,0
81612,True,0,No user reviews,0,0,0
81613,True,0,No user reviews,0,0,0
81614,True,0,No user reviews,0,0,0
81615,True,0,No user reviews,0,0,0
81616,True,0,No user reviews,0,0,0
81617,True,0,No user reviews,0,0,0
81618,True,0,No user reviews,0,0,0
81619,True,0,No user reviews,0,0,0
81620,True,0,No user reviews,0,0,0
81621,True,0,No user reviews,0,0,0
81622,True,0,No user reviews,0,0,0
81623,True,0,No user reviews,0,0,0
81624,True,0,No user reviews,0,0,0
81625,True,0,No user reviews,0,0,0
81626,True,0,No user reviews,0,0,0
81627,True,0,No user reviews,0,0,0
81628,True,0,No user reviews,0,0,0
81629,True,0,No user reviews,0,0,0
81630,True,0,No user reviews,0,0,0
81631,True,0,No user reviews,0,0,0
81632,True,0,No user reviews,0,0,0
81633,True,0,No user reviews,0,0,0
81634,True,0,No user reviews,0,0,0
81635,True,0,No user reviews,0,0,0
81636,True,0,No user reviews,0,0,0
81637,True,0,No user reviews,0,0,0
81638,True,0,No user reviews,0,0,0
81639,True,0,No user reviews,0,0,0
81640,True,0,No user reviews,0,0,0
81641,True,0,No user reviews,0,0,0
81642,True,0,No user reviews,0,0,0
81643,True,0,No user reviews,0,0,0
81644,True,0,No user reviews,0,0,0
81645,True,0,No user reviews,0,0,0
81646,True,0,No user reviews,0,0,0
81647,True,0,No user reviews,0,0,0
81648,True,0,No user reviews,0,0,0
81649,True,0,No user reviews,0,0,0
81650,True,0,No user reviews,0,0,0
81651,True,0,No user reviews,0,0,0
81655,True,0,No user reviews,0,0,0
81658,True,0,No user reviews,0,0,0
81660,True,0,No user reviews,0,0,0
81661,True,0,No user reviews,0,0,0
81662,True,0,No user reviews,0,0,0
81663,True,0,No user reviews,0,0,0
81664,True,0,No user reviews,0,0,0
81665,True,0,No user reviews,0,0,0
81666,True,0,No user reviews,0,0,0
81667,True,0,No user reviews,0,0,0
81668,True,0,No user reviews,0,0,0
81669,True,0,No user reviews,0,0,0
81670,True,0,No user reviews,0,0,0
81671,True,0,No user reviews,0,0,0
81672,True,0,No user reviews,0,0,0
81673,True,0,No user reviews,0,0,0
81674,True,0,No user reviews,0,0,0
81675,True,0,No user reviews,0,0,0
81676,True,0,No user reviews,0,0,0
81677,True,0,No user reviews,0,0,0
81678,True,0,No user reviews,0,0,0
81679,True,0,No user reviews,0,0,0
81680,True,0,No user reviews,0,0,0
81681,True,0,No user reviews,0,0,0
81682,True,0,No user reviews,0,0,0
81683,True,0,No user reviews,0,0,0
81684,True,0,No user reviews,0,0,0
81685,True,0,No user reviews,0,0,0
81686,True,0,No user reviews,0,0,0
81687,True,0,No user reviews,0,0,0
81688,True,0,No user reviews,0,0,0
81689,True,0,No user reviews,0,0,0
81690,True,0,No user reviews,0,0,0
81691,True,0,No user reviews,0,0,0
81692,True,0,No user reviews,0,0,0
81693,True,0,No user reviews,0,0,0
81694,True,0,No user reviews,0,0,0
81695,True,0,No user reviews,0,0,0
81696,True,0,No user reviews,0,0,0
81697,True,0,No user reviews,0,0,0
81698,True,0,No user reviews,0,0,0
81699,True,0,No user reviews,0,0,0
81700,True,0,No user reviews,0,0,0
81701,True,0,No user reviews,0,0,0
81702,True,0,No user reviews,0,0,0
81703,True,0,No user reviews,0,0,0
81704,True,0,No user reviews,0,0,0
81705,True,0,No user reviews,0,0,0
81706,True,0,No user reviews,0,0,0
81707,True,0,No user reviews,0,0,0
81708,True,0,No user reviews,0,0,0
81709,True,0,No user reviews,0,0,0
81710,True,0,No user reviews,0,0,0
81711,True,0,No user reviews,0,0,0
81712,True,0,No user reviews,0,0,0
81713,True,0,No user reviews,0,0,0
81714,True,0,No user reviews,0,0,0
81715,True,0,No user reviews,0,0,0
81716,True,0,No user reviews,0,0,0
81717,True,0,No user reviews,0,0,0
81718,True,0,No user reviews,0,0,0
81719,True,0,No user reviews,0,0,0
81720,True,0,No user reviews,0,0,0
81721,True,0,No user reviews,0,0,0
81722,True,0,No user reviews,0,0,0
81723,True,0,No user reviews,0,0,0
81724,True,0,No user reviews,0,0,0
81725,True,0,No user reviews,0,0,0
81726,True,0,No user reviews,0,0,0
81727,True,0,No user reviews,0,0,0
81728,True,0,No user reviews,0,0,0
81729,True,0,No user reviews,0,0,0
81730,True,0,No user reviews,0,0,0
81731,True,0,No user reviews,0,0,0
81732,True,0,No user reviews,0,0,0
81733,True,0,No user reviews,0,0,0
81734,True,0,No user reviews,0,0,0
81735,True,0,No user reviews,0,0,0
81736,True,0,No user reviews,0,0,0
81737,True,0,No user reviews,0,0,0
81738,True,0,No user reviews,0,0,0
81739,True,0,No user reviews,0,0,0
81740,True,0,No user reviews,0,0,0
81741,True,0,No user reviews,0,0,0
81742,True,0,No user reviews,0,0,0
81743,True,0,No user reviews,0,0,0
81744,True,0,No user reviews,0,0,0
81745,True,0,No user reviews,0,0,0
81746,True,0,No user reviews,0,0,0
81747,True,0,No user reviews,0,0,0
81748,True,0,No user reviews,0,0,0
81749,True,0,No user reviews,0,0,0
81750,True,0,No user reviews,0,0,0
81751,True,0,No user reviews,0,0,0
81752,True,0,No user reviews,0,0,0
81753,True,0,No user reviews,0,0,0
81754,True,0,No user reviews,0,0,0
81755,True,0,No user reviews,0,0,0
81756,True,0,No user reviews,0,0,0
81757,True,0,No user reviews,0,0,0
81758,True,0,No user reviews,0,0,0
81759,True,0,No user reviews,0,0,0
81760,True,0,No user reviews,0,0,0
81761,True,0,No user reviews,0,0,0
81762,True,0,No user reviews,0,0,0
81763,True,0,No user reviews,0,0,0
81764,True,0,No user reviews,0,0,0
81765,True,0,No user reviews,0,0,0
81766,True,0,No user reviews,0,0,0
81767,True,0,No user reviews,0,0,0
81768,True,0,No user reviews,0,0,0
81769,True,0,No user reviews,0,0,0
81770,True,0,No user reviews,0,0,0
81771,True,0,No user reviews,0,0,0
81772,True,0,No user reviews,0,0,0
81773,True,0,No user reviews,0,0,0
81774,True,0,No user reviews,0,0,0
81775,True,0,No user reviews,0,0,0
81776,True,0,No user reviews,0,0,0
81777,True,0,No user reviews,0,0,0
81778,True,0,No user reviews,0,0,0
81779,True,0,No user reviews,0,0,0
81780,True,0,No user reviews,0,0,0
81781,True,0,No user reviews,0,0,0
81782,True,0,No user reviews,0,0,0
81783,True,0,No user reviews,0,0,0
81784,True,0,No user reviews,0,0,0
81785,True,0,No user reviews,0,0,0
81786,True,0,No user reviews,0,0,0
81787,True,0,No user reviews,0,0,0
81788,True,0,No user reviews,0,0,0
81789,True,0,No user reviews,0,0,0
81790,True,0,No user reviews,0,0,0
81791,True,0,No user reviews,0,0,0
81792,True,0,No user reviews,0,0,0
81793,True,0,No user reviews,0,0,0
81794,True,0,No user reviews,0,0,0
81795,True,0,No user reviews,0,0,0
81796,True,0,No user reviews,0,0,0
81797,True,0,No user reviews,0,0,0
81798,True,0,No user reviews,0,0,0
81799,True,0,No user reviews,0,0,0
81800,True,0,No user reviews,0,0,0
81801,True,0,No user reviews,0,0,0
81802,True,0,No user reviews,0,0,0
81803,True,0,No user reviews,0,0,0
81804,True,0,No user reviews,0,0,0
81805,True,0,No user reviews,0,0,0
81806,True,0,No user reviews,0,0,0
81807,True,0,No user reviews,0,0,0
81808,True,0,No user reviews,0,0,0
81809,True,0,No user reviews,0,0,0
81810,True,0,No user reviews,0,0,0
81811,True,0,No user reviews,0,0,0
81812,True,0,No user reviews,0,0,0
81813,True,0,No user reviews,0,0,0
81814,True,0,No user reviews,0,0,0
81815,True,0,No user reviews,0,0,0
81816,True,0,No user reviews,0,0,0
81817,True,0,No user reviews,0,0,0
81818,True,0,No user reviews,0,0,0
81819,True,0,No user reviews,0,0,0
81820,True,0,No user reviews,0,0,0
81821,True,0,No user reviews,0,0,0
81822,True,0,No user reviews,0,0,0
81823,True,0,No user reviews,0,0,0
81824,True,0,No user reviews,0,0,0
81825,True,0,No user reviews,0,0,0
81826,True,0,No user reviews,0,0,0
81827,True,0,No user reviews,0,0,0
81828,True,0,No user reviews,0,0,0
81829,True,0,No user reviews,0,0,0
81830,True,0,No user reviews,0,0,0
81831,True,0,No user reviews,0,0,0
81832,True,0,No user reviews,0,0,0
81833,True,0,No user reviews,0,0,0
81834,True,0,No user reviews,0,0,0
81835,True,0,No user reviews,0,0,0
81836,True,0,No user reviews,0,0,0
81837,True,0,No user reviews,0,0,0
81838,True,0,No user reviews,0,0,0
81839,True,0,No user reviews,0,0,0
81840,True,0,No user reviews,0,0,0
81841,True,0,No user reviews,0,0,0
81842,True,0,No user reviews,0,0,0
81843,True,0,No user reviews,0,0,0
81844,True,0,No user reviews,0,0,0
81845,True,0,No user reviews,0,0,0
81846,True,0,No user reviews,0,0,0
81847,True,0,No user reviews,0,0,0
81848,True,0,No user reviews,0,0,0
81849,True,0,No user reviews,0,0,0
81850,True,0,No user reviews,0,0,0
81851,True,0,No user reviews,0,0,0
81852,True,0,No user reviews,0,0,0
81853,True,0,No user reviews,0,0,0
81854,True,0,No user reviews,0,0,0
81855,True,0,No user reviews,0,0,0
81856,True,0,No user reviews,0,0,0
81857,True,0,No user reviews,0,0,0
81858,True,0,No user reviews,0,0,0
81859,True,0,No user reviews,0,0,0
81860,True,0,No user reviews,0,0,0
81861,True,0,No user reviews,0,0,0
81862,True,0,No user reviews,0,0,0
81863,True,0,No user reviews,0,0,0
81864,True,0,No user reviews,0,0,0
81865,True,0,No user reviews,0,0,0
81866,True,0,No user reviews,0,0,0
81867,True,0,No user reviews,0,0,0
81868,True,0,No user reviews,0,0,0
81869,True,0,No user reviews,0,0,0
81870,True,0,No user reviews,0,0,0
81871,True,0,No user reviews,0,0,0
81872,True,0,No user reviews,0,0,0
81873,True,0,No user reviews,0,0,0
81874,True,0,No user reviews,0,0,0
81875,True,0,No user reviews,0,0,0
81876,True,0,No user reviews,0,0,0
81877,True,0,No user reviews,0,0,0
81878,True,0,No user reviews,0,0,0
81879,True,0,No user reviews,0,0,0
81880,True,0,No user reviews,0,0,0
81881,True,0,No user reviews,0,0,0
81882,True,0,No user reviews,0,0,0
81883,True,0,No user reviews,0,0,0
81884,True,0,No user reviews,0,0,0
81885,True,0,No user reviews,0,0,0
81886,True,0,No user reviews,0,0,0
81887,True,0,No user reviews,0,0,0
81888,True,0,No user reviews,0,0,0
81889,True,0,No user reviews,0,0,0
81890,True,0,No user reviews,0,0,0
81891,True,0,No user reviews,0,0,0
81892,True,0,No user reviews,0,0,0
81893,True,0,No user reviews,0,0,0
81894,True,0,No user reviews,0,0,0
81895,True,0,No user reviews,0,0,0
81896,True,0,No user reviews,0,0,0
81897,True,0,No user reviews,0,0,0
81898,True,0,No user reviews,0,0,0
81899,True,0,No user reviews,0,0,0
81900,True,0,No user reviews,0,0,0
81901,True,0,No user reviews,0,0,0
81902,True,0,No user reviews,0,0,0
81903,True,0,No user reviews,0,0,0
81904,True,0,No user reviews,0,0,0
81905,True,0,No user reviews,0,0,0
81906,True,0,No user reviews,0,0,0
81907,True,0,No user reviews,0,0,0
81908,True,0,No user reviews,0,0,0
81909,True,0,No user reviews,0,0,0
81910,True,0,No user reviews,0,0,0
81911,True,0,No user reviews,0,0,0
81912,True,0,No user reviews,0,0,0
81913,True,0,No user reviews,0,0,0
81914,True,0,No user reviews,0,0,0
81915,True,0,No user reviews,0,0,0
81916,True,0,No user reviews,0,0,0
81917,True,0,No user reviews,0,0,0
81918,True,0,No user reviews,0,0,0
81919,True,0,No user reviews,0,0,0
81920,True,0,No user reviews,0,0,0
81921,True,0,No user reviews,0,0,0
81922,True,0,No user reviews,0,0,0
81923,True,0,No user reviews,0,0,0
81924,True,0,No user reviews,0,0,0
81925,True,0,No user reviews,0,0,0
81926,True,0,No user reviews,0,0,0
81927,True,0,No user reviews,0,0,0
81928,True,0,No user reviews,0,0,0
81929,True,0,No user reviews,0,0,0
81930,True,0,No user reviews,0,0,0
81931,True,0,No user reviews,0,0,0
81932,True,0,No user reviews,0,0,0
81933,True,0,No user reviews,0,0,0
81935,True,0,No user reviews,0,0,0
81936,True,0,No user reviews,0,0,0
81937,True,0,No user reviews,0,0,0
81938,True,0,No user reviews,0,0,0
81939,True,0,No user reviews,0,0,0
81940,True,0,No user reviews,0,0,0
81941,True,0,No user reviews,0,0,0
81942,True,0,No user reviews,0,0,0
81943,True,0,No user reviews,0,0,0
81944,True,0,No user reviews,0,0,0
81945,True,0,No user reviews,0,0,0
81946,True,0,No user reviews,0,0,0
81947,True,0,No user reviews,0,0,0
81948,True,0,No user reviews,0,0,0
81949,True,0,No user reviews,0,0,0
81950,True,0,No user reviews,0,0,0
81951,True,0,No user reviews,0,0,0
81952,True,0,No user reviews,0,0,0
81953,True,0,No user reviews,0,0,0
81954,True,0,No user reviews,0,0,0
81955,True,0,No user reviews,0,0,0
81956,True,0,No user reviews,0,0,0
81957,True,0,No user reviews,0,0,0
81958,True,0,No user reviews,0,0,0
81959,True,0,No user reviews,0,0,0
81960,True,0,No user reviews,0,0,0
81961,True,0,No user reviews,0,0,0
81962,True,0,No user reviews,0,0,0
81963,True,0,No user reviews,0,0,0
81964,True,0,No user reviews,0,0,0
81965,True,0,No user reviews,0,0,0
81966,True,0,No user reviews,0,0,0
81967,True,0,No user reviews,0,0,0
81968,True,0,No user reviews,0,0,0
81969,True,0,No user reviews,0,0,0
81970,True,0,No user reviews,0,0,0
81971,True,0,No user reviews,0,0,0
81972,True,0,No user reviews,0,0,0
81973,True,0,No user reviews,0,0,0
81974,True,0,No user reviews,0,0,0
81975,True,0,No user reviews,0,0,0
81976,True,0,No user reviews,0,0,0
81977,True,0,No user reviews,0,0,0
81978,True,0,No user reviews,0,0,0
81979,True,0,No user reviews,0,0,0
81980,True,0,No user reviews,0,0,0
81981,True,0,No user reviews,0,0,0
81982,True,0,No user reviews,0,0,0
81983,True,0,No user reviews,0,0,0
81984,True,0,No user reviews,0,0,0
81985,True,0,No user reviews,0,0,0
81986,True,0,No user reviews,0,0,0
81987,True,0,No user reviews,0,0,0
81988,True,0,No user reviews,0,0,0
81989,True,0,No user reviews,0,0,0
81990,True,0,No user reviews,0,0,0
81991,True,0,No user reviews,0,0,0
81992,True,0,No user reviews,0,0,0
81993,True,0,No user reviews,0,0,0
81994,True,0,No user reviews,0,0,0
81996,True,0,No user reviews,0,0,0
81997,True,0,No user reviews,0,0,0
81998,True,0,No user reviews,0,0,0
81999,True,0,No user reviews,0,0,0
82000,True,0,No user reviews,0,0,0
82001,True,0,No user reviews,0,0,0
82002,True,0,No user reviews,0,0,0
82006,True,0,No user reviews,0,0,0
82007,True,0,No user reviews,0,0,0
82008,True,0,No user reviews,0,0,0
82009,True,0,No user reviews,0,0,0
82010,True,0,No user reviews,0,0,0
82011,True,0,No user reviews,0,0,0
82012,True,0,No user reviews,0,0,0
82013,True,0,No user reviews,0,0,0
82014,True,0,No user reviews,0,0,0
82015,True,0,No user reviews,0,0,0
82016,True,0,No user reviews,0,0,0
82017,True,0,No user reviews,0,0,0
82018,True,0,No user reviews,0,0,0
82019,True,0,No user reviews,0,0,0
82020,True,0,No user reviews,0,0,0
82021,True,0,No user reviews,0,0,0
82022,True,0,No user reviews,0,0,0
82024,True,0,No user reviews,0,0,0
82025,True,0,No user reviews,0,0,0
82026,True,0,No user reviews,0,0,0
82027,True,0,No user reviews,0,0,0
82028,True,0,No user reviews,0,0,0
82029,True,0,No user reviews,0,0,0
82030,True,0,No user reviews,0,0,0
82031,True,0,No user reviews,0,0,0
82032,True,0,No user reviews,0,0,0
82033,True,0,No user reviews,0,0,0
82035,True,0,No user reviews,0,0,0
82036,True,0,No user reviews,0,0,0
82037,True,0,No user reviews,0,0,0
82038,True,0,No user reviews,0,0,0
82039,True,0,No user reviews,0,0,0
82040,True,0,No user reviews,0,0,0
82041,True,0,No user reviews,0,0,0
82042,True,0,No user reviews,0,0,0
82043,True,0,No user reviews,0,0,0
82044,True,0,No user reviews,0,0,0
82045,True,0,No user reviews,0,0,0
82047,True,0,No user reviews,0,0,0
82048,True,0,No user reviews,0,0,0
82049,True,0,No user reviews,0,0,0
82050,True,0,No user reviews,0,0,0
82051,True,0,No user reviews,0,0,0
82052,True,0,No user reviews,0,0,0
82053,True,0,No user reviews,0,0,0
82054,True,0,No user reviews,0,0,0
82055,True,0,No user reviews,0,0,0
82056,True,0,No user reviews,0,0,0
82057,True,0,No user reviews,0,0,0
82058,True,0,No user reviews,0,0,0
82059,True,0,No user reviews,0,0,0
82060,True,0,No user reviews,0,0,0
82061,True,0,No user reviews,0,0,0
82062,True,0,No user reviews,0,0,0
82063,True,0,No user reviews,0,0,0
82064,True,0,No user reviews,0,0,0
82065,True,0,No user reviews,0,0,0
82066,True,0,No user reviews,0,0,0
82067,True,0,No user reviews,0,0,0
82068,True,0,No user reviews,0,0,0
82069,True,0,No user reviews,0,0,0
82070,True,0,No user reviews,0,0,0
82071,True,0,No user reviews,0,0,0
82072,True,0,No user reviews,0,0,0
82073,True,0,No user reviews,0,0,0
82074,True,0,No user reviews,0,0,0
82075,True,0,No user reviews,0,0,0
82076,True,0,No user reviews,0,0,0
82077,True,0,No user reviews,0,0,0
82078,True,0,No user reviews,0,0,0
82079,True,0,No user reviews,0,0,0
82080,True,0,No user reviews,0,0,0
82081,True,0,No user reviews,0,0,0
82082,True,0,No user reviews,0,0,0
82083,True,0,No user reviews,0,0,0
82084,True,0,No user reviews,0,0,0
82085,True,0,No user reviews,0,0,0
82086,True,0,No user reviews,0,0,0
82087,True,0,No user reviews,0,0,0
82088,True,0,No user reviews,0,0,0
82089,True,0,No user reviews,0,0,0
82090,True,0,No user reviews,0,0,0
82091,True,0,No user reviews,0,0,0
82092,True,0,No user reviews,0,0,0
82093,True,0,No user reviews,0,0,0
82094,True,0,No user reviews,0,0,0
82095,True,0,No user reviews,0,0,0
82096,True,0,No user reviews,0,0,0
82097,True,0,No user reviews,0,0,0
82098,True,0,No user reviews,0,0,0
82100,True,0,No user reviews,0,0,0
82101,True,0,No user reviews,0,0,0
82102,True,0,No user reviews,0,0,0
82103,True,0,No user reviews,0,0,0
82121,True,0,No user reviews,0,0,0
82122,True,0,No user reviews,0,0,0
82123,True,0,No user reviews,0,0,0
82125,True,0,No user reviews,0,0,0
82128,True,0,No user reviews,0,0,0
82129,True,0,No user reviews,0,0,0
82130,True,0,No user reviews,0,0,0
82131,True,0,No user reviews,0,0,0
82132,True,0,No user reviews,0,0,0
82133,True,0,No user reviews,0,0,0
82134,True,0,No user reviews,0,0,0
82135,True,0,No user reviews,0,0,0
82136,True,0,No user reviews,0,0,0
82137,True,0,No user reviews,0,0,0
82138,True,0,No user reviews,0,0,0
82139,True,0,No user reviews,0,0,0
82140,True,0,No user reviews,0,0,0
82141,True,0,No user reviews,0,0,0
82142,True,0,No user reviews,0,0,0
82143,True,0,No user reviews,0,0,0
82144,True,0,No user reviews,0,0,0
82147,True,0,No user reviews,0,0,0
82148,True,0,No user reviews,0,0,0
82149,True,0,No user reviews,0,0,0
82151,True,0,No user reviews,0,0,0
82152,True,0,No user reviews,0,0,0
82153,True,0,No user reviews,0,0,0
82154,True,0,No user reviews,0,0,0
82155,True,0,No user reviews,0,0,0
82156,True,0,No user reviews,0,0,0
82157,True,0,No user reviews,0,0,0
82158,True,0,No user reviews,0,0,0
82159,True,0,No user reviews,0,0,0
82160,True,0,No user reviews,0,0,0
82161,True,0,No user reviews,0,0,0
82162,True,0,No user reviews,0,0,0
82163,True,0,No user reviews,0,0,0
82164,True,0,No user reviews,0,0,0
82165,True,0,No user reviews,0,0,0
82166,True,0,No user reviews,0,0,0
82167,True,0,No user reviews,0,0,0
82168,True,0,No user reviews,0,0,0
82169,True,0,No user reviews,0,0,0
82170,True,0,No user reviews,0,0,0
82171,True,0,No user reviews,0,0,0
82172,True,0,No user reviews,0,0,0
82173,True,0,No user reviews,0,0,0
82174,True,0,No user reviews,0,0,0
82175,True,0,No user reviews,0,0,0
82176,True,0,No user reviews,0,0,0
82177,True,0,No user reviews,0,0,0
82178,True,0,No user reviews,0,0,0
82179,True,0,No user reviews,0,0,0
82180,True,0,No user reviews,0,0,0
82181,True,0,No user reviews,0,0,0
82182,True,0,No user reviews,0,0,0
90100,True,7,Positive,17,0,17
90110,True,0,No user reviews,0,0,0
90200,True,8,Very Positive,169,38,207
90207,True,0,1 user reviews,1,0,1
90208,True,0,1 user reviews,1,0,1
90209,True,0,No user reviews,0,0,0
90210,True,0,No user reviews,0,0,0
90400,True,7,Positive,40,6,46
90410,True,0,No user reviews,0,0,0
90500,True,5,Mixed,38,51,89
90503,True,0,1 user reviews,0,1,1
90504,True,0,1 user reviews,0,1,1
90520,True,0,No user reviews,0,0,0
90530,True,0,No user reviews,0,0,0
90800,True,0,5 user reviews,4,1,5
90810,True,0,No user reviews,0,0,0
90900,True,0,No user reviews,0,0,0
91100,True,8,Very Positive,285,36,321
91104,True,0,6 user reviews,6,0,6
91106,True,0,2 user reviews,2,0,2
91110,True,0,No user reviews,0,0,0
91200,True,8,Very Positive,366,67,433
91210,True,0,No user reviews,0,0,0
91310,True,8,Very Positive,4614,1115,5729
91330,True,5,Mixed,196,134,330
91333,True,0,7 user reviews,5,2,7
91342,True,0,5 user reviews,3,2,5
91345,True,0,No user reviews,0,0,0
91346,True,0,5 user reviews,5,0,5
91600,True,8,Very Positive,1085,109,1194
91602,True,0,No user reviews,0,0,0
91603,True,0,No user reviews,0,0,0
91604,True,0,3 user reviews,2,1,3
91605,True,0,No user reviews,0,0,0
91606,True,0,No user reviews,0,0,0
91607,True,0,No user reviews,0,0,0
91608,True,0,No user reviews,0,0,0
91609,True,0,No user reviews,0,0,0
91610,True,0,No user reviews,0,0,0
91612,True,0,1 user reviews,1,0,1
91613,True,0,No user reviews,0,0,0
91614,True,0,1 user reviews,1,0,1
91615,True,0,No user reviews,0,0,0
91616,True,0,No user reviews,0,0,0
91617,True,0,No user reviews,0,0,0
91618,True,0,3 user reviews,3,0,3
91619,True,0,No user reviews,0,0,0
91621,True,0,No user reviews,0,0,0
91622,True,0,No user reviews,0,0,0
91623,True,0,No user reviews,0,0,0
91624,True,0,No user reviews,0,0,0
91700,True,8,Very Positive,3147,555,3702
91720,True,0,No user reviews,0,0,0
91800,True,7,Positive,40,8,48
91810,True,7,Positive,16,3,19
91820,True,0,No user reviews,0,0,0
91830,True,0,No user reviews,0,0,0
91900,True,8,Very Positive,248,48,296
91920,True,0,No user reviews,0,0,0
91930,True,0,No user reviews,0,0,0
92000,True,5,Mixed,698,453,1151
92100,True,5,Mixed,210,227,437
92200,True,8,Very Positive,68,6,74
92210,True,8,Very Positive,76,14,90
92220,True,8,Very Positive,56,10,66
92230,True,0,No user reviews,0,0,0
92240,True,0,No user reviews,0,0,0
92250,True,0,No user reviews,0,0,0
92300,True,6,Mostly Positive,252,106,358
92302,True,0,3 user reviews,2,1,3
92303,True,0,1 user reviews,1,0,1
92310,True,0,No user reviews,0,0,0
92400,True,6,Mostly Positive,21,6,27
92500,True,0,No user reviews,0,0,0
92502,True,0,6 user reviews,6,0,6
92503,True,0,1 user reviews,1,0,1
92504,True,0,No user reviews,0,0,0
92505,True,0,No user reviews,0,0,0
92506,True,0,No user reviews,0,0,0
92507,True,0,No user reviews,0,0,0
92508,True,0,No user reviews,0,0,0
92600,True,8,Very Positive,47,10,57
92620,True,0,No user reviews,0,0,0
92621,True,0,No user reviews,0,0,0
92622,True,0,No user reviews,0,0,0
92700,True,4,Mostly Negative,13,28,41
92800,True,9,Overwhelmingly Positive,1441,59,1500
92803,True,7,Positive,13,1,14
92810,True,0,No user reviews,0,0,0
92900,True,5,Mixed,34,35,69
93200,True,8,Very Positive,302,70,372
93206,True,0,3 user reviews,3,0,3
93207,True,0,2 user reviews,2,0,2
93305,True,0,No user reviews,0,0,0
94000,True,5,Mixed,199,178,377
94200,True,8,Very Positive,435,23,458
94202,True,0,8 user reviews,7,1,8
94203,True,0,No user reviews,0,0,0
94205,True,0,No user reviews,0,0,0
94300,True,8,Very Positive,723,69,792
94303,True,0,8 user reviews,7,1,8
94304,True,0,6 user reviews,5,1,6
94400,True,8,Very Positive,3149,359,3508
94500,True,7,Positive,35,4,39
94510,True,7,Positive,35,5,40
94520,True,7,Positive,37,2,39
94530,True,7,Positive,45,4,49
94590,True,8,Very Positive,210,37,247
94600,True,7,Positive,29,5,34
94610,True,7,Positive,12,2,14
94620,True,8,Very Positive,58,2,60
95300,True,8,Very Positive,293,62,355
95310,True,0,No user reviews,0,0,0
95400,True,8,Very Positive,771,58,829
95500,True,0,7 user reviews,7,0,7
95502,True,0,No user reviews,0,0,0
95510,True,0,No user reviews,0,0,0
95700,True,7,Positive,10,0,10
95900,True,5,Mixed,70,36,106
96000,True,8,Very Positive,1103,158,1261
96010,True,0,No user reviews,0,0,0
96100,True,8,Very Positive,2278,427,2705
96200,True,6,Mostly Positive,33,13,46
96300,True,5,Mixed,97,143,240
96308,True,0,2 user reviews,2,0,2
96419,True,0,No user reviews,0,0,0
96800,True,5,Mixed,78,48,126
96810,True,0,No user reviews,0,0,0
96819,True,0,No user reviews,0,0,0
96831,True,0,1 user reviews,1,0,1
96900,True,0,9 user reviews,4,5,9
97000,True,8,Very Positive,847,89,936
97010,True,0,No user reviews,0,0,0
97110,True,8,Very Positive,43,10,53
97120,True,8,Very Positive,60,5,65
97130,True,8,Very Positive,76,10,86
97300,True,0,1 user reviews,1,0,1
97301,True,0,1 user reviews,1,0,1
97302,True,0,1 user reviews,1,0,1
97303,True,0,1 user reviews,1,0,1
97304,True,0,1 user reviews,1,0,1
97305,True,0,1 user reviews,1,0,1
97306,True,0,1 user reviews,1,0,1
97307,True,0,1 user reviews,1,0,1
97308,True,0,1 user reviews,1,0,1
97309,True,0,1 user reviews,1,0,1
97310,True,0,1 user reviews,1,0,1
97311,True,0,1 user reviews,1,0,1
97312,True,0,1 user reviews,1,0,1
97313,True,0,1 user reviews,1,0,1
97314,True,0,1 user reviews,1,0,1
97315,True,0,1 user reviews,1,0,1
97316,True,0,1 user reviews,1,0,1
97317,True,0,1 user reviews,1,0,1
97318,True,0,1 user reviews,1,0,1
97319,True,0,1 user reviews,1,0,1
97320,True,0,1 user reviews,1,0,1
97321,True,0,1 user reviews,1,0,1
97322,True,0,1 user reviews,1,0,1
97323,True,0,1 user reviews,1,0,1
97324,True,0,1 user reviews,1,0,1
97325,True,0,1 user reviews,1,0,1
97326,True,0,1 user reviews,1,0,1
97327,True,0,1 user reviews,1,0,1
97328,True,0,No user reviews,0,0,0
97330,True,8,Very Positive,562,98,660
97340,True,0,No user reviews,0,0,0
97350,True,0,1 user reviews,1,0,1
97360,True,0,No user reviews,0,0,0
97361,True,0,No user reviews,0,0,0
97362,True,0,No user reviews,0,0,0
97363,True,0,No user reviews,0,0,0
97364,True,0,1 user reviews,0,1,1
97365,True,0,No user reviews,0,0,0
97366,True,0,1 user reviews,1,0,1
97367,True,0,No user reviews,0,0,0
97368,True,0,No user reviews,0,0,0
97369,True,0,No user reviews,0,0,0
97370,True,0,1 user reviews,0,1,1
97371,True,0,No user reviews,0,0,0
97372,True,0,No user reviews,0,0,0
97373,True,0,No user reviews,0,0,0
97374,True,0,No user reviews,0,0,0
97375,True,0,No user reviews,0,0,0
97376,True,0,No user reviews,0,0,0
97377,True,0,No user reviews,0,0,0
97378,True,0,No user reviews,0,0,0
97379,True,0,No user reviews,0,0,0
97380,True,0,1 user reviews,0,1,1
97381,True,0,No user reviews,0,0,0
97382,True,0,No user reviews,0,0,0
97383,True,0,No user reviews,0,0,0
97384,True,0,No user reviews,0,0,0
97385,True,0,No user reviews,0,0,0
97386,True,0,No user reviews,0,0,0
97387,True,0,No user reviews,0,0,0
97388,True,0,No user reviews,0,0,0
97389,True,0,No user reviews,0,0,0
98001,True,0,No user reviews,0,0,0
98002,True,0,No user reviews,0,0,0
98003,True,0,No user reviews,0,0,0
98004,True,0,No user reviews,0,0,0
98005,True,0,No user reviews,0,0,0
98006,True,0,No user reviews,0,0,0
98007,True,0,No user reviews,0,0,0
98008,True,0,No user reviews,0,0,0
98009,True,0,No user reviews,0,0,0
98011,True,0,No user reviews,0,0,0
98012,True,0,No user reviews,0,0,0
98014,True,0,No user reviews,0,0,0
98015,True,0,No user reviews,0,0,0
98100,True,6,Mostly Positive,112,44,156
98200,True,8,Very Positive,733,83,816
98203,True,0,No user reviews,0,0,0
98204,True,0,No user reviews,0,0,0
98205,True,0,No user reviews,0,0,0
98210,True,0,No user reviews,0,0,0
98211,True,0,7 user reviews,5,2,7
98212,True,0,No user reviews,0,0,0
98213,True,0,No user reviews,0,0,0
98214,True,0,No user reviews,0,0,0
98220,True,0,No user reviews,0,0,0
98300,True,8,Very Positive,620,66,686
98400,True,8,Very Positive,1354,278,1632
98421,True,7,Positive,33,1,34
98500,True,5,Mixed,43,42,85
98510,True,6,Mostly Positive,54,21,75
98600,True,6,Mostly Positive,131,34,165
98610,True,0,No user reviews,0,0,0
98800,True,8,Very Positive,2476,137,2613
98810,True,0,No user reviews,0,0,0
98820,True,0,8 user reviews,7,1,8
98821,True,0,No user reviews,0,0,0
98822,True,7,Positive,10,0,10
98900,True,5,Mixed,31,14,45
99100,True,4,Mostly Negative,47,121,168
99110,True,0,No user reviews,0,0,0
99120,True,5,Mixed,19,15,34
99300,True,8,Very Positive,311,57,368
99310,True,0,No user reviews,0,0,0
99400,True,5,Mixed,69,64,133
99410,True,4,Mostly Negative,10,25,35
99508,True,0,No user reviews,0,0,0
99509,True,0,No user reviews,0,0,0
99610,True,7,Positive,36,7,43
99611,True,7,Positive,37,8,45
99612,True,6,Mostly Positive,44,12,56
99613,True,0,No user reviews,0,0,0
99614,True,6,Mostly Positive,21,8,29
99700,True,8,Very Positive,143,12,155
99809,True,0,No user reviews,0,0,0
99810,True,6,Mostly Positive,1608,463,2071
99830,True,8,Very Positive,88,7,95
99839,True,0,No user reviews,0,0,0
99841,True,0,No user reviews,0,0,0
99842,True,0,No user reviews,0,0,0
99843,True,0,No user reviews,0,0,0
99845,True,0,No user reviews,0,0,0
99846,True,0,No user reviews,0,0,0
99850,True,0,No user reviews,0,0,0
99870,True,0,No user reviews,0,0,0
99890,True,6,Mostly Positive,53,14,67
99895,True,0,No user reviews,0,0,0
99896,True,0,No user reviews,0,0,0
99900,True,6,Mostly Positive,91,29,120
99909,True,0,No user reviews,0,0,0
99910,True,5,Mixed,8,6,14
99920,True,0,No user reviews,0,0,0
99930,True,0,No user reviews,0,0,0
100400,True,6,Mostly Positive,31,10,41
100410,True,6,Mostly Positive,54,16,70
100970,True,0,1 user reviews,1,0,1
100973,True,0,No user reviews,0,0,0
100980,True,8,Very Positive,68,9,77
101000,True,0,No user reviews,0,0,0
101001,True,0,1 user reviews,1,0,1
101002,True,0,No user reviews,0,0,0
101003,True,0,No user reviews,0,0,0
101004,True,0,No user reviews,0,0,0
101005,True,0,No user reviews,0,0,0
101006,True,0,No user reviews,0,0,0
101008,True,0,No user reviews,0,0,0
102000,True,0,No user reviews,0,0,0
102001,True,0,No user reviews,0,0,0
102002,True,0,No user reviews,0,0,0
102003,True,0,No user reviews,0,0,0
102020,True,0,No user reviews,0,0,0
102028,True,0,No user reviews,0,0,0
102029,True,0,No user reviews,0,0,0
102030,True,0,No user reviews,0,0,0
102031,True,0,No user reviews,0,0,0
102032,True,0,No user reviews,0,0,0
102033,True,0,No user reviews,0,0,0
102034,True,0,No user reviews,0,0,0
102035,True,0,No user reviews,0,0,0
102200,True,6,Mostly Positive,117,32,149
102210,True,0,No user reviews,0,0,0
102220,True,0,No user reviews,0,0,0
102400,True,0,7 user reviews,6,1,7
102410,True,0,No user reviews,0,0,0
102500,True,8,Very Positive,6614,864,7478
102600,True,9,Overwhelmingly Positive,2580,78,2658
102610,True,0,No user reviews,0,0,0
102620,True,0,No user reviews,0,0,0
102621,True,0,No user reviews,0,0,0
102622,True,7,Positive,24,2,26
102623,True,7,Positive,16,3,19
102624,True,0,No user reviews,0,0,0
102700,True,5,Mixed,46,48,94
102800,True,0,No user reviews,0,0,0
102810,True,8,Very Positive,46,9,55
102820,True,4,Mostly Negative,158,317,475
102822,True,0,4 user reviews,1,3,4
102830,True,0,No user reviews,0,0,0
102840,True,6,Mostly Positive,357,100,457
102842,True,0,No user reviews,0,0,0
102850,True,5,Mixed,110,52,162
104000,True,5,Mixed,64,28,92
104010,True,0,No user reviews,0,0,0
104020,True,7,Positive,33,8,41
104100,True,5,Mixed,42,21,63
104200,True,8,Very Positive,1162,264,1426
104300,True,0,No user reviews,0,0,0
104310,True,0,No user reviews,0,0,0
104600,True,8,Very Positive,254,52,306
104700,True,5,Mixed,16,12,28
104800,True,0,No user reviews,0,0,0
104900,True,6,Mostly Positive,9142,2618,11760
105000,True,5,Mixed,273,163,436
105100,True,5,Mixed,92,95,187
105200,True,0,No user reviews,0,0,0
105300,True,6,Mostly Positive,123,44,167
105310,True,0,No user reviews,0,0,0
105400,True,8,Very Positive,349,72,421
105410,True,0,No user reviews,0,0,0
105411,True,0,2 user reviews,2,0,2
105412,True,0,1 user reviews,1,0,1
105413,True,0,No user reviews,0,0,0
105414,True,0,No user reviews,0,0,0
105415,True,0,1 user reviews,1,0,1
105420,True,8,Very Positive,68,13,81
105430,True,8,Very Positive,108,4,112
105450,True,8,Very Positive,8864,982,9846
105600,True,9,Overwhelmingly Positive,266322,5300,271622
105610,True,0,No user reviews,0,0,0
105700,True,6,Mostly Positive,34,12,46
105710,True,0,No user reviews,0,0,0
105800,True,8,Very Positive,270,49,319
105802,True,0,No user reviews,0,0,0
106000,True,5,Mixed,34,28,62
106010,True,0,No user reviews,0,0,0
106020,True,0,No user reviews,0,0,0
106021,True,0,No user reviews,0,0,0
107000,True,0,4 user reviews,3,1,4
107010,True,0,No user reviews,0,0,0
107011,True,0,No user reviews,0,0,0
107100,True,9,Overwhelmingly Positive,14359,478,14837
107104,True,8,Very Positive,59,1,60
107110,True,0,No user reviews,0,0,0
107200,True,8,Very Positive,1480,109,1589
107210,True,0,No user reviews,0,0,0
107300,True,8,Very Positive,681,123,804
107310,True,8,Very Positive,1804,133,1937
107400,True,0,No user reviews,0,0,0
107410,True,8,Very Positive,59587,5920,65507
107430,True,0,1 user reviews,1,0,1
107600,True,9,Overwhelmingly Positive,586,22,608
107610,True,0,No user reviews,0,0,0
107702,True,0,No user reviews,0,0,0
107800,True,8,Very Positive,430,48,478
107820,True,0,2 user reviews,2,0,2
107821,True,5,Mixed,10,5,15
107830,True,0,No user reviews,0,0,0
107900,True,0,No user reviews,0,0,0
108100,True,5,Mixed,55,42,97
108110,True,4,Mostly Negative,22,54,76
108200,True,8,Very Positive,1204,161,1365
108210,True,0,2 user reviews,0,2,2
108220,True,0,No user reviews,0,0,0
108230,True,6,Mostly Positive,7,3,10
108231,True,0,5 user reviews,5,0,5
108232,True,0,5 user reviews,5,0,5
108233,True,0,6 user reviews,6,0,6
108500,True,8,Very Positive,191,24,215
108600,True,8,Very Positive,9591,1424,11015
108700,True,5,Mixed,172,87,259
108710,True,8,Very Positive,7563,880,8443
108726,True,7,Positive,33,4,37
108727,True,0,No user reviews,0,0,0
108800,True,8,Very Positive,1931,455,2386
109200,True,8,Very Positive,54,13,67
109400,True,4,Mostly Negative,7,20,27
109410,True,0,No user reviews,0,0,0
109500,True,5,Mixed,38,32,70
109600,True,5,Mixed,80,35,115
109700,True,5,Mixed,27,16,43
109702,True,0,No user reviews,0,0,0
109720,True,0,No user reviews,0,0,0
110400,True,7,Positive,37,5,42
110500,True,7,Positive,16,3,19
110520,True,0,No user reviews,0,0,0
110600,True,6,Mostly Positive,9,3,12
110610,True,7,Positive,13,1,14
110630,True,6,Mostly Positive,15,4,19
110800,True,8,Very Positive,6802,1407,8209
110810,True,8,Very Positive,81,8,89
111000,True,5,Mixed,28,25,53
111010,True,5,Mixed,26,20,46
111020,True,0,No user reviews,0,0,0
111030,True,0,No user reviews,0,0,0
111100,True,8,Very Positive,93,7,100
111300,True,6,Mostly Positive,16,6,22
111400,True,4,Mostly Negative,63,106,169
111402,True,0,1 user reviews,1,0,1
111403,True,0,No user reviews,0,0,0
111600,True,8,Very Positive,194,38,232
111610,True,0,No user reviews,0,0,0
111710,True,0,No user reviews,0,0,0
111800,True,6,Mostly Positive,185,50,235
111900,True,2,Very Negative,32,132,164
111910,True,0,No user reviews,0,0,0
111911,True,0,No user reviews,0,0,0
111912,True,0,No user reviews,0,0,0
111913,True,0,No user reviews,0,0,0
111914,True,0,No user reviews,0,0,0
111915,True,0,No user reviews,0,0,0
111916,True,0,No user reviews,0,0,0
112100,True,8,Very Positive,219,49,268
112110,True,0,No user reviews,0,0,0
113020,True,8,Very Positive,2238,182,2420
113200,True,9,Overwhelmingly Positive,18398,865,19263
113203,True,0,5 user reviews,5,0,5
113204,True,8,Very Positive,314,19,333
113205,True,0,No user reviews,0,0,0
113400,True,5,Mixed,91,105,196
113402,True,0,No user reviews,0,0,0
113403,True,0,No user reviews,0,0,0
113404,True,7,Positive,9,2,11
113405,True,6,Mostly Positive,11,3,14
113420,True,4,Mostly Negative,11,17,28
113900,True,0,No user reviews,0,0,0
115100,True,8,Very Positive,1294,72,1366
115110,True,8,Very Positive,481,43,524
115120,True,8,Very Positive,384,72,456
115200,True,5,Mixed,57,70,127
115210,True,6,Mostly Positive,97,41,138
115220,True,5,Mixed,76,37,113
115300,True,8,Very Positive,2752,560,3312
115308,True,0,No user reviews,0,0,0
115309,True,0,No user reviews,0,0,0
115320,True,5,Mixed,1604,825,2429
115340,True,5,Mixed,12,8,20
115800,True,8,Very Positive,1696,214,1910
116100,True,5,Mixed,61,36,97
116120,True,7,Positive,37,3,40
200000,True,0,1 user reviews,1,0,1
200001,True,0,No user reviews,0,0,0
200002,True,0,1 user reviews,1,0,1
200010,True,8,Very Positive,847,163,1010
200020,True,4,Mostly Negative,19,33,52
200030,True,0,No user reviews,0,0,0
200050,True,4,Mostly Negative,28,48,76
200060,True,0,No user reviews,0,0,0
200080,True,6,Mostly Positive,118,41,159
200130,True,8,Very Positive,100,25,125
200150,True,5,Mixed,97,100,197
200170,True,8,Very Positive,1323,301,1624
200172,True,0,No user reviews,0,0,0
200173,True,0,No user reviews,0,0,0
200174,True,0,No user reviews,0,0,0
200175,True,0,No user reviews,0,0,0
200176,True,0,No user reviews,0,0,0
200177,True,0,No user reviews,0,0,0
200178,True,0,No user reviews,0,0,0
200179,True,0,No user reviews,0,0,0
200180,True,0,No user reviews,0,0,0
200181,True,0,No user reviews,0,0,0
200182,True,0,No user reviews,0,0,0
200183,True,0,No user reviews,0,0,0
200185,True,0,3 user reviews,3,0,3
200186,True,0,No user reviews,0,0,0
200187,True,0,No user reviews,0,0,0
200188,True,0,2 user reviews,2,0,2
200189,True,0,1 user reviews,1,0,1
200190,True,5,Mixed,14,11,25
200210,True,6,Mostly Positive,102,27,129
200230,True,5,Mixed,141,84,225
200240,True,0,No user reviews,0,0,0
200260,True,8,Very Positive,9425,566,9991
200300,True,0,1 user reviews,1,0,1
200310,True,0,No user reviews,0,0,0
200320,True,0,No user reviews,0,0,0
200321,True,0,No user reviews,0,0,0
200322,True,0,No user reviews,0,0,0
200323,True,0,No user reviews,0,0,0
200330,True,7,Positive,20,1,21
200340,True,0,No user reviews,0,0,0
200350,True,5,Mixed,9,12,21
200370,True,5,Mixed,146,93,239
200390,True,5,Mixed,30,33,63
200396,True,0,No user reviews,0,0,0
200397,True,0,1 user reviews,1,0,1
200400,True,0,No user reviews,0,0,0
200410,True,5,Mixed,27,20,47
200440,True,5,Mixed,18,11,29
200490,True,5,Mixed,29,28,57
200496,True,0,No user reviews,0,0,0
200510,True,8,Very Positive,17748,1038,18786
200519,True,0,No user reviews,0,0,0
200530,True,0,7 user reviews,5,2,7
200550,True,4,Mostly Negative,40,70,110
200570,True,0,No user reviews,0,0,0
200590,True,6,Mostly Positive,70,21,91
200600,True,0,No user reviews,0,0,0
200610,True,0,6 user reviews,6,0,6
200620,True,0,2 user reviews,1,1,2
200630,True,4,Mostly Negative,25,82,107
200650,True,0,No user reviews,0,0,0
200670,True,4,Mostly Negative,28,59,87
200710,True,8,Very Positive,13747,841,14588
200730,True,0,No user reviews,0,0,0
200731,True,0,No user reviews,0,0,0
200732,True,0,No user reviews,0,0,0
200733,True,0,No user reviews,0,0,0
200734,True,0,No user reviews,0,0,0
200735,True,0,No user reviews,0,0,0
200770,True,0,No user reviews,0,0,0
200780,True,0,No user reviews,0,0,0
200790,True,0,No user reviews,0,0,0
200800,True,0,No user reviews,0,0,0
200810,True,0,No user reviews,0,0,0
200820,True,0,No user reviews,0,0,0
200830,True,0,No user reviews,0,0,0
200840,True,0,No user reviews,0,0,0
200850,True,0,No user reviews,0,0,0
200860,True,0,4 user reviews,3,1,4
200870,True,0,3 user reviews,1,2,3
200880,True,0,3 user reviews,1,2,3
200890,True,0,1 user reviews,0,1,1
200891,True,6,Mostly Positive,11,3,14
200900,True,8,Very Positive,2539,145,2684
200910,True,8,Very Positive,748,83,831
200940,True,8,Very Positive,1443,172,1615
200960,True,8,Very Positive,233,14,247
200980,True,7,Positive,33,1,34
200990,True,7,Positive,26,1,27
201000,True,7,Positive,21,0,21
201010,True,8,Very Positive,60,2,62
201020,True,8,Very Positive,51,8,59
201040,True,0,9 user reviews,2,7,9
201060,True,0,No user reviews,0,0,0
201070,True,5,Mixed,60,39,99
201090,True,0,No user reviews,0,0,0
201100,True,0,2 user reviews,1,1,2
201120,True,0,No user reviews,0,0,0
201160,True,0,No user reviews,0,0,0
201170,True,0,No user reviews,0,0,0
201190,True,0,No user reviews,0,0,0
201210,True,0,2 user reviews,1,1,2
201230,True,5,Mixed,10,7,17
201270,True,8,Very Positive,11179,1031,12210
201271,True,5,Mixed,231,133,364
201272,True,5,Mixed,38,32,70
201273,True,0,4 user reviews,4,0,4
201274,True,7,Positive,13,1,14
201275,True,0,2 user reviews,1,1,2
201276,True,0,No user reviews,0,0,0
201277,True,7,Positive,13,3,16
201278,True,0,No user reviews,0,0,0
201279,True,7,Positive,12,2,14
201280,True,8,Very Positive,232,13,245
201290,True,6,Mostly Positive,370,106,476
201310,True,8,Very Positive,801,63,864
201330,True,8,Very Positive,2688,343,3031
201420,True,8,Very Positive,236,50,286
201430,True,0,No user reviews,0,0,0
201480,True,5,Mixed,125,135,260
201490,True,2,Very Negative,29,174,203
201510,True,1,Overwhelmingly Negative,75,618,693
201570,True,6,Mostly Positive,99,40,139
201600,True,0,No user reviews,0,0,0
201680,True,0,No user reviews,0,0,0
201700,True,6,Mostly Positive,448,144,592
201720,True,0,No user reviews,0,0,0
201760,True,8,Very Positive,52,13,65
201790,True,8,Very Positive,4578,317,4895
201801,True,0,No user reviews,0,0,0
201802,True,7,Positive,13,3,16
201803,True,0,No user reviews,0,0,0
201804,True,6,Mostly Positive,10,4,14
201805,True,6,Mostly Positive,8,3,11
201809,True,0,4 user reviews,4,0,4
201810,True,8,Very Positive,14179,1882,16061
201830,True,5,Mixed,457,232,689
201870,True,8,Very Positive,2154,492,2646
201877,True,5,Mixed,7,9,16
201878,True,0,No user reviews,0,0,0
201879,True,0,No user reviews,0,0,0
201880,True,0,No user reviews,0,0,0
201881,True,5,Mixed,5,7,12
201882,True,5,Mixed,26,28,54
201890,True,0,No user reviews,0,0,0
201930,True,0,No user reviews,0,0,0
201951,True,0,No user reviews,0,0,0
201952,True,0,No user reviews,0,0,0
201953,True,0,No user reviews,0,0,0
201954,True,0,No user reviews,0,0,0
201955,True,0,No user reviews,0,0,0
201956,True,0,No user reviews,0,0,0
201957,True,0,No user reviews,0,0,0
201958,True,0,No user reviews,0,0,0
201959,True,0,No user reviews,0,0,0
201960,True,0,No user reviews,0,0,0
201961,True,0,No user reviews,0,0,0
201962,True,0,No user reviews,0,0,0
201963,True,0,No user reviews,0,0,0
201964,True,0,No user reviews,0,0,0
201965,True,0,No user reviews,0,0,0
201966,True,0,1 user reviews,1,0,1
201969,True,0,No user reviews,0,0,0
201970,True,0,No user reviews,0,0,0
201971,True,0,No user reviews,0,0,0
201972,True,0,1 user reviews,1,0,1
201973,True,0,No user reviews,0,0,0
202010,True,0,No user reviews,0,0,0
202020,True,0,No user reviews,0,0,0
202030,True,0,No user reviews,0,0,0
202040,True,0,No user reviews,0,0,0
202070,True,8,Very Positive,91,14,105
202090,True,8,Very Positive,283,35,318
202092,True,0,No user reviews,0,0,0
202093,True,0,No user reviews,0,0,0
202094,True,0,No user reviews,0,0,0
202095,True,0,No user reviews,0,0,0
202110,True,0,No user reviews,0,0,0
202113,True,0,No user reviews,0,0,0
202130,True,5,Mixed,95,132,227
202170,True,8,Very Positive,5440,352,5792
202181,True,0,No user reviews,0,0,0
202190,True,0,No user reviews,0,0,0
202191,True,0,2 user reviews,0,2,2
202192,True,0,No user reviews,0,0,0
202193,True,0,2 user reviews,0,2,2
202195,True,0,No user reviews,0,0,0
202197,True,0,No user reviews,0,0,0
202198,True,0,No user reviews,0,0,0
202199,True,0,No user reviews,0,0,0
202200,True,6,Mostly Positive,518,144,662
202220,True,0,No user reviews,0,0,0
202230,True,0,No user reviews,0,0,0
202240,True,0,No user reviews,0,0,0
202270,True,5,Mixed,77,79,156
202290,True,0,2 user reviews,1,1,2
202310,True,5,Mixed,178,147,325
202351,True,0,No user reviews,0,0,0
202352,True,0,No user reviews,0,0,0
202370,True,5,Mixed,21,12,33
202390,True,0,1 user reviews,1,0,1
202410,True,8,Very Positive,50,9,59
202412,True,0,No user reviews,0,0,0
202450,True,0,1 user reviews,1,0,1
202452,True,0,1 user reviews,0,1,1
202454,True,0,1 user reviews,1,0,1
202480,True,0,No user reviews,0,0,0
202485,True,6,Mostly Positive,17,5,22
202520,True,0,5 user reviews,4,1,5
202521,True,0,4 user reviews,3,1,4
202522,True,0,No user reviews,0,0,0
202523,True,0,1 user reviews,1,0,1
202524,True,0,4 user reviews,3,1,4
202530,True,5,Mixed,314,403,717
202550,True,0,No user reviews,0,0,0
202570,True,8,Very Positive,2688,343,3031
202610,True,0,No user reviews,0,0,0
202650,True,0,No user reviews,0,0,0
202651,True,0,No user reviews,0,0,0
202652,True,0,1 user reviews,0,1,1
202670,True,8,Very Positive,85,11,96
202690,True,8,Very Positive,99,4,103
202710,True,5,Mixed,298,131,429
202730,True,8,Very Positive,71,10,81
202750,True,6,Mostly Positive,1307,488,1795
202860,True,4,Mostly Negative,9,19,28
202880,True,0,No user reviews,0,0,0
202900,True,0,No user reviews,0,0,0
202920,True,0,No user reviews,0,0,0
202930,True,0,No user reviews,0,0,0
202931,True,0,No user reviews,0,0,0
202941,True,0,1 user reviews,1,0,1
202950,True,0,No user reviews,0,0,0
202951,True,0,1 user reviews,0,1,1
202960,True,0,No user reviews,0,0,0
202961,True,0,3 user reviews,3,0,3
202970,True,8,Very Positive,4749,1055,5804
202988,True,0,No user reviews,0,0,0
202990,True,8,Very Positive,1091,116,1207
203050,True,0,No user reviews,0,0,0
203060,True,0,No user reviews,0,0,0
203140,True,8,Very Positive,6757,1185,7942
203160,True,8,Very Positive,30984,1853,32837
203180,True,0,No user reviews,0,0,0
203181,True,0,No user reviews,0,0,0
203182,True,0,No user reviews,0,0,0
203183,True,0,No user reviews,0,0,0
203184,True,0,No user reviews,0,0,0
203190,True,0,No user reviews,0,0,0
203210,True,8,Very Positive,331,26,357
203230,True,0,No user reviews,0,0,0
203250,True,5,Mixed,160,85,245
203290,True,6,Mostly Positive,64,20,84
203300,True,0,No user reviews,0,0,0
203340,True,0,3 user reviews,0,3,3
203341,True,0,3 user reviews,0,3,3
203342,True,0,2 user reviews,0,2,2
203343,True,0,5 user reviews,2,3,5
203344,True,0,5 user reviews,3,2,5
203345,True,0,4 user reviews,2,2,4
203350,True,6,Mostly Positive,178,56,234
203353,True,0,No user reviews,0,0,0
203358,True,0,9 user reviews,8,1,9
203510,True,8,Very Positive,404,77,481
203530,True,0,No user reviews,0,0,0
203560,True,8,Very Positive,67,10,77
203600,True,0,No user reviews,0,0,0
203630,True,8,Very Positive,447,70,517
203650,True,6,Mostly Positive,337,110,447
203670,True,0,No user reviews,0,0,0
203680,True,6,Mostly Positive,144,56,200
203699,True,0,No user reviews,0,0,0
203700,True,0,6 user reviews,4,2,6
203701,True,6,Mostly Positive,11,4,15
203702,True,0,3 user reviews,2,1,3
203730,True,8,Very Positive,420,23,443
203733,True,0,3 user reviews,3,0,3
203750,True,8,Very Positive,920,195,1115
203765,True,0,6 user reviews,2,4,6
203766,True,0,4 user reviews,2,2,4
203770,True,8,Very Positive,19755,1513,21268
203772,True,6,Mostly Positive,10,4,14
203773,True,6,Mostly Positive,21,9,30
203774,True,0,6 user reviews,2,4,6
203775,True,0,6 user reviews,3,3,6
203776,True,4,Mostly Negative,50,123,173
203777,True,0,5 user reviews,1,4,5
203778,True,5,Mixed,53,23,76
203810,True,6,Mostly Positive,2341,678,3019
203813,True,0,No user reviews,0,0,0
203830,True,8,Very Positive,480,97,577
203850,True,7,Positive,41,1,42
203871,True,0,No user reviews,0,0,0
203872,True,0,No user reviews,0,0,0
203873,True,0,No user reviews,0,0,0
203874,True,0,No user reviews,0,0,0
203875,True,0,No user reviews,0,0,0
203876,True,0,No user reviews,0,0,0
203877,True,0,No user reviews,0,0,0
203879,True,0,No user reviews,0,0,0
203881,True,0,1 user reviews,1,0,1
203970,True,0,No user reviews,0,0,0
203990,True,8,Very Positive,91,11,102
204010,True,0,No user reviews,0,0,0
204030,True,8,Very Positive,2798,290,3088
204050,True,0,No user reviews,0,0,0
204060,True,6,Mostly Positive,661,175,836
204075,True,0,No user reviews,0,0,0
204080,True,5,Mixed,231,124,355
204085,True,0,No user reviews,0,0,0
204086,True,0,No user reviews,0,0,0
204100,True,6,Mostly Positive,8864,2310,11174
204106,True,0,2 user reviews,1,1,2
204107,True,0,3 user reviews,0,3,3
204108,True,0,1 user reviews,0,1,1
204109,True,0,1 user reviews,0,1,1
204110,True,0,2 user reviews,0,2,2
204111,True,0,1 user reviews,0,1,1
204112,True,0,No user reviews,0,0,0
204120,True,8,Very Positive,337,56,393
204140,True,6,Mostly Positive,44,18,62
204180,True,8,Very Positive,602,122,724
204182,True,0,5 user reviews,3,2,5
204185,True,0,4 user reviews,4,0,4
204220,True,7,Positive,24,6,30
204240,True,8,Very Positive,926,143,1069
204260,True,0,No user reviews,0,0,0
204280,True,0,No user reviews,0,0,0
204281,True,0,2 user reviews,0,2,2
204282,True,0,4 user reviews,3,1,4
204283,True,0,2 user reviews,2,0,2
204284,True,0,2 user reviews,2,0,2
204285,True,0,3 user reviews,2,1,3
204286,True,0,2 user reviews,2,0,2
204287,True,0,5 user reviews,3,2,5
204288,True,0,1 user reviews,1,0,1
204289,True,0,6 user reviews,0,6,6
204290,True,6,Mostly Positive,10,3,13
204291,True,0,No user reviews,0,0,0
204292,True,0,No user reviews,0,0,0
204300,True,8,Very Positive,5855,1035,6890
204303,True,7,Positive,14,2,16
204304,True,0,1 user reviews,1,0,1
204305,True,0,2 user reviews,2,0,2
204306,True,0,4 user reviews,4,0,4
204307,True,0,2 user reviews,2,0,2
204308,True,0,5 user reviews,5,0,5
204309,True,0,1 user reviews,1,0,1
204310,True,0,6 user reviews,5,1,6
204311,True,0,5 user reviews,5,0,5
204312,True,0,4 user reviews,3,1,4
204313,True,0,No user reviews,0,0,0
204314,True,0,4 user reviews,2,2,4
204315,True,0,6 user reviews,6,0,6
204317,True,0,6 user reviews,6,0,6
204318,True,0,2 user reviews,2,0,2
204319,True,0,3 user reviews,2,1,3
204340,True,8,Very Positive,1604,269,1873
204350,True,0,No user reviews,0,0,0
204360,True,9,Overwhelmingly Positive,20621,727,21348
204371,True,8,Very Positive,223,1,224
204372,True,8,Very Positive,224,6,230
204380,True,5,Mixed,7,4,11
204381,True,0,8 user reviews,5,3,8
204382,True,0,4 user reviews,2,2,4
204383,True,0,5 user reviews,3,2,5
204384,True,0,7 user reviews,3,4,7
204385,True,7,Positive,9,2,11
204386,True,7,Positive,9,1,10
204387,True,0,4 user reviews,3,1,4
204388,True,0,5 user reviews,5,0,5
204390,True,8,Very Positive,61,10,71
204410,True,0,No user reviews,0,0,0
204419,True,0,No user reviews,0,0,0
204420,True,0,No user reviews,0,0,0
204440,True,8,Very Positive,49,6,55
204450,True,8,Very Positive,5568,310,5878
204470,True,0,No user reviews,0,0,0
204482,True,0,No user reviews,0,0,0
204483,True,0,No user reviews,0,0,0
204510,True,0,9 user reviews,5,4,9
204530,True,8,Very Positive,1406,76,1482
204560,True,4,Mostly Negative,18,33,51
204580,True,7,Positive,9,2,11
204610,True,0,No user reviews,0,0,0
204630,True,8,Very Positive,900,117,1017
204650,True,0,No user reviews,0,0,0
204680,True,0,No user reviews,0,0,0
204731,True,0,No user reviews,0,0,0
204732,True,0,2 user reviews,1,1,2
204733,True,0,No user reviews,0,0,0
204734,True,0,2 user reviews,0,2,2
204760,True,4,Mostly Negative,18,62,80
204800,True,0,No user reviews,0,0,0
204802,True,0,No user reviews,0,0,0
204803,True,0,No user reviews,0,0,0
204820,True,0,No user reviews,0,0,0
204840,True,4,Mostly Negative,17,26,43
204851,True,0,No user reviews,0,0,0
204860,True,5,Mixed,52,29,81
204880,True,8,Very Positive,5106,308,5414
204900,True,0,9 user reviews,4,5,9
204901,True,0,9 user reviews,4,5,9
204902,True,0,4 user reviews,4,0,4
204920,True,0,No user reviews,0,0,0
204940,True,5,Mixed,45,37,82
204980,True,0,No user reviews,0,0,0
205020,True,8,Very Positive,221,31,252
205060,True,5,Mixed,46,31,77
205063,True,0,1 user reviews,1,0,1
205070,True,6,Mostly Positive,34,11,45
205073,True,0,3 user reviews,3,0,3
205080,True,5,Mixed,42,21,63
205083,True,0,1 user reviews,1,0,1
205093,True,0,No user reviews,0,0,0
205100,True,9,Overwhelmingly Positive,23491,747,24238
205120,True,0,No user reviews,0,0,0
205140,True,0,1 user reviews,1,0,1
205150,True,0,No user reviews,0,0,0
205160,True,0,No user reviews,0,0,0
205170,True,0,1 user reviews,0,1,1
205180,True,0,No user reviews,0,0,0
205190,True,8,Very Positive,273,41,314
205215,True,0,No user reviews,0,0,0
205216,True,0,No user reviews,0,0,0
205230,True,6,Mostly Positive,163,44,207
205250,True,7,Positive,10,1,11
205252,True,0,No user reviews,0,0,0
205270,True,6,Mostly Positive,16,5,21
205272,True,0,No user reviews,0,0,0
205330,True,8,Very Positive,52,13,65
205350,True,5,Mixed,188,210,398
205370,True,0,No user reviews,0,0,0
205530,True,5,Mixed,30,27,57
205541,True,0,No user reviews,0,0,0
205550,True,5,Mixed,51,36,87
205590,True,4,Mostly Negative,8,24,32
205610,True,6,Mostly Positive,272,112,384
205630,True,7,Positive,33,6,39
205631,True,0,No user reviews,0,0,0
205632,True,7,Positive,9,1,10
205633,True,6,Mostly Positive,11,3,14
205634,True,7,Positive,12,1,13
205635,True,5,Mixed,5,5,10
205636,True,5,Mixed,10,5,15
205637,True,0,9 user reviews,8,1,9
205638,True,0,9 user reviews,7,2,9
205650,True,6,Mostly Positive,545,155,700
205690,True,6,Mostly Positive,76,20,96
205700,True,0,No user reviews,0,0,0
205710,True,5,Mixed,4,6,10
205730,True,8,Very Positive,254,35,289
205750,True,0,No user reviews,0,0,0
205790,True,0,No user reviews,0,0,0
205810,True,5,Mixed,39,19,58
205830,True,8,Very Positive,62,1,63
205840,True,8,Very Positive,227,56,283
205860,True,0,No user reviews,0,0,0
205870,True,6,Mostly Positive,58,17,75
205890,True,7,Positive,12,1,13
205910,True,8,Very Positive,1374,124,1498
205930,True,8,Very Positive,263,41,304
205950,True,8,Very Positive,1822,191,2013
205990,True,5,Mixed,325,190,515
206020,True,7,Positive,40,9,49
206040,True,7,Positive,16,4,20
206060,True,7,Positive,34,3,37
206085,True,0,No user reviews,0,0,0
206086,True,0,No user reviews,0,0,0
206088,True,0,No user reviews,0,0,0
206089,True,0,No user reviews,0,0,0
206090,True,0,No user reviews,0,0,0
206091,True,0,No user reviews,0,0,0
206092,True,0,3 user reviews,1,2,3
206093,True,0,No user reviews,0,0,0
206094,True,0,No user reviews,0,0,0
206095,True,0,1 user reviews,1,0,1
206096,True,0,No user reviews,0,0,0
206097,True,0,No user reviews,0,0,0
206098,True,0,No user reviews,0,0,0
206099,True,0,1 user reviews,1,0,1
206100,True,0,No user reviews,0,0,0
206101,True,0,No user reviews,0,0,0
206102,True,0,No user reviews,0,0,0
206103,True,0,No user reviews,0,0,0
206104,True,0,No user reviews,0,0,0
206105,True,0,No user reviews,0,0,0
206106,True,0,No user reviews,0,0,0
206107,True,0,2 user reviews,1,1,2
206108,True,0,1 user reviews,1,0,1
206109,True,0,No user reviews,0,0,0
206110,True,0,No user reviews,0,0,0
206111,True,0,No user reviews,0,0,0
206112,True,0,No user reviews,0,0,0
206113,True,0,No user reviews,0,0,0
206114,True,0,No user reviews,0,0,0
206115,True,0,No user reviews,0,0,0
206116,True,0,No user reviews,0,0,0
206117,True,0,No user reviews,0,0,0
206118,True,0,2 user reviews,2,0,2
206119,True,0,No user reviews,0,0,0
206120,True,0,No user reviews,0,0,0
206121,True,0,No user reviews,0,0,0
206122,True,0,No user reviews,0,0,0
206123,True,0,No user reviews,0,0,0
206124,True,0,1 user reviews,1,0,1
206125,True,0,2 user reviews,2,0,2
206126,True,0,No user reviews,0,0,0
206127,True,0,3 user reviews,3,0,3
206128,True,0,No user reviews,0,0,0
206129,True,0,No user reviews,0,0,0
206130,True,0,No user reviews,0,0,0
206131,True,0,No user reviews,0,0,0
206132,True,0,No user reviews,0,0,0
206133,True,0,No user reviews,0,0,0
206134,True,0,No user reviews,0,0,0
206135,True,0,No user reviews,0,0,0
206136,True,0,No user reviews,0,0,0
206137,True,0,No user reviews,0,0,0
206138,True,0,2 user reviews,2,0,2
206139,True,0,1 user reviews,1,0,1
206140,True,0,No user reviews,0,0,0
206141,True,0,No user reviews,0,0,0
206142,True,0,1 user reviews,0,1,1
206143,True,0,1 user reviews,1,0,1
206144,True,0,No user reviews,0,0,0
206145,True,0,No user reviews,0,0,0
206146,True,0,No user reviews,0,0,0
206147,True,0,No user reviews,0,0,0
206148,True,0,1 user reviews,1,0,1
206149,True,0,No user reviews,0,0,0
206150,True,0,1 user reviews,1,0,1
206151,True,0,2 user reviews,2,0,2
206152,True,0,No user reviews,0,0,0
206153,True,0,1 user reviews,1,0,1
206154,True,0,1 user reviews,1,0,1
206155,True,0,1 user reviews,1,0,1
206156,True,0,No user reviews,0,0,0
206157,True,0,No user reviews,0,0,0
206158,True,0,No user reviews,0,0,0
206159,True,0,No user reviews,0,0,0
206160,True,0,1 user reviews,1,0,1
206161,True,0,No user reviews,0,0,0
206162,True,0,No user reviews,0,0,0
206163,True,0,1 user reviews,1,0,1
206164,True,0,1 user reviews,1,0,1
206165,True,0,1 user reviews,1,0,1
206166,True,0,3 user reviews,2,1,3
206167,True,0,No user reviews,0,0,0
206168,True,0,No user reviews,0,0,0
206169,True,0,No user reviews,0,0,0
206170,True,0,No user reviews,0,0,0
206171,True,0,No user reviews,0,0,0
206172,True,0,3 user reviews,1,2,3
206173,True,0,No user reviews,0,0,0
206174,True,0,1 user reviews,1,0,1
206175,True,0,No user reviews,0,0,0
206176,True,0,2 user reviews,1,1,2
206177,True,0,1 user reviews,1,0,1
206178,True,0,1 user reviews,1,0,1
206179,True,0,2 user reviews,1,1,2
206180,True,0,No user reviews,0,0,0
206190,True,9,Overwhelmingly Positive,6857,174,7031
206193,True,0,2 user reviews,2,0,2
206195,True,0,1 user reviews,1,0,1
206210,True,8,Very Positive,215,38,253
206230,True,5,Mixed,17,11,28
206250,True,6,Mostly Positive,58,20,78
206270,True,0,No user reviews,0,0,0
206290,True,0,No user reviews,0,0,0
206310,True,0,No user reviews,0,0,0
206370,True,8,Very Positive,153,8,161
206410,True,7,Positive,12,2,14
206415,True,0,No user reviews,0,0,0
206416,True,0,No user reviews,0,0,0
206420,True,8,Very Positive,17022,2070,19092
206440,True,9,Overwhelmingly Positive,13204,546,13750
206450,True,8,Very Positive,77,2,79
206480,True,6,Mostly Positive,41,12,53
206500,True,6,Mostly Positive,34,13,47
206521,True,7,Positive,32,4,36
206522,True,5,Mixed,8,7,15
206523,True,0,No user reviews,0,0,0
206524,True,0,No user reviews,0,0,0
206525,True,0,No user reviews,0,0,0
206526,True,0,No user reviews,0,0,0
206550,True,0,2 user reviews,2,0,2
206560,True,0,No user reviews,0,0,0
206570,True,0,No user reviews,0,0,0
206580,True,0,No user reviews,0,0,0
206590,True,0,No user reviews,0,0,0
206610,True,4,Mostly Negative,17,47,64
206650,True,0,No user reviews,0,0,0
206690,True,8,Very Positive,69,12,81
206710,True,0,No user reviews,0,0,0
206711,True,0,No user reviews,0,0,0
206712,True,0,4 user reviews,2,2,4
206713,True,0,No user reviews,0,0,0
206714,True,0,1 user reviews,1,0,1
206715,True,0,No user reviews,0,0,0
206716,True,0,1 user reviews,0,1,1
206717,True,0,No user reviews,0,0,0
206718,True,0,3 user reviews,3,0,3
206720,True,0,1 user reviews,0,1,1
206721,True,0,No user reviews,0,0,0
206730,True,0,No user reviews,0,0,0
206740,True,7,Positive,18,4,22
206743,True,0,No user reviews,0,0,0
206744,True,0,No user reviews,0,0,0
206745,True,0,No user reviews,0,0,0
206746,True,0,No user reviews,0,0,0
206747,True,0,No user reviews,0,0,0
206748,True,0,No user reviews,0,0,0
206749,True,0,No user reviews,0,0,0
206750,True,0,No user reviews,0,0,0
206751,True,0,No user reviews,0,0,0
206752,True,0,No user reviews,0,0,0
206753,True,0,No user reviews,0,0,0
206760,True,5,Mixed,35,38,73
206781,True,0,No user reviews,0,0,0
206782,True,0,No user reviews,0,0,0
206783,True,0,No user reviews,0,0,0
206784,True,0,No user reviews,0,0,0
206785,True,0,No user reviews,0,0,0
206786,True,0,No user reviews,0,0,0
206787,True,0,1 user reviews,1,0,1
206788,True,0,No user reviews,0,0,0
206881,True,0,No user reviews,0,0,0
206882,True,0,No user reviews,0,0,0
206940,True,0,No user reviews,0,0,0
206950,True,0,No user reviews,0,0,0
206960,True,0,No user reviews,0,0,0
206970,True,0,No user reviews,0,0,0
206980,True,0,No user reviews,0,0,0
207000,True,5,Mixed,9,13,22
207010,True,0,No user reviews,0,0,0
207011,True,0,No user reviews,0,0,0
207012,True,0,No user reviews,0,0,0
207020,True,6,Mostly Positive,86,24,110
207040,True,8,Very Positive,230,45,275
207060,True,7,Positive,12,3,15
207080,True,9,Overwhelmingly Positive,512,23,535
207100,True,0,No user reviews,0,0,0
207111,True,0,1 user reviews,1,0,1
207112,True,0,2 user reviews,2,0,2
207113,True,0,2 user reviews,1,1,2
207114,True,0,1 user reviews,1,0,1
207115,True,0,No user reviews,0,0,0
207130,True,0,No user reviews,0,0,0
207140,True,8,Very Positive,6781,396,7177
207150,True,4,Mostly Negative,121,189,310
207165,True,0,No user reviews,0,0,0
207166,True,0,No user reviews,0,0,0
207167,True,0,No user reviews,0,0,0
207168,True,0,No user reviews,0,0,0
207169,True,0,No user reviews,0,0,0
207170,True,8,Very Positive,2341,179,2520
207190,True,5,Mixed,22,21,43
207210,True,5,Mixed,547,381,928
207221,True,7,Positive,18,4,22
207230,True,5,Mixed,15,8,23
207241,True,0,No user reviews,0,0,0
207250,True,5,Mixed,151,70,221
207270,True,0,No user reviews,0,0,0
207320,True,8,Very Positive,693,46,739
207350,True,9,Overwhelmingly Positive,1148,57,1205
207370,True,5,Mixed,92,95,187
207375,True,0,No user reviews,0,0,0
207380,True,8,Very Positive,89,11,100
207385,True,0,No user reviews,0,0,0
207400,True,8,Very Positive,231,13,244
207405,True,0,No user reviews,0,0,0
207420,True,6,Mostly Positive,241,75,316
207430,True,5,Mixed,127,104,231
207490,True,8,Very Positive,932,74,1006
207510,True,0,No user reviews,0,0,0
207530,True,8,Very Positive,265,14,279
207570,True,8,Very Positive,97,4,101
207610,True,9,Overwhelmingly Positive,16231,600,16831
207620,True,6,Mostly Positive,257,87,344
207630,True,0,No user reviews,0,0,0
207650,True,6,Mostly Positive,34,13,47
207655,True,0,No user reviews,0,0,0
207660,True,0,No user reviews,0,0,0
207670,True,5,Mixed,10,8,18
207690,True,9,Overwhelmingly Positive,1275,59,1334
207710,True,5,Mixed,7,4,11
207730,True,4,Mostly Negative,42,115,157
207750,True,8,Very Positive,489,65,554
207770,True,0,No user reviews,0,0,0
207790,True,4,Mostly Negative,59,144,203
207811,True,0,No user reviews,0,0,0
207812,True,0,No user reviews,0,0,0
207813,True,0,No user reviews,0,0,0
207815,True,8,Very Positive,229,15,244
207816,True,8,Very Positive,114,1,115
207870,True,6,Mostly Positive,147,50,197
207890,True,8,Very Positive,117,1,118
207930,True,5,Mixed,109,58,167
207970,True,0,No user reviews,0,0,0
207990,True,0,No user reviews,0,0,0
208010,True,0,No user reviews,0,0,0
208030,True,0,2 user reviews,2,0,2
208050,True,0,No user reviews,0,0,0
208070,True,0,No user reviews,0,0,0
208100,True,0,No user reviews,0,0,0
208101,True,0,No user reviews,0,0,0
208102,True,0,No user reviews,0,0,0
208103,True,0,No user reviews,0,0,0
208110,True,5,Mixed,51,38,89
208140,True,6,Mostly Positive,3099,835,3934
208151,True,0,No user reviews,0,0,0
208152,True,0,No user reviews,0,0,0
208153,True,0,No user reviews,0,0,0
208154,True,0,No user reviews,0,0,0
208155,True,0,No user reviews,0,0,0
208156,True,0,No user reviews,0,0,0
208157,True,0,No user reviews,0,0,0
208158,True,0,No user reviews,0,0,0
208159,True,0,No user reviews,0,0,0
208200,True,8,Very Positive,2194,438,2632
208220,True,0,No user reviews,0,0,0
208280,True,8,Very Positive,50,8,58
208281,True,0,3 user reviews,2,1,3
208282,True,7,Positive,8,2,10
208283,True,0,8 user reviews,6,2,8
208284,True,6,Mostly Positive,15,4,19
208285,True,0,No user reviews,0,0,0
208286,True,7,Positive,40,5,45
208287,True,6,Mostly Positive,7,3,10
208288,True,5,Mixed,12,11,23
208289,True,0,9 user reviews,9,0,9
208290,True,0,No user reviews,0,0,0
208292,True,6,Mostly Positive,10,3,13
208293,True,7,Positive,13,2,15
208294,True,6,Mostly Positive,10,3,13
208295,True,0,4 user reviews,4,0,4
208296,True,7,Positive,19,2,21
208298,True,7,Positive,10,0,10
208299,True,0,No user reviews,0,0,0
208300,True,7,Positive,35,8,43
208301,True,6,Mostly Positive,22,9,31
208302,True,7,Positive,17,3,20
208303,True,7,Positive,14,2,16
208304,True,6,Mostly Positive,14,5,19
208305,True,0,No user reviews,0,0,0
208306,True,7,Positive,18,4,22
208307,True,7,Positive,18,4,22
208311,True,0,No user reviews,0,0,0
208312,True,0,No user reviews,0,0,0
208313,True,0,No user reviews,0,0,0
208314,True,0,No user reviews,0,0,0
208315,True,0,No user reviews,0,0,0
208316,True,0,No user reviews,0,0,0
208317,True,0,No user reviews,0,0,0
208318,True,0,8 user reviews,8,0,8
208319,True,7,Positive,13,0,13
208320,True,0,No user reviews,0,0,0
208340,True,0,No user reviews,0,0,0
208341,True,0,3 user reviews,2,1,3
208342,True,0,3 user reviews,3,0,3
208343,True,4,Mostly Negative,16,25,41
208344,True,0,No user reviews,0,0,0
208345,True,0,No user reviews,0,0,0
208346,True,6,Mostly Positive,9,3,12
208347,True,0,No user reviews,0,0,0
208348,True,6,Mostly Positive,13,4,17
208349,True,5,Mixed,5,5,10
208350,True,5,Mixed,24,13,37
208351,True,0,9 user reviews,8,1,9
208352,True,7,Positive,26,6,32
208353,True,0,7 user reviews,5,2,7
208354,True,0,8 user reviews,4,4,8
208355,True,5,Mixed,9,5,14
208356,True,6,Mostly Positive,12,5,17
208357,True,0,No user reviews,0,0,0
208358,True,0,No user reviews,0,0,0
208359,True,0,No user reviews,0,0,0
208361,True,5,Mixed,35,24,59
208362,True,5,Mixed,6,4,10
208363,True,7,Positive,26,2,28
208364,True,7,Positive,26,3,29
208365,True,6,Mostly Positive,17,5,22
208366,True,0,4 user reviews,3,1,4
208367,True,0,7 user reviews,7,0,7
208368,True,0,No user reviews,0,0,0
208369,True,7,Positive,10,1,11
208370,True,0,8 user reviews,6,2,8
208371,True,7,Positive,13,0,13
208372,True,0,No user reviews,0,0,0
208373,True,0,No user reviews,0,0,0
208374,True,0,6 user reviews,1,5,6
208375,True,7,Positive,15,0,15
208376,True,0,9 user reviews,9,0,9
208377,True,7,Positive,13,1,14
208378,True,0,No user reviews,0,0,0
208379,True,7,Positive,15,1,16
208400,True,8,Very Positive,579,52,631
208460,True,3,Negative,3,21,24
208462,True,0,No user reviews,0,0,0
208470,True,0,No user reviews,0,0,0
208480,True,5,Mixed,3162,1533,4695
208482,True,0,No user reviews,0,0,0
208483,True,0,No user reviews,0,0,0
208484,True,0,No user reviews,0,0,0
208485,True,0,No user reviews,0,0,0
208487,True,0,No user reviews,0,0,0
208488,True,0,No user reviews,0,0,0
208489,True,0,No user reviews,0,0,0
208491,True,5,Mixed,14,13,27
208492,True,0,No user reviews,0,0,0
208500,True,8,Very Positive,429,59,488
208520,True,5,Mixed,434,313,747
208539,True,0,No user reviews,0,0,0
208540,True,0,4 user reviews,3,1,4
208541,True,7,Positive,10,2,12
208542,True,0,4 user reviews,2,2,4
208543,True,0,5 user reviews,4,1,5
208544,True,7,Positive,19,2,21
208545,True,0,5 user reviews,4,1,5
208546,True,0,7 user reviews,7,0,7
208570,True,5,Mixed,64,68,132
208575,True,8,Very Positive,231,23,254
208580,True,8,Very Positive,9587,744,10331
208600,True,8,Very Positive,337,46,383
208610,True,0,No user reviews,0,0,0
208620,True,6,Mostly Positive,23,9,32
208630,True,7,Positive,20,1,21
208640,True,7,Positive,20,0,20
208650,True,6,Mostly Positive,11295,2861,14156
208670,True,8,Very Positive,144,27,171
208690,True,5,Mixed,51,27,78
208710,True,6,Mostly Positive,11,4,15
208730,True,5,Mixed,475,224,699
208740,True,7,Positive,16,4,20
208741,True,7,Positive,10,1,11
208742,True,7,Positive,9,1,10
208750,True,8,Very Positive,1359,133,1492
208790,True,3,Negative,2,10,12
208791,True,5,Mixed,8,8,16
208792,True,4,Mostly Negative,4,9,13
208793,True,4,Mostly Negative,6,12,18
208801,True,5,Mixed,4,6,10
208802,True,4,Mostly Negative,5,8,13
208803,True,4,Mostly Negative,4,7,11
208804,True,4,Mostly Negative,3,7,10
208805,True,4,Mostly Negative,5,9,14
208806,True,6,Mostly Positive,14,6,20
208807,True,6,Mostly Positive,18,6,24
208808,True,6,Mostly Positive,15,6,21
208809,True,6,Mostly Positive,14,4,18
208810,True,5,Mixed,9,9,18
208811,True,5,Mixed,8,8,16
208812,True,4,Mostly Negative,58,122,180
208813,True,5,Mixed,8,10,18
208814,True,5,Mixed,9,8,17
208816,True,0,No user reviews,0,0,0
208817,True,7,Positive,16,4,20
208818,True,7,Positive,23,4,27
208830,True,0,1 user reviews,1,0,1
208831,True,0,1 user reviews,1,0,1
208832,True,0,1 user reviews,1,0,1
208833,True,0,No user reviews,0,0,0
208834,True,0,No user reviews,0,0,0
208835,True,0,1 user reviews,1,0,1
208836,True,0,No user reviews,0,0,0
208837,True,0,No user reviews,0,0,0
208838,True,0,No user reviews,0,0,0
208839,True,0,No user reviews,0,0,0
208840,True,0,No user reviews,0,0,0
208841,True,0,No user reviews,0,0,0
208842,True,0,No user reviews,0,0,0
208843,True,0,1 user reviews,1,0,1
208844,True,0,No user reviews,0,0,0
208911,True,0,No user reviews,0,0,0
208981,True,0,5 user reviews,3,2,5
208982,True,0,No user reviews,0,0,0
208983,True,0,No user reviews,0,0,0
208984,True,0,No user reviews,0,0,0
208985,True,0,No user reviews,0,0,0
209000,True,8,Very Positive,6204,1372,7576
209040,True,0,No user reviews,0,0,0
209060,True,8,Very Positive,359,57,416
209080,True,8,Very Positive,5819,493,6312
209100,True,5,Mixed,532,562,1094
209120,True,5,Mixed,371,333,704
209160,True,5,Mixed,2096,2439,4535
209170,True,8,Very Positive,95,15,110
209190,True,8,Very Positive,259,33,292
209201,True,0,2 user reviews,2,0,2
209202,True,0,6 user reviews,5,1,6
209230,True,8,Very Positive,77,12,89
209270,True,6,Mostly Positive,231,77,308
209300,True,0,No user reviews,0,0,0
209301,True,0,No user reviews,0,0,0
209302,True,0,No user reviews,0,0,0
209303,True,0,No user reviews,0,0,0
209304,True,0,No user reviews,0,0,0
209330,True,5,Mixed,102,58,160
209340,True,5,Mixed,64,47,111
209343,True,0,No user reviews,0,0,0
209360,True,7,Positive,18,4,22
209362,True,0,No user reviews,0,0,0
209370,True,9,Overwhelmingly Positive,1119,58,1177
209373,True,0,7 user reviews,7,0,7
209375,True,0,No user reviews,0,0,0
209390,True,3,Negative,5,23,28
209421,True,0,No user reviews,0,0,0
209422,True,0,No user reviews,0,0,0
209423,True,0,No user reviews,0,0,0
209424,True,0,No user reviews,0,0,0
209425,True,0,No user reviews,0,0,0
209426,True,0,No user reviews,0,0,0
209427,True,0,No user reviews,0,0,0
209428,True,0,No user reviews,0,0,0
209460,True,8,Very Positive,87,8,95
209520,True,5,Mixed,111,55,166
209540,True,6,Mostly Positive,679,176,855
209545,True,0,5 user reviews,5,0,5
209546,True,0,1 user reviews,0,1,1
209547,True,0,No user reviews,0,0,0
209548,True,0,No user reviews,0,0,0
209610,True,5,Mixed,23,20,43
209630,True,8,Very Positive,127,22,149
209650,True,5,Mixed,2591,2238,4829
209660,True,8,Very Positive,54,13,67
209670,True,8,Very Positive,909,224,1133
209690,True,6,Mostly Positive,50,16,66
209720,True,0,No user reviews,0,0,0
209721,True,0,No user reviews,0,0,0
209730,True,5,Mixed,59,65,124
209750,True,5,Mixed,15,15,30
209771,True,0,3 user reviews,3,0,3
209772,True,0,6 user reviews,5,1,6
209790,True,8,Very Positive,118,14,132
209793,True,0,1 user reviews,0,1,1
209801,True,0,1 user reviews,0,1,1
209811,True,6,Mostly Positive,114,34,148
209812,True,6,Mostly Positive,93,32,125
209817,True,0,No user reviews,0,0,0
209819,True,0,No user reviews,0,0,0
209830,True,8,Very Positive,477,62,539
209850,True,5,Mixed,26,12,38
209870,True,5,Mixed,43,62,105
209872,True,0,9 user reviews,3,6,9
209873,True,5,Mixed,5,6,11
209874,True,0,3 user reviews,2,1,3
209875,True,0,No user reviews,0,0,0
209876,True,0,No user reviews,0,0,0
209877,True,0,No user reviews,0,0,0
209890,True,0,No user reviews,0,0,0
209950,True,8,Very Positive,300,28,328
210011,True,0,No user reviews,0,0,0
210012,True,0,5 user reviews,5,0,5
210013,True,0,6 user reviews,6,0,6
210014,True,5,Mixed,4,6,10
210015,True,0,3 user reviews,3,0,3
210016,True,0,4 user reviews,3,1,4
210017,True,0,4 user reviews,4,0,4
210018,True,0,4 user reviews,3,1,4
210019,True,0,5 user reviews,5,0,5
210030,True,0,No user reviews,0,0,0
210031,True,0,No user reviews,0,0,0
210032,True,0,No user reviews,0,0,0
210033,True,0,No user reviews,0,0,0
210034,True,0,No user reviews,0,0,0
210035,True,0,No user reviews,0,0,0
210036,True,0,No user reviews,0,0,0
210037,True,0,No user reviews,0,0,0
210038,True,0,No user reviews,0,0,0
210039,True,0,No user reviews,0,0,0
210040,True,0,No user reviews,0,0,0
210041,True,0,No user reviews,0,0,0
210042,True,0,No user reviews,0,0,0
210043,True,0,No user reviews,0,0,0
210044,True,0,No user reviews,0,0,0
210045,True,0,No user reviews,0,0,0
210046,True,0,No user reviews,0,0,0
210047,True,0,1 user reviews,1,0,1
210048,True,0,No user reviews,0,0,0
210049,True,0,No user reviews,0,0,0
210050,True,0,No user reviews,0,0,0
210051,True,0,No user reviews,0,0,0
210052,True,0,No user reviews,0,0,0
210053,True,0,No user reviews,0,0,0
210054,True,0,1 user reviews,1,0,1
210055,True,0,No user reviews,0,0,0
210056,True,0,No user reviews,0,0,0
210057,True,0,No user reviews,0,0,0
210058,True,0,No user reviews,0,0,0
210059,True,0,No user reviews,0,0,0
210060,True,0,No user reviews,0,0,0
210061,True,0,No user reviews,0,0,0
210062,True,0,No user reviews,0,0,0
210063,True,0,No user reviews,0,0,0
210064,True,0,No user reviews,0,0,0
210065,True,0,No user reviews,0,0,0
210066,True,0,No user reviews,0,0,0
210067,True,0,No user reviews,0,0,0
210068,True,0,1 user reviews,0,1,1
210069,True,0,1 user reviews,1,0,1
210070,True,0,No user reviews,0,0,0
210071,True,0,No user reviews,0,0,0
210072,True,0,No user reviews,0,0,0
210073,True,0,No user reviews,0,0,0
210074,True,0,No user reviews,0,0,0
210075,True,0,No user reviews,0,0,0
210076,True,0,No user reviews,0,0,0
210077,True,0,No user reviews,0,0,0
210078,True,0,No user reviews,0,0,0
210079,True,0,No user reviews,0,0,0
210080,True,0,No user reviews,0,0,0
210081,True,0,No user reviews,0,0,0
210082,True,0,No user reviews,0,0,0
210083,True,0,No user reviews,0,0,0
210084,True,0,No user reviews,0,0,0
210085,True,0,No user reviews,0,0,0
210086,True,0,No user reviews,0,0,0
210088,True,0,No user reviews,0,0,0
210089,True,0,No user reviews,0,0,0
210090,True,0,No user reviews,0,0,0
210091,True,0,No user reviews,0,0,0
210092,True,0,No user reviews,0,0,0
210093,True,0,No user reviews,0,0,0
210094,True,0,No user reviews,0,0,0
210095,True,0,No user reviews,0,0,0
210096,True,0,No user reviews,0,0,0
210097,True,0,No user reviews,0,0,0
210098,True,0,No user reviews,0,0,0
210099,True,0,No user reviews,0,0,0
210100,True,0,No user reviews,0,0,0
210101,True,0,No user reviews,0,0,0
210102,True,0,No user reviews,0,0,0
210103,True,0,No user reviews,0,0,0
210104,True,0,No user reviews,0,0,0
210105,True,0,No user reviews,0,0,0
210106,True,0,No user reviews,0,0,0
210107,True,0,No user reviews,0,0,0
210108,True,0,No user reviews,0,0,0
210109,True,0,No user reviews,0,0,0
210110,True,0,No user reviews,0,0,0
210111,True,0,No user reviews,0,0,0
210112,True,0,No user reviews,0,0,0
210113,True,7,Positive,11,2,13
210130,True,0,No user reviews,0,0,0
210170,True,5,Mixed,27,13,40
210190,True,0,No user reviews,0,0,0
210230,True,7,Positive,40,1,41
210290,True,0,No user reviews,0,0,0
210310,True,0,No user reviews,0,0,0
210350,True,0,6 user reviews,3,3,6
210370,True,0,No user reviews,0,0,0
210390,True,6,Mostly Positive,33,10,43
210410,True,0,No user reviews,0,0,0
210430,True,0,No user reviews,0,0,0
210450,True,0,No user reviews,0,0,0
210470,True,0,No user reviews,0,0,0
210490,True,3,Negative,0,36,36
210500,True,0,No user reviews,0,0,0
210510,True,0,3 user reviews,2,1,3
210550,True,8,Very Positive,172,25,197
210561,True,0,9 user reviews,4,5,9
210720,True,0,No user reviews,0,0,0
210740,True,0,No user reviews,0,0,0
210770,True,8,Very Positive,3614,274,3888
210840,True,0,No user reviews,0,0,0
210892,True,5,Mixed,6,4,10
210893,True,0,6 user reviews,3,3,6
210894,True,0,8 user reviews,6,2,8
210895,True,5,Mixed,46,20,66
210896,True,5,Mixed,7,4,11
210897,True,6,Mostly Positive,14,4,18
210898,True,5,Mixed,18,8,26
210899,True,0,9 user reviews,4,5,9
210900,True,5,Mixed,9,6,15
210901,True,6,Mostly Positive,7,3,10
210902,True,5,Mixed,44,57,101
210903,True,0,3 user reviews,1,2,3
210904,True,5,Mixed,9,13,22
210905,True,5,Mixed,8,7,15
210906,True,5,Mixed,32,27,59
210907,True,0,3 user reviews,1,2,3
210908,True,6,Mostly Positive,90,24,114
210931,True,7,Positive,18,2,20
210932,True,7,Positive,13,2,15
210933,True,8,Very Positive,64,2,66
210934,True,7,Positive,42,4,46
210936,True,7,Positive,20,2,22
210937,True,7,Positive,21,3,24
210938,True,7,Positive,15,2,17
210939,True,0,No user reviews,0,0,0
210942,True,0,No user reviews,0,0,0
210944,True,7,Positive,11,1,12
210945,True,7,Positive,16,1,17
210950,True,8,Very Positive,247,22,269
210970,True,8,Very Positive,3956,720,4676
210990,True,6,Mostly Positive,16,5,21
210999,True,0,No user reviews,0,0,0
211000,True,0,No user reviews,0,0,0
211001,True,0,No user reviews,0,0,0
211010,True,7,Positive,24,5,29
211050,True,5,Mixed,48,29,77
211070,True,5,Mixed,48,29,77
211090,True,0,No user reviews,0,0,0
211120,True,6,Mostly Positive,151,55,206
211140,True,0,No user reviews,0,0,0
211160,True,5,Mixed,205,189,394
211180,True,8,Very Positive,155,17,172
211200,True,0,3 user reviews,3,0,3
211201,True,0,4 user reviews,4,0,4
211202,True,0,2 user reviews,2,0,2
211203,True,0,2 user reviews,1,1,2
211204,True,0,2 user reviews,1,1,2
211205,True,0,5 user reviews,5,0,5
211206,True,0,5 user reviews,5,0,5
211207,True,0,2 user reviews,2,0,2
211208,True,0,2 user reviews,2,0,2
211209,True,0,3 user reviews,3,0,3
211260,True,8,Very Positive,1105,202,1307
211262,True,0,6 user reviews,6,0,6
211280,True,5,Mixed,49,34,83
211340,True,8,Very Positive,546,42,588
211340,True,8,Very Positive,546,42,588
211360,True,8,Very Positive,88,10,98
211380,True,0,No user reviews,0,0,0
211400,True,5,Mixed,2598,1115,3713
211419,True,0,8 user reviews,8,0,8
211420,True,8,Very Positive,27631,3407,31038
211440,True,8,Very Positive,123,22,145
211500,True,8,Very Positive,394,83,477
211520,True,0,5 user reviews,4,1,5
211521,True,0,5 user reviews,4,1,5
211522,True,0,6 user reviews,4,2,6
211523,True,5,Mixed,6,7,13
211580,True,5,Mixed,101,100,201
211600,True,8,Very Positive,1253,95,1348
211670,True,0,5 user reviews,4,1,5
211691,True,0,No user reviews,0,0,0
211692,True,0,No user reviews,0,0,0
211693,True,0,No user reviews,0,0,0
211720,True,8,Very Positive,558,75,633
211740,True,8,Very Positive,765,45,810
211780,True,6,Mostly Positive,305,98,403
211800,True,7,Positive,21,4,25
211820,True,8,Very Positive,37306,4140,41446
211880,True,0,No user reviews,0,0,0
211900,True,8,Very Positive,189,40,229
211940,True,0,No user reviews,0,0,0
211954,True,0,No user reviews,0,0,0
211970,True,5,Mixed,52,54,106
211990,True,0,1 user reviews,0,1,1
211991,True,0,No user reviews,0,0,0
211992,True,0,No user reviews,0,0,0
211994,True,0,No user reviews,0,0,0
212010,True,5,Mixed,269,135,404
212030,True,6,Mostly Positive,232,61,293
212041,True,0,3 user reviews,3,0,3
212050,True,8,Very Positive,240,26,266
212070,True,5,Mixed,54,32,86
212090,True,0,No user reviews,0,0,0
212110,True,6,Mostly Positive,33,9,42
212140,True,0,No user reviews,0,0,0
212160,True,4,Mostly Negative,16,47,63
212170,True,0,3 user reviews,3,0,3
212171,True,0,6 user reviews,6,0,6
212172,True,0,4 user reviews,3,1,4
212180,True,0,No user reviews,0,0,0
212200,True,5,Mixed,20,19,39
212210,True,0,7 user reviews,4,3,7
212211,True,0,No user reviews,0,0,0
212220,True,0,No user reviews,0,0,0
212240,True,0,No user reviews,0,0,0
212301,True,5,Mixed,81,77,158
212330,True,0,No user reviews,0,0,0
212350,True,0,No user reviews,0,0,0
212370,True,0,No user reviews,0,0,0
212390,True,0,5 user reviews,2,3,5
212410,True,5,Mixed,84,81,165
212432,True,0,No user reviews,0,0,0
212433,True,0,No user reviews,0,0,0
212434,True,0,No user reviews,0,0,0
212435,True,0,No user reviews,0,0,0
212436,True,0,No user reviews,0,0,0
212437,True,0,No user reviews,0,0,0
212438,True,0,No user reviews,0,0,0
212439,True,0,No user reviews,0,0,0
212440,True,0,No user reviews,0,0,0
212441,True,0,No user reviews,0,0,0
212442,True,0,No user reviews,0,0,0
212443,True,0,No user reviews,0,0,0
212444,True,0,No user reviews,0,0,0
212445,True,0,No user reviews,0,0,0
212446,True,0,No user reviews,0,0,0
212447,True,0,No user reviews,0,0,0
212448,True,0,No user reviews,0,0,0
212449,True,0,No user reviews,0,0,0
212450,True,0,No user reviews,0,0,0
212480,True,8,Very Positive,4108,255,4363
212500,True,8,Very Positive,79,14,93
212541,True,0,No user reviews,0,0,0
212542,True,0,No user reviews,0,0,0
212560,True,0,No user reviews,0,0,0
212580,True,5,Mixed,226,171,397
212601,True,0,1 user reviews,0,1,1
212602,True,0,No user reviews,0,0,0
212603,True,0,4 user reviews,4,0,4
212604,True,0,No user reviews,0,0,0
212630,True,5,Mixed,904,567,1471
212671,True,0,2 user reviews,1,1,2
212672,True,0,8 user reviews,6,2,8
212673,True,0,3 user reviews,1,2,3
212675,True,0,No user reviews,0,0,0
212676,True,0,No user reviews,0,0,0
212677,True,0,No user reviews,0,0,0
212679,True,0,No user reviews,0,0,0
212680,True,9,Overwhelmingly Positive,31658,1240,32898
212700,True,5,Mixed,9,10,19
212710,True,0,No user reviews,0,0,0
212720,True,0,No user reviews,0,0,0
212740,True,5,Mixed,94,43,137
212751,True,0,No user reviews,0,0,0
212752,True,0,No user reviews,0,0,0
212753,True,0,No user reviews,0,0,0
212780,True,5,Mixed,66,51,117
212800,True,6,Mostly Positive,18,7,25
212840,True,0,No user reviews,0,0,0
212860,True,0,No user reviews,0,0,0
212890,True,0,No user reviews,0,0,0
212891,True,0,No user reviews,0,0,0
212892,True,0,No user reviews,0,0,0
212893,True,6,Mostly Positive,46,19,65
212894,True,8,Very Positive,162,7,169
212910,True,9,Overwhelmingly Positive,1915,68,1983
213030,True,8,Very Positive,321,37,358
213040,True,0,No user reviews,0,0,0
213050,True,0,No user reviews,0,0,0
213151,True,0,No user reviews,0,0,0
213152,True,0,No user reviews,0,0,0
213174,True,0,No user reviews,0,0,0
213176,True,0,No user reviews,0,0,0
213178,True,0,1 user reviews,1,0,1
213179,True,7,Positive,8,2,10
213194,True,0,1 user reviews,1,0,1
213195,True,0,8 user reviews,5,3,8
213196,True,0,No user reviews,0,0,0
213197,True,7,Positive,14,3,17
213198,True,0,6 user reviews,4,2,6
213199,True,0,No user reviews,0,0,0
213210,True,8,Very Positive,205,38,243
213230,True,8,Very Positive,211,23,234
213231,True,0,No user reviews,0,0,0
213250,True,5,Mixed,100,139,239
213311,True,0,6 user reviews,3,3,6
213312,True,0,7 user reviews,5,2,7
213330,True,8,Very Positive,564,70,634
213350,True,5,Mixed,27,36,63
213370,True,6,Mostly Positive,23,7,30
213390,True,0,No user reviews,0,0,0
213410,True,0,No user reviews,0,0,0
213430,True,0,No user reviews,0,0,0
213450,True,0,No user reviews,0,0,0
213470,True,0,No user reviews,0,0,0
213490,True,0,No user reviews,0,0,0
213530,True,0,No user reviews,0,0,0
213550,True,0,1 user reviews,1,0,1
213570,True,0,No user reviews,0,0,0
213590,True,0,No user reviews,0,0,0
213610,True,8,Very Positive,4604,706,5310
213630,True,0,No user reviews,0,0,0
213650,True,0,6 user reviews,4,2,6
213661,True,0,1 user reviews,1,0,1
213662,True,0,2 user reviews,2,0,2
213663,True,0,1 user reviews,1,0,1
213664,True,0,1 user reviews,1,0,1
213665,True,0,1 user reviews,1,0,1
213670,True,9,Overwhelmingly Positive,17062,543,17605
213780,True,6,Mostly Positive,74,25,99
213781,True,0,No user reviews,0,0,0
213850,True,8,Very Positive,1818,427,2245
213860,True,0,No user reviews,0,0,0
213870,True,0,No user reviews,0,0,0
213890,True,0,1 user reviews,0,1,1
213891,True,0,No user reviews,0,0,0
213892,True,0,No user reviews,0,0,0
213893,True,0,No user reviews,0,0,0
213894,True,0,No user reviews,0,0,0
213895,True,0,No user reviews,0,0,0
213896,True,0,3 user reviews,3,0,3
213897,True,0,No user reviews,0,0,0
213898,True,0,No user reviews,0,0,0
213899,True,0,No user reviews,0,0,0
213900,True,0,No user reviews,0,0,0
213901,True,0,No user reviews,0,0,0
213903,True,0,No user reviews,0,0,0
213904,True,0,No user reviews,0,0,0
213905,True,0,No user reviews,0,0,0
213906,True,0,1 user reviews,0,1,1
213907,True,0,1 user reviews,0,1,1
213908,True,0,No user reviews,0,0,0
213909,True,0,No user reviews,0,0,0
213910,True,0,No user reviews,0,0,0
213930,True,0,1 user reviews,1,0,1
214050,True,0,No user reviews,0,0,0
214070,True,0,No user reviews,0,0,0
214090,True,0,No user reviews,0,0,0
214100,True,5,Mixed,17,18,35
214130,True,5,Mixed,59,36,95
214150,True,5,Mixed,30,42,72
214170,True,8,Very Positive,775,128,903
214230,True,5,Mixed,63,36,99
214250,True,5,Mixed,619,423,1042
214270,True,0,6 user reviews,5,1,6
214291,True,0,No user reviews,0,0,0
214292,True,0,No user reviews,0,0,0
214310,True,6,Mostly Positive,23,9,32
214320,True,5,Mixed,10,10,20
214330,True,0,No user reviews,0,0,0
214331,True,0,No user reviews,0,0,0
214340,True,8,Very Positive,1762,431,2193
214360,True,5,Mixed,463,205,668
214400,True,0,4 user reviews,4,0,4
214420,True,8,Very Positive,534,95,629
214490,True,8,Very Positive,14033,1311,15344
214510,True,8,Very Positive,1481,218,1699
214530,True,0,2 user reviews,1,1,2
214531,True,0,No user reviews,0,0,0
214550,True,8,Very Positive,47,9,56
214560,True,9,Overwhelmingly Positive,6590,221,6811
214570,True,8,Very Positive,53,5,58
214590,True,8,Very Positive,300,28,328
214610,True,8,Very Positive,235,29,264
214630,True,5,Mixed,115,70,185
214640,True,0,No user reviews,0,0,0
214643,True,0,2 user reviews,2,0,2
214644,True,0,No user reviews,0,0,0
214645,True,0,No user reviews,0,0,0
214646,True,0,No user reviews,0,0,0
214647,True,0,No user reviews,0,0,0
214648,True,0,No user reviews,0,0,0
214649,True,0,6 user reviews,6,0,6
214652,True,0,No user reviews,0,0,0
214653,True,0,No user reviews,0,0,0
214700,True,5,Mixed,609,329,938
214710,True,0,No user reviews,0,0,0
214730,True,8,Very Positive,574,96,670
214770,True,8,Very Positive,1597,126,1723
214790,True,8,Very Positive,464,67,531
214810,True,0,No user reviews,0,0,0
214820,True,0,No user reviews,0,0,0
214830,True,8,Very Positive,541,68,609
214850,True,8,Very Positive,93,13,106
214870,True,5,Mixed,486,209,695
214910,True,4,Mostly Negative,41,62,103
214929,True,0,No user reviews,0,0,0
214930,True,5,Mixed,69,40,109
214931,True,6,Mostly Positive,370,117,487
214932,True,8,Very Positive,481,102,583
214933,True,8,Very Positive,208,31,239
214934,True,0,No user reviews,0,0,0
214935,True,0,No user reviews,0,0,0
214936,True,0,No user reviews,0,0,0
214937,True,0,No user reviews,0,0,0
214950,True,6,Mostly Positive,15198,3879,19077
214970,True,8,Very Positive,416,44,460
214980,True,0,No user reviews,0,0,0
214981,True,0,No user reviews,0,0,0
214982,True,0,No user reviews,0,0,0
214983,True,0,No user reviews,0,0,0
214984,True,0,No user reviews,0,0,0
214985,True,0,No user reviews,0,0,0
214986,True,0,1 user reviews,1,0,1
214987,True,0,6 user reviews,2,4,6
214988,True,0,7 user reviews,2,5,7
214990,True,0,5 user reviews,3,2,5
214991,True,5,Mixed,8,4,12
215000,True,0,3 user reviews,3,0,3
215001,True,7,Positive,19,4,23
215002,True,0,9 user reviews,5,4,9
215003,True,7,Positive,12,1,13
215004,True,0,7 user reviews,6,1,7
215005,True,6,Mostly Positive,12,4,16
215020,True,0,No user reviews,0,0,0
215060,True,0,No user reviews,0,0,0
215080,True,5,Mixed,32,22,54
215100,True,5,Mixed,7,4,11
215120,True,0,6 user reviews,5,1,6
215160,True,8,Very Positive,683,86,769
215180,True,0,No user reviews,0,0,0
215200,True,0,5 user reviews,3,2,5
215220,True,0,No user reviews,0,0,0
215240,True,0,2 user reviews,0,2,2
215241,True,0,4 user reviews,1,3,4
215242,True,0,8 user reviews,3,5,8
215243,True,0,2 user reviews,1,1,2
215244,True,0,2 user reviews,0,2,2
215245,True,0,6 user reviews,0,6,6
215246,True,0,5 user reviews,1,4,5
215247,True,0,5 user reviews,3,2,5
215248,True,0,3 user reviews,2,1,3
215249,True,0,3 user reviews,0,3,3
215250,True,0,No user reviews,0,0,0
215251,True,0,3 user reviews,1,2,3
215252,True,0,No user reviews,0,0,0
215253,True,0,4 user reviews,2,2,4
215254,True,0,No user reviews,0,0,0
215255,True,0,3 user reviews,1,2,3
215256,True,5,Mixed,21,12,33
215257,True,5,Mixed,11,5,16
215258,True,7,Positive,11,2,13
215259,True,0,4 user reviews,1,3,4
215261,True,0,No user reviews,0,0,0
215263,True,0,No user reviews,0,0,0
215280,True,6,Mostly Positive,2280,960,3240
215291,True,0,No user reviews,0,0,0
215301,True,0,No user reviews,0,0,0
215302,True,0,No user reviews,0,0,0
215303,True,0,No user reviews,0,0,0
215304,True,0,No user reviews,0,0,0
215305,True,0,No user reviews,0,0,0
215306,True,0,No user reviews,0,0,0
215307,True,0,No user reviews,0,0,0
215308,True,0,No user reviews,0,0,0
215309,True,0,No user reviews,0,0,0
215310,True,0,No user reviews,0,0,0
215311,True,0,No user reviews,0,0,0
215312,True,0,No user reviews,0,0,0
215314,True,0,No user reviews,0,0,0
215315,True,0,No user reviews,0,0,0
215316,True,0,No user reviews,0,0,0
215317,True,0,No user reviews,0,0,0
215318,True,0,No user reviews,0,0,0
215319,True,0,No user reviews,0,0,0
215320,True,0,No user reviews,0,0,0
215321,True,0,No user reviews,0,0,0
215350,True,0,No user reviews,0,0,0
215360,True,0,No user reviews,0,0,0
215370,True,0,5 user reviews,4,1,5
215371,True,0,3 user reviews,2,1,3
215373,True,0,4 user reviews,3,1,4
215374,True,0,8 user reviews,8,0,8
215390,True,4,Mostly Negative,4,7,11
215410,True,0,No user reviews,0,0,0
215430,True,0,No user reviews,0,0,0
215431,True,0,No user reviews,0,0,0
215432,True,0,No user reviews,0,0,0
215433,True,0,No user reviews,0,0,0
215434,True,0,No user reviews,0,0,0
215435,True,0,No user reviews,0,0,0
215436,True,0,No user reviews,0,0,0
215450,True,7,Positive,22,0,22
215470,True,6,Mostly Positive,1966,526,2492
215490,True,0,No user reviews,0,0,0
215510,True,6,Mostly Positive,378,148,526
215530,True,8,Very Positive,2016,472,2488
215532,True,0,No user reviews,0,0,0
215533,True,0,4 user reviews,2,2,4
215534,True,6,Mostly Positive,11,4,15
215535,True,7,Positive,14,3,17
215536,True,7,Positive,9,2,11
215537,True,0,No user reviews,0,0,0
215550,True,5,Mixed,30,25,55
215590,True,0,No user reviews,0,0,0
215630,True,5,Mixed,120,61,181
215670,True,6,Mostly Positive,576,245,821
215690,True,8,Very Positive,278,51,329
215710,True,8,Very Positive,119,19,138
215770,True,5,Mixed,10,15,25
215772,True,0,No user reviews,0,0,0
215790,True,4,Mostly Negative,37,142,179
215811,True,0,No user reviews,0,0,0
215812,True,0,1 user reviews,0,1,1
215813,True,0,2 user reviews,1,1,2
215814,True,0,4 user reviews,2,2,4
215815,True,0,3 user reviews,2,1,3
215816,True,0,No user reviews,0,0,0
215817,True,0,1 user reviews,0,1,1
215818,True,0,3 user reviews,0,3,3
215819,True,0,1 user reviews,0,1,1
215820,True,0,1 user reviews,0,1,1
215821,True,0,No user reviews,0,0,0
215822,True,0,No user reviews,0,0,0
215823,True,0,No user reviews,0,0,0
215824,True,0,6 user reviews,3,3,6
215825,True,0,1 user reviews,1,0,1
215826,True,0,4 user reviews,3,1,4
215827,True,0,4 user reviews,3,1,4
215830,True,8,Very Positive,139,30,169
215850,True,0,3 user reviews,2,1,3
215851,True,0,No user reviews,0,0,0
215852,True,0,No user reviews,0,0,0
215853,True,0,No user reviews,0,0,0
215854,True,0,No user reviews,0,0,0
215855,True,0,No user reviews,0,0,0
215856,True,0,No user reviews,0,0,0
215857,True,0,No user reviews,0,0,0
215858,True,0,No user reviews,0,0,0
215859,True,0,No user reviews,0,0,0
215860,True,0,No user reviews,0,0,0
215870,True,0,No user reviews,0,0,0
215919,True,0,No user reviews,0,0,0
215920,True,0,No user reviews,0,0,0
215923,True,0,1 user reviews,0,1,1
215924,True,0,No user reviews,0,0,0
215930,True,5,Mixed,148,92,240
215970,True,0,6 user reviews,2,4,6
215971,True,0,3 user reviews,1,2,3
215972,True,0,2 user reviews,2,0,2
215990,True,0,No user reviews,0,0,0
215991,True,0,No user reviews,0,0,0
215992,True,0,3 user reviews,3,0,3
215993,True,0,1 user reviews,1,0,1
215994,True,0,No user reviews,0,0,0
215995,True,0,No user reviews,0,0,0
215996,True,0,No user reviews,0,0,0
215997,True,0,1 user reviews,1,0,1
215998,True,0,3 user reviews,2,1,3
216010,True,0,No user reviews,0,0,0
216090,True,8,Very Positive,181,12,193
216110,True,6,Mostly Positive,217,65,282
216130,True,4,Mostly Negative,19,68,87
216150,True,5,Mixed,51,37,88
216170,True,0,No user reviews,0,0,0
216172,True,7,Positive,10,1,11
216173,True,0,7 user reviews,6,1,7
216174,True,7,Positive,9,2,11
216210,True,5,Mixed,21,17,38
216250,True,6,Mostly Positive,1577,407,1984
216260,True,8,Very Positive,357,49,406
216280,True,0,No user reviews,0,0,0
216290,True,8,Very Positive,108,9,117
216310,True,0,No user reviews,0,0,0
216330,True,0,No user reviews,0,0,0
216332,True,0,3 user reviews,1,2,3
216333,True,0,9 user reviews,7,2,9
216334,True,0,2 user reviews,0,2,2
216335,True,0,4 user reviews,1,3,4
216370,True,0,No user reviews,0,0,0
216390,True,5,Mixed,129,67,196
216411,True,0,8 user reviews,5,3,8
216412,True,0,6 user reviews,5,1,6
216413,True,0,7 user reviews,4,3,7
216414,True,7,Positive,9,1,10
216415,True,0,7 user reviews,5,2,7
216416,True,0,5 user reviews,4,1,5
216417,True,0,5 user reviews,4,1,5
216418,True,0,7 user reviews,5,2,7
216419,True,0,9 user reviews,7,2,9
216420,True,7,Positive,9,1,10
216421,True,0,8 user reviews,6,2,8
216430,True,0,3 user reviews,3,0,3
216431,True,0,2 user reviews,2,0,2
216432,True,0,1 user reviews,1,0,1
216433,True,0,1 user reviews,1,0,1
216434,True,0,1 user reviews,1,0,1
216435,True,0,No user reviews,0,0,0
216436,True,0,1 user reviews,1,0,1
216437,True,0,1 user reviews,1,0,1
216438,True,0,No user reviews,0,0,0
216439,True,0,No user reviews,0,0,0
216440,True,0,No user reviews,0,0,0
216441,True,0,3 user reviews,2,1,3
216442,True,0,No user reviews,0,0,0
216443,True,0,No user reviews,0,0,0
216444,True,0,2 user reviews,1,1,2
216445,True,0,1 user reviews,1,0,1
216446,True,0,No user reviews,0,0,0
216447,True,0,No user reviews,0,0,0
216448,True,0,1 user reviews,0,1,1
216449,True,0,No user reviews,0,0,0
216450,True,0,No user reviews,0,0,0
216451,True,0,No user reviews,0,0,0
216452,True,0,4 user reviews,4,0,4
216453,True,0,No user reviews,0,0,0
216454,True,0,No user reviews,0,0,0
216455,True,0,No user reviews,0,0,0
216456,True,0,No user reviews,0,0,0
216457,True,0,No user reviews,0,0,0
216458,True,0,No user reviews,0,0,0
216459,True,0,No user reviews,0,0,0
216460,True,0,No user reviews,0,0,0
216461,True,0,No user reviews,0,0,0
216462,True,0,2 user reviews,2,0,2
216463,True,0,No user reviews,0,0,0
216464,True,0,2 user reviews,2,0,2
216465,True,0,1 user reviews,1,0,1
216466,True,0,No user reviews,0,0,0
216467,True,0,No user reviews,0,0,0
216468,True,0,2 user reviews,2,0,2
216469,True,0,No user reviews,0,0,0
216530,True,0,No user reviews,0,0,0
216570,True,0,No user reviews,0,0,0
216610,True,7,Positive,12,0,12
216630,True,0,No user reviews,0,0,0
216631,True,0,No user reviews,0,0,0
216632,True,0,No user reviews,0,0,0
216633,True,0,No user reviews,0,0,0
216670,True,7,Positive,31,1,32
216690,True,0,No user reviews,0,0,0
216840,True,0,No user reviews,0,0,0
216850,True,0,No user reviews,0,0,0
216890,True,6,Mostly Positive,679,188,867
216910,True,6,Mostly Positive,399,159,558
216930,True,0,4 user reviews,4,0,4
216938,True,0,No user reviews,0,0,0
217060,True,5,Mixed,37,48,85
217100,True,5,Mixed,166,203,369
217120,True,8,Very Positive,47,4,51
217140,True,5,Mixed,841,368,1209
217160,True,0,No user reviews,0,0,0
217200,True,8,Very Positive,1594,114,1708
217221,True,0,No user reviews,0,0,0
217222,True,0,No user reviews,0,0,0
217270,True,6,Mostly Positive,48,14,62
217290,True,8,Very Positive,126,22,148
217300,True,0,2 user reviews,2,0,2
217350,True,0,1 user reviews,1,0,1
217370,True,7,Positive,27,2,29
217390,True,0,2 user reviews,1,1,2
217410,True,0,5 user reviews,2,3,5
217430,True,0,No user reviews,0,0,0
217470,True,0,No user reviews,0,0,0
217490,True,0,No user reviews,0,0,0
217507,True,0,No user reviews,0,0,0
217508,True,0,No user reviews,0,0,0
217510,True,0,No user reviews,0,0,0
217550,True,0,No user reviews,0,0,0
217570,True,0,No user reviews,0,0,0
217590,True,0,No user reviews,0,0,0
217610,True,0,No user reviews,0,0,0
217630,True,0,No user reviews,0,0,0
217650,True,0,No user reviews,0,0,0
217690,True,5,Mixed,316,217,533
217750,True,5,Mixed,9,7,16
217760,True,0,No user reviews,0,0,0
217780,True,0,No user reviews,0,0,0
217781,True,0,No user reviews,0,0,0
217790,True,6,Mostly Positive,129,53,182
217810,True,0,4 user reviews,4,0,4
217811,True,0,No user reviews,0,0,0
217830,True,0,No user reviews,0,0,0
217860,True,5,Mixed,72,65,137
217900,True,8,Very Positive,137,24,161
217920,True,5,Mixed,279,123,402
217940,True,0,No user reviews,0,0,0
217941,True,0,2 user reviews,2,0,2
217942,True,0,No user reviews,0,0,0
217961,True,0,8 user reviews,8,0,8
217962,True,7,Positive,10,0,10
217980,True,9,Overwhelmingly Positive,695,21,716
218020,True,7,Positive,42,6,48
218040,True,5,Mixed,34,32,66
218060,True,8,Very Positive,913,61,974
218064,True,0,No user reviews,0,0,0
218065,True,7,Positive,16,0,16
218069,True,0,No user reviews,0,0,0
218090,True,6,Mostly Positive,358,97,455
218100,True,0,7 user reviews,6,1,7
218110,True,0,No user reviews,0,0,0
218130,True,5,Mixed,141,105,246
218170,True,0,No user reviews,0,0,0
218180,True,0,No user reviews,0,0,0
218210,True,0,No user reviews,0,0,0
218230,True,6,Mostly Positive,270,93,363
218240,True,7,Positive,18,1,19
218241,True,7,Positive,15,1,16
218242,True,7,Positive,21,1,22
218290,True,0,1 user reviews,1,0,1
218330,True,0,No user reviews,0,0,0
218350,True,0,No user reviews,0,0,0
218410,True,9,Overwhelmingly Positive,1572,54,1626
218450,True,0,No user reviews,0,0,0
218455,True,0,No user reviews,0,0,0
218461,True,0,1 user reviews,1,0,1
218463,True,0,No user reviews,0,0,0
218470,True,0,No user reviews,0,0,0
218510,True,5,Mixed,79,63,142
218550,True,8,Very Positive,692,52,744
218560,True,4,Mostly Negative,56,128,184
218571,True,0,No user reviews,0,0,0
218572,True,0,No user reviews,0,0,0
218573,True,0,No user reviews,0,0,0
218574,True,0,No user reviews,0,0,0
218579,True,0,No user reviews,0,0,0
218582,True,0,No user reviews,0,0,0
218583,True,0,No user reviews,0,0,0
218585,True,0,No user reviews,0,0,0
218620,True,8,Very Positive,87618,18413,106031
218630,True,0,No user reviews,0,0,0
218640,True,6,Mostly Positive,1617,458,2075
218660,True,6,Mostly Positive,34,9,43
218680,True,8,Very Positive,3318,300,3618
218700,True,6,Mostly Positive,18,6,24
218740,True,6,Mostly Positive,103,44,147
218760,True,8,Very Positive,122,13,135
218780,True,0,5 user reviews,3,2,5
218781,True,0,No user reviews,0,0,0
218784,True,4,Mostly Negative,3,10,13
218785,True,7,Positive,21,0,21
218786,True,7,Positive,18,0,18
218800,True,0,No user reviews,0,0,0
218820,True,6,Mostly Positive,580,196,776
218841,True,0,No user reviews,0,0,0
218842,True,0,No user reviews,0,0,0
218843,True,0,2 user reviews,2,0,2
218844,True,0,1 user reviews,1,0,1
218980,True,2,Very Negative,14,76,90
219030,True,0,No user reviews,0,0,0
219070,True,0,4 user reviews,1,3,4
219091,True,0,No user reviews,0,0,0
219092,True,8,Very Positive,58,9,67
219093,True,0,No user reviews,0,0,0
219094,True,0,No user reviews,0,0,0
219095,True,0,No user reviews,0,0,0
219096,True,0,No user reviews,0,0,0
219097,True,8,Very Positive,45,10,55
219098,True,8,Very Positive,55,3,58
219099,True,0,No user reviews,0,0,0
219101,True,8,Very Positive,47,4,51
219102,True,0,No user reviews,0,0,0
219103,True,8,Very Positive,74,3,77
219104,True,0,No user reviews,0,0,0
219130,True,0,1 user reviews,1,0,1
219131,True,0,1 user reviews,1,0,1
219133,True,0,No user reviews,0,0,0
219134,True,0,No user reviews,0,0,0
219135,True,0,No user reviews,0,0,0
219136,True,0,2 user reviews,1,1,2
219150,True,9,Overwhelmingly Positive,23535,695,24230
219152,True,8,Very Positive,87,5,92
219190,True,8,Very Positive,255,38,293
219200,True,8,Very Positive,139,25,164
219210,True,0,No user reviews,0,0,0
219212,True,0,No user reviews,0,0,0
219240,True,0,No user reviews,0,0,0
219340,True,0,1 user reviews,0,1,1
219360,True,0,No user reviews,0,0,0
219380,True,0,No user reviews,0,0,0
219440,True,6,Mostly Positive,13,4,17
219441,True,0,5 user reviews,3,2,5
219442,True,0,6 user reviews,4,2,6
219443,True,5,Mixed,25,11,36
219444,True,0,7 user reviews,6,1,7
219445,True,5,Mixed,6,5,11
219446,True,7,Positive,10,1,11
219447,True,4,Mostly Negative,5,8,13
219520,True,0,No user reviews,0,0,0
219540,True,0,No user reviews,0,0,0
219600,True,8,Very Positive,170,40,210
219622,True,0,No user reviews,0,0,0
219623,True,0,No user reviews,0,0,0
219624,True,0,No user reviews,0,0,0
219625,True,0,No user reviews,0,0,0
219626,True,0,No user reviews,0,0,0
219627,True,0,No user reviews,0,0,0
219628,True,0,No user reviews,0,0,0
219629,True,0,No user reviews,0,0,0
219630,True,0,No user reviews,0,0,0
219640,True,8,Very Positive,18010,4126,22136
219660,True,0,No user reviews,0,0,0
219680,True,8,Very Positive,829,206,1035
219700,True,0,1 user reviews,0,1,1
219720,True,0,No user reviews,0,0,0
219740,True,9,Overwhelmingly Positive,25294,837,26131
219750,True,8,Very Positive,51,4,55
219760,True,5,Mixed,72,78,150
219780,True,6,Mostly Positive,883,250,1133
219800,True,5,Mixed,26,13,39
219830,True,8,Very Positive,1484,340,1824
219850,True,0,No user reviews,0,0,0
219870,True,0,No user reviews,0,0,0
219890,True,9,Overwhelmingly Positive,7712,366,8078
219910,True,8,Very Positive,513,89,602
219950,True,8,Very Positive,364,48,412
219990,True,8,Very Positive,19582,1057,20639
220050,True,5,Mixed,147,212,359
220070,True,0,No user reviews,0,0,0
220090,True,8,Very Positive,396,60,456
220120,True,0,No user reviews,0,0,0
220121,True,0,No user reviews,0,0,0
220140,True,0,No user reviews,0,0,0
220159,True,0,No user reviews,0,0,0
220160,True,6,Mostly Positive,849,297,1146
220180,True,0,No user reviews,0,0,0
220200,True,8,Very Positive,42460,2601,45061
220240,True,8,Very Positive,20043,3209,23252
220260,True,8,Very Positive,1393,174,1567
220280,True,0,No user reviews,0,0,0
220285,True,0,2 user reviews,2,0,2
220400,True,0,No user reviews,0,0,0
220420,True,7,Positive,19,3,22
220440,True,8,Very Positive,3666,316,3982
220460,True,8,Very Positive,339,63,402
220480,True,0,No user reviews,0,0,0
220500,True,0,No user reviews,0,0,0
220600,True,0,No user reviews,0,0,0
220620,True,0,No user reviews,0,0,0
220640,True,0,No user reviews,0,0,0
220660,True,5,Mixed,378,561,939
220680,True,0,No user reviews,0,0,0
220700,True,8,Very Positive,1715,106,1821
220720,True,0,No user reviews,0,0,0
220740,True,8,Very Positive,398,71,469
220760,True,8,Very Positive,582,92,674
220780,True,8,Very Positive,2843,177,3020
220800,True,0,No user reviews,0,0,0
220801,True,0,No user reviews,0,0,0
220802,True,0,No user reviews,0,0,0
220803,True,0,No user reviews,0,0,0
220804,True,0,No user reviews,0,0,0
220805,True,0,No user reviews,0,0,0
220806,True,0,No user reviews,0,0,0
220807,True,0,No user reviews,0,0,0
220808,True,0,No user reviews,0,0,0
220809,True,0,No user reviews,0,0,0
220810,True,0,No user reviews,0,0,0
220811,True,0,1 user reviews,0,1,1
220812,True,0,1 user reviews,0,1,1
220813,True,0,2 user reviews,1,1,2
220820,True,8,Very Positive,690,136,826
220822,True,0,5 user reviews,5,0,5
220823,True,0,9 user reviews,8,1,9
220824,True,0,7 user reviews,7,0,7
220825,True,0,6 user reviews,6,0,6
220840,True,0,No user reviews,0,0,0
220860,True,8,Very Positive,1060,201,1261
220900,True,7,Positive,14,3,17
220960,True,0,8 user reviews,7,1,8
220980,True,6,Mostly Positive,103,41,144
221000,True,0,No user reviews,0,0,0
221001,True,8,Very Positive,55,5,60
221002,True,0,No user reviews,0,0,0
221020,True,4,Mostly Negative,476,1440,1916
221030,True,0,No user reviews,0,0,0
221040,True,6,Mostly Positive,3708,1445,5153
221080,True,0,No user reviews,0,0,0
221090,True,0,No user reviews,0,0,0
221091,True,0,No user reviews,0,0,0
221092,True,0,No user reviews,0,0,0
221093,True,0,No user reviews,0,0,0
221094,True,0,No user reviews,0,0,0
221095,True,0,No user reviews,0,0,0
221100,True,5,Mixed,65946,40739,106685
221120,True,0,No user reviews,0,0,0
221161,True,0,9 user reviews,4,5,9
221162,True,5,Mixed,10,9,19
221165,True,6,Mostly Positive,10,3,13
221166,True,6,Mostly Positive,8,3,11
221167,True,0,8 user reviews,7,1,8
221168,True,6,Mostly Positive,10,4,14
221169,True,0,1 user reviews,0,1,1
221180,True,8,Very Positive,224,20,244
221200,True,0,No user reviews,0,0,0
221220,True,0,No user reviews,0,0,0
221260,True,9,Overwhelmingly Positive,3089,161,3250
221340,True,6,Mostly Positive,19,8,27
221360,True,0,No user reviews,0,0,0
221380,True,8,Very Positive,28256,1597,29853
221410,True,0,No user reviews,0,0,0
221430,True,7,Positive,12,0,12
221445,True,0,No user reviews,0,0,0
221450,True,0,No user reviews,0,0,0
221500,True,0,No user reviews,0,0,0
221540,True,8,Very Positive,982,212,1194
221560,True,5,Mixed,75,90,165
221620,True,0,No user reviews,0,0,0
221640,True,9,Overwhelmingly Positive,10232,286,10518
221660,True,0,No user reviews,0,0,0
221680,True,8,Very Positive,5139,526,5665
221770,True,0,No user reviews,0,0,0
221790,True,0,No user reviews,0,0,0
221810,True,8,Very Positive,846,170,1016
221825,True,0,No user reviews,0,0,0
221829,True,0,3 user reviews,3,0,3
221830,True,8,Very Positive,122,30,152
221850,True,0,No user reviews,0,0,0
221870,True,0,No user reviews,0,0,0
221910,True,8,Very Positive,21995,1924,23919
221931,True,0,No user reviews,0,0,0
221980,True,0,No user reviews,0,0,0
222021,True,6,Mostly Positive,21,8,29
222041,True,0,No user reviews,0,0,0
222042,True,0,No user reviews,0,0,0
222043,True,0,No user reviews,0,0,0
222044,True,0,2 user reviews,2,0,2
222045,True,0,No user reviews,0,0,0
222046,True,0,No user reviews,0,0,0
222047,True,0,No user reviews,0,0,0
222048,True,0,No user reviews,0,0,0
222049,True,0,No user reviews,0,0,0
222050,True,0,No user reviews,0,0,0
222051,True,0,1 user reviews,1,0,1
222052,True,0,No user reviews,0,0,0
222053,True,0,No user reviews,0,0,0
222054,True,0,No user reviews,0,0,0
222055,True,0,1 user reviews,1,0,1
222056,True,0,No user reviews,0,0,0
222057,True,0,4 user reviews,4,0,4
222058,True,0,No user reviews,0,0,0
222059,True,0,No user reviews,0,0,0
222060,True,0,No user reviews,0,0,0
222061,True,0,No user reviews,0,0,0
222062,True,0,No user reviews,0,0,0
222063,True,0,No user reviews,0,0,0
222064,True,0,1 user reviews,1,0,1
222065,True,0,No user reviews,0,0,0
222066,True,0,No user reviews,0,0,0
222067,True,0,No user reviews,0,0,0
222068,True,0,No user reviews,0,0,0
222069,True,0,No user reviews,0,0,0
222070,True,0,No user reviews,0,0,0
222071,True,0,No user reviews,0,0,0
222072,True,0,No user reviews,0,0,0
222073,True,0,4 user reviews,4,0,4
222074,True,0,No user reviews,0,0,0
222075,True,0,1 user reviews,1,0,1
222076,True,0,No user reviews,0,0,0
222077,True,0,No user reviews,0,0,0
222078,True,0,No user reviews,0,0,0
222079,True,0,No user reviews,0,0,0
222080,True,0,No user reviews,0,0,0
222081,True,0,1 user reviews,0,1,1
222082,True,0,No user reviews,0,0,0
222083,True,0,No user reviews,0,0,0
222084,True,0,No user reviews,0,0,0
222085,True,0,No user reviews,0,0,0
222086,True,0,No user reviews,0,0,0
222087,True,0,No user reviews,0,0,0
222088,True,0,No user reviews,0,0,0
222089,True,0,No user reviews,0,0,0
222090,True,0,1 user reviews,1,0,1
222091,True,0,No user reviews,0,0,0
222092,True,0,1 user reviews,1,0,1
222093,True,0,1 user reviews,1,0,1
222094,True,0,No user reviews,0,0,0
222095,True,0,1 user reviews,0,1,1
222096,True,0,No user reviews,0,0,0
222097,True,0,No user reviews,0,0,0
222098,True,0,No user reviews,0,0,0
222099,True,0,No user reviews,0,0,0
222100,True,0,1 user reviews,1,0,1
222101,True,0,No user reviews,0,0,0
222102,True,0,No user reviews,0,0,0
222103,True,0,No user reviews,0,0,0
222104,True,0,No user reviews,0,0,0
222105,True,0,No user reviews,0,0,0
222106,True,0,No user reviews,0,0,0
222107,True,0,No user reviews,0,0,0
222108,True,0,No user reviews,0,0,0
222109,True,0,No user reviews,0,0,0
222110,True,0,No user reviews,0,0,0
222111,True,0,No user reviews,0,0,0
222112,True,0,No user reviews,0,0,0
222113,True,0,4 user reviews,3,1,4
222114,True,0,1 user reviews,1,0,1
222115,True,0,No user reviews,0,0,0
222116,True,0,No user reviews,0,0,0
222117,True,0,No user reviews,0,0,0
222118,True,0,No user reviews,0,0,0
222119,True,0,No user reviews,0,0,0
222120,True,0,No user reviews,0,0,0
222121,True,0,No user reviews,0,0,0
222122,True,0,2 user reviews,1,1,2
222137,True,0,No user reviews,0,0,0
222138,True,0,No user reviews,0,0,0
222139,True,0,No user reviews,0,0,0
222140,True,5,Mixed,139,60,199
222160,True,5,Mixed,61,45,106
222180,True,0,9 user reviews,5,4,9
222221,True,0,3 user reviews,3,0,3
222222,True,0,4 user reviews,3,1,4
222223,True,0,2 user reviews,2,0,2
222224,True,0,No user reviews,0,0,0
222225,True,0,No user reviews,0,0,0
222240,True,0,No user reviews,0,0,0
222280,True,7,Positive,19,3,22
222281,True,0,5 user reviews,2,3,5
222282,True,5,Mixed,7,4,11
222283,True,0,7 user reviews,5,2,7
222284,True,5,Mixed,7,4,11
222285,True,0,4 user reviews,2,2,4
222300,True,0,No user reviews,0,0,0
222320,True,0,No user reviews,0,0,0
222380,True,0,5 user reviews,5,0,5
222400,True,0,No user reviews,0,0,0
222420,True,8,Very Positive,317,33,350
222440,True,8,Very Positive,408,14,422
222480,True,8,Very Positive,1336,272,1608
222500,True,0,No user reviews,0,0,0
222520,True,0,4 user reviews,2,2,4
222532,True,0,1 user reviews,1,0,1
222540,True,0,1 user reviews,1,0,1
222541,True,5,Mixed,9,4,13
222542,True,7,Positive,18,1,19
222543,True,7,Positive,14,0,14
222544,True,7,Positive,11,1,12
222545,True,0,9 user reviews,7,2,9
222546,True,0,No user reviews,0,0,0
222547,True,0,4 user reviews,2,2,4
222548,True,0,1 user reviews,1,0,1
222549,True,7,Positive,22,2,24
222550,True,0,3 user reviews,2,1,3
222551,True,7,Positive,10,2,12
222554,True,7,Positive,26,2,28
222555,True,0,6 user reviews,4,2,6
222556,True,0,7 user reviews,5,2,7
222557,True,6,Mostly Positive,41,13,54
222558,True,6,Mostly Positive,18,5,23
222561,True,7,Positive,19,3,22
222562,True,6,Mostly Positive,12,4,16
222564,True,0,7 user reviews,7,0,7
222565,True,0,No user reviews,0,0,0
222566,True,7,Positive,11,0,11
222567,True,7,Positive,19,0,19
222568,True,0,7 user reviews,5,2,7
222569,True,0,3 user reviews,3,0,3
222570,True,0,3 user reviews,2,1,3
222571,True,7,Positive,10,0,10
222573,True,7,Positive,12,0,12
222574,True,0,6 user reviews,5,1,6
222575,True,6,Mostly Positive,15,4,19
222576,True,7,Positive,10,0,10
222577,True,0,8 user reviews,8,0,8
222578,True,0,8 user reviews,6,2,8
222579,True,0,9 user reviews,9,0,9
222580,True,0,5 user reviews,2,3,5
222581,True,7,Positive,11,0,11
222582,True,7,Positive,34,5,39
222583,True,0,5 user reviews,5,0,5
222584,True,7,Positive,19,4,23
222585,True,0,9 user reviews,5,4,9
222586,True,0,9 user reviews,6,3,9
222587,True,0,7 user reviews,6,1,7
222588,True,7,Positive,16,4,20
222589,True,0,3 user reviews,3,0,3
222590,True,7,Positive,14,0,14
222591,True,0,8 user reviews,7,1,8
222593,True,7,Positive,36,9,45
222594,True,0,3 user reviews,3,0,3
222595,True,0,4 user reviews,4,0,4
222596,True,7,Positive,16,0,16
222597,True,7,Positive,33,3,36
222598,True,0,3 user reviews,3,0,3
222599,True,7,Positive,13,0,13
222601,True,0,3 user reviews,1,2,3
222602,True,0,No user reviews,0,0,0
222603,True,7,Positive,20,4,24
222604,True,7,Positive,13,2,15
222605,True,0,No user reviews,0,0,0
222606,True,0,7 user reviews,7,0,7
222607,True,0,9 user reviews,9,0,9
222608,True,0,9 user reviews,5,4,9
222609,True,0,No user reviews,0,0,0
222610,True,5,Mixed,5,5,10
222611,True,5,Mixed,10,8,18
222612,True,0,8 user reviews,8,0,8
222613,True,7,Positive,30,6,36
222615,True,0,No user reviews,0,0,0
222616,True,0,7 user reviews,5,2,7
222617,True,7,Positive,21,1,22
222618,True,7,Positive,9,2,11
222619,True,7,Positive,11,0,11
222621,True,0,No user reviews,0,0,0
222622,True,5,Mixed,10,9,19
222623,True,4,Mostly Negative,5,20,25
222624,True,0,3 user reviews,2,1,3
222625,True,6,Mostly Positive,28,11,39
222626,True,0,1 user reviews,0,1,1
222627,True,6,Mostly Positive,26,7,33
222628,True,6,Mostly Positive,7,3,10
222629,True,0,6 user reviews,5,1,6
222630,True,0,3 user reviews,3,0,3
222631,True,5,Mixed,11,14,25
222632,True,8,Very Positive,44,6,50
222633,True,6,Mostly Positive,8,3,11
222634,True,0,9 user reviews,9,0,9
222635,True,0,9 user reviews,7,2,9
222636,True,0,3 user reviews,2,1,3
222637,True,0,No user reviews,0,0,0
222638,True,0,No user reviews,0,0,0
222639,True,0,7 user reviews,4,3,7
222640,True,6,Mostly Positive,255,67,322
222660,True,8,Very Positive,127,17,144
222680,True,0,4 user reviews,4,0,4
222700,True,0,No user reviews,0,0,0
222710,True,5,Mixed,81,43,124
222730,True,6,Mostly Positive,1686,480,2166
222750,True,8,Very Positive,1829,250,2079
222801,True,0,3 user reviews,2,1,3
222802,True,0,3 user reviews,1,2,3
222804,True,0,8 user reviews,7,1,8
222805,True,0,6 user reviews,2,4,6
222806,True,0,3 user reviews,2,1,3
222807,True,0,6 user reviews,5,1,6
222820,True,0,7 user reviews,6,1,7
222860,True,0,4 user reviews,3,1,4
222880,True,8,Very Positive,31987,2751,34738
222900,True,8,Very Positive,171,14,185
222940,True,8,Very Positive,1090,122,1212
222960,True,0,No user reviews,0,0,0
222961,True,0,No user reviews,0,0,0
222962,True,0,No user reviews,0,0,0
222970,True,0,No user reviews,0,0,0
222971,True,0,No user reviews,0,0,0
222972,True,0,No user reviews,0,0,0
222973,True,0,No user reviews,0,0,0
222980,True,8,Very Positive,891,147,1038
223000,True,7,Positive,26,1,27
223031,True,0,No user reviews,0,0,0
223032,True,0,No user reviews,0,0,0
223060,True,0,No user reviews,0,0,0
223070,True,0,No user reviews,0,0,0
223090,True,0,No user reviews,0,0,0
223100,True,5,Mixed,2240,1207,3447
223140,True,0,No user reviews,0,0,0
223160,True,0,No user reviews,0,0,0
223180,True,7,Positive,25,3,28
223181,True,0,No user reviews,0,0,0
223220,True,8,Very Positive,378,87,465
223240,True,0,No user reviews,0,0,0
223250,True,0,No user reviews,0,0,0
223260,True,0,No user reviews,0,0,0
223261,True,0,3 user reviews,3,0,3
223262,True,0,2 user reviews,2,0,2
223280,True,7,Positive,27,4,31
223300,True,0,No user reviews,0,0,0
223330,True,5,Mixed,151,116,267
223350,True,0,3 user reviews,2,1,3
223370,True,0,No user reviews,0,0,0
223390,True,5,Mixed,125,82,207
223410,True,5,Mixed,292,126,418
223430,True,4,Mostly Negative,50,125,175
223450,True,8,Very Positive,115,26,141
223470,True,9,Overwhelmingly Positive,17575,716,18291
223490,True,5,Mixed,190,262,452
223510,True,6,Mostly Positive,534,154,688
223530,True,0,No user reviews,0,0,0
223570,True,0,No user reviews,0,0,0
223591,True,0,No user reviews,0,0,0
223592,True,5,Mixed,4,6,10
223593,True,8,Very Positive,107,18,125
223594,True,8,Very Positive,88,10,98
223595,True,5,Mixed,6,4,10
223597,True,6,Mostly Positive,68,20,88
223598,True,4,Mostly Negative,75,123,198
223630,True,5,Mixed,82,44,126
223650,True,0,No user reviews,0,0,0
223670,True,8,Very Positive,492,66,558
223691,True,0,1 user reviews,1,0,1
223710,True,6,Mostly Positive,105,36,141
223730,True,8,Very Positive,130,13,143
223732,True,0,No user reviews,0,0,0
223750,True,8,Very Positive,138,23,161
223770,True,7,Positive,24,4,28
223790,True,7,Positive,28,3,31
223792,True,7,Positive,17,4,21
223793,True,5,Mixed,70,57,127
223810,True,8,Very Positive,870,114,984
223830,True,8,Very Positive,1533,213,1746
223850,True,8,Very Positive,2271,218,2489
223852,True,0,No user reviews,0,0,0
223870,True,7,Positive,42,3,45
223890,True,0,No user reviews,0,0,0
223910,True,0,No user reviews,0,0,0
223920,True,0,No user reviews,0,0,0
224000,True,0,No user reviews,0,0,0
224040,True,6,Mostly Positive,78,31,109
224060,True,8,Very Positive,1395,138,1533
224140,True,5,Mixed,18,11,29
224141,True,5,Mixed,13,12,25
224142,True,5,Mixed,17,11,28
224143,True,6,Mostly Positive,24,10,34
224144,True,5,Mixed,14,14,28
224145,True,5,Mixed,24,11,35
224160,True,5,Mixed,17,13,30
224161,True,6,Mostly Positive,33,12,45
224162,True,5,Mixed,16,12,28
224163,True,5,Mixed,17,12,29
224164,True,5,Mixed,25,11,36
224165,True,5,Mixed,16,12,28
224166,True,5,Mixed,22,13,35
224167,True,5,Mixed,15,13,28
224168,True,5,Mixed,19,14,33
224180,True,6,Mostly Positive,182,49,231
224200,True,8,Very Positive,118,25,143
224240,True,0,No user reviews,0,0,0
224242,True,0,No user reviews,0,0,0
224243,True,0,1 user reviews,1,0,1
224244,True,0,No user reviews,0,0,0
224245,True,0,No user reviews,0,0,0
224260,True,8,Very Positive,262,54,316
224280,True,0,1 user reviews,0,1,1
224300,True,8,Very Positive,257,49,306
224320,True,0,No user reviews,0,0,0
224325,True,0,No user reviews,0,0,0
224326,True,0,No user reviews,0,0,0
224327,True,0,No user reviews,0,0,0
224340,True,4,Mostly Negative,10,17,27
224360,True,0,1 user reviews,0,1,1
224380,True,4,Mostly Negative,8,19,27
224420,True,5,Mixed,154,118,272
224440,True,5,Mixed,865,1174,2039
224460,True,8,Very Positive,1929,231,2160
224462,True,0,4 user reviews,4,0,4
224480,True,8,Very Positive,4327,332,4659
224500,True,6,Mostly Positive,1514,466,1980
224520,True,0,No user reviews,0,0,0
224540,True,5,Mixed,3234,2987,6221
224560,True,0,No user reviews,0,0,0
224580,True,8,Very Positive,149,28,177
224600,True,6,Mostly Positive,1170,468,1638
224610,True,5,Mixed,7,4,11
224611,True,0,No user reviews,0,0,0
224612,True,0,No user reviews,0,0,0
224613,True,0,No user reviews,0,0,0
224614,True,0,No user reviews,0,0,0
224615,True,0,No user reviews,0,0,0
224616,True,0,No user reviews,0,0,0
224620,True,0,No user reviews,0,0,0
224640,True,0,No user reviews,0,0,0
224660,True,0,No user reviews,0,0,0
224740,True,5,Mixed,221,280,501
224760,True,8,Very Positive,4379,438,4817
224780,True,0,No user reviews,0,0,0
224800,True,0,No user reviews,0,0,0
224820,True,9,Overwhelmingly Positive,901,34,935
224860,True,4,Mostly Negative,62,128,190
224900,True,5,Mixed,122,72,194
224920,True,5,Mixed,413,214,627
224940,True,5,Mixed,156,81,237
224960,True,8,Very Positive,857,212,1069
224980,True,8,Very Positive,213,39,252
225000,True,6,Mostly Positive,113,45,158
225020,True,5,Mixed,184,150,334
225060,True,0,No user reviews,0,0,0
225080,True,8,Very Positive,14371,814,15185
225100,True,0,No user reviews,0,0,0
225140,True,9,Overwhelmingly Positive,1791,39,1830
225160,True,8,Very Positive,1077,115,1192
225180,True,5,Mixed,34,15,49
225200,True,4,Mostly Negative,6,10,16
225219,True,0,No user reviews,0,0,0
225260,True,8,Very Positive,3897,266,4163
225270,True,7,Positive,21,3,24
225280,True,8,Very Positive,223,34,257
225300,True,8,Very Positive,435,73,508
225320,True,8,Very Positive,255,48,303
225340,True,8,Very Positive,679,79,758
225360,True,5,Mixed,141,187,328
225370,True,0,No user reviews,0,0,0
225420,True,5,Mixed,282,254,536
225424,True,0,2 user reviews,1,1,2
225428,True,0,No user reviews,0,0,0
225429,True,0,3 user reviews,3,0,3
225430,True,0,1 user reviews,1,0,1
225431,True,0,3 user reviews,3,0,3
225432,True,0,1 user reviews,1,0,1
225434,True,0,7 user reviews,7,0,7
225540,True,6,Mostly Positive,20613,5232,25845
225580,True,0,No user reviews,0,0,0
225600,True,6,Mostly Positive,1368,569,1937
225640,True,6,Mostly Positive,515,198,713
225700,True,0,No user reviews,0,0,0
225760,True,0,No user reviews,0,0,0
225780,True,0,3 user reviews,3,0,3
225820,True,5,Mixed,15,17,32
225821,True,6,Mostly Positive,38,12,50
225822,True,5,Mixed,12,15,27
225823,True,5,Mixed,18,16,34
225824,True,5,Mixed,28,17,45
225825,True,5,Mixed,17,15,32
225826,True,5,Mixed,25,15,40
225827,True,5,Mixed,25,13,38
225828,True,5,Mixed,10,12,22
225829,True,4,Mostly Negative,11,17,28
225830,True,6,Mostly Positive,50,19,69
225831,True,5,Mixed,23,12,35
225832,True,5,Mixed,30,17,47
225833,True,8,Very Positive,81,13,94
225834,True,6,Mostly Positive,41,17,58
225840,True,8,Very Positive,127,10,137
225999,True,0,No user reviews,0,0,0
226080,True,0,No user reviews,0,0,0
226100,True,6,Mostly Positive,290,104,394
226120,True,6,Mostly Positive,81,30,111
226140,True,0,No user reviews,0,0,0
226150,True,0,No user reviews,0,0,0
226170,True,0,No user reviews,0,0,0
226190,True,0,No user reviews,0,0,0
226191,True,0,No user reviews,0,0,0
226192,True,0,No user reviews,0,0,0
226193,True,0,No user reviews,0,0,0
226194,True,0,No user reviews,0,0,0
226195,True,0,No user reviews,0,0,0
226196,True,0,No user reviews,0,0,0
226197,True,0,No user reviews,0,0,0
226198,True,0,No user reviews,0,0,0
226240,True,0,No user reviews,0,0,0
226260,True,0,No user reviews,0,0,0
226320,True,4,Mostly Negative,189,427,616
226350,True,0,3 user reviews,2,1,3
226370,True,0,3 user reviews,2,1,3
226390,True,0,1 user reviews,0,1,1
226451,True,0,No user reviews,0,0,0
226452,True,0,No user reviews,0,0,0
226453,True,0,No user reviews,0,0,0
226454,True,0,No user reviews,0,0,0
226455,True,0,No user reviews,0,0,0
226456,True,0,No user reviews,0,0,0
226457,True,0,No user reviews,0,0,0
226459,True,6,Mostly Positive,22,8,30
226470,True,0,No user reviews,0,0,0
226490,True,0,No user reviews,0,0,0
226491,True,0,No user reviews,0,0,0
226540,True,0,No user reviews,0,0,0
226560,True,5,Mixed,109,104,213
226580,True,6,Mostly Positive,302,85,387
226620,True,8,Very Positive,561,77,638
226660,True,0,8 user reviews,6,2,8
226662,True,5,Mixed,6,4,10
226663,True,7,Positive,21,5,26
226664,True,0,9 user reviews,5,4,9
226665,True,4,Mostly Negative,40,101,141
226666,True,4,Mostly Negative,27,63,90
226667,True,6,Mostly Positive,60,17,77
226668,True,5,Mixed,6,4,10
226669,True,0,8 user reviews,2,6,8
226670,True,0,4 user reviews,1,3,4
226671,True,0,3 user reviews,2,1,3
226672,True,5,Mixed,5,6,11
226673,True,5,Mixed,6,5,11
226700,True,4,Mostly Negative,2527,5411,7938
226720,True,5,Mixed,424,275,699
226740,True,6,Mostly Positive,511,158,669
226760,True,6,Mostly Positive,9,3,12
226780,True,5,Mixed,21,26,47
226800,True,0,No user reviews,0,0,0
226801,True,0,No user reviews,0,0,0
226820,True,8,Very Positive,83,7,90
226840,True,8,Very Positive,2996,688,3684
226860,True,6,Mostly Positive,4567,1307,5874
226880,True,8,Very Positive,569,62,631
226960,True,6,Mostly Positive,118,41,159
226980,True,8,Very Positive,825,60,885
226990,True,0,4 user reviews,4,0,4
226991,True,0,4 user reviews,3,1,4
226992,True,0,2 user reviews,2,0,2
226993,True,0,3 user reviews,3,0,3
226994,True,0,2 user reviews,2,0,2
226995,True,0,4 user reviews,4,0,4
226996,True,0,4 user reviews,3,1,4
226997,True,0,5 user reviews,4,1,5
226998,True,0,5 user reviews,5,0,5
226999,True,3,Negative,2,12,14
227000,True,9,Overwhelmingly Positive,1737,30,1767
227020,True,5,Mixed,72,53,125
227040,True,0,No user reviews,0,0,0
227050,True,0,No user reviews,0,0,0
227060,True,5,Mixed,128,94,222
227080,True,8,Very Positive,523,28,551
227090,True,0,3 user reviews,3,0,3
227100,True,8,Very Positive,1289,177,1466
227129,True,0,4 user reviews,2,2,4
227130,True,4,Mostly Negative,14,35,49
227131,True,4,Mostly Negative,4,10,14
227132,True,4,Mostly Negative,12,19,31
227133,True,0,No user reviews,0,0,0
227140,True,0,No user reviews,0,0,0
227146,True,0,No user reviews,0,0,0
227147,True,0,No user reviews,0,0,0
227148,True,0,No user reviews,0,0,0
227160,True,1,Overwhelmingly Negative,208,955,1163
227180,True,5,Mixed,254,220,474
227200,True,8,Very Positive,427,43,470
227220,True,8,Very Positive,717,96,813
227240,True,0,7 user reviews,5,2,7
227260,True,8,Very Positive,449,48,497
227280,True,6,Mostly Positive,305,122,427
227300,True,9,Overwhelmingly Positive,51992,1436,53428
227310,True,8,Very Positive,375,28,403
227320,True,8,Very Positive,990,91,1081
227380,True,6,Mostly Positive,224,74,298
227400,True,5,Mixed,172,99,271
227420,True,0,No user reviews,0,0,0
227440,True,0,No user reviews,0,0,0
227480,True,5,Mixed,517,291,808
227560,True,5,Mixed,67,38,105
227563,True,0,No user reviews,0,0,0
227580,True,8,Very Positive,943,116,1059
227600,True,8,Very Positive,564,68,632
227660,True,0,No user reviews,0,0,0
227661,True,0,No user reviews,0,0,0
227662,True,0,No user reviews,0,0,0
227680,True,1,Overwhelmingly Negative,729,5332,6061
227720,True,5,Mixed,95,84,179
227740,True,0,No user reviews,0,0,0
227741,True,0,No user reviews,0,0,0
227742,True,0,No user reviews,0,0,0
227760,True,5,Mixed,88,47,135
227780,True,8,Very Positive,634,85,719
227800,True,6,Mostly Positive,46,15,61
227860,True,5,Mixed,1705,1481,3186
227940,True,5,Mixed,577,471,1048
227960,True,0,No user reviews,0,0,0
227980,True,0,No user reviews,0,0,0
228000,True,0,No user reviews,0,0,0
228020,True,0,No user reviews,0,0,0
228180,True,6,Mostly Positive,774,222,996
228200,True,8,Very Positive,1895,128,2023
228221,True,0,No user reviews,0,0,0
228222,True,0,No user reviews,0,0,0
228223,True,0,No user reviews,0,0,0
228240,True,0,No user reviews,0,0,0
228260,True,6,Mostly Positive,765,225,990
228280,True,8,Very Positive,4256,462,4718
228300,True,6,Mostly Positive,2921,764,3685
228320,True,5,Mixed,43,48,91
228360,True,8,Very Positive,674,48,722
228380,True,8,Very Positive,8732,1765,10497
228400,True,5,Mixed,810,828,1638
228421,True,0,1 user reviews,1,0,1
228422,True,0,No user reviews,0,0,0
228423,True,0,No user reviews,0,0,0
228440,True,5,Mixed,57,30,87
228460,True,0,No user reviews,0,0,0
228500,True,0,No user reviews,0,0,0
228520,True,0,No user reviews,0,0,0
228540,True,0,No user reviews,0,0,0
228560,True,5,Mixed,190,172,362
228580,True,0,No user reviews,0,0,0
228600,True,0,6 user reviews,6,0,6
228601,True,7,Positive,28,1,29
228760,True,6,Mostly Positive,429,130,559
228780,True,0,No user reviews,0,0,0
228800,True,0,No user reviews,0,0,0
228860,True,0,No user reviews,0,0,0
228880,True,5,Mixed,617,318,935
228940,True,6,Mostly Positive,66,24,90
228960,True,8,Very Positive,148,18,166
228980,True,0,No user reviews,0,0,0
229080,True,0,4 user reviews,3,1,4
229100,True,0,No user reviews,0,0,0
229150,True,0,No user reviews,0,0,0
229151,True,0,No user reviews,0,0,0
229152,True,0,No user reviews,0,0,0
229153,True,0,No user reviews,0,0,0
229154,True,0,No user reviews,0,0,0
229155,True,0,No user reviews,0,0,0
229156,True,0,No user reviews,0,0,0
229157,True,0,No user reviews,0,0,0
229158,True,0,No user reviews,0,0,0
229159,True,0,No user reviews,0,0,0
229160,True,0,No user reviews,0,0,0
229161,True,0,No user reviews,0,0,0
229162,True,0,No user reviews,0,0,0
229163,True,0,No user reviews,0,0,0
229164,True,0,No user reviews,0,0,0
229170,True,0,No user reviews,0,0,0
229190,True,0,4 user reviews,2,2,4
229210,True,0,7 user reviews,6,1,7
229230,True,0,7 user reviews,6,1,7
229250,True,0,6 user reviews,2,4,6
229270,True,6,Mostly Positive,8,3,11
229290,True,0,8 user reviews,7,1,8
229310,True,6,Mostly Positive,8,3,11
229330,True,0,No user reviews,0,0,0
229480,True,8,Very Positive,440,72,512
229520,True,5,Mixed,121,68,189
229560,True,0,7 user reviews,1,6,7
229580,True,5,Mixed,318,253,571
229600,True,5,Mixed,46,51,97
229626,True,7,Positive,14,1,15
229627,True,5,Mixed,10,5,15
229629,True,0,7 user reviews,2,5,7
229630,True,6,Mostly Positive,7,3,10
229660,True,7,Positive,40,4,44
229750,True,0,9 user reviews,8,1,9
229751,True,0,5 user reviews,4,1,5
229752,True,7,Positive,11,2,13
229753,True,7,Positive,10,2,12
229754,True,7,Positive,13,2,15
229755,True,0,3 user reviews,3,0,3
229757,True,0,3 user reviews,3,0,3
229758,True,0,4 user reviews,4,0,4
229771,True,0,No user reviews,0,0,0
229790,True,0,3 user reviews,2,1,3
229791,True,0,No user reviews,0,0,0
229792,True,0,No user reviews,0,0,0
229810,True,5,Mixed,36,22,58
229870,True,8,Very Positive,185,44,229
229890,True,6,Mostly Positive,26,9,35
229950,True,0,1 user reviews,1,0,1
229970,True,5,Mixed,29,21,50
230010,True,0,No user reviews,0,0,0
230030,True,0,No user reviews,0,0,0
230050,True,8,Very Positive,3028,487,3515
230070,True,6,Mostly Positive,1284,338,1622
230090,True,8,Very Positive,307,13,320
230150,True,6,Mostly Positive,77,25,102
230170,True,0,No user reviews,0,0,0
230190,True,8,Very Positive,2525,412,2937
230210,True,0,No user reviews,0,0,0
230230,True,8,Very Positive,4783,517,5300
230250,True,0,No user reviews,0,0,0
230270,True,9,Overwhelmingly Positive,1354,57,1411
230290,True,9,Overwhelmingly Positive,6352,320,6672
230310,True,4,Mostly Negative,36,88,124
230320,True,0,No user reviews,0,0,0
230330,True,8,Very Positive,123,22,145
230350,True,8,Very Positive,123,22,145
230410,True,8,Very Positive,1009,136,1145
230650,True,4,Mostly Negative,46,75,121
230690,True,0,No user reviews,0,0,0
230691,True,0,1 user reviews,0,1,1
230692,True,0,No user reviews,0,0,0
230700,True,8,Very Positive,903,183,1086
230760,True,0,2 user reviews,0,2,2
230780,True,8,Very Positive,43,7,50
230790,True,0,No user reviews,0,0,0
230791,True,0,2 user reviews,1,1,2
230820,True,8,Very Positive,662,89,751
230830,True,0,No user reviews,0,0,0
230840,True,5,Mixed,232,262,494
230860,True,8,Very Positive,328,32,360
230880,True,0,3 user reviews,3,0,3
230882,True,0,4 user reviews,3,1,4
230883,True,7,Positive,11,0,11
230884,True,0,5 user reviews,4,1,5
230885,True,0,2 user reviews,2,0,2
230886,True,0,2 user reviews,2,0,2
230887,True,0,4 user reviews,4,0,4
230888,True,0,6 user reviews,6,0,6
230889,True,0,No user reviews,0,0,0
230890,True,0,6 user reviews,6,0,6
230891,True,0,2 user reviews,2,0,2
230892,True,7,Positive,10,0,10
230900,True,0,3 user reviews,3,0,3
230920,True,0,2 user reviews,1,1,2
230940,True,5,Mixed,55,25,80
230980,True,6,Mostly Positive,113,30,143
231020,True,5,Mixed,20,15,35
231040,True,8,Very Positive,161,35,196
231060,True,0,9 user reviews,5,4,9
231120,True,0,2 user reviews,2,0,2
231140,True,5,Mixed,263,291,554
231160,True,8,Very Positive,2703,153,2856
231180,True,8,Very Positive,58,3,61
231200,True,8,Very Positive,1291,252,1543
231230,True,0,No user reviews,0,0,0
231250,True,0,No user reviews,0,0,0
231310,True,5,Mixed,150,88,238
231330,True,6,Mostly Positive,331,126,457
231340,True,0,No user reviews,0,0,0
231350,True,0,No user reviews,0,0,0
231390,True,0,No user reviews,0,0,0
231430,True,8,Very Positive,15000,3233,18233
231451,True,0,No user reviews,0,0,0
231453,True,0,No user reviews,0,0,0
231454,True,0,No user reviews,0,0,0
231455,True,0,No user reviews,0,0,0
231456,True,0,2 user reviews,1,1,2
231457,True,0,No user reviews,0,0,0
231458,True,0,No user reviews,0,0,0
231459,True,0,No user reviews,0,0,0
231460,True,0,1 user reviews,0,1,1
231461,True,0,No user reviews,0,0,0
231462,True,0,1 user reviews,1,0,1
231463,True,0,3 user reviews,1,2,3
231464,True,0,No user reviews,0,0,0
231465,True,0,4 user reviews,4,0,4
231466,True,0,5 user reviews,5,0,5
231467,True,0,No user reviews,0,0,0
231468,True,0,No user reviews,0,0,0
231469,True,0,No user reviews,0,0,0
231470,True,0,No user reviews,0,0,0
231471,True,0,No user reviews,0,0,0
231472,True,0,No user reviews,0,0,0
231473,True,0,No user reviews,0,0,0
231474,True,0,No user reviews,0,0,0
231475,True,0,No user reviews,0,0,0
231476,True,0,No user reviews,0,0,0
231477,True,0,No user reviews,0,0,0
231478,True,0,No user reviews,0,0,0
231479,True,4,Mostly Negative,19,29,48
231480,True,5,Mixed,14,14,28
231481,True,0,No user reviews,0,0,0
231482,True,0,No user reviews,0,0,0
231483,True,0,No user reviews,0,0,0
231484,True,0,No user reviews,0,0,0
231485,True,0,No user reviews,0,0,0
231486,True,0,No user reviews,0,0,0
231487,True,0,No user reviews,0,0,0
231488,True,0,No user reviews,0,0,0
231489,True,0,No user reviews,0,0,0
231490,True,0,No user reviews,0,0,0
231491,True,0,No user reviews,0,0,0
231492,True,0,No user reviews,0,0,0
231494,True,0,No user reviews,0,0,0
231504,True,0,1 user reviews,1,0,1
231505,True,0,No user reviews,0,0,0
231506,True,0,No user reviews,0,0,0
231507,True,0,No user reviews,0,0,0
231571,True,0,No user reviews,0,0,0
231670,True,8,Very Positive,750,95,845
231720,True,4,Mostly Negative,14,33,47
231740,True,8,Very Positive,832,203,1035
231801,True,0,No user reviews,0,0,0
231811,True,0,No user reviews,0,0,0
231890,True,0,No user reviews,0,0,0
231910,True,8,Very Positive,141,35,176
231970,True,0,No user reviews,0,0,0
231990,True,5,Mixed,118,78,196
232010,True,6,Mostly Positive,1179,312,1491
232050,True,5,Mixed,432,296,728
232090,True,8,Very Positive,27998,4081,32079
232130,True,0,No user reviews,0,0,0
232150,True,0,No user reviews,0,0,0
232191,True,0,3 user reviews,2,1,3
232192,True,0,No user reviews,0,0,0
232210,True,0,No user reviews,0,0,0
232250,True,0,No user reviews,0,0,0
232430,True,6,Mostly Positive,7397,2271,9668
232450,True,5,Mixed,32,21,53
232491,True,0,No user reviews,0,0,0
232510,True,0,No user reviews,0,0,0
232530,True,0,8 user reviews,7,1,8
232550,True,6,Mostly Positive,9,3,12
232570,True,6,Mostly Positive,9,3,12
232590,True,5,Mixed,9,8,17
232634,True,7,Positive,38,4,42
232640,True,0,No user reviews,0,0,0
232644,True,0,No user reviews,0,0,0
232646,True,0,No user reviews,0,0,0
232647,True,6,Mostly Positive,14,6,20
232670,True,0,8 user reviews,5,3,8
232673,True,0,No user reviews,0,0,0
232690,True,0,No user reviews,0,0,0
232710,True,0,No user reviews,0,0,0
232730,True,0,No user reviews,0,0,0
232750,True,6,Mostly Positive,751,281,1032
232770,True,8,Very Positive,985,160,1145
232790,True,8,Very Positive,2350,552,2902
232810,True,4,Mostly Negative,987,3288,4275
232830,True,0,No user reviews,0,0,0
232890,True,5,Mixed,1395,895,2290
232910,True,8,Very Positive,1274,306,1580
232930,True,0,No user reviews,0,0,0
232950,True,5,Mixed,59,75,134
232970,True,8,Very Positive,119,19,138
232990,True,0,1 user reviews,1,0,1
233010,True,0,No user reviews,0,0,0
233030,True,0,No user reviews,0,0,0
233050,True,0,No user reviews,0,0,0
233070,True,0,No user reviews,0,0,0
233110,True,4,Mostly Negative,31,47,78
233130,True,8,Very Positive,6508,393,6901
233150,True,8,Very Positive,1969,167,2136
233190,True,6,Mostly Positive,173,50,223
233210,True,4,Mostly Negative,35,78,113
233230,True,6,Mostly Positive,708,248,956
233250,True,5,Mixed,4208,3299,7507
233270,True,8,Very Positive,6482,944,7426
233290,True,6,Mostly Positive,2158,543,2701
233310,True,6,Mostly Positive,76,22,98
233350,True,8,Very Positive,241,45,286
233370,True,6,Mostly Positive,254,99,353
233390,True,5,Mixed,45,22,67
233410,True,8,Very Positive,57,8,65
233431,True,0,No user reviews,0,0,0
233432,True,0,No user reviews,0,0,0
233450,True,8,Very Positive,21815,2087,23902
233470,True,8,Very Positive,2157,531,2688
233490,True,0,No user reviews,0,0,0
233510,True,5,Mixed,41,20,61
233530,True,4,Mostly Negative,19,49,68
233550,True,8,Very Positive,564,117,681
233570,True,0,No user reviews,0,0,0
233590,True,0,4 user reviews,2,2,4
233591,True,0,2 user reviews,2,0,2
233592,True,0,2 user reviews,2,0,2
233610,True,8,Very Positive,3002,198,3200
233630,True,0,No user reviews,0,0,0
233680,True,8,Very Positive,216,30,246
233700,True,8,Very Positive,653,106,759
233710,True,0,No user reviews,0,0,0
233720,True,8,Very Positive,6252,1268,7520
233740,True,8,Very Positive,1585,181,1766
233780,True,0,No user reviews,0,0,0
233800,True,8,Very Positive,77,11,88
233840,True,5,Mixed,422,187,609
233860,True,8,Very Positive,17574,1144,18718
233870,True,0,No user reviews,0,0,0
233920,True,0,No user reviews,0,0,0
233940,True,0,No user reviews,0,0,0
233960,True,0,No user reviews,0,0,0
233980,True,8,Very Positive,1323,219,1542
234000,True,5,Mixed,25,19,44
234021,True,0,No user reviews,0,0,0
234022,True,0,1 user reviews,1,0,1
234023,True,0,No user reviews,0,0,0
234024,True,0,No user reviews,0,0,0
234040,True,0,No user reviews,0,0,0
234060,True,5,Mixed,21,29,50
234080,True,6,Mostly Positive,1482,575,2057
234140,True,8,Very Positive,13196,1528,14724
234160,True,8,Very Positive,266,47,313
234190,True,8,Very Positive,1714,242,1956
234210,True,0,No user reviews,0,0,0
234230,True,0,No user reviews,0,0,0
234250,True,0,No user reviews,0,0,0
234270,True,8,Very Positive,682,41,723
234290,True,5,Mixed,45,37,82
234310,True,0,No user reviews,0,0,0
234330,True,5,Mixed,7,8,15
234350,True,0,9 user reviews,8,1,9
234370,True,5,Mixed,8,10,18
234390,True,8,Very Positive,609,71,680
234430,True,0,No user reviews,0,0,0
234431,True,0,No user reviews,0,0,0
234432,True,0,No user reviews,0,0,0
234433,True,0,No user reviews,0,0,0
234490,True,5,Mixed,75,60,135
234510,True,8,Very Positive,63,0,63
234530,True,5,Mixed,325,285,610
234570,True,0,2 user reviews,0,2,2
234630,True,6,Mostly Positive,2496,1020,3516
234650,True,8,Very Positive,5076,633,5709
234670,True,8,Very Positive,2383,319,2702
234690,True,0,No user reviews,0,0,0
234710,True,8,Very Positive,3131,540,3671
234730,True,0,No user reviews,0,0,0
234731,True,0,No user reviews,0,0,0
234740,True,0,No user reviews,0,0,0
234770,True,5,Mixed,13,17,30
234771,True,0,7 user reviews,6,1,7
234772,True,7,Positive,14,0,14
234773,True,7,Positive,10,1,11
234774,True,0,4 user reviews,3,1,4
234775,True,0,6 user reviews,3,3,6
234776,True,7,Positive,14,1,15
234777,True,0,5 user reviews,4,1,5
234778,True,0,3 user reviews,2,1,3
234779,True,0,4 user reviews,3,1,4
234780,True,0,3 user reviews,2,1,3
234781,True,0,3 user reviews,2,1,3
234782,True,0,7 user reviews,6,1,7
234783,True,0,3 user reviews,2,1,3
234784,True,0,5 user reviews,3,2,5
234785,True,7,Positive,12,2,14
234786,True,0,3 user reviews,2,1,3
234787,True,7,Positive,17,3,20
234788,True,7,Positive,14,1,15
234789,True,0,3 user reviews,2,1,3
234790,True,0,3 user reviews,2,1,3
234791,True,0,8 user reviews,8,0,8
234792,True,0,9 user reviews,8,1,9
234793,True,0,5 user reviews,4,1,5
234794,True,0,4 user reviews,3,1,4
234820,True,6,Mostly Positive,173,67,240
234860,True,0,4 user reviews,1,3,4
234880,True,0,4 user reviews,4,0,4
234900,True,8,Very Positive,451,71,522
234920,True,6,Mostly Positive,113,31,144
234940,True,8,Very Positive,208,49,257
234980,True,2,Very Negative,11,79,90
235070,True,5,Mixed,39,25,64
235130,True,0,5 user reviews,4,1,5
235140,True,0,1 user reviews,1,0,1
235150,True,0,7 user reviews,7,0,7
235210,True,8,Very Positive,923,137,1060
235230,True,0,1 user reviews,1,0,1
235250,True,8,Very Positive,466,79,545
235320,True,8,Very Positive,379,41,420
235340,True,0,6 user reviews,2,4,6
235360,True,6,Mostly Positive,253,90,343
235380,True,5,Mixed,602,505,1107
235400,True,0,No user reviews,0,0,0
235460,True,8,Very Positive,8845,717,9562
235520,True,6,Mostly Positive,60,19,79
235540,True,8,Very Positive,5980,1161,7141
235560,True,0,No user reviews,0,0,0
235580,True,9,Overwhelmingly Positive,664,28,692
235584,True,8,Very Positive,66,14,80
235585,True,6,Mostly Positive,15,4,19
235600,True,6,Mostly Positive,3968,1068,5036
235610,True,0,No user reviews,0,0,0
235611,True,0,No user reviews,0,0,0
235620,True,6,Mostly Positive,315,115,430
235640,True,0,No user reviews,0,0,0
235660,True,6,Mostly Positive,64,18,82
235700,True,6,Mostly Positive,27,7,34
235720,True,7,Positive,15,3,18
235740,True,0,No user reviews,0,0,0
235780,True,7,Positive,8,2,10
235800,True,6,Mostly Positive,2268,640,2908
235820,True,8,Very Positive,236,47,283
235883,True,3,Negative,3,23,26
235884,True,0,No user reviews,0,0,0
235900,True,8,Very Positive,298,30,328
235920,True,0,No user reviews,0,0,0
235940,True,0,No user reviews,0,0,0
235960,True,0,No user reviews,0,0,0
235980,True,8,Very Positive,107,1,108
236010,True,0,1 user reviews,0,1,1
236090,True,9,Overwhelmingly Positive,7589,352,7941
236110,True,5,Mixed,1371,726,2097
236130,True,5,Mixed,134,96,230
236150,True,6,Mostly Positive,1552,592,2144
236290,True,0,9 user reviews,8,1,9
236370,True,5,Mixed,1861,1342,3203
236390,True,5,Mixed,478,210,688
236430,True,8,Very Positive,10492,1855,12347
236450,True,9,Overwhelmingly Positive,2129,89,2218
236490,True,5,Mixed,9,6,15
236510,True,4,Mostly Negative,659,1208,1867
236530,True,4,Mostly Negative,4,15,19
236551,True,0,No user reviews,0,0,0
236552,True,0,No user reviews,0,0,0
236553,True,0,No user reviews,0,0,0
236554,True,0,No user reviews,0,0,0
236555,True,0,No user reviews,0,0,0
236556,True,0,No user reviews,0,0,0
236557,True,0,No user reviews,0,0,0
236558,True,0,No user reviews,0,0,0
236570,True,0,1 user reviews,1,0,1
236590,True,0,No user reviews,0,0,0
236591,True,0,No user reviews,0,0,0
236650,True,0,No user reviews,0,0,0
236660,True,0,1 user reviews,1,0,1
236690,True,6,Mostly Positive,2450,781,3231
236730,True,6,Mostly Positive,98,37,135
236790,True,2,Very Negative,40,162,202
236810,True,0,No user reviews,0,0,0
236830,True,0,No user reviews,0,0,0
236850,True,8,Very Positive,27010,4142,31152
236870,True,6,Mostly Positive,7972,2041,10013
236890,True,5,Mixed,13,9,22
236910,True,0,No user reviews,0,0,0
236930,True,8,Very Positive,373,10,383
236951,True,0,No user reviews,0,0,0
236970,True,5,Mixed,6,7,13
236990,True,0,No user reviews,0,0,0
237010,True,6,Mostly Positive,12,4,16
237030,True,7,Positive,14,2,16
237050,True,7,Positive,13,2,15
237070,True,7,Positive,14,2,16
237090,True,7,Positive,13,1,14
237130,True,0,No user reviews,0,0,0
237151,True,0,8 user reviews,5,3,8
237170,True,0,No user reviews,0,0,0
237171,True,0,No user reviews,0,0,0
237210,True,0,No user reviews,0,0,0
237230,True,0,No user reviews,0,0,0
237250,True,0,No user reviews,0,0,0
237270,True,0,No user reviews,0,0,0
237310,True,6,Mostly Positive,29,11,40
237350,True,6,Mostly Positive,103,37,140
237370,True,5,Mixed,109,70,179
237410,True,0,No user reviews,0,0,0
237430,True,6,Mostly Positive,444,117,561
237450,True,0,4 user reviews,2,2,4
237470,True,5,Mixed,51,41,92
237491,True,0,No user reviews,0,0,0
237530,True,0,No user reviews,0,0,0
237550,True,4,Mostly Negative,41,62,103
237570,True,8,Very Positive,161,26,187
237590,True,4,Mostly Negative,22,40,62
237619,True,5,Mixed,17,23,40
237620,True,5,Mixed,12,13,25
237621,True,0,No user reviews,0,0,0
237622,True,0,No user reviews,0,0,0
237623,True,0,No user reviews,0,0,0
237630,True,8,Very Positive,1887,308,2195
237680,True,0,2 user reviews,2,0,2
237700,True,0,2 user reviews,2,0,2
237720,True,0,No user reviews,0,0,0
237740,True,8,Very Positive,1630,191,1821
237760,True,8,Very Positive,64,3,67
237780,True,0,No user reviews,0,0,0
237810,True,0,No user reviews,0,0,0
237850,True,8,Very Positive,1309,306,1615
237870,True,5,Mixed,1814,1152,2966
237890,True,5,Mixed,787,343,1130
237930,True,8,Very Positive,12892,750,13642
237950,True,5,Mixed,89,47,136
237970,True,5,Mixed,23,17,40
237990,True,8,Very Positive,5626,746,6372
238010,True,8,Very Positive,7668,721,8389
238050,True,8,Very Positive,149,11,160
238070,True,0,5 user reviews,2,3,5
238090,True,6,Mostly Positive,3675,1158,4833
238110,True,0,No user reviews,0,0,0
238120,True,0,No user reviews,0,0,0
238121,True,0,No user reviews,0,0,0
238122,True,0,No user reviews,0,0,0
238130,True,0,No user reviews,0,0,0
238170,True,4,Mostly Negative,52,135,187
238210,True,8,Very Positive,3246,172,3418
238240,True,4,Mostly Negative,520,1011,1531
238250,True,0,No user reviews,0,0,0
238251,True,0,4 user reviews,4,0,4
238260,True,7,Positive,29,5,34
238270,True,7,Positive,11,0,11
238271,True,0,4 user reviews,4,0,4
238272,True,0,2 user reviews,2,0,2
238273,True,0,No user reviews,0,0,0
238280,True,6,Mostly Positive,626,216,842
238300,True,7,Positive,37,4,41
238301,True,7,Positive,10,2,12
238302,True,6,Mostly Positive,28,8,36
238303,True,7,Positive,43,4,47
238304,True,5,Mixed,34,48,82
238305,True,0,No user reviews,0,0,0
238320,True,9,Overwhelmingly Positive,14182,623,14805
238340,True,7,Positive,16,1,17
238370,True,6,Mostly Positive,1461,589,2050
238430,True,6,Mostly Positive,3610,1394,5004
238450,True,0,5 user reviews,5,0,5
238460,True,9,Overwhelmingly Positive,17454,505,17959
238480,True,0,1 user reviews,0,1,1
238481,True,7,Positive,10,2,12
238482,True,0,8 user reviews,7,1,8
238510,True,0,No user reviews,0,0,0
238530,True,8,Very Positive,224,14,238
238590,True,0,No user reviews,0,0,0
238630,True,6,Mostly Positive,85,27,112
238650,True,0,No user reviews,0,0,0
238652,True,0,No user reviews,0,0,0
238670,True,0,No user reviews,0,0,0
238690,True,0,No user reviews,0,0,0
238710,True,7,Positive,22,3,25
238750,True,5,Mixed,879,457,1336
238870,True,2,Very Negative,25,204,229
238890,True,5,Mixed,68,76,144
238900,True,0,1 user reviews,1,0,1
238910,True,8,Very Positive,190,33,223
238930,True,5,Mixed,152,98,250
238950,True,0,3 user reviews,3,0,3
238960,True,8,Very Positive,548,50,598
238991,True,0,8 user reviews,7,1,8
239030,True,9,Overwhelmingly Positive,19738,707,20445
239070,True,8,Very Positive,2033,258,2291
239090,True,8,Very Positive,242,17,259
239120,True,6,Mostly Positive,780,215,995
239140,True,8,Very Positive,37735,2790,40525
239160,True,5,Mixed,3352,1835,5187
239200,True,5,Mixed,1983,1192,3175
239220,True,0,No user reviews,0,0,0
239240,True,0,No user reviews,0,0,0
239250,True,6,Mostly Positive,801,232,1033
239280,True,0,No user reviews,0,0,0
239350,True,8,Very Positive,7532,635,8167
239370,True,0,5 user reviews,2,3,5
239380,True,0,No user reviews,0,0,0
239390,True,0,No user reviews,0,0,0
239391,True,0,No user reviews,0,0,0
239392,True,0,No user reviews,0,0,0
239393,True,0,No user reviews,0,0,0
239430,True,8,Very Positive,353,82,435
239450,True,5,Mixed,32,24,56
239490,True,0,No user reviews,0,0,0
239510,True,0,No user reviews,0,0,0
239550,True,6,Mostly Positive,328,107,435
239570,True,8,Very Positive,87,10,97
239660,True,0,5 user reviews,2,3,5
239680,True,0,No user reviews,0,0,0
239681,True,0,No user reviews,0,0,0
239682,True,0,No user reviews,0,0,0
239683,True,0,No user reviews,0,0,0
239684,True,0,No user reviews,0,0,0
239685,True,0,No user reviews,0,0,0
239686,True,0,No user reviews,0,0,0
239687,True,0,No user reviews,0,0,0
239688,True,0,No user reviews,0,0,0
239700,True,8,Very Positive,276,42,318
239760,True,0,No user reviews,0,0,0
239780,True,0,No user reviews,0,0,0
239800,True,8,Very Positive,884,74,958
239820,True,8,Very Positive,16935,960,17895
239840,True,6,Mostly Positive,898,361,1259
239860,True,0,No user reviews,0,0,0
239880,True,0,No user reviews,0,0,0
239890,True,0,No user reviews,0,0,0
239900,True,0,No user reviews,0,0,0
239920,True,0,No user reviews,0,0,0
239940,True,0,No user reviews,0,0,0
239950,True,0,No user reviews,0,0,0
240020,True,0,No user reviews,0,0,0
240040,True,0,No user reviews,0,0,0
240060,True,0,No user reviews,0,0,0
240070,True,0,No user reviews,0,0,0
240080,True,0,No user reviews,0,0,0
240100,True,0,No user reviews,0,0,0
240110,True,0,No user reviews,0,0,0
240120,True,0,No user reviews,0,0,0
240130,True,0,No user reviews,0,0,0
240140,True,0,No user reviews,0,0,0
240150,True,0,No user reviews,0,0,0
240160,True,8,Very Positive,63,5,68
240180,True,7,Positive,32,4,36
240200,True,7,Positive,30,6,36
240220,True,0,No user reviews,0,0,0
240240,True,0,No user reviews,0,0,0
240280,True,7,Positive,39,6,45
240300,True,5,Mixed,12,17,29
240320,True,0,2 user reviews,1,1,2
240340,True,8,Very Positive,54,6,60
240360,True,6,Mostly Positive,22,8,30
240380,True,0,No user reviews,0,0,0
240420,True,0,No user reviews,0,0,0
240440,True,8,Very Positive,471,45,516
240460,True,5,Mixed,587,426,1013
240480,True,0,4 user reviews,4,0,4
240500,True,8,Very Positive,76,9,85
240570,True,0,No user reviews,0,0,0
240580,True,0,No user reviews,0,0,0
240600,True,6,Mostly Positive,136,53,189
240610,True,0,No user reviews,0,0,0
240611,True,0,No user reviews,0,0,0
240612,True,0,3 user reviews,3,0,3
240613,True,0,No user reviews,0,0,0
240620,True,5,Mixed,86,61,147
240660,True,6,Mostly Positive,34,11,45
240720,True,8,Very Positive,10821,2169,12990
240760,True,8,Very Positive,2448,555,3003
240800,True,0,No user reviews,0,0,0
240820,True,5,Mixed,13,6,19
240840,True,0,No user reviews,0,0,0
240850,True,0,No user reviews,0,0,0
240860,True,0,No user reviews,0,0,0
240870,True,0,No user reviews,0,0,0
240880,True,0,No user reviews,0,0,0
240890,True,0,No user reviews,0,0,0
240910,True,0,No user reviews,0,0,0
240930,True,0,No user reviews,0,0,0
240940,True,0,No user reviews,0,0,0
240950,True,0,No user reviews,0,0,0
240970,True,8,Very Positive,245,21,266
240990,True,0,No user reviews,0,0,0
241000,True,5,Mixed,110,143,253
241040,True,0,No user reviews,0,0,0
241050,True,0,No user reviews,0,0,0
241060,True,0,No user reviews,0,0,0
241070,True,7,Positive,17,1,18
241090,True,0,No user reviews,0,0,0
241100,True,0,No user reviews,0,0,0
241120,True,0,No user reviews,0,0,0
241130,True,0,No user reviews,0,0,0
241140,True,0,No user reviews,0,0,0
241150,True,0,No user reviews,0,0,0
241210,True,0,No user reviews,0,0,0
241230,True,0,No user reviews,0,0,0
241240,True,8,Very Positive,532,40,572
241260,True,8,Very Positive,1038,113,1151
241280,True,5,Mixed,296,255,551
241300,True,8,Very Positive,82,8,90
241320,True,8,Very Positive,222,19,241
241340,True,0,No user reviews,0,0,0
241360,True,0,No user reviews,0,0,0
241361,True,0,No user reviews,0,0,0
241362,True,0,No user reviews,0,0,0
241363,True,0,No user reviews,0,0,0
241364,True,5,Mixed,15,12,27
241365,True,0,No user reviews,0,0,0
241366,True,0,No user reviews,0,0,0
241367,True,0,No user reviews,0,0,0
241368,True,4,Mostly Negative,9,27,36
241369,True,4,Mostly Negative,31,60,91
241370,True,5,Mixed,7,4,11
241371,True,5,Mixed,8,10,18
241372,True,5,Mixed,12,6,18
241373,True,0,No user reviews,0,0,0
241410,True,8,Very Positive,515,77,592
241430,True,7,Positive,34,3,37
241490,True,0,No user reviews,0,0,0
241500,True,0,No user reviews,0,0,0
241540,True,8,Very Positive,7246,1648,8894
241560,True,5,Mixed,2863,1646,4509
241600,True,8,Very Positive,8513,664,9177
241620,True,5,Mixed,143,78,221
241640,True,0,No user reviews,0,0,0
241660,True,0,9 user reviews,8,1,9
241680,True,0,2 user reviews,1,1,2
241700,True,0,No user reviews,0,0,0
241720,True,5,Mixed,263,260,523
241760,True,5,Mixed,59,30,89
241790,True,7,Positive,25,4,29
241890,True,0,No user reviews,0,0,0
241910,True,8,Very Positive,352,78,430
241930,True,8,Very Positive,19923,1948,21871
241950,True,0,No user reviews,0,0,0
241960,True,0,No user reviews,0,0,0
241970,True,0,No user reviews,0,0,0
241990,True,5,Mixed,245,106,351
242050,True,8,Very Positive,12420,1862,14282
242110,True,7,Positive,22,5,27
242120,True,0,4 user reviews,1,3,4
242130,True,5,Mixed,163,168,331
242150,True,0,No user reviews,0,0,0
242180,True,0,No user reviews,0,0,0
242270,True,0,No user reviews,0,0,0
242280,True,0,2 user reviews,2,0,2
242290,True,0,1 user reviews,1,0,1
242300,True,5,Mixed,7,6,13
242310,True,6,Mostly Positive,9,3,12
242320,True,0,No user reviews,0,0,0
242360,True,0,No user reviews,0,0,0
242380,True,0,No user reviews,0,0,0
242460,True,0,No user reviews,0,0,0
242480,True,0,No user reviews,0,0,0
242520,True,0,No user reviews,0,0,0
242530,True,6,Mostly Positive,93,39,132
242550,True,8,Very Positive,1430,192,1622
242570,True,5,Mixed,698,306,1004
242590,True,0,2 user reviews,1,1,2
242610,True,0,7 user reviews,7,0,7
242630,True,0,1 user reviews,1,0,1
242640,True,8,Very Positive,2140,493,2633
242680,True,9,Overwhelmingly Positive,6730,218,6948
242700,True,8,Very Positive,2444,599,3043
242720,True,6,Mostly Positive,24,7,31
242760,True,8,Very Positive,65392,4072,69464
242780,True,8,Very Positive,170,41,211
242820,True,9,Overwhelmingly Positive,1030,51,1081
242840,True,6,Mostly Positive,296,85,381
242860,True,8,Very Positive,13729,1943,15672
242880,True,6,Mostly Positive,1694,443,2137
242920,True,8,Very Positive,17937,2101,20038
242940,True,6,Mostly Positive,137,35,172
242960,True,5,Mixed,214,119,333
242980,True,5,Mixed,160,105,265
243000,True,6,Mostly Positive,132,52,184
243020,True,5,Mixed,61,35,96
243040,True,8,Very Positive,437,47,484
243060,True,5,Mixed,51,28,79
243120,True,8,Very Positive,1293,267,1560
243160,True,8,Very Positive,78,15,93
243180,True,5,Mixed,13,12,25
243200,True,8,Very Positive,617,68,685
243220,True,8,Very Positive,274,45,319
243280,True,7,Positive,27,5,32
243300,True,3,Negative,4,25,29
243320,True,4,Mostly Negative,47,81,128
243340,True,0,No user reviews,0,0,0
243360,True,6,Mostly Positive,103,39,142
243380,True,0,No user reviews,0,0,0
243411,True,0,No user reviews,0,0,0
243412,True,0,No user reviews,0,0,0
243413,True,0,No user reviews,0,0,0
243414,True,0,No user reviews,0,0,0
243415,True,0,No user reviews,0,0,0
243440,True,0,4 user reviews,2,2,4
243441,True,0,No user reviews,0,0,0
243442,True,0,1 user reviews,0,1,1
243450,True,6,Mostly Positive,311,112,423
243470,True,5,Mixed,6983,3912,10895
243560,True,4,Mostly Negative,27,45,72
243600,True,0,No user reviews,0,0,0
243730,True,0,No user reviews,0,0,0
243750,True,0,No user reviews,0,0,0
243780,True,8,Very Positive,231,45,276
243800,True,8,Very Positive,848,109,957
243820,True,0,No user reviews,0,0,0
243870,True,0,No user reviews,0,0,0
243890,True,5,Mixed,9,10,19
243930,True,5,Mixed,763,448,1211
243950,True,6,Mostly Positive,764,286,1050
243959,True,0,No user reviews,0,0,0
243970,True,8,Very Positive,2547,219,2766
244030,True,5,Mixed,539,484,1023
244050,True,5,Mixed,158,89,247
244060,True,5,Mixed,9,10,19
244061,True,0,3 user reviews,3,0,3
244062,True,7,Positive,11,2,13
244063,True,0,5 user reviews,4,1,5
244064,True,0,4 user reviews,1,3,4
244065,True,0,9 user reviews,9,0,9
244066,True,0,8 user reviews,4,4,8
244070,True,6,Mostly Positive,147,62,209
244090,True,5,Mixed,73,34,107
244160,True,8,Very Positive,4153,634,4787
244210,True,8,Very Positive,10660,1385,12045
244230,True,6,Mostly Positive,38,12,50
244290,True,0,9 user reviews,8,1,9
244310,True,0,No user reviews,0,0,0
244350,True,0,8 user reviews,2,6,8
244370,True,0,No user reviews,0,0,0
244390,True,6,Mostly Positive,54,15,69
244410,True,6,Mostly Positive,109,40,149
244430,True,8,Very Positive,604,87,691
244450,True,8,Very Positive,8238,1038,9276
244470,True,0,No user reviews,0,0,0
244590,True,8,Very Positive,100,25,125
244630,True,6,Mostly Positive,9,3,12
244650,True,0,No user reviews,0,0,0
244690,True,5,Mixed,27,12,39
244710,True,8,Very Positive,1170,194,1364
244730,True,8,Very Positive,857,82,939
244750,True,8,Very Positive,79,19,98
244770,True,6,Mostly Positive,1118,479,1597
244810,True,6,Mostly Positive,179,47,226
244830,True,7,Positive,11,1,12
244850,True,8,Very Positive,42107,5133,47240
244870,True,8,Very Positive,1398,182,1580
244890,True,8,Very Positive,45,6,51
244910,True,6,Mostly Positive,443,156,599
244930,True,5,Mixed,986,560,1546
244950,True,6,Mostly Positive,16,5,21
245010,True,5,Mixed,30,29,59
245030,True,0,No user reviews,0,0,0
245050,True,4,Mostly Negative,26,43,69
245070,True,0,No user reviews,0,0,0
245130,True,4,Mostly Negative,408,804,1212
245150,True,6,Mostly Positive,330,86,416
245170,True,9,Overwhelmingly Positive,7412,385,7797
245172,True,8,Very Positive,49,1,50
245173,True,0,No user reviews,0,0,0
245174,True,8,Very Positive,61,1,62
245175,True,8,Very Positive,90,3,93
245176,True,8,Very Positive,47,4,51
245177,True,0,No user reviews,0,0,0
245190,True,0,2 user reviews,2,0,2
245191,True,0,7 user reviews,7,0,7
245192,True,0,3 user reviews,1,2,3
245193,True,0,5 user reviews,4,1,5
245220,True,0,8 user reviews,8,0,8
245280,True,8,Very Positive,1639,337,1976
245300,True,5,Mixed,65,46,111
245340,True,0,No user reviews,0,0,0
245350,True,0,No user reviews,0,0,0
245370,True,5,Mixed,96,144,240
245390,True,8,Very Positive,668,75,743
245410,True,5,Mixed,53,23,76
245430,True,8,Very Positive,78,10,88
245450,True,8,Very Positive,398,46,444
245470,True,6,Mostly Positive,3391,1125,4516
245490,True,5,Mixed,713,385,1098
245550,True,7,Positive,9,1,10
245580,True,0,3 user reviews,3,0,3
245620,True,6,Mostly Positive,3108,1022,4130
245640,True,0,No user reviews,0,0,0
245660,True,0,1 user reviews,1,0,1
245680,True,0,No user reviews,0,0,0
245681,True,0,No user reviews,0,0,0
245682,True,0,No user reviews,0,0,0
245683,True,0,No user reviews,0,0,0
245730,True,5,Mixed,85,81,166
245810,True,8,Very Positive,138,13,151
245850,True,0,No user reviews,0,0,0
245890,True,6,Mostly Positive,115,40,155
245910,True,5,Mixed,113,59,172
245930,True,8,Very Positive,168,32,200
245950,True,8,Very Positive,108,24,132
245970,True,8,Very Positive,137,22,159
246010,True,0,No user reviews,0,0,0
246030,True,0,No user reviews,0,0,0
246050,True,0,5 user reviews,5,0,5
246070,True,5,Mixed,226,166,392
246090,True,1,Overwhelmingly Negative,462,2227,2689
246110,True,6,Mostly Positive,627,252,879
246170,True,0,No user reviews,0,0,0
246210,True,0,No user reviews,0,0,0
246250,True,0,7 user reviews,6,1,7
246251,True,0,7 user reviews,7,0,7
246252,True,0,8 user reviews,6,2,8
246253,True,0,9 user reviews,8,1,9
246254,True,0,9 user reviews,7,2,9
246255,True,5,Mixed,6,6,12
246256,True,7,Positive,14,0,14
246257,True,0,8 user reviews,6,2,8
246260,True,7,Positive,23,4,27
246280,True,5,Mixed,16,9,25
246300,True,5,Mixed,178,99,277
246340,True,0,No user reviews,0,0,0
246360,True,5,Mixed,8,9,17
246380,True,0,No user reviews,0,0,0
246400,True,8,Very Positive,85,21,106
246420,True,9,Overwhelmingly Positive,2269,100,2369
246440,True,0,No user reviews,0,0,0
246460,True,0,No user reviews,0,0,0
246561,True,0,No user reviews,0,0,0
246562,True,0,4 user reviews,3,1,4
246563,True,0,No user reviews,0,0,0
246564,True,0,No user reviews,0,0,0
246580,True,8,Very Positive,1364,222,1586
246600,True,0,9 user reviews,9,0,9
246620,True,8,Very Positive,13435,953,14388
246640,True,0,No user reviews,0,0,0
246660,True,0,No user reviews,0,0,0
246680,True,5,Mixed,86,39,125
246720,True,6,Mostly Positive,15,5,20
246740,True,5,Mixed,15,20,35
246760,True,5,Mixed,251,127,378
246800,True,0,4 user reviews,3,1,4
246820,True,0,4 user reviews,3,1,4
246840,True,8,Very Positive,1119,73,1192
246880,True,3,Negative,7,38,45
246900,True,8,Very Positive,5068,325,5393
246920,True,8,Very Positive,57,9,66
246940,True,4,Mostly Negative,56,195,251
246960,True,8,Very Positive,82,17,99
246980,True,6,Mostly Positive,60,22,82
247000,True,6,Mostly Positive,1683,515,2198
247020,True,9,Overwhelmingly Positive,2416,114,2530
247080,True,9,Overwhelmingly Positive,8796,343,9139
247120,True,0,1 user reviews,0,1,1
247140,True,8,Very Positive,335,29,364
247180,True,0,No user reviews,0,0,0
247190,True,0,No user reviews,0,0,0
247240,True,8,Very Positive,775,155,930
247260,True,0,No user reviews,0,0,0
247290,True,5,Mixed,17,9,26
247291,True,7,Positive,10,1,11
247292,True,7,Positive,12,2,14
247293,True,6,Mostly Positive,25,7,32
247294,True,7,Positive,13,1,14
247295,True,8,Very Positive,65,3,68
247296,True,0,No user reviews,0,0,0
247297,True,8,Very Positive,76,14,90
247298,True,7,Positive,19,1,20
247299,True,7,Positive,19,0,19
247300,True,7,Positive,40,4,44
247301,True,7,Positive,16,3,19
247302,True,5,Mixed,39,25,64
247303,True,8,Very Positive,104,7,111
247304,True,8,Very Positive,82,9,91
247305,True,7,Positive,13,0,13
247306,True,7,Positive,19,3,22
247307,True,7,Positive,10,1,11
247308,True,6,Mostly Positive,16,5,21
247309,True,6,Mostly Positive,15,5,20
247310,True,0,9 user reviews,5,4,9
247350,True,8,Very Positive,222,31,253
247370,True,6,Mostly Positive,115,45,160
247390,True,0,No user reviews,0,0,0
247430,True,8,Very Positive,563,94,657
247450,True,0,No user reviews,0,0,0
247560,True,0,No user reviews,0,0,0
247580,True,6,Mostly Positive,26,10,36
247620,True,0,No user reviews,0,0,0
247640,True,0,No user reviews,0,0,0
247660,True,5,Mixed,935,460,1395
247710,True,0,No user reviews,0,0,0
247730,True,4,Mostly Negative,3429,5427,8856
247750,True,0,5 user reviews,5,0,5
247811,True,0,No user reviews,0,0,0
247830,True,7,Positive,11,1,12
247852,True,0,No user reviews,0,0,0
247870,True,4,Mostly Negative,75,114,189
247890,True,0,No user reviews,0,0,0
247910,True,8,Very Positive,1024,181,1205
247930,True,5,Mixed,13,8,21
247950,True,4,Mostly Negative,156,527,683
248140,True,0,No user reviews,0,0,0
248160,True,5,Mixed,11,5,16
248170,True,8,Very Positive,303,34,337
248190,True,8,Very Positive,97,18,115
248210,True,0,No user reviews,0,0,0
248270,True,5,Mixed,20,17,37
248290,True,5,Mixed,110,63,173
248310,True,9,Overwhelmingly Positive,1977,69,2046
248330,True,8,Very Positive,406,25,431
248350,True,5,Mixed,160,91,251
248370,True,5,Mixed,18,14,32
248390,True,8,Very Positive,2889,580,3469
248410,True,4,Mostly Negative,21,72,93
248450,True,5,Mixed,99,48,147
248470,True,5,Mixed,113,83,196
248490,True,5,Mixed,33,39,72
248510,True,8,Very Positive,62,12,74
248530,True,6,Mostly Positive,60,18,78
248550,True,8,Very Positive,247,18,265
248570,True,8,Very Positive,90,12,102
248590,True,0,No user reviews,0,0,0
248610,True,8,Very Positive,2781,191,2972
248630,True,5,Mixed,273,392,665
248650,True,5,Mixed,195,89,284
248710,True,4,Mostly Negative,45,180,225
248730,True,6,Mostly Positive,141,36,177
248750,True,8,Very Positive,151,3,154
248751,True,0,No user reviews,0,0,0
248752,True,0,No user reviews,0,0,0
248753,True,0,No user reviews,0,0,0
248754,True,0,No user reviews,0,0,0
248755,True,0,No user reviews,0,0,0
248756,True,0,No user reviews,0,0,0
248757,True,0,No user reviews,0,0,0
248800,True,6,Mostly Positive,412,128,540
248820,True,8,Very Positive,12542,783,13325
248860,True,8,Very Positive,2385,282,2667
248950,True,0,No user reviews,0,0,0
248970,True,8,Very Positive,136,29,165
249050,True,8,Very Positive,4711,600,5311
249070,True,0,No user reviews,0,0,0
249081,True,0,7 user reviews,4,3,7
249082,True,5,Mixed,4,6,10
249083,True,0,5 user reviews,4,1,5
249085,True,7,Positive,9,1,10
249086,True,0,7 user reviews,6,1,7
249087,True,0,2 user reviews,2,0,2
249088,True,5,Mixed,10,6,16
249090,True,0,5 user reviews,5,0,5
249092,True,0,3 user reviews,2,1,3
249094,True,0,5 user reviews,5,0,5
249100,True,0,No user reviews,0,0,0
249101,True,0,No user reviews,0,0,0
249102,True,0,No user reviews,0,0,0
249103,True,0,No user reviews,0,0,0
249104,True,0,No user reviews,0,0,0
249105,True,0,No user reviews,0,0,0
249106,True,0,No user reviews,0,0,0
249107,True,0,No user reviews,0,0,0
249108,True,0,No user reviews,0,0,0
249109,True,0,No user reviews,0,0,0
249110,True,0,No user reviews,0,0,0
249111,True,0,No user reviews,0,0,0
249112,True,0,No user reviews,0,0,0
249113,True,0,No user reviews,0,0,0
249114,True,0,No user reviews,0,0,0
249115,True,0,No user reviews,0,0,0
249116,True,0,No user reviews,0,0,0
249117,True,0,No user reviews,0,0,0
249120,True,7,Positive,10,1,11
249121,True,0,7 user reviews,6,1,7
249122,True,7,Positive,11,0,11
249130,True,8,Very Positive,3249,349,3598
249150,True,0,No user reviews,0,0,0
249170,True,0,8 user reviews,4,4,8
249180,True,5,Mixed,48,22,70
249181,True,5,Mixed,7,5,12
249190,True,5,Mixed,75,102,177
249230,True,5,Mixed,716,406,1122
249310,True,7,Positive,23,2,25
249320,True,8,Very Positive,106,20,126
249330,True,8,Very Positive,542,50,592
249360,True,5,Mixed,162,84,246
249380,True,6,Mostly Positive,904,307,1211
249540,True,0,4 user reviews,0,4,4
249550,True,5,Mixed,139,68,207
249570,True,5,Mixed,104,140,244
249590,True,8,Very Positive,550,127,677
249610,True,6,Mostly Positive,8,3,11
249630,True,8,Very Positive,1349,209,1558
249650,True,5,Mixed,620,416,1036
249680,True,8,Very Positive,826,69,895
249700,True,0,No user reviews,0,0,0
249730,True,5,Mixed,8,6,14
249740,True,0,No user reviews,0,0,0
249750,True,0,1 user reviews,1,0,1
249760,True,0,No user reviews,0,0,0
249770,True,0,No user reviews,0,0,0
249870,True,8,Very Positive,697,160,857
249910,True,0,9 user reviews,0,9,9
249911,True,0,No user reviews,0,0,0
249912,True,0,No user reviews,0,0,0
249913,True,0,No user reviews,0,0,0
249920,True,0,No user reviews,0,0,0
249921,True,0,5 user reviews,2,3,5
249922,True,0,2 user reviews,2,0,2
249923,True,0,5 user reviews,4,1,5
249930,True,4,Mostly Negative,6,11,17
249950,True,8,Very Positive,281,62,343
249970,True,0,No user reviews,0,0,0
249990,True,6,Mostly Positive,791,298,1089
250010,True,0,No user reviews,0,0,0
250030,True,8,Very Positive,82,20,102
250050,True,9,Overwhelmingly Positive,558,25,583
250070,True,6,Mostly Positive,7,3,10
250110,True,9,Overwhelmingly Positive,737,32,769
250180,True,8,Very Positive,1798,222,2020
250260,True,8,Very Positive,2968,241,3209
250300,True,8,Very Positive,83,18,101
250310,True,0,1 user reviews,1,0,1
250320,True,9,Overwhelmingly Positive,11804,317,12121
250340,True,6,Mostly Positive,1594,678,2272
250360,True,6,Mostly Positive,10,4,14
250380,True,8,Very Positive,268,48,316
250400,True,6,Mostly Positive,3302,1053,4355
250420,True,5,Mixed,7,7,14
250460,True,6,Mostly Positive,235,97,332
250500,True,9,Overwhelmingly Positive,1338,59,1397
250520,True,8,Very Positive,1981,315,2296
250540,True,4,Mostly Negative,3,10,13
250560,True,6,Mostly Positive,530,145,675
250580,True,6,Mostly Positive,328,137,465
250600,True,8,Very Positive,71,7,78
250620,True,8,Very Positive,1921,299,2220
250640,True,6,Mostly Positive,106,41,147
250660,True,5,Mixed,125,64,189
250680,True,6,Mostly Positive,366,142,508
250700,True,8,Very Positive,356,40,396
250720,True,3,Negative,7,30,37
250740,True,5,Mixed,7,4,11
250760,True,9,Overwhelmingly Positive,7607,301,7908
250790,True,0,No user reviews,0,0,0
250810,True,0,No user reviews,0,0,0
250820,True,0,No user reviews,0,0,0
250870,True,5,Mixed,38,51,89
250900,True,9,Overwhelmingly Positive,46484,941,47425
250930,True,0,2 user reviews,2,0,2
250940,True,0,No user reviews,0,0,0
250990,True,6,Mostly Positive,10,4,14
251000,True,0,No user reviews,0,0,0
251020,True,5,Mixed,13,11,24
251040,True,0,1 user reviews,1,0,1
251060,True,8,Very Positive,4550,595,5145
251080,True,0,8 user reviews,7,1,8
251081,True,0,5 user reviews,5,0,5
251090,True,0,No user reviews,0,0,0
251110,True,8,Very Positive,733,107,840
251130,True,8,Very Positive,1069,82,1151
251150,True,8,Very Positive,3238,254,3492
251170,True,5,Mixed,768,359,1127
251210,True,8,Very Positive,105,16,121
251230,True,6,Mostly Positive,123,37,160
251270,True,8,Very Positive,460,51,511
251290,True,9,Overwhelmingly Positive,1226,30,1256
251310,True,5,Mixed,37,40,77
251370,True,8,Very Positive,270,11,281
251390,True,5,Mixed,75,38,113
251410,True,5,Mixed,52,74,126
251430,True,8,Very Positive,192,23,215
251450,True,4,Mostly Negative,3,7,10
251470,True,8,Very Positive,1184,66,1250
251490,True,8,Very Positive,103,4,107
251510,True,7,Positive,12,1,13
251530,True,5,Mixed,36,21,57
251570,True,8,Very Positive,44267,7937,52204
251590,True,5,Mixed,13,16,29
251610,True,8,Very Positive,142,15,157
251630,True,8,Very Positive,504,91,595
251650,True,7,Positive,8,2,10
251670,True,0,No user reviews,0,0,0
251690,True,5,Mixed,93,50,143
251710,True,5,Mixed,114,53,167
251730,True,8,Very Positive,1280,125,1405
251770,True,8,Very Positive,220,30,250
251790,True,0,2 user reviews,0,2,2
251810,True,6,Mostly Positive,135,52,187
251830,True,8,Very Positive,256,11,267
251850,True,6,Mostly Positive,230,68,298
251870,True,8,Very Positive,845,109,954
251890,True,5,Mixed,133,147,280
251910,True,7,Positive,32,6,38
251950,True,5,Mixed,55,25,80
251970,True,5,Mixed,124,81,205
251990,True,9,Overwhelmingly Positive,4035,205,4240
252010,True,8,Very Positive,217,46,263
252030,True,8,Very Positive,1237,237,1474
252050,True,2,Very Negative,11,107,118
252070,True,6,Mostly Positive,75,24,99
252090,True,6,Mostly Positive,27,8,35
252110,True,8,Very Positive,1129,60,1189
252130,True,8,Very Positive,231,18,249
252150,True,8,Very Positive,120,19,139
252170,True,5,Mixed,26,13,39
252210,True,5,Mixed,34,44,78
252230,True,5,Mixed,115,63,178
252250,True,5,Mixed,266,365,631
252270,True,5,Mixed,45,26,71
252290,True,6,Mostly Positive,74,30,104
252310,True,8,Very Positive,215,27,242
252330,True,8,Very Positive,1966,290,2256
252350,True,6,Mostly Positive,684,179,863
252370,True,8,Very Positive,251,47,298
252390,True,5,Mixed,66,39,105
252410,True,8,Very Positive,1606,124,1730
252430,True,5,Mixed,17,24,41
252450,True,5,Mixed,695,567,1262
252470,True,6,Mostly Positive,1444,399,1843
252490,True,8,Very Positive,168070,27689,195759
252530,True,6,Mostly Positive,833,259,1092
252550,True,8,Very Positive,260,48,308
252570,True,5,Mixed,146,65,211
252590,True,0,No user reviews,0,0,0
252610,True,9,Overwhelmingly Positive,3123,142,3265
252630,True,8,Very Positive,896,123,1019
252670,True,8,Very Positive,761,132,893
252690,True,6,Mostly Positive,566,156,722
252710,True,6,Mostly Positive,110,28,138
252730,True,8,Very Positive,76,12,88
252750,True,8,Very Positive,60,13,73
252830,True,5,Mixed,92,40,132
252850,True,5,Mixed,23,15,38
252870,True,8,Very Positive,1875,183,2058
252890,True,6,Mostly Positive,48,14,62
252910,True,2,Very Negative,21,169,190
252950,True,8,Very Positive,156890,18237,175127
252970,True,6,Mostly Positive,42,18,60
252990,True,0,6 user reviews,6,0,6
253030,True,8,Very Positive,1088,62,1150
253110,True,8,Very Positive,1660,142,1802
253150,True,6,Mostly Positive,333,109,442
253190,True,5,Mixed,278,142,420
253230,True,9,Overwhelmingly Positive,17612,286,17898
253250,True,6,Mostly Positive,3237,1183,4420
253290,True,8,Very Positive,243,18,261
253310,True,5,Mixed,13,6,19
253330,True,6,Mostly Positive,478,173,651
253350,True,8,Very Positive,59,10,69
253370,True,5,Mixed,67,38,105
253390,True,6,Mostly Positive,42,15,57
253410,True,5,Mixed,61,48,109
253430,True,6,Mostly Positive,2805,766,3571
253470,True,5,Mixed,57,34,91
253510,True,5,Mixed,172,173,345
253530,True,6,Mostly Positive,11,3,14
253570,True,7,Positive,8,2,10
253610,True,6,Mostly Positive,164,63,227
253630,True,5,Mixed,99,83,182
253650,True,5,Mixed,496,273,769
253670,True,6,Mostly Positive,19,8,27
253690,True,6,Mostly Positive,134,48,182
253710,True,5,Mixed,104,149,253
253750,True,9,Overwhelmingly Positive,824,41,865
253770,True,4,Mostly Negative,118,249,367
253790,True,6,Mostly Positive,110,30,140
253830,True,0,1 user reviews,0,1,1
253831,True,0,No user reviews,0,0,0
253832,True,0,No user reviews,0,0,0
253840,True,8,Very Positive,919,98,1017
253860,True,5,Mixed,32,39,71
253880,True,5,Mixed,106,56,162
253900,True,6,Mostly Positive,467,120,587
253920,True,6,Mostly Positive,180,58,238
253940,True,6,Mostly Positive,186,49,235
253960,True,5,Mixed,31,41,72
253980,True,5,Mixed,465,229,694
254000,True,0,No user reviews,0,0,0
254020,True,0,No user reviews,0,0,0
254040,True,0,No user reviews,0,0,0
254060,True,5,Mixed,58,42,100
254080,True,5,Mixed,44,36,80
254100,True,5,Mixed,38,20,58
254150,True,0,No user reviews,0,0,0
254170,True,0,No user reviews,0,0,0
254180,True,0,No user reviews,0,0,0
254181,True,0,No user reviews,0,0,0
254182,True,0,No user reviews,0,0,0
254183,True,0,No user reviews,0,0,0
254184,True,0,No user reviews,0,0,0
254185,True,0,No user reviews,0,0,0
254200,True,6,Mostly Positive,1358,498,1856
254240,True,0,No user reviews,0,0,0
254260,True,8,Very Positive,89,1,90
254270,True,0,No user reviews,0,0,0
254290,True,0,3 user reviews,3,0,3
254291,True,0,3 user reviews,3,0,3
254300,True,0,2 user reviews,2,0,2
254320,True,8,Very Positive,1019,133,1152
254370,True,5,Mixed,49,44,93
254420,True,0,No user reviews,0,0,0
254421,True,0,No user reviews,0,0,0
254422,True,0,No user reviews,0,0,0
254423,True,0,No user reviews,0,0,0
254440,True,8,Very Positive,1124,121,1245
254460,True,8,Very Positive,384,29,413
254480,True,6,Mostly Positive,113,40,153
254560,True,0,No user reviews,0,0,0
254582,True,0,No user reviews,0,0,0
254583,True,0,No user reviews,0,0,0
254584,True,0,No user reviews,0,0,0
254585,True,0,No user reviews,0,0,0
254590,True,4,Mostly Negative,110,170,280
254620,True,0,No user reviews,0,0,0
254650,True,4,Mostly Negative,52,82,134
254670,True,0,No user reviews,0,0,0
254671,True,0,No user reviews,0,0,0
254672,True,0,No user reviews,0,0,0
254673,True,0,No user reviews,0,0,0
254674,True,0,No user reviews,0,0,0
254700,True,8,Very Positive,6834,928,7762
254820,True,8,Very Positive,46,7,53
254840,True,6,Mostly Positive,60,18,78
254860,True,4,Mostly Negative,4,10,14
254880,True,8,Very Positive,84,8,92
254900,True,0,3 user reviews,3,0,3
254920,True,6,Mostly Positive,24,7,31
254940,True,0,9 user reviews,6,3,9
254960,True,8,Very Positive,265,41,306
254980,True,0,No user reviews,0,0,0
255000,True,0,No user reviews,0,0,0
255010,True,6,Mostly Positive,12,4,16
255030,True,5,Mixed,31,24,55
255050,True,7,Positive,33,3,36
255060,True,0,No user reviews,0,0,0
255070,True,5,Mixed,500,216,716
255140,True,0,No user reviews,0,0,0
255160,True,0,2 user reviews,2,0,2
255161,True,0,No user reviews,0,0,0
255162,True,0,No user reviews,0,0,0
255163,True,0,2 user reviews,1,1,2
255164,True,0,No user reviews,0,0,0
255165,True,0,No user reviews,0,0,0
255166,True,0,No user reviews,0,0,0
255167,True,0,No user reviews,0,0,0
255168,True,0,No user reviews,0,0,0
255169,True,0,No user reviews,0,0,0
255190,True,0,No user reviews,0,0,0
255210,True,0,No user reviews,0,0,0
255240,True,0,No user reviews,0,0,0
255250,True,0,1 user reviews,0,1,1
255251,True,0,No user reviews,0,0,0
255253,True,0,No user reviews,0,0,0
255260,True,5,Mixed,37,26,63
255280,True,6,Mostly Positive,257,93,350
255300,True,8,Very Positive,240,60,300
255320,True,6,Mostly Positive,211,82,293
255340,True,8,Very Positive,129,7,136
255370,True,5,Mixed,149,64,213
255390,True,8,Very Positive,338,21,359
255420,True,5,Mixed,919,1356,2275
255440,True,0,No user reviews,0,0,0
255470,True,0,No user reviews,0,0,0
255480,True,5,Mixed,544,332,876
255520,True,6,Mostly Positive,680,182,862
255550,True,0,No user reviews,0,0,0
255551,True,0,No user reviews,0,0,0
255580,True,0,No user reviews,0,0,0
255690,True,0,9 user reviews,7,2,9
255691,True,4,Mostly Negative,4,8,12
255692,True,5,Mixed,8,8,16
255710,True,8,Very Positive,46920,4006,50926
255780,True,0,No user reviews,0,0,0
255870,True,8,Very Positive,122,8,130
255890,True,0,No user reviews,0,0,0
255910,True,7,Positive,17,1,18
255920,True,6,Mostly Positive,128,36,164
255940,True,5,Mixed,33,32,65
255960,True,7,Positive,37,6,43
255980,True,4,Mostly Negative,4,12,16
256010,True,4,Mostly Negative,63,129,192
256030,True,5,Mixed,78,56,134
256050,True,2,Very Negative,5,60,65
256070,True,6,Mostly Positive,24,8,32
256100,True,0,No user reviews,0,0,0
256120,True,0,No user reviews,0,0,0
256180,True,0,No user reviews,0,0,0
256190,True,5,Mixed,581,446,1027
256230,True,0,No user reviews,0,0,0
256240,True,0,9 user reviews,8,1,9
256270,True,5,Mixed,16,8,24
256280,True,0,4 user reviews,1,3,4
256290,True,8,Very Positive,4311,451,4762
256320,True,7,Positive,34,4,38
256321,True,6,Mostly Positive,18,5,23
256330,True,5,Mixed,154,100,254
256350,True,5,Mixed,33,18,51
256370,True,6,Mostly Positive,280,101,381
256390,True,5,Mixed,54,68,122
256410,True,0,No user reviews,0,0,0
256440,True,4,Mostly Negative,6,13,19
256460,True,8,Very Positive,328,38,366
256480,True,0,No user reviews,0,0,0
256490,True,0,No user reviews,0,0,0
256500,True,8,Very Positive,56,7,63
256501,True,0,6 user reviews,6,0,6
256502,True,7,Positive,11,0,11
256503,True,0,6 user reviews,6,0,6
256504,True,0,8 user reviews,7,1,8
256505,True,7,Positive,10,0,10
256506,True,0,1 user reviews,1,0,1
256507,True,0,2 user reviews,2,0,2
256508,True,0,No user reviews,0,0,0
256509,True,0,No user reviews,0,0,0
256510,True,7,Positive,12,1,13
256511,True,0,No user reviews,0,0,0
256512,True,0,No user reviews,0,0,0
256513,True,0,No user reviews,0,0,0
256514,True,0,No user reviews,0,0,0
256520,True,0,1 user reviews,1,0,1
256521,True,0,1 user reviews,0,1,1
256522,True,0,4 user reviews,4,0,4
256523,True,0,3 user reviews,3,0,3
256524,True,0,No user reviews,0,0,0
256525,True,0,No user reviews,0,0,0
256526,True,0,No user reviews,0,0,0
256527,True,0,No user reviews,0,0,0
256529,True,0,No user reviews,0,0,0
256530,True,0,No user reviews,0,0,0
256531,True,0,No user reviews,0,0,0
256532,True,0,No user reviews,0,0,0
256533,True,0,No user reviews,0,0,0
256534,True,0,No user reviews,0,0,0
256535,True,0,1 user reviews,1,0,1
256539,True,0,No user reviews,0,0,0
256546,True,0,No user reviews,0,0,0
256549,True,0,No user reviews,0,0,0
256552,True,0,No user reviews,0,0,0
256554,True,0,No user reviews,0,0,0
256555,True,0,No user reviews,0,0,0
256556,True,0,No user reviews,0,0,0
256568,True,0,No user reviews,0,0,0
256570,True,0,No user reviews,0,0,0
256576,True,0,No user reviews,0,0,0
256611,True,0,No user reviews,0,0,0
256614,True,0,No user reviews,0,0,0
257020,True,0,1 user reviews,1,0,1
257030,True,8,Very Positive,563,74,637
257050,True,5,Mixed,176,195,371
257080,True,8,Very Positive,131,32,163
257120,True,8,Very Positive,188,41,229
257140,True,0,No user reviews,0,0,0
257170,True,8,Very Positive,705,115,820
257190,True,0,No user reviews,0,0,0
257210,True,0,No user reviews,0,0,0
257220,True,6,Mostly Positive,38,14,52
257260,True,8,Very Positive,47,3,50
257280,True,0,No user reviews,0,0,0
257281,True,0,No user reviews,0,0,0
257290,True,0,4 user reviews,4,0,4
257300,True,0,No user reviews,0,0,0
257310,True,0,5 user reviews,4,1,5
257320,True,0,7 user reviews,4,3,7
257330,True,0,No user reviews,0,0,0
257331,True,0,No user reviews,0,0,0
257332,True,0,No user reviews,0,0,0
257333,True,0,No user reviews,0,0,0
257334,True,0,No user reviews,0,0,0
257350,True,8,Very Positive,2581,281,2862
257370,True,5,Mixed,74,79,153
257371,True,5,Mixed,41,60,101
257380,True,0,No user reviews,0,0,0
257400,True,5,Mixed,98,131,229
257420,True,8,Very Positive,1613,346,1959
257510,True,9,Overwhelmingly Positive,11098,467,11565
257610,True,5,Mixed,24,12,36
257630,True,5,Mixed,42,35,77
257650,True,5,Mixed,15,10,25
257670,True,6,Mostly Positive,189,59,248
257690,True,8,Very Positive,464,82,546
257710,True,0,5 user reviews,5,0,5
257730,True,6,Mostly Positive,29,9,38
257750,True,8,Very Positive,943,184,1127
257770,True,5,Mixed,34,20,54
257790,True,8,Very Positive,171,19,190
257830,True,5,Mixed,125,108,233
257850,True,8,Very Positive,7301,497,7798
257870,True,5,Mixed,25,13,38
257890,True,3,Negative,2,19,21
257910,True,0,No user reviews,0,0,0
257930,True,2,Very Negative,11,175,186
257970,True,8,Very Positive,234,52,286
257990,True,8,Very Positive,199,31,230
258010,True,8,Very Positive,368,58,426
258050,True,5,Mixed,173,107,280
258070,True,7,Positive,14,2,16
258090,True,6,Mostly Positive,42,14,56
258130,True,0,No user reviews,0,0,0
258150,True,0,No user reviews,0,0,0
258160,True,0,No user reviews,0,0,0
258180,True,4,Mostly Negative,536,1180,1716
258200,True,5,Mixed,46,24,70
258220,True,5,Mixed,105,55,160
258240,True,4,Mostly Negative,10,29,39
258260,True,0,No user reviews,0,0,0
258261,True,0,No user reviews,0,0,0
258262,True,0,No user reviews,0,0,0
258263,True,0,No user reviews,0,0,0
258264,True,0,No user reviews,0,0,0
258270,True,5,Mixed,13,19,32
258280,True,0,No user reviews,0,0,0
258300,True,0,No user reviews,0,0,0
258320,True,0,No user reviews,0,0,0
258341,True,0,No user reviews,0,0,0
258342,True,0,No user reviews,0,0,0
258343,True,0,1 user reviews,1,0,1
258344,True,0,No user reviews,0,0,0
258345,True,0,No user reviews,0,0,0
258346,True,0,No user reviews,0,0,0
258347,True,0,2 user reviews,2,0,2
258348,True,0,3 user reviews,3,0,3
258349,True,0,No user reviews,0,0,0
258350,True,0,1 user reviews,1,0,1
258351,True,0,No user reviews,0,0,0
258352,True,0,1 user reviews,0,1,1
258353,True,0,9 user reviews,9,0,9
258354,True,0,1 user reviews,1,0,1
258355,True,0,No user reviews,0,0,0
258356,True,0,No user reviews,0,0,0
258357,True,0,No user reviews,0,0,0
258358,True,0,1 user reviews,1,0,1
258359,True,0,No user reviews,0,0,0
258360,True,0,No user reviews,0,0,0
258361,True,0,4 user reviews,4,0,4
258362,True,0,No user reviews,0,0,0
258363,True,0,No user reviews,0,0,0
258364,True,0,No user reviews,0,0,0
258365,True,0,4 user reviews,3,1,4
258366,True,0,1 user reviews,1,0,1
258367,True,0,1 user reviews,1,0,1
258368,True,0,No user reviews,0,0,0
258369,True,0,No user reviews,0,0,0
258370,True,0,No user reviews,0,0,0
258371,True,0,No user reviews,0,0,0
258372,True,0,No user reviews,0,0,0
258373,True,0,No user reviews,0,0,0
258374,True,0,1 user reviews,1,0,1
258375,True,0,No user reviews,0,0,0
258376,True,0,No user reviews,0,0,0
258377,True,0,No user reviews,0,0,0
258378,True,0,4 user reviews,4,0,4
258379,True,0,No user reviews,0,0,0
258380,True,0,No user reviews,0,0,0
258381,True,0,2 user reviews,2,0,2
258382,True,0,1 user reviews,0,1,1
258383,True,0,1 user reviews,1,0,1
258384,True,0,3 user reviews,3,0,3
258385,True,0,3 user reviews,2,1,3
258386,True,0,2 user reviews,2,0,2
258388,True,0,3 user reviews,3,0,3
258389,True,0,No user reviews,0,0,0
258390,True,0,No user reviews,0,0,0
258391,True,0,No user reviews,0,0,0
258392,True,0,5 user reviews,5,0,5
258393,True,0,No user reviews,0,0,0
258394,True,0,1 user reviews,1,0,1
258395,True,0,2 user reviews,1,1,2
258396,True,0,1 user reviews,1,0,1
258397,True,0,6 user reviews,6,0,6
258398,True,0,No user reviews,0,0,0
258399,True,0,No user reviews,0,0,0
258400,True,0,No user reviews,0,0,0
258401,True,0,No user reviews,0,0,0
258402,True,0,1 user reviews,1,0,1
258403,True,0,No user reviews,0,0,0
258404,True,0,2 user reviews,1,1,2
258405,True,0,No user reviews,0,0,0
258406,True,0,No user reviews,0,0,0
258407,True,0,No user reviews,0,0,0
258408,True,0,No user reviews,0,0,0
258409,True,0,No user reviews,0,0,0
258410,True,0,1 user reviews,1,0,1
258411,True,0,No user reviews,0,0,0
258412,True,0,1 user reviews,1,0,1
258413,True,0,No user reviews,0,0,0
258414,True,0,8 user reviews,4,4,8
258415,True,0,3 user reviews,3,0,3
258416,True,0,No user reviews,0,0,0
258417,True,0,No user reviews,0,0,0
258418,True,0,1 user reviews,1,0,1
258419,True,0,2 user reviews,2,0,2
258420,True,0,6 user reviews,4,2,6
258450,True,0,No user reviews,0,0,0
258460,True,7,Positive,22,2,24
258470,True,0,1 user reviews,1,0,1
258500,True,0,2 user reviews,2,0,2
258501,True,0,2 user reviews,2,0,2
258502,True,0,4 user reviews,3,1,4
258510,True,0,1 user reviews,1,0,1
258511,True,0,1 user reviews,1,0,1
258512,True,0,No user reviews,0,0,0
258520,True,8,Very Positive,3305,494,3799
258540,True,0,3 user reviews,1,2,3
258541,True,0,4 user reviews,2,2,4
258542,True,0,3 user reviews,0,3,3
258543,True,5,Mixed,6,6,12
258550,True,0,No user reviews,0,0,0
258580,True,0,No user reviews,0,0,0
258590,True,6,Mostly Positive,157,65,222
258640,True,5,Mixed,11,13,24
258641,True,5,Mixed,10,5,15
258642,True,7,Positive,11,0,11
258643,True,6,Mostly Positive,8,3,11
258644,True,5,Mixed,5,7,12
258645,True,0,6 user reviews,4,2,6
258646,True,0,8 user reviews,7,1,8
258647,True,6,Mostly Positive,20,7,27
258648,True,8,Very Positive,50,9,59
258650,True,7,Positive,9,1,10
258652,True,7,Positive,17,2,19
258653,True,7,Positive,23,3,26
258654,True,7,Positive,32,8,40
258655,True,6,Mostly Positive,19,5,24
258656,True,7,Positive,14,1,15
258657,True,7,Positive,10,0,10
258658,True,7,Positive,13,1,14
258659,True,7,Positive,12,1,13
258661,True,0,9 user reviews,7,2,9
258662,True,0,No user reviews,0,0,0
258663,True,5,Mixed,23,24,47
258666,True,0,4 user reviews,1,3,4
258668,True,4,Mostly Negative,8,13,21
258671,True,0,4 user reviews,3,1,4
258674,True,0,7 user reviews,5,2,7
258677,True,0,4 user reviews,3,1,4
258678,True,7,Positive,8,2,10
258700,True,4,Mostly Negative,4,7,11
258740,True,0,8 user reviews,6,2,8
258741,True,0,2 user reviews,2,0,2
258742,True,0,4 user reviews,4,0,4
258743,True,6,Mostly Positive,10,3,13
258744,True,7,Positive,9,1,10
258745,True,0,1 user reviews,1,0,1
258750,True,7,Positive,18,2,20
258751,True,7,Positive,26,5,31
258752,True,7,Positive,9,1,10
258760,True,6,Mostly Positive,187,77,264
258780,True,0,No user reviews,0,0,0
258800,True,7,Positive,25,5,30
258803,True,0,2 user reviews,2,0,2
258804,True,0,2 user reviews,2,0,2
258810,True,5,Mixed,9,4,13
258811,True,0,No user reviews,0,0,0
258812,True,0,4 user reviews,3,1,4
258813,True,0,3 user reviews,2,1,3
258814,True,0,4 user reviews,3,1,4
258815,True,0,3 user reviews,0,3,3
258816,True,0,7 user reviews,4,3,7
258817,True,4,Mostly Negative,20,41,61
258850,True,0,4 user reviews,4,0,4
258851,True,0,2 user reviews,1,1,2
258852,True,0,1 user reviews,1,0,1
258880,True,5,Mixed,36,47,83
258890,True,8,Very Positive,207,51,258
258910,True,8,Very Positive,118,17,135
258930,True,0,2 user reviews,2,0,2
258940,True,0,No user reviews,0,0,0
258941,True,0,No user reviews,0,0,0
258942,True,0,No user reviews,0,0,0
258950,True,5,Mixed,60,49,109
258970,True,6,Mostly Positive,2581,782,3363
258990,True,0,1 user reviews,1,0,1
258991,True,0,No user reviews,0,0,0
258992,True,0,No user reviews,0,0,0
258993,True,0,No user reviews,0,0,0
258994,True,0,No user reviews,0,0,0
259000,True,0,No user reviews,0,0,0
259020,True,5,Mixed,8,6,14
259040,True,6,Mostly Positive,47,17,64
259041,True,5,Mixed,54,33,87
259060,True,8,Very Positive,823,90,913
259080,True,7,Positive,42,3,45
259110,True,0,8 user reviews,8,0,8
259120,True,0,1 user reviews,1,0,1
259121,True,0,1 user reviews,1,0,1
259122,True,0,No user reviews,0,0,0
259130,True,6,Mostly Positive,135,34,169
259170,True,4,Mostly Negative,59,108,167
259190,True,5,Mixed,66,48,114
259210,True,0,5 user reviews,5,0,5
259211,True,0,8 user reviews,8,0,8
259220,True,0,No user reviews,0,0,0
259230,True,0,3 user reviews,2,1,3
259240,True,0,1 user reviews,1,0,1
259250,True,7,Positive,15,2,17
259251,True,6,Mostly Positive,7,3,10
259252,True,0,9 user reviews,5,4,9
259253,True,0,7 user reviews,3,4,7
259260,True,0,No user reviews,0,0,0
259270,True,0,No user reviews,0,0,0
259271,True,0,No user reviews,0,0,0
259280,True,0,No user reviews,0,0,0
259300,True,0,No user reviews,0,0,0
259320,True,4,Mostly Negative,9,25,34
259340,True,5,Mixed,40,26,66
259360,True,0,No user reviews,0,0,0
259380,True,5,Mixed,218,99,317
259381,True,6,Mostly Positive,275,100,375
259390,True,8,Very Positive,90,12,102
259410,True,8,Very Positive,126,16,142
259430,True,6,Mostly Positive,128,42,170
259450,True,5,Mixed,98,46,144
259470,True,7,Positive,17,4,21
259490,True,8,Very Positive,50,5,55
259510,True,8,Very Positive,104,20,124
259530,True,8,Very Positive,1293,81,1374
259550,True,8,Very Positive,1015,95,1110
259570,True,5,Mixed,448,198,646
259590,True,0,1 user reviews,1,0,1
259591,True,0,1 user reviews,1,0,1
259592,True,0,No user reviews,0,0,0
259600,True,8,Very Positive,157,37,194
259620,True,5,Mixed,111,101,212
259640,True,4,Mostly Negative,18,46,64
259660,True,5,Mixed,146,73,219
259680,True,9,Overwhelmingly Positive,2279,109,2388
259700,True,5,Mixed,42,61,103
259720,True,5,Mixed,97,57,154
259740,True,8,Very Positive,255,31,286
259760,True,4,Mostly Negative,9,22,31
259780,True,8,Very Positive,277,40,317
259800,True,4,Mostly Negative,133,376,509
259810,True,7,Positive,15,0,15
259830,True,5,Mixed,9,4,13
259870,True,6,Mostly Positive,111,35,146
259890,True,3,Negative,6,43,49
259900,True,5,Mixed,22,10,32
259910,True,2,Very Negative,17,80,97
259940,True,7,Positive,21,3,24
259960,True,7,Positive,27,3,30
259980,True,8,Very Positive,46,7,53
260000,True,5,Mixed,21,10,31
260020,True,6,Mostly Positive,8,3,11
260040,True,7,Positive,14,2,16
260060,True,7,Positive,15,3,18
260080,True,4,Mostly Negative,10,17,27
260100,True,0,No user reviews,0,0,0
260101,True,0,No user reviews,0,0,0
260130,True,6,Mostly Positive,153,64,217
260160,True,6,Mostly Positive,224,70,294
260190,True,8,Very Positive,247,39,286
260210,True,5,Mixed,413,356,769
260230,True,8,Very Positive,5212,370,5582
260250,True,5,Mixed,142,107,249
260270,True,5,Mixed,29,23,52
260290,True,6,Mostly Positive,21,7,28
260291,True,0,2 user reviews,2,0,2
260292,True,0,No user reviews,0,0,0
260293,True,0,1 user reviews,0,1,1
260300,True,0,No user reviews,0,0,0
260302,True,0,No user reviews,0,0,0
260304,True,0,No user reviews,0,0,0
260305,True,0,No user reviews,0,0,0
260308,True,0,No user reviews,0,0,0
260309,True,0,No user reviews,0,0,0
260310,True,0,No user reviews,0,0,0
260311,True,0,No user reviews,0,0,0
260312,True,0,No user reviews,0,0,0
260313,True,0,No user reviews,0,0,0
260314,True,0,No user reviews,0,0,0
260315,True,0,No user reviews,0,0,0
260316,True,0,No user reviews,0,0,0
260317,True,0,No user reviews,0,0,0
260318,True,0,No user reviews,0,0,0
260319,True,0,No user reviews,0,0,0
260320,True,0,No user reviews,0,0,0
260321,True,0,No user reviews,0,0,0
260322,True,0,No user reviews,0,0,0
260323,True,0,No user reviews,0,0,0
260324,True,0,No user reviews,0,0,0
260325,True,0,No user reviews,0,0,0
260326,True,0,No user reviews,0,0,0
260330,True,6,Mostly Positive,51,17,68
260380,True,5,Mixed,14,9,23
260400,True,0,No user reviews,0,0,0
260401,True,0,No user reviews,0,0,0
260402,True,0,No user reviews,0,0,0
260403,True,0,No user reviews,0,0,0
260410,True,0,5 user reviews,4,1,5
260430,True,5,Mixed,60,36,96
260460,True,0,No user reviews,0,0,0
260461,True,0,No user reviews,0,0,0
260471,True,6,Mostly Positive,7,3,10
260472,True,0,6 user reviews,3,3,6
260476,True,0,No user reviews,0,0,0
260477,True,0,No user reviews,0,0,0
260478,True,0,No user reviews,0,0,0
260510,True,2,Very Negative,6,51,57
260530,True,7,Positive,27,4,31
260550,True,6,Mostly Positive,19,6,25
260570,True,8,Very Positive,240,23,263
260650,True,5,Mixed,44,30,74
260690,True,6,Mostly Positive,80,23,103
260710,True,5,Mixed,20,9,29
260730,True,8,Very Positive,395,79,474
260750,True,8,Very Positive,381,18,399
260770,True,0,No user reviews,0,0,0
260790,True,8,Very Positive,268,41,309
260850,True,0,3 user reviews,2,1,3
260860,True,0,1 user reviews,1,0,1
260880,True,0,1 user reviews,1,0,1
260930,True,5,Mixed,49,38,87
260960,True,0,9 user reviews,7,2,9
260990,True,6,Mostly Positive,22,7,29
261020,True,0,No user reviews,0,0,0
261030,True,9,Overwhelmingly Positive,9802,492,10294
261050,True,5,Mixed,54,29,83
261060,True,0,No user reviews,0,0,0
261070,True,0,No user reviews,0,0,0
261110,True,6,Mostly Positive,1080,343,1423
261130,True,0,1 user reviews,1,0,1
261160,True,0,6 user reviews,2,4,6
261161,True,0,3 user reviews,2,1,3
261180,True,9,Overwhelmingly Positive,2261,99,2360
261200,True,0,No user reviews,0,0,0
261210,True,0,No user reviews,0,0,0
261220,True,0,No user reviews,0,0,0
261240,True,0,No user reviews,0,0,0
261300,True,0,No user reviews,0,0,0
261301,True,0,No user reviews,0,0,0
261302,True,0,No user reviews,0,0,0
261310,True,0,No user reviews,0,0,0
261330,True,0,No user reviews,0,0,0
261331,True,0,No user reviews,0,0,0
261340,True,0,No user reviews,0,0,0
261341,True,0,No user reviews,0,0,0
261350,True,5,Mixed,10,8,18
261390,True,0,No user reviews,0,0,0
261391,True,0,No user reviews,0,0,0
261392,True,0,1 user reviews,1,0,1
261393,True,0,No user reviews,0,0,0
261394,True,0,1 user reviews,0,1,1
261395,True,0,No user reviews,0,0,0
261396,True,0,No user reviews,0,0,0
261397,True,0,No user reviews,0,0,0
261398,True,0,No user reviews,0,0,0
261399,True,0,No user reviews,0,0,0
261400,True,0,1 user reviews,0,1,1
261401,True,0,No user reviews,0,0,0
261402,True,0,No user reviews,0,0,0
261403,True,0,No user reviews,0,0,0
261404,True,0,No user reviews,0,0,0
261405,True,0,No user reviews,0,0,0
261406,True,0,No user reviews,0,0,0
261407,True,0,No user reviews,0,0,0
261408,True,0,1 user reviews,1,0,1
261409,True,0,No user reviews,0,0,0
261410,True,0,No user reviews,0,0,0
261411,True,0,No user reviews,0,0,0
261412,True,0,No user reviews,0,0,0
261420,True,0,1 user reviews,1,0,1
261421,True,0,2 user reviews,1,1,2
261430,True,5,Mixed,6,4,10
261450,True,0,No user reviews,0,0,0
261470,True,6,Mostly Positive,638,249,887
261510,True,8,Very Positive,361,36,397
261530,True,6,Mostly Positive,986,326,1312
261550,True,8,Very Positive,45426,6056,51482
261570,True,9,Overwhelmingly Positive,11247,455,11702
261590,True,0,No user reviews,0,0,0
261600,True,3,Negative,3,21,24
261620,True,0,No user reviews,0,0,0
261640,True,6,Mostly Positive,10205,2597,12802
261660,True,0,No user reviews,0,0,0
261680,True,8,Very Positive,183,43,226
261700,True,8,Very Positive,367,53,420
261720,True,5,Mixed,26,28,54
261740,True,5,Mixed,13,9,22
261760,True,5,Mixed,750,583,1333
261820,True,7,Positive,25,1,26
261880,True,8,Very Positive,221,26,247
261900,True,0,7 user reviews,7,0,7
261920,True,4,Mostly Negative,29,59,88
261940,True,7,Positive,10,2,12
261960,True,6,Mostly Positive,21,8,29
261980,True,4,Mostly Negative,5,12,17
262000,True,8,Very Positive,357,45,402
262060,True,8,Very Positive,29800,3367,33167
262080,True,3,Negative,0,12,12
262100,True,4,Mostly Negative,14,23,37
262120,True,6,Mostly Positive,283,104,387
262142,True,0,1 user reviews,1,0,1
262150,True,5,Mixed,536,245,781
262190,True,6,Mostly Positive,92,37,129
262210,True,8,Very Positive,51,7,58
262230,True,0,1 user reviews,1,0,1
262240,True,8,Very Positive,68,8,76
262260,True,8,Very Positive,540,68,608
262280,True,6,Mostly Positive,619,244,863
262300,True,0,4 user reviews,4,0,4
262340,True,0,No user reviews,0,0,0
262341,True,0,No user reviews,0,0,0
262342,True,0,1 user reviews,1,0,1
262360,True,0,No user reviews,0,0,0
262361,True,0,No user reviews,0,0,0
262362,True,0,No user reviews,0,0,0
262370,True,5,Mixed,6,4,10
262390,True,8,Very Positive,434,88,522
262410,True,5,Mixed,73,34,107
262450,True,8,Very Positive,196,43,239
262470,True,8,Very Positive,194,19,213
262490,True,6,Mostly Positive,233,83,316
262510,True,5,Mixed,12,8,20
262550,True,8,Very Positive,258,33,291
262590,True,8,Very Positive,82,14,96
262610,True,5,Mixed,10,10,20
262630,True,0,5 user reviews,3,2,5
262650,True,4,Mostly Negative,10,19,29
262690,True,8,Very Positive,193,41,234
262750,True,5,Mixed,103,51,154
262770,True,8,Very Positive,110,13,123
262790,True,8,Very Positive,306,56,362
262810,True,5,Mixed,6,9,15
262830,True,8,Very Positive,577,53,630
262850,True,8,Very Positive,184,7,191
262870,True,3,Negative,1,9,10
262880,True,0,No user reviews,0,0,0
262900,True,6,Mostly Positive,133,42,175
262920,True,0,2 user reviews,2,0,2
262940,True,8,Very Positive,526,66,592
262960,True,6,Mostly Positive,536,177,713
262980,True,4,Mostly Negative,5,12,17
263020,True,8,Very Positive,403,34,437
263040,True,5,Mixed,26,18,44
263060,True,6,Mostly Positive,1025,344,1369
263100,True,8,Very Positive,383,60,443
263120,True,0,4 user reviews,4,0,4
263140,True,5,Mixed,29,42,71
263180,True,0,5 user reviews,3,2,5
263200,True,6,Mostly Positive,322,85,407
263260,True,8,Very Positive,67,14,81
263280,True,8,Very Positive,6371,1235,7606
263300,True,8,Very Positive,815,159,974
263320,True,6,Mostly Positive,191,52,243
263340,True,5,Mixed,49,44,93
263360,True,6,Mostly Positive,209,60,269
263380,True,8,Very Positive,56,8,64
263400,True,8,Very Positive,218,18,236
263420,True,5,Mixed,36,52,88
263440,True,5,Mixed,1035,1257,2292
263460,True,7,Positive,39,7,46
263480,True,5,Mixed,31,34,65
263500,True,7,Positive,8,2,10
263520,True,5,Mixed,34,17,51
263540,True,0,5 user reviews,3,2,5
263560,True,8,Very Positive,257,44,301
263600,True,4,Mostly Negative,8,19,27
263620,True,8,Very Positive,872,192,1064
263640,True,5,Mixed,23,30,53
263680,True,5,Mixed,131,89,220
263700,True,6,Mostly Positive,35,10,45
263720,True,5,Mixed,166,76,242
263740,True,6,Mostly Positive,198,57,255
263760,True,8,Very Positive,3030,249,3279
263800,True,3,Negative,1,17,18
263820,True,8,Very Positive,314,33,347
263840,True,6,Mostly Positive,35,9,44
263860,True,5,Mixed,43,22,65
263880,True,8,Very Positive,168,22,190
263920,True,5,Mixed,86,51,137
263940,True,6,Mostly Positive,35,11,46
263960,True,7,Positive,13,2,15
263980,True,8,Very Positive,2499,221,2720
264000,True,5,Mixed,47,36,83
264020,True,5,Mixed,8,4,12
264060,True,7,Positive,42,6,48
264080,True,8,Very Positive,70,5,75
264120,True,5,Mixed,36,46,82
264140,True,5,Mixed,2388,1513,3901
264160,True,8,Very Positive,347,50,397
264200,True,9,Overwhelmingly Positive,8485,146,8631
264220,True,8,Very Positive,47,7,54
264240,True,6,Mostly Positive,396,113,509
264260,True,5,Mixed,23,11,34
264280,True,5,Mixed,82,87,169
264300,True,5,Mixed,157,106,263
264320,True,5,Mixed,26,18,44
264340,True,7,Positive,31,3,34
264380,True,7,Positive,9,1,10
264400,True,7,Positive,21,0,21
264420,True,7,Positive,22,4,26
264440,True,0,5 user reviews,1,4,5
264460,True,5,Mixed,4,6,10
264480,True,5,Mixed,15,20,35
264520,True,6,Mostly Positive,59,18,77
264540,True,6,Mostly Positive,63,27,90
264560,True,8,Very Positive,59,8,67
264580,True,4,Mostly Negative,5,10,15
264600,True,5,Mixed,24,11,35
264610,True,5,Mixed,146,91,237
264660,True,0,No user reviews,0,0,0
264680,True,0,No user reviews,0,0,0
264681,True,0,1 user reviews,0,1,1
264682,True,0,1 user reviews,1,0,1
264683,True,0,No user reviews,0,0,0
264690,True,8,Very Positive,114,9,123
264710,True,9,Overwhelmingly Positive,75833,3685,79518
264730,True,6,Mostly Positive,366,143,509
264750,True,6,Mostly Positive,12,5,17
264800,True,0,No user reviews,0,0,0
264802,True,0,5 user reviews,2,3,5
264804,True,5,Mixed,12,8,20
264805,True,0,8 user reviews,2,6,8
264820,True,0,No user reviews,0,0,0
264830,True,0,3 user reviews,1,2,3
264840,True,0,1 user reviews,1,0,1
264841,True,0,No user reviews,0,0,0
264850,True,0,No user reviews,0,0,0
264910,True,0,No user reviews,0,0,0
264920,True,0,2 user reviews,2,0,2
264930,True,0,No user reviews,0,0,0
264970,True,0,9 user reviews,3,6,9
265000,True,8,Very Positive,245,52,297
265020,True,3,Negative,3,29,32
265060,True,0,7 user reviews,2,5,7
265061,True,0,9 user reviews,6,3,9
265090,True,0,No user reviews,0,0,0
265100,True,0,No user reviews,0,0,0
265120,True,5,Mixed,89,93,182
265130,True,0,5 user reviews,3,2,5
265131,True,0,2 user reviews,2,0,2
265132,True,0,3 user reviews,2,1,3
265140,True,4,Mostly Negative,9,20,29
265141,True,0,6 user reviews,1,5,6
265142,True,0,2 user reviews,1,1,2
265143,True,0,2 user reviews,1,1,2
265144,True,0,1 user reviews,1,0,1
265145,True,0,1 user reviews,1,0,1
265146,True,0,1 user reviews,1,0,1
265150,True,0,No user reviews,0,0,0
265170,True,8,Very Positive,87,14,101
265191,True,5,Mixed,9,8,17
265192,True,5,Mixed,7,6,13
265193,True,5,Mixed,8,10,18
265200,True,0,2 user reviews,2,0,2
265210,True,8,Very Positive,1790,173,1963
265230,True,0,No user reviews,0,0,0
265240,True,4,Mostly Negative,2,8,10
265300,True,5,Mixed,1860,1725,3585
265330,True,5,Mixed,220,120,340
265360,True,0,No user reviews,0,0,0
265380,True,5,Mixed,20,14,34
265400,True,4,Mostly Negative,24,40,64
265410,True,0,4 user reviews,3,1,4
265420,True,6,Mostly Positive,11,3,14
265460,True,0,1 user reviews,1,0,1
265461,True,0,4 user reviews,4,0,4
265462,True,0,3 user reviews,3,0,3
265463,True,0,6 user reviews,5,1,6
265464,True,0,3 user reviews,3,0,3
265465,True,0,No user reviews,0,0,0
265470,True,8,Very Positive,91,14,105
265490,True,0,2 user reviews,1,1,2
265530,True,0,No user reviews,0,0,0
265550,True,5,Mixed,2459,1092,3551
265570,True,0,No user reviews,0,0,0
265590,True,6,Mostly Positive,384,119,503
265610,True,9,Overwhelmingly Positive,1383,33,1416
265630,True,8,Very Positive,242,31,273
265650,True,0,No user reviews,0,0,0
265670,True,4,Mostly Negative,5,11,16
265690,True,6,Mostly Positive,392,100,492
265730,True,0,2 user reviews,2,0,2
265750,True,6,Mostly Positive,338,103,441
265770,True,0,1 user reviews,1,0,1
265790,True,0,7 user reviews,6,1,7
265810,True,5,Mixed,185,137,322
265830,True,5,Mixed,76,39,115
265870,True,6,Mostly Positive,22,9,31
265890,True,9,Overwhelmingly Positive,2001,72,2073
265930,True,8,Very Positive,21788,2832,24620
265950,True,6,Mostly Positive,157,52,209
265970,True,5,Mixed,106,121,227
265990,True,5,Mixed,160,84,244
266010,True,9,Overwhelmingly Positive,3090,134,3224
266030,True,0,No user reviews,0,0,0
266050,True,5,Mixed,27,18,45
266090,True,5,Mixed,55,81,136
266110,True,8,Very Positive,307,41,348
266130,True,8,Very Positive,947,217,1164
266150,True,0,5 user reviews,4,1,5
266170,True,5,Mixed,159,77,236
266190,True,4,Mostly Negative,24,41,65
266210,True,8,Very Positive,2184,124,2308
266230,True,8,Very Positive,288,50,338
266250,True,7,Positive,37,3,40
266270,True,6,Mostly Positive,49,16,65
266290,True,4,Mostly Negative,33,81,114
266310,True,6,Mostly Positive,448,168,616
266330,True,5,Mixed,14,15,29
266370,True,5,Mixed,9,12,21
266390,True,6,Mostly Positive,208,70,278
266410,True,6,Mostly Positive,320,88,408
266430,True,5,Mixed,15,8,23
266470,True,5,Mixed,24,17,41
266490,True,8,Very Positive,509,68,577
266510,True,8,Very Positive,2625,309,2934
266550,True,4,Mostly Negative,6,10,16
266590,True,0,8 user reviews,4,4,8
266620,True,4,Mostly Negative,7,14,21
266710,True,0,No user reviews,0,0,0
266720,True,0,No user reviews,0,0,0
266730,True,7,Positive,12,1,13
266740,True,7,Positive,9,1,10
266750,True,5,Mixed,10,6,16
266760,True,0,No user reviews,0,0,0
266780,True,0,No user reviews,0,0,0
266800,True,0,No user reviews,0,0,0
266810,True,0,No user reviews,0,0,0
266840,True,8,Very Positive,6711,919,7630
266862,True,0,No user reviews,0,0,0
266864,True,0,No user reviews,0,0,0
266868,True,0,No user reviews,0,0,0
266870,True,0,No user reviews,0,0,0
266873,True,0,No user reviews,0,0,0
266874,True,0,No user reviews,0,0,0
266880,True,0,No user reviews,0,0,0
266930,True,7,Positive,35,4,39
266931,True,7,Positive,21,4,25
266940,True,8,Very Positive,53,13,66
266980,True,0,8 user reviews,4,4,8
267000,True,0,1 user reviews,0,1,1
267001,True,0,1 user reviews,1,0,1
267060,True,5,Mixed,41,25,66
267160,True,0,No user reviews,0,0,0
267180,True,0,No user reviews,0,0,0
267191,True,0,No user reviews,0,0,0
267220,True,0,7 user reviews,0,7,7
267340,True,6,Mostly Positive,60,20,80
267360,True,8,Very Positive,197,11,208
267380,True,5,Mixed,135,108,243
267381,True,8,Very Positive,222,33,255
267382,True,0,1 user reviews,1,0,1
267420,True,0,No user reviews,0,0,0
267440,True,5,Mixed,18,14,32
267480,True,0,3 user reviews,3,0,3
267490,True,4,Mostly Negative,131,246,377
267510,True,0,No user reviews,0,0,0
267511,True,0,No user reviews,0,0,0
267512,True,0,No user reviews,0,0,0
267530,True,6,Mostly Positive,682,174,856
267550,True,5,Mixed,245,193,438
267570,True,0,No user reviews,0,0,0
267580,True,0,No user reviews,0,0,0
267590,True,0,No user reviews,0,0,0
267591,True,0,No user reviews,0,0,0
267600,True,2,Very Negative,39,313,352
267610,True,4,Mostly Negative,38,122,160
267630,True,5,Mixed,42,43,85
267650,True,0,6 user reviews,6,0,6
267651,True,0,No user reviews,0,0,0
267652,True,0,1 user reviews,1,0,1
267653,True,0,3 user reviews,1,2,3
267654,True,0,No user reviews,0,0,0
267655,True,5,Mixed,10,9,19
267660,True,0,2 user reviews,2,0,2
267670,True,5,Mixed,15,11,26
267680,True,0,No user reviews,0,0,0
267710,True,0,No user reviews,0,0,0
267711,True,0,No user reviews,0,0,0
267712,True,0,No user reviews,0,0,0
267713,True,0,No user reviews,0,0,0
267714,True,0,No user reviews,0,0,0
267720,True,0,No user reviews,0,0,0
267730,True,5,Mixed,7,10,17
267750,True,5,Mixed,310,238,548
267770,True,0,5 user reviews,3,2,5
267771,True,0,3 user reviews,2,1,3
267772,True,6,Mostly Positive,8,3,11
267773,True,0,3 user reviews,2,1,3
267774,True,0,4 user reviews,3,1,4
267775,True,7,Positive,14,1,15
267776,True,0,1 user reviews,1,0,1
267777,True,0,1 user reviews,1,0,1
267778,True,0,3 user reviews,2,1,3
267780,True,0,9 user reviews,7,2,9
267781,True,0,4 user reviews,3,1,4
267782,True,0,9 user reviews,9,0,9
267783,True,0,2 user reviews,2,0,2
267784,True,7,Positive,14,1,15
267785,True,0,2 user reviews,2,0,2
267786,True,0,2 user reviews,2,0,2
267787,True,0,6 user reviews,5,1,6
267788,True,5,Mixed,7,5,12
267789,True,5,Mixed,8,5,13
267810,True,0,4 user reviews,4,0,4
267820,True,0,No user reviews,0,0,0
267830,True,0,No user reviews,0,0,0
267860,True,0,No user reviews,0,0,0
267861,True,0,No user reviews,0,0,0
267862,True,0,No user reviews,0,0,0
267863,True,0,No user reviews,0,0,0
267864,True,0,No user reviews,0,0,0
267870,True,0,No user reviews,0,0,0
267880,True,0,No user reviews,0,0,0
267890,True,0,No user reviews,0,0,0
267900,True,5,Mixed,42,49,91
267920,True,8,Very Positive,137,30,167
267940,True,5,Mixed,5,5,10
267960,True,4,Mostly Negative,6,15,21
267980,True,8,Very Positive,62,4,66
268030,True,0,No user reviews,0,0,0
268050,True,6,Mostly Positive,2949,1018,3967
268080,True,7,Positive,14,0,14
268081,True,0,No user reviews,0,0,0
268082,True,0,No user reviews,0,0,0
268090,True,8,Very Positive,124,7,131
268100,True,0,3 user reviews,3,0,3
268101,True,0,7 user reviews,6,1,7
268110,True,0,No user reviews,0,0,0
268111,True,0,No user reviews,0,0,0
268112,True,0,No user reviews,0,0,0
268113,True,0,No user reviews,0,0,0
268114,True,0,No user reviews,0,0,0
268115,True,0,No user reviews,0,0,0
268120,True,0,No user reviews,0,0,0
268121,True,0,No user reviews,0,0,0
268122,True,0,No user reviews,0,0,0
268123,True,0,No user reviews,0,0,0
268124,True,0,No user reviews,0,0,0
268125,True,0,No user reviews,0,0,0
268130,True,8,Very Positive,4296,242,4538
268200,True,5,Mixed,39,33,72
268220,True,8,Very Positive,241,42,283
268240,True,6,Mostly Positive,16,6,22
268260,True,5,Mixed,29,32,61
268280,True,0,3 user reviews,3,0,3
268281,True,0,No user reviews,0,0,0
268290,True,0,No user reviews,0,0,0
268291,True,0,No user reviews,0,0,0
268296,True,0,No user reviews,0,0,0
268297,True,0,No user reviews,0,0,0
268300,True,0,No user reviews,0,0,0
268310,True,0,No user reviews,0,0,0
268311,True,0,No user reviews,0,0,0
268312,True,0,No user reviews,0,0,0
268313,True,0,No user reviews,0,0,0
268314,True,0,No user reviews,0,0,0
268315,True,0,No user reviews,0,0,0
268320,True,8,Very Positive,157,17,174
268340,True,7,Positive,12,1,13
268360,True,5,Mixed,76,33,109
268400,True,8,Very Positive,751,77,828
268420,True,6,Mostly Positive,57,21,78
268500,True,8,Very Positive,20518,3377,23895
268520,True,0,8 user reviews,1,7,8
268540,True,5,Mixed,203,139,342
268560,True,0,No user reviews,0,0,0
268590,True,0,1 user reviews,1,0,1
268600,True,0,No user reviews,0,0,0
268610,True,0,3 user reviews,3,0,3
268611,True,0,2 user reviews,2,0,2
268612,True,0,2 user reviews,2,0,2
268613,True,0,3 user reviews,3,0,3
268614,True,0,5 user reviews,4,1,5
268620,True,0,5 user reviews,4,1,5
268650,True,8,Very Positive,4680,484,5164
268670,True,4,Mostly Negative,56,91,147
268710,True,5,Mixed,16,21,37
268750,True,8,Very Positive,2911,556,3467
268770,True,6,Mostly Positive,91,23,114
268810,True,6,Mostly Positive,73,22,95
268850,True,5,Mixed,25,13,38
268870,True,6,Mostly Positive,1122,359,1481
268890,True,4,Mostly Negative,69,139,208
268910,True,9,Overwhelmingly Positive,25956,1119,27075
268930,True,5,Mixed,29,21,50
268970,True,3,Negative,2,9,11
268990,True,8,Very Positive,290,18,308
269010,True,6,Mostly Positive,70,27,97
269030,True,8,Very Positive,721,159,880
269050,True,8,Very Positive,756,54,810
269110,True,6,Mostly Positive,277,77,354
269150,True,7,Positive,42,6,48
269170,True,8,Very Positive,487,76,563
269190,True,8,Very Positive,636,102,738
269210,True,6,Mostly Positive,4786,1881,6667
269230,True,8,Very Positive,137,28,165
269250,True,8,Very Positive,258,40,298
269270,True,8,Very Positive,463,40,503
269290,True,5,Mixed,168,192,360
269310,True,5,Mixed,284,166,450
269330,True,8,Very Positive,88,9,97
269350,True,4,Mostly Negative,22,37,59
269370,True,6,Mostly Positive,101,39,140
269390,True,0,No user reviews,0,0,0
269430,True,0,7 user reviews,2,5,7
269450,True,8,Very Positive,51,3,54
269470,True,5,Mixed,95,86,181
269490,True,8,Very Positive,361,49,410
269530,True,3,Negative,2,13,15
269550,True,5,Mixed,10,9,19
269570,True,8,Very Positive,61,10,71
269590,True,4,Mostly Negative,17,34,51
269610,True,5,Mixed,39,29,68
269630,True,4,Mostly Negative,5,8,13
269650,True,8,Very Positive,978,181,1159
269670,True,6,Mostly Positive,327,83,410
269690,True,6,Mostly Positive,110,43,153
269710,True,8,Very Positive,56,3,59
269730,True,5,Mixed,513,290,803
269770,True,8,Very Positive,1963,199,2162
269790,True,6,Mostly Positive,986,300,1286
269810,True,5,Mixed,90,40,130
269890,True,5,Mixed,38,53,91
269910,True,0,No user reviews,0,0,0
269950,True,8,Very Positive,3907,455,4362
269990,True,6,Mostly Positive,27,10,37
270010,True,8,Very Positive,190,26,216
270030,True,0,9 user reviews,8,1,9
270050,True,6,Mostly Positive,228,63,291
270070,True,5,Mixed,13,9,22
270090,True,4,Mostly Negative,49,74,123
270110,True,5,Mixed,170,88,258
270130,True,8,Very Positive,685,137,822
270150,True,8,Very Positive,3114,382,3496
270170,True,5,Mixed,18,12,30
270190,True,5,Mixed,24,15,39
270210,True,8,Very Positive,1904,192,2096
270230,True,8,Very Positive,57,12,69
270270,True,5,Mixed,156,105,261
270310,True,8,Very Positive,123,23,146
270330,True,3,Negative,4,17,21
270370,True,7,Positive,18,0,18
270410,True,5,Mixed,10,5,15
270430,True,0,8 user reviews,1,7,8
270450,True,8,Very Positive,1700,147,1847
270490,True,8,Very Positive,72,14,86
270510,True,5,Mixed,22,12,34
270550,True,8,Very Positive,3414,516,3930
270570,True,5,Mixed,15,7,22
270590,True,5,Mixed,19,18,37
270610,True,8,Very Positive,52,4,56
270630,True,8,Very Positive,564,102,666
270650,True,0,No user reviews,0,0,0
270660,True,0,No user reviews,0,0,0
270680,True,0,No user reviews,0,0,0
270700,True,0,3 user reviews,3,0,3
270740,True,0,No user reviews,0,0,0
270741,True,0,No user reviews,0,0,0
270742,True,0,No user reviews,0,0,0
270743,True,0,No user reviews,0,0,0
270744,True,0,No user reviews,0,0,0
270745,True,0,No user reviews,0,0,0
270750,True,7,Positive,12,2,14
270760,True,5,Mixed,6,4,10
270770,True,4,Mostly Negative,15,33,48
270790,True,6,Mostly Positive,55,19,74
270810,True,7,Positive,36,7,43
270830,True,5,Mixed,23,23,46
270850,True,6,Mostly Positive,1177,315,1492
270870,True,0,No user reviews,0,0,0
270871,True,0,No user reviews,0,0,0
270880,True,9,Overwhelmingly Positive,24063,974,25037
270900,True,0,No user reviews,0,0,0
270910,True,5,Mixed,149,164,313
270930,True,0,No user reviews,0,0,0
270940,True,0,5 user reviews,4,1,5
270941,True,0,3 user reviews,3,0,3
270942,True,0,2 user reviews,1,1,2
270950,True,6,Mostly Positive,107,33,140
270990,True,0,No user reviews,0,0,0
271000,True,0,No user reviews,0,0,0
271001,True,0,No user reviews,0,0,0
271002,True,0,No user reviews,0,0,0
271003,True,0,No user reviews,0,0,0
271004,True,0,No user reviews,0,0,0
271005,True,0,No user reviews,0,0,0
271030,True,7,Positive,33,4,37
271080,True,0,No user reviews,0,0,0
271090,True,0,2 user reviews,2,0,2
271100,True,0,2 user reviews,2,0,2
271110,True,0,9 user reviews,7,2,9
271120,True,0,No user reviews,0,0,0
271180,True,0,No user reviews,0,0,0
271240,True,6,Mostly Positive,1688,510,2198
271260,True,6,Mostly Positive,880,309,1189
271331,True,0,4 user reviews,2,2,4
271360,True,6,Mostly Positive,136,40,176
271370,True,4,Mostly Negative,37,63,100
271380,True,0,No user reviews,0,0,0
271381,True,0,No user reviews,0,0,0
271382,True,0,No user reviews,0,0,0
271383,True,0,No user reviews,0,0,0
271384,True,0,No user reviews,0,0,0
271385,True,0,No user reviews,0,0,0
271386,True,0,No user reviews,0,0,0
271387,True,0,No user reviews,0,0,0
271388,True,0,No user reviews,0,0,0
271389,True,0,No user reviews,0,0,0
271390,True,7,Positive,22,4,26
271400,True,6,Mostly Positive,9,3,12
271410,True,0,No user reviews,0,0,0
271411,True,0,No user reviews,0,0,0
271412,True,0,No user reviews,0,0,0
271413,True,0,No user reviews,0,0,0
271414,True,0,No user reviews,0,0,0
271415,True,0,No user reviews,0,0,0
271416,True,0,4 user reviews,3,1,4
271417,True,0,1 user reviews,1,0,1
271418,True,0,1 user reviews,1,0,1
271419,True,0,5 user reviews,5,0,5
271420,True,0,No user reviews,0,0,0
271421,True,0,No user reviews,0,0,0
271422,True,0,No user reviews,0,0,0
271423,True,0,1 user reviews,1,0,1
271424,True,0,No user reviews,0,0,0
271425,True,0,No user reviews,0,0,0
271426,True,0,No user reviews,0,0,0
271427,True,0,No user reviews,0,0,0
271428,True,0,No user reviews,0,0,0
271429,True,0,No user reviews,0,0,0
271430,True,0,No user reviews,0,0,0
271431,True,0,No user reviews,0,0,0
271432,True,0,1 user reviews,1,0,1
271433,True,0,1 user reviews,1,0,1
271438,True,0,No user reviews,0,0,0
271439,True,0,No user reviews,0,0,0
271440,True,0,No user reviews,0,0,0
271441,True,0,No user reviews,0,0,0
271442,True,0,No user reviews,0,0,0
271443,True,0,No user reviews,0,0,0
271444,True,0,1 user reviews,1,0,1
271445,True,0,No user reviews,0,0,0
271446,True,0,1 user reviews,1,0,1
271447,True,0,No user reviews,0,0,0
271448,True,0,No user reviews,0,0,0
271449,True,0,1 user reviews,1,0,1
271450,True,0,2 user reviews,2,0,2
271451,True,0,1 user reviews,1,0,1
271452,True,0,No user reviews,0,0,0
271453,True,0,No user reviews,0,0,0
271454,True,0,1 user reviews,0,1,1
271455,True,0,No user reviews,0,0,0
271456,True,0,2 user reviews,2,0,2
271457,True,0,2 user reviews,2,0,2
271458,True,0,No user reviews,0,0,0
271459,True,0,No user reviews,0,0,0
271460,True,0,No user reviews,0,0,0
271461,True,0,1 user reviews,0,1,1
271462,True,0,3 user reviews,1,2,3
271463,True,0,2 user reviews,2,0,2
271464,True,0,No user reviews,0,0,0
271465,True,0,No user reviews,0,0,0
271466,True,0,No user reviews,0,0,0
271467,True,0,No user reviews,0,0,0
271468,True,0,No user reviews,0,0,0
271469,True,0,1 user reviews,1,0,1
271470,True,0,No user reviews,0,0,0
271471,True,0,No user reviews,0,0,0
271472,True,0,3 user reviews,2,1,3
271473,True,0,No user reviews,0,0,0
271474,True,0,1 user reviews,1,0,1
271475,True,0,No user reviews,0,0,0
271476,True,0,No user reviews,0,0,0
271477,True,0,No user reviews,0,0,0
271478,True,0,No user reviews,0,0,0
271479,True,0,8 user reviews,4,4,8
271480,True,0,1 user reviews,1,0,1
271481,True,0,1 user reviews,1,0,1
271489,True,0,No user reviews,0,0,0
271490,True,0,No user reviews,0,0,0
271491,True,0,1 user reviews,1,0,1
271492,True,0,No user reviews,0,0,0
271497,True,0,No user reviews,0,0,0
271498,True,0,2 user reviews,0,2,2
271499,True,0,No user reviews,0,0,0
271500,True,4,Mostly Negative,105,266,371
271520,True,6,Mostly Positive,8,3,11
271530,True,0,No user reviews,0,0,0
271540,True,0,No user reviews,0,0,0
271550,True,7,Positive,30,2,32
271570,True,6,Mostly Positive,97,29,126
271590,True,6,Mostly Positive,192005,68170,260175
271640,True,0,2 user reviews,0,2,2
271670,True,8,Very Positive,192,23,215
271710,True,0,No user reviews,0,0,0
271730,True,5,Mixed,35,37,72
271750,True,0,No user reviews,0,0,0
271760,True,6,Mostly Positive,165,49,214
271800,True,0,2 user reviews,0,2,2
271801,True,0,1 user reviews,1,0,1
271802,True,0,4 user reviews,2,2,4
271810,True,0,No user reviews,0,0,0
271820,True,8,Very Positive,419,39,458
271840,True,0,No user reviews,0,0,0
271850,True,5,Mixed,55,42,97
271860,True,5,Mixed,48,31,79
271880,True,0,No user reviews,0,0,0
271900,True,8,Very Positive,723,39,762
271920,True,7,Positive,36,8,44
271940,True,0,No user reviews,0,0,0
271941,True,0,No user reviews,0,0,0
271942,True,6,Mostly Positive,28,9,37
271943,True,8,Very Positive,45,9,54
271944,True,8,Very Positive,53,11,64
271950,True,0,5 user reviews,4,1,5
271960,True,0,2 user reviews,2,0,2
271961,True,0,2 user reviews,2,0,2
271962,True,0,3 user reviews,3,0,3
271963,True,0,2 user reviews,2,0,2
271964,True,0,4 user reviews,4,0,4
271970,True,8,Very Positive,95,16,111
271990,True,6,Mostly Positive,11,3,14
272010,True,6,Mostly Positive,35,12,47
272030,True,0,No user reviews,0,0,0
272040,True,8,Very Positive,281,12,293
272060,True,5,Mixed,18,12,30
272080,True,0,3 user reviews,1,2,3
272083,True,0,2 user reviews,1,1,2
272084,True,0,1 user reviews,1,0,1
272090,True,0,1 user reviews,0,1,1
272100,True,0,8 user reviews,8,0,8
272230,True,8,Very Positive,1037,235,1272
272260,True,0,No user reviews,0,0,0
272261,True,0,No user reviews,0,0,0
272270,True,5,Mixed,767,331,1098
272290,True,0,No user reviews,0,0,0
272300,True,5,Mixed,4,6,10
272330,True,8,Very Positive,61,10,71
272350,True,0,No user reviews,0,0,0
272390,True,0,No user reviews,0,0,0
272470,True,5,Mixed,445,233,678
272490,True,4,Mostly Negative,2,8,10
272510,True,6,Mostly Positive,1199,349,1548
272600,True,8,Very Positive,849,47,896
272620,True,8,Very Positive,115,27,142
272640,True,0,No user reviews,0,0,0
272670,True,8,Very Positive,182,3,185
272680,True,6,Mostly Positive,37,12,49
272690,True,0,1 user reviews,0,1,1
272700,True,6,Mostly Positive,11,3,14
272710,True,5,Mixed,6,5,11
272770,True,0,9 user reviews,9,0,9
272830,True,0,No user reviews,0,0,0
272860,True,0,No user reviews,0,0,0
272880,True,0,No user reviews,0,0,0
272890,True,5,Mixed,46,24,70
272910,True,0,No user reviews,0,0,0
272920,True,0,No user reviews,0,0,0
272950,True,0,4 user reviews,4,0,4
272960,True,0,No user reviews,0,0,0
272970,True,0,2 user reviews,1,1,2
272990,True,7,Positive,38,7,45
273030,True,2,Very Negative,12,62,74
273070,True,6,Mostly Positive,226,84,310
273110,True,5,Mixed,107,73,180
273130,True,0,No user reviews,0,0,0
273150,True,0,8 user reviews,7,1,8
273151,True,0,9 user reviews,6,3,9
273152,True,0,3 user reviews,3,0,3
273153,True,5,Mixed,13,6,19
273240,True,5,Mixed,77,36,113
273280,True,0,No user reviews,0,0,0
273290,True,0,No user reviews,0,0,0
273300,True,9,Overwhelmingly Positive,602,19,621
273350,True,5,Mixed,3180,1840,5020
273370,True,0,No user reviews,0,0,0
273380,True,5,Mixed,49,23,72
273381,True,5,Mixed,31,25,56
273390,True,8,Very Positive,82,4,86
273450,True,0,No user reviews,0,0,0
273480,True,0,No user reviews,0,0,0
273490,True,0,No user reviews,0,0,0
273500,True,8,Very Positive,281,52,333
273520,True,0,No user reviews,0,0,0
273521,True,0,No user reviews,0,0,0
273522,True,0,3 user reviews,2,1,3
273523,True,0,No user reviews,0,0,0
273524,True,0,1 user reviews,1,0,1
273525,True,0,1 user reviews,0,1,1
273526,True,0,2 user reviews,2,0,2
273527,True,0,No user reviews,0,0,0
273530,True,0,No user reviews,0,0,0
273540,True,0,1 user reviews,0,1,1
273550,True,0,No user reviews,0,0,0
273570,True,8,Very Positive,252,10,262
273580,True,8,Very Positive,76,4,80
273590,True,6,Mostly Positive,36,14,50
273600,True,6,Mostly Positive,99,28,127
273620,True,6,Mostly Positive,142,42,184
273670,True,0,No user reviews,0,0,0
273680,True,0,1 user reviews,1,0,1
273700,True,0,No user reviews,0,0,0
273730,True,4,Mostly Negative,14,52,66
273740,True,3,Negative,1,20,21
273750,True,5,Mixed,25,16,41
273760,True,2,Very Negative,6,49,55
273770,True,2,Very Negative,19,209,228
273790,True,0,5 user reviews,2,3,5
273800,True,4,Mostly Negative,5,11,16
273820,True,3,Negative,6,26,32
273830,True,3,Negative,0,11,11
273840,True,8,Very Positive,115,26,141
273850,True,0,9 user reviews,0,9,9
273860,True,0,7 user reviews,2,5,7
273890,True,0,6 user reviews,3,3,6
273940,True,4,Mostly Negative,17,30,47
273960,True,5,Mixed,34,41,75
274010,True,5,Mixed,14,18,32
274050,True,6,Mostly Positive,14,5,19
274100,True,0,No user reviews,0,0,0
274110,True,0,No user reviews,0,0,0
274111,True,0,No user reviews,0,0,0
274112,True,0,No user reviews,0,0,0
274120,True,0,9 user reviews,6,3,9
274121,True,0,6 user reviews,5,1,6
274122,True,0,7 user reviews,6,1,7
274123,True,8,Very Positive,90,4,94
274130,True,5,Mixed,108,79,187
274150,True,0,No user reviews,0,0,0
274160,True,0,No user reviews,0,0,0
274161,True,0,2 user reviews,2,0,2
274170,True,8,Very Positive,11418,1233,12651
274190,True,9,Overwhelmingly Positive,14692,507,15199
274230,True,5,Mixed,519,226,745
274250,True,8,Very Positive,212,52,264
274270,True,8,Very Positive,801,129,930
274290,True,5,Mixed,809,437,1246
274310,True,6,Mostly Positive,900,226,1126
274350,True,9,Overwhelmingly Positive,677,35,712
274390,True,0,No user reviews,0,0,0
274430,True,0,5 user reviews,5,0,5
274431,True,0,8 user reviews,6,2,8
274440,True,5,Mixed,10,6,16
274450,True,8,Very Positive,63,13,76
274470,True,0,No user reviews,0,0,0
274471,True,0,No user reviews,0,0,0
274480,True,8,Very Positive,188,28,216
274500,True,9,Overwhelmingly Positive,2176,71,2247
274520,True,8,Very Positive,3485,207,3692
274560,True,5,Mixed,352,188,540
274620,True,5,Mixed,24,15,39
274700,True,8,Very Positive,55,2,57
274800,True,0,No user reviews,0,0,0
274880,True,8,Very Positive,49,12,61
274900,True,8,Very Positive,2366,285,2651
274920,True,8,Very Positive,2053,488,2541
274940,True,8,Very Positive,7626,812,8438
274960,True,4,Mostly Negative,7,23,30
274980,True,6,Mostly Positive,445,157,602
275000,True,0,No user reviews,0,0,0
275020,True,0,8 user reviews,8,0,8
275030,True,0,8 user reviews,6,2,8
275050,True,0,1 user reviews,0,1,1
275060,True,4,Mostly Negative,18,63,81
275080,True,5,Mixed,42,49,91
275100,True,8,Very Positive,1222,215,1437
275124,True,0,1 user reviews,0,1,1
275125,True,0,1 user reviews,1,0,1
275127,True,0,1 user reviews,1,0,1
275128,True,0,1 user reviews,0,1,1
275134,True,0,3 user reviews,3,0,3
275138,True,0,1 user reviews,1,0,1
275139,True,0,1 user reviews,0,1,1
275144,True,0,4 user reviews,3,1,4
275163,True,0,2 user reviews,2,0,2
275170,True,0,No user reviews,0,0,0
275171,True,0,No user reviews,0,0,0
275180,True,8,Very Positive,331,51,382
275200,True,8,Very Positive,781,67,848
275240,True,0,1 user reviews,0,1,1
275290,True,8,Very Positive,205,51,256
275310,True,4,Mostly Negative,5,20,25
275330,True,0,3 user reviews,1,2,3
275350,True,6,Mostly Positive,40,12,52
275370,True,0,No user reviews,0,0,0
275390,True,8,Very Positive,800,59,859
275440,True,0,No user reviews,0,0,0
275470,True,6,Mostly Positive,52,19,71
275490,True,5,Mixed,7,4,11
275510,True,5,Mixed,31,38,69
275530,True,5,Mixed,207,107,314
275550,True,0,No user reviews,0,0,0
275551,True,0,No user reviews,0,0,0
275552,True,0,No user reviews,0,0,0
275553,True,0,No user reviews,0,0,0
275554,True,0,No user reviews,0,0,0
275560,True,6,Mostly Positive,9,3,12
275570,True,8,Very Positive,179,38,217
275590,True,5,Mixed,119,104,223
275610,True,5,Mixed,200,179,379
275670,True,8,Very Positive,911,161,1072
275690,True,8,Very Positive,178,20,198
275700,True,8,Very Positive,200,25,225
275710,True,0,No user reviews,0,0,0
275800,True,0,2 user reviews,1,1,2
275804,True,0,1 user reviews,1,0,1
275805,True,0,2 user reviews,2,0,2
275806,True,0,2 user reviews,1,1,2
275807,True,0,1 user reviews,0,1,1
275809,True,0,No user reviews,0,0,0
275810,True,6,Mostly Positive,12,4,16
275830,True,7,Positive,16,0,16
275850,True,5,Mixed,57831,34566,92397
276020,True,0,No user reviews,0,0,0
276060,True,0,No user reviews,0,0,0
276160,True,0,No user reviews,0,0,0
276190,True,0,4 user reviews,1,3,4
276200,True,0,No user reviews,0,0,0
276210,True,0,9 user reviews,9,0,9
276220,True,5,Mixed,10,12,22
276240,True,6,Mostly Positive,8,3,11
276300,True,5,Mixed,8,7,15
276340,True,8,Very Positive,66,13,79
276360,True,5,Mixed,14,11,25
276380,True,0,7 user reviews,1,6,7
276430,True,0,9 user reviews,4,5,9
276440,True,5,Mixed,6,8,14
276460,True,0,5 user reviews,1,4,5
276550,True,0,7 user reviews,7,0,7
276551,True,0,8 user reviews,5,3,8
276552,True,7,Positive,12,1,13
276730,True,5,Mixed,7,5,12
276750,True,6,Mostly Positive,29,10,39
276810,True,6,Mostly Positive,2559,1037,3596
276870,True,5,Mixed,77,51,128
276890,True,8,Very Positive,87,18,105
277110,True,6,Mostly Positive,75,26,101
277150,True,0,1 user reviews,1,0,1
277170,True,0,4 user reviews,2,2,4
277210,True,0,1 user reviews,1,0,1
277230,True,0,2 user reviews,2,0,2
277250,True,0,6 user reviews,4,2,6
277270,True,5,Mixed,27,14,41
277390,True,8,Very Positive,84,11,95
277430,True,6,Mostly Positive,1450,429,1879
277450,True,6,Mostly Positive,308,106,414
277460,True,6,Mostly Positive,144,46,190
277470,True,5,Mixed,45,37,82
277490,True,8,Very Positive,94,23,117
277500,True,4,Mostly Negative,30,53,83
277510,True,5,Mixed,7,6,13
277520,True,5,Mixed,17,22,39
277530,True,0,No user reviews,0,0,0
277531,True,0,No user reviews,0,0,0
277540,True,4,Mostly Negative,4,7,11
277560,True,5,Mixed,12,16,28
277580,True,0,No user reviews,0,0,0
277581,True,0,No user reviews,0,0,0
277590,True,6,Mostly Positive,381,152,533
277630,True,7,Positive,39,9,48
277650,True,7,Positive,33,8,41
277670,True,0,2 user reviews,0,2,2
277671,True,0,3 user reviews,3,0,3
277672,True,0,2 user reviews,2,0,2
277673,True,0,1 user reviews,1,0,1
277674,True,0,2 user reviews,2,0,2
277675,True,0,2 user reviews,2,0,2
277676,True,0,No user reviews,0,0,0
277677,True,0,1 user reviews,1,0,1
277678,True,0,2 user reviews,2,0,2
277679,True,0,No user reviews,0,0,0
277680,True,8,Very Positive,180,28,208
277700,True,8,Very Positive,51,5,56
277720,True,0,3 user reviews,1,2,3
277721,True,0,3 user reviews,2,1,3
277730,True,0,8 user reviews,3,5,8
277731,True,0,9 user reviews,8,1,9
277732,True,5,Mixed,13,8,21
277733,True,5,Mixed,8,8,16
277734,True,0,No user reviews,0,0,0
277735,True,0,8 user reviews,7,1,8
277736,True,0,8 user reviews,8,0,8
277737,True,3,Negative,2,9,11
277739,True,6,Mostly Positive,22,6,28
277740,True,8,Very Positive,84,1,85
277741,True,0,8 user reviews,6,2,8
277742,True,7,Positive,17,4,21
277743,True,0,No user reviews,0,0,0
277745,True,7,Positive,27,0,27
277747,True,5,Mixed,25,11,36
277748,True,7,Positive,38,3,41
277749,True,0,6 user reviews,4,2,6
277751,True,0,5 user reviews,5,0,5
277752,True,5,Mixed,26,17,43
277753,True,7,Positive,14,0,14
277754,True,7,Positive,19,2,21
277755,True,7,Positive,8,2,10
277756,True,7,Positive,11,1,12
277757,True,7,Positive,13,0,13
277758,True,0,4 user reviews,3,1,4
277759,True,7,Positive,13,2,15
277760,True,7,Positive,30,5,35
277761,True,7,Positive,12,3,15
277762,True,7,Positive,16,1,17
277763,True,7,Positive,23,2,25
277764,True,6,Mostly Positive,7,3,10
277765,True,7,Positive,15,2,17
277767,True,5,Mixed,11,6,17
277768,True,5,Mixed,10,6,16
277769,True,7,Positive,27,5,32
277770,True,0,6 user reviews,5,1,6
277771,True,7,Positive,20,1,21
277773,True,5,Mixed,25,16,41
277774,True,7,Positive,8,2,10
277776,True,0,4 user reviews,3,1,4
277777,True,7,Positive,43,2,45
277778,True,0,6 user reviews,6,0,6
277779,True,0,No user reviews,0,0,0
277820,True,7,Positive,13,1,14
277821,True,6,Mostly Positive,14,5,19
277830,True,8,Very Positive,70,16,86
277840,True,0,3 user reviews,3,0,3
277841,True,0,1 user reviews,1,0,1
277842,True,0,1 user reviews,1,0,1
277843,True,0,7 user reviews,2,5,7
277844,True,0,No user reviews,0,0,0
277845,True,0,No user reviews,0,0,0
277846,True,0,No user reviews,0,0,0
277850,True,6,Mostly Positive,14,4,18
277870,True,6,Mostly Positive,178,76,254
277890,True,8,Very Positive,488,61,549
277910,True,5,Mixed,59,30,89
277930,True,4,Mostly Negative,211,326,537
277950,True,5,Mixed,67,33,100
277970,True,0,No user reviews,0,0,0
277971,True,0,No user reviews,0,0,0
277972,True,0,No user reviews,0,0,0
277973,True,0,No user reviews,0,0,0
277974,True,0,No user reviews,0,0,0
277975,True,0,No user reviews,0,0,0
277976,True,0,No user reviews,0,0,0
277977,True,0,No user reviews,0,0,0
277990,True,0,No user reviews,0,0,0
278030,True,0,No user reviews,0,0,0
278031,True,0,No user reviews,0,0,0
278080,True,6,Mostly Positive,2077,542,2619
278100,True,8,Very Positive,131,19,150
278120,True,7,Positive,14,2,16
278130,True,0,No user reviews,0,0,0
278131,True,0,4 user reviews,4,0,4
278140,True,0,No user reviews,0,0,0
278190,True,5,Mixed,28,14,42
278210,True,7,Positive,26,1,27
278360,True,8,Very Positive,6078,493,6571
278420,True,7,Positive,29,4,33
278440,True,6,Mostly Positive,71,26,97
278460,True,8,Very Positive,337,39,376
278480,True,0,2 user reviews,0,2,2
278481,True,0,1 user reviews,0,1,1
278490,True,7,Positive,12,3,15
278510,True,7,Positive,24,1,25
278530,True,6,Mostly Positive,20,8,28
278550,True,5,Mixed,25,12,37
278570,True,8,Very Positive,88,20,108
278590,True,6,Mostly Positive,11,3,14
278620,True,5,Mixed,118,62,180
278640,True,5,Mixed,60,26,86
278700,True,0,No user reviews,0,0,0
278701,True,0,1 user reviews,1,0,1
278710,True,5,Mixed,5,5,10
278711,True,5,Mixed,5,5,10
278712,True,5,Mixed,12,9,21
278720,True,0,No user reviews,0,0,0
278730,True,0,No user reviews,0,0,0
278731,True,0,No user reviews,0,0,0
278732,True,0,No user reviews,0,0,0
278733,True,0,No user reviews,0,0,0
278734,True,0,No user reviews,0,0,0
278735,True,0,No user reviews,0,0,0
278736,True,0,No user reviews,0,0,0
278737,True,0,No user reviews,0,0,0
278810,True,5,Mixed,49,35,84
278850,True,0,3 user reviews,1,2,3
278890,True,6,Mostly Positive,112,36,148
278910,True,6,Mostly Positive,337,90,427
278930,True,6,Mostly Positive,87,23,110
278970,True,3,Negative,7,33,40
279070,True,8,Very Positive,77,11,88
279090,True,0,No user reviews,0,0,0
279100,True,0,No user reviews,0,0,0
279110,True,0,2 user reviews,2,0,2
279111,True,0,2 user reviews,0,2,2
279112,True,0,2 user reviews,1,1,2
279120,True,0,No user reviews,0,0,0
279140,True,6,Mostly Positive,193,59,252
279160,True,5,Mixed,64,36,100
279260,True,6,Mostly Positive,156,54,210
279280,True,0,No user reviews,0,0,0
279420,True,7,Positive,15,3,18
279440,True,6,Mostly Positive,172,62,234
279460,True,4,Mostly Negative,4,8,12
279480,True,5,Mixed,9,7,16
279500,True,5,Mixed,8,9,17
279520,True,5,Mixed,5,6,11
279540,True,6,Mostly Positive,67,19,86
279560,True,5,Mixed,10,7,17
279580,True,5,Mixed,35,19,54
279600,True,5,Mixed,25,24,49
279601,True,0,8 user reviews,3,5,8
279602,True,5,Mixed,11,8,19
279603,True,0,8 user reviews,4,4,8
279620,True,5,Mixed,36,42,78
279621,True,0,5 user reviews,2,3,5
279622,True,5,Mixed,8,4,12
279623,True,4,Mostly Negative,34,58,92
279640,True,7,Positive,28,7,35
279720,True,5,Mixed,81,47,128
279740,True,5,Mixed,12,11,23
279800,True,8,Very Positive,229,8,237
279820,True,0,1 user reviews,1,0,1
279830,True,0,1 user reviews,1,0,1
279840,True,7,Positive,19,0,19
279900,True,5,Mixed,36,19,55
279920,True,5,Mixed,35,16,51
279940,True,8,Very Positive,225,33,258
279960,True,0,3 user reviews,3,0,3
279961,True,0,4 user reviews,3,1,4
279962,True,0,2 user reviews,1,1,2
279963,True,0,2 user reviews,1,1,2
279964,True,0,2 user reviews,1,1,2
279965,True,0,2 user reviews,2,0,2
279966,True,0,1 user reviews,1,0,1
279967,True,0,4 user reviews,4,0,4
279968,True,0,1 user reviews,1,0,1
279990,True,5,Mixed,22,10,32
280010,True,0,6 user reviews,3,3,6
280030,True,0,No user reviews,0,0,0
280031,True,0,No user reviews,0,0,0
280032,True,0,No user reviews,0,0,0
280040,True,5,Mixed,125,54,179
280140,True,5,Mixed,64,28,92
280160,True,8,Very Positive,2380,276,2656
280180,True,8,Very Positive,705,127,832
280200,True,7,Positive,19,3,22
280220,True,9,Overwhelmingly Positive,2256,80,2336
280320,True,5,Mixed,203,146,349
280360,True,5,Mixed,144,137,281
280380,True,3,Negative,4,22,26
280440,True,8,Very Positive,53,11,64
280460,True,5,Mixed,25,14,39
280500,True,0,8 user reviews,6,2,8
280520,True,6,Mostly Positive,511,151,662
280540,True,5,Mixed,67,30,97
280560,True,8,Very Positive,201,11,212
280600,True,8,Very Positive,189,37,226
280620,True,0,6 user reviews,4,2,6
280640,True,3,Negative,4,19,23
280680,True,8,Very Positive,509,42,551
280720,True,6,Mostly Positive,181,49,230
280740,True,6,Mostly Positive,1772,545,2317
280760,True,0,No user reviews,0,0,0
280761,True,0,No user reviews,0,0,0
280762,True,0,No user reviews,0,0,0
280763,True,0,No user reviews,0,0,0
280790,True,8,Very Positive,817,151,968
280830,True,5,Mixed,18,17,35
280850,True,5,Mixed,23,13,36
280890,True,5,Mixed,26,29,55
280910,True,8,Very Positive,123,12,135
280930,True,8,Very Positive,56,6,62
281050,True,7,Positive,20,3,23
281060,True,6,Mostly Positive,21,6,27
281080,True,0,2 user reviews,2,0,2
281100,True,0,1 user reviews,1,0,1
281102,True,0,6 user reviews,1,5,6
281103,True,0,1 user reviews,1,0,1
281130,True,2,Very Negative,10,75,85
281150,True,0,No user reviews,0,0,0
281200,True,6,Mostly Positive,70,20,90
281220,True,5,Mixed,138,112,250
281240,True,5,Mixed,30,13,43
281260,True,5,Mixed,16,21,37
281280,True,6,Mostly Positive,109,31,140
281340,True,0,4 user reviews,3,1,4
281341,True,0,No user reviews,0,0,0
281342,True,0,1 user reviews,1,0,1
281343,True,0,3 user reviews,3,0,3
281344,True,0,2 user reviews,1,1,2
281345,True,0,No user reviews,0,0,0
281346,True,0,4 user reviews,4,0,4
281347,True,0,No user reviews,0,0,0
281350,True,4,Mostly Negative,17,40,57
281370,True,4,Mostly Negative,146,323,469
281390,True,6,Mostly Positive,37,15,52
281410,True,6,Mostly Positive,131,46,177
281430,True,5,Mixed,33,27,60
281450,True,8,Very Positive,68,15,83
281510,True,0,No user reviews,0,0,0
281511,True,0,1 user reviews,1,0,1
281560,True,5,Mixed,6,4,10
281580,True,5,Mixed,30,29,59
281600,True,0,1 user reviews,1,0,1
281601,True,0,1 user reviews,1,0,1
281602,True,0,1 user reviews,1,0,1
281603,True,0,2 user reviews,2,0,2
281604,True,0,1 user reviews,1,0,1
281606,True,0,1 user reviews,1,0,1
281607,True,0,1 user reviews,1,0,1
281610,True,8,Very Positive,2386,593,2979
281630,True,0,No user reviews,0,0,0
281640,True,8,Very Positive,1113,113,1226
281720,True,0,No user reviews,0,0,0
281721,True,0,No user reviews,0,0,0
281722,True,0,No user reviews,0,0,0
281723,True,0,No user reviews,0,0,0
281724,True,0,No user reviews,0,0,0
281725,True,0,No user reviews,0,0,0
281750,True,6,Mostly Positive,133,36,169
281770,True,6,Mostly Positive,7,3,10
281780,True,0,4 user reviews,4,0,4
281810,True,0,1 user reviews,1,0,1
281811,True,0,1 user reviews,1,0,1
281812,True,0,1 user reviews,1,0,1
281820,True,6,Mostly Positive,17,6,23
281840,True,4,Mostly Negative,22,47,69
281860,True,7,Positive,37,2,39
281900,True,5,Mixed,5,6,11
281920,True,8,Very Positive,514,76,590
281940,True,5,Mixed,203,177,380
281960,True,0,No user reviews,0,0,0
281970,True,0,No user reviews,0,0,0
281980,True,0,No user reviews,0,0,0
281981,True,0,No user reviews,0,0,0
281990,True,8,Very Positive,32071,4764,36835
282010,True,8,Very Positive,99,19,118
282030,True,8,Very Positive,96,16,112
282050,True,5,Mixed,152,150,302
282070,True,8,Very Positive,16338,1244,17582
282100,True,8,Very Positive,53,6,59
282130,True,0,No user reviews,0,0,0
282131,True,0,No user reviews,0,0,0
282132,True,0,No user reviews,0,0,0
282140,True,9,Overwhelmingly Positive,10764,497,11261
282160,True,0,No user reviews,0,0,0
282201,True,0,1 user reviews,1,0,1
282210,True,5,Mixed,601,609,1210
282230,True,0,No user reviews,0,0,0
282240,True,0,No user reviews,0,0,0
282250,True,0,1 user reviews,0,1,1
282270,True,0,No user reviews,0,0,0
282280,True,0,3 user reviews,2,1,3
282350,True,5,Mixed,737,355,1092
282370,True,0,No user reviews,0,0,0
282400,True,6,Mostly Positive,575,166,741
282440,True,8,Very Positive,1155,192,1347
282470,True,9,Overwhelmingly Positive,487,15,502
282500,True,0,No user reviews,0,0,0
282510,True,6,Mostly Positive,80,31,111
282511,True,5,Mixed,56,39,95
282512,True,6,Mostly Positive,20,6,26
282513,True,7,Positive,17,4,21
282514,True,7,Positive,28,5,33
282515,True,7,Positive,16,3,19
282516,True,6,Mostly Positive,17,6,23
282520,True,0,3 user reviews,3,0,3
282530,True,6,Mostly Positive,341,114,455
282550,True,0,1 user reviews,0,1,1
282560,True,4,Mostly Negative,450,1292,1742
282580,True,0,No user reviews,0,0,0
282590,True,8,Very Positive,411,91,502
282620,True,5,Mixed,31,16,47
282640,True,7,Positive,18,1,19
282660,True,4,Mostly Negative,5,14,19
282680,True,6,Mostly Positive,35,13,48
282740,True,0,5 user reviews,4,1,5
282760,True,8,Very Positive,565,106,671
282780,True,6,Mostly Positive,50,18,68
282800,True,8,Very Positive,5834,333,6167
282860,True,4,Mostly Negative,32,74,106
282880,True,5,Mixed,33,23,56
282900,True,8,Very Positive,4925,294,5219
282960,True,0,1 user reviews,1,0,1
283000,True,5,Mixed,23,23,46
283020,True,0,9 user reviews,3,6,9
283040,True,4,Mostly Negative,6,10,16
283060,True,0,6 user reviews,1,5,6
283080,True,8,Very Positive,143,24,167
283100,True,4,Mostly Negative,28,98,126
283160,True,8,Very Positive,1068,115,1183
283180,True,6,Mostly Positive,36,11,47
283230,True,5,Mixed,100,59,159
283270,True,8,Very Positive,54,6,60
283290,True,8,Very Positive,415,55,470
283310,True,5,Mixed,23,10,33
283330,True,0,8 user reviews,5,3,8
283350,True,4,Mostly Negative,14,22,36
283370,True,5,Mixed,12,15,27
283390,True,5,Mixed,21,12,33
283410,True,5,Mixed,13,13,26
283430,True,7,Positive,9,2,11
283450,True,5,Mixed,14,16,30
283470,True,3,Negative,3,13,16
283490,True,5,Mixed,10,7,17
283530,True,0,7 user reviews,1,6,7
283540,True,0,No user reviews,0,0,0
283541,True,0,No user reviews,0,0,0
283542,True,0,2 user reviews,1,1,2
283550,True,0,9 user reviews,8,1,9
283551,True,0,8 user reviews,8,0,8
283552,True,0,6 user reviews,4,2,6
283560,True,4,Mostly Negative,25,40,65
283580,True,5,Mixed,26,29,55
283600,True,5,Mixed,27,16,43
283620,True,6,Mostly Positive,241,80,321
283640,True,8,Very Positive,3771,431,4202
283660,True,5,Mixed,46,27,73
283680,True,8,Very Positive,421,53,474
283740,True,5,Mixed,195,156,351
283750,True,0,5 user reviews,4,1,5
283810,True,0,No user reviews,0,0,0
283811,True,0,No user reviews,0,0,0
283812,True,0,No user reviews,0,0,0
283813,True,0,No user reviews,0,0,0
283820,True,7,Positive,34,3,37
283840,True,7,Positive,31,3,34
283880,True,0,9 user reviews,7,2,9
283900,True,0,No user reviews,0,0,0
283920,True,8,Very Positive,96,4,100
283940,True,8,Very Positive,221,6,227
283960,True,9,Overwhelmingly Positive,512,10,522
283980,True,8,Very Positive,201,8,209
284000,True,7,Positive,24,3,27
284020,True,7,Positive,27,3,30
284040,True,0,No user reviews,0,0,0
284050,True,8,Very Positive,248,16,264
284070,True,0,1 user reviews,1,0,1
284080,True,0,No user reviews,0,0,0
284100,True,5,Mixed,63,53,116
284140,True,5,Mixed,21,17,38
284160,True,9,Overwhelmingly Positive,25000,1178,26178
284180,True,8,Very Positive,43,9,52
284200,True,0,No user reviews,0,0,0
284220,True,7,Positive,10,2,12
284240,True,8,Very Positive,347,61,408
284260,True,8,Very Positive,101,14,115
284290,True,4,Mostly Negative,15,23,38
284390,True,8,Very Positive,643,34,677
284410,True,6,Mostly Positive,10,4,14
284430,True,7,Positive,13,2,15
284440,True,6,Mostly Positive,29,9,38
284441,True,6,Mostly Positive,26,8,34
284450,True,7,Positive,42,4,46
284460,True,8,Very Positive,803,138,941
284480,True,0,No user reviews,0,0,0
284500,True,6,Mostly Positive,11,4,15
284510,True,0,No user reviews,0,0,0
284511,True,0,No user reviews,0,0,0
284512,True,0,No user reviews,0,0,0
284580,True,4,Mostly Negative,4,7,11
284670,True,0,No user reviews,0,0,0
284671,True,0,No user reviews,0,0,0
284672,True,0,No user reviews,0,0,0
284680,True,0,3 user reviews,2,1,3
284700,True,0,No user reviews,0,0,0
284710,True,8,Very Positive,210,20,230
284730,True,8,Very Positive,103,12,115
284750,True,8,Very Positive,243,39,282
284770,True,8,Very Positive,280,11,291
284790,True,8,Very Positive,158,8,166
284810,True,8,Very Positive,127,3,130
284830,True,8,Very Positive,200,28,228
284850,True,8,Very Positive,278,10,288
284870,True,8,Very Positive,180,29,209
284890,True,6,Mostly Positive,119,30,149
284910,True,0,2 user reviews,1,1,2
284930,True,5,Mixed,12,13,25
284950,True,6,Mostly Positive,178,53,231
284970,True,5,Mixed,15,21,36
284990,True,5,Mixed,54,42,96
285010,True,6,Mostly Positive,51,21,72
285030,True,0,6 user reviews,4,2,6
285050,True,5,Mixed,140,75,215
285070,True,6,Mostly Positive,30,10,40
285110,True,8,Very Positive,492,79,571
285130,True,5,Mixed,34,24,58
285150,True,0,5 user reviews,5,0,5
285160,True,5,Mixed,701,360,1061
285190,True,5,Mixed,2438,3020,5458
285230,True,0,No user reviews,0,0,0
285250,True,0,No user reviews,0,0,0
285270,True,0,No user reviews,0,0,0
285290,True,0,No user reviews,0,0,0
285310,True,8,Very Positive,2887,166,3053
285330,True,8,Very Positive,1897,267,2164
285350,True,0,6 user reviews,4,2,6
285370,True,0,1 user reviews,1,0,1
285380,True,5,Mixed,67,67,134
285400,True,5,Mixed,15,11,26
285420,True,7,Positive,24,2,26
285440,True,8,Very Positive,587,31,618
285460,True,0,2 user reviews,2,0,2
285461,True,0,8 user reviews,6,2,8
285462,True,0,4 user reviews,2,2,4
285470,True,0,3 user reviews,3,0,3
285480,True,4,Mostly Negative,61,100,161
285500,True,5,Mixed,227,110,337
285520,True,5,Mixed,20,9,29
285540,True,0,2 user reviews,1,1,2
285550,True,0,3 user reviews,3,0,3
285580,True,0,2 user reviews,0,2,2
285600,True,0,No user reviews,0,0,0
285610,True,0,No user reviews,0,0,0
285611,True,0,No user reviews,0,0,0
285612,True,0,No user reviews,0,0,0
285613,True,0,No user reviews,0,0,0
285614,True,0,No user reviews,0,0,0
285615,True,0,No user reviews,0,0,0
285616,True,0,No user reviews,0,0,0
285617,True,0,No user reviews,0,0,0
285618,True,0,No user reviews,0,0,0
285619,True,0,No user reviews,0,0,0
285620,True,0,No user reviews,0,0,0
285621,True,0,No user reviews,0,0,0
285622,True,0,No user reviews,0,0,0
285623,True,0,No user reviews,0,0,0
285625,True,0,No user reviews,0,0,0
285626,True,0,No user reviews,0,0,0
285630,True,0,No user reviews,0,0,0
285663,True,0,No user reviews,0,0,0
285670,True,0,3 user reviews,0,3,3
285690,True,0,No user reviews,0,0,0
285730,True,0,3 user reviews,3,0,3
285740,True,8,Very Positive,507,29,536
285800,True,6,Mostly Positive,276,88,364
285820,True,8,Very Positive,182,15,197
285840,True,8,Very Positive,63,15,78
285900,True,6,Mostly Positive,8314,2821,11135
285920,True,8,Very Positive,6081,604,6685
285960,True,5,Mixed,67,55,122
285980,True,7,Positive,24,4,28
286000,True,8,Very Positive,1134,238,1372
286040,True,6,Mostly Positive,863,354,1217
286080,True,7,Positive,16,2,18
286100,True,7,Positive,28,1,29
286120,True,4,Mostly Negative,21,43,64
286140,True,6,Mostly Positive,99,36,135
286160,True,9,Overwhelmingly Positive,14671,599,15270
286200,True,6,Mostly Positive,20,8,28
286220,True,5,Mixed,28,19,47
286240,True,8,Very Positive,310,23,333
286260,True,8,Very Positive,598,52,650
286280,True,6,Mostly Positive,114,30,144
286300,True,7,Positive,25,6,31
286320,True,8,Very Positive,163,13,176
286340,True,5,Mixed,1260,570,1830
286360,True,5,Mixed,28,17,45
286380,True,8,Very Positive,83,7,90
286460,True,8,Very Positive,114,12,126
286480,True,8,Very Positive,90,15,105
286500,True,8,Very Positive,107,2,109
286520,True,5,Mixed,6,7,13
286540,True,8,Very Positive,92,9,101
286570,True,5,Mixed,192,266,458
286630,True,0,No user reviews,0,0,0
286631,True,0,No user reviews,0,0,0
286632,True,0,1 user reviews,1,0,1
286633,True,0,5 user reviews,3,2,5
286634,True,0,6 user reviews,6,0,6
286635,True,7,Positive,10,1,11
286636,True,7,Positive,9,1,10
286650,True,0,No user reviews,0,0,0
286660,True,8,Very Positive,67,14,81
286670,True,0,4 user reviews,4,0,4
286671,True,7,Positive,10,0,10
286690,True,8,Very Positive,10852,2519,13371
286730,True,5,Mixed,14,12,26
286750,True,5,Mixed,29,16,45
286770,True,6,Mostly Positive,64,19,83
286790,True,0,3 user reviews,1,2,3
286810,True,5,Mixed,68,42,110
286830,True,3,Negative,5,28,33
286880,True,7,Positive,10,2,12
286910,True,0,2 user reviews,2,0,2
286911,True,0,1 user reviews,1,0,1
286912,True,0,3 user reviews,1,2,3
286913,True,0,4 user reviews,3,1,4
286914,True,0,No user reviews,0,0,0
286915,True,0,No user reviews,0,0,0
286920,True,0,3 user reviews,3,0,3
286930,True,5,Mixed,7,7,14
286940,True,5,Mixed,46,31,77
286960,True,0,No user reviews,0,0,0
286961,True,0,5 user reviews,3,2,5
286962,True,0,No user reviews,0,0,0
286963,True,0,2 user reviews,2,0,2
286964,True,0,5 user reviews,2,3,5
286965,True,0,1 user reviews,1,0,1
286966,True,0,8 user reviews,8,0,8
286970,True,0,5 user reviews,4,1,5
286971,True,0,6 user reviews,5,1,6
286972,True,0,1 user reviews,1,0,1
287020,True,8,Very Positive,413,28,441
287070,True,8,Very Positive,80,10,90
287090,True,0,2 user reviews,2,0,2
287091,True,0,1 user reviews,1,0,1
287092,True,0,No user reviews,0,0,0
287093,True,0,No user reviews,0,0,0
287094,True,0,1 user reviews,1,0,1
287095,True,0,No user reviews,0,0,0
287100,True,4,Mostly Negative,5,16,21
287120,True,6,Mostly Positive,68,29,97
287140,True,5,Mixed,42,20,62
287200,True,5,Mixed,101,70,171
287220,True,5,Mixed,99,97,196
287240,True,0,No user reviews,0,0,0
287260,True,8,Very Positive,287,60,347
287280,True,0,No user reviews,0,0,0
287290,True,6,Mostly Positive,2522,835,3357
287330,True,5,Mixed,12,14,26
287340,True,5,Mixed,249,366,615
287360,True,0,No user reviews,0,0,0
287370,True,5,Mixed,18,10,28
287371,True,6,Mostly Positive,22,7,29
287390,True,8,Very Positive,8761,1897,10658
287410,True,0,No user reviews,0,0,0
287411,True,0,No user reviews,0,0,0
287420,True,0,No user reviews,0,0,0
287440,True,0,No user reviews,0,0,0
287450,True,8,Very Positive,3935,277,4212
287490,True,0,No user reviews,0,0,0
287530,True,0,3 user reviews,3,0,3
287531,True,0,4 user reviews,4,0,4
287540,True,7,Positive,11,0,11
287550,True,0,No user reviews,0,0,0
287580,True,5,Mixed,237,137,374
287600,True,5,Mixed,51,32,83
287620,True,0,No user reviews,0,0,0
287630,True,8,Very Positive,1137,273,1410
287670,True,0,No user reviews,0,0,0
287671,True,0,No user reviews,0,0,0
287672,True,0,No user reviews,0,0,0
287673,True,0,No user reviews,0,0,0
287680,True,5,Mixed,118,102,220
287700,True,8,Very Positive,20220,2383,22603
287720,True,5,Mixed,40,20,60
287740,True,0,5 user reviews,0,5,5
287760,True,7,Positive,8,2,10
287770,True,0,No user reviews,0,0,0
287771,True,0,No user reviews,0,0,0
287780,True,0,3 user reviews,3,0,3
287820,True,0,No user reviews,0,0,0
287840,True,8,Very Positive,140,31,171
287860,True,5,Mixed,20,13,33
287900,True,8,Very Positive,73,16,89
287920,True,6,Mostly Positive,51,18,69
287960,True,8,Very Positive,74,18,92
287980,True,9,Overwhelmingly Positive,3716,128,3844
288000,True,0,6 user reviews,1,5,6
288020,True,5,Mixed,70,34,104
288040,True,6,Mostly Positive,253,82,335
288060,True,8,Very Positive,233,45,278
288100,True,0,7 user reviews,4,3,7
288120,True,8,Very Positive,465,55,520
288140,True,5,Mixed,441,246,687
288160,True,9,Overwhelmingly Positive,6900,194,7094
288220,True,8,Very Positive,149,13,162
288240,True,0,No user reviews,0,0,0
288250,True,0,No user reviews,0,0,0
288260,True,6,Mostly Positive,38,11,49
288270,True,5,Mixed,18,25,43
288290,True,7,Positive,41,7,48
288310,True,0,No user reviews,0,0,0
288320,True,0,No user reviews,0,0,0
288321,True,0,No user reviews,0,0,0
288330,True,0,2 user reviews,0,2,2
288340,True,0,No user reviews,0,0,0
288370,True,8,Very Positive,171,41,212
288390,True,0,1 user reviews,1,0,1
288420,True,0,3 user reviews,2,1,3
288460,True,0,No user reviews,0,0,0
288470,True,8,Very Positive,3107,745,3852
288500,True,5,Mixed,6,4,10
288520,True,8,Very Positive,248,45,293
288570,True,5,Mixed,134,61,195
288610,True,0,5 user reviews,3,2,5
288630,True,0,5 user reviews,2,3,5
288650,True,5,Mixed,10,8,18
288670,True,7,Positive,9,2,11
288690,True,0,4 user reviews,2,2,4
288710,True,0,2 user reviews,1,1,2
288730,True,4,Mostly Negative,8,13,21
288750,True,5,Mixed,5,5,10
288780,True,0,1 user reviews,1,0,1
288790,True,5,Mixed,34,30,64
288800,True,0,No user reviews,0,0,0
288810,True,0,No user reviews,0,0,0
288811,True,0,No user reviews,0,0,0
288812,True,0,No user reviews,0,0,0
288813,True,0,No user reviews,0,0,0
288814,True,0,No user reviews,0,0,0
288815,True,0,No user reviews,0,0,0
288816,True,0,No user reviews,0,0,0
288817,True,0,No user reviews,0,0,0
288818,True,0,No user reviews,0,0,0
288819,True,0,No user reviews,0,0,0
288820,True,0,No user reviews,0,0,0
288822,True,0,No user reviews,0,0,0
288823,True,0,No user reviews,0,0,0
288824,True,0,No user reviews,0,0,0
288830,True,5,Mixed,27,18,45
288840,True,8,Very Positive,61,10,71
288850,True,0,3 user reviews,3,0,3
288860,True,5,Mixed,21,19,40
288880,True,5,Mixed,57,40,97
288900,True,7,Positive,11,2,13
288930,True,8,Very Positive,274,67,341
288940,True,0,1 user reviews,1,0,1
288970,True,5,Mixed,21,14,35
288980,True,0,No user reviews,0,0,0
289010,True,0,1 user reviews,0,1,1
289050,True,5,Mixed,9,9,18
289060,True,0,2 user reviews,2,0,2
289070,True,6,Mostly Positive,33557,8595,42152
289090,True,5,Mixed,259,145,404
289120,True,0,No user reviews,0,0,0
289121,True,0,No user reviews,0,0,0
289122,True,0,No user reviews,0,0,0
289130,True,8,Very Positive,6562,1050,7612
289180,True,6,Mostly Positive,36,15,51
289200,True,6,Mostly Positive,67,24,91
289220,True,5,Mixed,8,12,20
289240,True,0,6 user reviews,4,2,6
289260,True,7,Positive,30,6,36
289280,True,5,Mixed,47,24,71
289300,True,6,Mostly Positive,95,27,122
289320,True,4,Mostly Negative,5,10,15
289340,True,5,Mixed,73,56,129
289360,True,5,Mixed,7,6,13
289380,True,6,Mostly Positive,11,3,14
289400,True,5,Mixed,32,35,67
289420,True,5,Mixed,23,15,38
289440,True,6,Mostly Positive,28,10,38
289460,True,5,Mixed,25,25,50
289480,True,4,Mostly Negative,5,20,25
289500,True,6,Mostly Positive,34,13,47
289520,True,5,Mixed,171,110,281
289540,True,0,No user reviews,0,0,0
289550,True,0,7 user reviews,4,3,7
289570,True,4,Mostly Negative,7,12,19
289580,True,5,Mixed,14,21,35
289600,True,5,Mixed,90,63,153
289620,True,5,Mixed,43,46,89
289650,True,5,Mixed,5653,3563,9216
289690,True,5,Mixed,209,181,390
289730,True,7,Positive,9,2,11
289731,True,7,Positive,10,2,12
289733,True,0,9 user reviews,6,3,9
289734,True,4,Mostly Negative,5,10,15
289740,True,0,No user reviews,0,0,0
289760,True,8,Very Positive,205,33,238
289780,True,0,3 user reviews,2,1,3
289800,True,4,Mostly Negative,31,50,81
289820,True,3,Negative,8,34,42
289840,True,4,Mostly Negative,11,21,32
289880,True,4,Mostly Negative,31,89,120
289881,True,4,Mostly Negative,66,220,286
289890,True,6,Mostly Positive,87,27,114
289930,True,5,Mixed,232,106,338
289950,True,5,Mixed,703,355,1058
289970,True,0,No user reviews,0,0,0
289980,True,0,No user reviews,0,0,0
290000,True,8,Very Positive,94,19,113
290020,True,6,Mostly Positive,70,19,89
290040,True,8,Very Positive,96,21,117
290060,True,6,Mostly Positive,108,37,145
290080,True,5,Mixed,2371,1573,3944
290140,True,0,8 user reviews,5,3,8
290180,True,7,Positive,9,1,10
290260,True,8,Very Positive,137,14,151
290280,True,5,Mixed,63,30,93
290300,True,8,Very Positive,3798,587,4385
290320,True,7,Positive,17,3,20
290340,True,8,Very Positive,3496,724,4220
290380,True,8,Very Positive,67,4,71
290400,True,6,Mostly Positive,11,4,15
290401,True,0,5 user reviews,4,1,5
290402,True,5,Mixed,6,4,10
290403,True,0,4 user reviews,2,2,4
290404,True,0,2 user reviews,1,1,2
290405,True,0,2 user reviews,1,1,2
290406,True,0,3 user reviews,1,2,3
290440,True,5,Mixed,11,12,23
290460,True,5,Mixed,11,6,17
290470,True,0,No user reviews,0,0,0
290490,True,4,Mostly Negative,32,57,89
290510,True,8,Very Positive,150,16,166
290530,True,6,Mostly Positive,185,48,233
290630,True,0,6 user reviews,1,5,6
290650,True,3,Negative,8,33,41
290690,True,8,Very Positive,280,11,291
290730,True,0,3 user reviews,2,1,3
290750,True,0,5 user reviews,0,5,5
290770,True,8,Very Positive,1728,250,1978
290790,True,5,Mixed,1143,515,1658
290810,True,5,Mixed,23,25,48
290830,True,0,No user reviews,0,0,0
290850,True,0,6 user reviews,3,3,6
290870,True,4,Mostly Negative,8,13,21
290890,True,8,Very Positive,387,88,475
290930,True,7,Positive,23,4,27
290970,True,5,Mixed,100,53,153
290990,True,5,Mixed,22,15,37
291010,True,5,Mixed,544,364,908
291030,True,5,Mixed,61,44,105
291050,True,5,Mixed,16,10,26
291070,True,6,Mostly Positive,22,6,28
291090,True,5,Mixed,24,14,38
291130,True,5,Mixed,96,68,164
291170,True,5,Mixed,27,15,42
291190,True,6,Mostly Positive,120,33,153
291210,True,0,No user reviews,0,0,0
291250,True,5,Mixed,56,64,120
291270,True,4,Mostly Negative,7,11,18
291290,True,7,Positive,10,1,11
291330,True,5,Mixed,7,9,16
291370,True,4,Mostly Negative,34,95,129
291390,True,0,9 user reviews,6,3,9
291430,True,5,Mixed,5,6,11
291450,True,5,Mixed,51,48,99
291470,True,0,4 user reviews,4,0,4
291471,True,0,4 user reviews,3,1,4
291472,True,0,1 user reviews,1,0,1
291473,True,0,3 user reviews,2,1,3
291474,True,0,3 user reviews,3,0,3
291480,True,5,Mixed,219,207,426
291500,True,0,No user reviews,0,0,0
291501,True,0,No user reviews,0,0,0
291502,True,0,No user reviews,0,0,0
291503,True,0,1 user reviews,1,0,1
291504,True,0,No user reviews,0,0,0
291505,True,0,No user reviews,0,0,0
291506,True,0,No user reviews,0,0,0
291507,True,0,No user reviews,0,0,0
291508,True,0,No user reviews,0,0,0
291509,True,0,No user reviews,0,0,0
291520,True,0,No user reviews,0,0,0
291521,True,0,No user reviews,0,0,0
291522,True,0,No user reviews,0,0,0
291523,True,0,No user reviews,0,0,0
291524,True,0,No user reviews,0,0,0
291525,True,0,1 user reviews,1,0,1
291540,True,0,No user reviews,0,0,0
291541,True,0,No user reviews,0,0,0
291542,True,0,No user reviews,0,0,0
291543,True,0,No user reviews,0,0,0
291544,True,0,No user reviews,0,0,0
291545,True,0,No user reviews,0,0,0
291550,True,8,Very Positive,1212,239,1451
291610,True,0,4 user reviews,3,1,4
291630,True,6,Mostly Positive,86,33,119
291640,True,5,Mixed,21,20,41
291650,True,8,Very Positive,5947,986,6933
291690,True,5,Mixed,38,24,62
291710,True,8,Very Positive,144,21,165
291750,True,0,No user reviews,0,0,0
291770,True,6,Mostly Positive,57,15,72
291790,True,0,No user reviews,0,0,0
291820,True,0,No user reviews,0,0,0
291821,True,0,No user reviews,0,0,0
291822,True,0,1 user reviews,1,0,1
291830,True,0,1 user reviews,1,0,1
291831,True,0,No user reviews,0,0,0
291832,True,0,No user reviews,0,0,0
291840,True,6,Mostly Positive,19,6,25
291860,True,8,Very Positive,3512,239,3751
291900,True,7,Positive,27,1,28
291901,True,0,No user reviews,0,0,0
291902,True,0,No user reviews,0,0,0
291910,True,5,Mixed,96,100,196
291930,True,4,Mostly Negative,23,53,76
291950,True,0,No user reviews,0,0,0
291960,True,5,Mixed,68,41,109
292020,True,0,9 user reviews,8,1,9
292021,True,7,Positive,25,3,28
292030,True,9,Overwhelmingly Positive,126443,3029,129472
292050,True,7,Positive,29,0,29
292060,True,5,Mixed,41,33,74
292090,True,7,Positive,10,1,11
292114,True,0,No user reviews,0,0,0
292116,True,0,No user reviews,0,0,0
292117,True,0,No user reviews,0,0,0
292118,True,0,No user reviews,0,0,0
292119,True,0,No user reviews,0,0,0
292120,True,6,Mostly Positive,3697,1402,5099
292140,True,5,Mixed,963,716,1679
292160,True,6,Mostly Positive,42,18,60
292180,True,5,Mixed,384,180,564
292200,True,6,Mostly Positive,75,24,99
292220,True,7,Positive,8,2,10
292230,True,5,Mixed,87,45,132
292240,True,8,Very Positive,71,5,76
292260,True,8,Very Positive,50,2,52
292280,True,6,Mostly Positive,8,3,11
292300,True,0,9 user reviews,5,4,9
292320,True,7,Positive,30,5,35
292330,True,5,Mixed,141,167,308
292350,True,7,Positive,17,2,19
292370,True,5,Mixed,8,4,12
292380,True,4,Mostly Negative,10,22,32
292390,True,8,Very Positive,77,8,85
292400,True,5,Mixed,57,33,90
292410,True,8,Very Positive,492,114,606
292420,True,5,Mixed,27,26,53
292470,True,0,No user reviews,0,0,0
292471,True,0,1 user reviews,0,1,1
292472,True,0,1 user reviews,0,1,1
292473,True,0,1 user reviews,1,0,1
292474,True,0,No user reviews,0,0,0
292480,True,6,Mostly Positive,77,25,102
292500,True,8,Very Positive,351,14,365
292570,True,6,Mostly Positive,40,13,53
292600,True,8,Very Positive,117,7,124
292620,True,5,Mixed,35,52,87
292630,True,4,Mostly Negative,61,93,154
292640,True,0,No user reviews,0,0,0
292660,True,6,Mostly Positive,54,15,69
292670,True,7,Positive,29,7,36
292680,True,0,6 user reviews,5,1,6
292690,True,0,No user reviews,0,0,0
292700,True,0,No user reviews,0,0,0
292701,True,0,No user reviews,0,0,0
292702,True,0,1 user reviews,1,0,1
292710,True,7,Positive,8,2,10
292711,True,0,7 user reviews,6,1,7
292712,True,0,8 user reviews,6,2,8
292720,True,0,No user reviews,0,0,0
292721,True,0,No user reviews,0,0,0
292722,True,0,No user reviews,0,0,0
292730,True,5,Mixed,2372,3223,5595
292750,True,0,No user reviews,0,0,0
292760,True,7,Positive,10,2,12
292780,True,8,Very Positive,145,3,148
292800,True,8,Very Positive,160,5,165
292820,True,4,Mostly Negative,23,41,64
292840,True,7,Positive,19,1,20
292860,True,6,Mostly Positive,9,3,12
292880,True,8,Very Positive,62,7,69
292900,True,0,6 user reviews,2,4,6
292910,True,8,Very Positive,796,162,958
292930,True,6,Mostly Positive,197,63,260
292950,True,0,2 user reviews,2,0,2
292951,True,0,2 user reviews,0,2,2
292960,True,0,1 user reviews,1,0,1
292980,True,0,7 user reviews,3,4,7
292981,True,5,Mixed,13,6,19
292982,True,5,Mixed,76,33,109
292983,True,4,Mostly Negative,4,8,12
292984,True,7,Positive,9,1,10
292985,True,5,Mixed,7,7,14
292990,True,6,Mostly Positive,27,9,36
293010,True,5,Mixed,392,306,698
293030,True,0,No user reviews,0,0,0
293054,True,7,Positive,17,4,21
293055,True,0,No user reviews,0,0,0
293057,True,0,6 user reviews,2,4,6
293058,True,0,No user reviews,0,0,0
293059,True,5,Mixed,13,6,19
293080,True,0,No user reviews,0,0,0
293090,True,0,1 user reviews,1,0,1
293091,True,0,1 user reviews,1,0,1
293092,True,0,1 user reviews,1,0,1
293093,True,0,1 user reviews,1,0,1
293094,True,0,1 user reviews,1,0,1
293095,True,0,No user reviews,0,0,0
293096,True,0,No user reviews,0,0,0
293097,True,0,No user reviews,0,0,0
293098,True,0,No user reviews,0,0,0
293099,True,0,1 user reviews,1,0,1
293101,True,0,No user reviews,0,0,0
293110,True,0,5 user reviews,5,0,5
293120,True,0,No user reviews,0,0,0
293130,True,0,No user reviews,0,0,0
293131,True,0,No user reviews,0,0,0
293132,True,0,No user reviews,0,0,0
293133,True,0,No user reviews,0,0,0
293134,True,0,No user reviews,0,0,0
293140,True,7,Positive,18,1,19
293160,True,5,Mixed,60,42,102
293180,True,5,Mixed,246,201,447
293200,True,5,Mixed,13,8,21
293220,True,5,Mixed,347,157,504
293240,True,8,Very Positive,213,18,231
293260,True,7,Positive,27,5,32
293300,True,7,Positive,15,0,15
293320,True,5,Mixed,93,121,214
293340,True,5,Mixed,40,34,74
293360,True,0,8 user reviews,7,1,8
293400,True,2,Very Negative,7,46,53
293420,True,5,Mixed,9,10,19
293440,True,5,Mixed,38,19,57
293460,True,6,Mostly Positive,51,20,71
293480,True,4,Mostly Negative,32,49,81
293520,True,6,Mostly Positive,271,114,385
293540,True,4,Mostly Negative,3,9,12
293560,True,0,No user reviews,0,0,0
293600,True,0,9 user reviews,4,5,9
293660,True,8,Very Positive,175,27,202
293680,True,8,Very Positive,318,38,356
293720,True,3,Negative,2,11,13
293740,True,8,Very Positive,128,29,157
293760,True,8,Very Positive,2919,306,3225
293780,True,9,Overwhelmingly Positive,2642,103,2745
293800,True,0,No user reviews,0,0,0
293820,True,0,3 user reviews,2,1,3
293840,True,5,Mixed,21,10,31
293860,True,5,Mixed,150,68,218
293880,True,8,Very Positive,102,11,113
293900,True,8,Very Positive,94,14,108
293920,True,5,Mixed,18,22,40
293940,True,5,Mixed,21,18,39
293960,True,5,Mixed,24,13,37
293980,True,0,6 user reviews,5,1,6
294000,True,8,Very Positive,90,13,103
294020,True,5,Mixed,90,58,148
294040,True,5,Mixed,95,49,144
294060,True,5,Mixed,16,8,24
294100,True,9,Overwhelmingly Positive,43629,763,44392
294140,True,8,Very Positive,473,72,545
294160,True,0,1 user reviews,0,1,1
294180,True,0,6 user reviews,4,2,6
294190,True,0,2 user reviews,2,0,2
294230,True,6,Mostly Positive,94,29,123
294250,True,0,No user reviews,0,0,0
294260,True,0,1 user reviews,1,0,1
294270,True,0,No user reviews,0,0,0
294280,True,5,Mixed,12,8,20
294300,True,0,No user reviews,0,0,0
294301,True,0,No user reviews,0,0,0
294302,True,0,No user reviews,0,0,0
294303,True,0,No user reviews,0,0,0
294304,True,0,No user reviews,0,0,0
294310,True,0,No user reviews,0,0,0
294311,True,0,No user reviews,0,0,0
294312,True,0,No user reviews,0,0,0
294330,True,0,No user reviews,0,0,0
294340,True,0,2 user reviews,1,1,2
294350,True,0,No user reviews,0,0,0
294370,True,6,Mostly Positive,135,51,186
294390,True,5,Mixed,17,17,34
294420,True,0,3 user reviews,3,0,3
294440,True,8,Very Positive,273,33,306
294460,True,7,Positive,27,5,32
294510,True,0,No user reviews,0,0,0
294530,True,8,Very Positive,82,2,84
294540,True,8,Very Positive,114,8,122
294550,True,7,Positive,40,2,42
294560,True,6,Mostly Positive,8,3,11
294570,True,8,Very Positive,45,6,51
294580,True,6,Mostly Positive,11,3,14
294590,True,8,Very Positive,60,5,65
294600,True,0,No user reviews,0,0,0
294650,True,8,Very Positive,75,5,80
294660,True,8,Very Positive,299,9,308
294670,True,8,Very Positive,116,14,130
294680,True,8,Very Positive,62,3,65
294690,True,7,Positive,24,6,30
294700,True,5,Mixed,16,14,30
294710,True,7,Positive,14,0,14
294720,True,7,Positive,30,2,32
294730,True,7,Positive,32,8,40
294750,True,5,Mixed,68,31,99
294770,True,5,Mixed,9,10,19
294790,True,5,Mixed,19,14,33
294810,True,8,Very Positive,389,32,421
294830,True,5,Mixed,39,57,96
294850,True,0,No user reviews,0,0,0
294860,True,8,Very Positive,5384,548,5932
294900,True,0,No user reviews,0,0,0
294901,True,0,No user reviews,0,0,0
294902,True,0,No user reviews,0,0,0
294903,True,0,No user reviews,0,0,0
294904,True,0,1 user reviews,1,0,1
294905,True,0,No user reviews,0,0,0
294906,True,0,No user reviews,0,0,0
294907,True,0,No user reviews,0,0,0
294908,True,0,No user reviews,0,0,0
294909,True,0,No user reviews,0,0,0
294910,True,0,1 user reviews,1,0,1
294911,True,0,No user reviews,0,0,0
294912,True,0,1 user reviews,1,0,1
294913,True,0,1 user reviews,1,0,1
294914,True,0,2 user reviews,1,1,2
294915,True,0,No user reviews,0,0,0
294916,True,0,1 user reviews,1,0,1
294917,True,0,No user reviews,0,0,0
294918,True,0,No user reviews,0,0,0
294919,True,0,1 user reviews,1,0,1
294920,True,0,No user reviews,0,0,0
294921,True,0,No user reviews,0,0,0
294922,True,0,No user reviews,0,0,0
294923,True,0,1 user reviews,1,0,1
294924,True,0,2 user reviews,1,1,2
294925,True,0,No user reviews,0,0,0
294926,True,0,No user reviews,0,0,0
294927,True,0,2 user reviews,1,1,2
294928,True,0,No user reviews,0,0,0
294929,True,0,2 user reviews,1,1,2
294930,True,0,2 user reviews,1,1,2
294931,True,0,No user reviews,0,0,0
294932,True,0,1 user reviews,1,0,1
294934,True,0,No user reviews,0,0,0
294935,True,0,No user reviews,0,0,0
294936,True,0,No user reviews,0,0,0
294937,True,0,No user reviews,0,0,0
294938,True,0,No user reviews,0,0,0
294939,True,0,No user reviews,0,0,0
294940,True,0,1 user reviews,1,0,1
294941,True,0,No user reviews,0,0,0
294942,True,0,3 user reviews,3,0,3
294943,True,0,No user reviews,0,0,0
294944,True,0,No user reviews,0,0,0
294945,True,0,No user reviews,0,0,0
294946,True,0,No user reviews,0,0,0
294947,True,0,No user reviews,0,0,0
294948,True,0,No user reviews,0,0,0
294953,True,0,1 user reviews,0,1,1
294954,True,0,No user reviews,0,0,0
294955,True,0,No user reviews,0,0,0
294956,True,0,No user reviews,0,0,0
294957,True,0,2 user reviews,2,0,2
294958,True,0,1 user reviews,1,0,1
294959,True,0,1 user reviews,1,0,1
294960,True,0,1 user reviews,1,0,1
294961,True,0,2 user reviews,2,0,2
294962,True,0,1 user reviews,1,0,1
294963,True,0,1 user reviews,1,0,1
294964,True,0,2 user reviews,2,0,2
294965,True,0,No user reviews,0,0,0
294966,True,0,1 user reviews,1,0,1
294967,True,0,No user reviews,0,0,0
294968,True,0,1 user reviews,1,0,1
294969,True,0,1 user reviews,1,0,1
294970,True,0,No user reviews,0,0,0
294971,True,0,No user reviews,0,0,0
294972,True,0,No user reviews,0,0,0
294973,True,0,No user reviews,0,0,0
294974,True,0,No user reviews,0,0,0
294975,True,0,No user reviews,0,0,0
294976,True,0,No user reviews,0,0,0
294977,True,0,No user reviews,0,0,0
294978,True,0,1 user reviews,1,0,1
294979,True,0,No user reviews,0,0,0
294980,True,0,1 user reviews,1,0,1
294981,True,0,No user reviews,0,0,0
294982,True,0,No user reviews,0,0,0
294983,True,0,No user reviews,0,0,0
294984,True,0,No user reviews,0,0,0
294985,True,0,2 user reviews,2,0,2
294990,True,7,Positive,15,0,15
294992,True,0,No user reviews,0,0,0
294993,True,0,2 user reviews,0,2,2
294994,True,0,No user reviews,0,0,0
294995,True,0,No user reviews,0,0,0
294996,True,0,No user reviews,0,0,0
294997,True,0,3 user reviews,2,1,3
294998,True,0,No user reviews,0,0,0
294999,True,0,1 user reviews,0,1,1
295000,True,0,No user reviews,0,0,0
295001,True,0,No user reviews,0,0,0
295002,True,0,No user reviews,0,0,0
295003,True,0,No user reviews,0,0,0
295004,True,0,No user reviews,0,0,0
295005,True,0,3 user reviews,3,0,3
295006,True,0,No user reviews,0,0,0
295007,True,0,No user reviews,0,0,0
295008,True,0,No user reviews,0,0,0
295009,True,0,1 user reviews,1,0,1
295010,True,0,No user reviews,0,0,0
295011,True,0,3 user reviews,3,0,3
295012,True,0,1 user reviews,1,0,1
295013,True,0,No user reviews,0,0,0
295014,True,0,No user reviews,0,0,0
295015,True,0,No user reviews,0,0,0
295016,True,0,No user reviews,0,0,0
295017,True,0,4 user reviews,4,0,4
295018,True,0,No user reviews,0,0,0
295019,True,0,No user reviews,0,0,0
295020,True,0,No user reviews,0,0,0
295021,True,0,No user reviews,0,0,0
295022,True,0,No user reviews,0,0,0
295023,True,0,4 user reviews,3,1,4
295024,True,0,3 user reviews,3,0,3
295025,True,0,No user reviews,0,0,0
295026,True,0,No user reviews,0,0,0
295027,True,0,1 user reviews,1,0,1
295028,True,0,4 user reviews,1,3,4
295029,True,0,4 user reviews,3,1,4
295030,True,0,2 user reviews,2,0,2
295031,True,0,No user reviews,0,0,0
295032,True,0,No user reviews,0,0,0
295033,True,0,No user reviews,0,0,0
295034,True,0,3 user reviews,2,1,3
295035,True,0,1 user reviews,1,0,1
295036,True,0,2 user reviews,1,1,2
295037,True,0,2 user reviews,1,1,2
295038,True,0,No user reviews,0,0,0
295039,True,0,No user reviews,0,0,0
295040,True,0,2 user reviews,2,0,2
295041,True,0,No user reviews,0,0,0
295042,True,0,1 user reviews,1,0,1
295043,True,0,3 user reviews,3,0,3
295044,True,0,3 user reviews,3,0,3
295045,True,0,No user reviews,0,0,0
295046,True,0,No user reviews,0,0,0
295047,True,0,1 user reviews,1,0,1
295048,True,0,1 user reviews,1,0,1
295049,True,0,No user reviews,0,0,0
295050,True,0,1 user reviews,0,1,1
295051,True,0,2 user reviews,2,0,2
295052,True,0,1 user reviews,1,0,1
295053,True,0,1 user reviews,1,0,1
295054,True,0,No user reviews,0,0,0
295055,True,0,1 user reviews,1,0,1
295056,True,0,3 user reviews,2,1,3
295057,True,0,2 user reviews,2,0,2
295058,True,0,2 user reviews,2,0,2
295059,True,0,1 user reviews,0,1,1
295060,True,0,1 user reviews,1,0,1
295061,True,0,No user reviews,0,0,0
295062,True,0,No user reviews,0,0,0
295063,True,0,No user reviews,0,0,0
295064,True,0,3 user reviews,1,2,3
295065,True,0,1 user reviews,0,1,1
295066,True,0,2 user reviews,2,0,2
295067,True,0,No user reviews,0,0,0
295068,True,0,No user reviews,0,0,0
295069,True,0,4 user reviews,3,1,4
295070,True,0,No user reviews,0,0,0
295071,True,0,No user reviews,0,0,0
295072,True,0,No user reviews,0,0,0
295073,True,0,2 user reviews,2,0,2
295074,True,0,No user reviews,0,0,0
295075,True,0,No user reviews,0,0,0
295076,True,0,1 user reviews,1,0,1
295077,True,0,No user reviews,0,0,0
295078,True,0,3 user reviews,1,2,3
295079,True,0,No user reviews,0,0,0
295080,True,0,No user reviews,0,0,0
295081,True,0,No user reviews,0,0,0
295082,True,0,No user reviews,0,0,0
295083,True,0,4 user reviews,3,1,4
295084,True,0,8 user reviews,2,6,8
295085,True,0,No user reviews,0,0,0
295086,True,0,7 user reviews,7,0,7
295087,True,0,1 user reviews,1,0,1
295088,True,0,1 user reviews,1,0,1
295089,True,0,4 user reviews,2,2,4
295090,True,0,2 user reviews,2,0,2
295091,True,0,No user reviews,0,0,0
295092,True,0,2 user reviews,2,0,2
295093,True,0,7 user reviews,4,3,7
295094,True,0,No user reviews,0,0,0
295095,True,0,1 user reviews,1,0,1
295096,True,0,No user reviews,0,0,0
295097,True,0,No user reviews,0,0,0
295098,True,0,No user reviews,0,0,0
295099,True,0,4 user reviews,4,0,4
295110,True,5,Mixed,18596,14767,33363
295162,True,5,Mixed,6,4,10
295173,True,0,2 user reviews,2,0,2
295174,True,0,1 user reviews,1,0,1
295177,True,0,No user reviews,0,0,0
295178,True,0,No user reviews,0,0,0
295181,True,0,1 user reviews,0,1,1
295182,True,0,2 user reviews,2,0,2
295183,True,0,No user reviews,0,0,0
295184,True,0,No user reviews,0,0,0
295188,True,0,No user reviews,0,0,0
295190,True,0,9 user reviews,7,2,9
295191,True,0,2 user reviews,2,0,2
295192,True,0,3 user reviews,3,0,3
295193,True,0,No user reviews,0,0,0
295194,True,0,1 user reviews,1,0,1
295196,True,0,6 user reviews,6,0,6
295197,True,0,No user reviews,0,0,0
295198,True,0,No user reviews,0,0,0
295199,True,0,2 user reviews,2,0,2
295200,True,0,2 user reviews,2,0,2
295201,True,0,No user reviews,0,0,0
295202,True,0,No user reviews,0,0,0
295203,True,0,No user reviews,0,0,0
295204,True,0,1 user reviews,0,1,1
295205,True,0,No user reviews,0,0,0
295206,True,0,No user reviews,0,0,0
295207,True,0,1 user reviews,1,0,1
295208,True,0,No user reviews,0,0,0
295209,True,0,1 user reviews,1,0,1
295210,True,0,No user reviews,0,0,0
295220,True,0,4 user reviews,2,2,4
295221,True,0,8 user reviews,4,4,8
295222,True,0,4 user reviews,1,3,4
295230,True,0,No user reviews,0,0,0
295250,True,4,Mostly Negative,68,128,196
295270,True,6,Mostly Positive,729,266,995
295330,True,0,No user reviews,0,0,0
295350,True,0,No user reviews,0,0,0
295390,True,0,No user reviews,0,0,0
295430,True,0,No user reviews,0,0,0
295431,True,0,No user reviews,0,0,0
295432,True,0,No user reviews,0,0,0
295433,True,0,No user reviews,0,0,0
295434,True,0,No user reviews,0,0,0
295435,True,0,1 user reviews,1,0,1
295436,True,0,1 user reviews,1,0,1
295437,True,0,5 user reviews,3,2,5
295438,True,0,2 user reviews,2,0,2
295439,True,0,1 user reviews,1,0,1
295440,True,0,No user reviews,0,0,0
295490,True,6,Mostly Positive,31,11,42
295500,True,0,No user reviews,0,0,0
295510,True,7,Positive,22,0,22
295530,True,0,No user reviews,0,0,0
295550,True,8,Very Positive,55,13,68
295560,True,0,1 user reviews,1,0,1
295590,True,5,Mixed,61,66,127
295610,True,4,Mostly Negative,14,31,45
295630,True,8,Very Positive,49,12,61
295650,True,0,1 user reviews,1,0,1
295670,True,6,Mostly Positive,114,41,155
295690,True,8,Very Positive,560,85,645
295710,True,0,No user reviews,0,0,0
295730,True,8,Very Positive,42,10,52
295750,True,8,Very Positive,162,35,197
295770,True,6,Mostly Positive,217,69,286
295790,True,6,Mostly Positive,1654,440,2094
295810,True,5,Mixed,33,44,77
295850,True,5,Mixed,162,83,245
295870,True,5,Mixed,34,16,50
295910,True,5,Mixed,25,11,36
295930,True,0,8 user reviews,6,2,8
295950,True,4,Mostly Negative,5,8,13
295990,True,4,Mostly Negative,11,44,55
296010,True,6,Mostly Positive,59,15,74
296030,True,5,Mixed,12,6,18
296050,True,5,Mixed,32,15,47
296070,True,5,Mixed,255,155,410
296093,True,7,Positive,12,1,13
296103,True,0,5 user reviews,3,2,5
296150,True,4,Mostly Negative,9,25,34
296170,True,0,9 user reviews,9,0,9
296180,True,5,Mixed,19,12,31
296200,True,0,No user reviews,0,0,0
296210,True,5,Mixed,17,11,28
296220,True,6,Mostly Positive,72,30,102
296240,True,8,Very Positive,257,59,316
296270,True,0,4 user reviews,4,0,4
296271,True,0,2 user reviews,2,0,2
296280,True,5,Mixed,15,22,37
296300,True,6,Mostly Positive,1170,476,1646
296320,True,0,No user reviews,0,0,0
296340,True,0,No user reviews,0,0,0
296350,True,0,No user reviews,0,0,0
296360,True,0,4 user reviews,4,0,4
296440,True,0,5 user reviews,4,1,5
296441,True,0,1 user reviews,0,1,1
296450,True,0,6 user reviews,4,2,6
296470,True,9,Overwhelmingly Positive,2561,113,2674
296490,True,9,Overwhelmingly Positive,1763,66,1829
296510,True,0,9 user reviews,6,3,9
296530,True,5,Mixed,14,21,35
296550,True,5,Mixed,39,17,56
296570,True,6,Mostly Positive,391,100,491
296590,True,5,Mixed,9,13,22
296610,True,4,Mostly Negative,15,34,49
296630,True,6,Mostly Positive,49,18,67
296650,True,0,3 user reviews,3,0,3
296710,True,8,Very Positive,766,87,853
296730,True,6,Mostly Positive,53,20,73
296770,True,5,Mixed,157,122,279
296790,True,6,Mostly Positive,26,7,33
296810,True,0,4 user reviews,4,0,4
296830,True,5,Mixed,345,237,582
296850,True,6,Mostly Positive,8,3,11
296870,True,8,Very Positive,464,46,510
296890,True,7,Positive,26,3,29
296910,True,6,Mostly Positive,247,103,350
296930,True,6,Mostly Positive,70,18,88
296950,True,0,2 user reviews,0,2,2
296970,True,8,Very Positive,1514,128,1642
296990,True,0,9 user reviews,5,4,9
297000,True,6,Mostly Positive,2042,848,2890
297020,True,5,Mixed,43,27,70
297050,True,0,No user reviews,0,0,0
297060,True,7,Positive,41,6,47
297070,True,4,Mostly Negative,3,7,10
297080,True,0,3 user reviews,2,1,3
297090,True,0,7 user reviews,3,4,7
297100,True,4,Mostly Negative,23,41,64
297110,True,8,Very Positive,401,47,448
297120,True,8,Very Positive,668,143,811
297130,True,6,Mostly Positive,1322,503,1825
297140,True,0,3 user reviews,3,0,3
297141,True,0,3 user reviews,2,1,3
297142,True,0,3 user reviews,3,0,3
297143,True,5,Mixed,5,6,11
297150,True,0,No user reviews,0,0,0
297190,True,0,9 user reviews,6,3,9
297210,True,0,8 user reviews,6,2,8
297270,True,0,9 user reviews,3,6,9
297290,True,8,Very Positive,56,10,66
297310,True,5,Mixed,69,58,127
297330,True,5,Mixed,39,26,65
297350,True,6,Mostly Positive,253,104,357
297370,True,7,Positive,33,5,38
297390,True,0,2 user reviews,0,2,2
297410,True,7,Positive,20,2,22
297450,True,4,Mostly Negative,13,21,34
297470,True,6,Mostly Positive,162,61,223
297490,True,8,Very Positive,53,11,64
297510,True,0,6 user reviews,5,1,6
297511,True,0,4 user reviews,2,2,4
297512,True,6,Mostly Positive,15,6,21
297513,True,5,Mixed,6,4,10
297514,True,0,4 user reviews,4,0,4
297515,True,0,6 user reviews,6,0,6
297550,True,0,No user reviews,0,0,0
297570,True,6,Mostly Positive,27,9,36
297590,True,7,Positive,28,1,29
297600,True,0,No user reviews,0,0,0
297601,True,0,No user reviews,0,0,0
297610,True,0,No user reviews,0,0,0
297620,True,5,Mixed,14,12,26
297640,True,0,2 user reviews,2,0,2
297641,True,0,5 user reviews,2,3,5
297642,True,0,1 user reviews,1,0,1
297643,True,0,2 user reviews,1,1,2
297644,True,6,Mostly Positive,13,4,17
297645,True,0,6 user reviews,5,1,6
297650,True,0,7 user reviews,7,0,7
297651,True,0,No user reviews,0,0,0
297652,True,0,No user reviews,0,0,0
297660,True,7,Positive,32,2,34
297690,True,0,No user reviews,0,0,0
297700,True,0,No user reviews,0,0,0
297720,True,5,Mixed,70,43,113
297740,True,5,Mixed,9,4,13
297750,True,5,Mixed,140,84,224
297760,True,8,Very Positive,130,26,156
297780,True,0,No user reviews,0,0,0
297790,True,6,Mostly Positive,9,3,12
297791,True,7,Positive,40,4,44
297792,True,7,Positive,17,4,21
297793,True,7,Positive,19,2,21
297800,True,0,No user reviews,0,0,0
297810,True,4,Mostly Negative,369,897,1266
297830,True,5,Mixed,68,44,112
297831,True,5,Mixed,38,19,57
297840,True,0,7 user reviews,6,1,7
297841,True,0,1 user reviews,0,1,1
297842,True,0,No user reviews,0,0,0
297860,True,6,Mostly Positive,271,104,375
297880,True,0,No user reviews,0,0,0
297890,True,0,No user reviews,0,0,0
297891,True,0,No user reviews,0,0,0
297892,True,0,No user reviews,0,0,0
297893,True,0,No user reviews,0,0,0
297894,True,0,No user reviews,0,0,0
297895,True,0,No user reviews,0,0,0
297900,True,0,2 user reviews,1,1,2
297910,True,0,No user reviews,0,0,0
297920,True,6,Mostly Positive,134,52,186
297940,True,0,No user reviews,0,0,0
297950,True,0,1 user reviews,0,1,1
297960,True,0,No user reviews,0,0,0
297980,True,0,No user reviews,0,0,0
297990,True,0,No user reviews,0,0,0
298000,True,0,No user reviews,0,0,0
298010,True,0,1 user reviews,0,1,1
298020,True,5,Mixed,15,18,33
298030,True,9,Overwhelmingly Positive,1243,54,1297
298050,True,6,Mostly Positive,2301,848,3149
298110,True,6,Mostly Positive,9209,2700,11909
298140,True,6,Mostly Positive,34,12,46
298160,True,0,9 user reviews,5,4,9
298180,True,8,Very Positive,112,4,116
298220,True,4,Mostly Negative,8,19,27
298240,True,5,Mixed,47,36,83
298260,True,5,Mixed,20,10,30
298280,True,6,Mostly Positive,56,16,72
298340,True,5,Mixed,37,32,69
298360,True,8,Very Positive,73,9,82
298380,True,0,4 user reviews,1,3,4
298400,True,8,Very Positive,187,15,202
298420,True,0,6 user reviews,2,4,6
298480,True,6,Mostly Positive,216,80,296
298520,True,8,Very Positive,497,107,604
298560,True,8,Very Positive,146,33,179
298600,True,8,Very Positive,870,58,928
298610,True,5,Mixed,1153,824,1977
298620,True,0,3 user reviews,2,1,3
298630,True,8,Very Positive,7530,884,8414
298641,True,8,Very Positive,119,6,125
298670,True,4,Mostly Negative,4,8,12
298671,True,0,No user reviews,0,0,0
298672,True,3,Negative,2,16,18
298680,True,7,Positive,15,0,15
298690,True,0,No user reviews,0,0,0
298720,True,0,3 user reviews,3,0,3
298740,True,0,No user reviews,0,0,0
298781,True,0,No user reviews,0,0,0
298782,True,0,No user reviews,0,0,0
298783,True,0,No user reviews,0,0,0
298784,True,0,No user reviews,0,0,0
298785,True,0,No user reviews,0,0,0
298786,True,0,No user reviews,0,0,0
298788,True,0,No user reviews,0,0,0
298790,True,7,Positive,28,1,29
298810,True,0,5 user reviews,3,2,5
298820,True,7,Positive,12,3,15
298830,True,0,9 user reviews,8,1,9
298840,True,0,5 user reviews,4,1,5
298850,True,5,Mixed,7,5,12
298860,True,0,4 user reviews,4,0,4
298880,True,0,1 user reviews,1,0,1
298900,True,5,Mixed,1903,1545,3448
298910,True,0,No user reviews,0,0,0
298920,True,0,No user reviews,0,0,0
298930,True,6,Mostly Positive,130,49,179
298950,True,5,Mixed,36,20,56
298970,True,0,4 user reviews,3,1,4
299010,True,0,3 user reviews,1,2,3
299020,True,5,Mixed,5,5,10
299030,True,8,Very Positive,613,76,689
299050,True,5,Mixed,75,83,158
299070,True,8,Very Positive,88,8,96
299090,True,5,Mixed,9,11,20
299100,True,0,4 user reviews,2,2,4
299110,True,8,Very Positive,111,22,133
299130,True,0,No user reviews,0,0,0
299140,True,0,1 user reviews,1,0,1
299150,True,5,Mixed,46,26,72
299160,True,8,Very Positive,40,10,50
299170,True,4,Mostly Negative,10,16,26
299180,True,5,Mixed,26,17,43
299190,True,0,1 user reviews,1,0,1
299230,True,7,Positive,47,2,49
299240,True,8,Very Positive,201,3,204
299250,True,5,Mixed,114,157,271
299260,True,0,9 user reviews,7,2,9
299270,True,0,1 user reviews,0,1,1
299280,True,0,No user reviews,0,0,0
299290,True,0,1 user reviews,1,0,1
299300,True,0,No user reviews,0,0,0
299301,True,0,No user reviews,0,0,0
299310,True,0,No user reviews,0,0,0
299330,True,0,No user reviews,0,0,0
299340,True,4,Mostly Negative,44,85,129
299350,True,8,Very Positive,50,5,55
299360,True,6,Mostly Positive,858,302,1160
299370,True,0,No user reviews,0,0,0
299380,True,0,7 user reviews,5,2,7
299400,True,8,Very Positive,127,15,142
299420,True,5,Mixed,8,8,16
299440,True,7,Positive,9,1,10
299460,True,5,Mixed,492,237,729
299480,True,5,Mixed,80,48,128
299500,True,5,Mixed,105,72,177
299540,True,8,Very Positive,264,54,318
299600,True,5,Mixed,44,41,85
299640,True,6,Mostly Positive,47,15,62
299660,True,8,Very Positive,224,21,245
299680,True,8,Very Positive,232,51,283
299700,True,5,Mixed,34,33,67
299720,True,8,Very Positive,392,65,457
299740,True,5,Mixed,7493,3835,11328
299780,True,5,Mixed,77,47,124
299800,True,0,8 user reviews,6,2,8
299820,True,3,Negative,1,10,11
299840,True,0,No user reviews,0,0,0
299860,True,4,Mostly Negative,403,665,1068
299890,True,5,Mixed,17,25,42
299910,True,0,No user reviews,0,0,0
299950,True,6,Mostly Positive,257,70,327
299990,True,0,No user reviews,0,0,0
300040,True,0,3 user reviews,2,1,3
300060,True,5,Mixed,279,239,518
300080,True,5,Mixed,9,13,22
300120,True,7,Positive,14,2,16
300130,True,0,No user reviews,0,0,0
300140,True,0,2 user reviews,1,1,2
300150,True,0,No user reviews,0,0,0
300160,True,3,Negative,1,15,16
300200,True,5,Mixed,6,4,10
300220,True,5,Mixed,27,16,43
300260,True,5,Mixed,112,74,186
300280,True,6,Mostly Positive,10,3,13
300300,True,8,Very Positive,132,23,155
300320,True,5,Mixed,40,29,69
300340,True,8,Very Positive,81,9,90
300360,True,5,Mixed,18,13,31
300380,True,8,Very Positive,3221,632,3853
300400,True,8,Very Positive,60,14,74
300440,True,0,No user reviews,0,0,0
300441,True,0,No user reviews,0,0,0
300442,True,0,No user reviews,0,0,0
300450,True,0,No user reviews,0,0,0
300460,True,0,No user reviews,0,0,0
300510,True,0,4 user reviews,2,2,4
300540,True,7,Positive,9,2,11
300550,True,8,Very Positive,2805,296,3101
300570,True,9,Overwhelmingly Positive,1081,50,1131
300580,True,6,Mostly Positive,144,42,186
300600,True,0,No user reviews,0,0,0
300610,True,5,Mixed,82,100,182
300620,True,0,No user reviews,0,0,0
300630,True,5,Mixed,28,16,44
300640,True,0,No user reviews,0,0,0
300641,True,0,No user reviews,0,0,0
300642,True,0,No user reviews,0,0,0
300650,True,0,No user reviews,0,0,0
300660,True,0,No user reviews,0,0,0
300661,True,0,No user reviews,0,0,0
300662,True,0,No user reviews,0,0,0
300663,True,0,No user reviews,0,0,0
300730,True,0,No user reviews,0,0,0
300760,True,5,Mixed,21,13,34
300780,True,0,No user reviews,0,0,0
300790,True,0,5 user reviews,5,0,5
300820,True,5,Mixed,69,58,127
300840,True,7,Positive,20,2,22
300860,True,0,No user reviews,0,0,0
300870,True,6,Mostly Positive,11,3,14
300900,True,4,Mostly Negative,19,42,61
300910,True,4,Mostly Negative,3,9,12
300920,True,0,5 user reviews,2,3,5
300930,True,0,No user reviews,0,0,0
300960,True,0,No user reviews,0,0,0
300970,True,0,6 user reviews,4,2,6
300980,True,0,No user reviews,0,0,0
300981,True,0,No user reviews,0,0,0
300982,True,0,No user reviews,0,0,0
300990,True,0,2 user reviews,2,0,2
300991,True,0,1 user reviews,1,0,1
300992,True,0,2 user reviews,2,0,2
301050,True,7,Positive,22,5,27
301060,True,0,No user reviews,0,0,0
301110,True,0,No user reviews,0,0,0
301111,True,0,No user reviews,0,0,0
301112,True,0,No user reviews,0,0,0
301113,True,0,No user reviews,0,0,0
301114,True,0,4 user reviews,4,0,4
301115,True,0,6 user reviews,6,0,6
301116,True,0,2 user reviews,2,0,2
301120,True,8,Very Positive,596,91,687
301140,True,0,8 user reviews,8,0,8
301150,True,8,Very Positive,93,21,114
301170,True,0,No user reviews,0,0,0
301180,True,7,Positive,16,3,19
301190,True,8,Very Positive,219,45,264
301200,True,8,Very Positive,120,21,141
301210,True,0,8 user reviews,5,3,8
301220,True,0,7 user reviews,1,6,7
301240,True,0,No user reviews,0,0,0
301241,True,0,No user reviews,0,0,0
301242,True,0,No user reviews,0,0,0
301243,True,0,No user reviews,0,0,0
301244,True,0,1 user reviews,0,1,1
301245,True,0,No user reviews,0,0,0
301246,True,0,No user reviews,0,0,0
301247,True,0,No user reviews,0,0,0
301248,True,0,No user reviews,0,0,0
301249,True,0,No user reviews,0,0,0
301250,True,0,3 user reviews,1,2,3
301260,True,0,7 user reviews,6,1,7
301270,True,0,4 user reviews,3,1,4
301280,True,0,No user reviews,0,0,0
301300,True,8,Very Positive,151,3,154
301320,True,8,Very Positive,418,26,444
301360,True,5,Mixed,12,11,23
301380,True,8,Very Positive,98,11,109
301420,True,0,2 user reviews,0,2,2
301460,True,6,Mostly Positive,127,37,164
301480,True,5,Mixed,411,349,760
301500,True,6,Mostly Positive,35,15,50
301520,True,5,Mixed,665,377,1042
301540,True,5,Mixed,9,5,14
301560,True,6,Mostly Positive,74,31,105
301600,True,7,Positive,11,0,11
301610,True,8,Very Positive,129,30,159
301640,True,8,Very Positive,3079,505,3584
301650,True,8,Very Positive,450,41,491
301660,True,7,Positive,22,4,26
301670,True,6,Mostly Positive,18,6,24
301690,True,6,Mostly Positive,14,6,20
301700,True,7,Positive,25,5,30
301710,True,0,No user reviews,0,0,0
301720,True,0,No user reviews,0,0,0
301730,True,5,Mixed,12,15,27
301740,True,6,Mostly Positive,55,23,78
301750,True,5,Mixed,8,8,16
301760,True,5,Mixed,22,25,47
301771,True,0,No user reviews,0,0,0
301820,True,0,No user reviews,0,0,0
301830,True,7,Positive,28,5,33
301840,True,8,Very Positive,240,46,286
301860,True,6,Mostly Positive,977,294,1271
301880,True,0,4 user reviews,3,1,4
301890,True,0,No user reviews,0,0,0
301891,True,0,3 user reviews,3,0,3
301892,True,5,Mixed,10,5,15
301893,True,0,3 user reviews,1,2,3
301894,True,0,3 user reviews,1,2,3
301895,True,0,8 user reviews,6,2,8
301896,True,0,7 user reviews,4,3,7
301897,True,0,7 user reviews,4,3,7
301900,True,0,9 user reviews,9,0,9
301910,True,6,Mostly Positive,1949,758,2707
301920,True,8,Very Positive,50,2,52
301930,True,7,Positive,11,2,13
301950,True,0,3 user reviews,3,0,3
301970,True,8,Very Positive,421,30,451
301980,True,5,Mixed,28,18,46
301990,True,0,8 user reviews,5,3,8
302010,True,5,Mixed,34,17,51
302020,True,0,2 user reviews,0,2,2
302030,True,0,1 user reviews,0,1,1
302060,True,5,Mixed,55,35,90
302080,True,6,Mostly Positive,352,105,457
302110,True,6,Mostly Positive,28,8,36
302120,True,7,Positive,43,3,46
302130,True,8,Very Positive,71,8,79
302160,True,5,Mixed,18,22,40
302170,True,5,Mixed,10,9,19
302180,True,6,Mostly Positive,35,11,46
302190,True,5,Mixed,31,16,47
302200,True,0,No user reviews,0,0,0
302210,True,8,Very Positive,41,10,51
302230,True,0,No user reviews,0,0,0
302260,True,5,Mixed,6,9,15
302270,True,5,Mixed,480,591,1071
302290,True,4,Mostly Negative,5,10,15
302300,True,0,No user reviews,0,0,0
302310,True,6,Mostly Positive,17,6,23
302320,True,5,Mixed,10,11,21
302330,True,6,Mostly Positive,22,7,29
302340,True,7,Positive,13,3,16
302350,True,7,Positive,46,1,47
302360,True,7,Positive,25,2,27
302370,True,4,Mostly Negative,6,15,21
302380,True,7,Positive,33,2,35
302390,True,4,Mostly Negative,12,37,49
302440,True,4,Mostly Negative,6,17,23
302450,True,0,1 user reviews,1,0,1
302451,True,0,No user reviews,0,0,0
302452,True,0,No user reviews,0,0,0
302453,True,0,No user reviews,0,0,0
302460,True,0,No user reviews,0,0,0
302470,True,5,Mixed,26,14,40
302490,True,8,Very Positive,54,3,57
302510,True,8,Very Positive,5740,1249,6989
302530,True,0,No user reviews,0,0,0
302550,True,0,No user reviews,0,0,0
302570,True,5,Mixed,7,8,15
302590,True,8,Very Positive,217,46,263
302610,True,8,Very Positive,695,49,744
302650,True,0,8 user reviews,5,3,8
302670,True,6,Mostly Positive,2711,800,3511
302690,True,8,Very Positive,223,37,260
302710,True,8,Very Positive,277,40,317
302730,True,7,Positive,21,1,22
302750,True,7,Positive,37,1,38
302790,True,8,Very Positive,448,38,486
302810,True,7,Positive,9,2,11
302830,True,5,Mixed,49,53,102
302850,True,4,Mostly Negative,8,14,22
302870,True,0,7 user reviews,2,5,7
302910,True,4,Mostly Negative,17,31,48
302950,True,5,Mixed,13,17,30
302970,True,6,Mostly Positive,42,13,55
303210,True,8,Very Positive,9009,1435,10444
303250,True,0,No user reviews,0,0,0
303251,True,0,No user reviews,0,0,0
303260,True,5,Mixed,9,8,17
303290,True,8,Very Positive,258,46,304
303310,True,9,Overwhelmingly Positive,526,21,547
303330,True,0,No user reviews,0,0,0
303331,True,0,1 user reviews,0,1,1
303332,True,0,No user reviews,0,0,0
303340,True,7,Positive,16,4,20
303360,True,0,1 user reviews,0,1,1
303390,True,5,Mixed,728,728,1456
303430,True,8,Very Positive,283,20,303
303470,True,0,8 user reviews,6,2,8
303510,True,5,Mixed,14,16,30
303530,True,5,Mixed,12,7,19
303550,True,8,Very Positive,78,13,91
303590,True,8,Very Positive,265,3,268
303610,True,8,Very Positive,276,52,328
303630,True,0,No user reviews,0,0,0
303640,True,0,No user reviews,0,0,0
303641,True,0,No user reviews,0,0,0
303642,True,0,No user reviews,0,0,0
303643,True,0,No user reviews,0,0,0
303644,True,0,No user reviews,0,0,0
303645,True,0,No user reviews,0,0,0
303646,True,0,No user reviews,0,0,0
303647,True,0,No user reviews,0,0,0
303680,True,8,Very Positive,180,12,192
303690,True,8,Very Positive,167,15,182
303710,True,4,Mostly Negative,3,7,10
303720,True,5,Mixed,18,8,26
303730,True,7,Positive,12,1,13
303740,True,0,No user reviews,0,0,0
303760,True,0,No user reviews,0,0,0
303780,True,0,8 user reviews,8,0,8
303790,True,6,Mostly Positive,218,92,310
303800,True,6,Mostly Positive,313,134,447
303830,True,4,Mostly Negative,2,8,10
303840,True,5,Mixed,38,20,58
303850,True,0,3 user reviews,3,0,3
303860,True,6,Mostly Positive,17,5,22
303870,True,5,Mixed,6,9,15
303880,True,0,3 user reviews,2,1,3
303890,True,0,No user reviews,0,0,0
303910,True,5,Mixed,8,8,16
303920,True,0,No user reviews,0,0,0
303940,True,8,Very Positive,66,13,79
303990,True,0,No user reviews,0,0,0
304000,True,5,Mixed,11,12,23
304010,True,5,Mixed,23,28,51
304020,True,7,Positive,27,4,31
304030,True,5,Mixed,335,323,658
304050,True,6,Mostly Positive,338,133,471
304070,True,0,No user reviews,0,0,0
304071,True,0,No user reviews,0,0,0
304072,True,0,No user reviews,0,0,0
304080,True,0,2 user reviews,1,1,2
304081,True,0,1 user reviews,1,0,1
304082,True,0,3 user reviews,2,1,3
304120,True,0,No user reviews,0,0,0
304121,True,0,No user reviews,0,0,0
304130,True,0,No user reviews,0,0,0
304131,True,0,No user reviews,0,0,0
304132,True,0,No user reviews,0,0,0
304133,True,0,No user reviews,0,0,0
304134,True,0,No user reviews,0,0,0
304140,True,7,Positive,11,1,12
304150,True,0,8 user reviews,2,6,8
304170,True,4,Mostly Negative,10,19,29
304190,True,0,No user reviews,0,0,0
304210,True,7,Positive,23,4,27
304211,True,7,Positive,29,1,30
304212,True,9,Overwhelmingly Positive,764,39,803
304213,True,7,Positive,36,2,38
304214,True,8,Very Positive,236,38,274
304220,True,0,No user reviews,0,0,0
304240,True,8,Very Positive,3527,341,3868
304270,True,0,No user reviews,0,0,0
304290,True,8,Very Positive,113,27,140
304300,True,0,2 user reviews,2,0,2
304301,True,0,3 user reviews,2,1,3
304310,True,7,Positive,34,7,41
304320,True,0,3 user reviews,3,0,3
304330,True,0,1 user reviews,1,0,1
304350,True,5,Mixed,158,79,237
304360,True,0,1 user reviews,0,1,1
304380,True,6,Mostly Positive,178,68,246
304390,True,5,Mixed,14605,8614,23219
304410,True,9,Overwhelmingly Positive,1388,36,1424
304430,True,9,Overwhelmingly Positive,10237,502,10739
304440,True,0,No user reviews,0,0,0
304460,True,5,Mixed,80,42,122
304480,True,7,Positive,8,2,10
304500,True,6,Mostly Positive,15,6,21
304520,True,0,No user reviews,0,0,0
304530,True,5,Mixed,887,557,1444
304540,True,5,Mixed,7,6,13
304570,True,0,No user reviews,0,0,0
304580,True,5,Mixed,33,40,73
304590,True,0,3 user reviews,2,1,3
304600,True,0,No user reviews,0,0,0
304610,True,0,No user reviews,0,0,0
304620,True,0,No user reviews,0,0,0
304650,True,8,Very Positive,3773,734,4507
304670,True,6,Mostly Positive,148,49,197
304690,True,0,4 user reviews,2,2,4
304710,True,0,No user reviews,0,0,0
304730,True,5,Mixed,671,520,1191
304750,True,0,9 user reviews,0,9,9
304810,True,0,7 user reviews,4,3,7
304850,True,7,Positive,17,3,20
304870,True,0,No user reviews,0,0,0
304890,True,0,No user reviews,0,0,0
304910,True,8,Very Positive,94,22,116
304930,True,8,Very Positive,2680,292,2972
304950,True,6,Mostly Positive,245,80,325
304970,True,0,1 user reviews,1,0,1
305010,True,0,7 user reviews,5,2,7
305030,True,0,No user reviews,0,0,0
305050,True,6,Mostly Positive,308,111,419
305070,True,6,Mostly Positive,51,17,68
305140,True,0,No user reviews,0,0,0
305150,True,0,No user reviews,0,0,0
305180,True,5,Mixed,23,10,33
305181,True,7,Positive,23,0,23
305182,True,7,Positive,8,2,10
305183,True,0,7 user reviews,5,2,7
305184,True,5,Mixed,6,5,11
305185,True,0,7 user reviews,5,2,7
305186,True,0,9 user reviews,6,3,9
305187,True,0,9 user reviews,7,2,9
305190,True,0,No user reviews,0,0,0
305200,True,0,3 user reviews,0,3,3
305221,True,0,4 user reviews,3,1,4
305260,True,5,Mixed,10,6,16
305280,True,0,No user reviews,0,0,0
305300,True,0,No user reviews,0,0,0
305310,True,0,No user reviews,0,0,0
305311,True,0,No user reviews,0,0,0
305320,True,0,No user reviews,0,0,0
305321,True,0,No user reviews,0,0,0
305322,True,0,No user reviews,0,0,0
305323,True,0,No user reviews,0,0,0
305324,True,0,No user reviews,0,0,0
305325,True,0,No user reviews,0,0,0
305326,True,0,No user reviews,0,0,0
305327,True,0,No user reviews,0,0,0
305328,True,0,No user reviews,0,0,0
305329,True,0,No user reviews,0,0,0
305330,True,0,No user reviews,0,0,0
305331,True,0,No user reviews,0,0,0
305332,True,0,No user reviews,0,0,0
305333,True,0,No user reviews,0,0,0
305334,True,0,No user reviews,0,0,0
305335,True,0,No user reviews,0,0,0
305336,True,0,No user reviews,0,0,0
305337,True,0,No user reviews,0,0,0
305338,True,0,No user reviews,0,0,0
305339,True,0,No user reviews,0,0,0
305340,True,0,No user reviews,0,0,0
305341,True,0,No user reviews,0,0,0
305342,True,0,1 user reviews,1,0,1
305360,True,0,2 user reviews,2,0,2
305370,True,0,No user reviews,0,0,0
305380,True,8,Very Positive,438,46,484
305390,True,5,Mixed,14,18,32
305400,True,0,No user reviews,0,0,0
305410,True,0,1 user reviews,1,0,1
305420,True,0,No user reviews,0,0,0
305430,True,0,No user reviews,0,0,0
305431,True,0,No user reviews,0,0,0
305440,True,0,No user reviews,0,0,0
305450,True,0,1 user reviews,1,0,1
305460,True,0,8 user reviews,3,5,8
305470,True,0,1 user reviews,0,1,1
305471,True,0,No user reviews,0,0,0
305472,True,0,No user reviews,0,0,0
305480,True,5,Mixed,9,6,15
305490,True,6,Mostly Positive,15,4,19
305500,True,5,Mixed,17,14,31
305510,True,5,Mixed,32,36,68
305530,True,0,No user reviews,0,0,0
305531,True,0,No user reviews,0,0,0
305532,True,0,No user reviews,0,0,0
305540,True,0,No user reviews,0,0,0
305570,True,0,5 user reviews,5,0,5
305620,True,8,Very Positive,21545,2388,23933
305640,True,5,Mixed,127,68,195
305660,True,4,Mostly Negative,4,13,17
305700,True,0,6 user reviews,3,3,6
305720,True,0,6 user reviews,4,2,6
305740,True,6,Mostly Positive,10,3,13
305760,True,8,Very Positive,80,1,81
305780,True,6,Mostly Positive,72,20,92
305800,True,5,Mixed,26,12,38
305820,True,7,Positive,14,2,16
305840,True,4,Mostly Negative,32,94,126
305860,True,5,Mixed,10,11,21
305880,True,0,3 user reviews,3,0,3
305920,True,8,Very Positive,51,4,55
305940,True,5,Mixed,221,143,364
305960,True,4,Mostly Negative,183,333,516
305980,True,5,Mixed,30,21,51
306000,True,6,Mostly Positive,8,3,11
306020,True,8,Very Positive,3618,255,3873
306040,True,6,Mostly Positive,398,134,532
306060,True,0,No user reviews,0,0,0
306100,True,0,1 user reviews,1,0,1
306110,True,0,No user reviews,0,0,0
306130,True,8,Very Positive,31132,7232,38364
306150,True,0,6 user reviews,3,3,6
306160,True,7,Positive,20,4,24
306170,True,0,2 user reviews,2,0,2
306171,True,0,2 user reviews,2,0,2
306180,True,7,Positive,10,0,10
306190,True,0,No user reviews,0,0,0
306200,True,6,Mostly Positive,133,39,172
306240,True,0,No user reviews,0,0,0
306260,True,5,Mixed,8,11,19
306280,True,0,No user reviews,0,0,0
306300,True,0,No user reviews,0,0,0
306320,True,0,No user reviews,0,0,0
306330,True,0,No user reviews,0,0,0
306350,True,7,Positive,14,2,16
306370,True,5,Mixed,34,26,60
306390,True,5,Mixed,12,11,23
306391,True,5,Mixed,29,17,46
306392,True,7,Positive,13,3,16
306393,True,5,Mixed,13,11,24
306394,True,5,Mixed,8,6,14
306395,True,5,Mixed,7,5,12
306396,True,6,Mostly Positive,20,6,26
306397,True,5,Mixed,9,12,21
306398,True,6,Mostly Positive,14,5,19
306399,True,5,Mixed,6,9,15
306401,True,0,4 user reviews,4,0,4
306410,True,5,Mixed,60,61,121
306440,True,5,Mixed,38,32,70
306460,True,8,Very Positive,3447,195,3642
306470,True,0,No user reviews,0,0,0
306480,True,5,Mixed,17,8,25
306490,True,5,Mixed,35,31,66
306500,True,0,No user reviews,0,0,0
306510,True,0,No user reviews,0,0,0
306530,True,0,No user reviews,0,0,0
306531,True,0,1 user reviews,1,0,1
306550,True,8,Very Positive,127,26,153
306601,True,0,1 user reviews,1,0,1
306610,True,0,1 user reviews,1,0,1
306620,True,5,Mixed,9,7,16
306630,True,6,Mostly Positive,135,37,172
306640,True,8,Very Positive,66,6,72
306660,True,8,Very Positive,1411,281,1692
306670,True,4,Mostly Negative,57,215,272
306680,True,8,Very Positive,119,25,144
306690,True,5,Mixed,140,77,217
306700,True,8,Very Positive,148,17,165
306720,True,0,No user reviews,0,0,0
306721,True,0,1 user reviews,1,0,1
306722,True,0,No user reviews,0,0,0
306723,True,0,No user reviews,0,0,0
306760,True,6,Mostly Positive,1308,354,1662
306850,True,7,Positive,22,0,22
306880,True,0,9 user reviews,5,4,9
306890,True,0,9 user reviews,8,1,9
306930,True,0,No user reviews,0,0,0
306950,True,5,Mixed,6,4,10
307010,True,8,Very Positive,67,11,78
307030,True,7,Positive,9,1,10
307050,True,8,Very Positive,309,54,363
307070,True,5,Mixed,10,8,18
307090,True,6,Mostly Positive,35,15,50
307110,True,8,Very Positive,1392,216,1608
307130,True,5,Mixed,45,56,101
307150,True,5,Mixed,13,9,22
307170,True,5,Mixed,10,6,16
307190,True,8,Very Positive,48,11,59
307210,True,5,Mixed,13,11,24
307230,True,6,Mostly Positive,434,169,603
307270,True,0,4 user reviews,3,1,4
307290,True,0,7 user reviews,3,4,7
307340,True,8,Very Positive,147,8,155
307350,True,5,Mixed,7,8,15
307390,True,0,1 user reviews,0,1,1
307410,True,0,8 user reviews,2,6,8
307420,True,0,3 user reviews,2,1,3
307430,True,5,Mixed,25,11,36
307450,True,0,No user reviews,0,0,0
307451,True,0,No user reviews,0,0,0
307452,True,0,No user reviews,0,0,0
307453,True,0,No user reviews,0,0,0
307454,True,0,No user reviews,0,0,0
307456,True,0,No user reviews,0,0,0
307457,True,0,No user reviews,0,0,0
307458,True,0,No user reviews,0,0,0
307459,True,0,No user reviews,0,0,0
307460,True,0,No user reviews,0,0,0
307461,True,0,No user reviews,0,0,0
307462,True,0,No user reviews,0,0,0
307463,True,0,No user reviews,0,0,0
307464,True,0,No user reviews,0,0,0
307465,True,0,No user reviews,0,0,0
307500,True,0,No user reviews,0,0,0
307530,True,0,4 user reviews,0,4,4
307540,True,0,No user reviews,0,0,0
307560,True,0,8 user reviews,4,4,8
307570,True,6,Mostly Positive,68,25,93
307580,True,9,Overwhelmingly Positive,521,26,547
307590,True,7,Positive,24,2,26
307600,True,5,Mixed,17,8,25
307610,True,0,4 user reviews,1,3,4
307620,True,5,Mixed,24,15,39
307640,True,8,Very Positive,349,64,413
307650,True,0,2 user reviews,2,0,2
307670,True,6,Mostly Positive,1233,372,1605
307690,True,8,Very Positive,10484,809,11293
307720,True,0,No user reviews,0,0,0
307740,True,7,Positive,16,2,18
307750,True,6,Mostly Positive,12,4,16
307760,True,5,Mixed,52,38,90
307770,True,6,Mostly Positive,23,6,29
307780,True,6,Mostly Positive,5072,2003,7075
307781,True,0,No user reviews,0,0,0
307800,True,5,Mixed,15,11,26
307810,True,0,No user reviews,0,0,0
307820,True,0,1 user reviews,1,0,1
307821,True,0,1 user reviews,1,0,1
307822,True,0,1 user reviews,1,0,1
307823,True,0,1 user reviews,1,0,1
307824,True,0,3 user reviews,3,0,3
307825,True,0,1 user reviews,1,0,1
307860,True,0,No user reviews,0,0,0
307880,True,5,Mixed,1520,1144,2664
307900,True,7,Positive,17,4,21
307920,True,5,Mixed,9,6,15
307930,True,5,Mixed,20,19,39
307940,True,6,Mostly Positive,131,45,176
307960,True,6,Mostly Positive,1688,460,2148
307980,True,5,Mixed,18,15,33
307990,True,5,Mixed,23,21,44
308000,True,7,Positive,30,4,34
308010,True,0,No user reviews,0,0,0
308020,True,0,No user reviews,0,0,0
308030,True,0,No user reviews,0,0,0
308040,True,6,Mostly Positive,91,38,129
308060,True,6,Mostly Positive,158,43,201
308080,True,5,Mixed,14,8,22
308140,True,0,No user reviews,0,0,0
308150,True,0,No user reviews,0,0,0
308160,True,0,No user reviews,0,0,0
308161,True,0,No user reviews,0,0,0
308162,True,0,No user reviews,0,0,0
308163,True,0,No user reviews,0,0,0
308164,True,0,No user reviews,0,0,0
308171,True,0,2 user reviews,1,1,2
308172,True,0,3 user reviews,2,1,3
308173,True,6,Mostly Positive,212,73,285
308180,True,7,Positive,14,2,16
308261,True,0,1 user reviews,1,0,1
308262,True,0,1 user reviews,1,0,1
308263,True,0,1 user reviews,1,0,1
308264,True,0,No user reviews,0,0,0
308265,True,0,1 user reviews,1,0,1
308266,True,0,1 user reviews,1,0,1
308267,True,0,5 user reviews,5,0,5
308268,True,0,No user reviews,0,0,0
308269,True,0,3 user reviews,3,0,3
308270,True,6,Mostly Positive,169,44,213
308300,True,7,Positive,8,2,10
308310,True,7,Positive,16,1,17
308330,True,7,Positive,24,5,29
308360,True,7,Positive,17,2,19
308380,True,6,Mostly Positive,10,3,13
308400,True,0,1 user reviews,1,0,1
308420,True,8,Very Positive,1612,205,1817
308440,True,0,7 user reviews,6,1,7
308460,True,5,Mixed,50,22,72
308520,True,4,Mostly Negative,10,18,28
308540,True,0,4 user reviews,3,1,4
308560,True,6,Mostly Positive,14,5,19
308580,True,7,Positive,8,2,10
308600,True,8,Very Positive,90,5,95
309870,True,0,2 user reviews,2,0,2
309871,True,0,2 user reviews,2,0,2
309872,True,0,No user reviews,0,0,0
309890,True,0,No user reviews,0,0,0
309900,True,5,Mixed,12,8,20
309920,True,0,2 user reviews,2,0,2
309940,True,0,2 user reviews,2,0,2
309970,True,0,No user reviews,0,0,0
309971,True,0,No user reviews,0,0,0
309972,True,0,No user reviews,0,0,0
309973,True,0,1 user reviews,1,0,1
309990,True,7,Positive,24,4,28
309991,True,7,Positive,21,5,26
310030,True,5,Mixed,12,7,19
310031,True,5,Mixed,107,80,187
310032,True,0,7 user reviews,6,1,7
310033,True,0,5 user reviews,3,2,5
310034,True,0,7 user reviews,5,2,7
310040,True,0,No user reviews,0,0,0
310050,True,0,3 user reviews,1,2,3
310060,True,8,Very Positive,669,117,786
310070,True,6,Mostly Positive,10,3,13
310080,True,9,Overwhelmingly Positive,3316,172,3488
310090,True,0,1 user reviews,1,0,1
310091,True,0,1 user reviews,1,0,1
310100,True,0,9 user reviews,8,1,9
310110,True,5,Mixed,48,52,100
310240,True,0,No user reviews,0,0,0
310260,True,0,1 user reviews,0,1,1
310280,True,0,1 user reviews,0,1,1
310300,True,0,3 user reviews,3,0,3
310360,True,9,Overwhelmingly Positive,844,38,882
310370,True,5,Mixed,22,13,35
310380,True,6,Mostly Positive,934,239,1173
310390,True,8,Very Positive,54,13,67
310400,True,0,1 user reviews,1,0,1
310410,True,0,2 user reviews,2,0,2
310420,True,0,3 user reviews,2,1,3
310430,True,0,3 user reviews,1,2,3
310440,True,0,3 user reviews,2,1,3
310450,True,0,4 user reviews,3,1,4
310460,True,0,9 user reviews,2,7,9
310470,True,5,Mixed,314,426,740
310490,True,8,Very Positive,71,13,84
310510,True,8,Very Positive,611,138,749
310530,True,0,No user reviews,0,0,0
310560,True,8,Very Positive,8107,932,9039
310580,True,0,No user reviews,0,0,0
310640,True,3,Negative,2,12,14
310660,True,7,Positive,27,1,28
310680,True,0,1 user reviews,1,0,1
310690,True,0,8 user reviews,2,6,8
310700,True,8,Very Positive,300,35,335
310740,True,8,Very Positive,148,22,170
310750,True,0,No user reviews,0,0,0
310751,True,0,No user reviews,0,0,0
310752,True,0,No user reviews,0,0,0
310790,True,8,Very Positive,692,71,763
310810,True,7,Positive,16,3,19
310830,True,0,6 user reviews,5,1,6
310850,True,4,Mostly Negative,29,54,83
310880,True,3,Negative,3,16,19
310890,True,5,Mixed,193,191,384
310950,True,5,Mixed,4434,2875,7309
310970,True,6,Mostly Positive,14,5,19
310990,True,0,1 user reviews,1,0,1
311010,True,8,Very Positive,255,63,318
311030,True,0,No user reviews,0,0,0
311031,True,0,3 user reviews,0,3,3
311040,True,4,Mostly Negative,22,34,56
311050,True,5,Mixed,152,96,248
311060,True,7,Positive,17,2,19
311080,True,4,Mostly Negative,6,22,28
311100,True,6,Mostly Positive,12,4,16
311120,True,5,Mixed,73,84,157
311140,True,5,Mixed,99,72,171
311160,True,5,Mixed,11,10,21
311161,True,5,Mixed,10,5,15
311162,True,0,3 user reviews,1,2,3
311163,True,0,7 user reviews,4,3,7
311164,True,5,Mixed,20,11,31
311170,True,4,Mostly Negative,5,8,13
311190,True,8,Very Positive,374,13,387
311210,True,6,Mostly Positive,22301,5698,27999
311240,True,8,Very Positive,1192,165,1357
311250,True,5,Mixed,53,36,89
311260,True,5,Mixed,867,645,1512
311290,True,6,Mostly Positive,1108,432,1540
311310,True,5,Mixed,2066,1387,3453
311320,True,0,1 user reviews,1,0,1
311330,True,0,4 user reviews,4,0,4
311340,True,8,Very Positive,4461,971,5432
311380,True,0,1 user reviews,1,0,1
311400,True,4,Mostly Negative,78,179,257
311440,True,0,2 user reviews,2,0,2
311460,True,0,No user reviews,0,0,0
311480,True,6,Mostly Positive,77,28,105
311490,True,0,8 user reviews,5,3,8
311500,True,0,2 user reviews,1,1,2
311540,True,0,3 user reviews,2,1,3
311550,True,0,1 user reviews,1,0,1
311551,True,0,3 user reviews,2,1,3
311560,True,8,Very Positive,2648,525,3173
311590,True,0,No user reviews,0,0,0
311600,True,5,Mixed,6,6,12
311660,True,6,Mostly Positive,47,18,65
311680,True,6,Mostly Positive,27,11,38
311690,True,9,Overwhelmingly Positive,22415,991,23406
311720,True,6,Mostly Positive,166,47,213
311730,True,5,Mixed,926,518,1444
311770,True,6,Mostly Positive,246,67,313
311800,True,8,Very Positive,290,20,310
311820,True,7,Positive,14,1,15
311840,True,4,Mostly Negative,13,20,33
311850,True,6,Mostly Positive,22,7,29
311860,True,6,Mostly Positive,28,10,38
311870,True,8,Very Positive,400,56,456
311910,True,5,Mixed,33,24,57
311920,True,0,1 user reviews,0,1,1
311921,True,0,No user reviews,0,0,0
311930,True,7,Positive,47,2,49
311940,True,0,1 user reviews,0,1,1
311950,True,0,2 user reviews,2,0,2
311980,True,3,Negative,6,26,32
311990,True,0,No user reviews,0,0,0
312000,True,0,No user reviews,0,0,0
312010,True,8,Very Positive,143,16,159
312020,True,0,5 user reviews,2,3,5
312050,True,0,4 user reviews,2,2,4
312060,True,0,1 user reviews,1,0,1
312090,True,0,1 user reviews,1,0,1
312150,True,7,Positive,27,2,29
312200,True,5,Mixed,346,152,498
312210,True,5,Mixed,243,353,596
312220,True,0,3 user reviews,1,2,3
312230,True,6,Mostly Positive,184,52,236
312240,True,0,4 user reviews,2,2,4
312260,True,0,No user reviews,0,0,0
312270,True,0,No user reviews,0,0,0
312280,True,7,Positive,33,8,41
312290,True,6,Mostly Positive,32,9,41
312300,True,8,Very Positive,103,11,114
312310,True,0,2 user reviews,2,0,2
312330,True,0,No user reviews,0,0,0
312340,True,0,No user reviews,0,0,0
312350,True,6,Mostly Positive,110,32,142
312360,True,5,Mixed,57,30,87
312370,True,8,Very Positive,379,82,461
312380,True,7,Positive,9,2,11
312390,True,6,Mostly Positive,20,6,26
312400,True,0,9 user reviews,2,7,9
312410,True,6,Mostly Positive,19,7,26
312420,True,5,Mixed,9,10,19
312430,True,5,Mixed,96,99,195
312440,True,5,Mixed,11,7,18
312450,True,8,Very Positive,241,46,287
312510,True,7,Positive,28,7,35
312520,True,8,Very Positive,1520,179,1699
312530,True,9,Overwhelmingly Positive,7719,251,7970
312540,True,8,Very Positive,300,27,327
312560,True,8,Very Positive,172,18,190
312580,True,0,No user reviews,0,0,0
312590,True,0,2 user reviews,1,1,2
312600,True,5,Mixed,39,18,57
312610,True,8,Very Positive,500,75,575
312630,True,6,Mostly Positive,75,20,95
312640,True,6,Mostly Positive,13,4,17
312650,True,6,Mostly Positive,166,52,218
312660,True,8,Very Positive,5755,769,6524
312670,True,8,Very Positive,856,148,1004
312680,True,5,Mixed,11,7,18
312690,True,7,Positive,11,2,13
312720,True,8,Very Positive,67,3,70
312740,True,6,Mostly Positive,11,3,14
312750,True,8,Very Positive,726,145,871
312780,True,6,Mostly Positive,712,186,898
312790,True,5,Mixed,76,63,139
312800,True,0,No user reviews,0,0,0
312840,True,6,Mostly Positive,832,280,1112
312860,True,0,3 user reviews,2,1,3
312900,True,5,Mixed,23,13,36
312920,True,8,Very Positive,85,18,103
312930,True,0,No user reviews,0,0,0
312960,True,4,Mostly Negative,11,29,40
312970,True,6,Mostly Positive,58,15,73
312980,True,8,Very Positive,279,37,316
312990,True,8,Very Positive,60,3,63
313010,True,4,Mostly Negative,261,642,903
313020,True,8,Very Positive,753,171,924
313030,True,0,No user reviews,0,0,0
313040,True,4,Mostly Negative,16,28,44
313080,True,5,Mixed,148,95,243
313110,True,0,No user reviews,0,0,0
313120,True,6,Mostly Positive,11819,3937,15756
313130,True,5,Mixed,26,20,46
313140,True,6,Mostly Positive,75,27,102
313160,True,8,Very Positive,3433,381,3814
313190,True,0,8 user reviews,1,7,8
313200,True,5,Mixed,22,13,35
313210,True,5,Mixed,46,29,75
313220,True,0,No user reviews,0,0,0
313240,True,6,Mostly Positive,7,3,10
313260,True,0,9 user reviews,6,3,9
313280,True,0,1 user reviews,1,0,1
313281,True,0,2 user reviews,1,1,2
313290,True,0,No user reviews,0,0,0
313300,True,0,No user reviews,0,0,0
313310,True,0,No user reviews,0,0,0
313311,True,0,No user reviews,0,0,0
313320,True,0,No user reviews,0,0,0
313330,True,4,Mostly Negative,4,16,20
313340,True,8,Very Positive,3992,654,4646
313350,True,0,2 user reviews,2,0,2
313360,True,6,Mostly Positive,26,8,34
313381,True,4,Mostly Negative,11,22,33
313390,True,6,Mostly Positive,58,19,77
313400,True,8,Very Positive,122,4,126
313420,True,6,Mostly Positive,12,5,17
313430,True,7,Positive,23,4,27
313470,True,7,Positive,40,7,47
313480,True,8,Very Positive,212,35,247
313500,True,8,Very Positive,191,34,225
313520,True,0,No user reviews,0,0,0
313560,True,7,Positive,20,1,21
313590,True,6,Mostly Positive,121,32,153
313620,True,2,Very Negative,23,98,121
313630,True,6,Mostly Positive,1090,303,1393
313650,True,5,Mixed,48,27,75
313660,True,5,Mixed,29,15,44
313680,True,0,No user reviews,0,0,0
313690,True,8,Very Positive,847,168,1015
313710,True,0,No user reviews,0,0,0
313711,True,0,No user reviews,0,0,0
313712,True,0,No user reviews,0,0,0
313713,True,0,No user reviews,0,0,0
313730,True,7,Positive,11,1,12
313740,True,6,Mostly Positive,2473,845,3318
313760,True,7,Positive,12,3,15
313780,True,6,Mostly Positive,454,138,592
313790,True,0,4 user reviews,3,1,4
313800,True,0,4 user reviews,4,0,4
313810,True,5,Mixed,54,31,85
313830,True,5,Mixed,53,31,84
313850,True,0,No user reviews,0,0,0
313870,True,5,Mixed,42,34,76
313900,True,0,No user reviews,0,0,0
313920,True,0,No user reviews,0,0,0
313930,True,0,No user reviews,0,0,0
313931,True,0,2 user reviews,1,1,2
313932,True,0,No user reviews,0,0,0
313960,True,5,Mixed,7,10,17
313980,True,8,Very Positive,80,18,98
313990,True,0,No user reviews,0,0,0
314000,True,6,Mostly Positive,128,44,172
314010,True,8,Very Positive,68,16,84
314020,True,6,Mostly Positive,1201,367,1568
314030,True,8,Very Positive,164,22,186
314050,True,0,4 user reviews,2,2,4
314070,True,8,Very Positive,440,43,483
314091,True,0,No user reviews,0,0,0
314120,True,5,Mixed,8,4,12
314130,True,0,1 user reviews,0,1,1
314150,True,5,Mixed,135,121,256
314160,True,8,Very Positive,8589,1585,10174
314170,True,0,No user reviews,0,0,0
314180,True,8,Very Positive,143,5,148
314200,True,5,Mixed,23,10,33
314210,True,4,Mostly Negative,3,9,12
314220,True,5,Mixed,24,17,41
314230,True,8,Very Positive,1004,62,1066
314240,True,5,Mixed,184,155,339
314250,True,6,Mostly Positive,51,16,67
314280,True,5,Mixed,9,6,15
314290,True,0,7 user reviews,4,3,7
314300,True,0,3 user reviews,1,2,3
314320,True,5,Mixed,87,40,127
314330,True,8,Very Positive,43,7,50
314340,True,5,Mixed,23,29,52
314350,True,0,4 user reviews,3,1,4
314360,True,0,2 user reviews,2,0,2
314370,True,7,Positive,38,8,46
314380,True,5,Mixed,92,77,169
314390,True,0,No user reviews,0,0,0
314400,True,0,1 user reviews,1,0,1
314410,True,8,Very Positive,741,64,805
314420,True,0,7 user reviews,4,3,7
314430,True,0,No user reviews,0,0,0
314450,True,8,Very Positive,492,116,608
314460,True,5,Mixed,10,10,20
314470,True,8,Very Positive,98,15,113
314490,True,0,No user reviews,0,0,0
314500,True,6,Mostly Positive,74,22,96
314510,True,5,Mixed,13,13,26
314520,True,5,Mixed,301,230,531
314530,True,0,9 user reviews,0,9,9
314540,True,0,8 user reviews,5,3,8
314560,True,5,Mixed,41,32,73
314570,True,0,1 user reviews,1,0,1
314590,True,7,Positive,16,1,17
314610,True,0,No user reviews,0,0,0
314630,True,0,7 user reviews,6,1,7
314650,True,9,Overwhelmingly Positive,1775,93,1868
314660,True,8,Very Positive,1046,162,1208
314680,True,7,Positive,36,0,36
314710,True,5,Mixed,441,396,837
314730,True,0,7 user reviews,4,3,7
314750,True,0,1 user reviews,0,1,1
314760,True,4,Mostly Negative,3,11,14
314770,True,5,Mixed,7,4,11
314780,True,0,No user reviews,0,0,0
314781,True,0,No user reviews,0,0,0
314782,True,0,No user reviews,0,0,0
314783,True,0,No user reviews,0,0,0
314790,True,6,Mostly Positive,165,54,219
314810,True,5,Mixed,110,93,203
314830,True,5,Mixed,141,90,231
314850,True,3,Negative,0,13,13
314860,True,0,No user reviews,0,0,0
314950,True,4,Mostly Negative,4,10,14
314970,True,7,Positive,9,1,10
314980,True,6,Mostly Positive,449,153,602
315030,True,0,No user reviews,0,0,0
315050,True,0,9 user reviews,6,3,9
315060,True,0,9 user reviews,6,3,9
315070,True,0,4 user reviews,1,3,4
315080,True,6,Mostly Positive,11,3,14
315100,True,0,1 user reviews,1,0,1
315101,True,0,2 user reviews,1,1,2
315110,True,8,Very Positive,48,8,56
315120,True,0,2 user reviews,1,1,2
315130,True,5,Mixed,8,7,15
315150,True,5,Mixed,9,11,20
315151,True,6,Mostly Positive,18,5,23
315190,True,0,No user reviews,0,0,0
315200,True,7,Positive,15,0,15
315220,True,0,No user reviews,0,0,0
315240,True,5,Mixed,12,14,26
315260,True,5,Mixed,46,47,93
315320,True,4,Mostly Negative,12,22,34
315330,True,3,Negative,4,21,25
315340,True,5,Mixed,56,35,91
315392,True,0,9 user reviews,2,7,9
315393,True,5,Mixed,18,8,26
315410,True,0,No user reviews,0,0,0
315411,True,0,No user reviews,0,0,0
315412,True,0,No user reviews,0,0,0
315420,True,0,No user reviews,0,0,0
315430,True,6,Mostly Positive,1298,430,1728
315440,True,5,Mixed,60,50,110
315450,True,5,Mixed,6,5,11
315460,True,8,Very Positive,1691,145,1836
315480,True,0,4 user reviews,1,3,4
315490,True,0,3 user reviews,2,1,3
315510,True,0,No user reviews,0,0,0
315520,True,0,2 user reviews,2,0,2
315530,True,0,7 user reviews,6,1,7
315540,True,5,Mixed,16,16,32
315550,True,5,Mixed,34,45,79
315560,True,0,6 user reviews,6,0,6
315610,True,6,Mostly Positive,10,4,14
315630,True,0,No user reviews,0,0,0
315640,True,0,No user reviews,0,0,0
315650,True,7,Positive,11,0,11
315660,True,6,Mostly Positive,756,287,1043
315670,True,6,Mostly Positive,90,38,128
315680,True,4,Mostly Negative,8,17,25
315690,True,0,No user reviews,0,0,0
315720,True,0,3 user reviews,3,0,3
315730,True,0,No user reviews,0,0,0
315800,True,0,No user reviews,0,0,0
315810,True,8,Very Positive,460,29,489
315830,True,8,Very Positive,48,6,54
315840,True,8,Very Positive,291,38,329
315850,True,5,Mixed,78,38,116
315860,True,5,Mixed,169,77,246
315880,True,0,No user reviews,0,0,0
315890,True,0,8 user reviews,6,2,8
315906,True,0,1 user reviews,1,0,1
315907,True,0,No user reviews,0,0,0
315908,True,0,No user reviews,0,0,0
315909,True,0,No user reviews,0,0,0
315916,True,0,3 user reviews,1,2,3
315917,True,0,No user reviews,0,0,0
315918,True,0,No user reviews,0,0,0
315919,True,0,No user reviews,0,0,0
315920,True,5,Mixed,30,21,51
315930,True,5,Mixed,9,6,15
315940,True,5,Mixed,9,6,15
315960,True,7,Positive,23,1,24
315970,True,0,No user reviews,0,0,0
315990,True,0,4 user reviews,1,3,4
316000,True,0,No user reviews,0,0,0
316010,True,6,Mostly Positive,524,143,667
316020,True,6,Mostly Positive,11,4,15
316030,True,5,Mixed,18,9,27
316040,True,0,No user reviews,0,0,0
316050,True,0,1 user reviews,1,0,1
316060,True,5,Mixed,10,6,16
316070,True,0,1 user reviews,1,0,1
316080,True,8,Very Positive,61,8,69
316090,True,0,No user reviews,0,0,0
316100,True,0,No user reviews,0,0,0
316110,True,0,No user reviews,0,0,0
316130,True,0,No user reviews,0,0,0
316131,True,0,1 user reviews,1,0,1
316140,True,5,Mixed,26,21,47
316160,True,5,Mixed,44,44,88
316180,True,5,Mixed,19,10,29
316240,True,3,Negative,2,16,18
316260,True,6,Mostly Positive,36,15,51
316290,True,0,No user reviews,0,0,0
316320,True,4,Mostly Negative,4,7,11
316360,True,7,Positive,12,0,12
316370,True,4,Mostly Negative,9,18,27
316390,True,4,Mostly Negative,29,49,78
316410,True,8,Very Positive,347,52,399
316430,True,5,Mixed,517,355,872
316440,True,0,6 user reviews,6,0,6
316441,True,0,3 user reviews,3,0,3
316442,True,0,3 user reviews,1,2,3
316443,True,0,3 user reviews,3,0,3
316444,True,0,6 user reviews,5,1,6
316445,True,0,2 user reviews,2,0,2
316446,True,0,9 user reviews,6,3,9
316447,True,0,5 user reviews,5,0,5
316448,True,0,3 user reviews,2,1,3
316450,True,0,No user reviews,0,0,0
316460,True,0,6 user reviews,6,0,6
316470,True,0,No user reviews,0,0,0
316480,True,7,Positive,20,5,25
316490,True,0,No user reviews,0,0,0
316491,True,0,No user reviews,0,0,0
316500,True,0,No user reviews,0,0,0
316510,True,0,No user reviews,0,0,0
316520,True,0,No user reviews,0,0,0
316530,True,0,No user reviews,0,0,0
316540,True,0,No user reviews,0,0,0
316541,True,0,No user reviews,0,0,0
316542,True,0,No user reviews,0,0,0
316560,True,7,Positive,40,1,41
316570,True,0,No user reviews,0,0,0
316590,True,0,1 user reviews,1,0,1
316600,True,8,Very Positive,164,10,174
316610,True,8,Very Positive,183,4,187
316620,True,0,3 user reviews,2,1,3
316630,True,0,4 user reviews,3,1,4
316640,True,0,No user reviews,0,0,0
316650,True,0,No user reviews,0,0,0
316651,True,0,No user reviews,0,0,0
316660,True,7,Positive,16,1,17
316670,True,0,No user reviews,0,0,0
316671,True,0,No user reviews,0,0,0
316680,True,0,No user reviews,0,0,0
316700,True,2,Very Negative,6,45,51
316710,True,0,1 user reviews,0,1,1
316720,True,9,Overwhelmingly Positive,976,24,1000
316740,True,5,Mixed,7,10,17
316750,True,4,Mostly Negative,54,136,190
316790,True,8,Very Positive,2187,272,2459
316810,True,5,Mixed,28,23,51
316820,True,0,No user reviews,0,0,0
316821,True,0,No user reviews,0,0,0
316830,True,0,5 user reviews,4,1,5
316840,True,6,Mostly Positive,20,7,27
316850,True,0,No user reviews,0,0,0
316860,True,0,1 user reviews,1,0,1
316861,True,0,1 user reviews,1,0,1
316862,True,0,2 user reviews,2,0,2
316863,True,0,2 user reviews,2,0,2
316864,True,0,4 user reviews,3,1,4
316865,True,0,1 user reviews,1,0,1
316866,True,0,No user reviews,0,0,0
316867,True,0,No user reviews,0,0,0
316868,True,0,2 user reviews,2,0,2
316870,True,0,No user reviews,0,0,0
316890,True,5,Mixed,42,22,64
316900,True,0,No user reviews,0,0,0
316910,True,7,Positive,31,2,33
316920,True,0,1 user reviews,1,0,1
316930,True,5,Mixed,197,107,304
316950,True,4,Mostly Negative,8,24,32
316960,True,6,Mostly Positive,18,7,25
316961,True,0,2 user reviews,1,1,2
316962,True,4,Mostly Negative,15,45,60
316963,True,6,Mostly Positive,12,5,17
316964,True,8,Very Positive,85,15,100
316965,True,7,Positive,26,3,29
316966,True,7,Positive,10,0,10
316967,True,7,Positive,21,1,22
316970,True,5,Mixed,22,27,49
316980,True,0,No user reviews,0,0,0
317000,True,0,No user reviews,0,0,0
317020,True,7,Positive,19,0,19
317030,True,8,Very Positive,53,5,58
317040,True,8,Very Positive,242,16,258
317060,True,5,Mixed,17,10,27
317080,True,3,Negative,1,11,12
317100,True,6,Mostly Positive,172,62,234
317140,True,0,1 user reviews,1,0,1
317150,True,0,5 user reviews,5,0,5
317170,True,0,No user reviews,0,0,0
317202,True,0,8 user reviews,4,4,8
317203,True,0,7 user reviews,2,5,7
317210,True,0,No user reviews,0,0,0
317230,True,0,No user reviews,0,0,0
317240,True,0,No user reviews,0,0,0
317250,True,6,Mostly Positive,641,195,836
317260,True,0,No user reviews,0,0,0
317280,True,8,Very Positive,64,10,74
317290,True,0,9 user reviews,7,2,9
317300,True,6,Mostly Positive,55,15,70
317320,True,8,Very Positive,89,7,96
317330,True,4,Mostly Negative,4,8,12
317350,True,0,No user reviews,0,0,0
317360,True,8,Very Positive,84,13,97
317370,True,5,Mixed,19,11,30
317380,True,6,Mostly Positive,17,5,22
317400,True,8,Very Positive,122,5,127
317410,True,0,8 user reviews,6,2,8
317430,True,0,No user reviews,0,0,0
317440,True,5,Mixed,28,29,57
317450,True,0,No user reviews,0,0,0
317451,True,0,No user reviews,0,0,0
317452,True,0,No user reviews,0,0,0
317453,True,0,No user reviews,0,0,0
317454,True,0,No user reviews,0,0,0
317455,True,0,No user reviews,0,0,0
317460,True,0,No user reviews,0,0,0
317461,True,0,No user reviews,0,0,0
317462,True,0,1 user reviews,0,1,1
317463,True,0,No user reviews,0,0,0
317464,True,0,1 user reviews,1,0,1
317465,True,0,No user reviews,0,0,0
317470,True,6,Mostly Positive,17,6,23
317480,True,7,Positive,24,1,25
317490,True,7,Positive,17,4,21
317500,True,0,3 user reviews,1,2,3
317501,True,0,4 user reviews,3,1,4
317510,True,8,Very Positive,348,64,412
317530,True,5,Mixed,40,24,64
317540,True,0,2 user reviews,2,0,2
317550,True,0,2 user reviews,2,0,2
317560,True,0,3 user reviews,3,0,3
317580,True,0,8 user reviews,5,3,8
317590,True,0,8 user reviews,4,4,8
317591,True,0,No user reviews,0,0,0
317592,True,0,No user reviews,0,0,0
317600,True,0,No user reviews,0,0,0
317610,True,4,Mostly Negative,3,8,11
317620,True,6,Mostly Positive,339,129,468
317660,True,5,Mixed,50,42,92
317670,True,0,No user reviews,0,0,0
317690,True,0,1 user reviews,0,1,1
317710,True,8,Very Positive,139,10,149
317720,True,0,9 user reviews,2,7,9
317730,True,4,Mostly Negative,4,14,18
317740,True,7,Positive,11,1,12
317750,True,0,No user reviews,0,0,0
317770,True,0,8 user reviews,7,1,8
317780,True,0,No user reviews,0,0,0
317790,True,0,1 user reviews,1,0,1
317820,True,6,Mostly Positive,764,269,1033
317830,True,0,No user reviews,0,0,0
317831,True,0,No user reviews,0,0,0
317832,True,0,No user reviews,0,0,0
317833,True,0,No user reviews,0,0,0
317840,True,6,Mostly Positive,8,3,11
317850,True,5,Mixed,30,42,72
317880,True,0,3 user reviews,2,1,3
317890,True,0,7 user reviews,7,0,7
317910,True,0,No user reviews,0,0,0
317920,True,0,1 user reviews,0,1,1
317940,True,5,Mixed,46,20,66
317950,True,5,Mixed,11,10,21
317970,True,5,Mixed,25,31,56
318020,True,5,Mixed,697,462,1159
318050,True,0,1 user reviews,0,1,1
318060,True,0,No user reviews,0,0,0
318070,True,0,1 user reviews,1,0,1
318071,True,0,No user reviews,0,0,0
318072,True,0,2 user reviews,2,0,2
318073,True,0,No user reviews,0,0,0
318074,True,0,1 user reviews,1,0,1
318075,True,0,No user reviews,0,0,0
318077,True,0,No user reviews,0,0,0
318080,True,0,1 user reviews,0,1,1
318090,True,5,Mixed,76,44,120
318100,True,5,Mixed,235,213,448
318110,True,0,No user reviews,0,0,0
318111,True,0,2 user reviews,2,0,2
318130,True,9,Overwhelmingly Positive,897,27,924
318150,True,0,1 user reviews,1,0,1
318170,True,0,No user reviews,0,0,0
318220,True,5,Mixed,561,650,1211
318230,True,6,Mostly Positive,626,175,801
318240,True,0,No user reviews,0,0,0
318260,True,5,Mixed,35,28,63
318271,True,0,1 user reviews,1,0,1
318290,True,7,Positive,15,3,18
318300,True,0,2 user reviews,0,2,2
318310,True,8,Very Positive,254,22,276
318320,True,0,No user reviews,0,0,0
318330,True,8,Very Positive,97,13,110
318340,True,0,No user reviews,0,0,0
318350,True,4,Mostly Negative,8,13,21
318390,True,5,Mixed,45,39,84
318412,True,4,Mostly Negative,10,16,26
318420,True,5,Mixed,71,77,148
318430,True,8,Very Positive,1223,267,1490
318440,True,5,Mixed,14,9,23
318450,True,0,No user reviews,0,0,0
318480,True,7,Positive,15,0,15
318490,True,0,No user reviews,0,0,0
318500,True,7,Positive,23,2,25
318510,True,6,Mostly Positive,13,5,18
318511,True,6,Mostly Positive,11,4,15
318520,True,7,Positive,19,2,21
318521,True,7,Positive,33,1,34
318530,True,8,Very Positive,534,102,636
318560,True,0,3 user reviews,0,3,3
318570,True,5,Mixed,42,24,66
318590,True,0,No user reviews,0,0,0
318591,True,0,1 user reviews,1,0,1
318600,True,6,Mostly Positive,748,212,960
318620,True,0,No user reviews,0,0,0
318640,True,0,No user reviews,0,0,0
318650,True,5,Mixed,46,25,71
318660,True,0,4 user reviews,1,3,4
318680,True,0,2 user reviews,0,2,2
318690,True,2,Very Negative,10,48,58
318710,True,6,Mostly Positive,10,3,13
318720,True,0,No user reviews,0,0,0
318740,True,0,5 user reviews,4,1,5
318770,True,0,No user reviews,0,0,0
318780,True,0,No user reviews,0,0,0
318790,True,0,5 user reviews,1,4,5
318791,True,5,Mixed,54,65,119
318792,True,4,Mostly Negative,12,23,35
318793,True,5,Mixed,16,22,38
318794,True,4,Mostly Negative,4,11,15
318795,True,0,No user reviews,0,0,0
318796,True,0,No user reviews,0,0,0
318797,True,0,No user reviews,0,0,0
318798,True,0,No user reviews,0,0,0
318799,True,0,No user reviews,0,0,0
318800,True,0,No user reviews,0,0,0
318801,True,0,No user reviews,0,0,0
318802,True,0,No user reviews,0,0,0
318803,True,0,No user reviews,0,0,0
318804,True,0,No user reviews,0,0,0
318805,True,0,No user reviews,0,0,0
318810,True,0,No user reviews,0,0,0
318820,True,0,No user reviews,0,0,0
318830,True,0,No user reviews,0,0,0
318850,True,6,Mostly Positive,34,13,47
318860,True,5,Mixed,35,19,54
318870,True,0,3 user reviews,3,0,3
318872,True,0,2 user reviews,2,0,2
318873,True,0,No user reviews,0,0,0
318874,True,0,2 user reviews,2,0,2
318875,True,0,3 user reviews,2,1,3
318940,True,0,No user reviews,0,0,0
318950,True,5,Mixed,11,9,20
318960,True,0,No user reviews,0,0,0
318970,True,8,Very Positive,430,82,512
318980,True,5,Mixed,5,5,10
318990,True,0,5 user reviews,2,3,5
319000,True,0,1 user reviews,1,0,1
319010,True,0,1 user reviews,1,0,1
319011,True,0,9 user reviews,9,0,9
319012,True,0,5 user reviews,2,3,5
319013,True,0,No user reviews,0,0,0
319014,True,8,Very Positive,83,1,84
319015,True,7,Positive,45,1,46
319016,True,7,Positive,21,0,21
319017,True,7,Positive,13,0,13
319018,True,7,Positive,14,3,17
319020,True,0,No user reviews,0,0,0
319030,True,0,No user reviews,0,0,0
319050,True,6,Mostly Positive,424,144,568
319060,True,0,No user reviews,0,0,0
319070,True,0,No user reviews,0,0,0
319080,True,8,Very Positive,53,9,62
319090,True,5,Mixed,146,92,238
319120,True,0,No user reviews,0,0,0
319130,True,0,No user reviews,0,0,0
319140,True,6,Mostly Positive,266,99,365
319150,True,0,7 user reviews,4,3,7
319170,True,8,Very Positive,65,3,68
319180,True,5,Mixed,34,28,62
319210,True,0,7 user reviews,2,5,7
319230,True,5,Mixed,30,15,45
319240,True,0,1 user reviews,1,0,1
319250,True,8,Very Positive,323,35,358
319260,True,0,3 user reviews,2,1,3
319270,True,7,Positive,29,5,34
319280,True,5,Mixed,89,39,128
319290,True,0,2 user reviews,1,1,2
319300,True,6,Mostly Positive,12,4,16
319320,True,8,Very Positive,68,14,82
319340,True,0,No user reviews,0,0,0
319390,True,0,No user reviews,0,0,0
319400,True,8,Very Positive,73,9,82
319410,True,6,Mostly Positive,22,8,30
319430,True,4,Mostly Negative,5,12,17
319450,True,8,Very Positive,77,16,93
319470,True,8,Very Positive,62,9,71
319480,True,8,Very Positive,310,23,333
319510,True,8,Very Positive,11942,1448,13390
319540,True,5,Mixed,58,71,129
319560,True,6,Mostly Positive,153,47,200
319570,True,0,2 user reviews,1,1,2
319580,True,0,No user reviews,0,0,0
319620,True,0,No user reviews,0,0,0
319630,True,9,Overwhelmingly Positive,44230,1651,45881
319730,True,0,1 user reviews,0,1,1
319740,True,6,Mostly Positive,121,44,165
319750,True,6,Mostly Positive,36,11,47
319760,True,8,Very Positive,85,19,104
319780,True,4,Mostly Negative,17,28,45
319790,True,0,No user reviews,0,0,0
319800,True,0,No user reviews,0,0,0
319810,True,7,Positive,28,5,33
319820,True,0,6 user reviews,6,0,6
319821,True,0,1 user reviews,1,0,1
319830,True,5,Mixed,12,9,21
319840,True,0,No user reviews,0,0,0
319850,True,6,Mostly Positive,55,17,72
319870,True,8,Very Positive,124,12,136
319880,True,0,No user reviews,0,0,0
319910,True,5,Mixed,1091,672,1763
319920,True,0,No user reviews,0,0,0
319930,True,7,Positive,14,0,14
319970,True,6,Mostly Positive,214,88,302
319980,True,5,Mixed,5,6,11
319990,True,5,Mixed,10,10,20
320000,True,6,Mostly Positive,14,6,20
320020,True,0,3 user reviews,1,2,3
320030,True,5,Mixed,176,99,275
320040,True,6,Mostly Positive,856,227,1083
320050,True,0,No user reviews,0,0,0
320051,True,0,No user reviews,0,0,0
320052,True,0,1 user reviews,0,1,1
320090,True,7,Positive,25,5,30
320110,True,6,Mostly Positive,24,10,34
320120,True,5,Mixed,13,10,23
320140,True,8,Very Positive,1085,111,1196
320150,True,6,Mostly Positive,14,6,20
320180,True,0,No user reviews,0,0,0
320190,True,0,2 user reviews,0,2,2
320210,True,0,No user reviews,0,0,0
320220,True,0,No user reviews,0,0,0
320240,True,6,Mostly Positive,2612,1047,3659
320290,True,0,No user reviews,0,0,0
320300,True,8,Very Positive,3095,356,3451
320310,True,4,Mostly Negative,8,19,27
320320,True,6,Mostly Positive,125,37,162
320330,True,6,Mostly Positive,35,11,46
320340,True,5,Mixed,255,300,555
320350,True,7,Positive,19,3,22
320351,True,7,Positive,16,1,17
320352,True,5,Mixed,12,13,25
320353,True,5,Mixed,10,10,20
320360,True,0,8 user reviews,7,1,8
320361,True,7,Positive,17,0,17
320362,True,0,8 user reviews,5,3,8
320363,True,0,8 user reviews,7,1,8
320364,True,0,1 user reviews,0,1,1
320370,True,7,Positive,12,1,13
320371,True,7,Positive,13,2,15
320372,True,4,Mostly Negative,6,12,18
320373,True,0,No user reviews,0,0,0
320374,True,0,No user reviews,0,0,0
320380,True,0,7 user reviews,3,4,7
320381,True,0,4 user reviews,3,1,4
320382,True,0,3 user reviews,2,1,3
320383,True,4,Mostly Negative,6,13,19
320384,True,0,4 user reviews,3,1,4
320385,True,0,4 user reviews,3,1,4
320386,True,0,6 user reviews,3,3,6
320387,True,0,4 user reviews,3,1,4
320388,True,0,5 user reviews,4,1,5
320390,True,0,No user reviews,0,0,0
320400,True,7,Positive,16,1,17
320410,True,0,4 user reviews,2,2,4
320420,True,0,No user reviews,0,0,0
320430,True,8,Very Positive,392,77,469
320440,True,0,2 user reviews,1,1,2
320520,True,5,Mixed,6,6,12
320540,True,6,Mostly Positive,81,30,111
320550,True,0,No user reviews,0,0,0
320551,True,0,1 user reviews,0,1,1
320552,True,0,3 user reviews,2,1,3
320553,True,0,2 user reviews,2,0,2
320554,True,0,1 user reviews,1,0,1
320555,True,0,No user reviews,0,0,0
320560,True,0,No user reviews,0,0,0
320570,True,0,No user reviews,0,0,0
320590,True,0,9 user reviews,7,2,9
320610,True,6,Mostly Positive,46,16,62
320630,True,6,Mostly Positive,44,18,62
320650,True,5,Mixed,14,14,28
320670,True,7,Positive,38,8,46
320690,True,5,Mixed,29,24,53
320710,True,0,No user reviews,0,0,0
320720,True,0,1 user reviews,0,1,1
320721,True,0,2 user reviews,1,1,2
320730,True,0,3 user reviews,1,2,3
320750,True,0,4 user reviews,3,1,4
320760,True,8,Very Positive,403,26,429
320790,True,4,Mostly Negative,4,10,14
320820,True,5,Mixed,244,140,384
320830,True,0,2 user reviews,1,1,2
320840,True,6,Mostly Positive,136,40,176
320850,True,0,No user reviews,0,0,0
320860,True,0,5 user reviews,2,3,5
320880,True,0,No user reviews,0,0,0
320890,True,0,1 user reviews,1,0,1
320900,True,0,5 user reviews,3,2,5
320970,True,6,Mostly Positive,15,6,21
320986,True,5,Mixed,6,9,15
320987,True,5,Mixed,5,7,12
320988,True,4,Mostly Negative,3,7,10
320989,True,5,Mixed,13,16,29
321010,True,0,No user reviews,0,0,0
321020,True,0,1 user reviews,1,0,1
321030,True,4,Mostly Negative,7,15,22
321040,True,8,Very Positive,1106,181,1287
321060,True,8,Very Positive,104,21,125
321070,True,0,1 user reviews,0,1,1
321080,True,0,9 user reviews,5,4,9
321100,True,7,Positive,9,1,10
321140,True,0,1 user reviews,1,0,1
321141,True,0,3 user reviews,3,0,3
321142,True,0,4 user reviews,3,1,4
321150,True,5,Mixed,45,36,81
321160,True,6,Mostly Positive,13,5,18
321170,True,0,2 user reviews,2,0,2
321180,True,0,3 user reviews,3,0,3
321181,True,0,2 user reviews,2,0,2
321182,True,0,2 user reviews,2,0,2
321190,True,8,Very Positive,48,4,52
321210,True,0,No user reviews,0,0,0
321230,True,0,No user reviews,0,0,0
321231,True,0,No user reviews,0,0,0
321232,True,0,No user reviews,0,0,0
321250,True,0,1 user reviews,1,0,1
321260,True,5,Mixed,84,98,182
321270,True,8,Very Positive,399,95,494
321280,True,0,No user reviews,0,0,0
321290,True,8,Very Positive,358,56,414
321300,True,5,Mixed,1862,844,2706
321310,True,0,3 user reviews,0,3,3
321330,True,5,Mixed,14,8,22
321350,True,6,Mostly Positive,8,3,11
321360,True,6,Mostly Positive,2108,609,2717
321370,True,5,Mixed,19,15,34
321380,True,0,No user reviews,0,0,0
321390,True,0,7 user reviews,0,7,7
321400,True,5,Mixed,130,65,195
321410,True,8,Very Positive,256,57,313
321420,True,0,1 user reviews,1,0,1
321421,True,0,4 user reviews,4,0,4
321430,True,6,Mostly Positive,83,25,108
321450,True,7,Positive,12,2,14
321460,True,0,3 user reviews,2,1,3
321470,True,0,2 user reviews,2,0,2
321471,True,0,1 user reviews,1,0,1
321472,True,0,1 user reviews,1,0,1
321473,True,0,1 user reviews,1,0,1
321474,True,0,1 user reviews,1,0,1
321475,True,0,No user reviews,0,0,0
321476,True,0,1 user reviews,1,0,1
321478,True,0,1 user reviews,0,1,1
321480,True,0,4 user reviews,4,0,4
321490,True,3,Negative,4,17,21
321510,True,0,5 user reviews,3,2,5
321540,True,7,Positive,20,5,25
321560,True,7,Positive,31,7,38
321580,True,5,Mixed,16,18,34
321600,True,3,Negative,1,24,25
321610,True,5,Mixed,5,5,10
321620,True,6,Mostly Positive,15,6,21
321630,True,0,No user reviews,0,0,0
321640,True,0,No user reviews,0,0,0
321641,True,0,No user reviews,0,0,0
321642,True,0,No user reviews,0,0,0
321643,True,0,No user reviews,0,0,0
321644,True,0,No user reviews,0,0,0
321645,True,0,No user reviews,0,0,0
321646,True,0,No user reviews,0,0,0
321647,True,0,No user reviews,0,0,0
321648,True,0,No user reviews,0,0,0
321649,True,0,No user reviews,0,0,0
321650,True,0,No user reviews,0,0,0
321690,True,0,No user reviews,0,0,0
321700,True,0,No user reviews,0,0,0
321710,True,7,Positive,9,2,11
321730,True,0,No user reviews,0,0,0
321770,True,0,No user reviews,0,0,0
321800,True,8,Very Positive,782,104,886
321830,True,5,Mixed,79,42,121
321840,True,0,4 user reviews,4,0,4
321870,True,6,Mostly Positive,140,49,189
321880,True,5,Mixed,9,4,13
321890,True,7,Positive,13,2,15
321900,True,0,No user reviews,0,0,0
321920,True,5,Mixed,27,13,40
321930,True,0,No user reviews,0,0,0
321940,True,0,9 user reviews,6,3,9
321950,True,5,Mixed,11,13,24
321960,True,5,Mixed,763,797,1560
321980,True,6,Mostly Positive,258,101,359
321990,True,7,Positive,10,0,10
322000,True,5,Mixed,23,18,41
322010,True,0,No user reviews,0,0,0
322020,True,8,Very Positive,55,4,59
322021,True,7,Positive,13,1,14
322022,True,5,Mixed,21,18,39
322030,True,0,3 user reviews,2,1,3
322050,True,0,No user reviews,0,0,0
322080,True,6,Mostly Positive,37,14,51
322090,True,0,No user reviews,0,0,0
322100,True,5,Mixed,8,9,17
322110,True,8,Very Positive,2089,138,2227
322130,True,7,Positive,19,2,21
322150,True,0,No user reviews,0,0,0
322151,True,0,No user reviews,0,0,0
322152,True,0,No user reviews,0,0,0
322153,True,0,No user reviews,0,0,0
322160,True,3,Negative,1,15,16
322170,True,8,Very Positive,41801,2506,44307
322190,True,9,Overwhelmingly Positive,1190,47,1237
322210,True,8,Very Positive,557,59,616
322250,True,0,No user reviews,0,0,0
322290,True,8,Very Positive,171,16,187
322300,True,5,Mixed,412,338,750
322330,True,9,Overwhelmingly Positive,35819,1313,37132
322360,True,0,3 user reviews,0,3,3
322361,True,5,Mixed,7,6,13
322410,True,0,No user reviews,0,0,0
322420,True,0,2 user reviews,2,0,2
322430,True,0,5 user reviews,1,4,5
322440,True,4,Mostly Negative,5,12,17
322450,True,8,Very Positive,111,9,120
322460,True,0,No user reviews,0,0,0
322480,True,0,No user reviews,0,0,0
322500,True,8,Very Positive,9423,1245,10668
322510,True,0,2 user reviews,1,1,2
322520,True,6,Mostly Positive,433,178,611
322540,True,4,Mostly Negative,12,22,34
322550,True,0,6 user reviews,4,2,6
322580,True,0,2 user reviews,1,1,2
322600,True,5,Mixed,13,18,31
322610,True,0,No user reviews,0,0,0
322630,True,5,Mixed,20,30,50
322660,True,8,Very Positive,110,7,117
322670,True,0,No user reviews,0,0,0
322680,True,6,Mostly Positive,123,40,163
322700,True,0,1 user reviews,1,0,1
322740,True,0,No user reviews,0,0,0
322750,True,6,Mostly Positive,64,27,91
322770,True,8,Very Positive,1816,174,1990
322780,True,5,Mixed,1958,1281,3239
322820,True,0,No user reviews,0,0,0
322830,True,0,No user reviews,0,0,0
322840,True,0,No user reviews,0,0,0
322850,True,5,Mixed,44,41,85
322900,True,5,Mixed,66,61,127
322910,True,6,Mostly Positive,647,268,915
322920,True,5,Mixed,982,778,1760
322930,True,6,Mostly Positive,58,17,75
322950,True,4,Mostly Negative,6,24,30
322960,True,7,Positive,28,1,29
322970,True,5,Mixed,20,25,45
322980,True,5,Mixed,13,19,32
322990,True,3,Negative,2,16,18
323000,True,5,Mixed,4,6,10
323010,True,0,No user reviews,0,0,0
323020,True,0,3 user reviews,3,0,3
323040,True,6,Mostly Positive,36,10,46
323060,True,6,Mostly Positive,766,295,1061
323110,True,0,No user reviews,0,0,0
323120,True,0,No user reviews,0,0,0
323130,True,0,2 user reviews,2,0,2
323140,True,0,2 user reviews,2,0,2
323150,True,0,No user reviews,0,0,0
323160,True,0,No user reviews,0,0,0
323170,True,0,4 user reviews,3,1,4
323180,True,0,5 user reviews,5,0,5
323190,True,8,Very Positive,15833,1557,17390
323210,True,0,No user reviews,0,0,0
323220,True,8,Very Positive,1499,169,1668
323230,True,5,Mixed,9,7,16
323240,True,5,Mixed,12,10,22
323250,True,5,Mixed,9,4,13
323260,True,0,8 user reviews,4,4,8
323270,True,5,Mixed,8,4,12
323280,True,6,Mostly Positive,22,9,31
323290,True,0,1 user reviews,1,0,1
323320,True,8,Very Positive,2217,159,2376
323340,True,7,Positive,10,2,12
323341,True,7,Positive,24,3,27
323360,True,0,No user reviews,0,0,0
323370,True,5,Mixed,94,43,137
323380,True,8,Very Positive,663,61,724
323390,True,0,1 user reviews,1,0,1
323410,True,5,Mixed,14,9,23
323420,True,0,7 user reviews,7,0,7
323450,True,8,Very Positive,47,6,53
323460,True,8,Very Positive,139,20,159
323470,True,8,Very Positive,5451,866,6317
323490,True,8,Very Positive,67,12,79
323500,True,6,Mostly Positive,540,163,703
323510,True,5,Mixed,6,4,10
323520,True,0,5 user reviews,5,0,5
323530,True,0,5 user reviews,4,1,5
323560,True,0,No user reviews,0,0,0
323570,True,0,No user reviews,0,0,0
323580,True,8,Very Positive,661,161,822
323620,True,0,5 user reviews,0,5,5
323630,True,0,4 user reviews,3,1,4
323650,True,0,No user reviews,0,0,0
323670,True,8,Very Positive,176,38,214
323680,True,0,2 user reviews,0,2,2
323700,True,5,Mixed,11,11,22
323720,True,6,Mostly Positive,214,90,304
323730,True,0,2 user reviews,2,0,2
323740,True,0,1 user reviews,1,0,1
323750,True,0,No user reviews,0,0,0
323760,True,0,No user reviews,0,0,0
323780,True,5,Mixed,37,31,68
323850,True,8,Very Positive,2167,360,2527
323870,True,0,1 user reviews,1,0,1
323871,True,0,3 user reviews,2,1,3
323872,True,0,No user reviews,0,0,0
323900,True,0,No user reviews,0,0,0
323910,True,8,Very Positive,42,9,51
323930,True,0,1 user reviews,0,1,1
323931,True,0,2 user reviews,2,0,2
323932,True,0,No user reviews,0,0,0
323933,True,0,No user reviews,0,0,0
323934,True,0,No user reviews,0,0,0
323935,True,0,6 user reviews,4,2,6
323936,True,0,1 user reviews,1,0,1
323940,True,0,3 user reviews,2,1,3
323950,True,0,No user reviews,0,0,0
324020,True,5,Mixed,13,12,25
324030,True,0,6 user reviews,6,0,6
324060,True,4,Mostly Negative,8,16,24
324070,True,8,Very Positive,45,9,54
324080,True,8,Very Positive,1684,327,2011
324090,True,4,Mostly Negative,4,9,13
324110,True,5,Mixed,16,19,35
324120,True,6,Mostly Positive,119,45,164
324140,True,8,Very Positive,62,13,75
324160,True,9,Overwhelmingly Positive,1038,23,1061
324170,True,5,Mixed,120,59,179
324180,True,0,No user reviews,0,0,0
324190,True,5,Mixed,67,97,164
324200,True,0,No user reviews,0,0,0
324230,True,0,No user reviews,0,0,0
324240,True,5,Mixed,6,8,14
324250,True,5,Mixed,8,4,12
324260,True,6,Mostly Positive,260,86,346
324270,True,0,4 user reviews,1,3,4
324280,True,4,Mostly Negative,7,18,25
324290,True,0,6 user reviews,2,4,6
324300,True,0,5 user reviews,5,0,5
324310,True,5,Mixed,347,245,592
324330,True,0,6 user reviews,4,2,6
324341,True,0,No user reviews,0,0,0
324343,True,5,Mixed,7,7,14
324344,True,6,Mostly Positive,103,31,134
324350,True,0,No user reviews,0,0,0
324351,True,0,No user reviews,0,0,0
324352,True,0,2 user reviews,1,1,2
324360,True,0,2 user reviews,1,1,2
324390,True,0,2 user reviews,2,0,2
324400,True,0,8 user reviews,5,3,8
324420,True,5,Mixed,15,8,23
324460,True,0,No user reviews,0,0,0
324470,True,6,Mostly Positive,70,22,92
324490,True,0,No user reviews,0,0,0
324510,True,6,Mostly Positive,881,263,1144
324520,True,6,Mostly Positive,104,32,136
324570,True,6,Mostly Positive,349,92,441
324590,True,0,No user reviews,0,0,0
324600,True,0,6 user reviews,4,2,6
324601,True,0,4 user reviews,4,0,4
324602,True,0,3 user reviews,1,2,3
324610,True,3,Negative,3,13,16
324650,True,6,Mostly Positive,92,27,119
324680,True,9,Overwhelmingly Positive,671,21,692
324690,True,0,No user reviews,0,0,0
324710,True,8,Very Positive,126,8,134
324720,True,0,7 user reviews,5,2,7
324730,True,6,Mostly Positive,14,5,19
324740,True,6,Mostly Positive,165,44,209
324750,True,6,Mostly Positive,13,5,18
324760,True,5,Mixed,58,42,100
324770,True,5,Mixed,9,10,19
324790,True,5,Mixed,31,17,48
324800,True,8,Very Positive,5294,708,6002
324810,True,8,Very Positive,860,172,1032
324830,True,0,No user reviews,0,0,0
324850,True,0,No user reviews,0,0,0
324870,True,0,No user reviews,0,0,0
324890,True,0,No user reviews,0,0,0
324910,True,0,No user reviews,0,0,0
324912,True,0,3 user reviews,3,0,3
324913,True,0,1 user reviews,1,0,1
324920,True,0,No user reviews,0,0,0
325040,True,0,No user reviews,0,0,0
325041,True,0,No user reviews,0,0,0
325042,True,0,No user reviews,0,0,0
325043,True,0,No user reviews,0,0,0
325044,True,0,No user reviews,0,0,0
325060,True,8,Very Positive,77,9,86
325070,True,6,Mostly Positive,29,8,37
325080,True,6,Mostly Positive,38,10,48
325090,True,8,Very Positive,123,13,136
325100,True,5,Mixed,32,22,54
325110,True,0,7 user reviews,6,1,7
325120,True,5,Mixed,61,36,97
325130,True,0,No user reviews,0,0,0
325135,True,0,1 user reviews,1,0,1
325136,True,0,No user reviews,0,0,0
325137,True,0,No user reviews,0,0,0
325138,True,0,1 user reviews,1,0,1
325139,True,0,1 user reviews,1,0,1
325140,True,0,1 user reviews,1,0,1
325141,True,0,3 user reviews,3,0,3
325142,True,0,4 user reviews,4,0,4
325143,True,0,2 user reviews,1,1,2
325144,True,0,2 user reviews,2,0,2
325150,True,8,Very Positive,56,4,60
325160,True,7,Positive,30,1,31
325170,True,0,No user reviews,0,0,0
325180,True,8,Very Positive,85,14,99
325210,True,5,Mixed,214,94,308
325260,True,0,2 user reviews,1,1,2
325300,True,0,5 user reviews,5,0,5
325320,True,6,Mostly Positive,25,10,35
325340,True,0,1 user reviews,1,0,1
325350,True,0,No user reviews,0,0,0
325370,True,7,Positive,23,2,25
325420,True,6,Mostly Positive,468,142,610
325430,True,4,Mostly Negative,18,38,56
325470,True,5,Mixed,7,7,14
325490,True,0,No user reviews,0,0,0
325500,True,0,5 user reviews,3,2,5
325501,True,0,3 user reviews,3,0,3
325502,True,0,2 user reviews,2,0,2
325503,True,0,2 user reviews,2,0,2
325504,True,5,Mixed,18,9,27
325520,True,8,Very Positive,71,16,87
325570,True,0,1 user reviews,1,0,1
325580,True,5,Mixed,14,7,21
325590,True,0,2 user reviews,2,0,2
325600,True,5,Mixed,944,699,1643
325610,True,6,Mostly Positive,6079,2050,8129
325630,True,5,Mixed,63,72,135
325640,True,0,No user reviews,0,0,0
325660,True,0,No user reviews,0,0,0
325670,True,0,No user reviews,0,0,0
325680,True,0,No user reviews,0,0,0
325690,True,0,No user reviews,0,0,0
325691,True,0,No user reviews,0,0,0
325692,True,0,No user reviews,0,0,0
325693,True,0,No user reviews,0,0,0
325723,True,5,Mixed,140,197,337
325724,True,6,Mostly Positive,712,186,898
325730,True,5,Mixed,108,50,158
325760,True,0,No user reviews,0,0,0
325790,True,4,Mostly Negative,28,69,97
325860,True,0,8 user reviews,8,0,8
325870,True,0,9 user reviews,8,1,9
325880,True,5,Mixed,9,8,17
325910,True,7,Positive,27,4,31
325930,True,8,Very Positive,103,16,119
325940,True,0,No user reviews,0,0,0
325950,True,7,Positive,11,2,13
325951,True,0,7 user reviews,3,4,7
325952,True,5,Mixed,6,7,13
325953,True,0,5 user reviews,2,3,5
325954,True,7,Positive,40,9,49
325955,True,0,7 user reviews,3,4,7
325956,True,7,Positive,11,2,13
325957,True,0,No user reviews,0,0,0
325958,True,0,4 user reviews,0,4,4
325959,True,5,Mixed,5,7,12
325960,True,0,No user reviews,0,0,0
325961,True,0,9 user reviews,7,2,9
325962,True,6,Mostly Positive,16,5,21
325963,True,7,Positive,17,4,21
325964,True,7,Positive,12,2,14
325965,True,5,Mixed,8,4,12
325968,True,7,Positive,14,2,16
325969,True,7,Positive,23,0,23
325970,True,6,Mostly Positive,45,17,62
325971,True,0,9 user reviews,6,3,9
325972,True,0,5 user reviews,4,1,5
325973,True,5,Mixed,7,5,12
325974,True,5,Mixed,30,16,46
325975,True,0,No user reviews,0,0,0
325976,True,7,Positive,37,5,42
325977,True,6,Mostly Positive,12,5,17
325978,True,0,No user reviews,0,0,0
325979,True,0,5 user reviews,5,0,5
325981,True,5,Mixed,6,5,11
325982,True,0,No user reviews,0,0,0
325987,True,6,Mostly Positive,10,3,13
325988,True,5,Mixed,8,11,19
325989,True,5,Mixed,8,5,13
325990,True,7,Positive,27,2,29
325991,True,0,7 user reviews,6,1,7
325992,True,7,Positive,22,2,24
325993,True,7,Positive,22,3,25
325994,True,0,2 user reviews,1,1,2
325996,True,0,No user reviews,0,0,0
326001,True,0,No user reviews,0,0,0
326002,True,0,No user reviews,0,0,0
326003,True,0,No user reviews,0,0,0
326004,True,0,No user reviews,0,0,0
326005,True,0,3 user reviews,1,2,3
326006,True,0,No user reviews,0,0,0
326007,True,0,No user reviews,0,0,0
326008,True,0,No user reviews,0,0,0
326009,True,0,No user reviews,0,0,0
326010,True,0,2 user reviews,2,0,2
326011,True,0,3 user reviews,3,0,3
326012,True,0,No user reviews,0,0,0
326013,True,0,No user reviews,0,0,0
326014,True,0,No user reviews,0,0,0
326015,True,0,2 user reviews,2,0,2
326016,True,0,1 user reviews,0,1,1
326017,True,0,3 user reviews,3,0,3
326018,True,0,1 user reviews,1,0,1
326019,True,0,No user reviews,0,0,0
326020,True,0,No user reviews,0,0,0
326021,True,0,No user reviews,0,0,0
326022,True,0,No user reviews,0,0,0
326023,True,0,2 user reviews,2,0,2
326024,True,0,5 user reviews,3,2,5
326025,True,0,No user reviews,0,0,0
326026,True,0,1 user reviews,1,0,1
326027,True,0,No user reviews,0,0,0
326028,True,0,No user reviews,0,0,0
326029,True,0,No user reviews,0,0,0
326030,True,0,No user reviews,0,0,0
326031,True,0,1 user reviews,1,0,1
326033,True,0,2 user reviews,2,0,2
326034,True,0,1 user reviews,1,0,1
326035,True,0,No user reviews,0,0,0
326036,True,0,3 user reviews,3,0,3
326037,True,0,3 user reviews,3,0,3
326038,True,0,No user reviews,0,0,0
326039,True,0,No user reviews,0,0,0
326040,True,0,1 user reviews,0,1,1
326041,True,0,No user reviews,0,0,0
326042,True,0,No user reviews,0,0,0
326043,True,0,2 user reviews,2,0,2
326044,True,0,No user reviews,0,0,0
326045,True,0,No user reviews,0,0,0
326046,True,0,No user reviews,0,0,0
326047,True,0,3 user reviews,3,0,3
326049,True,0,No user reviews,0,0,0
326050,True,0,2 user reviews,1,1,2
326060,True,6,Mostly Positive,22,8,30
326070,True,0,No user reviews,0,0,0
326110,True,4,Mostly Negative,3,7,10
326120,True,7,Positive,9,1,10
326130,True,0,3 user reviews,1,2,3
326150,True,8,Very Positive,301,27,328
326160,True,5,Mixed,327,336,663
326170,True,0,No user reviews,0,0,0
326180,True,5,Mixed,290,156,446
326190,True,6,Mostly Positive,212,80,292
326210,True,0,3 user reviews,2,1,3
326220,True,0,2 user reviews,1,1,2
326230,True,4,Mostly Negative,4,7,11
326240,True,0,No user reviews,0,0,0
326250,True,0,No user reviews,0,0,0
326260,True,0,No user reviews,0,0,0
326270,True,0,1 user reviews,1,0,1
326290,True,0,1 user reviews,1,0,1
326300,True,0,2 user reviews,2,0,2
326310,True,0,2 user reviews,1,1,2
326340,True,6,Mostly Positive,63,27,90
326350,True,0,No user reviews,0,0,0
326360,True,0,No user reviews,0,0,0
326370,True,0,4 user reviews,4,0,4
326380,True,5,Mixed,16,7,23
326390,True,0,4 user reviews,4,0,4
326391,True,0,7 user reviews,6,1,7
326410,True,8,Very Positive,1343,324,1667
326420,True,4,Mostly Negative,5,13,18
326430,True,7,Positive,11,1,12
326431,True,7,Positive,13,3,16
326440,True,0,No user reviews,0,0,0
326451,True,0,No user reviews,0,0,0
326452,True,0,No user reviews,0,0,0
326460,True,8,Very Positive,10477,825,11302
326470,True,0,7 user reviews,3,4,7
326480,True,8,Very Positive,1664,153,1817
326500,True,0,No user reviews,0,0,0
326520,True,6,Mostly Positive,21,9,30
326530,True,0,7 user reviews,5,2,7
326590,True,6,Mostly Positive,38,11,49
326600,True,0,6 user reviews,6,0,6
326610,True,0,5 user reviews,5,0,5
326620,True,7,Positive,21,0,21
326621,True,5,Mixed,21,10,31
326630,True,4,Mostly Negative,6,12,18
326650,True,3,Negative,0,20,20
326670,True,6,Mostly Positive,318,131,449
326690,True,0,No user reviews,0,0,0
326691,True,0,No user reviews,0,0,0
326720,True,8,Very Positive,93,13,106
326730,True,5,Mixed,16,14,30
326740,True,0,No user reviews,0,0,0
326760,True,7,Positive,13,0,13
326770,True,0,1 user reviews,0,1,1
326771,True,0,No user reviews,0,0,0
326772,True,0,No user reviews,0,0,0
326790,True,0,No user reviews,0,0,0
326800,True,0,No user reviews,0,0,0
326810,True,0,3 user reviews,3,0,3
326840,True,8,Very Positive,198,43,241
326880,True,0,No user reviews,0,0,0
326950,True,6,Mostly Positive,70,22,92
326960,True,0,No user reviews,0,0,0
326990,True,0,2 user reviews,1,1,2
327000,True,0,5 user reviews,1,4,5
327010,True,5,Mixed,18,21,39
327030,True,6,Mostly Positive,1170,324,1494
327040,True,0,2 user reviews,1,1,2
327060,True,6,Mostly Positive,146,56,202
327070,True,6,Mostly Positive,1375,580,1955
327090,True,5,Mixed,548,443,991
327100,True,0,1 user reviews,0,1,1
327130,True,5,Mixed,43,41,84
327140,True,8,Very Positive,317,19,336
327150,True,6,Mostly Positive,21,9,30
327170,True,0,7 user reviews,6,1,7
327171,True,0,5 user reviews,5,0,5
327172,True,0,7 user reviews,4,3,7
327173,True,6,Mostly Positive,12,4,16
327175,True,7,Positive,25,6,31
327210,True,7,Positive,14,1,15
327220,True,8,Very Positive,337,49,386
327230,True,0,No user reviews,0,0,0
327231,True,5,Mixed,5,5,10
327232,True,0,3 user reviews,2,1,3
327240,True,0,No user reviews,0,0,0
327260,True,6,Mostly Positive,93,34,127
327270,True,0,1 user reviews,1,0,1
327280,True,5,Mixed,169,146,315
327310,True,8,Very Positive,79,16,95
327320,True,0,No user reviews,0,0,0
327340,True,8,Very Positive,57,1,58
327360,True,0,No user reviews,0,0,0
327370,True,6,Mostly Positive,21,7,28
327380,True,5,Mixed,17,17,34
327390,True,8,Very Positive,62,6,68
327400,True,8,Very Positive,268,17,285
327410,True,8,Very Positive,1811,334,2145
327440,True,6,Mostly Positive,97,26,123
327450,True,7,Positive,25,1,26
327470,True,0,No user reviews,0,0,0
327480,True,0,No user reviews,0,0,0
327490,True,4,Mostly Negative,8,22,30
327500,True,7,Positive,38,6,44
327510,True,6,Mostly Positive,389,104,493
327520,True,5,Mixed,31,17,48
327530,True,0,8 user reviews,8,0,8
327560,True,8,Very Positive,455,41,496
327610,True,0,3 user reviews,3,0,3
327640,True,0,5 user reviews,2,3,5
327650,True,0,6 user reviews,3,3,6
327670,True,6,Mostly Positive,402,120,522
327690,True,7,Positive,10,0,10
327740,True,8,Very Positive,265,32,297
327760,True,6,Mostly Positive,11,3,14
327770,True,0,No user reviews,0,0,0
327810,True,0,No user reviews,0,0,0
327830,True,6,Mostly Positive,74,27,101
327831,True,5,Mixed,6,4,10
327840,True,0,2 user reviews,2,0,2
327850,True,0,No user reviews,0,0,0
327860,True,6,Mostly Positive,1027,293,1320
327870,True,0,2 user reviews,2,0,2
327880,True,8,Very Positive,308,48,356
327890,True,6,Mostly Positive,2262,685,2947
327900,True,0,No user reviews,0,0,0
327910,True,5,Mixed,17,9,26
327920,True,5,Mixed,7,9,16
327930,True,8,Very Positive,108,11,119
327940,True,6,Mostly Positive,10,3,13
327950,True,8,Very Positive,93,5,98
327960,True,0,9 user reviews,1,8,9
327970,True,0,No user reviews,0,0,0
327971,True,0,No user reviews,0,0,0
327972,True,0,No user reviews,0,0,0
327973,True,0,No user reviews,0,0,0
327980,True,7,Positive,20,2,22
328000,True,5,Mixed,8,8,16
328020,True,0,2 user reviews,0,2,2
328021,True,0,No user reviews,0,0,0
328022,True,0,No user reviews,0,0,0
328060,True,0,7 user reviews,4,3,7
328070,True,8,Very Positive,943,150,1093
328080,True,8,Very Positive,3336,358,3694
328100,True,5,Mixed,9,13,22
328110,True,0,3 user reviews,3,0,3
328120,True,0,No user reviews,0,0,0
328130,True,0,1 user reviews,0,1,1
328140,True,5,Mixed,62,70,132
328160,True,0,No user reviews,0,0,0
328170,True,0,No user reviews,0,0,0
328171,True,0,No user reviews,0,0,0
328200,True,0,1 user reviews,1,0,1
328210,True,7,Positive,11,0,11
328220,True,4,Mostly Negative,43,112,155
328230,True,7,Positive,18,0,18
328240,True,0,No user reviews,0,0,0
328260,True,0,1 user reviews,0,1,1
328270,True,5,Mixed,72,39,111
328280,True,0,1 user reviews,1,0,1
328290,True,0,1 user reviews,1,0,1
328300,True,0,No user reviews,0,0,0
328310,True,4,Mostly Negative,6,13,19
328390,True,0,No user reviews,0,0,0
328400,True,0,No user reviews,0,0,0
328402,True,0,1 user reviews,1,0,1
328430,True,5,Mixed,7,5,12
328440,True,4,Mostly Negative,14,33,47
328450,True,6,Mostly Positive,20,8,28
328460,True,5,Mixed,22,16,38
328470,True,8,Very Positive,76,8,84
328480,True,0,No user reviews,0,0,0
328500,True,8,Very Positive,121,24,145
328510,True,5,Mixed,29,13,42
328530,True,0,No user reviews,0,0,0
328550,True,7,Positive,22,4,26
328560,True,0,No user reviews,0,0,0
328580,True,0,No user reviews,0,0,0
328590,True,6,Mostly Positive,99,36,135
328600,True,5,Mixed,36,26,62
328640,True,5,Mixed,5,6,11
328650,True,0,6 user reviews,4,2,6
328670,True,4,Mostly Negative,3,9,12
328680,True,0,8 user reviews,6,2,8
328690,True,0,No user reviews,0,0,0
328710,True,5,Mixed,23,20,43
328730,True,8,Very Positive,135,5,140
328740,True,4,Mostly Negative,5,10,15
328750,True,0,No user reviews,0,0,0
328760,True,8,Very Positive,699,51,750
328780,True,7,Positive,15,3,18
328790,True,0,No user reviews,0,0,0
328802,True,7,Positive,10,0,10
328803,True,0,1 user reviews,1,0,1
328804,True,0,2 user reviews,2,0,2
328810,True,0,2 user reviews,0,2,2
328811,True,0,No user reviews,0,0,0
328812,True,0,No user reviews,0,0,0
328813,True,0,No user reviews,0,0,0
328814,True,0,3 user reviews,3,0,3
328815,True,0,No user reviews,0,0,0
328816,True,0,No user reviews,0,0,0
328817,True,0,No user reviews,0,0,0
328818,True,0,1 user reviews,0,1,1
328820,True,0,1 user reviews,1,0,1
328821,True,0,2 user reviews,1,1,2
328830,True,5,Mixed,26,30,56
328850,True,0,6 user reviews,6,0,6
328860,True,0,No user reviews,0,0,0
328861,True,0,No user reviews,0,0,0
328880,True,5,Mixed,5,5,10
328890,True,0,9 user reviews,4,5,9
328900,True,7,Positive,39,8,47
328920,True,8,Very Positive,46,9,55
328930,True,7,Positive,17,3,20
328940,True,5,Mixed,95,77,172
328950,True,0,No user reviews,0,0,0
328990,True,0,4 user reviews,0,4,4
329000,True,4,Mostly Negative,5,10,15
329010,True,6,Mostly Positive,109,37,146
329011,True,5,Mixed,6,4,10
329012,True,5,Mixed,15,7,22
329013,True,0,5 user reviews,1,4,5
329020,True,0,1 user reviews,1,0,1
329030,True,0,No user reviews,0,0,0
329040,True,6,Mostly Positive,36,13,49
329050,True,8,Very Positive,1744,211,1955
329070,True,6,Mostly Positive,311,79,390
329100,True,0,8 user reviews,7,1,8
329110,True,7,Positive,32,8,40
329130,True,8,Very Positive,1700,112,1812
329150,True,0,8 user reviews,7,1,8
329180,True,0,1 user reviews,1,0,1
329190,True,5,Mixed,64,39,103
329200,True,5,Mixed,71,40,111
329230,True,0,No user reviews,0,0,0
329240,True,5,Mixed,9,6,15
329260,True,0,No user reviews,0,0,0
329270,True,0,7 user reviews,5,2,7
329280,True,5,Mixed,6,9,15
329310,True,6,Mostly Positive,24,8,32
329320,True,7,Positive,18,3,21
329340,True,0,7 user reviews,7,0,7
329350,True,0,No user reviews,0,0,0
329360,True,0,No user reviews,0,0,0
329370,True,0,No user reviews,0,0,0
329380,True,5,Mixed,20,12,32
329430,True,6,Mostly Positive,2229,776,3005
329440,True,5,Mixed,529,341,870
329460,True,8,Very Positive,141,7,148
329480,True,0,2 user reviews,0,2,2
329490,True,8,Very Positive,713,155,868
329500,True,0,No user reviews,0,0,0
329510,True,0,1 user reviews,1,0,1
329530,True,8,Very Positive,82,4,86
329550,True,0,3 user reviews,3,0,3
329551,True,0,3 user reviews,3,0,3
329580,True,0,No user reviews,0,0,0
329590,True,0,No user reviews,0,0,0
329600,True,0,No user reviews,0,0,0
329610,True,5,Mixed,54,73,127
329620,True,5,Mixed,10,6,16
329630,True,7,Positive,30,1,31
329640,True,7,Positive,25,5,30
329650,True,6,Mostly Positive,90,26,116
329670,True,5,Mixed,14,8,22
329680,True,5,Mixed,9,6,15
329690,True,7,Positive,37,9,46
329710,True,0,No user reviews,0,0,0
329720,True,0,No user reviews,0,0,0
329760,True,0,No user reviews,0,0,0
329770,True,5,Mixed,34,24,58
329790,True,0,2 user reviews,2,0,2
329820,True,0,5 user reviews,4,1,5
329821,True,0,3 user reviews,2,1,3
329822,True,0,4 user reviews,4,0,4
329830,True,6,Mostly Positive,416,126,542
329840,True,0,No user reviews,0,0,0
329860,True,8,Very Positive,583,80,663
329880,True,0,4 user reviews,4,0,4
329910,True,0,4 user reviews,4,0,4
329920,True,8,Very Positive,64,4,68
329960,True,0,No user reviews,0,0,0
329970,True,8,Very Positive,420,58,478
329980,True,5,Mixed,13,9,22
329990,True,0,No user reviews,0,0,0
329991,True,0,1 user reviews,1,0,1
330000,True,0,3 user reviews,0,3,3
330020,True,8,Very Positive,2646,201,2847
330030,True,0,No user reviews,0,0,0
330040,True,0,No user reviews,0,0,0
330070,True,6,Mostly Positive,509,197,706
330100,True,6,Mostly Positive,101,31,132
330130,True,0,7 user reviews,3,4,7
330140,True,0,No user reviews,0,0,0
330160,True,7,Positive,10,0,10
330180,True,8,Very Positive,67,11,78
330210,True,2,Very Negative,10,47,57
330230,True,0,2 user reviews,1,1,2
330240,True,0,3 user reviews,0,3,3
330260,True,7,Positive,19,2,21
330270,True,5,Mixed,61,57,118
330280,True,0,No user reviews,0,0,0
330340,True,0,No user reviews,0,0,0
330350,True,4,Mostly Negative,64,224,288
330360,True,0,No user reviews,0,0,0
330361,True,0,No user reviews,0,0,0
330362,True,0,No user reviews,0,0,0
330363,True,0,No user reviews,0,0,0
330370,True,7,Positive,24,3,27
330380,True,0,No user reviews,0,0,0
330390,True,8,Very Positive,822,108,930
330420,True,7,Positive,31,5,36
330450,True,0,2 user reviews,2,0,2
330460,True,6,Mostly Positive,196,62,258
330470,True,5,Mixed,48,28,76
330480,True,0,No user reviews,0,0,0
330500,True,0,8 user reviews,6,2,8
330510,True,0,1 user reviews,0,1,1
330511,True,0,No user reviews,0,0,0
330520,True,0,1 user reviews,0,1,1
330570,True,5,Mixed,120,106,226
330580,True,8,Very Positive,497,116,613
330590,True,0,7 user reviews,4,3,7
330610,True,0,No user reviews,0,0,0
330620,True,6,Mostly Positive,73,24,97
330630,True,0,No user reviews,0,0,0
330631,True,0,4 user reviews,2,2,4
330650,True,7,Positive,9,1,10
330660,True,7,Positive,8,2,10
330670,True,0,7 user reviews,6,1,7
330680,True,0,5 user reviews,0,5,5
330690,True,0,No user reviews,0,0,0
330700,True,0,No user reviews,0,0,0
330710,True,0,No user reviews,0,0,0
330720,True,8,Very Positive,88,12,100
330730,True,7,Positive,19,0,19
330750,True,5,Mixed,5,5,10
330760,True,0,2 user reviews,1,1,2
330770,True,6,Mostly Positive,72,22,94
330800,True,0,No user reviews,0,0,0
330810,True,0,1 user reviews,1,0,1
330820,True,8,Very Positive,359,61,420
330830,True,8,Very Positive,7735,430,8165
330840,True,6,Mostly Positive,3829,1489,5318
330880,True,0,8 user reviews,3,5,8
330950,True,0,No user reviews,0,0,0
330960,True,0,No user reviews,0,0,0
330961,True,0,No user reviews,0,0,0
330970,True,0,No user reviews,0,0,0
330980,True,0,No user reviews,0,0,0
330981,True,0,No user reviews,0,0,0
330982,True,0,No user reviews,0,0,0
330983,True,0,No user reviews,0,0,0
330984,True,0,No user reviews,0,0,0
330985,True,0,No user reviews,0,0,0
330986,True,0,No user reviews,0,0,0
330987,True,0,No user reviews,0,0,0
330988,True,0,No user reviews,0,0,0
330990,True,5,Mixed,43,26,69
331000,True,0,1 user reviews,0,1,1
331050,True,4,Mostly Negative,3,8,11
331060,True,5,Mixed,5,5,10
331061,True,5,Mixed,9,4,13
331062,True,0,2 user reviews,2,0,2
331063,True,0,2 user reviews,1,1,2
331064,True,0,5 user reviews,2,3,5
331065,True,5,Mixed,10,5,15
331066,True,0,2 user reviews,0,2,2
331067,True,0,3 user reviews,1,2,3
331068,True,0,5 user reviews,4,1,5
331069,True,7,Positive,8,2,10
331070,True,0,6 user reviews,1,5,6
331071,True,0,5 user reviews,1,4,5
331072,True,4,Mostly Negative,4,9,13
331103,True,0,No user reviews,0,0,0
331104,True,0,No user reviews,0,0,0
331105,True,0,No user reviews,0,0,0
331106,True,0,No user reviews,0,0,0
331107,True,0,No user reviews,0,0,0
331108,True,0,No user reviews,0,0,0
331113,True,0,No user reviews,0,0,0
331114,True,0,No user reviews,0,0,0
331115,True,0,No user reviews,0,0,0
331116,True,0,No user reviews,0,0,0
331117,True,0,No user reviews,0,0,0
331118,True,0,No user reviews,0,0,0
331120,True,0,6 user reviews,3,3,6
331130,True,0,5 user reviews,5,0,5
331160,True,6,Mostly Positive,162,54,216
331180,True,5,Mixed,18,8,26
331181,True,7,Positive,24,3,27
331190,True,8,Very Positive,118,28,146
331200,True,5,Mixed,231,118,349
331210,True,5,Mixed,5,7,12
331220,True,6,Mostly Positive,56,23,79
331230,True,0,No user reviews,0,0,0
331240,True,0,No user reviews,0,0,0
331250,True,0,No user reviews,0,0,0
331260,True,0,No user reviews,0,0,0
331270,True,0,No user reviews,0,0,0
331290,True,0,7 user reviews,5,2,7
331300,True,0,3 user reviews,1,2,3
331310,True,0,2 user reviews,2,0,2
331330,True,5,Mixed,14,9,23
331340,True,5,Mixed,23,10,33
331350,True,0,No user reviews,0,0,0
331351,True,0,No user reviews,0,0,0
331352,True,0,2 user reviews,2,0,2
331353,True,0,1 user reviews,1,0,1
331354,True,0,3 user reviews,3,0,3
331355,True,0,2 user reviews,2,0,2
331356,True,0,No user reviews,0,0,0
331357,True,0,No user reviews,0,0,0
331358,True,0,1 user reviews,1,0,1
331360,True,6,Mostly Positive,143,40,183
331380,True,0,No user reviews,0,0,0
331390,True,6,Mostly Positive,69,18,87
331400,True,0,4 user reviews,1,3,4
331420,True,0,No user reviews,0,0,0
331430,True,0,No user reviews,0,0,0
331440,True,6,Mostly Positive,544,152,696
331450,True,5,Mixed,19,10,29
331460,True,7,Positive,22,4,26
331470,True,8,Very Positive,47,6,53
331480,True,8,Very Positive,492,57,549
331490,True,0,3 user reviews,3,0,3
331491,True,0,5 user reviews,1,4,5
331492,True,0,9 user reviews,3,6,9
331500,True,8,Very Positive,903,149,1052
331510,True,6,Mostly Positive,46,18,64
331520,True,0,1 user reviews,1,0,1
331550,True,0,No user reviews,0,0,0
331560,True,0,No user reviews,0,0,0
331570,True,0,1 user reviews,1,0,1
331580,True,0,7 user reviews,4,3,7
331600,True,6,Mostly Positive,1464,388,1852
331610,True,4,Mostly Negative,8,25,33
331620,True,0,2 user reviews,2,0,2
331650,True,5,Mixed,50,22,72
331660,True,0,7 user reviews,3,4,7
331670,True,8,Very Positive,896,76,972
331690,True,6,Mostly Positive,248,91,339
331720,True,5,Mixed,24,14,38
331740,True,0,3 user reviews,2,1,3
331750,True,8,Very Positive,112,6,118
331760,True,6,Mostly Positive,11,4,15
331780,True,0,No user reviews,0,0,0
331790,True,5,Mixed,23,13,36
331800,True,0,4 user reviews,4,0,4
331810,True,4,Mostly Negative,12,37,49
331870,True,8,Very Positive,780,96,876
331880,True,5,Mixed,18,26,44
331890,True,0,1 user reviews,0,1,1
331891,True,0,No user reviews,0,0,0
331892,True,0,No user reviews,0,0,0
331900,True,6,Mostly Positive,296,100,396
331920,True,6,Mostly Positive,107,45,152
331930,True,8,Very Positive,74,15,89
331950,True,0,No user reviews,0,0,0
331960,True,0,No user reviews,0,0,0
331970,True,8,Very Positive,88,3,91
331980,True,5,Mixed,16,12,28
332000,True,0,No user reviews,0,0,0
332001,True,0,No user reviews,0,0,0
332010,True,0,No user reviews,0,0,0
332011,True,0,No user reviews,0,0,0
332020,True,0,No user reviews,0,0,0
332030,True,0,No user reviews,0,0,0
332070,True,5,Mixed,11,13,24
332120,True,0,1 user reviews,1,0,1
332130,True,0,1 user reviews,1,0,1
332150,True,0,2 user reviews,0,2,2
332190,True,0,No user reviews,0,0,0
332191,True,0,No user reviews,0,0,0
332200,True,8,Very Positive,2482,184,2666
332220,True,0,No user reviews,0,0,0
332221,True,0,No user reviews,0,0,0
332222,True,0,No user reviews,0,0,0
332223,True,0,No user reviews,0,0,0
332224,True,0,No user reviews,0,0,0
332225,True,0,No user reviews,0,0,0
332229,True,0,No user reviews,0,0,0
332230,True,0,No user reviews,0,0,0
332231,True,0,No user reviews,0,0,0
332232,True,0,No user reviews,0,0,0
332240,True,0,3 user reviews,3,0,3
332250,True,5,Mixed,50,24,74
332260,True,7,Positive,40,5,45
332270,True,6,Mostly Positive,21,7,28
332290,True,0,3 user reviews,3,0,3
332291,True,0,2 user reviews,2,0,2
332292,True,0,3 user reviews,2,1,3
332293,True,0,4 user reviews,3,1,4
332300,True,0,No user reviews,0,0,0
332310,True,6,Mostly Positive,5022,1669,6691
332330,True,8,Very Positive,57,10,67
332340,True,0,2 user reviews,1,1,2
332350,True,6,Mostly Positive,271,99,370
332360,True,6,Mostly Positive,65,22,87
332370,True,0,4 user reviews,3,1,4
332380,True,5,Mixed,17,9,26
332390,True,6,Mostly Positive,54,17,71
332400,True,5,Mixed,34,15,49
332410,True,5,Mixed,24,14,38
332420,True,0,No user reviews,0,0,0
332430,True,0,No user reviews,0,0,0
332460,True,0,2 user reviews,2,0,2
332470,True,0,No user reviews,0,0,0
332480,True,6,Mostly Positive,84,23,107
332490,True,6,Mostly Positive,150,47,197
332500,True,5,Mixed,1319,1293,2612
332530,True,7,Positive,25,3,28
332540,True,7,Positive,31,3,34
332570,True,8,Very Positive,2315,240,2555
332580,True,8,Very Positive,52,9,61
332610,True,8,Very Positive,84,13,97
332620,True,5,Mixed,40,19,59
332630,True,7,Positive,18,2,20
332650,True,5,Mixed,48,44,92
332670,True,0,No user reviews,0,0,0
332700,True,4,Mostly Negative,5,11,16
332710,True,5,Mixed,8,7,15
332730,True,0,4 user reviews,0,4,4
332740,True,0,3 user reviews,3,0,3
332750,True,0,No user reviews,0,0,0
332760,True,0,6 user reviews,5,1,6
332790,True,5,Mixed,53,79,132
332800,True,8,Very Positive,5893,574,6467
332810,True,0,5 user reviews,4,1,5
332830,True,7,Positive,44,4,48
332850,True,0,No user reviews,0,0,0
332880,True,7,Positive,16,4,20
332890,True,0,No user reviews,0,0,0
332950,True,8,Very Positive,63,3,66
332990,True,0,No user reviews,0,0,0
333000,True,0,No user reviews,0,0,0
333030,True,0,2 user reviews,1,1,2
333040,True,0,3 user reviews,2,1,3
333060,True,0,3 user reviews,3,0,3
333080,True,0,8 user reviews,2,6,8
333081,True,0,5 user reviews,2,3,5
333082,True,0,No user reviews,0,0,0
333083,True,0,No user reviews,0,0,0
333084,True,0,4 user reviews,2,2,4
333087,True,0,1 user reviews,0,1,1
333088,True,0,1 user reviews,0,1,1
333090,True,0,7 user reviews,5,2,7
333091,True,6,Mostly Positive,8,3,11
333100,True,4,Mostly Negative,6,10,16
333110,True,7,Positive,40,2,42
333120,True,5,Mixed,7,6,13
333130,True,0,4 user reviews,3,1,4
333140,True,0,No user reviews,0,0,0
333150,True,0,6 user reviews,5,1,6
333160,True,7,Positive,16,0,16
333170,True,0,6 user reviews,6,0,6
333200,True,0,No user reviews,0,0,0
333210,True,5,Mixed,83,54,137
333220,True,8,Very Positive,52,8,60
333230,True,0,1 user reviews,1,0,1
333250,True,6,Mostly Positive,359,112,471
333260,True,8,Very Positive,61,0,61
333270,True,0,No user reviews,0,0,0
333290,True,7,Positive,10,0,10
333300,True,8,Very Positive,574,76,650
333310,True,0,No user reviews,0,0,0
333320,True,0,2 user reviews,2,0,2
333330,True,7,Positive,38,7,45
333340,True,4,Mostly Negative,31,59,90
333350,True,5,Mixed,25,17,42
333380,True,0,8 user reviews,4,4,8
333390,True,6,Mostly Positive,31,10,41
333400,True,0,4 user reviews,4,0,4
333410,True,0,No user reviews,0,0,0
333420,True,6,Mostly Positive,1428,461,1889
333430,True,5,Mixed,43,21,64
333460,True,0,3 user reviews,3,0,3
333470,True,0,No user reviews,0,0,0
333480,True,0,No user reviews,0,0,0
333481,True,0,No user reviews,0,0,0
333490,True,0,4 user reviews,3,1,4
333500,True,0,No user reviews,0,0,0
333510,True,7,Positive,16,3,19
333520,True,0,No user reviews,0,0,0
333530,True,5,Mixed,19,11,30
333540,True,5,Mixed,8,6,14
333580,True,0,5 user reviews,5,0,5
333600,True,8,Very Positive,5567,296,5863
333630,True,0,No user reviews,0,0,0
333640,True,9,Overwhelmingly Positive,2362,106,2468
333650,True,7,Positive,10,1,11
333660,True,5,Mixed,27,17,44
333670,True,0,No user reviews,0,0,0
333680,True,0,No user reviews,0,0,0
333690,True,0,8 user reviews,4,4,8
333700,True,0,No user reviews,0,0,0
333710,True,0,1 user reviews,1,0,1
333720,True,0,No user reviews,0,0,0
333730,True,0,6 user reviews,3,3,6
333740,True,5,Mixed,36,50,86
333760,True,7,Positive,22,5,27
333770,True,0,4 user reviews,4,0,4
333771,True,0,1 user reviews,1,0,1
333772,True,0,2 user reviews,2,0,2
333773,True,0,3 user reviews,3,0,3
333780,True,0,No user reviews,0,0,0
333790,True,0,No user reviews,0,0,0
333800,True,4,Mostly Negative,10,38,48
333810,True,0,9 user reviews,5,4,9
333811,True,0,2 user reviews,2,0,2
333812,True,0,5 user reviews,4,1,5
333813,True,0,1 user reviews,1,0,1
333814,True,0,No user reviews,0,0,0
333815,True,0,No user reviews,0,0,0
333816,True,0,2 user reviews,2,0,2
333817,True,0,2 user reviews,2,0,2
333820,True,8,Very Positive,290,19,309
333850,True,0,2 user reviews,0,2,2
333860,True,4,Mostly Negative,4,8,12
333870,True,7,Positive,37,8,45
333880,True,8,Very Positive,84,21,105
333890,True,0,No user reviews,0,0,0
333891,True,0,2 user reviews,2,0,2
333892,True,0,No user reviews,0,0,0
333900,True,0,No user reviews,0,0,0
333910,True,0,1 user reviews,1,0,1
333920,True,0,No user reviews,0,0,0
333921,True,0,3 user reviews,2,1,3
333930,True,8,Very Positive,729,167,896
333950,True,5,Mixed,1883,1500,3383
333970,True,6,Mostly Positive,40,12,52
333980,True,8,Very Positive,1138,151,1289
333990,True,6,Mostly Positive,36,11,47
334030,True,0,1 user reviews,1,0,1
334040,True,4,Mostly Negative,312,535,847
334050,True,0,6 user reviews,4,2,6
334060,True,0,No user reviews,0,0,0
334070,True,5,Mixed,105,57,162
334080,True,7,Positive,47,0,47
334090,True,0,No user reviews,0,0,0
334100,True,7,Positive,14,2,16
334110,True,0,No user reviews,0,0,0
334111,True,0,No user reviews,0,0,0
334112,True,0,No user reviews,0,0,0
334113,True,0,No user reviews,0,0,0
334120,True,5,Mixed,257,182,439
334140,True,8,Very Positive,48,2,50
334150,True,0,No user reviews,0,0,0
334160,True,0,No user reviews,0,0,0
334161,True,0,1 user reviews,1,0,1
334180,True,0,2 user reviews,1,1,2
334190,True,6,Mostly Positive,97,27,124
334210,True,6,Mostly Positive,95,27,122
334220,True,0,1 user reviews,1,0,1
334221,True,0,No user reviews,0,0,0
334230,True,8,Very Positive,16407,2065,18472
334260,True,0,2 user reviews,2,0,2
334270,True,5,Mixed,19,15,34
334280,True,0,8 user reviews,3,5,8
334290,True,5,Mixed,30,29,59
334300,True,7,Positive,15,2,17
334310,True,8,Very Positive,191,33,224
334330,True,0,No user reviews,0,0,0
334340,True,5,Mixed,9,8,17
334350,True,0,No user reviews,0,0,0
334360,True,0,1 user reviews,0,1,1
334370,True,0,3 user reviews,1,2,3
334380,True,0,2 user reviews,2,0,2
334390,True,0,4 user reviews,4,0,4
334402,True,0,6 user reviews,5,1,6
334410,True,5,Mixed,21,10,31
334420,True,5,Mixed,303,160,463
334430,True,0,No user reviews,0,0,0
334440,True,0,3 user reviews,2,1,3
334441,True,0,4 user reviews,4,0,4
334442,True,0,1 user reviews,0,1,1
334450,True,0,8 user reviews,8,0,8
334470,True,0,3 user reviews,1,2,3
334480,True,0,1 user reviews,1,0,1
334490,True,0,2 user reviews,1,1,2
334510,True,0,1 user reviews,0,1,1
334520,True,0,1 user reviews,1,0,1
334530,True,0,3 user reviews,2,1,3
334540,True,8,Very Positive,522,42,564
334560,True,7,Positive,39,8,47
334590,True,0,No user reviews,0,0,0
334600,True,0,No user reviews,0,0,0
334610,True,0,No user reviews,0,0,0
334611,True,0,No user reviews,0,0,0
334620,True,0,7 user reviews,3,4,7
334660,True,0,3 user reviews,3,0,3
334690,True,6,Mostly Positive,49,18,67
334710,True,6,Mostly Positive,37,13,50
334740,True,0,5 user reviews,5,0,5
334770,True,7,Positive,24,2,26
334771,True,7,Positive,10,1,11
334772,True,7,Positive,44,5,49
334773,True,7,Positive,27,0,27
334774,True,7,Positive,32,0,32
334780,True,7,Positive,31,0,31
334781,True,7,Positive,24,3,27
334782,True,7,Positive,19,1,20
334790,True,7,Positive,31,3,34
334791,True,7,Positive,16,2,18
334792,True,5,Mixed,4,6,10
334793,True,7,Positive,26,4,30
334810,True,7,Positive,10,2,12
334830,True,5,Mixed,12,10,22
334840,True,0,6 user reviews,6,0,6
334850,True,5,Mixed,65,30,95
334860,True,0,No user reviews,0,0,0
334880,True,0,No user reviews,0,0,0
334890,True,0,No user reviews,0,0,0
334900,True,0,No user reviews,0,0,0
334920,True,0,1 user reviews,1,0,1
334930,True,0,5 user reviews,0,5,5
334940,True,9,Overwhelmingly Positive,635,17,652
334960,True,0,8 user reviews,5,3,8
334970,True,0,4 user reviews,3,1,4
334980,True,5,Mixed,16,21,37
334990,True,0,No user reviews,0,0,0
335000,True,8,Very Positive,1019,80,1099
335010,True,6,Mostly Positive,17,6,23
335020,True,5,Mixed,72,53,125
335030,True,4,Mostly Negative,132,289,421
335050,True,2,Very Negative,11,68,79
335060,True,0,6 user reviews,4,2,6
335070,True,6,Mostly Positive,191,51,242
335090,True,7,Positive,13,0,13
335100,True,6,Mostly Positive,77,27,104
335110,True,0,1 user reviews,1,0,1
335120,True,5,Mixed,67,39,106
335170,True,0,2 user reviews,2,0,2
335180,True,6,Mostly Positive,10,4,14
335190,True,8,Very Positive,153,24,177
335200,True,5,Mixed,19,13,32
335210,True,3,Negative,1,10,11
335220,True,0,4 user reviews,2,2,4
335240,True,8,Very Positive,80,13,93
335260,True,0,8 user reviews,8,0,8
335290,True,6,Mostly Positive,14,6,20
335300,True,8,Very Positive,11999,2246,14245
335310,True,0,3 user reviews,1,2,3
335320,True,5,Mixed,29,16,45
335330,True,4,Mostly Negative,5,15,20
335350,True,7,Positive,32,5,37
335370,True,5,Mixed,9,5,14
335410,True,0,No user reviews,0,0,0
335420,True,0,2 user reviews,2,0,2
335430,True,8,Very Positive,48,9,57
335440,True,0,1 user reviews,0,1,1
335450,True,0,6 user reviews,5,1,6
335460,True,7,Positive,13,0,13
335473,True,0,No user reviews,0,0,0
335474,True,0,No user reviews,0,0,0
335475,True,0,1 user reviews,1,0,1
335476,True,0,1 user reviews,1,0,1
335477,True,0,1 user reviews,1,0,1
335478,True,0,1 user reviews,1,0,1
335483,True,0,No user reviews,0,0,0
335484,True,0,No user reviews,0,0,0
335485,True,0,No user reviews,0,0,0
335486,True,0,No user reviews,0,0,0
335487,True,0,No user reviews,0,0,0
335488,True,0,No user reviews,0,0,0
335490,True,0,No user reviews,0,0,0
335491,True,0,No user reviews,0,0,0
335492,True,0,No user reviews,0,0,0
335510,True,7,Positive,33,4,37
335520,True,0,No user reviews,0,0,0
335550,True,0,6 user reviews,6,0,6
335560,True,0,1 user reviews,1,0,1
335570,True,0,4 user reviews,2,2,4
335580,True,0,1 user reviews,1,0,1
335590,True,0,No user reviews,0,0,0
335620,True,8,Very Positive,1778,239,2017
335640,True,0,2 user reviews,2,0,2
335650,True,0,No user reviews,0,0,0
335660,True,5,Mixed,26,13,39
335670,True,9,Overwhelmingly Positive,6688,271,6959
335680,True,0,No user reviews,0,0,0
335690,True,5,Mixed,7,6,13
335700,True,5,Mixed,26,20,46
335770,True,5,Mixed,9,4,13
335790,True,6,Mostly Positive,223,56,279
335800,True,0,1 user reviews,1,0,1
335820,True,0,2 user reviews,2,0,2
335830,True,5,Mixed,116,74,190
335840,True,7,Positive,32,2,34
335850,True,3,Negative,2,17,19
335880,True,0,No user reviews,0,0,0
335890,True,0,1 user reviews,1,0,1
335900,True,0,5 user reviews,3,2,5
335920,True,8,Very Positive,90,10,100
335930,True,5,Mixed,9,11,20
335940,True,4,Mostly Negative,3,8,11
335950,True,0,3 user reviews,2,1,3
335970,True,0,No user reviews,0,0,0
335981,True,0,3 user reviews,0,3,3
335982,True,0,No user reviews,0,0,0
335990,True,0,No user reviews,0,0,0
335991,True,0,No user reviews,0,0,0
336010,True,6,Mostly Positive,26,11,37
336020,True,0,5 user reviews,2,3,5
336030,True,5,Mixed,9,4,13
336040,True,0,1 user reviews,1,0,1
336050,True,0,No user reviews,0,0,0
336060,True,6,Mostly Positive,164,42,206
336070,True,0,1 user reviews,1,0,1
336080,True,6,Mostly Positive,182,47,229
336090,True,6,Mostly Positive,19,5,24
336100,True,5,Mixed,38,18,56
336110,True,6,Mostly Positive,18,7,25
336130,True,8,Very Positive,272,29,301
336140,True,9,Overwhelmingly Positive,830,34,864
336150,True,6,Mostly Positive,167,43,210
336160,True,0,2 user reviews,1,1,2
336170,True,7,Positive,10,0,10
336180,True,0,No user reviews,0,0,0
336200,True,0,7 user reviews,4,3,7
336210,True,3,Negative,2,11,13
336220,True,5,Mixed,18,8,26
336230,True,0,8 user reviews,7,1,8
336240,True,8,Very Positive,177,32,209
336250,True,4,Mostly Negative,13,21,34
336270,True,0,7 user reviews,6,1,7
336300,True,8,Very Positive,149,30,179
336310,True,7,Positive,41,6,47
336320,True,0,1 user reviews,1,0,1
336370,True,8,Very Positive,77,3,80
336380,True,5,Mixed,17,14,31
336400,True,0,No user reviews,0,0,0
336420,True,8,Very Positive,69,12,81
336440,True,7,Positive,33,5,38
336460,True,0,No user reviews,0,0,0
336520,True,0,2 user reviews,1,1,2
336530,True,5,Mixed,10,7,17
336610,True,8,Very Positive,189,19,208
336620,True,0,No user reviews,0,0,0
336630,True,5,Mixed,6,6,12
336650,True,0,No user reviews,0,0,0
336660,True,0,1 user reviews,1,0,1
336661,True,0,No user reviews,0,0,0
336670,True,0,2 user reviews,1,1,2
336680,True,7,Positive,8,2,10
336700,True,7,Positive,13,2,15
336710,True,0,3 user reviews,3,0,3
336730,True,0,6 user reviews,3,3,6
336760,True,0,7 user reviews,7,0,7
336770,True,0,3 user reviews,3,0,3
336780,True,0,1 user reviews,0,1,1
336790,True,5,Mixed,37,21,58
336800,True,0,No user reviews,0,0,0
336810,True,0,No user reviews,0,0,0
336840,True,0,8 user reviews,8,0,8
336850,True,0,1 user reviews,1,0,1
336851,True,0,4 user reviews,2,2,4
336860,True,0,No user reviews,0,0,0
336870,True,0,No user reviews,0,0,0
336900,True,0,1 user reviews,0,1,1
336930,True,5,Mixed,5,5,10
336940,True,8,Very Positive,103,17,120
337000,True,6,Mostly Positive,7925,3380,11305
337020,True,0,No user reviews,0,0,0
337040,True,5,Mixed,69,31,100
337050,True,0,No user reviews,0,0,0
337070,True,5,Mixed,139,94,233
337100,True,0,1 user reviews,0,1,1
337101,True,0,No user reviews,0,0,0
337102,True,0,No user reviews,0,0,0
337103,True,0,1 user reviews,1,0,1
337104,True,0,2 user reviews,1,1,2
337105,True,0,No user reviews,0,0,0
337110,True,5,Mixed,5,5,10
337120,True,0,No user reviews,0,0,0
337130,True,0,6 user reviews,5,1,6
337150,True,8,Very Positive,685,53,738
337170,True,0,No user reviews,0,0,0
337180,True,6,Mostly Positive,26,11,37
337210,True,5,Mixed,19,26,45
337220,True,5,Mixed,25,26,51
337270,True,8,Very Positive,99,18,117
337280,True,6,Mostly Positive,27,10,37
337290,True,8,Very Positive,51,8,59
337310,True,0,No user reviews,0,0,0
337320,True,8,Very Positive,4952,317,5269
337340,True,9,Overwhelmingly Positive,3051,54,3105
337350,True,8,Very Positive,165,9,174
337360,True,5,Mixed,40,31,71
337380,True,0,No user reviews,0,0,0
337400,True,0,3 user reviews,3,0,3
337410,True,0,No user reviews,0,0,0
337420,True,5,Mixed,31,23,54
337430,True,0,No user reviews,0,0,0
337450,True,7,Positive,12,2,14
337460,True,0,4 user reviews,3,1,4
337480,True,6,Mostly Positive,41,15,56
337490,True,6,Mostly Positive,104,32,136
337570,True,0,1 user reviews,1,0,1
337630,True,7,Positive,16,3,19
337640,True,0,No user reviews,0,0,0
337650,True,7,Positive,18,2,20
337660,True,5,Mixed,141,174,315
337661,True,6,Mostly Positive,298,91,389
337670,True,7,Positive,22,1,23
337680,True,8,Very Positive,73,18,91
337690,True,0,No user reviews,0,0,0
337700,True,5,Mixed,7,8,15
337710,True,0,No user reviews,0,0,0
337720,True,8,Very Positive,120,3,123
337730,True,0,4 user reviews,2,2,4
337740,True,0,1 user reviews,0,1,1
337760,True,7,Positive,38,5,43
337810,True,0,No user reviews,0,0,0
337820,True,5,Mixed,50,31,81
337830,True,0,No user reviews,0,0,0
337840,True,7,Positive,33,3,36
337850,True,8,Very Positive,100,8,108
337870,True,0,No user reviews,0,0,0
337871,True,0,No user reviews,0,0,0
337872,True,0,No user reviews,0,0,0
337880,True,4,Mostly Negative,19,49,68
337890,True,6,Mostly Positive,20,6,26
337900,True,0,2 user reviews,0,2,2
337901,True,0,1 user reviews,1,0,1
337902,True,0,6 user reviews,5,1,6
337910,True,0,No user reviews,0,0,0
337930,True,8,Very Positive,367,27,394
337940,True,6,Mostly Positive,13,4,17
337950,True,3,Negative,7,35,42
337960,True,6,Mostly Positive,41,11,52
337970,True,0,8 user reviews,4,4,8
337980,True,5,Mixed,15,20,35
338000,True,0,3 user reviews,3,0,3
338010,True,0,No user reviews,0,0,0
338030,True,0,1 user reviews,0,1,1
338040,True,5,Mixed,20,17,37
338050,True,5,Mixed,7,9,16
338060,True,6,Mostly Positive,90,30,120
338070,True,0,2 user reviews,2,0,2
338080,True,0,No user reviews,0,0,0
338090,True,0,No user reviews,0,0,0
338100,True,0,No user reviews,0,0,0
338110,True,7,Positive,9,1,10
338120,True,5,Mixed,22,24,46
338130,True,5,Mixed,52,26,78
338140,True,6,Mostly Positive,123,46,169
338160,True,6,Mostly Positive,163,55,218
338161,True,5,Mixed,15,9,24
338162,True,7,Positive,21,3,24
338163,True,5,Mixed,179,169,348
338170,True,8,Very Positive,1276,148,1424
338180,True,6,Mostly Positive,7,3,10
338190,True,8,Very Positive,95,12,107
338200,True,0,No user reviews,0,0,0
338201,True,0,1 user reviews,1,0,1
338202,True,0,3 user reviews,3,0,3
338230,True,0,No user reviews,0,0,0
338240,True,0,No user reviews,0,0,0
338250,True,7,Positive,29,2,31
338260,True,5,Mixed,6,4,10
338290,True,0,6 user reviews,4,2,6
338300,True,0,8 user reviews,5,3,8
338310,True,7,Positive,31,4,35
338320,True,6,Mostly Positive,111,41,152
338330,True,5,Mixed,12,9,21
338340,True,0,No user reviews,0,0,0
338350,True,5,Mixed,4,6,10
338360,True,7,Positive,36,0,36
338370,True,0,2 user reviews,2,0,2
338371,True,0,1 user reviews,1,0,1
338372,True,0,2 user reviews,1,1,2
338390,True,5,Mixed,817,361,1178
338400,True,5,Mixed,75,48,123
338420,True,6,Mostly Positive,17,7,24
338440,True,0,No user reviews,0,0,0
338453,True,0,No user reviews,0,0,0
338470,True,5,Mixed,27,14,41
338480,True,0,No user reviews,0,0,0
338490,True,0,No user reviews,0,0,0
338510,True,0,No user reviews,0,0,0
338511,True,0,No user reviews,0,0,0
338512,True,0,No user reviews,0,0,0
338513,True,0,No user reviews,0,0,0
338514,True,0,No user reviews,0,0,0
338515,True,0,No user reviews,0,0,0
338516,True,0,No user reviews,0,0,0
338518,True,0,No user reviews,0,0,0
338520,True,0,1 user reviews,1,0,1
338521,True,0,No user reviews,0,0,0
338522,True,0,No user reviews,0,0,0
338523,True,0,No user reviews,0,0,0
338524,True,0,No user reviews,0,0,0
338525,True,0,1 user reviews,1,0,1
338530,True,5,Mixed,44,32,76
338540,True,0,3 user reviews,0,3,3
338550,True,7,Positive,13,2,15
338590,True,5,Mixed,17,12,29
338600,True,0,2 user reviews,2,0,2
338620,True,2,Very Negative,20,86,106
338630,True,6,Mostly Positive,14,4,18
338640,True,5,Mixed,14,8,22
338650,True,0,3 user reviews,0,3,3
338661,True,0,3 user reviews,0,3,3
338680,True,0,No user reviews,0,0,0
338690,True,0,No user reviews,0,0,0
338700,True,0,1 user reviews,1,0,1
338710,True,5,Mixed,18,23,41
338720,True,7,Positive,32,3,35
338721,True,0,8 user reviews,4,4,8
338722,True,0,2 user reviews,1,1,2
338723,True,0,4 user reviews,2,2,4
338740,True,0,No user reviews,0,0,0
338741,True,0,No user reviews,0,0,0
338743,True,0,7 user reviews,5,2,7
338744,True,0,6 user reviews,6,0,6
338745,True,0,6 user reviews,4,2,6
338746,True,0,2 user reviews,2,0,2
338760,True,7,Positive,47,2,49
338770,True,0,9 user reviews,9,0,9
338800,True,8,Very Positive,97,23,120
338810,True,0,No user reviews,0,0,0
338820,True,0,No user reviews,0,0,0
338830,True,5,Mixed,12,12,24
338840,True,0,No user reviews,0,0,0
338882,True,5,Mixed,4,6,10
338890,True,6,Mostly Positive,12,4,16
338920,True,0,No user reviews,0,0,0
338950,True,0,No user reviews,0,0,0
338960,True,7,Positive,33,1,34
338980,True,6,Mostly Positive,55,16,71
339000,True,5,Mixed,6,8,14
339010,True,0,No user reviews,0,0,0
339030,True,5,Mixed,13,11,24
339031,True,0,1 user reviews,0,1,1
339032,True,0,1 user reviews,0,1,1
339033,True,0,9 user reviews,5,4,9
339034,True,0,9 user reviews,3,6,9
339040,True,8,Very Positive,88,14,102
339070,True,0,6 user reviews,6,0,6
339080,True,0,2 user reviews,2,0,2
339090,True,7,Positive,18,0,18
339110,True,0,3 user reviews,0,3,3
339120,True,0,3 user reviews,3,0,3
339130,True,8,Very Positive,134,17,151
339160,True,7,Positive,15,2,17
339190,True,6,Mostly Positive,175,60,235
339200,True,8,Very Positive,403,92,495
339210,True,5,Mixed,44,41,85
339230,True,5,Mixed,528,324,852
339240,True,3,Negative,2,9,11
339250,True,5,Mixed,8,5,13
339280,True,6,Mostly Positive,19,8,27
339290,True,0,9 user reviews,1,8,9
339320,True,6,Mostly Positive,13,4,17
339330,True,7,Positive,24,1,25
339340,True,8,Very Positive,931,217,1148
339350,True,9,Overwhelmingly Positive,1515,50,1565
339360,True,0,1 user reviews,1,0,1
339380,True,0,No user reviews,0,0,0
339381,True,0,2 user reviews,2,0,2
339382,True,0,1 user reviews,1,0,1
339383,True,0,1 user reviews,1,0,1
339384,True,0,1 user reviews,1,0,1
339385,True,0,No user reviews,0,0,0
339386,True,0,1 user reviews,1,0,1
339387,True,0,1 user reviews,1,0,1
339388,True,0,1 user reviews,1,0,1
339390,True,0,4 user reviews,4,0,4
339391,True,0,2 user reviews,2,0,2
339392,True,0,2 user reviews,2,0,2
339393,True,0,No user reviews,0,0,0
339395,True,0,2 user reviews,2,0,2
339396,True,0,No user reviews,0,0,0
339398,True,0,No user reviews,0,0,0
339400,True,6,Mostly Positive,71,26,97
339410,True,0,No user reviews,0,0,0
339430,True,0,5 user reviews,4,1,5
339440,True,8,Very Positive,133,19,152
339460,True,7,Positive,17,3,20
339470,True,4,Mostly Negative,16,45,61
339480,True,5,Mixed,99,110,209
339500,True,0,3 user reviews,0,3,3
339510,True,8,Very Positive,93,22,115
339520,True,0,No user reviews,0,0,0
339530,True,0,9 user reviews,3,6,9
339540,True,4,Mostly Negative,7,11,18
339550,True,7,Positive,40,0,40
339560,True,0,No user reviews,0,0,0
339570,True,8,Very Positive,91,18,109
339580,True,6,Mostly Positive,444,138,582
339590,True,5,Mixed,6,6,12
339600,True,5,Mixed,22,23,45
339610,True,5,Mixed,55,30,85
339620,True,0,1 user reviews,1,0,1
339630,True,0,No user reviews,0,0,0
339640,True,5,Mixed,35,31,66
339690,True,0,4 user reviews,4,0,4
339700,True,5,Mixed,16,17,33
339710,True,0,3 user reviews,1,2,3
339720,True,0,7 user reviews,6,1,7
339750,True,0,1 user reviews,1,0,1
339760,True,0,1 user reviews,1,0,1
339770,True,0,2 user reviews,2,0,2
339790,True,8,Very Positive,172,15,187
339800,True,9,Overwhelmingly Positive,14182,515,14697
339810,True,0,No user reviews,0,0,0
339820,True,0,3 user reviews,0,3,3
339830,True,5,Mixed,26,17,43
339840,True,5,Mixed,9,11,20
339850,True,6,Mostly Positive,16,6,22
339860,True,0,8 user reviews,0,8,8
339870,True,0,No user reviews,0,0,0
339890,True,0,No user reviews,0,0,0
339900,True,4,Mostly Negative,8,25,33
339910,True,8,Very Positive,114,27,141
339961,True,0,No user reviews,0,0,0
339970,True,0,No user reviews,0,0,0
339980,True,0,No user reviews,0,0,0
339990,True,0,No user reviews,0,0,0
340000,True,8,Very Positive,329,39,368
340020,True,0,No user reviews,0,0,0
340030,True,3,Negative,0,11,11
340050,True,8,Very Positive,973,216,1189
340070,True,5,Mixed,111,164,275
340080,True,7,Positive,32,1,33
340090,True,0,5 user reviews,5,0,5
340110,True,0,No user reviews,0,0,0
340120,True,6,Mostly Positive,27,8,35
340130,True,0,7 user reviews,6,1,7
340140,True,0,2 user reviews,0,2,2
340150,True,6,Mostly Positive,813,239,1052
340170,True,5,Mixed,769,489,1258
340190,True,0,1 user reviews,1,0,1
340200,True,4,Mostly Negative,5,10,15
340210,True,5,Mixed,24,18,42
340220,True,4,Mostly Negative,8,19,27
340230,True,0,1 user reviews,1,0,1
340231,True,0,2 user reviews,1,1,2
340232,True,0,No user reviews,0,0,0
340233,True,0,1 user reviews,1,0,1
340250,True,0,5 user reviews,5,0,5
340260,True,0,9 user reviews,7,2,9
340270,True,6,Mostly Positive,128,34,162
340280,True,8,Very Positive,99,14,113
340290,True,5,Mixed,16,7,23
340300,True,8,Very Positive,181,26,207
340310,True,6,Mostly Positive,114,35,149
340320,True,8,Very Positive,72,15,87
340330,True,0,4 user reviews,3,1,4
340340,True,6,Mostly Positive,194,49,243
340350,True,0,3 user reviews,2,1,3
340360,True,8,Very Positive,129,28,157
340370,True,7,Positive,13,1,14
340380,True,7,Positive,8,2,10
340400,True,0,4 user reviews,4,0,4
340410,True,0,2 user reviews,0,2,2
340440,True,6,Mostly Positive,18,7,25
340450,True,6,Mostly Positive,18,6,24
340460,True,0,1 user reviews,0,1,1
340470,True,6,Mostly Positive,40,13,53
340480,True,6,Mostly Positive,9,3,12
340490,True,8,Very Positive,296,70,366
340500,True,7,Positive,12,2,14
340520,True,8,Very Positive,258,26,284
340530,True,3,Negative,2,9,11
340540,True,0,1 user reviews,0,1,1
340550,True,5,Mixed,9,9,18
340560,True,0,4 user reviews,2,2,4
340570,True,0,5 user reviews,3,2,5
340580,True,8,Very Positive,108,12,120
340600,True,7,Positive,17,1,18
340610,True,5,Mixed,8,6,14
340620,True,0,3 user reviews,1,2,3
340630,True,4,Mostly Negative,8,14,22
340640,True,0,5 user reviews,2,3,5
340650,True,5,Mixed,14,11,25
340661,True,0,No user reviews,0,0,0
340670,True,0,No user reviews,0,0,0
340680,True,0,1 user reviews,1,0,1
340700,True,0,3 user reviews,2,1,3
340720,True,7,Positive,11,2,13
340730,True,8,Very Positive,494,94,588
340740,True,0,No user reviews,0,0,0
340750,True,0,8 user reviews,4,4,8
340770,True,6,Mostly Positive,81,21,102
340800,True,8,Very Positive,86,6,92
340810,True,0,7 user reviews,5,2,7
340830,True,6,Mostly Positive,116,35,151
340840,True,5,Mixed,9,4,13
340860,True,8,Very Positive,50,10,60
340880,True,7,Positive,15,1,16
340890,True,0,No user reviews,0,0,0
340920,True,0,4 user reviews,2,2,4
340950,True,5,Mixed,9,4,13
340960,True,5,Mixed,18,8,26
340970,True,0,No user reviews,0,0,0
340980,True,0,No user reviews,0,0,0
340990,True,6,Mostly Positive,10,4,14
341000,True,8,Very Positive,1094,148,1242
341020,True,5,Mixed,79,39,118
341030,True,5,Mixed,66,48,114
341040,True,8,Very Positive,50,11,61
341050,True,0,No user reviews,0,0,0
341060,True,5,Mixed,17,20,37
341070,True,0,9 user reviews,6,3,9
341080,True,0,5 user reviews,3,2,5
341090,True,8,Very Positive,53,4,57
341110,True,0,No user reviews,0,0,0
341120,True,8,Very Positive,59,3,62
341150,True,8,Very Positive,140,27,167
341160,True,0,5 user reviews,3,2,5
341170,True,7,Positive,9,1,10
341190,True,0,4 user reviews,3,1,4
341210,True,0,No user reviews,0,0,0
341220,True,0,1 user reviews,0,1,1
341260,True,0,3 user reviews,1,2,3
341270,True,0,6 user reviews,2,4,6
341290,True,7,Positive,8,2,10
341300,True,0,No user reviews,0,0,0
341310,True,6,Mostly Positive,538,209,747
341320,True,0,No user reviews,0,0,0
341340,True,0,No user reviews,0,0,0
341360,True,0,9 user reviews,6,3,9
341380,True,4,Mostly Negative,3,9,12
341390,True,6,Mostly Positive,84,34,118
341410,True,0,2 user reviews,2,0,2
341440,True,7,Positive,12,3,15
341450,True,0,No user reviews,0,0,0
341460,True,0,No user reviews,0,0,0
341470,True,5,Mixed,5,6,11
341480,True,0,No user reviews,0,0,0
341490,True,0,1 user reviews,1,0,1
341500,True,5,Mixed,258,167,425
341510,True,6,Mostly Positive,12,5,17
341530,True,7,Positive,31,3,34
341540,True,5,Mixed,11,7,18
341550,True,8,Very Positive,154,17,171
341570,True,7,Positive,11,2,13
341610,True,0,3 user reviews,3,0,3
341640,True,5,Mixed,5,6,11
341660,True,4,Mostly Negative,13,28,41
341680,True,7,Positive,25,3,28
341690,True,5,Mixed,10,8,18
341700,True,6,Mostly Positive,26,11,37
341710,True,5,Mixed,148,82,230
341720,True,0,2 user reviews,2,0,2
341730,True,8,Very Positive,75,11,86
341750,True,0,8 user reviews,4,4,8
341760,True,7,Positive,9,2,11
341770,True,0,6 user reviews,2,4,6
341790,True,0,1 user reviews,1,0,1
341800,True,9,Overwhelmingly Positive,4661,60,4721
341810,True,7,Positive,16,3,19
341820,True,7,Positive,32,8,40
341840,True,0,3 user reviews,3,0,3
341841,True,0,No user reviews,0,0,0
341842,True,7,Positive,10,0,10
341843,True,0,No user reviews,0,0,0
341844,True,0,2 user reviews,2,0,2
341845,True,0,6 user reviews,2,4,6
341846,True,0,1 user reviews,1,0,1
341847,True,0,1 user reviews,0,1,1
341848,True,0,4 user reviews,1,3,4
341849,True,0,1 user reviews,1,0,1
341850,True,0,1 user reviews,1,0,1
341870,True,5,Mixed,148,64,212
341890,True,5,Mixed,7,5,12
341910,True,7,Positive,21,5,26
341930,True,5,Mixed,14,16,30
341940,True,6,Mostly Positive,3364,959,4323
341950,True,8,Very Positive,85,18,103
341960,True,7,Positive,14,2,16
341990,True,0,No user reviews,0,0,0
342000,True,4,Mostly Negative,8,22,30
342010,True,0,1 user reviews,1,0,1
342020,True,5,Mixed,12,7,19
342050,True,0,No user reviews,0,0,0
342051,True,0,No user reviews,0,0,0
342090,True,4,Mostly Negative,2,8,10
342100,True,6,Mostly Positive,11,3,14
342130,True,0,7 user reviews,4,3,7
342150,True,0,No user reviews,0,0,0
342180,True,8,Very Positive,2850,649,3499
342190,True,6,Mostly Positive,85,25,110
342200,True,5,Mixed,65,30,95
342230,True,5,Mixed,27,22,49
342240,True,0,6 user reviews,3,3,6
342250,True,0,1 user reviews,1,0,1
342260,True,5,Mixed,87,38,125
342270,True,0,No user reviews,0,0,0
342280,True,8,Very Positive,60,9,69
342290,True,0,1 user reviews,0,1,1
342300,True,8,Very Positive,215,16,231
342310,True,5,Mixed,304,173,477
342330,True,0,No user reviews,0,0,0
342350,True,8,Very Positive,83,20,103
342360,True,5,Mixed,5,5,10
342370,True,7,Positive,8,2,10
342380,True,8,Very Positive,708,140,848
342430,True,0,4 user reviews,4,0,4
342450,True,5,Mixed,40,44,84
342480,True,7,Positive,39,7,46
342490,True,6,Mostly Positive,94,25,119
342500,True,4,Mostly Negative,4,15,19
342510,True,0,4 user reviews,3,1,4
342520,True,5,Mixed,6,4,10
342530,True,6,Mostly Positive,16,6,22
342540,True,0,8 user reviews,3,5,8
342550,True,4,Mostly Negative,36,61,97
342560,True,9,Overwhelmingly Positive,2267,97,2364
342570,True,0,3 user reviews,0,3,3
342580,True,8,Very Positive,637,67,704
342590,True,0,No user reviews,0,0,0
342600,True,0,No user reviews,0,0,0
342610,True,8,Very Positive,191,6,197
342620,True,6,Mostly Positive,63,19,82
342630,True,7,Positive,31,3,34
342640,True,5,Mixed,313,140,453
342650,True,0,8 user reviews,5,3,8
342660,True,0,2 user reviews,1,1,2
342680,True,0,7 user reviews,5,2,7
342730,True,0,No user reviews,0,0,0
342740,True,5,Mixed,7,7,14
342750,True,0,No user reviews,0,0,0
342751,True,0,1 user reviews,1,0,1
342752,True,0,No user reviews,0,0,0
342753,True,0,2 user reviews,2,0,2
342754,True,0,6 user reviews,6,0,6
342755,True,0,2 user reviews,2,0,2
342756,True,0,2 user reviews,2,0,2
342757,True,0,No user reviews,0,0,0
342758,True,0,1 user reviews,1,0,1
342759,True,0,No user reviews,0,0,0
342760,True,0,No user reviews,0,0,0
342761,True,0,2 user reviews,2,0,2
342762,True,0,No user reviews,0,0,0
342763,True,0,1 user reviews,1,0,1
342764,True,0,No user reviews,0,0,0
342765,True,0,No user reviews,0,0,0
342766,True,0,No user reviews,0,0,0
342767,True,0,1 user reviews,0,1,1
342768,True,0,2 user reviews,1,1,2
342769,True,0,1 user reviews,0,1,1
342770,True,0,No user reviews,0,0,0
342771,True,0,No user reviews,0,0,0
342772,True,0,No user reviews,0,0,0
342773,True,0,No user reviews,0,0,0
342774,True,0,No user reviews,0,0,0
342775,True,0,No user reviews,0,0,0
342776,True,0,2 user reviews,2,0,2
342777,True,0,No user reviews,0,0,0
342778,True,0,No user reviews,0,0,0
342779,True,0,1 user reviews,1,0,1
342780,True,0,1 user reviews,1,0,1
342781,True,0,No user reviews,0,0,0
342782,True,0,No user reviews,0,0,0
342783,True,0,No user reviews,0,0,0
342784,True,0,No user reviews,0,0,0
342785,True,0,1 user reviews,1,0,1
342786,True,0,2 user reviews,1,1,2
342787,True,0,No user reviews,0,0,0
342788,True,0,No user reviews,0,0,0
342789,True,0,2 user reviews,2,0,2
342790,True,0,5 user reviews,5,0,5
342791,True,0,No user reviews,0,0,0
342792,True,0,2 user reviews,2,0,2
342793,True,0,No user reviews,0,0,0
342794,True,0,No user reviews,0,0,0
342795,True,0,No user reviews,0,0,0
342796,True,0,1 user reviews,1,0,1
342797,True,0,No user reviews,0,0,0
342798,True,0,No user reviews,0,0,0
342799,True,0,No user reviews,0,0,0
342800,True,0,1 user reviews,1,0,1
342801,True,0,No user reviews,0,0,0
342802,True,0,No user reviews,0,0,0
342803,True,0,No user reviews,0,0,0
342804,True,0,No user reviews,0,0,0
342805,True,0,No user reviews,0,0,0
342806,True,0,2 user reviews,2,0,2
342807,True,0,No user reviews,0,0,0
342808,True,0,No user reviews,0,0,0
342809,True,0,No user reviews,0,0,0
342810,True,0,No user reviews,0,0,0
342811,True,0,2 user reviews,2,0,2
342812,True,0,1 user reviews,1,0,1
342813,True,0,No user reviews,0,0,0
342814,True,0,No user reviews,0,0,0
342815,True,0,1 user reviews,1,0,1
342816,True,0,2 user reviews,1,1,2
342817,True,0,1 user reviews,1,0,1
342818,True,0,No user reviews,0,0,0
342819,True,0,1 user reviews,1,0,1
342820,True,0,No user reviews,0,0,0
342821,True,0,No user reviews,0,0,0
342822,True,0,2 user reviews,2,0,2
342823,True,0,No user reviews,0,0,0
342824,True,0,No user reviews,0,0,0
342825,True,0,6 user reviews,6,0,6
342826,True,0,No user reviews,0,0,0
342827,True,0,No user reviews,0,0,0
342828,True,0,No user reviews,0,0,0
342829,True,0,2 user reviews,2,0,2
342830,True,0,1 user reviews,1,0,1
342831,True,0,6 user reviews,5,1,6
342832,True,0,No user reviews,0,0,0
342833,True,0,No user reviews,0,0,0
342834,True,0,No user reviews,0,0,0
342835,True,0,1 user reviews,1,0,1
342836,True,0,1 user reviews,1,0,1
342837,True,0,1 user reviews,1,0,1
342838,True,0,No user reviews,0,0,0
342839,True,0,1 user reviews,1,0,1
342840,True,0,No user reviews,0,0,0
342841,True,7,Positive,11,0,11
342842,True,0,1 user reviews,1,0,1
342843,True,0,3 user reviews,3,0,3
342844,True,0,2 user reviews,2,0,2
342845,True,0,No user reviews,0,0,0
342846,True,0,1 user reviews,1,0,1
342847,True,0,1 user reviews,1,0,1
342848,True,0,No user reviews,0,0,0
342849,True,0,1 user reviews,1,0,1
342850,True,0,No user reviews,0,0,0
342851,True,0,3 user reviews,3,0,3
342852,True,0,No user reviews,0,0,0
342853,True,0,1 user reviews,1,0,1
342854,True,0,No user reviews,0,0,0
342855,True,0,No user reviews,0,0,0
342856,True,0,No user reviews,0,0,0
342857,True,0,No user reviews,0,0,0
342858,True,0,No user reviews,0,0,0
342859,True,0,1 user reviews,0,1,1
342860,True,5,Mixed,32,15,47
342870,True,5,Mixed,6,5,11
342880,True,0,7 user reviews,5,2,7
342890,True,5,Mixed,20,17,37
342910,True,5,Mixed,19,16,35
342920,True,0,9 user reviews,7,2,9
342940,True,8,Very Positive,905,135,1040
342970,True,5,Mixed,54,42,96
342980,True,0,7 user reviews,4,3,7
342990,True,5,Mixed,24,31,55
343000,True,5,Mixed,13,14,27
343010,True,0,No user reviews,0,0,0
343020,True,0,1 user reviews,1,0,1
343070,True,5,Mixed,75,55,130
343090,True,8,Very Positive,146,33,179
343100,True,6,Mostly Positive,252,100,352
343120,True,5,Mixed,23,14,37
343140,True,0,8 user reviews,4,4,8
343150,True,4,Mostly Negative,12,19,31
343170,True,0,7 user reviews,3,4,7
343180,True,0,8 user reviews,5,3,8
343250,True,0,3 user reviews,2,1,3
343270,True,5,Mixed,119,78,197
343280,True,4,Mostly Negative,18,33,51
343290,True,0,7 user reviews,7,0,7
343300,True,7,Positive,12,1,13
343310,True,0,No user reviews,0,0,0
343320,True,7,Positive,8,2,10
343330,True,0,No user reviews,0,0,0
343340,True,4,Mostly Negative,4,10,14
343360,True,5,Mixed,109,75,184
343370,True,8,Very Positive,85,5,90
343380,True,0,No user reviews,0,0,0
343390,True,5,Mixed,17,8,25
343410,True,0,3 user reviews,3,0,3
343420,True,0,No user reviews,0,0,0
343421,True,0,No user reviews,0,0,0
343422,True,0,No user reviews,0,0,0
343423,True,0,No user reviews,0,0,0
343424,True,0,No user reviews,0,0,0
343425,True,0,No user reviews,0,0,0
343426,True,0,No user reviews,0,0,0
343430,True,7,Positive,10,2,12
343440,True,8,Very Positive,290,51,341
343450,True,0,No user reviews,0,0,0
343460,True,5,Mixed,44,35,79
343461,True,6,Mostly Positive,69,19,88
343462,True,5,Mixed,99,54,153
343463,True,8,Very Positive,113,13,126
343464,True,5,Mixed,319,168,487
343480,True,0,No user reviews,0,0,0
343510,True,0,1 user reviews,1,0,1
343560,True,8,Very Positive,148,26,174
343570,True,7,Positive,11,2,13
343580,True,7,Positive,16,2,18
343590,True,0,No user reviews,0,0,0
343591,True,0,2 user reviews,1,1,2
343592,True,0,3 user reviews,1,2,3
343593,True,0,No user reviews,0,0,0
343594,True,4,Mostly Negative,7,13,20
343595,True,5,Mixed,4,6,10
343596,True,0,6 user reviews,0,6,6
343597,True,0,1 user reviews,0,1,1
343598,True,0,3 user reviews,1,2,3
343599,True,0,1 user reviews,0,1,1
343600,True,5,Mixed,14,10,24
343610,True,5,Mixed,7,7,14
343611,True,4,Mostly Negative,14,38,52
343612,True,0,2 user reviews,0,2,2
343613,True,0,No user reviews,0,0,0
343614,True,0,No user reviews,0,0,0
343615,True,0,2 user reviews,0,2,2
343630,True,0,No user reviews,0,0,0
343660,True,0,No user reviews,0,0,0
343690,True,4,Mostly Negative,4,11,15
343700,True,0,No user reviews,0,0,0
343710,True,5,Mixed,429,247,676
343720,True,0,No user reviews,0,0,0
343730,True,0,4 user reviews,2,2,4
343740,True,0,2 user reviews,2,0,2
343750,True,0,7 user reviews,2,5,7
343760,True,0,2 user reviews,1,1,2
343770,True,0,1 user reviews,0,1,1
343780,True,8,Very Positive,1273,94,1367
343800,True,6,Mostly Positive,22,8,30
343810,True,7,Positive,34,2,36
343820,True,6,Mostly Positive,29,8,37
343830,True,0,7 user reviews,5,2,7
343840,True,7,Positive,28,4,32
343860,True,8,Very Positive,1379,172,1551
343930,True,5,Mixed,32,17,49
343940,True,0,No user reviews,0,0,0
343950,True,5,Mixed,6,6,12
343951,True,0,8 user reviews,2,6,8
343952,True,5,Mixed,5,6,11
343953,True,6,Mostly Positive,25,10,35
343955,True,4,Mostly Negative,8,14,22
343956,True,6,Mostly Positive,16,5,21
343959,True,5,Mixed,16,7,23
343961,True,5,Mixed,9,8,17
343962,True,5,Mixed,8,5,13
343970,True,0,No user reviews,0,0,0
343980,True,0,No user reviews,0,0,0
343981,True,0,No user reviews,0,0,0
343982,True,0,No user reviews,0,0,0
343990,True,5,Mixed,6,8,14
344000,True,0,No user reviews,0,0,0
344030,True,5,Mixed,9,7,16
344050,True,0,5 user reviews,4,1,5
344060,True,0,3 user reviews,3,0,3
344070,True,0,4 user reviews,4,0,4
344080,True,0,No user reviews,0,0,0
344090,True,0,No user reviews,0,0,0
344100,True,0,5 user reviews,2,3,5
344110,True,0,No user reviews,0,0,0
344120,True,0,2 user reviews,2,0,2
344121,True,0,No user reviews,0,0,0
344122,True,0,No user reviews,0,0,0
344123,True,0,No user reviews,0,0,0
344130,True,7,Positive,12,2,14
344140,True,5,Mixed,169,83,252
344150,True,0,No user reviews,0,0,0
344160,True,3,Negative,3,17,20
344170,True,0,No user reviews,0,0,0
344171,True,0,No user reviews,0,0,0
344172,True,0,1 user reviews,1,0,1
344173,True,0,1 user reviews,1,0,1
344174,True,0,No user reviews,0,0,0
344175,True,0,No user reviews,0,0,0
344176,True,0,No user reviews,0,0,0
344177,True,0,No user reviews,0,0,0
344178,True,0,1 user reviews,1,0,1
344180,True,6,Mostly Positive,28,12,40
344190,True,0,1 user reviews,1,0,1
344200,True,0,No user reviews,0,0,0
344210,True,0,4 user reviews,3,1,4
344220,True,0,9 user reviews,4,5,9
344230,True,5,Mixed,19,11,30
344240,True,5,Mixed,288,165,453
344250,True,0,No user reviews,0,0,0
344251,True,0,No user reviews,0,0,0
344252,True,0,No user reviews,0,0,0
344253,True,0,No user reviews,0,0,0
344254,True,0,No user reviews,0,0,0
344255,True,0,No user reviews,0,0,0
344256,True,0,No user reviews,0,0,0
344257,True,0,No user reviews,0,0,0
344258,True,0,No user reviews,0,0,0
344259,True,0,No user reviews,0,0,0
344260,True,0,3 user reviews,2,1,3
344270,True,0,7 user reviews,7,0,7
344290,True,5,Mixed,12,6,18
344300,True,5,Mixed,13,7,20
344340,True,8,Very Positive,92,21,113
344350,True,0,No user reviews,0,0,0
344351,True,0,No user reviews,0,0,0
344352,True,0,No user reviews,0,0,0
344353,True,0,No user reviews,0,0,0
344354,True,0,No user reviews,0,0,0
344355,True,0,No user reviews,0,0,0
344358,True,0,No user reviews,0,0,0
344359,True,0,No user reviews,0,0,0
344380,True,0,No user reviews,0,0,0
344381,True,0,No user reviews,0,0,0
344382,True,0,No user reviews,0,0,0
344383,True,0,No user reviews,0,0,0
344384,True,0,No user reviews,0,0,0
344385,True,0,No user reviews,0,0,0
344386,True,0,No user reviews,0,0,0
344387,True,0,No user reviews,0,0,0
344388,True,0,No user reviews,0,0,0
344389,True,0,No user reviews,0,0,0
344390,True,0,No user reviews,0,0,0
344391,True,0,No user reviews,0,0,0
344392,True,0,No user reviews,0,0,0
344393,True,0,No user reviews,0,0,0
344394,True,0,No user reviews,0,0,0
344395,True,0,No user reviews,0,0,0
344396,True,0,No user reviews,0,0,0
344397,True,0,No user reviews,0,0,0
344398,True,0,No user reviews,0,0,0
344399,True,0,No user reviews,0,0,0
344410,True,5,Mixed,88,43,131
344420,True,0,No user reviews,0,0,0
344421,True,0,No user reviews,0,0,0
344422,True,0,No user reviews,0,0,0
344423,True,0,No user reviews,0,0,0
344424,True,0,No user reviews,0,0,0
344440,True,8,Very Positive,61,8,69
344450,True,8,Very Positive,283,45,328
344461,True,5,Mixed,47,30,77
344462,True,5,Mixed,29,27,56
344463,True,8,Very Positive,63,14,77
344470,True,0,No user reviews,0,0,0
344480,True,8,Very Positive,104,1,105
344490,True,0,1 user reviews,1,0,1
344500,True,7,Positive,42,6,48
344510,True,6,Mostly Positive,19,5,24
344530,True,0,1 user reviews,1,0,1
344630,True,8,Very Positive,91,9,100
344650,True,0,No user reviews,0,0,0
344662,True,0,No user reviews,0,0,0
344670,True,0,No user reviews,0,0,0
344730,True,0,6 user reviews,6,0,6
344740,True,8,Very Positive,482,95,577
344760,True,5,Mixed,4175,3583,7758
344770,True,8,Very Positive,440,8,448
344790,True,5,Mixed,13,14,27
344800,True,8,Very Positive,49,8,57
344810,True,8,Very Positive,54,13,67
344820,True,4,Mostly Negative,15,45,60
344840,True,4,Mostly Negative,67,105,172
344850,True,6,Mostly Positive,599,179,778
344860,True,8,Very Positive,169,9,178
344890,True,4,Mostly Negative,10,25,35
344900,True,4,Mostly Negative,16,26,42
344910,True,5,Mixed,104,85,189
344920,True,0,1 user reviews,1,0,1
344960,True,0,4 user reviews,3,1,4
344970,True,0,No user reviews,0,0,0
345000,True,0,No user reviews,0,0,0
345010,True,5,Mixed,165,78,243
345020,True,6,Mostly Positive,23,6,29
345030,True,5,Mixed,6,9,15
345040,True,0,4 user reviews,4,0,4
345050,True,0,9 user reviews,7,2,9
345060,True,6,Mostly Positive,22,8,30
345080,True,5,Mixed,55,29,84
345090,True,8,Very Positive,207,41,248
345120,True,8,Very Positive,92,20,112
345130,True,0,9 user reviews,8,1,9
345140,True,5,Mixed,39,28,67
345150,True,0,1 user reviews,1,0,1
345170,True,0,No user reviews,0,0,0
345180,True,8,Very Positive,1121,161,1282
345190,True,0,No user reviews,0,0,0
345191,True,0,No user reviews,0,0,0
345200,True,8,Very Positive,143,15,158
345220,True,7,Positive,12,2,14
345230,True,5,Mixed,31,19,50
345240,True,8,Very Positive,244,33,277
345260,True,5,Mixed,463,238,701
345280,True,5,Mixed,19,24,43
345290,True,0,4 user reviews,3,1,4
345300,True,0,1 user reviews,1,0,1
345310,True,0,2 user reviews,2,0,2
345330,True,6,Mostly Positive,95,26,121
345340,True,5,Mixed,7,4,11
345350,True,8,Very Positive,1177,278,1455
345370,True,8,Very Positive,275,60,335
345380,True,0,No user reviews,0,0,0
345390,True,8,Very Positive,867,108,975
345430,True,8,Very Positive,162,25,187
345440,True,4,Mostly Negative,16,46,62
345460,True,0,No user reviews,0,0,0
345470,True,0,1 user reviews,1,0,1
345480,True,6,Mostly Positive,33,10,43
345520,True,0,No user reviews,0,0,0
345540,True,7,Positive,33,8,41
345552,True,0,No user reviews,0,0,0
345553,True,0,No user reviews,0,0,0
345554,True,0,No user reviews,0,0,0
345555,True,0,No user reviews,0,0,0
345556,True,0,No user reviews,0,0,0
345557,True,0,1 user reviews,1,0,1
345558,True,0,No user reviews,0,0,0
345562,True,0,No user reviews,0,0,0
345570,True,0,3 user reviews,3,0,3
345580,True,5,Mixed,7,6,13
345610,True,8,Very Positive,470,29,499
345620,True,8,Very Positive,53,8,61
345630,True,7,Positive,37,1,38
345640,True,5,Mixed,15,11,26
345650,True,0,7 user reviews,5,2,7
345660,True,5,Mixed,278,135,413
345670,True,7,Positive,12,0,12
345680,True,0,8 user reviews,7,1,8
345681,True,0,9 user reviews,7,2,9
345690,True,0,3 user reviews,0,3,3
345700,True,5,Mixed,22,13,35
345710,True,3,Negative,2,20,22
345720,True,7,Positive,12,0,12
345740,True,7,Positive,36,4,40
345741,True,7,Positive,12,0,12
345750,True,5,Mixed,30,28,58
345790,True,0,9 user reviews,5,4,9
345800,True,8,Very Positive,51,8,59
345820,True,9,Overwhelmingly Positive,706,32,738
345830,True,0,No user reviews,0,0,0
345860,True,8,Very Positive,91,20,111
345870,True,7,Positive,12,3,15
345890,True,5,Mixed,239,111,350
345900,True,0,2 user reviews,2,0,2
345930,True,0,1 user reviews,1,0,1
345950,True,0,No user reviews,0,0,0
345980,True,6,Mostly Positive,95,38,133
345990,True,6,Mostly Positive,13,4,17
346010,True,9,Overwhelmingly Positive,15838,803,16641
346040,True,5,Mixed,12,13,25
346060,True,7,Positive,11,0,11
346070,True,0,No user reviews,0,0,0
346071,True,0,1 user reviews,1,0,1
346080,True,4,Mostly Negative,4,10,14
346090,True,7,Positive,21,4,25
346110,True,6,Mostly Positive,102386,34564,136950
346120,True,7,Positive,41,6,47
346130,True,0,1 user reviews,1,0,1
346140,True,5,Mixed,36,31,67
346150,True,4,Mostly Negative,3,10,13
346160,True,5,Mixed,10,11,21
346170,True,8,Very Positive,92,2,94
346180,True,6,Mostly Positive,303,78,381
346200,True,0,5 user reviews,4,1,5
346210,True,7,Positive,9,2,11
346220,True,5,Mixed,64,52,116
346240,True,5,Mixed,20,13,33
346250,True,6,Mostly Positive,16,6,22
346260,True,0,No user reviews,0,0,0
346261,True,0,No user reviews,0,0,0
346270,True,4,Mostly Negative,28,73,101
346280,True,0,No user reviews,0,0,0
346290,True,0,1 user reviews,0,1,1
346300,True,4,Mostly Negative,3,7,10
346310,True,0,No user reviews,0,0,0
346311,True,0,No user reviews,0,0,0
346320,True,5,Mixed,10,14,24
346330,True,7,Positive,31,5,36
346340,True,7,Positive,19,4,23
346360,True,7,Positive,11,1,12
346370,True,0,2 user reviews,1,1,2
346390,True,0,No user reviews,0,0,0
346400,True,0,1 user reviews,1,0,1
346420,True,6,Mostly Positive,123,51,174
346430,True,0,3 user reviews,1,2,3
346440,True,6,Mostly Positive,9,3,12
346450,True,6,Mostly Positive,29,11,40
346460,True,8,Very Positive,141,33,174
346470,True,8,Very Positive,202,11,213
346480,True,0,1 user reviews,1,0,1
346490,True,0,5 user reviews,2,3,5
346500,True,6,Mostly Positive,25,9,34
346510,True,7,Positive,19,2,21
346540,True,0,No user reviews,0,0,0
346541,True,0,No user reviews,0,0,0
346542,True,0,No user reviews,0,0,0
346550,True,5,Mixed,21,23,44
346560,True,8,Very Positive,466,32,498
346610,True,5,Mixed,19,16,35
346620,True,0,No user reviews,0,0,0
346630,True,5,Mixed,51,27,78
346640,True,0,No user reviews,0,0,0
346650,True,3,Negative,0,11,11
346660,True,0,No user reviews,0,0,0
346670,True,0,7 user reviews,4,3,7
346680,True,0,No user reviews,0,0,0
346690,True,0,No user reviews,0,0,0
346720,True,0,9 user reviews,6,3,9
346730,True,8,Very Positive,153,28,181
346740,True,0,8 user reviews,7,1,8
346741,True,0,8 user reviews,8,0,8
346742,True,7,Positive,8,2,10
346750,True,0,No user reviews,0,0,0
346760,True,0,2 user reviews,0,2,2
346770,True,7,Positive,19,2,21
346780,True,0,3 user reviews,2,1,3
346800,True,0,6 user reviews,4,2,6
346810,True,6,Mostly Positive,194,57,251
346830,True,5,Mixed,113,83,196
346850,True,8,Very Positive,338,34,372
346860,True,0,No user reviews,0,0,0
346870,True,0,No user reviews,0,0,0
346890,True,0,No user reviews,0,0,0
346900,True,8,Very Positive,252,44,296
346920,True,4,Mostly Negative,4,9,13
346930,True,5,Mixed,21,16,37
346940,True,8,Very Positive,1707,284,1991
346950,True,5,Mixed,7,5,12
346970,True,8,Very Positive,161,33,194
346990,True,0,No user reviews,0,0,0
347000,True,5,Mixed,33,16,49
347010,True,0,No user reviews,0,0,0
347040,True,6,Mostly Positive,8,3,11
347050,True,0,1 user reviews,0,1,1
347060,True,4,Mostly Negative,10,19,29
347070,True,0,5 user reviews,5,0,5
347090,True,6,Mostly Positive,122,40,162
347100,True,0,1 user reviews,0,1,1
347101,True,0,No user reviews,0,0,0
347102,True,0,No user reviews,0,0,0
347103,True,0,No user reviews,0,0,0
347104,True,0,No user reviews,0,0,0
347105,True,0,No user reviews,0,0,0
347110,True,0,1 user reviews,1,0,1
347120,True,0,No user reviews,0,0,0
347160,True,8,Very Positive,256,36,292
347170,True,5,Mixed,93,75,168
347190,True,7,Positive,11,2,13
347210,True,7,Positive,11,1,12
347211,True,7,Positive,26,1,27
347212,True,7,Positive,17,4,21
347213,True,7,Positive,28,3,31
347230,True,5,Mixed,12,7,19
347240,True,0,1 user reviews,1,0,1
347250,True,7,Positive,23,0,23
347260,True,6,Mostly Positive,10,3,13
347270,True,5,Mixed,7,4,11
347280,True,6,Mostly Positive,7,3,10
347290,True,5,Mixed,107,56,163
347330,True,0,4 user reviews,2,2,4
347350,True,0,No user reviews,0,0,0
347360,True,0,No user reviews,0,0,0
347370,True,0,No user reviews,0,0,0
347380,True,0,No user reviews,0,0,0
347400,True,6,Mostly Positive,74,20,94
347410,True,0,6 user reviews,1,5,6
347430,True,6,Mostly Positive,416,145,561
347440,True,5,Mixed,55,27,82
347450,True,0,3 user reviews,2,1,3
347470,True,7,Positive,32,1,33
347480,True,0,9 user reviews,4,5,9
347490,True,0,No user reviews,0,0,0
347491,True,0,No user reviews,0,0,0
347492,True,0,No user reviews,0,0,0
347493,True,0,No user reviews,0,0,0
347494,True,0,No user reviews,0,0,0
347510,True,7,Positive,31,4,35
347520,True,7,Positive,9,1,10
347530,True,0,No user reviews,0,0,0
347560,True,6,Mostly Positive,255,109,364
347570,True,0,No user reviews,0,0,0
347580,True,3,Negative,2,16,18
347590,True,7,Positive,24,0,24
347600,True,6,Mostly Positive,311,105,416
347610,True,8,Very Positive,89,6,95
347620,True,8,Very Positive,170,21,191
347630,True,0,No user reviews,0,0,0
347640,True,0,No user reviews,0,0,0
347641,True,0,No user reviews,0,0,0
347642,True,0,No user reviews,0,0,0
347643,True,0,No user reviews,0,0,0
347644,True,0,No user reviews,0,0,0
347645,True,0,No user reviews,0,0,0
347650,True,0,No user reviews,0,0,0
347651,True,0,No user reviews,0,0,0
347652,True,0,No user reviews,0,0,0
347653,True,0,No user reviews,0,0,0
347654,True,0,No user reviews,0,0,0
347655,True,0,No user reviews,0,0,0
347660,True,7,Positive,13,2,15
347670,True,8,Very Positive,261,51,312
347680,True,0,1 user reviews,1,0,1
347690,True,5,Mixed,11,8,19
347700,True,0,No user reviews,0,0,0
347710,True,8,Very Positive,71,16,87
347720,True,8,Very Positive,285,17,302
347730,True,7,Positive,18,1,19
347780,True,0,No user reviews,0,0,0
347790,True,7,Positive,20,4,24
347800,True,0,No user reviews,0,0,0
347820,True,6,Mostly Positive,14,5,19
347830,True,8,Very Positive,1109,123,1232
347900,True,0,No user reviews,0,0,0
347910,True,0,No user reviews,0,0,0
347920,True,0,No user reviews,0,0,0
347930,True,0,6 user reviews,0,6,6
347940,True,5,Mixed,136,95,231
347950,True,0,No user reviews,0,0,0
347970,True,0,No user reviews,0,0,0
347980,True,7,Positive,11,2,13
347981,True,0,9 user reviews,8,1,9
347990,True,8,Very Positive,217,6,223
348000,True,0,2 user reviews,1,1,2
348010,True,0,1 user reviews,1,0,1
348030,True,5,Mixed,118,84,202
348040,True,8,Very Positive,431,2,433
348070,True,0,1 user reviews,1,0,1
348080,True,0,No user reviews,0,0,0
348090,True,6,Mostly Positive,397,138,535
348091,True,6,Mostly Positive,98,42,140
348100,True,0,1 user reviews,1,0,1
348110,True,0,No user reviews,0,0,0
348160,True,0,5 user reviews,5,0,5
348180,True,5,Mixed,18,16,34
348190,True,0,No user reviews,0,0,0
348200,True,8,Very Positive,264,28,292
348210,True,0,6 user reviews,4,2,6
348240,True,7,Positive,39,6,45
348250,True,7,Positive,46,3,49
348270,True,5,Mixed,40,42,82
348280,True,5,Mixed,5,6,11
348290,True,5,Mixed,31,44,75
348300,True,8,Very Positive,66,6,72
348310,True,0,1 user reviews,1,0,1
348320,True,0,1 user reviews,1,0,1
348330,True,7,Positive,38,2,40
348340,True,5,Mixed,21,16,37
348350,True,0,No user reviews,0,0,0
348360,True,6,Mostly Positive,162,49,211
348370,True,0,No user reviews,0,0,0
348380,True,4,Mostly Negative,20,53,73
348400,True,5,Mixed,39,27,66
348430,True,7,Positive,43,0,43
348440,True,7,Positive,38,2,40
348450,True,4,Mostly Negative,15,30,45
348460,True,5,Mixed,62,31,93
348470,True,6,Mostly Positive,363,124,487
348490,True,6,Mostly Positive,103,29,132
348500,True,0,No user reviews,0,0,0
348510,True,4,Mostly Negative,67,142,209
348540,True,5,Mixed,29,13,42
348550,True,9,Overwhelmingly Positive,518,18,536
348560,True,8,Very Positive,48,2,50
348561,True,8,Very Positive,90,9,99
348570,True,0,No user reviews,0,0,0
348580,True,0,No user reviews,0,0,0
348610,True,0,No user reviews,0,0,0
348620,True,7,Positive,12,2,14
348650,True,3,Negative,1,10,11
348670,True,5,Mixed,118,101,219
348680,True,0,3 user reviews,2,1,3
348681,True,0,5 user reviews,5,0,5
348682,True,0,3 user reviews,3,0,3
348684,True,0,2 user reviews,2,0,2
348685,True,0,2 user reviews,2,0,2
348686,True,0,2 user reviews,1,1,2
348687,True,0,8 user reviews,8,0,8
348690,True,0,No user reviews,0,0,0
348700,True,0,1 user reviews,0,1,1
348710,True,8,Very Positive,274,33,307
348730,True,4,Mostly Negative,6,12,18
348740,True,0,2 user reviews,0,2,2
348750,True,0,2 user reviews,2,0,2
348760,True,0,1 user reviews,1,0,1
348790,True,5,Mixed,10,6,16
348800,True,0,8 user reviews,7,1,8
348810,True,5,Mixed,9,5,14
348820,True,8,Very Positive,97,13,110
348840,True,0,No user reviews,0,0,0
348850,True,0,4 user reviews,2,2,4
348860,True,0,9 user reviews,2,7,9
348870,True,5,Mixed,22,17,39
348900,True,0,No user reviews,0,0,0
348910,True,6,Mostly Positive,64,17,81
348920,True,0,No user reviews,0,0,0
348940,True,0,8 user reviews,7,1,8
348950,True,8,Very Positive,48,4,52
348960,True,5,Mixed,6,5,11
348970,True,0,No user reviews,0,0,0
348980,True,0,6 user reviews,2,4,6
348990,True,6,Mostly Positive,9,3,12
349000,True,0,6 user reviews,5,1,6
349020,True,5,Mixed,9,8,17
349040,True,8,Very Positive,5937,1088,7025
349050,True,0,No user reviews,0,0,0
349060,True,0,7 user reviews,4,3,7
349080,True,0,1 user reviews,1,0,1
349100,True,7,Positive,38,0,38
349110,True,0,No user reviews,0,0,0
349130,True,0,No user reviews,0,0,0
349140,True,6,Mostly Positive,66,23,89
349150,True,0,3 user reviews,2,1,3
349190,True,5,Mixed,11,10,21
349210,True,0,No user reviews,0,0,0
349220,True,8,Very Positive,320,44,364
349230,True,0,8 user reviews,6,2,8
349231,True,0,5 user reviews,4,1,5
349240,True,6,Mostly Positive,11,3,14
349250,True,8,Very Positive,150,3,153
349260,True,7,Positive,17,4,21
349270,True,6,Mostly Positive,35,15,50
349280,True,5,Mixed,6,4,10
349300,True,8,Very Positive,41,10,51
349310,True,8,Very Positive,104,7,111
349320,True,6,Mostly Positive,9,3,12
349350,True,6,Mostly Positive,23,9,32
349370,True,0,1 user reviews,1,0,1
349440,True,4,Mostly Negative,9,29,38
349450,True,5,Mixed,11,10,21
349460,True,0,8 user reviews,4,4,8
349470,True,0,No user reviews,0,0,0
349480,True,0,7 user reviews,6,1,7
349500,True,8,Very Positive,181,39,220
349510,True,8,Very Positive,54,6,60
349520,True,0,No user reviews,0,0,0
349530,True,5,Mixed,12,8,20
349540,True,5,Mixed,13,15,28
349550,True,5,Mixed,24,13,37
349560,True,0,No user reviews,0,0,0
349580,True,4,Mostly Negative,36,59,95
349620,True,0,No user reviews,0,0,0
349650,True,0,6 user reviews,4,2,6
349660,True,0,No user reviews,0,0,0
349670,True,0,9 user reviews,4,5,9
349680,True,8,Very Positive,69,5,74
349690,True,7,Positive,24,1,25
349700,True,5,Mixed,18,15,33
349710,True,0,1 user reviews,1,0,1
349720,True,0,8 user reviews,3,5,8
349730,True,8,Very Positive,257,42,299
349740,True,7,Positive,15,0,15
349750,True,0,6 user reviews,1,5,6
349760,True,7,Positive,25,1,26
349770,True,6,Mostly Positive,12,5,17
349780,True,0,2 user reviews,2,0,2
349790,True,5,Mixed,89,53,142
349800,True,0,No user reviews,0,0,0
349810,True,0,1 user reviews,1,0,1
349820,True,0,No user reviews,0,0,0
349830,True,5,Mixed,193,109,302
349840,True,4,Mostly Negative,4,8,12
349890,True,0,No user reviews,0,0,0
349930,True,0,No user reviews,0,0,0
349931,True,0,No user reviews,0,0,0
349932,True,0,No user reviews,0,0,0
349933,True,0,No user reviews,0,0,0
349934,True,0,1 user reviews,1,0,1
349935,True,0,4 user reviews,4,0,4
349936,True,0,No user reviews,0,0,0
349937,True,0,1 user reviews,1,0,1
349938,True,0,1 user reviews,1,0,1
349939,True,0,No user reviews,0,0,0
349940,True,0,2 user reviews,0,2,2
349941,True,0,No user reviews,0,0,0
349950,True,0,9 user reviews,7,2,9
349960,True,0,2 user reviews,2,0,2
349961,True,0,No user reviews,0,0,0
349970,True,0,No user reviews,0,0,0
349980,True,0,1 user reviews,0,1,1
349990,True,0,No user reviews,0,0,0
350000,True,0,6 user reviews,3,3,6
350010,True,5,Mixed,46,58,104
350020,True,0,1 user reviews,0,1,1
350050,True,0,No user reviews,0,0,0
350060,True,5,Mixed,8,4,12
350070,True,8,Very Positive,534,74,608
350080,True,8,Very Positive,3722,547,4269
350090,True,5,Mixed,5,5,10
350110,True,5,Mixed,66,85,151
350130,True,0,No user reviews,0,0,0
350140,True,0,No user reviews,0,0,0
350150,True,6,Mostly Positive,60,20,80
350200,True,4,Mostly Negative,13,38,51
350210,True,6,Mostly Positive,21,6,27
350220,True,2,Very Negative,16,74,90
350230,True,0,No user reviews,0,0,0
350260,True,0,No user reviews,0,0,0
350270,True,0,5 user reviews,4,1,5
350271,True,0,5 user reviews,4,1,5
350272,True,4,Mostly Negative,6,12,18
350280,True,6,Mostly Positive,2220,862,3082
350300,True,0,2 user reviews,2,0,2
350310,True,5,Mixed,120,60,180
350330,True,0,No user reviews,0,0,0
350380,True,3,Negative,6,32,38
350400,True,0,1 user reviews,1,0,1
350410,True,0,1 user reviews,1,0,1
350412,True,0,1 user reviews,0,1,1
350413,True,0,No user reviews,0,0,0
350414,True,0,3 user reviews,3,0,3
350415,True,0,No user reviews,0,0,0
350420,True,0,No user reviews,0,0,0
350430,True,0,No user reviews,0,0,0
350440,True,0,No user reviews,0,0,0
350450,True,0,No user reviews,0,0,0
350460,True,7,Positive,29,3,32
350480,True,6,Mostly Positive,14,6,20
350490,True,5,Mixed,8,12,20
350500,True,5,Mixed,43,52,95
350520,True,0,No user reviews,0,0,0
350530,True,4,Mostly Negative,15,29,44
350550,True,7,Positive,12,0,12
350560,True,0,No user reviews,0,0,0
350600,True,5,Mixed,52,31,83
350610,True,7,Positive,16,3,19
350620,True,7,Positive,24,5,29
350630,True,6,Mostly Positive,13,5,18
350640,True,6,Mostly Positive,930,293,1223
350660,True,0,1 user reviews,1,0,1
350680,True,0,1 user reviews,1,0,1
350690,True,6,Mostly Positive,29,8,37
350700,True,0,2 user reviews,0,2,2
350710,True,5,Mixed,15,8,23
350720,True,0,No user reviews,0,0,0
350730,True,0,No user reviews,0,0,0
350740,True,8,Very Positive,257,29,286
350770,True,5,Mixed,42,31,73
350780,True,8,Very Positive,74,12,86
350800,True,0,6 user reviews,1,5,6
350810,True,8,Very Positive,54,9,63
350820,True,0,No user reviews,0,0,0
350840,True,0,5 user reviews,1,4,5
350870,True,0,No user reviews,0,0,0
350880,True,7,Positive,12,2,14
350910,True,8,Very Positive,201,4,205
350970,True,8,Very Positive,58,7,65
350990,True,0,No user reviews,0,0,0
351020,True,0,No user reviews,0,0,0
351030,True,8,Very Positive,172,30,202
351040,True,5,Mixed,81,66,147
351050,True,5,Mixed,21,15,36
351060,True,4,Mostly Negative,9,25,34
351070,True,0,1 user reviews,1,0,1
351080,True,5,Mixed,28,13,41
351090,True,8,Very Positive,253,7,260
351100,True,5,Mixed,230,112,342
351140,True,0,6 user reviews,2,4,6
351150,True,5,Mixed,145,63,208
351170,True,0,6 user reviews,5,1,6
351220,True,0,8 user reviews,5,3,8
351230,True,8,Very Positive,77,11,88
351240,True,7,Positive,28,3,31
351250,True,8,Very Positive,52,4,56
351270,True,0,No user reviews,0,0,0
351280,True,0,No user reviews,0,0,0
351290,True,5,Mixed,1211,1312,2523
351300,True,5,Mixed,41,34,75
351320,True,7,Positive,12,2,14
351330,True,6,Mostly Positive,15,4,19
351340,True,6,Mostly Positive,170,68,238
351390,True,0,6 user reviews,5,1,6
351400,True,0,9 user reviews,7,2,9
351410,True,0,1 user reviews,1,0,1
351420,True,0,7 user reviews,5,2,7
351430,True,0,2 user reviews,1,1,2
351450,True,5,Mixed,18,15,33
351460,True,0,No user reviews,0,0,0
351461,True,0,8 user reviews,8,0,8
351462,True,0,No user reviews,0,0,0
351470,True,5,Mixed,32,18,50
351480,True,8,Very Positive,174,12,186
351490,True,6,Mostly Positive,282,75,357
351510,True,8,Very Positive,495,39,534
351540,True,0,No user reviews,0,0,0
351570,True,7,Positive,8,2,10
351590,True,0,7 user reviews,7,0,7
351591,True,0,9 user reviews,9,0,9
351630,True,0,1 user reviews,0,1,1
351640,True,8,Very Positive,80,2,82
351650,True,0,No user reviews,0,0,0
351660,True,0,No user reviews,0,0,0
351680,True,0,3 user reviews,3,0,3
351690,True,0,4 user reviews,4,0,4
351700,True,9,Overwhelmingly Positive,537,25,562
351710,True,8,Very Positive,1212,110,1322
351720,True,5,Mixed,7,6,13
351730,True,5,Mixed,39,19,58
351740,True,0,8 user reviews,6,2,8
351760,True,0,No user reviews,0,0,0
351770,True,0,No user reviews,0,0,0
351790,True,0,3 user reviews,3,0,3
351800,True,6,Mostly Positive,9,3,12
351810,True,7,Positive,9,1,10
351820,True,6,Mostly Positive,11,3,14
351840,True,0,No user reviews,0,0,0
351860,True,6,Mostly Positive,85,29,114
351870,True,6,Mostly Positive,58,16,74
351890,True,5,Mixed,165,238,403
351900,True,5,Mixed,105,81,186
351910,True,5,Mixed,92,84,176
351920,True,9,Overwhelmingly Positive,1344,62,1406
351930,True,0,1 user reviews,1,0,1
351940,True,6,Mostly Positive,151,57,208
351970,True,8,Very Positive,2321,538,2859
351980,True,0,No user reviews,0,0,0
351990,True,8,Very Positive,806,146,952
352000,True,8,Very Positive,84,21,105
352010,True,6,Mostly Positive,63,25,88
352021,True,0,No user reviews,0,0,0
352030,True,7,Positive,17,2,19
352050,True,6,Mostly Positive,9,3,12
352070,True,8,Very Positive,74,8,82
352080,True,6,Mostly Positive,10,3,13
352111,True,0,No user reviews,0,0,0
352120,True,4,Mostly Negative,5,8,13
352130,True,5,Mixed,15,12,27
352140,True,6,Mostly Positive,40,12,52
352150,True,4,Mostly Negative,4,7,11
352160,True,0,No user reviews,0,0,0
352170,True,4,Mostly Negative,8,13,21
352181,True,0,No user reviews,0,0,0
352182,True,0,7 user reviews,5,2,7
352183,True,0,4 user reviews,2,2,4
352184,True,5,Mixed,7,7,14
352185,True,0,2 user reviews,2,0,2
352186,True,7,Positive,9,2,11
352187,True,0,4 user reviews,3,1,4
352188,True,0,4 user reviews,1,3,4
352189,True,0,4 user reviews,2,2,4
352190,True,5,Mixed,13,6,19
352200,True,0,6 user reviews,2,4,6
352210,True,0,4 user reviews,2,2,4
352220,True,6,Mostly Positive,168,44,212
352230,True,7,Positive,12,0,12
352240,True,5,Mixed,60,38,98
352280,True,0,8 user reviews,2,6,8
352290,True,0,9 user reviews,8,1,9
352310,True,0,No user reviews,0,0,0
352336,True,0,No user reviews,0,0,0
352360,True,5,Mixed,9,6,15
352370,True,6,Mostly Positive,14,6,20
352390,True,0,No user reviews,0,0,0
352391,True,0,No user reviews,0,0,0
352400,True,8,Very Positive,1154,222,1376
352430,True,5,Mixed,73,46,119
352440,True,7,Positive,12,3,15
352450,True,0,No user reviews,0,0,0
352490,True,0,No user reviews,0,0,0
352520,True,8,Very Positive,2105,155,2260
352530,True,0,4 user reviews,2,2,4
352540,True,0,No user reviews,0,0,0
352550,True,4,Mostly Negative,202,512,714
352560,True,0,6 user reviews,4,2,6
352580,True,5,Mixed,14,13,27
352590,True,5,Mixed,10,5,15
352610,True,8,Very Positive,90,12,102
352620,True,7,Positive,20,2,22
352640,True,7,Positive,13,1,14
352680,True,0,No user reviews,0,0,0
352690,True,0,No user reviews,0,0,0
352700,True,0,3 user reviews,3,0,3
352710,True,0,7 user reviews,7,0,7
352720,True,8,Very Positive,1880,430,2310
352730,True,0,6 user reviews,4,2,6
352740,True,6,Mostly Positive,12,4,16
352750,True,0,3 user reviews,2,1,3
352760,True,5,Mixed,10,5,15
352780,True,8,Very Positive,155,33,188
352790,True,7,Positive,8,2,10
352810,True,6,Mostly Positive,8,3,11
352820,True,0,No user reviews,0,0,0
352830,True,0,No user reviews,0,0,0
352840,True,8,Very Positive,75,0,75
352850,True,0,5 user reviews,2,3,5
352870,True,0,No user reviews,0,0,0
352871,True,0,No user reviews,0,0,0
352872,True,0,No user reviews,0,0,0
352873,True,0,No user reviews,0,0,0
352874,True,0,No user reviews,0,0,0
352875,True,0,No user reviews,0,0,0
352890,True,5,Mixed,78,38,116
352900,True,0,7 user reviews,4,3,7
352920,True,0,No user reviews,0,0,0
352921,True,0,No user reviews,0,0,0
352922,True,0,No user reviews,0,0,0
352923,True,0,No user reviews,0,0,0
352924,True,0,No user reviews,0,0,0
352925,True,0,No user reviews,0,0,0
352926,True,0,No user reviews,0,0,0
352927,True,0,No user reviews,0,0,0
352928,True,0,No user reviews,0,0,0
352940,True,0,No user reviews,0,0,0
352941,True,0,No user reviews,0,0,0
352942,True,0,No user reviews,0,0,0
352943,True,0,No user reviews,0,0,0
352944,True,0,No user reviews,0,0,0
352950,True,4,Mostly Negative,66,154,220
352960,True,4,Mostly Negative,13,21,34
352980,True,0,2 user reviews,1,1,2
352990,True,0,2 user reviews,0,2,2
352991,True,0,8 user reviews,6,2,8
353000,True,0,2 user reviews,2,0,2
353020,True,0,No user reviews,0,0,0
353050,True,7,Positive,13,2,15
353051,True,0,6 user reviews,2,4,6
353052,True,0,5 user reviews,3,2,5
353053,True,0,7 user reviews,5,2,7
353060,True,0,2 user reviews,0,2,2
353070,True,5,Mixed,33,29,62
353080,True,0,7 user reviews,6,1,7
353090,True,8,Very Positive,272,9,281
353110,True,6,Mostly Positive,13,4,17
353120,True,0,No user reviews,0,0,0
353130,True,5,Mixed,5,5,10
353140,True,0,9 user reviews,5,4,9
353190,True,5,Mixed,61,35,96
353220,True,0,6 user reviews,2,4,6
353240,True,0,No user reviews,0,0,0
353250,True,0,No user reviews,0,0,0
353251,True,0,No user reviews,0,0,0
353252,True,0,No user reviews,0,0,0
353260,True,0,1 user reviews,1,0,1
353270,True,9,Overwhelmingly Positive,1267,57,1324
353280,True,7,Positive,32,2,34
353300,True,0,5 user reviews,2,3,5
353310,True,0,No user reviews,0,0,0
353311,True,0,No user reviews,0,0,0
353320,True,0,No user reviews,0,0,0
353330,True,8,Very Positive,439,29,468
353340,True,6,Mostly Positive,15,4,19
353350,True,0,No user reviews,0,0,0
353360,True,7,Positive,11,1,12
353370,True,6,Mostly Positive,5186,1810,6996
353380,True,6,Mostly Positive,2817,1039,3856
353390,True,0,7 user reviews,6,1,7
353400,True,0,No user reviews,0,0,0
353410,True,0,No user reviews,0,0,0
353420,True,0,No user reviews,0,0,0
353430,True,0,No user reviews,0,0,0
353440,True,0,No user reviews,0,0,0
353450,True,0,No user reviews,0,0,0
353460,True,0,No user reviews,0,0,0
353470,True,0,No user reviews,0,0,0
353480,True,0,No user reviews,0,0,0
353490,True,0,No user reviews,0,0,0
353500,True,0,No user reviews,0,0,0
353510,True,0,No user reviews,0,0,0
353520,True,0,No user reviews,0,0,0
353530,True,0,No user reviews,0,0,0
353540,True,8,Very Positive,401,14,415
353550,True,5,Mixed,118,74,192
353560,True,8,Very Positive,1540,279,1819
353570,True,0,3 user reviews,3,0,3
353571,True,0,4 user reviews,4,0,4
353580,True,7,Positive,28,7,35
353590,True,0,No user reviews,0,0,0
353600,True,0,5 user reviews,2,3,5
353610,True,5,Mixed,8,9,17
353620,True,0,8 user reviews,3,5,8
353630,True,5,Mixed,18,27,45
353640,True,8,Very Positive,816,117,933
353700,True,8,Very Positive,429,47,476
353740,True,0,No user reviews,0,0,0
353741,True,0,No user reviews,0,0,0
353742,True,0,No user reviews,0,0,0
353760,True,0,7 user reviews,5,2,7
353761,True,0,5 user reviews,4,1,5
353770,True,0,3 user reviews,1,2,3
353790,True,0,8 user reviews,8,0,8
353820,True,7,Positive,12,1,13
353830,True,6,Mostly Positive,255,92,347
353850,True,0,2 user reviews,2,0,2
353860,True,0,No user reviews,0,0,0
353870,True,0,No user reviews,0,0,0
353890,True,6,Mostly Positive,40,13,53
353930,True,0,No user reviews,0,0,0
353940,True,5,Mixed,6,6,12
353970,True,0,6 user reviews,4,2,6
353980,True,5,Mixed,18,9,27
353990,True,5,Mixed,6,4,10
354020,True,0,2 user reviews,2,0,2
354030,True,0,7 user reviews,6,1,7
354040,True,0,1 user reviews,1,0,1
354050,True,5,Mixed,11,9,20
354060,True,0,No user reviews,0,0,0
354110,True,0,No user reviews,0,0,0
354140,True,8,Very Positive,3161,468,3629
354160,True,5,Mixed,43,51,94
354170,True,0,1 user reviews,0,1,1
354171,True,0,No user reviews,0,0,0
354180,True,5,Mixed,10,7,17
354190,True,0,No user reviews,0,0,0
354200,True,4,Mostly Negative,3,7,10
354230,True,5,Mixed,15,9,24
354240,True,8,Very Positive,1298,226,1524
354270,True,0,1 user reviews,1,0,1
354280,True,0,7 user reviews,5,2,7
354290,True,0,7 user reviews,5,2,7
354300,True,0,No user reviews,0,0,0
354310,True,7,Positive,17,1,18
354320,True,0,No user reviews,0,0,0
354330,True,6,Mostly Positive,98,34,132
354331,True,5,Mixed,14,13,27
354350,True,0,8 user reviews,8,0,8
354380,True,5,Mixed,470,207,677
354390,True,0,No user reviews,0,0,0
354400,True,8,Very Positive,174,8,182
354413,True,0,No user reviews,0,0,0
354430,True,6,Mostly Positive,112,45,157
354461,True,0,1 user reviews,1,0,1
354462,True,0,1 user reviews,1,0,1
354463,True,0,1 user reviews,1,0,1
354464,True,0,4 user reviews,4,0,4
354465,True,0,3 user reviews,3,0,3
354466,True,0,2 user reviews,2,0,2
354467,True,7,Positive,10,1,11
354468,True,5,Mixed,14,13,27
354469,True,0,1 user reviews,1,0,1
354480,True,0,No user reviews,0,0,0
354500,True,0,2 user reviews,1,1,2
354510,True,0,No user reviews,0,0,0
354520,True,0,1 user reviews,1,0,1
354530,True,0,No user reviews,0,0,0
354540,True,0,No user reviews,0,0,0
354550,True,0,No user reviews,0,0,0
354560,True,5,Mixed,8,5,13
354570,True,0,No user reviews,0,0,0
354600,True,7,Positive,17,2,19
354620,True,7,Positive,40,8,48
354640,True,4,Mostly Negative,4,7,11
354650,True,8,Very Positive,202,34,236
354680,True,8,Very Positive,215,29,244
354690,True,0,5 user reviews,1,4,5
354700,True,0,3 user reviews,1,2,3
354701,True,0,3 user reviews,2,1,3
354702,True,0,2 user reviews,1,1,2
354720,True,5,Mixed,11,6,17
354730,True,5,Mixed,12,17,29
354740,True,8,Very Positive,71,11,82
354770,True,0,8 user reviews,6,2,8
354780,True,0,No user reviews,0,0,0
354810,True,0,4 user reviews,1,3,4
354820,True,3,Negative,1,14,15
354830,True,8,Very Positive,3722,547,4269
354860,True,6,Mostly Positive,27,10,37
354890,True,0,No user reviews,0,0,0
354900,True,0,3 user reviews,3,0,3
354920,True,5,Mixed,8,6,14
354930,True,0,3 user reviews,2,1,3
354940,True,0,No user reviews,0,0,0
354950,True,5,Mixed,12,8,20
354960,True,5,Mixed,7,5,12
354970,True,5,Mixed,21,13,34
355000,True,0,7 user reviews,4,3,7
355010,True,5,Mixed,19,14,33
355020,True,0,1 user reviews,0,1,1
355030,True,6,Mostly Positive,14,6,20
355050,True,8,Very Positive,472,58,530
355060,True,5,Mixed,73,77,150
355070,True,0,No user reviews,0,0,0
355080,True,0,6 user reviews,3,3,6
355090,True,0,No user reviews,0,0,0
355100,True,5,Mixed,12,8,20
355120,True,0,6 user reviews,1,5,6
355130,True,6,Mostly Positive,105,45,150
355140,True,7,Positive,10,2,12
355150,True,5,Mixed,161,183,344
355170,True,8,Very Positive,138,6,144
355180,True,8,Very Positive,132,22,154
355190,True,5,Mixed,11,7,18
355200,True,0,No user reviews,0,0,0
355201,True,0,No user reviews,0,0,0
355202,True,0,No user reviews,0,0,0
355203,True,0,1 user reviews,0,1,1
355204,True,0,No user reviews,0,0,0
355205,True,0,No user reviews,0,0,0
355206,True,0,No user reviews,0,0,0
355207,True,0,No user reviews,0,0,0
355208,True,0,No user reviews,0,0,0
355209,True,0,No user reviews,0,0,0
355210,True,0,No user reviews,0,0,0
355230,True,7,Positive,13,3,16
355240,True,8,Very Positive,125,25,150
355250,True,8,Very Positive,219,53,272
355260,True,0,1 user reviews,0,1,1
355262,True,0,No user reviews,0,0,0
355270,True,8,Very Positive,121,11,132
355280,True,0,5 user reviews,5,0,5
355290,True,0,No user reviews,0,0,0
355300,True,0,1 user reviews,1,0,1
355310,True,6,Mostly Positive,15,4,19
355320,True,0,No user reviews,0,0,0
355340,True,5,Mixed,8,6,14
355341,True,5,Mixed,11,7,18
355350,True,7,Positive,23,5,28
355360,True,0,8 user reviews,7,1,8
355370,True,6,Mostly Positive,11,3,14
355380,True,0,2 user reviews,0,2,2
355400,True,5,Mixed,69,31,100
355410,True,8,Very Positive,45,8,53
355420,True,8,Very Positive,67,5,72
355430,True,5,Mixed,9,8,17
355440,True,0,1 user reviews,1,0,1
355450,True,0,1 user reviews,1,0,1
355460,True,5,Mixed,11,13,24
355490,True,5,Mixed,9,6,15
355500,True,0,1 user reviews,1,0,1
355510,True,0,2 user reviews,1,1,2
355520,True,8,Very Positive,113,20,133
355530,True,8,Very Positive,143,24,167
355550,True,0,No user reviews,0,0,0
355560,True,7,Positive,11,2,13
355570,True,7,Positive,15,1,16
355630,True,8,Very Positive,82,8,90
355640,True,0,4 user reviews,3,1,4
355641,True,7,Positive,13,2,15
355650,True,0,5 user reviews,4,1,5
355660,True,0,No user reviews,0,0,0
355670,True,0,2 user reviews,2,0,2
355680,True,6,Mostly Positive,99,42,141
355690,True,7,Positive,11,2,13
355730,True,7,Positive,16,1,17
355740,True,7,Positive,30,6,36
355750,True,0,No user reviews,0,0,0
355760,True,5,Mixed,115,114,229
355770,True,0,1 user reviews,0,1,1
355790,True,8,Very Positive,825,180,1005
355800,True,6,Mostly Positive,276,115,391
355810,True,5,Mixed,6,6,12
355820,True,7,Positive,36,2,38
355830,True,0,No user reviews,0,0,0
355840,True,5,Mixed,71,47,118
355860,True,6,Mostly Positive,152,58,210
355870,True,0,No user reviews,0,0,0
355880,True,9,Overwhelmingly Positive,1145,13,1158
355900,True,0,7 user reviews,5,2,7
355910,True,5,Mixed,7,4,11
355920,True,7,Positive,27,3,30
355950,True,8,Very Positive,249,62,311
355960,True,4,Mostly Negative,237,430,667
355970,True,6,Mostly Positive,194,71,265
355980,True,9,Overwhelmingly Positive,622,30,652
355990,True,0,No user reviews,0,0,0
356000,True,6,Mostly Positive,67,20,87
356010,True,0,No user reviews,0,0,0
356030,True,0,7 user reviews,4,3,7
356040,True,6,Mostly Positive,1475,493,1968
356050,True,6,Mostly Positive,248,100,348
356070,True,0,6 user reviews,3,3,6
356090,True,7,Positive,16,1,17
356100,True,6,Mostly Positive,11,4,15
356110,True,0,3 user reviews,3,0,3
356120,True,0,No user reviews,0,0,0
356121,True,0,No user reviews,0,0,0
356122,True,0,No user reviews,0,0,0
356123,True,0,No user reviews,0,0,0
356124,True,0,No user reviews,0,0,0
356130,True,0,3 user reviews,2,1,3
356140,True,0,1 user reviews,1,0,1
356160,True,4,Mostly Negative,6,14,20
356170,True,0,3 user reviews,1,2,3
356180,True,5,Mixed,51,25,76
356190,True,8,Very Positive,11930,2231,14161
356200,True,6,Mostly Positive,22,6,28
356210,True,0,9 user reviews,4,5,9
356230,True,0,3 user reviews,3,0,3
356231,True,0,3 user reviews,3,0,3
356240,True,7,Positive,9,1,10
356250,True,8,Very Positive,80,8,88
356260,True,8,Very Positive,66,16,82
356270,True,5,Mixed,39,19,58
356280,True,5,Mixed,6,9,15
356290,True,5,Mixed,9,6,15
356310,True,0,6 user reviews,4,2,6
356350,True,0,No user reviews,0,0,0
356370,True,0,No user reviews,0,0,0
356380,True,5,Mixed,27,13,40
356390,True,8,Very Positive,47,11,58
356400,True,8,Very Positive,1813,143,1956
356410,True,0,3 user reviews,3,0,3
356420,True,8,Very Positive,97,14,111
356430,True,8,Very Positive,180,38,218
356440,True,7,Positive,11,1,12
356450,True,6,Mostly Positive,52,18,70
356460,True,6,Mostly Positive,11,3,14
356500,True,8,Very Positive,1108,118,1226
356510,True,4,Mostly Negative,10,23,33
356520,True,7,Positive,11,0,11
356530,True,8,Very Positive,111,13,124
356540,True,7,Positive,9,2,11
356550,True,7,Positive,10,2,12
356560,True,7,Positive,12,1,13
356570,True,8,Very Positive,1994,346,2340
356580,True,5,Mixed,40,22,62
356630,True,0,2 user reviews,2,0,2
356640,True,0,No user reviews,0,0,0
356650,True,6,Mostly Positive,837,302,1139
356670,True,8,Very Positive,82,2,84
356710,True,0,2 user reviews,2,0,2
356730,True,0,4 user reviews,3,1,4
356740,True,0,No user reviews,0,0,0
356741,True,0,2 user reviews,2,0,2
356742,True,0,No user reviews,0,0,0
356743,True,0,No user reviews,0,0,0
356744,True,0,1 user reviews,1,0,1
356750,True,0,7 user reviews,6,1,7
356751,True,0,2 user reviews,2,0,2
356770,True,5,Mixed,22,14,36
356780,True,0,No user reviews,0,0,0
356790,True,7,Positive,21,4,25
356800,True,5,Mixed,8,10,18
356810,True,0,No user reviews,0,0,0
356820,True,0,1 user reviews,1,0,1
356831,True,8,Very Positive,107,2,109
356860,True,0,No user reviews,0,0,0
356870,True,0,5 user reviews,1,4,5
356880,True,5,Mixed,64,39,103
356890,True,5,Mixed,55,31,86
356910,True,6,Mostly Positive,52,19,71
356960,True,5,Mixed,34,31,65
356970,True,0,1 user reviews,1,0,1
357030,True,0,7 user reviews,2,5,7
357040,True,0,2 user reviews,1,1,2
357060,True,0,No user reviews,0,0,0
357070,True,8,Very Positive,825,98,923
357080,True,0,No user reviews,0,0,0
357090,True,0,No user reviews,0,0,0
357100,True,0,No user reviews,0,0,0
357110,True,0,2 user reviews,1,1,2
357120,True,6,Mostly Positive,42,17,59
357160,True,0,No user reviews,0,0,0
357161,True,0,No user reviews,0,0,0
357162,True,0,No user reviews,0,0,0
357163,True,0,3 user reviews,1,2,3
357170,True,0,No user reviews,0,0,0
357171,True,0,No user reviews,0,0,0
357180,True,7,Positive,16,1,17
357190,True,8,Very Positive,1237,137,1374
357200,True,0,5 user reviews,2,3,5
357210,True,0,No user reviews,0,0,0
357240,True,0,No user reviews,0,0,0
357250,True,0,No user reviews,0,0,0
357260,True,0,1 user reviews,1,0,1
357261,True,0,1 user reviews,1,0,1
357262,True,0,1 user reviews,1,0,1
357280,True,6,Mostly Positive,22,8,30
357290,True,4,Mostly Negative,69,105,174
357300,True,8,Very Positive,417,21,438
357310,True,6,Mostly Positive,465,175,640
357320,True,5,Mixed,19,15,34
357330,True,8,Very Positive,608,43,651
357340,True,8,Very Positive,159,26,185
357350,True,0,2 user reviews,2,0,2
357360,True,7,Positive,40,8,48
357370,True,5,Mixed,18,14,32
357380,True,8,Very Positive,318,78,396
357400,True,7,Positive,23,1,24
357410,True,8,Very Positive,71,0,71
357440,True,0,No user reviews,0,0,0
357450,True,0,No user reviews,0,0,0
357460,True,5,Mixed,42,19,61
357470,True,0,4 user reviews,4,0,4
357480,True,7,Positive,10,2,12
357490,True,7,Positive,9,1,10
357500,True,5,Mixed,9,9,18
357600,True,8,Very Positive,74,4,78
357650,True,5,Mixed,66,34,100
357670,True,6,Mostly Positive,112,48,160
357690,True,5,Mixed,11,7,18
357700,True,0,8 user reviews,6,2,8
357710,True,0,2 user reviews,2,0,2
357711,True,0,2 user reviews,2,0,2
357720,True,8,Very Positive,73,15,88
357730,True,5,Mixed,7,4,11
357750,True,7,Positive,14,1,15
357760,True,5,Mixed,72,71,143
357780,True,6,Mostly Positive,174,54,228
357790,True,0,No user reviews,0,0,0
357800,True,0,6 user reviews,6,0,6
357820,True,0,4 user reviews,1,3,4
357830,True,6,Mostly Positive,14,5,19
357840,True,5,Mixed,12,10,22
357850,True,7,Positive,24,2,26
357890,True,7,Positive,23,4,27
357900,True,5,Mixed,74,101,175
357910,True,4,Mostly Negative,4,8,12
357920,True,4,Mostly Negative,7,17,24
357930,True,0,7 user reviews,4,3,7
357940,True,6,Mostly Positive,45,15,60
357970,True,0,No user reviews,0,0,0
357980,True,0,No user reviews,0,0,0
358000,True,5,Mixed,10,9,19
358010,True,0,1 user reviews,1,0,1
358020,True,7,Positive,22,1,23
358030,True,7,Positive,26,2,28
358070,True,8,Very Positive,103,9,112
358080,True,0,6 user reviews,3,3,6
358090,True,8,Very Positive,751,170,921
358110,True,0,No user reviews,0,0,0
358120,True,0,7 user reviews,6,1,7
358130,True,8,Very Positive,847,125,972
358140,True,6,Mostly Positive,13,4,17
358141,True,7,Positive,14,1,15
358142,True,7,Positive,25,2,27
358143,True,0,3 user reviews,3,0,3
358144,True,0,7 user reviews,4,3,7
358150,True,8,Very Positive,475,78,553
358170,True,6,Mostly Positive,8,3,11
358180,True,7,Positive,20,1,21
358190,True,7,Positive,27,2,29
358200,True,7,Positive,12,1,13
358210,True,7,Positive,20,0,20
358220,True,7,Positive,12,1,13
358230,True,0,9 user reviews,9,0,9
358240,True,0,4 user reviews,3,1,4
358250,True,7,Positive,44,2,46
358260,True,7,Positive,42,2,44
358270,True,8,Very Positive,78,2,80
358280,True,7,Positive,13,1,14
358290,True,7,Positive,33,6,39
358300,True,6,Mostly Positive,8,3,11
358310,True,7,Positive,12,1,13
358320,True,0,6 user reviews,6,0,6
358330,True,0,8 user reviews,4,4,8
358340,True,7,Positive,21,2,23
358350,True,7,Positive,29,3,32
358360,True,8,Very Positive,58,5,63
358370,True,7,Positive,23,2,25
358380,True,7,Positive,37,5,42
358390,True,0,7 user reviews,7,0,7
358400,True,0,3 user reviews,2,1,3
358410,True,7,Positive,29,4,33
358420,True,0,8 user reviews,3,5,8
358430,True,0,7 user reviews,6,1,7
358440,True,0,4 user reviews,3,1,4
358470,True,8,Very Positive,427,20,447
358480,True,0,8 user reviews,2,6,8
358620,True,0,No user reviews,0,0,0
358640,True,0,No user reviews,0,0,0
358650,True,7,Positive,31,3,34
358700,True,4,Mostly Negative,3,9,12
358720,True,0,No user reviews,0,0,0
358750,True,8,Very Positive,308,62,370
358760,True,6,Mostly Positive,8,3,11
358770,True,8,Very Positive,97,13,110
358780,True,0,No user reviews,0,0,0
358800,True,7,Positive,8,2,10
358810,True,8,Very Positive,40,10,50
358820,True,0,2 user reviews,1,1,2
358830,True,8,Very Positive,116,11,127
358840,True,0,7 user reviews,3,4,7
358850,True,0,6 user reviews,4,2,6
358870,True,0,No user reviews,0,0,0
358880,True,0,2 user reviews,2,0,2
358910,True,0,No user reviews,0,0,0
358920,True,6,Mostly Positive,42,13,55
358930,True,5,Mixed,7,7,14
358950,True,0,No user reviews,0,0,0
358960,True,8,Very Positive,75,6,81
358970,True,0,No user reviews,0,0,0
358986,True,0,No user reviews,0,0,0
359000,True,0,No user reviews,0,0,0
359001,True,0,No user reviews,0,0,0
359040,True,8,Very Positive,171,18,189
359050,True,9,Overwhelmingly Positive,4114,178,4292
359060,True,4,Mostly Negative,4,9,13
359070,True,4,Mostly Negative,4,7,11
359080,True,0,No user reviews,0,0,0
359090,True,0,2 user reviews,2,0,2
359100,True,8,Very Positive,274,68,342
359110,True,0,1 user reviews,1,0,1
359120,True,0,No user reviews,0,0,0
359130,True,0,1 user reviews,1,0,1
359140,True,8,Very Positive,90,6,96
359160,True,4,Mostly Negative,4,13,17
359180,True,0,3 user reviews,3,0,3
359190,True,7,Positive,10,2,12
359220,True,5,Mixed,170,75,245
359230,True,5,Mixed,292,167,459
359250,True,5,Mixed,10,5,15
359260,True,0,4 user reviews,2,2,4
359280,True,6,Mostly Positive,15,6,21
359290,True,4,Mostly Negative,6,11,17
359300,True,0,4 user reviews,2,2,4
359310,True,8,Very Positive,729,126,855
359320,True,6,Mostly Positive,21576,7132,28708
359340,True,5,Mixed,8,4,12
359350,True,8,Very Positive,182,23,205
359370,True,5,Mixed,16,24,40
359380,True,0,2 user reviews,2,0,2
359390,True,8,Very Positive,1302,104,1406
359400,True,8,Very Positive,248,9,257
359410,True,8,Very Positive,95,18,113
359420,True,7,Positive,28,0,28
359440,True,6,Mostly Positive,65,27,92
359480,True,8,Very Positive,152,22,174
359490,True,0,5 user reviews,4,1,5
359491,True,7,Positive,15,0,15
359492,True,0,1 user reviews,1,0,1
359493,True,0,3 user reviews,3,0,3
359494,True,0,1 user reviews,1,0,1
359495,True,0,6 user reviews,6,0,6
359496,True,7,Positive,11,1,12
359497,True,0,3 user reviews,3,0,3
359498,True,0,No user reviews,0,0,0
359500,True,0,No user reviews,0,0,0
359510,True,8,Very Positive,418,12,430
359520,True,0,4 user reviews,3,1,4
359521,True,0,5 user reviews,5,0,5
359522,True,0,2 user reviews,2,0,2
359530,True,0,No user reviews,0,0,0
359540,True,0,No user reviews,0,0,0
359550,True,8,Very Positive,258326,28588,286914
359560,True,6,Mostly Positive,70,18,88
359570,True,0,8 user reviews,7,1,8
359580,True,5,Mixed,106,70,176
359600,True,5,Mixed,72,75,147
359610,True,5,Mixed,109,72,181
359620,True,5,Mixed,9,7,16
359630,True,5,Mixed,26,12,38
359650,True,8,Very Positive,66,6,72
359670,True,6,Mostly Positive,7,3,10
359680,True,0,No user reviews,0,0,0
359690,True,0,No user reviews,0,0,0
359700,True,0,No user reviews,0,0,0
359710,True,0,No user reviews,0,0,0
359720,True,0,No user reviews,0,0,0
359730,True,0,No user reviews,0,0,0
359740,True,0,No user reviews,0,0,0
359750,True,0,No user reviews,0,0,0
359760,True,0,4 user reviews,4,0,4
359780,True,7,Positive,9,1,10
359781,True,0,9 user reviews,8,1,9
359790,True,0,7 user reviews,7,0,7
359800,True,0,6 user reviews,3,3,6
359810,True,5,Mixed,49,48,97
359840,True,8,Very Positive,101,13,114
359850,True,0,4 user reviews,3,1,4
359860,True,0,1 user reviews,1,0,1
359870,True,8,Very Positive,4464,451,4915
359890,True,0,No user reviews,0,0,0
359900,True,5,Mixed,198,159,357
359920,True,6,Mostly Positive,90,33,123
359930,True,8,Very Positive,83,9,92
359940,True,5,Mixed,57,26,83
359950,True,0,No user reviews,0,0,0
359960,True,8,Very Positive,57,6,63
359970,True,0,8 user reviews,8,0,8
359980,True,0,No user reviews,0,0,0
360010,True,7,Positive,14,2,16
360020,True,0,5 user reviews,4,1,5
360030,True,6,Mostly Positive,12,4,16
360040,True,0,8 user reviews,5,3,8
360070,True,0,5 user reviews,3,2,5
360080,True,6,Mostly Positive,11,4,15
360090,True,6,Mostly Positive,12,4,16
360091,True,0,No user reviews,0,0,0
360092,True,0,No user reviews,0,0,0
360093,True,0,No user reviews,0,0,0
360094,True,0,No user reviews,0,0,0
360095,True,0,No user reviews,0,0,0
360096,True,0,No user reviews,0,0,0
360097,True,0,No user reviews,0,0,0
360098,True,0,No user reviews,0,0,0
360099,True,0,No user reviews,0,0,0
360110,True,0,No user reviews,0,0,0
360111,True,0,No user reviews,0,0,0
360112,True,0,No user reviews,0,0,0
360113,True,0,No user reviews,0,0,0
360114,True,0,5 user reviews,4,1,5
360115,True,0,6 user reviews,5,1,6
360120,True,0,No user reviews,0,0,0
360140,True,0,2 user reviews,2,0,2
360150,True,5,Mixed,180,171,351
360170,True,5,Mixed,1142,559,1701
360230,True,0,No user reviews,0,0,0
360240,True,0,4 user reviews,4,0,4
360250,True,0,No user reviews,0,0,0
360270,True,5,Mixed,22,19,41
360280,True,7,Positive,15,3,18
360290,True,0,4 user reviews,3,1,4
360340,True,7,Positive,9,1,10
360350,True,6,Mostly Positive,13,5,18
360360,True,0,No user reviews,0,0,0
360380,True,5,Mixed,133,111,244
360390,True,5,Mixed,23,23,46
360420,True,0,No user reviews,0,0,0
360421,True,0,No user reviews,0,0,0
360422,True,0,No user reviews,0,0,0
360423,True,0,No user reviews,0,0,0
360424,True,0,No user reviews,0,0,0
360425,True,0,No user reviews,0,0,0
360426,True,0,No user reviews,0,0,0
360427,True,0,No user reviews,0,0,0
360428,True,0,No user reviews,0,0,0
360430,True,5,Mixed,4621,3618,8239
360450,True,6,Mostly Positive,51,14,65
360480,True,0,7 user reviews,7,0,7
360510,True,5,Mixed,93,139,232
360520,True,7,Positive,9,2,11
360530,True,7,Positive,15,0,15
360550,True,8,Very Positive,93,18,111
360560,True,0,No user reviews,0,0,0
360580,True,5,Mixed,4,6,10
360590,True,3,Negative,1,10,11
360600,True,6,Mostly Positive,11,4,15
360610,True,5,Mixed,9,11,20
360620,True,8,Very Positive,59,10,69
360640,True,8,Very Positive,454,56,510
360650,True,8,Very Positive,190,43,233
360680,True,0,2 user reviews,1,1,2
360700,True,0,No user reviews,0,0,0
360720,True,0,4 user reviews,2,2,4
360730,True,6,Mostly Positive,30,11,41
360740,True,9,Overwhelmingly Positive,3309,91,3400
360750,True,0,9 user reviews,4,5,9
360770,True,0,1 user reviews,0,1,1
360820,True,7,Positive,18,2,20
360830,True,6,Mostly Positive,1105,327,1432
360840,True,7,Positive,34,5,39
360850,True,7,Positive,23,2,25
360870,True,0,7 user reviews,4,3,7
360880,True,5,Mixed,6,5,11
360890,True,4,Mostly Negative,20,46,66
360920,True,0,No user reviews,0,0,0
360930,True,0,No user reviews,0,0,0
360931,True,0,No user reviews,0,0,0
360940,True,8,Very Positive,2850,642,3492
360960,True,9,Overwhelmingly Positive,1093,50,1143
360970,True,5,Mixed,17,9,26
360990,True,0,2 user reviews,1,1,2
361020,True,7,Positive,20,1,21
361040,True,8,Very Positive,153,16,169
361060,True,0,No user reviews,0,0,0
361070,True,0,No user reviews,0,0,0
361100,True,0,9 user reviews,9,0,9
361110,True,0,6 user reviews,4,2,6
361130,True,5,Mixed,16,13,29
361160,True,0,2 user reviews,2,0,2
361180,True,0,5 user reviews,3,2,5
361181,True,5,Mixed,6,7,13
361182,True,0,1 user reviews,1,0,1
361183,True,5,Mixed,8,4,12
361190,True,5,Mixed,72,66,138
361200,True,4,Mostly Negative,5,20,25
361210,True,0,1 user reviews,1,0,1
361220,True,0,6 user reviews,6,0,6
361230,True,8,Very Positive,106,6,112
361240,True,0,No user reviews,0,0,0
361250,True,0,No user reviews,0,0,0
361270,True,0,No user reviews,0,0,0
361280,True,8,Very Positive,2194,210,2404
361290,True,6,Mostly Positive,74,25,99
361300,True,8,Very Positive,922,177,1099
361310,True,7,Positive,21,2,23
361312,True,0,3 user reviews,3,0,3
361313,True,0,3 user reviews,2,1,3
361314,True,0,7 user reviews,6,1,7
361320,True,6,Mostly Positive,57,16,73
361330,True,4,Mostly Negative,5,17,22
361340,True,0,No user reviews,0,0,0
361350,True,8,Very Positive,40,10,50
361360,True,8,Very Positive,83,10,93
361380,True,6,Mostly Positive,54,20,74
361420,True,8,Very Positive,24217,2750,26967
361430,True,5,Mixed,13,7,20
361440,True,0,5 user reviews,5,0,5
361470,True,0,2 user reviews,1,1,2
361480,True,0,No user reviews,0,0,0
361481,True,0,No user reviews,0,0,0
361482,True,0,No user reviews,0,0,0
361483,True,0,No user reviews,0,0,0
361484,True,0,No user reviews,0,0,0
361485,True,0,No user reviews,0,0,0
361490,True,0,No user reviews,0,0,0
361491,True,0,No user reviews,0,0,0
361492,True,0,No user reviews,0,0,0
361493,True,0,No user reviews,0,0,0
361494,True,0,No user reviews,0,0,0
361495,True,0,No user reviews,0,0,0
361500,True,0,1 user reviews,1,0,1
361520,True,0,No user reviews,0,0,0
361530,True,0,No user reviews,0,0,0
361540,True,0,No user reviews,0,0,0
361541,True,0,No user reviews,0,0,0
361542,True,0,No user reviews,0,0,0
361550,True,5,Mixed,481,288,769
361560,True,0,6 user reviews,1,5,6
361570,True,0,No user reviews,0,0,0
361571,True,0,No user reviews,0,0,0
361580,True,0,No user reviews,0,0,0
361600,True,7,Positive,10,1,11
361620,True,5,Mixed,5,5,10
361630,True,0,5 user reviews,3,2,5
361670,True,8,Very Positive,145,31,176
361680,True,0,2 user reviews,2,0,2
361690,True,6,Mostly Positive,90,25,115
361700,True,0,3 user reviews,3,0,3
361710,True,0,No user reviews,0,0,0
361720,True,0,No user reviews,0,0,0
361730,True,0,No user reviews,0,0,0
361740,True,0,No user reviews,0,0,0
361750,True,0,No user reviews,0,0,0
361760,True,0,No user reviews,0,0,0
361770,True,0,No user reviews,0,0,0
361780,True,0,1 user reviews,1,0,1
361790,True,0,5 user reviews,3,2,5
361800,True,5,Mixed,1188,704,1892
361820,True,8,Very Positive,64,10,74
361830,True,8,Very Positive,40,10,50
361840,True,6,Mostly Positive,38,12,50
361841,True,7,Positive,35,2,37
361842,True,7,Positive,30,2,32
361843,True,8,Very Positive,53,9,62
361850,True,8,Very Positive,74,8,82
361870,True,0,No user reviews,0,0,0
361880,True,0,4 user reviews,3,1,4
361890,True,5,Mixed,12,16,28
361930,True,6,Mostly Positive,9,3,12
361950,True,6,Mostly Positive,18,5,23
361970,True,5,Mixed,5,5,10
361990,True,8,Very Positive,522,37,559
362000,True,0,No user reviews,0,0,0
362001,True,0,No user reviews,0,0,0
362002,True,0,No user reviews,0,0,0
362003,True,0,3 user reviews,3,0,3
362010,True,0,2 user reviews,2,0,2
362020,True,0,9 user reviews,7,2,9
362030,True,0,2 user reviews,2,0,2
362040,True,0,No user reviews,0,0,0
362050,True,0,1 user reviews,1,0,1
362060,True,0,No user reviews,0,0,0
362070,True,0,2 user reviews,2,0,2
362090,True,8,Very Positive,130,18,148
362100,True,0,1 user reviews,1,0,1
362110,True,0,6 user reviews,5,1,6
362120,True,0,1 user reviews,1,0,1
362130,True,7,Positive,21,5,26
362140,True,0,8 user reviews,2,6,8
362150,True,0,5 user reviews,4,1,5
362160,True,7,Positive,9,1,10
362170,True,0,No user reviews,0,0,0
362180,True,0,No user reviews,0,0,0
362190,True,0,No user reviews,0,0,0
362200,True,0,No user reviews,0,0,0
362210,True,0,No user reviews,0,0,0
362220,True,0,No user reviews,0,0,0
362230,True,0,No user reviews,0,0,0
362240,True,0,No user reviews,0,0,0
362250,True,0,No user reviews,0,0,0
362260,True,0,No user reviews,0,0,0
362270,True,0,No user reviews,0,0,0
362280,True,0,1 user reviews,1,0,1
362290,True,5,Mixed,13,6,19
362300,True,5,Mixed,78,42,120
362310,True,6,Mostly Positive,24,7,31
362320,True,0,3 user reviews,2,1,3
362340,True,0,No user reviews,0,0,0
362350,True,5,Mixed,127,92,219
362360,True,0,5 user reviews,2,3,5
362370,True,0,3 user reviews,1,2,3
362380,True,7,Positive,17,2,19
362400,True,0,2 user reviews,1,1,2
362410,True,5,Mixed,43,28,71
362420,True,0,No user reviews,0,0,0
362440,True,0,No user reviews,0,0,0
362460,True,0,No user reviews,0,0,0
362490,True,8,Very Positive,3529,821,4350
362500,True,0,1 user reviews,1,0,1
362520,True,0,No user reviews,0,0,0
362530,True,0,1 user reviews,1,0,1
362540,True,0,No user reviews,0,0,0
362550,True,0,No user reviews,0,0,0
362560,True,0,1 user reviews,1,0,1
362570,True,0,No user reviews,0,0,0
362580,True,0,1 user reviews,1,0,1
362590,True,0,No user reviews,0,0,0
362600,True,0,No user reviews,0,0,0
362610,True,0,4 user reviews,2,2,4
362620,True,8,Very Positive,2796,204,3000
362630,True,0,No user reviews,0,0,0
362640,True,0,No user reviews,0,0,0
362641,True,0,No user reviews,0,0,0
362660,True,6,Mostly Positive,17,7,24
362680,True,9,Overwhelmingly Positive,3090,127,3217
362700,True,0,No user reviews,0,0,0
362710,True,0,No user reviews,0,0,0
362720,True,0,No user reviews,0,0,0
362740,True,0,6 user reviews,5,1,6
362760,True,0,1 user reviews,1,0,1
362780,True,5,Mixed,28,14,42
362790,True,7,Positive,14,0,14
362800,True,0,No user reviews,0,0,0
362810,True,8,Very Positive,159,27,186
362820,True,0,No user reviews,0,0,0
362830,True,4,Mostly Negative,8,16,24
362850,True,0,No user reviews,0,0,0
362860,True,6,Mostly Positive,52,14,66
362870,True,8,Very Positive,223,28,251
362890,True,9,Overwhelmingly Positive,23612,1092,24704
362900,True,0,7 user reviews,7,0,7
362920,True,4,Mostly Negative,10,21,31
362930,True,8,Very Positive,4663,460,5123
362940,True,7,Positive,13,1,14
362950,True,0,1 user reviews,1,0,1
362960,True,8,Very Positive,3735,643,4378
362970,True,0,No user reviews,0,0,0
362980,True,0,4 user reviews,2,2,4
363000,True,0,No user reviews,0,0,0
363020,True,4,Mostly Negative,10,21,31
363030,True,0,2 user reviews,2,0,2
363031,True,0,4 user reviews,3,1,4
363040,True,0,No user reviews,0,0,0
363050,True,7,Positive,20,0,20
363060,True,0,6 user reviews,6,0,6
363070,True,0,8 user reviews,7,1,8
363090,True,0,8 user reviews,6,2,8
363110,True,0,9 user reviews,5,4,9
363130,True,5,Mixed,247,136,383
363150,True,5,Mixed,442,243,685
363180,True,0,6 user reviews,4,2,6
363200,True,0,3 user reviews,3,0,3
363220,True,0,6 user reviews,6,0,6
363230,True,0,No user reviews,0,0,0
363240,True,7,Positive,18,3,21
363270,True,0,6 user reviews,3,3,6
363320,True,0,No user reviews,0,0,0
363330,True,8,Very Positive,121,16,137
363340,True,0,No user reviews,0,0,0
363350,True,0,3 user reviews,1,2,3
363351,True,0,3 user reviews,0,3,3
363360,True,6,Mostly Positive,484,191,675
363370,True,0,No user reviews,0,0,0
363410,True,6,Mostly Positive,45,13,58
363420,True,8,Very Positive,132,8,140
363430,True,4,Mostly Negative,18,30,48
363440,True,8,Very Positive,1042,208,1250
363460,True,8,Very Positive,218,28,246
363490,True,4,Mostly Negative,68,112,180
363500,True,7,Positive,17,3,20
363510,True,4,Mostly Negative,14,28,42
363520,True,5,Mixed,37,30,67
363530,True,4,Mostly Negative,59,170,229
363540,True,0,No user reviews,0,0,0
363570,True,0,No user reviews,0,0,0
363580,True,0,3 user reviews,2,1,3
363600,True,6,Mostly Positive,484,175,659
363610,True,4,Mostly Negative,24,62,86
363620,True,6,Mostly Positive,41,14,55
363630,True,0,5 user reviews,4,1,5
363640,True,0,1 user reviews,1,0,1
363650,True,5,Mixed,11,16,27
363660,True,3,Negative,2,12,14
363670,True,0,4 user reviews,3,1,4
363680,True,5,Mixed,2036,992,3028
363690,True,0,No user reviews,0,0,0
363740,True,0,No user reviews,0,0,0
363770,True,0,No user reviews,0,0,0
363780,True,0,No user reviews,0,0,0
363781,True,0,No user reviews,0,0,0
363790,True,6,Mostly Positive,145,37,182
363800,True,0,4 user reviews,3,1,4
363801,True,0,No user reviews,0,0,0
363802,True,0,No user reviews,0,0,0
363810,True,0,1 user reviews,1,0,1
363830,True,0,3 user reviews,2,1,3
363840,True,0,5 user reviews,4,1,5
363890,True,8,Very Positive,1635,155,1790
363900,True,0,6 user reviews,4,2,6
363910,True,0,No user reviews,0,0,0
363911,True,0,No user reviews,0,0,0
363920,True,0,2 user reviews,2,0,2
363930,True,8,Very Positive,1371,291,1662
363940,True,3,Negative,2,10,12
363950,True,5,Mixed,51,22,73
363960,True,4,Mostly Negative,5,9,14
363970,True,8,Very Positive,302,39,341
363980,True,8,Very Positive,154,30,184
363990,True,6,Mostly Positive,25,10,35
364000,True,0,6 user reviews,3,3,6
364020,True,0,1 user reviews,0,1,1
364050,True,5,Mixed,104,89,193
364060,True,0,7 user reviews,5,2,7
364100,True,0,4 user reviews,4,0,4
364130,True,0,4 user reviews,3,1,4
364170,True,0,No user reviews,0,0,0
364180,True,0,1 user reviews,0,1,1
364190,True,0,1 user reviews,1,0,1
364200,True,5,Mixed,20,12,32
364210,True,0,3 user reviews,3,0,3
364230,True,8,Very Positive,88,4,92
364240,True,5,Mixed,10,9,19
364250,True,7,Positive,21,1,22
364260,True,0,5 user reviews,4,1,5
364270,True,6,Mostly Positive,115,29,144
364300,True,5,Mixed,132,84,216
364320,True,5,Mixed,11,16,27
364321,True,7,Positive,10,2,12
364322,True,7,Positive,10,1,11
364323,True,5,Mixed,24,14,38
364324,True,6,Mostly Positive,63,26,89
364325,True,7,Positive,22,2,24
364326,True,0,5 user reviews,0,5,5
364327,True,0,5 user reviews,2,3,5
364328,True,5,Mixed,7,10,17
364329,True,7,Positive,10,2,12
364340,True,6,Mostly Positive,102,31,133
364350,True,5,Mixed,10,9,19
364360,True,8,Very Positive,12744,2846,15590
364370,True,5,Mixed,9,7,16
364380,True,5,Mixed,21,27,48
364390,True,8,Very Positive,306,25,331
364400,True,0,2 user reviews,2,0,2
364410,True,0,No user reviews,0,0,0
364420,True,6,Mostly Positive,1382,369,1751
364450,True,0,No user reviews,0,0,0
364470,True,0,No user reviews,0,0,0
364480,True,0,8 user reviews,3,5,8
364500,True,0,No user reviews,0,0,0
364510,True,8,Very Positive,78,6,84
364520,True,0,No user reviews,0,0,0
364530,True,0,No user reviews,0,0,0
364540,True,0,No user reviews,0,0,0
364550,True,0,No user reviews,0,0,0
364560,True,0,No user reviews,0,0,0
364570,True,0,No user reviews,0,0,0
364580,True,0,No user reviews,0,0,0
364590,True,0,No user reviews,0,0,0
364600,True,0,No user reviews,0,0,0
364610,True,0,No user reviews,0,0,0
364620,True,0,No user reviews,0,0,0
364630,True,5,Mixed,77,41,118
364640,True,8,Very Positive,103,23,126
364650,True,0,No user reviews,0,0,0
364660,True,0,2 user reviews,0,2,2
364670,True,0,5 user reviews,2,3,5
364690,True,4,Mostly Negative,35,57,92
364700,True,0,6 user reviews,5,1,6
364710,True,3,Negative,3,31,34
364720,True,0,8 user reviews,7,1,8
364730,True,0,No user reviews,0,0,0
364740,True,7,Positive,9,2,11
364750,True,0,5 user reviews,4,1,5
364770,True,7,Positive,18,4,22
364790,True,0,8 user reviews,7,1,8
364800,True,7,Positive,20,1,21
364810,True,6,Mostly Positive,51,14,65
364820,True,5,Mixed,56,42,98
364830,True,0,9 user reviews,9,0,9
364840,True,6,Mostly Positive,19,5,24
364850,True,0,3 user reviews,1,2,3
364880,True,0,No user reviews,0,0,0
364890,True,5,Mixed,16,13,29
364900,True,0,No user reviews,0,0,0
364910,True,4,Mostly Negative,20,38,58
364920,True,0,No user reviews,0,0,0
364930,True,8,Very Positive,291,8,299
364940,True,6,Mostly Positive,93,35,128
364970,True,5,Mixed,16,8,24
364980,True,0,9 user reviews,5,4,9
365000,True,0,No user reviews,0,0,0
365020,True,5,Mixed,140,104,244
365050,True,0,5 user reviews,4,1,5
365060,True,0,6 user reviews,5,1,6
365070,True,0,6 user reviews,3,3,6
365080,True,0,8 user reviews,6,2,8
365090,True,0,3 user reviews,3,0,3
365110,True,5,Mixed,6,6,12
365120,True,5,Mixed,31,15,46
365140,True,0,7 user reviews,3,4,7
365150,True,0,4 user reviews,3,1,4
365160,True,8,Very Positive,791,157,948
365170,True,8,Very Positive,73,8,81
365180,True,0,No user reviews,0,0,0
365190,True,8,Very Positive,63,15,78
365210,True,8,Very Positive,63,10,73
365220,True,0,No user reviews,0,0,0
365240,True,5,Mixed,7,5,12
365260,True,8,Very Positive,82,11,93
365270,True,0,No user reviews,0,0,0
365280,True,0,5 user reviews,2,3,5
365290,True,0,1 user reviews,1,0,1
365300,True,8,Very Positive,148,10,158
365310,True,5,Mixed,5,5,10
365320,True,6,Mostly Positive,46,19,65
365330,True,6,Mostly Positive,27,10,37
365340,True,6,Mostly Positive,12,4,16
365350,True,6,Mostly Positive,39,10,49
365360,True,8,Very Positive,6312,737,7049
365380,True,7,Positive,14,1,15
365400,True,0,1 user reviews,0,1,1
365420,True,4,Mostly Negative,5,17,22
365430,True,7,Positive,8,2,10
365440,True,5,Mixed,24,11,35
365450,True,8,Very Positive,4740,322,5062
365460,True,0,2 user reviews,0,2,2
365470,True,0,No user reviews,0,0,0
365480,True,5,Mixed,24,13,37
365490,True,0,No user reviews,0,0,0
365500,True,7,Positive,21,3,24
365510,True,0,5 user reviews,5,0,5
365520,True,0,4 user reviews,4,0,4
365530,True,0,5 user reviews,3,2,5
365540,True,0,2 user reviews,2,0,2
365560,True,5,Mixed,45,20,65
365580,True,8,Very Positive,50,2,52
365590,True,5,Mixed,14874,6595,21469
365620,True,4,Mostly Negative,7,17,24
365630,True,0,3 user reviews,2,1,3
365660,True,8,Very Positive,211,37,248
365670,True,8,Very Positive,78,3,81
365680,True,5,Mixed,9,6,15
365720,True,7,Positive,15,0,15
365730,True,0,6 user reviews,6,0,6
365750,True,4,Mostly Negative,3,12,15
365760,True,7,Positive,22,4,26
365770,True,8,Very Positive,199,43,242
365800,True,5,Mixed,14,20,34
365810,True,6,Mostly Positive,150,60,210
365820,True,6,Mostly Positive,33,9,42
365840,True,7,Positive,10,0,10
365850,True,6,Mostly Positive,14,5,19
365860,True,7,Positive,24,5,29
365870,True,7,Positive,35,4,39
365880,True,5,Mixed,44,23,67
365890,True,5,Mixed,62,31,93
365900,True,8,Very Positive,145,20,165
365920,True,0,No user reviews,0,0,0
365930,True,0,No user reviews,0,0,0
365940,True,7,Positive,10,0,10
365960,True,8,Very Positive,1094,186,1280
365970,True,0,2 user reviews,2,0,2
365980,True,0,8 user reviews,4,4,8
366000,True,6,Mostly Positive,92,38,130
366010,True,7,Positive,22,4,26
366050,True,0,2 user reviews,2,0,2
366060,True,6,Mostly Positive,7,3,10
366080,True,7,Positive,23,1,24
366090,True,8,Very Positive,2708,284,2992
366100,True,0,4 user reviews,4,0,4
366130,True,0,No user reviews,0,0,0
366140,True,0,No user reviews,0,0,0
366150,True,0,No user reviews,0,0,0
366180,True,4,Mostly Negative,5,8,13
366190,True,0,1 user reviews,1,0,1
366210,True,6,Mostly Positive,12,4,16
366220,True,5,Mixed,844,369,1213
366230,True,7,Positive,18,4,22
366240,True,8,Very Positive,323,14,337
366250,True,8,Very Positive,381,57,438
366260,True,8,Very Positive,68,14,82
366270,True,7,Positive,22,5,27
366280,True,6,Mostly Positive,29,9,38
366290,True,5,Mixed,42,31,73
366310,True,0,No user reviews,0,0,0
366320,True,8,Very Positive,690,148,838
366330,True,0,3 user reviews,2,1,3
366331,True,0,5 user reviews,3,2,5
366350,True,0,3 user reviews,3,0,3
366380,True,7,Positive,17,2,19
366400,True,6,Mostly Positive,21,9,30
366410,True,0,5 user reviews,5,0,5
366420,True,7,Positive,31,0,31
366430,True,0,No user reviews,0,0,0
366440,True,5,Mixed,357,355,712
366450,True,0,No user reviews,0,0,0
366460,True,0,6 user reviews,4,2,6
366480,True,0,No user reviews,0,0,0
366490,True,0,No user reviews,0,0,0
366510,True,6,Mostly Positive,38,14,52
366530,True,0,No user reviews,0,0,0
366550,True,7,Positive,13,1,14
366570,True,0,2 user reviews,2,0,2
366580,True,0,No user reviews,0,0,0
366590,True,7,Positive,22,2,24
366600,True,0,1 user reviews,1,0,1
366610,True,0,5 user reviews,1,4,5
366620,True,0,8 user reviews,5,3,8
366630,True,0,No user reviews,0,0,0
366640,True,5,Mixed,73,35,108
366650,True,5,Mixed,10,13,23
366660,True,5,Mixed,163,207,370
366670,True,5,Mixed,9,4,13
366680,True,0,No user reviews,0,0,0
366690,True,8,Very Positive,81,16,97
366700,True,0,4 user reviews,1,3,4
366710,True,0,No user reviews,0,0,0
366730,True,0,1 user reviews,1,0,1
366740,True,0,No user reviews,0,0,0
366750,True,0,No user reviews,0,0,0
366760,True,0,6 user reviews,4,2,6
366780,True,7,Positive,18,0,18
366800,True,0,2 user reviews,2,0,2
366810,True,5,Mixed,24,13,37
366820,True,0,No user reviews,0,0,0
366840,True,0,No user reviews,0,0,0
366841,True,0,No user reviews,0,0,0
366842,True,0,No user reviews,0,0,0
366843,True,6,Mostly Positive,302,126,428
366844,True,8,Very Positive,178,42,220
366845,True,6,Mostly Positive,68,25,93
366846,True,0,No user reviews,0,0,0
366847,True,0,No user reviews,0,0,0
366848,True,0,No user reviews,0,0,0
366849,True,8,Very Positive,147,31,178
366850,True,0,No user reviews,0,0,0
366870,True,6,Mostly Positive,264,94,358
366900,True,0,No user reviews,0,0,0
366910,True,5,Mixed,224,199,423
366920,True,7,Positive,16,0,16
366930,True,0,No user reviews,0,0,0
366960,True,0,5 user reviews,2,3,5
366970,True,8,Very Positive,144,11,155
366990,True,0,5 user reviews,5,0,5
367000,True,8,Very Positive,108,13,121
367010,True,5,Mixed,14,16,30
367020,True,8,Very Positive,107,20,127
367030,True,5,Mixed,17,8,25
367040,True,0,4 user reviews,1,3,4
367050,True,0,6 user reviews,6,0,6
367060,True,0,8 user reviews,6,2,8
367080,True,6,Mostly Positive,69,22,91
367090,True,0,6 user reviews,6,0,6
367110,True,8,Very Positive,70,17,87
367120,True,7,Positive,16,1,17
367140,True,7,Positive,29,0,29
367150,True,0,No user reviews,0,0,0
367160,True,0,No user reviews,0,0,0
367180,True,0,1 user reviews,1,0,1
367190,True,0,No user reviews,0,0,0
367210,True,0,6 user reviews,6,0,6
367220,True,0,4 user reviews,0,4,4
367240,True,0,6 user reviews,2,4,6
367250,True,0,2 user reviews,2,0,2
367260,True,6,Mostly Positive,15,5,20
367270,True,8,Very Positive,1464,312,1776
367280,True,0,No user reviews,0,0,0
367290,True,0,1 user reviews,1,0,1
367300,True,7,Positive,30,0,30
367320,True,0,1 user reviews,1,0,1
367330,True,7,Positive,36,9,45
367340,True,4,Mostly Negative,6,17,23
367350,True,5,Mixed,9,4,13
367380,True,0,2 user reviews,1,1,2
367390,True,0,No user reviews,0,0,0
367410,True,0,7 user reviews,7,0,7
367411,True,0,5 user reviews,2,3,5
367412,True,0,8 user reviews,8,0,8
367413,True,0,6 user reviews,6,0,6
367414,True,0,6 user reviews,5,1,6
367415,True,0,7 user reviews,7,0,7
367430,True,7,Positive,10,1,11
367450,True,8,Very Positive,3275,375,3650
367480,True,5,Mixed,85,44,129
367500,True,8,Very Positive,9183,1106,10289
367520,True,9,Overwhelmingly Positive,39372,1231,40603
367540,True,0,No user reviews,0,0,0
367550,True,5,Mixed,24,13,37
367570,True,8,Very Positive,290,33,323
367580,True,9,Overwhelmingly Positive,3228,109,3337
367600,True,5,Mixed,264,184,448
367610,True,0,No user reviews,0,0,0
367620,True,0,No user reviews,0,0,0
367621,True,0,No user reviews,0,0,0
367640,True,0,1 user reviews,1,0,1
367660,True,0,1 user reviews,0,1,1
367670,True,8,Very Positive,1009,103,1112
367680,True,6,Mostly Positive,49,15,64
367690,True,0,No user reviews,0,0,0
367700,True,0,2 user reviews,1,1,2
367710,True,5,Mixed,33,27,60
367730,True,0,No user reviews,0,0,0
367740,True,0,No user reviews,0,0,0
367750,True,0,No user reviews,0,0,0
367760,True,0,No user reviews,0,0,0
367770,True,0,No user reviews,0,0,0
367780,True,7,Positive,19,2,21
367800,True,0,3 user reviews,1,2,3
367810,True,0,No user reviews,0,0,0
367820,True,0,9 user reviews,6,3,9
367840,True,0,No user reviews,0,0,0
367850,True,8,Very Positive,50,2,52
367890,True,0,2 user reviews,2,0,2
367910,True,7,Positive,18,1,19
367920,True,0,No user reviews,0,0,0
367930,True,0,5 user reviews,5,0,5
367940,True,0,No user reviews,0,0,0
367950,True,7,Positive,13,1,14
367960,True,0,No user reviews,0,0,0
367970,True,0,No user reviews,0,0,0
367990,True,4,Mostly Negative,2,8,10
368000,True,6,Mostly Positive,67,26,93
368010,True,0,No user reviews,0,0,0
368040,True,7,Positive,17,1,18
368050,True,7,Positive,31,6,37
368060,True,0,No user reviews,0,0,0
368061,True,0,No user reviews,0,0,0
368070,True,5,Mixed,1386,878,2264
368080,True,8,Very Positive,48,7,55
368090,True,0,No user reviews,0,0,0
368140,True,6,Mostly Positive,27,7,34
368150,True,7,Positive,13,2,15
368160,True,8,Very Positive,97,2,99
368180,True,6,Mostly Positive,75,21,96
368190,True,0,9 user reviews,9,0,9
368220,True,5,Mixed,37,19,56
368230,True,8,Very Positive,2575,396,2971
368250,True,5,Mixed,11,5,16
368290,True,5,Mixed,8,5,13
368310,True,0,5 user reviews,3,2,5
368320,True,0,No user reviews,0,0,0
368340,True,9,Overwhelmingly Positive,4786,236,5022
368350,True,0,No user reviews,0,0,0
368360,True,6,Mostly Positive,2211,623,2834
368370,True,8,Very Positive,2945,366,3311
368390,True,9,Overwhelmingly Positive,643,30,673
368400,True,0,No user reviews,0,0,0
368401,True,0,1 user reviews,1,0,1
368410,True,0,1 user reviews,1,0,1
368420,True,5,Mixed,219,95,314
368430,True,6,Mostly Positive,229,97,326
368440,True,0,No user reviews,0,0,0
368450,True,5,Mixed,56,48,104
368470,True,5,Mixed,14,16,30
368500,True,6,Mostly Positive,3287,1125,4412
368510,True,0,No user reviews,0,0,0
368540,True,0,No user reviews,0,0,0
368550,True,0,1 user reviews,1,0,1
368570,True,8,Very Positive,54,8,62
368590,True,5,Mixed,102,57,159
368600,True,7,Positive,34,1,35
368610,True,8,Very Positive,223,14,237
368620,True,8,Very Positive,646,116,762
368640,True,5,Mixed,58,35,93
368650,True,8,Very Positive,239,19,258
368670,True,0,2 user reviews,2,0,2
368680,True,8,Very Positive,48,3,51
368690,True,0,8 user reviews,4,4,8
368700,True,7,Positive,8,2,10
368710,True,6,Mostly Positive,11,4,15
368720,True,5,Mixed,38,25,63
368730,True,8,Very Positive,507,125,632
368740,True,5,Mixed,49,30,79
368750,True,5,Mixed,22,19,41
368760,True,0,7 user reviews,3,4,7
368770,True,5,Mixed,5,5,10
368780,True,4,Mostly Negative,5,13,18
368790,True,4,Mostly Negative,13,31,44
368800,True,6,Mostly Positive,14,4,18
368820,True,0,1 user reviews,1,0,1
368830,True,7,Positive,26,2,28
368840,True,6,Mostly Positive,22,8,30
368860,True,4,Mostly Negative,181,415,596
368870,True,8,Very Positive,193,30,223
368880,True,0,5 user reviews,1,4,5
368890,True,7,Positive,44,5,49
368910,True,0,No user reviews,0,0,0
368920,True,0,9 user reviews,9,0,9
368930,True,0,1 user reviews,0,1,1
368950,True,0,7 user reviews,7,0,7
368960,True,5,Mixed,20,10,30
368961,True,0,No user reviews,0,0,0
368970,True,0,5 user reviews,3,2,5
368980,True,5,Mixed,15,8,23
368990,True,4,Mostly Negative,279,543,822
369000,True,5,Mixed,126,55,181
369010,True,0,No user reviews,0,0,0
369030,True,0,2 user reviews,1,1,2
369040,True,3,Negative,1,9,10
369050,True,0,4 user reviews,4,0,4
369060,True,0,3 user reviews,3,0,3
369070,True,5,Mixed,479,219,698
369080,True,3,Negative,3,30,33
369100,True,0,8 user reviews,4,4,8
369110,True,5,Mixed,206,125,331
369120,True,0,7 user reviews,4,3,7
369130,True,0,No user reviews,0,0,0
369131,True,0,No user reviews,0,0,0
369140,True,0,No user reviews,0,0,0
369150,True,8,Very Positive,263,51,314
369170,True,0,No user reviews,0,0,0
369180,True,5,Mixed,13,11,24
369190,True,5,Mixed,10,8,18
369210,True,0,No user reviews,0,0,0
369230,True,5,Mixed,22,12,34
369270,True,7,Positive,15,2,17
369280,True,5,Mixed,10,5,15
369290,True,6,Mostly Positive,100,33,133
369310,True,7,Positive,11,0,11
369320,True,0,No user reviews,0,0,0
369321,True,0,No user reviews,0,0,0
369322,True,0,No user reviews,0,0,0
369324,True,0,No user reviews,0,0,0
369325,True,0,No user reviews,0,0,0
369340,True,0,4 user reviews,4,0,4
369350,True,0,No user reviews,0,0,0
369360,True,0,2 user reviews,1,1,2
369370,True,5,Mixed,12,16,28
369380,True,0,No user reviews,0,0,0
369390,True,6,Mostly Positive,64,22,86
369400,True,0,8 user reviews,6,2,8
369410,True,0,No user reviews,0,0,0
369420,True,8,Very Positive,118,16,134
369430,True,0,No user reviews,0,0,0
369440,True,5,Mixed,176,88,264
369450,True,0,1 user reviews,0,1,1
369460,True,0,3 user reviews,0,3,3
369470,True,0,5 user reviews,3,2,5
369490,True,0,2 user reviews,2,0,2
369500,True,0,No user reviews,0,0,0
369501,True,0,No user reviews,0,0,0
369502,True,0,No user reviews,0,0,0
369503,True,0,No user reviews,0,0,0
369504,True,0,No user reviews,0,0,0
369505,True,0,No user reviews,0,0,0
369506,True,0,No user reviews,0,0,0
369507,True,0,No user reviews,0,0,0
369508,True,0,No user reviews,0,0,0
369509,True,0,No user reviews,0,0,0
369510,True,0,No user reviews,0,0,0
369511,True,0,No user reviews,0,0,0
369520,True,0,No user reviews,0,0,0
369530,True,8,Very Positive,343,56,399
369550,True,8,Very Positive,56,14,70
369560,True,6,Mostly Positive,25,7,32
369570,True,5,Mixed,14,7,21
369580,True,8,Very Positive,1331,154,1485
369610,True,0,4 user reviews,2,2,4
369620,True,0,8 user reviews,8,0,8
369630,True,0,No user reviews,0,0,0
369640,True,5,Mixed,5,5,10
369650,True,0,9 user reviews,5,4,9
369660,True,0,4 user reviews,3,1,4
369670,True,0,1 user reviews,1,0,1
369700,True,6,Mostly Positive,12,4,16
369710,True,0,No user reviews,0,0,0
369720,True,4,Mostly Negative,9,18,27
369730,True,0,No user reviews,0,0,0
369740,True,0,No user reviews,0,0,0
369760,True,0,No user reviews,0,0,0
369761,True,0,No user reviews,0,0,0
369762,True,0,No user reviews,0,0,0
369763,True,0,2 user reviews,2,0,2
369764,True,0,1 user reviews,1,0,1
369765,True,0,No user reviews,0,0,0
369766,True,0,1 user reviews,1,0,1
369767,True,0,6 user reviews,5,1,6
369768,True,0,No user reviews,0,0,0
369769,True,0,No user reviews,0,0,0
369770,True,0,1 user reviews,1,0,1
369771,True,0,1 user reviews,1,0,1
369772,True,0,1 user reviews,1,0,1
369773,True,0,1 user reviews,1,0,1
369774,True,0,No user reviews,0,0,0
369775,True,0,No user reviews,0,0,0
369776,True,0,2 user reviews,2,0,2
369777,True,0,1 user reviews,1,0,1
369778,True,0,No user reviews,0,0,0
369779,True,0,No user reviews,0,0,0
369780,True,0,No user reviews,0,0,0
369781,True,0,1 user reviews,1,0,1
369782,True,0,3 user reviews,2,1,3
369783,True,0,1 user reviews,1,0,1
369784,True,0,No user reviews,0,0,0
369785,True,0,No user reviews,0,0,0
369786,True,0,No user reviews,0,0,0
369787,True,0,2 user reviews,1,1,2
369788,True,0,No user reviews,0,0,0
369789,True,0,1 user reviews,1,0,1
369790,True,0,No user reviews,0,0,0
369791,True,0,No user reviews,0,0,0
369792,True,0,No user reviews,0,0,0
369793,True,0,2 user reviews,2,0,2
369794,True,0,No user reviews,0,0,0
369795,True,0,No user reviews,0,0,0
369796,True,0,2 user reviews,2,0,2
369797,True,0,No user reviews,0,0,0
369798,True,0,No user reviews,0,0,0
369799,True,0,No user reviews,0,0,0
369800,True,0,No user reviews,0,0,0
369801,True,0,No user reviews,0,0,0
369802,True,0,3 user reviews,3,0,3
369803,True,0,No user reviews,0,0,0
369804,True,0,2 user reviews,2,0,2
369805,True,0,1 user reviews,1,0,1
369806,True,0,No user reviews,0,0,0
369807,True,0,No user reviews,0,0,0
369808,True,0,No user reviews,0,0,0
369809,True,0,1 user reviews,1,0,1
369810,True,0,No user reviews,0,0,0
369811,True,0,1 user reviews,1,0,1
369812,True,0,No user reviews,0,0,0
369813,True,0,No user reviews,0,0,0
369814,True,0,No user reviews,0,0,0
369815,True,0,No user reviews,0,0,0
369816,True,0,2 user reviews,2,0,2
369817,True,0,No user reviews,0,0,0
369818,True,0,No user reviews,0,0,0
369819,True,0,No user reviews,0,0,0
369820,True,0,No user reviews,0,0,0
369821,True,0,No user reviews,0,0,0
369822,True,0,1 user reviews,0,1,1
369823,True,0,1 user reviews,1,0,1
369824,True,0,No user reviews,0,0,0
369825,True,0,No user reviews,0,0,0
369826,True,0,3 user reviews,1,2,3
369827,True,0,1 user reviews,1,0,1
369828,True,0,1 user reviews,1,0,1
369829,True,0,No user reviews,0,0,0
369830,True,8,Very Positive,90,3,93
369840,True,0,No user reviews,0,0,0
369860,True,0,3 user reviews,1,2,3
369890,True,6,Mostly Positive,45,17,62
369910,True,0,No user reviews,0,0,0
369920,True,0,No user reviews,0,0,0
369930,True,0,No user reviews,0,0,0
369940,True,0,No user reviews,0,0,0
369950,True,0,No user reviews,0,0,0
369960,True,0,No user reviews,0,0,0
369970,True,0,No user reviews,0,0,0
369980,True,0,No user reviews,0,0,0
369990,True,8,Very Positive,734,158,892
370001,True,8,Very Positive,51,2,53
370002,True,8,Very Positive,58,2,60
370003,True,7,Positive,20,0,20
370020,True,9,Overwhelmingly Positive,618,30,648
370040,True,7,Positive,12,1,13
370050,True,7,Positive,17,0,17
370060,True,8,Very Positive,245,46,291
370070,True,6,Mostly Positive,19,5,24
370080,True,7,Positive,16,1,17
370090,True,6,Mostly Positive,48,20,68
370110,True,0,No user reviews,0,0,0
370120,True,0,6 user reviews,6,0,6
370130,True,0,4 user reviews,2,2,4
370140,True,0,2 user reviews,1,1,2
370150,True,8,Very Positive,79,3,82
370160,True,5,Mixed,16,15,31
370170,True,0,4 user reviews,3,1,4
370190,True,5,Mixed,5,5,10
370200,True,0,2 user reviews,2,0,2
370210,True,0,9 user reviews,8,1,9
370220,True,0,5 user reviews,1,4,5
370230,True,0,2 user reviews,1,1,2
370240,True,5,Mixed,906,926,1832
370250,True,6,Mostly Positive,19,7,26
370261,True,0,No user reviews,0,0,0
370262,True,0,No user reviews,0,0,0
370263,True,0,No user reviews,0,0,0
370270,True,5,Mixed,11,5,16
370280,True,8,Very Positive,118,9,127
370300,True,7,Positive,20,0,20
370310,True,0,1 user reviews,1,0,1
370330,True,0,No user reviews,0,0,0
370340,True,7,Positive,9,2,11
370341,True,7,Positive,9,2,11
370350,True,4,Mostly Negative,18,41,59
370360,True,9,Overwhelmingly Positive,1842,47,1889
370370,True,0,No user reviews,0,0,0
370390,True,5,Mixed,14,9,23
370400,True,0,4 user reviews,2,2,4
370401,True,0,1 user reviews,1,0,1
370402,True,0,1 user reviews,1,0,1
370430,True,0,No user reviews,0,0,0
370440,True,5,Mixed,17,9,26
370450,True,0,No user reviews,0,0,0
370460,True,8,Very Positive,117,20,137
370480,True,7,Positive,37,7,44
370490,True,7,Positive,15,0,15
370500,True,0,1 user reviews,1,0,1
370510,True,5,Mixed,184,132,316
370520,True,0,No user reviews,0,0,0
370530,True,0,No user reviews,0,0,0
370540,True,8,Very Positive,179,15,194
370550,True,7,Positive,21,3,24
370560,True,0,9 user reviews,5,4,9
370570,True,7,Positive,11,2,13
370580,True,0,No user reviews,0,0,0
370590,True,5,Mixed,7,7,14
370600,True,5,Mixed,10,5,15
370620,True,0,9 user reviews,5,4,9
370640,True,5,Mixed,7,7,14
370650,True,0,6 user reviews,6,0,6
370660,True,6,Mostly Positive,11,4,15
370670,True,7,Positive,27,3,30
370690,True,0,7 user reviews,5,2,7
370700,True,5,Mixed,17,10,27
370710,True,6,Mostly Positive,28,9,37
370730,True,0,4 user reviews,1,3,4
370750,True,0,No user reviews,0,0,0
370770,True,7,Positive,10,0,10
370780,True,4,Mostly Negative,5,8,13
370800,True,5,Mixed,9,5,14
370810,True,0,6 user reviews,5,1,6
370820,True,0,No user reviews,0,0,0
370840,True,5,Mixed,38,25,63
370870,True,6,Mostly Positive,109,36,145
370880,True,0,No user reviews,0,0,0
370900,True,0,No user reviews,0,0,0
370910,True,8,Very Positive,849,59,908
370920,True,7,Positive,33,0,33
370940,True,7,Positive,12,2,14
370960,True,0,No user reviews,0,0,0
370970,True,0,1 user reviews,1,0,1
371000,True,7,Positive,8,2,10
371010,True,5,Mixed,92,43,135
371040,True,0,No user reviews,0,0,0
371070,True,0,No user reviews,0,0,0
371100,True,8,Very Positive,90,22,112
371110,True,0,2 user reviews,1,1,2
371120,True,5,Mixed,14,14,28
371130,True,0,No user reviews,0,0,0
371140,True,6,Mostly Positive,51,18,69
371180,True,8,Very Positive,305,20,325
371190,True,8,Very Positive,71,14,85
371200,True,6,Mostly Positive,681,178,859
371220,True,5,Mixed,29,23,52
371230,True,6,Mostly Positive,17,5,22
371240,True,7,Positive,16,3,19
371250,True,0,3 user reviews,0,3,3
371260,True,0,9 user reviews,4,5,9
371270,True,6,Mostly Positive,50,16,66
371280,True,5,Mixed,4,6,10
371290,True,0,5 user reviews,3,2,5
371300,True,6,Mostly Positive,71,19,90
371310,True,0,1 user reviews,1,0,1
371320,True,7,Positive,11,2,13
371330,True,6,Mostly Positive,60,17,77
371350,True,0,No user reviews,0,0,0
371360,True,3,Negative,2,13,15
371370,True,0,5 user reviews,3,2,5
371380,True,0,3 user reviews,3,0,3
371390,True,0,1 user reviews,1,0,1
371400,True,0,5 user reviews,3,2,5
371410,True,0,3 user reviews,0,3,3
371420,True,6,Mostly Positive,195,66,261
371430,True,7,Positive,28,5,33
371450,True,6,Mostly Positive,79,27,106
371460,True,5,Mixed,16,7,23
371470,True,0,No user reviews,0,0,0
371471,True,0,No user reviews,0,0,0
371472,True,0,No user reviews,0,0,0
371473,True,0,No user reviews,0,0,0
371490,True,0,No user reviews,0,0,0
371491,True,0,No user reviews,0,0,0
371492,True,0,No user reviews,0,0,0
371493,True,0,No user reviews,0,0,0
371500,True,8,Very Positive,163,21,184
371510,True,4,Mostly Negative,19,33,52
371520,True,6,Mostly Positive,277,118,395
371530,True,7,Positive,12,1,13
371550,True,8,Very Positive,93,21,114
371570,True,5,Mixed,99,57,156
371600,True,0,1 user reviews,1,0,1
371620,True,0,1 user reviews,0,1,1
371650,True,6,Mostly Positive,47,17,64
371660,True,8,Very Positive,5150,1151,6301
371670,True,4,Mostly Negative,86,142,228
371690,True,0,9 user reviews,6,3,9
371700,True,0,No user reviews,0,0,0
371710,True,4,Mostly Negative,7,19,26
371740,True,0,1 user reviews,0,1,1
371790,True,0,2 user reviews,1,1,2
371800,True,0,No user reviews,0,0,0
371810,True,0,6 user reviews,1,5,6
371840,True,0,No user reviews,0,0,0
371841,True,0,No user reviews,0,0,0
371842,True,0,No user reviews,0,0,0
371843,True,0,No user reviews,0,0,0
371844,True,0,No user reviews,0,0,0
371845,True,0,No user reviews,0,0,0
371846,True,0,No user reviews,0,0,0
371847,True,0,No user reviews,0,0,0
371848,True,0,No user reviews,0,0,0
371849,True,0,No user reviews,0,0,0
371850,True,6,Mostly Positive,19,6,25
371870,True,0,No user reviews,0,0,0
371880,True,0,6 user reviews,4,2,6
371890,True,0,3 user reviews,2,1,3
371900,True,0,7 user reviews,6,1,7
371930,True,0,1 user reviews,1,0,1
371970,True,8,Very Positive,1282,117,1399
372000,True,5,Mixed,1843,1281,3124
372020,True,0,3 user reviews,3,0,3
372030,True,7,Positive,14,0,14
372060,True,5,Mixed,15,11,26
372070,True,0,No user reviews,0,0,0
372080,True,7,Positive,19,4,23
372100,True,0,No user reviews,0,0,0
372110,True,0,9 user reviews,8,1,9
372112,True,0,6 user reviews,4,2,6
372140,True,0,2 user reviews,2,0,2
372150,True,0,2 user reviews,2,0,2
372160,True,0,9 user reviews,2,7,9
372170,True,0,1 user reviews,1,0,1
372180,True,0,No user reviews,0,0,0
372190,True,0,No user reviews,0,0,0
372200,True,0,4 user reviews,3,1,4
372210,True,8,Very Positive,162,20,182
372250,True,5,Mixed,13,6,19
372260,True,7,Positive,27,0,27
372270,True,0,No user reviews,0,0,0
372280,True,0,1 user reviews,1,0,1
372300,True,0,No user reviews,0,0,0
372301,True,0,No user reviews,0,0,0
372310,True,0,No user reviews,0,0,0
372320,True,7,Positive,11,1,12
372330,True,6,Mostly Positive,36,12,48
372340,True,0,No user reviews,0,0,0
372350,True,8,Very Positive,82,10,92
372360,True,8,Very Positive,1472,300,1772
372370,True,0,No user reviews,0,0,0
372380,True,6,Mostly Positive,18,7,25
372390,True,6,Mostly Positive,158,44,202
372410,True,0,No user reviews,0,0,0
372430,True,0,5 user reviews,1,4,5
372440,True,0,2 user reviews,0,2,2
372470,True,0,1 user reviews,1,0,1
372480,True,5,Mixed,8,10,18
372490,True,0,2 user reviews,0,2,2
372500,True,0,2 user reviews,2,0,2
372510,True,0,2 user reviews,1,1,2
372511,True,0,No user reviews,0,0,0
372512,True,0,No user reviews,0,0,0
372520,True,0,No user reviews,0,0,0
372540,True,0,9 user reviews,4,5,9
372550,True,0,1 user reviews,1,0,1
372560,True,0,3 user reviews,2,1,3
372570,True,0,8 user reviews,4,4,8
372580,True,0,No user reviews,0,0,0
372590,True,7,Positive,41,3,44
372630,True,0,No user reviews,0,0,0
372650,True,0,No user reviews,0,0,0
372660,True,0,3 user reviews,3,0,3
372670,True,0,2 user reviews,1,1,2
372690,True,8,Very Positive,117,24,141
372700,True,0,No user reviews,0,0,0
372710,True,5,Mixed,7,5,12
372720,True,5,Mixed,7,5,12
372730,True,0,No user reviews,0,0,0
372740,True,4,Mostly Negative,6,13,19
372750,True,5,Mixed,32,36,68
372770,True,0,6 user reviews,4,2,6
372780,True,4,Mostly Negative,9,14,23
372800,True,7,Positive,35,8,43
372810,True,0,1 user reviews,1,0,1
372820,True,0,3 user reviews,2,1,3
372830,True,7,Positive,40,9,49
372860,True,0,No user reviews,0,0,0
372870,True,0,1 user reviews,1,0,1
372890,True,0,2 user reviews,0,2,2
372900,True,0,No user reviews,0,0,0
372910,True,0,No user reviews,0,0,0
372920,True,0,No user reviews,0,0,0
372930,True,8,Very Positive,67,5,72
372940,True,8,Very Positive,93,3,96
372950,True,0,6 user reviews,5,1,6
372960,True,7,Positive,23,1,24
372970,True,6,Mostly Positive,19,7,26
372980,True,0,1 user reviews,0,1,1
373000,True,0,2 user reviews,1,1,2
373020,True,6,Mostly Positive,31,9,40
373021,True,0,No user reviews,0,0,0
373022,True,0,No user reviews,0,0,0
373023,True,0,No user reviews,0,0,0
373030,True,0,No user reviews,0,0,0
373080,True,3,Negative,6,32,38
373090,True,0,2 user reviews,2,0,2
373120,True,0,3 user reviews,3,0,3
373140,True,0,6 user reviews,5,1,6
373150,True,5,Mixed,30,17,47
373160,True,0,No user reviews,0,0,0
373170,True,0,3 user reviews,2,1,3
373171,True,0,4 user reviews,2,2,4
373180,True,8,Very Positive,1085,122,1207
373190,True,0,No user reviews,0,0,0
373200,True,0,1 user reviews,1,0,1
373220,True,0,No user reviews,0,0,0
373240,True,5,Mixed,43,27,70
373250,True,0,No user reviews,0,0,0
373280,True,4,Mostly Negative,4,12,16
373290,True,5,Mixed,23,24,47
373330,True,0,6 user reviews,2,4,6
373340,True,8,Very Positive,85,21,106
373350,True,0,No user reviews,0,0,0
373360,True,5,Mixed,21,10,31
373370,True,5,Mixed,106,142,248
373380,True,5,Mixed,11,7,18
373390,True,9,Overwhelmingly Positive,1564,73,1637
373400,True,7,Positive,12,1,13
373420,True,8,Very Positive,5683,829,6512
373440,True,5,Mixed,27,12,39
373450,True,0,No user reviews,0,0,0
373460,True,0,7 user reviews,4,3,7
373480,True,7,Positive,14,1,15
373490,True,5,Mixed,11,9,20
373491,True,0,4 user reviews,3,1,4
373560,True,0,No user reviews,0,0,0
373590,True,0,9 user reviews,5,4,9
373600,True,7,Positive,16,3,19
373610,True,7,Positive,40,7,47
373620,True,7,Positive,18,3,21
373630,True,7,Positive,13,2,15
373640,True,0,2 user reviews,2,0,2
373650,True,6,Mostly Positive,63,25,88
373670,True,0,1 user reviews,1,0,1
373680,True,0,No user reviews,0,0,0
373690,True,0,3 user reviews,3,0,3
373700,True,0,No user reviews,0,0,0
373711,True,0,No user reviews,0,0,0
373720,True,0,No user reviews,0,0,0
373730,True,5,Mixed,18,20,38
373740,True,8,Very Positive,53,11,64
373750,True,8,Very Positive,105,8,113
373770,True,9,Overwhelmingly Positive,1486,40,1526
373780,True,0,1 user reviews,1,0,1
373800,True,0,8 user reviews,5,3,8
373810,True,5,Mixed,5,5,10
373820,True,0,4 user reviews,3,1,4
373860,True,0,8 user reviews,3,5,8
373870,True,0,6 user reviews,2,4,6
373880,True,0,6 user reviews,2,4,6
373890,True,0,4 user reviews,2,2,4
373910,True,0,No user reviews,0,0,0
373920,True,5,Mixed,94,85,179
373930,True,6,Mostly Positive,708,238,946
373940,True,5,Mixed,15,21,36
373950,True,7,Positive,26,0,26
373951,True,7,Positive,21,1,22
373960,True,0,5 user reviews,0,5,5
373970,True,8,Very Positive,162,9,171
373980,True,5,Mixed,10,13,23
373990,True,6,Mostly Positive,9,3,12
374010,True,5,Mixed,23,11,34
374030,True,5,Mixed,596,354,950
374040,True,8,Very Positive,3012,710,3722
374050,True,5,Mixed,11,9,20
374060,True,5,Mixed,81,40,121
374080,True,0,4 user reviews,3,1,4
374100,True,0,1 user reviews,1,0,1
374120,True,0,5 user reviews,0,5,5
374130,True,0,No user reviews,0,0,0
374150,True,6,Mostly Positive,12,4,16
374160,True,0,1 user reviews,1,0,1
374170,True,5,Mixed,10,5,15
374180,True,0,No user reviews,0,0,0
374190,True,0,No user reviews,0,0,0
374210,True,0,No user reviews,0,0,0
374220,True,0,No user reviews,0,0,0
374240,True,5,Mixed,7,6,13
374250,True,0,1 user reviews,1,0,1
374260,True,0,No user reviews,0,0,0
374280,True,5,Mixed,250,178,428
374300,True,6,Mostly Positive,242,94,336
374301,True,8,Very Positive,364,72,436
374320,True,8,Very Positive,48415,4070,52485
374360,True,0,No user reviews,0,0,0
374380,True,6,Mostly Positive,33,13,46
374390,True,7,Positive,26,6,32
374400,True,6,Mostly Positive,79,23,102
374410,True,8,Very Positive,66,4,70
374420,True,0,1 user reviews,1,0,1
374430,True,0,1 user reviews,1,0,1
374450,True,5,Mixed,10,5,15
374460,True,7,Positive,11,2,13
374500,True,7,Positive,31,7,38
374510,True,4,Mostly Negative,6,10,16
374520,True,5,Mixed,18,26,44
374530,True,0,No user reviews,0,0,0
374540,True,0,No user reviews,0,0,0
374570,True,7,Positive,40,0,40
374620,True,0,5 user reviews,2,3,5
374630,True,0,4 user reviews,4,0,4
374640,True,4,Mostly Negative,10,37,47
374660,True,0,1 user reviews,1,0,1
374670,True,7,Positive,16,2,18
374680,True,0,3 user reviews,3,0,3
374690,True,0,8 user reviews,1,7,8
374700,True,0,No user reviews,0,0,0
374701,True,0,No user reviews,0,0,0
374702,True,0,No user reviews,0,0,0
374703,True,0,No user reviews,0,0,0
374704,True,0,No user reviews,0,0,0
374705,True,0,No user reviews,0,0,0
374706,True,0,No user reviews,0,0,0
374707,True,0,No user reviews,0,0,0
374708,True,0,No user reviews,0,0,0
374709,True,0,No user reviews,0,0,0
374710,True,0,No user reviews,0,0,0
374711,True,0,No user reviews,0,0,0
374712,True,0,No user reviews,0,0,0
374713,True,0,No user reviews,0,0,0
374714,True,0,No user reviews,0,0,0
374715,True,0,No user reviews,0,0,0
374716,True,0,No user reviews,0,0,0
374717,True,0,No user reviews,0,0,0
374718,True,0,No user reviews,0,0,0
374719,True,0,No user reviews,0,0,0
374720,True,0,No user reviews,0,0,0
374721,True,0,No user reviews,0,0,0
374722,True,0,No user reviews,0,0,0
374723,True,0,No user reviews,0,0,0
374724,True,0,No user reviews,0,0,0
374725,True,0,No user reviews,0,0,0
374726,True,0,No user reviews,0,0,0
374727,True,0,No user reviews,0,0,0
374728,True,0,No user reviews,0,0,0
374729,True,0,No user reviews,0,0,0
374730,True,0,No user reviews,0,0,0
374731,True,0,No user reviews,0,0,0
374732,True,0,No user reviews,0,0,0
374733,True,0,No user reviews,0,0,0
374734,True,0,No user reviews,0,0,0
374735,True,0,No user reviews,0,0,0
374736,True,0,No user reviews,0,0,0
374737,True,0,No user reviews,0,0,0
374738,True,0,No user reviews,0,0,0
374739,True,0,No user reviews,0,0,0
374740,True,0,No user reviews,0,0,0
374741,True,0,No user reviews,0,0,0
374742,True,0,No user reviews,0,0,0
374743,True,0,No user reviews,0,0,0
374744,True,0,No user reviews,0,0,0
374745,True,0,No user reviews,0,0,0
374746,True,0,No user reviews,0,0,0
374750,True,0,No user reviews,0,0,0
374770,True,0,2 user reviews,2,0,2
374780,True,0,No user reviews,0,0,0
374800,True,0,1 user reviews,1,0,1
374810,True,0,1 user reviews,1,0,1
374820,True,0,No user reviews,0,0,0
374830,True,7,Positive,36,0,36
374840,True,0,No user reviews,0,0,0
374850,True,7,Positive,8,2,10
374851,True,6,Mostly Positive,48,13,61
374871,True,0,3 user reviews,1,2,3
374880,True,0,4 user reviews,4,0,4
374890,True,0,No user reviews,0,0,0
374900,True,6,Mostly Positive,280,82,362
374930,True,0,No user reviews,0,0,0
374940,True,0,3 user reviews,3,0,3
374950,True,4,Mostly Negative,19,29,48
374960,True,0,4 user reviews,3,1,4
374970,True,0,3 user reviews,0,3,3
374990,True,0,6 user reviews,3,3,6
375000,True,0,5 user reviews,3,2,5
375010,True,0,6 user reviews,4,2,6
375020,True,5,Mixed,6,4,10
375030,True,6,Mostly Positive,21,9,30
375040,True,5,Mixed,15,7,22
375090,True,6,Mostly Positive,9,3,12
375120,True,8,Very Positive,110,23,133
375130,True,8,Very Positive,231,9,240
375140,True,0,No user reviews,0,0,0
375160,True,0,1 user reviews,1,0,1
375161,True,0,No user reviews,0,0,0
375170,True,7,Positive,10,1,11
375180,True,5,Mixed,98,63,161
375190,True,5,Mixed,9,4,13
375200,True,8,Very Positive,389,40,429
375210,True,7,Positive,27,5,32
375220,True,0,1 user reviews,1,0,1
375230,True,5,Mixed,1271,1199,2470
375250,True,8,Very Positive,94,8,102
375290,True,0,7 user reviews,6,1,7
375310,True,7,Positive,32,3,35
375320,True,5,Mixed,22,19,41
375330,True,5,Mixed,14,10,24
375340,True,0,No user reviews,0,0,0
375380,True,0,No user reviews,0,0,0
375381,True,0,No user reviews,0,0,0
375382,True,0,No user reviews,0,0,0
375383,True,0,No user reviews,0,0,0
375384,True,0,No user reviews,0,0,0
375385,True,0,No user reviews,0,0,0
375390,True,0,No user reviews,0,0,0
375420,True,0,4 user reviews,3,1,4
375430,True,0,3 user reviews,2,1,3
375440,True,8,Very Positive,170,17,187
375450,True,6,Mostly Positive,62,16,78
375460,True,4,Mostly Negative,52,142,194
375480,True,9,Overwhelmingly Positive,1600,59,1659
375500,True,5,Mixed,45,22,67
375510,True,5,Mixed,187,245,432
375520,True,6,Mostly Positive,25,10,35
375530,True,8,Very Positive,865,83,948
375550,True,0,3 user reviews,3,0,3
375560,True,0,No user reviews,0,0,0
375570,True,0,No user reviews,0,0,0
375580,True,0,6 user reviews,4,2,6
375590,True,0,No user reviews,0,0,0
375600,True,6,Mostly Positive,223,81,304
375610,True,0,No user reviews,0,0,0
375620,True,0,No user reviews,0,0,0
375630,True,0,No user reviews,0,0,0
375680,True,5,Mixed,22,27,49
375710,True,6,Mostly Positive,63,17,80
375720,True,0,1 user reviews,0,1,1
375750,True,8,Very Positive,166,18,184
375760,True,0,6 user reviews,4,2,6
375770,True,6,Mostly Positive,11,4,15
375790,True,6,Mostly Positive,11,3,14
375800,True,0,No user reviews,0,0,0
375810,True,0,6 user reviews,3,3,6
375820,True,8,Very Positive,876,70,946
375840,True,8,Very Positive,135,26,161
375850,True,5,Mixed,5,7,12
375860,True,0,No user reviews,0,0,0
375870,True,0,2 user reviews,2,0,2
375880,True,0,No user reviews,0,0,0
375890,True,0,2 user reviews,2,0,2
375900,True,5,Mixed,374,229,603
375910,True,5,Mixed,1358,657,2015
375930,True,6,Mostly Positive,10,3,13
375950,True,8,Very Positive,89,9,98
375960,True,5,Mixed,139,188,327
375980,True,0,1 user reviews,0,1,1
376010,True,0,No user reviews,0,0,0
376011,True,0,No user reviews,0,0,0
376020,True,0,No user reviews,0,0,0
376050,True,0,No user reviews,0,0,0
376070,True,0,No user reviews,0,0,0
376090,True,0,No user reviews,0,0,0
376110,True,5,Mixed,14,14,28
376120,True,4,Mostly Negative,3,12,15
376130,True,5,Mixed,20,16,36
376140,True,0,No user reviews,0,0,0
376150,True,4,Mostly Negative,7,11,18
376160,True,0,1 user reviews,1,0,1
376190,True,0,1 user reviews,1,0,1
376200,True,7,Positive,43,0,43
376210,True,8,Very Positive,12811,3202,16013
376230,True,0,1 user reviews,0,1,1
376240,True,7,Positive,25,1,26
376250,True,5,Mixed,13,9,22
376280,True,0,No user reviews,0,0,0
376300,True,8,Very Positive,775,58,833
376310,True,4,Mostly Negative,69,117,186
376320,True,0,2 user reviews,2,0,2
376350,True,0,3 user reviews,1,2,3
376360,True,0,2 user reviews,0,2,2
376370,True,7,Positive,11,0,11
376371,True,0,2 user reviews,2,0,2
376372,True,0,6 user reviews,6,0,6
376373,True,0,1 user reviews,1,0,1
376390,True,7,Positive,35,0,35
376391,True,7,Positive,44,3,47
376410,True,5,Mixed,13,13,26
376450,True,5,Mixed,10,12,22
376480,True,0,4 user reviews,0,4,4
376490,True,6,Mostly Positive,11,4,15
376520,True,8,Very Positive,274,39,313
376530,True,0,No user reviews,0,0,0
376540,True,0,No user reviews,0,0,0
376550,True,0,No user reviews,0,0,0
376560,True,0,3 user reviews,2,1,3
376570,True,6,Mostly Positive,59,21,80
376610,True,0,No user reviews,0,0,0
376611,True,0,No user reviews,0,0,0
376620,True,0,No user reviews,0,0,0
376660,True,5,Mixed,32,15,47
376670,True,0,No user reviews,0,0,0
376680,True,6,Mostly Positive,165,45,210
376700,True,7,Positive,21,4,25
376730,True,5,Mixed,46,36,82
376750,True,4,Mostly Negative,9,14,23
376760,True,7,Positive,16,4,20
376770,True,7,Positive,20,2,22
376780,True,5,Mixed,9,4,13
376790,True,6,Mostly Positive,12,4,16
376800,True,0,No user reviews,0,0,0
376810,True,0,No user reviews,0,0,0
376820,True,0,No user reviews,0,0,0
376860,True,0,No user reviews,0,0,0
376870,True,6,Mostly Positive,2428,966,3394
376880,True,5,Mixed,21,19,40
376890,True,0,No user reviews,0,0,0
376900,True,0,No user reviews,0,0,0
376901,True,0,No user reviews,0,0,0
376920,True,6,Mostly Positive,60,17,77
376930,True,6,Mostly Positive,26,8,34
376931,True,7,Positive,20,0,20
376932,True,7,Positive,35,5,40
376933,True,4,Mostly Negative,8,15,23
376934,True,7,Positive,11,1,12
376935,True,5,Mixed,6,4,10
376936,True,4,Mostly Negative,4,12,16
376938,True,6,Mostly Positive,33,12,45
376939,True,0,No user reviews,0,0,0
376942,True,7,Positive,26,0,26
376943,True,7,Positive,15,2,17
376944,True,6,Mostly Positive,14,5,19
376945,True,0,6 user reviews,5,1,6
376946,True,7,Positive,33,6,39
376947,True,0,No user reviews,0,0,0
376948,True,0,No user reviews,0,0,0
376949,True,0,6 user reviews,4,2,6
376950,True,7,Positive,13,3,16
376951,True,7,Positive,13,1,14
376952,True,0,7 user reviews,7,0,7
376953,True,6,Mostly Positive,13,4,17
376954,True,0,6 user reviews,2,4,6
376955,True,0,9 user reviews,3,6,9
376956,True,0,3 user reviews,3,0,3
376957,True,0,4 user reviews,3,1,4
376958,True,0,4 user reviews,3,1,4
376959,True,7,Positive,31,6,37
376960,True,0,4 user reviews,4,0,4
376961,True,7,Positive,29,2,31
376962,True,0,No user reviews,0,0,0
376963,True,7,Positive,12,1,13
376964,True,0,7 user reviews,5,2,7
376965,True,7,Positive,11,0,11
376966,True,7,Positive,21,2,23
376967,True,0,9 user reviews,3,6,9
376968,True,0,No user reviews,0,0,0
376969,True,0,5 user reviews,4,1,5
376970,True,7,Positive,29,2,31
376971,True,0,7 user reviews,4,3,7
376972,True,4,Mostly Negative,4,8,12
376973,True,0,No user reviews,0,0,0
376974,True,0,No user reviews,0,0,0
376975,True,5,Mixed,13,14,27
376976,True,0,4 user reviews,3,1,4
376977,True,0,5 user reviews,5,0,5
376978,True,0,No user reviews,0,0,0
376979,True,7,Positive,32,1,33
376980,True,8,Very Positive,46,4,50
376990,True,0,2 user reviews,2,0,2
377000,True,0,1 user reviews,0,1,1
377010,True,0,No user reviews,0,0,0
377020,True,0,No user reviews,0,0,0
377030,True,0,3 user reviews,2,1,3
377040,True,0,No user reviews,0,0,0
377050,True,0,No user reviews,0,0,0
377060,True,5,Mixed,126,66,192
377070,True,7,Positive,20,4,24
377080,True,8,Very Positive,228,11,239
377100,True,0,2 user reviews,2,0,2
377120,True,5,Mixed,31,21,52
377130,True,0,No user reviews,0,0,0
377140,True,5,Mixed,129,121,250
377150,True,6,Mostly Positive,11,4,15
377160,True,6,Mostly Positive,63204,19917,83121
377170,True,0,2 user reviews,2,0,2
377190,True,7,Positive,16,1,17
377200,True,0,6 user reviews,3,3,6
377210,True,0,No user reviews,0,0,0
377220,True,0,No user reviews,0,0,0
377250,True,0,2 user reviews,2,0,2
377260,True,0,No user reviews,0,0,0
377280,True,5,Mixed,12,9,21
377290,True,4,Mostly Negative,16,30,46
377300,True,0,No user reviews,0,0,0
377310,True,5,Mixed,14,8,22
377320,True,7,Positive,17,3,20
377330,True,8,Very Positive,75,2,77
377340,True,0,1 user reviews,1,0,1
377350,True,0,4 user reviews,1,3,4
377360,True,6,Mostly Positive,19,7,26
377420,True,7,Positive,10,0,10
377430,True,0,4 user reviews,4,0,4
377440,True,0,2 user reviews,2,0,2
377450,True,8,Very Positive,59,1,60
377460,True,8,Very Positive,77,3,80
377470,True,5,Mixed,30,21,51
377480,True,5,Mixed,27,22,49
377500,True,6,Mostly Positive,12,4,16
377520,True,6,Mostly Positive,113,32,145
377530,True,8,Very Positive,372,70,442
377540,True,0,No user reviews,0,0,0
377550,True,5,Mixed,5,5,10
377560,True,6,Mostly Positive,21,8,29
377570,True,6,Mostly Positive,9,3,12
377590,True,0,No user reviews,0,0,0
377600,True,8,Very Positive,87,13,100
377640,True,0,1 user reviews,1,0,1
377641,True,0,No user reviews,0,0,0
377660,True,8,Very Positive,63,1,64
377670,True,8,Very Positive,197,12,209
377680,True,8,Very Positive,288,69,357
377690,True,8,Very Positive,128,9,137
377710,True,7,Positive,46,2,48
377720,True,7,Positive,19,1,20
377730,True,0,2 user reviews,2,0,2
377760,True,8,Very Positive,81,10,91
377770,True,0,No user reviews,0,0,0
377790,True,0,No user reviews,0,0,0
377840,True,8,Very Positive,2820,220,3040
377860,True,8,Very Positive,432,9,441
377870,True,8,Very Positive,161,31,192
377880,True,8,Very Positive,74,8,82
377890,True,0,7 user reviews,5,2,7
377900,True,6,Mostly Positive,294,112,406
377920,True,0,No user reviews,0,0,0
377930,True,0,No user reviews,0,0,0
377940,True,6,Mostly Positive,10,3,13
377950,True,8,Very Positive,59,6,65
377970,True,5,Mixed,105,54,159
377980,True,5,Mixed,6,8,14
377990,True,0,No user reviews,0,0,0
378030,True,7,Positive,32,7,39
378040,True,5,Mixed,33,23,56
378041,True,6,Mostly Positive,16,5,21
378061,True,0,1 user reviews,1,0,1
378070,True,5,Mixed,9,6,15
378080,True,7,Positive,32,8,40
378090,True,5,Mixed,7,4,11
378100,True,5,Mixed,8,10,18
378110,True,8,Very Positive,73,17,90
378120,True,6,Mostly Positive,785,318,1103
378180,True,0,No user reviews,0,0,0
378200,True,0,No user reviews,0,0,0
378220,True,0,No user reviews,0,0,0
378240,True,0,6 user reviews,3,3,6
378250,True,0,No user reviews,0,0,0
378260,True,5,Mixed,43,19,62
378270,True,5,Mixed,91,41,132
378280,True,5,Mixed,8,7,15
378300,True,0,1 user reviews,1,0,1
378330,True,0,No user reviews,0,0,0
378350,True,0,9 user reviews,7,2,9
378360,True,6,Mostly Positive,216,91,307
378370,True,5,Mixed,132,62,194
378380,True,0,No user reviews,0,0,0
378390,True,0,No user reviews,0,0,0
378400,True,0,1 user reviews,1,0,1
378410,True,7,Positive,12,1,13
378420,True,2,Very Negative,1,52,53
378450,True,0,2 user reviews,1,1,2
378460,True,0,2 user reviews,1,1,2
378461,True,0,4 user reviews,0,4,4
378470,True,0,1 user reviews,1,0,1
378471,True,0,1 user reviews,1,0,1
378472,True,0,4 user reviews,2,2,4
378473,True,0,3 user reviews,1,2,3
378474,True,0,3 user reviews,3,0,3
378475,True,0,3 user reviews,3,0,3
378476,True,0,No user reviews,0,0,0
378477,True,0,No user reviews,0,0,0
378478,True,0,1 user reviews,1,0,1
378480,True,0,9 user reviews,5,4,9
378490,True,5,Mixed,17,12,29
378504,True,7,Positive,10,1,11
378505,True,0,5 user reviews,4,1,5
378510,True,0,4 user reviews,3,1,4
378530,True,6,Mostly Positive,19,6,25
378540,True,6,Mostly Positive,2033,633,2666
378550,True,0,5 user reviews,3,2,5
378551,True,0,2 user reviews,0,2,2
378552,True,0,1 user reviews,1,0,1
378570,True,0,9 user reviews,6,3,9
378580,True,5,Mixed,61,32,93
378590,True,0,4 user reviews,1,3,4
378610,True,8,Very Positive,3251,327,3578
378620,True,0,1 user reviews,1,0,1
378621,True,0,No user reviews,0,0,0
378630,True,6,Mostly Positive,14,4,18
378642,True,7,Positive,22,0,22
378643,True,7,Positive,24,1,25
378644,True,7,Positive,29,3,32
378645,True,7,Positive,33,0,33
378646,True,8,Very Positive,169,5,174
378647,True,7,Positive,28,4,32
378648,True,9,Overwhelmingly Positive,2716,31,2747
378649,True,9,Overwhelmingly Positive,1749,52,1801
378650,True,0,No user reviews,0,0,0
378660,True,5,Mixed,265,212,477
378670,True,0,No user reviews,0,0,0
378690,True,0,No user reviews,0,0,0
378700,True,5,Mixed,16,8,24
378710,True,0,8 user reviews,8,0,8
378720,True,8,Very Positive,1712,175,1887
378730,True,0,8 user reviews,6,2,8
378731,True,7,Positive,36,3,39
378750,True,8,Very Positive,61,2,63
378760,True,0,No user reviews,0,0,0
378770,True,8,Very Positive,62,4,66
378790,True,7,Positive,10,1,11
378800,True,5,Mixed,69,54,123
378810,True,7,Positive,17,4,21
378830,True,5,Mixed,7,10,17
378850,True,5,Mixed,6,4,10
378860,True,6,Mostly Positive,3224,914,4138
378890,True,0,No user reviews,0,0,0
378910,True,0,1 user reviews,1,0,1
378950,True,7,Positive,24,0,24
379030,True,0,No user reviews,0,0,0
379040,True,0,No user reviews,0,0,0
379190,True,0,6 user reviews,6,0,6
379191,True,0,No user reviews,0,0,0
379200,True,0,No user reviews,0,0,0
379210,True,8,Very Positive,438,78,516
379230,True,5,Mixed,7,7,14
379231,True,0,No user reviews,0,0,0
379232,True,0,6 user reviews,6,0,6
379233,True,5,Mixed,10,15,25
379234,True,0,No user reviews,0,0,0
379235,True,5,Mixed,10,8,18
379240,True,0,6 user reviews,4,2,6
379241,True,5,Mixed,5,6,11
379242,True,5,Mixed,8,4,12
379243,True,5,Mixed,11,8,19
379250,True,0,No user reviews,0,0,0
379260,True,0,7 user reviews,2,5,7
379270,True,0,No user reviews,0,0,0
379280,True,0,No user reviews,0,0,0
379290,True,5,Mixed,5,6,11
379310,True,8,Very Positive,392,66,458
379320,True,6,Mostly Positive,24,8,32
379340,True,0,8 user reviews,5,3,8
379350,True,0,9 user reviews,6,3,9
379370,True,5,Mixed,9,6,15
379380,True,0,7 user reviews,3,4,7
379390,True,6,Mostly Positive,10,3,13
379400,True,0,8 user reviews,6,2,8
379420,True,8,Very Positive,83,19,102
379430,True,6,Mostly Positive,18984,4893,23877
379520,True,7,Positive,15,0,15
379530,True,6,Mostly Positive,60,17,77
379541,True,7,Positive,12,3,15
379542,True,5,Mixed,77,60,137
379543,True,0,4 user reviews,3,1,4
379544,True,5,Mixed,6,4,10
379545,True,0,9 user reviews,5,4,9
379546,True,6,Mostly Positive,43,11,54
379547,True,5,Mixed,12,7,19
379548,True,7,Positive,15,2,17
379549,True,0,1 user reviews,1,0,1
379550,True,0,1 user reviews,1,0,1
379551,True,5,Mixed,9,4,13
379552,True,0,6 user reviews,5,1,6
379553,True,0,6 user reviews,5,1,6
379554,True,5,Mixed,21,11,32
379555,True,0,5 user reviews,2,3,5
379556,True,0,7 user reviews,4,3,7
379557,True,5,Mixed,11,5,16
379558,True,5,Mixed,14,17,31
379559,True,5,Mixed,5,5,10
379560,True,6,Mostly Positive,77,24,101
379561,True,5,Mixed,16,7,23
379562,True,0,9 user reviews,3,6,9
379563,True,5,Mixed,10,11,21
379564,True,0,9 user reviews,7,2,9
379565,True,5,Mixed,18,16,34
379566,True,7,Positive,21,4,25
379567,True,5,Mixed,13,15,28
379568,True,6,Mostly Positive,26,10,36
379570,True,0,1 user reviews,1,0,1
379571,True,0,No user reviews,0,0,0
379572,True,0,6 user reviews,5,1,6
379575,True,5,Mixed,12,13,25
379576,True,0,2 user reviews,0,2,2
379577,True,0,6 user reviews,5,1,6
379578,True,0,5 user reviews,5,0,5
379579,True,0,4 user reviews,3,1,4
379582,True,0,4 user reviews,3,1,4
379583,True,5,Mixed,6,5,11
379584,True,6,Mostly Positive,24,10,34
379585,True,0,3 user reviews,1,2,3
379586,True,0,8 user reviews,5,3,8
379587,True,0,3 user reviews,3,0,3
379589,True,0,No user reviews,0,0,0
379590,True,0,1 user reviews,1,0,1
379600,True,5,Mixed,22,11,33
379610,True,7,Positive,21,1,22
379630,True,0,No user reviews,0,0,0
379640,True,7,Positive,23,2,25
379650,True,0,No user reviews,0,0,0
379660,True,0,No user reviews,0,0,0
379670,True,7,Positive,17,3,20
379680,True,0,No user reviews,0,0,0
379700,True,0,No user reviews,0,0,0
379720,True,8,Very Positive,47500,2514,50014
379730,True,0,1 user reviews,1,0,1
379750,True,0,1 user reviews,1,0,1
379760,True,7,Positive,23,3,26
379800,True,0,No user reviews,0,0,0
379820,True,0,No user reviews,0,0,0
379870,True,0,4 user reviews,4,0,4
379960,True,5,Mixed,51,26,77
379970,True,0,1 user reviews,0,1,1
379980,True,8,Very Positive,936,85,1021
379990,True,4,Mostly Negative,3,9,12
380000,True,5,Mixed,5,6,11
380010,True,0,No user reviews,0,0,0
380020,True,5,Mixed,55,74,129
380050,True,0,No user reviews,0,0,0
380060,True,0,No user reviews,0,0,0
380080,True,5,Mixed,18,11,29
380100,True,0,6 user reviews,6,0,6
380120,True,0,5 user reviews,4,1,5
380130,True,0,1 user reviews,0,1,1
380140,True,0,3 user reviews,3,0,3
380150,True,6,Mostly Positive,390,111,501
380170,True,0,No user reviews,0,0,0
380210,True,0,7 user reviews,6,1,7
380220,True,5,Mixed,342,214,556
380230,True,6,Mostly Positive,37,12,49
380231,True,6,Mostly Positive,56,18,74
380232,True,0,3 user reviews,2,1,3
380360,True,0,8 user reviews,7,1,8
380540,True,5,Mixed,13,17,30
380550,True,5,Mixed,17,10,27
380560,True,0,7 user reviews,4,3,7
380570,True,5,Mixed,21,31,52
380580,True,5,Mixed,118,80,198
380600,True,5,Mixed,104,71,175
380610,True,0,No user reviews,0,0,0
380640,True,0,No user reviews,0,0,0
380650,True,0,No user reviews,0,0,0
380660,True,8,Very Positive,79,16,95
380670,True,8,Very Positive,249,17,266
380680,True,0,No user reviews,0,0,0
380690,True,0,7 user reviews,6,1,7
380700,True,5,Mixed,7,4,11
380710,True,0,5 user reviews,4,1,5
380720,True,0,No user reviews,0,0,0
380740,True,0,7 user reviews,7,0,7
380750,True,5,Mixed,135,61,196
380770,True,0,No user reviews,0,0,0
380790,True,0,4 user reviews,2,2,4
380800,True,0,4 user reviews,4,0,4
380810,True,8,Very Positive,66,3,69
380840,True,6,Mostly Positive,17,5,22
380850,True,0,4 user reviews,2,2,4
380860,True,7,Positive,14,2,16
380890,True,0,2 user reviews,1,1,2
380900,True,0,No user reviews,0,0,0
380901,True,0,No user reviews,0,0,0
380910,True,0,No user reviews,0,0,0
380920,True,7,Positive,31,5,36
380930,True,0,No user reviews,0,0,0
380950,True,0,3 user reviews,3,0,3
380970,True,0,1 user reviews,1,0,1
380990,True,4,Mostly Negative,9,16,25
381000,True,0,No user reviews,0,0,0
381010,True,5,Mixed,17,9,26
381020,True,8,Very Positive,480,42,522
381050,True,6,Mostly Positive,25,9,34
381090,True,7,Positive,12,3,15
381100,True,6,Mostly Positive,114,40,154
381120,True,5,Mixed,949,511,1460
381130,True,5,Mixed,4,6,10
381140,True,5,Mixed,10,8,18
381150,True,0,1 user reviews,1,0,1
381151,True,6,Mostly Positive,18,6,24
381152,True,5,Mixed,7,7,14
381160,True,0,No user reviews,0,0,0
381161,True,0,No user reviews,0,0,0
381162,True,0,No user reviews,0,0,0
381170,True,0,5 user reviews,3,2,5
381180,True,5,Mixed,92,125,217
381191,True,0,No user reviews,0,0,0
381200,True,0,No user reviews,0,0,0
381201,True,0,1 user reviews,1,0,1
381210,True,8,Very Positive,74972,16099,91071
381220,True,5,Mixed,15,20,35
381240,True,7,Positive,38,5,43
381250,True,0,3 user reviews,3,0,3
381260,True,5,Mixed,57,26,83
381290,True,0,No user reviews,0,0,0
381310,True,6,Mostly Positive,9,3,12
381320,True,7,Positive,29,3,32
381340,True,0,7 user reviews,7,0,7
381550,True,0,3 user reviews,2,1,3
381560,True,0,3 user reviews,3,0,3
381570,True,0,No user reviews,0,0,0
381590,True,5,Mixed,25,24,49
381600,True,0,No user reviews,0,0,0
381610,True,7,Positive,12,1,13
381640,True,0,No user reviews,0,0,0
381650,True,0,1 user reviews,1,0,1
381670,True,0,No user reviews,0,0,0
381671,True,0,3 user reviews,2,1,3
381690,True,0,No user reviews,0,0,0
381710,True,5,Mixed,12,8,20
381711,True,7,Positive,10,2,12
381712,True,7,Positive,10,2,12
381713,True,0,7 user reviews,6,1,7
381715,True,0,No user reviews,0,0,0
381716,True,0,No user reviews,0,0,0
381717,True,0,No user reviews,0,0,0
381720,True,0,No user reviews,0,0,0
381721,True,0,No user reviews,0,0,0
381730,True,0,No user reviews,0,0,0
381731,True,0,No user reviews,0,0,0
381750,True,5,Mixed,91,55,146
381760,True,6,Mostly Positive,11,4,15
381770,True,0,No user reviews,0,0,0
381780,True,8,Very Positive,591,38,629
381790,True,0,3 user reviews,3,0,3
381791,True,0,No user reviews,0,0,0
381792,True,0,5 user reviews,4,1,5
381800,True,4,Mostly Negative,4,8,12
381810,True,0,No user reviews,0,0,0
381830,True,0,No user reviews,0,0,0
381840,True,5,Mixed,6,4,10
381850,True,5,Mixed,6,6,12
381870,True,7,Positive,40,3,43
381880,True,7,Positive,36,9,45
381890,True,7,Positive,43,1,44
381900,True,7,Positive,34,5,39
381910,True,0,8 user reviews,6,2,8
381940,True,6,Mostly Positive,21,7,28
381960,True,0,1 user reviews,1,0,1
381970,True,0,1 user reviews,0,1,1
381990,True,0,9 user reviews,6,3,9
382000,True,0,No user reviews,0,0,0
382010,True,0,No user reviews,0,0,0
382030,True,0,No user reviews,0,0,0
382050,True,8,Very Positive,376,30,406
382060,True,0,1 user reviews,1,0,1
382070,True,7,Positive,29,7,36
382080,True,5,Mixed,21,14,35
382090,True,8,Very Positive,96,23,119
382110,True,6,Mostly Positive,764,302,1066
382120,True,0,2 user reviews,2,0,2
382130,True,5,Mixed,21,10,31
382140,True,5,Mixed,221,126,347
382151,True,0,1 user reviews,1,0,1
382160,True,0,9 user reviews,2,7,9
382170,True,0,2 user reviews,2,0,2
382180,True,6,Mostly Positive,24,10,34
382190,True,0,No user reviews,0,0,0
382200,True,0,5 user reviews,4,1,5
382210,True,7,Positive,16,4,20
382220,True,0,No user reviews,0,0,0
382250,True,6,Mostly Positive,17,6,23
382260,True,8,Very Positive,148,14,162
382270,True,0,9 user reviews,7,2,9
382280,True,0,No user reviews,0,0,0
382300,True,5,Mixed,49,65,114
382310,True,6,Mostly Positive,1706,519,2225
382320,True,0,4 user reviews,4,0,4
382330,True,5,Mixed,41,53,94
382350,True,5,Mixed,38,35,73
382360,True,5,Mixed,100,70,170
382380,True,8,Very Positive,89,18,107
382390,True,0,1 user reviews,1,0,1
382400,True,5,Mixed,28,16,44
382410,True,5,Mixed,7,6,13
382420,True,5,Mixed,37,32,69
382450,True,0,No user reviews,0,0,0
382451,True,0,No user reviews,0,0,0
382452,True,0,No user reviews,0,0,0
382460,True,0,5 user reviews,5,0,5
382461,True,0,No user reviews,0,0,0
382462,True,7,Positive,19,0,19
382463,True,0,No user reviews,0,0,0
382464,True,7,Positive,29,0,29
382465,True,0,No user reviews,0,0,0
382466,True,7,Positive,14,0,14
382467,True,7,Positive,13,1,14
382468,True,7,Positive,30,1,31
382469,True,7,Positive,20,0,20
382470,True,4,Mostly Negative,13,24,37
382480,True,6,Mostly Positive,31,13,44
382490,True,7,Positive,33,5,38
382500,True,0,No user reviews,0,0,0
382510,True,0,No user reviews,0,0,0
382530,True,0,No user reviews,0,0,0
382560,True,8,Very Positive,1264,85,1349
382620,True,7,Positive,10,0,10
382630,True,7,Positive,36,9,45
382640,True,7,Positive,11,0,11
382650,True,0,2 user reviews,2,0,2
382660,True,0,8 user reviews,4,4,8
382670,True,0,3 user reviews,3,0,3
382680,True,7,Positive,9,1,10
382690,True,0,No user reviews,0,0,0
382700,True,0,4 user reviews,2,2,4
382710,True,7,Positive,17,0,17
382720,True,0,2 user reviews,2,0,2
382730,True,0,5 user reviews,4,1,5
382740,True,0,6 user reviews,5,1,6
382750,True,7,Positive,12,0,12
382760,True,7,Positive,12,0,12
382770,True,0,1 user reviews,1,0,1
382780,True,6,Mostly Positive,16,5,21
382790,True,0,3 user reviews,1,2,3
382800,True,0,4 user reviews,1,3,4
382810,True,0,No user reviews,0,0,0
382811,True,0,No user reviews,0,0,0
382820,True,0,No user reviews,0,0,0
382840,True,0,No user reviews,0,0,0
382850,True,5,Mixed,11,13,24
382870,True,0,2 user reviews,2,0,2
382880,True,4,Mostly Negative,5,8,13
382890,True,6,Mostly Positive,448,161,609
382900,True,6,Mostly Positive,882,243,1125
382910,True,5,Mixed,9,5,14
382920,True,5,Mixed,17,8,25
382940,True,0,No user reviews,0,0,0
382950,True,0,6 user reviews,6,0,6
382990,True,0,No user reviews,0,0,0
383010,True,0,3 user reviews,1,2,3
383020,True,0,No user reviews,0,0,0
383040,True,0,No user reviews,0,0,0
383050,True,0,No user reviews,0,0,0
383070,True,5,Mixed,12,14,26
383080,True,8,Very Positive,112,25,137
383100,True,7,Positive,41,2,43
383110,True,0,1 user reviews,1,0,1
383120,True,8,Very Positive,9730,2213,11943
383130,True,0,4 user reviews,4,0,4
383140,True,0,No user reviews,0,0,0
383150,True,6,Mostly Positive,2120,653,2773
383180,True,5,Mixed,473,230,703
383190,True,0,4 user reviews,4,0,4
383230,True,6,Mostly Positive,599,173,772
383240,True,0,3 user reviews,1,2,3
383250,True,0,No user reviews,0,0,0
383270,True,8,Very Positive,310,22,332
383320,True,0,1 user reviews,1,0,1
383330,True,5,Mixed,17,18,35
383370,True,0,No user reviews,0,0,0
383380,True,0,1 user reviews,1,0,1
383400,True,0,9 user reviews,6,3,9
383410,True,0,No user reviews,0,0,0
383430,True,0,1 user reviews,1,0,1
383450,True,0,5 user reviews,4,1,5
383460,True,8,Very Positive,129,16,145
383470,True,0,No user reviews,0,0,0
383510,True,0,2 user reviews,2,0,2
383520,True,6,Mostly Positive,8,3,11
383530,True,0,2 user reviews,1,1,2
383540,True,0,7 user reviews,7,0,7
383560,True,5,Mixed,15,18,33
383570,True,0,No user reviews,0,0,0
383580,True,6,Mostly Positive,325,113,438
383590,True,0,7 user reviews,4,3,7
383600,True,0,No user reviews,0,0,0
383610,True,0,No user reviews,0,0,0
383620,True,4,Mostly Negative,4,12,16
383630,True,0,7 user reviews,5,2,7
383660,True,0,3 user reviews,1,2,3
383670,True,6,Mostly Positive,12,5,17
383680,True,0,1 user reviews,1,0,1
383690,True,8,Very Positive,80,15,95
383700,True,5,Mixed,12,7,19
383710,True,5,Mixed,8,5,13
383720,True,6,Mostly Positive,26,11,37
383730,True,7,Positive,29,6,35
383740,True,0,No user reviews,0,0,0
383750,True,0,6 user reviews,5,1,6
383760,True,6,Mostly Positive,8,3,11
383780,True,0,6 user reviews,3,3,6
383790,True,5,Mixed,185,143,328
383800,True,5,Mixed,8,4,12
383810,True,0,2 user reviews,1,1,2
383840,True,8,Very Positive,608,121,729
383850,True,0,No user reviews,0,0,0
383860,True,0,1 user reviews,1,0,1
383870,True,8,Very Positive,23602,4244,27846
383900,True,5,Mixed,26,34,60
383901,True,0,No user reviews,0,0,0
383902,True,0,No user reviews,0,0,0
383903,True,0,No user reviews,0,0,0
383904,True,0,No user reviews,0,0,0
383905,True,0,No user reviews,0,0,0
383906,True,0,No user reviews,0,0,0
383907,True,0,No user reviews,0,0,0
383908,True,0,1 user reviews,1,0,1
383909,True,0,No user reviews,0,0,0
383910,True,0,No user reviews,0,0,0
383911,True,0,No user reviews,0,0,0
383920,True,0,No user reviews,0,0,0
383930,True,6,Mostly Positive,42,14,56
383940,True,0,4 user reviews,3,1,4
383950,True,5,Mixed,9,4,13
383960,True,8,Very Positive,53,13,66
383980,True,9,Overwhelmingly Positive,11045,566,11611
383990,True,0,No user reviews,0,0,0
384000,True,6,Mostly Positive,44,17,61
384010,True,0,9 user reviews,4,5,9
384020,True,8,Very Positive,416,76,492
384021,True,6,Mostly Positive,303,83,386
384030,True,5,Mixed,6,6,12
384040,True,0,6 user reviews,5,1,6
384050,True,0,No user reviews,0,0,0
384060,True,0,No user reviews,0,0,0
384080,True,5,Mixed,50,39,89
384090,True,5,Mixed,22,22,44
384100,True,5,Mixed,6,5,11
384110,True,8,Very Positive,563,99,662
384120,True,5,Mixed,15,9,24
384140,True,0,3 user reviews,2,1,3
384150,True,7,Positive,35,5,40
384170,True,0,1 user reviews,1,0,1
384171,True,0,3 user reviews,3,0,3
384180,True,7,Positive,30,6,36
384190,True,8,Very Positive,6259,491,6750
384200,True,5,Mixed,19,9,28
384210,True,0,1 user reviews,0,1,1
384220,True,0,No user reviews,0,0,0
384221,True,0,No user reviews,0,0,0
384222,True,0,No user reviews,0,0,0
384223,True,0,No user reviews,0,0,0
384224,True,0,No user reviews,0,0,0
384225,True,0,No user reviews,0,0,0
384226,True,0,No user reviews,0,0,0
384227,True,0,No user reviews,0,0,0
384240,True,7,Positive,17,0,17
384250,True,7,Positive,12,1,13
384270,True,0,No user reviews,0,0,0
384280,True,8,Very Positive,72,12,84
384300,True,6,Mostly Positive,2016,754,2770
384310,True,6,Mostly Positive,93,32,125
384330,True,0,8 user reviews,7,1,8
384340,True,0,No user reviews,0,0,0
384350,True,0,No user reviews,0,0,0
384360,True,6,Mostly Positive,384,144,528
384370,True,0,2 user reviews,2,0,2
384380,True,5,Mixed,11,5,16
384410,True,0,No user reviews,0,0,0
384420,True,4,Mostly Negative,3,7,10
384421,True,0,No user reviews,0,0,0
384422,True,0,No user reviews,0,0,0
384423,True,0,No user reviews,0,0,0
384424,True,0,No user reviews,0,0,0
384425,True,0,No user reviews,0,0,0
384426,True,0,No user reviews,0,0,0
384427,True,0,No user reviews,0,0,0
384428,True,0,No user reviews,0,0,0
384429,True,0,No user reviews,0,0,0
384430,True,0,No user reviews,0,0,0
384431,True,0,No user reviews,0,0,0
384432,True,0,No user reviews,0,0,0
384433,True,0,No user reviews,0,0,0
384434,True,0,No user reviews,0,0,0
384435,True,0,No user reviews,0,0,0
384436,True,0,No user reviews,0,0,0
384437,True,0,No user reviews,0,0,0
384438,True,0,No user reviews,0,0,0
384439,True,0,No user reviews,0,0,0
384440,True,0,No user reviews,0,0,0
384441,True,0,No user reviews,0,0,0
384442,True,0,No user reviews,0,0,0
384443,True,0,No user reviews,0,0,0
384444,True,0,No user reviews,0,0,0
384445,True,0,No user reviews,0,0,0
384446,True,0,No user reviews,0,0,0
384447,True,0,No user reviews,0,0,0
384448,True,0,No user reviews,0,0,0
384449,True,0,No user reviews,0,0,0
384450,True,0,No user reviews,0,0,0
384451,True,0,No user reviews,0,0,0
384452,True,0,No user reviews,0,0,0
384453,True,0,No user reviews,0,0,0
384454,True,0,No user reviews,0,0,0
384455,True,0,No user reviews,0,0,0
384456,True,0,No user reviews,0,0,0
384457,True,0,No user reviews,0,0,0
384458,True,0,No user reviews,0,0,0
384459,True,0,No user reviews,0,0,0
384460,True,0,No user reviews,0,0,0
384461,True,0,No user reviews,0,0,0
384462,True,0,No user reviews,0,0,0
384463,True,0,No user reviews,0,0,0
384464,True,0,No user reviews,0,0,0
384465,True,0,No user reviews,0,0,0
384480,True,7,Positive,35,5,40
384490,True,5,Mixed,1519,1002,2521
384500,True,6,Mostly Positive,145,55,200
384520,True,0,No user reviews,0,0,0
384530,True,0,4 user reviews,4,0,4
384531,True,0,2 user reviews,0,2,2
384532,True,0,4 user reviews,4,0,4
384540,True,0,1 user reviews,0,1,1
384550,True,5,Mixed,136,69,205
384560,True,0,2 user reviews,2,0,2
384570,True,5,Mixed,93,70,163
384590,True,0,8 user reviews,8,0,8
384620,True,0,No user reviews,0,0,0
384621,True,0,No user reviews,0,0,0
384630,True,8,Very Positive,642,37,679
384650,True,0,1 user reviews,1,0,1
384660,True,0,3 user reviews,3,0,3
384670,True,0,No user reviews,0,0,0
384680,True,8,Very Positive,113,16,129
384690,True,8,Very Positive,60,3,63
384700,True,7,Positive,15,3,18
384710,True,0,2 user reviews,2,0,2
384720,True,0,5 user reviews,5,0,5
384730,True,0,No user reviews,0,0,0
384740,True,6,Mostly Positive,317,133,450
384750,True,5,Mixed,97,110,207
384840,True,4,Mostly Negative,9,22,31
384850,True,0,No user reviews,0,0,0
384880,True,0,8 user reviews,1,7,8
384890,True,7,Positive,12,1,13
384900,True,0,2 user reviews,0,2,2
384910,True,6,Mostly Positive,13,5,18
384920,True,4,Mostly Negative,8,17,25
384930,True,0,6 user reviews,2,4,6
384940,True,0,4 user reviews,4,0,4
384950,True,6,Mostly Positive,8,3,11
384960,True,8,Very Positive,103,25,128
384970,True,0,4 user reviews,1,3,4
384980,True,0,3 user reviews,1,2,3
384990,True,8,Very Positive,48,11,59
385020,True,0,9 user reviews,3,6,9
385030,True,7,Positive,17,0,17
385060,True,7,Positive,27,2,29
385070,True,7,Positive,36,9,45
385080,True,4,Mostly Negative,6,21,27
385100,True,7,Positive,24,0,24
385120,True,7,Positive,11,0,11
385130,True,7,Positive,23,3,26
385150,True,6,Mostly Positive,17,6,23
385160,True,0,No user reviews,0,0,0
385170,True,0,No user reviews,0,0,0
385190,True,0,4 user reviews,0,4,4
385220,True,0,3 user reviews,2,1,3
385230,True,6,Mostly Positive,31,8,39
385240,True,8,Very Positive,479,76,555
385250,True,8,Very Positive,274,3,277
385260,True,0,No user reviews,0,0,0
385270,True,6,Mostly Positive,31,13,44
385310,True,4,Mostly Negative,8,14,22
385330,True,8,Very Positive,313,25,338
385350,True,5,Mixed,8,5,13
385360,True,5,Mixed,29,16,45
385370,True,7,Positive,28,5,33
385380,True,6,Mostly Positive,506,149,655
385390,True,0,7 user reviews,2,5,7
385400,True,4,Mostly Negative,15,40,55
385410,True,0,4 user reviews,1,3,4
385420,True,0,8 user reviews,8,0,8
385440,True,6,Mostly Positive,18,5,23
385460,True,0,5 user reviews,2,3,5
385470,True,0,7 user reviews,1,6,7
385490,True,5,Mixed,5,5,10
385510,True,5,Mixed,17,8,25
385511,True,7,Positive,22,5,27
385520,True,7,Positive,31,1,32
385530,True,0,No user reviews,0,0,0
385540,True,0,No user reviews,0,0,0
385560,True,8,Very Positive,157,24,181
385570,True,0,No user reviews,0,0,0
385580,True,0,8 user reviews,2,6,8
385590,True,8,Very Positive,60,10,70
385600,True,5,Mixed,14,14,28
385630,True,0,2 user reviews,1,1,2
385640,True,0,No user reviews,0,0,0
385650,True,0,2 user reviews,1,1,2
385660,True,0,1 user reviews,0,1,1
385670,True,0,4 user reviews,4,0,4
385690,True,7,Positive,17,2,19
385700,True,4,Mostly Negative,7,15,22
385710,True,8,Very Positive,398,65,463
385720,True,0,No user reviews,0,0,0
385721,True,7,Positive,14,1,15
385730,True,5,Mixed,558,428,986
385760,True,5,Mixed,989,821,1810
385770,True,7,Positive,26,5,31
385800,True,8,Very Positive,3686,241,3927
385810,True,0,3 user reviews,1,2,3
385820,True,0,No user reviews,0,0,0
385830,True,5,Mixed,14,10,24
385840,True,7,Positive,10,0,10
385850,True,0,No user reviews,0,0,0
385860,True,5,Mixed,7,5,12
385870,True,0,4 user reviews,4,0,4
385890,True,0,1 user reviews,0,1,1
385900,True,4,Mostly Negative,4,10,14
385930,True,0,3 user reviews,2,1,3
385940,True,0,3 user reviews,1,2,3
385950,True,5,Mixed,5,6,11
385960,True,3,Negative,1,12,13
385970,True,6,Mostly Positive,350,143,493
385980,True,0,6 user reviews,2,4,6
386000,True,0,No user reviews,0,0,0
386010,True,0,No user reviews,0,0,0
386050,True,6,Mostly Positive,19,7,26
386070,True,8,Very Positive,4201,751,4952
386080,True,6,Mostly Positive,71,19,90
386090,True,0,6 user reviews,5,1,6
386100,True,7,Positive,11,2,13
386110,True,0,5 user reviews,0,5,5
386130,True,0,No user reviews,0,0,0
386140,True,6,Mostly Positive,12,4,16
386160,True,5,Mixed,25,12,37
386180,True,5,Mixed,317,180,497
386200,True,7,Positive,13,2,15
386230,True,0,No user reviews,0,0,0
386260,True,6,Mostly Positive,322,95,417
386270,True,0,1 user reviews,1,0,1
386280,True,5,Mixed,36,49,85
386290,True,4,Mostly Negative,4,12,16
386300,True,0,No user reviews,0,0,0
386310,True,0,No user reviews,0,0,0
386320,True,4,Mostly Negative,3,10,13
386330,True,0,3 user reviews,2,1,3
386340,True,5,Mixed,35,19,54
386350,True,5,Mixed,15,10,25
386360,True,6,Mostly Positive,523,136,659
386400,True,6,Mostly Positive,22,7,29
386420,True,7,Positive,17,2,19
386430,True,0,No user reviews,0,0,0
386450,True,0,No user reviews,0,0,0
386460,True,0,No user reviews,0,0,0
386470,True,0,No user reviews,0,0,0
386480,True,5,Mixed,134,83,217
386490,True,6,Mostly Positive,24,10,34
386500,True,0,1 user reviews,1,0,1
386510,True,0,1 user reviews,1,0,1
386520,True,8,Very Positive,115,16,131
386530,True,0,No user reviews,0,0,0
386540,True,3,Negative,2,9,11
386550,True,5,Mixed,7,9,16
386560,True,8,Very Positive,59,11,70
386570,True,0,1 user reviews,1,0,1
386580,True,0,No user reviews,0,0,0
386590,True,5,Mixed,352,229,581
386600,True,0,4 user reviews,4,0,4
386620,True,8,Very Positive,1140,130,1270
386630,True,0,6 user reviews,3,3,6
386640,True,0,1 user reviews,1,0,1
386650,True,5,Mixed,40,52,92
386690,True,6,Mostly Positive,20,7,27
386700,True,6,Mostly Positive,75,25,100
386710,True,6,Mostly Positive,11,4,15
386720,True,0,No user reviews,0,0,0
386721,True,0,No user reviews,0,0,0
386730,True,0,No user reviews,0,0,0
386740,True,6,Mostly Positive,24,7,31
386750,True,6,Mostly Positive,16,6,22
386760,True,0,2 user reviews,2,0,2
386770,True,6,Mostly Positive,54,20,74
386780,True,0,1 user reviews,0,1,1
386790,True,0,No user reviews,0,0,0
386791,True,0,No user reviews,0,0,0
386792,True,0,No user reviews,0,0,0
386793,True,0,No user reviews,0,0,0
386794,True,0,No user reviews,0,0,0
386795,True,0,No user reviews,0,0,0
386796,True,0,No user reviews,0,0,0
386797,True,0,No user reviews,0,0,0
386798,True,0,No user reviews,0,0,0
386800,True,0,No user reviews,0,0,0
386820,True,0,No user reviews,0,0,0
386830,True,0,No user reviews,0,0,0
386831,True,0,No user reviews,0,0,0
386840,True,7,Positive,18,4,22
386860,True,0,No user reviews,0,0,0
386870,True,5,Mixed,25,12,37
386880,True,5,Mixed,939,495,1434
386890,True,0,No user reviews,0,0,0
386900,True,8,Very Positive,81,8,89
386910,True,0,No user reviews,0,0,0
386911,True,0,No user reviews,0,0,0
386913,True,0,No user reviews,0,0,0
386920,True,0,No user reviews,0,0,0
386930,True,4,Mostly Negative,28,45,73
386940,True,9,Overwhelmingly Positive,5091,167,5258
386960,True,0,5 user reviews,4,1,5
386970,True,7,Positive,29,1,30
386990,True,8,Very Positive,65,12,77
387000,True,0,No user reviews,0,0,0
387010,True,6,Mostly Positive,46,17,63
387020,True,8,Very Positive,76,8,84
387040,True,0,No user reviews,0,0,0
387050,True,0,3 user reviews,2,1,3
387060,True,8,Very Positive,46,7,53
387070,True,0,6 user reviews,1,5,6
387080,True,0,No user reviews,0,0,0
387090,True,5,Mixed,14,16,30
387100,True,7,Positive,21,3,24
387110,True,0,2 user reviews,0,2,2
387120,True,0,1 user reviews,0,1,1
387130,True,0,3 user reviews,1,2,3
387140,True,0,No user reviews,0,0,0
387160,True,0,No user reviews,0,0,0
387170,True,0,1 user reviews,1,0,1
387190,True,0,No user reviews,0,0,0
387230,True,0,No user reviews,0,0,0
387240,True,7,Positive,26,3,29
387260,True,0,No user reviews,0,0,0
387270,True,0,9 user reviews,6,3,9
387280,True,7,Positive,15,2,17
387290,True,9,Overwhelmingly Positive,15109,760,15869
387340,True,8,Very Positive,911,109,1020
387370,True,5,Mixed,175,87,262
387380,True,0,No user reviews,0,0,0
387400,True,0,1 user reviews,1,0,1
387430,True,5,Mixed,20,9,29
387440,True,6,Mostly Positive,238,96,334
387450,True,0,No user reviews,0,0,0
387460,True,0,No user reviews,0,0,0
387470,True,7,Positive,13,0,13
387480,True,0,7 user reviews,7,0,7
387490,True,0,9 user reviews,8,1,9
387500,True,0,5 user reviews,0,5,5
387510,True,0,3 user reviews,2,1,3
387520,True,0,1 user reviews,1,0,1
387530,True,0,3 user reviews,2,1,3
387540,True,0,6 user reviews,6,0,6
387550,True,0,3 user reviews,3,0,3
387560,True,6,Mostly Positive,15,4,19
387570,True,0,3 user reviews,3,0,3
387580,True,0,No user reviews,0,0,0
387590,True,0,2 user reviews,2,0,2
387600,True,0,2 user reviews,1,1,2
387610,True,0,4 user reviews,3,1,4
387620,True,7,Positive,10,0,10
387630,True,0,3 user reviews,3,0,3
387640,True,7,Positive,12,2,14
387650,True,0,3 user reviews,1,2,3
387660,True,7,Positive,14,0,14
387670,True,0,No user reviews,0,0,0
387680,True,0,8 user reviews,7,1,8
387690,True,0,6 user reviews,6,0,6
387700,True,0,No user reviews,0,0,0
387740,True,0,No user reviews,0,0,0
387741,True,0,No user reviews,0,0,0
387742,True,0,No user reviews,0,0,0
387743,True,0,No user reviews,0,0,0
387744,True,0,No user reviews,0,0,0
387745,True,0,No user reviews,0,0,0
387770,True,0,2 user reviews,2,0,2
387780,True,0,1 user reviews,1,0,1
387790,True,0,No user reviews,0,0,0
387800,True,0,No user reviews,0,0,0
387810,True,0,No user reviews,0,0,0
387820,True,0,No user reviews,0,0,0
387840,True,8,Very Positive,48,11,59
387850,True,7,Positive,26,4,30
387860,True,7,Positive,36,8,44
387870,True,6,Mostly Positive,30,11,41
387880,True,5,Mixed,9,6,15
387890,True,0,1 user reviews,0,1,1
387910,True,0,No user reviews,0,0,0
387920,True,0,7 user reviews,7,0,7
387921,True,0,4 user reviews,4,0,4
387930,True,5,Mixed,50,45,95
387960,True,0,5 user reviews,2,3,5
387970,True,0,4 user reviews,3,1,4
387980,True,7,Positive,28,2,30
387981,True,0,4 user reviews,4,0,4
387982,True,0,3 user reviews,3,0,3
387983,True,0,3 user reviews,2,1,3
387984,True,7,Positive,10,0,10
387990,True,8,Very Positive,21749,2183,23932
388000,True,0,4 user reviews,4,0,4
388010,True,0,4 user reviews,3,1,4
388020,True,0,7 user reviews,5,2,7
388030,True,0,No user reviews,0,0,0
388050,True,5,Mixed,6,5,11
388060,True,5,Mixed,144,104,248
388070,True,0,No user reviews,0,0,0
388080,True,8,Very Positive,1224,211,1435
388090,True,8,Very Positive,4068,329,4397
388140,True,6,Mostly Positive,9,3,12
388160,True,3,Negative,1,9,10
388210,True,9,Overwhelmingly Positive,1246,32,1278
388260,True,6,Mostly Positive,13,4,17
388270,True,7,Positive,19,3,22
388280,True,0,4 user reviews,2,2,4
388300,True,4,Mostly Negative,3,11,14
388310,True,0,No user reviews,0,0,0
388320,True,6,Mostly Positive,403,120,523
388340,True,6,Mostly Positive,186,53,239
388350,True,0,No user reviews,0,0,0
388360,True,5,Mixed,25,17,42
388370,True,0,3 user reviews,1,2,3
388390,True,0,4 user reviews,2,2,4
388410,True,6,Mostly Positive,2018,783,2801
388420,True,8,Very Positive,49,7,56
388430,True,6,Mostly Positive,29,9,38
388440,True,0,8 user reviews,2,6,8
388450,True,8,Very Positive,105,3,108
388470,True,8,Very Positive,328,25,353
388471,True,8,Very Positive,73,5,78
388472,True,7,Positive,20,4,24
388473,True,0,No user reviews,0,0,0
388474,True,5,Mixed,20,13,33
388475,True,8,Very Positive,103,9,112
388476,True,0,7 user reviews,6,1,7
388477,True,6,Mostly Positive,107,35,142
388479,True,7,Positive,12,1,13
388480,True,0,No user reviews,0,0,0
388490,True,6,Mostly Positive,8,3,11
388500,True,0,2 user reviews,1,1,2
388520,True,0,No user reviews,0,0,0
388540,True,0,3 user reviews,2,1,3
388550,True,5,Mixed,6,6,12
388580,True,0,1 user reviews,0,1,1
388600,True,7,Positive,11,2,13
388620,True,8,Very Positive,77,8,85
388660,True,4,Mostly Negative,3,9,12
388670,True,0,No user reviews,0,0,0
388680,True,5,Mixed,13,7,20
388700,True,0,No user reviews,0,0,0
388710,True,0,1 user reviews,1,0,1
388720,True,6,Mostly Positive,21,6,27
388730,True,8,Very Positive,47,4,51
388750,True,9,Overwhelmingly Positive,671,32,703
388790,True,7,Positive,31,2,33
388800,True,8,Very Positive,404,79,483
388810,True,0,No user reviews,0,0,0
388830,True,0,1 user reviews,0,1,1
388840,True,0,4 user reviews,2,2,4
388880,True,8,Very Positive,4390,311,4701
388900,True,6,Mostly Positive,52,22,74
388910,True,7,Positive,15,0,15
388950,True,0,No user reviews,0,0,0
388960,True,0,6 user reviews,5,1,6
388970,True,7,Positive,40,9,49
388980,True,5,Mixed,44,34,78
389010,True,0,No user reviews,0,0,0
389040,True,5,Mixed,263,298,561
389050,True,6,Mostly Positive,77,26,103
389090,True,0,No user reviews,0,0,0
389120,True,5,Mixed,7,4,11
389140,True,8,Very Positive,599,51,650
389150,True,7,Positive,30,0,30
389160,True,5,Mixed,15,20,35
389170,True,8,Very Positive,46,7,53
389180,True,0,No user reviews,0,0,0
389190,True,5,Mixed,25,16,41
389220,True,5,Mixed,120,63,183
389230,True,0,4 user reviews,1,3,4
389240,True,7,Positive,21,0,21
389250,True,0,3 user reviews,2,1,3
389260,True,8,Very Positive,53,10,63
389270,True,6,Mostly Positive,31,13,44
389280,True,5,Mixed,455,327,782
389291,True,0,No user reviews,0,0,0
389300,True,0,1 user reviews,1,0,1
389310,True,5,Mixed,6,5,11
389330,True,0,6 user reviews,1,5,6
389350,True,0,No user reviews,0,0,0
389370,True,0,No user reviews,0,0,0
389380,True,0,No user reviews,0,0,0
389400,True,5,Mixed,11,5,16
389420,True,6,Mostly Positive,7,3,10
389421,True,7,Positive,17,2,19
389430,True,4,Mostly Negative,9,16,25
389440,True,0,No user reviews,0,0,0
389460,True,4,Mostly Negative,14,34,48
389470,True,6,Mostly Positive,13,5,18
389509,True,0,No user reviews,0,0,0
389510,True,8,Very Positive,1029,63,1092
389540,True,0,No user reviews,0,0,0
389570,True,6,Mostly Positive,57,15,72
389591,True,0,No user reviews,0,0,0
389600,True,0,No user reviews,0,0,0
389610,True,0,No user reviews,0,0,0
389620,True,0,No user reviews,0,0,0
389630,True,0,No user reviews,0,0,0
389650,True,8,Very Positive,94,6,100
389670,True,6,Mostly Positive,200,69,269
389680,True,0,4 user reviews,1,3,4
389690,True,0,1 user reviews,0,1,1
389700,True,4,Mostly Negative,25,66,91
389710,True,0,2 user reviews,2,0,2
389720,True,8,Very Positive,111,8,119
389730,True,8,Very Positive,11633,1160,12793
389740,True,5,Mixed,5,5,10
389750,True,0,2 user reviews,2,0,2
389770,True,0,No user reviews,0,0,0
389800,True,0,No user reviews,0,0,0
389810,True,5,Mixed,9,9,18
389830,True,0,2 user reviews,2,0,2
389840,True,5,Mixed,16,16,32
389870,True,5,Mixed,103,60,163
389900,True,5,Mixed,65,50,115
389910,True,0,No user reviews,0,0,0
389911,True,0,No user reviews,0,0,0
389912,True,0,1 user reviews,1,0,1
389913,True,0,No user reviews,0,0,0
389914,True,0,No user reviews,0,0,0
389915,True,0,No user reviews,0,0,0
389916,True,0,No user reviews,0,0,0
389917,True,0,No user reviews,0,0,0
389920,True,0,No user reviews,0,0,0
389921,True,0,No user reviews,0,0,0
389922,True,0,No user reviews,0,0,0
389930,True,5,Mixed,12,9,21
389940,True,0,3 user reviews,3,0,3
389950,True,0,No user reviews,0,0,0
389960,True,0,No user reviews,0,0,0
389970,True,0,2 user reviews,1,1,2
389980,True,0,No user reviews,0,0,0
389990,True,0,1 user reviews,1,0,1
390020,True,0,No user reviews,0,0,0
390030,True,6,Mostly Positive,201,57,258
390040,True,6,Mostly Positive,42,11,53
390060,True,0,No user reviews,0,0,0
390070,True,0,No user reviews,0,0,0
390090,True,0,No user reviews,0,0,0
390100,True,5,Mixed,29,17,46
390120,True,0,No user reviews,0,0,0
390160,True,0,No user reviews,0,0,0
390180,True,0,8 user reviews,5,3,8
390200,True,5,Mixed,34,20,54
390210,True,5,Mixed,35,19,54
390220,True,5,Mixed,17,11,28
390230,True,0,No user reviews,0,0,0
390290,True,8,Very Positive,168,28,196
390310,True,5,Mixed,89,58,147
390320,True,0,No user reviews,0,0,0
390330,True,6,Mostly Positive,38,10,48
390340,True,4,Mostly Negative,113,189,302
390360,True,0,No user reviews,0,0,0
390361,True,0,No user reviews,0,0,0
390362,True,0,1 user reviews,1,0,1
390363,True,0,1 user reviews,1,0,1
390364,True,0,No user reviews,0,0,0
390365,True,0,No user reviews,0,0,0
390366,True,0,1 user reviews,1,0,1
390367,True,0,1 user reviews,1,0,1
390368,True,0,No user reviews,0,0,0
390369,True,0,No user reviews,0,0,0
390370,True,0,No user reviews,0,0,0
390371,True,0,1 user reviews,1,0,1
390372,True,0,No user reviews,0,0,0
390373,True,0,No user reviews,0,0,0
390374,True,0,2 user reviews,2,0,2
390375,True,0,No user reviews,0,0,0
390376,True,0,1 user reviews,1,0,1
390377,True,0,3 user reviews,3,0,3
390378,True,0,No user reviews,0,0,0
390379,True,0,1 user reviews,1,0,1
390380,True,0,No user reviews,0,0,0
390381,True,0,2 user reviews,2,0,2
390382,True,0,No user reviews,0,0,0
390383,True,0,1 user reviews,1,0,1
390384,True,0,No user reviews,0,0,0
390385,True,0,No user reviews,0,0,0
390386,True,0,No user reviews,0,0,0
390387,True,0,No user reviews,0,0,0
390388,True,0,No user reviews,0,0,0
390389,True,0,5 user reviews,5,0,5
390390,True,0,1 user reviews,1,0,1
390391,True,0,No user reviews,0,0,0
390392,True,0,No user reviews,0,0,0
390393,True,0,1 user reviews,1,0,1
390394,True,0,No user reviews,0,0,0
390395,True,0,No user reviews,0,0,0
390396,True,0,No user reviews,0,0,0
390397,True,0,No user reviews,0,0,0
390398,True,0,No user reviews,0,0,0
390399,True,0,3 user reviews,2,1,3
390400,True,0,No user reviews,0,0,0
390401,True,0,No user reviews,0,0,0
390402,True,0,1 user reviews,0,1,1
390403,True,0,2 user reviews,2,0,2
390404,True,0,1 user reviews,1,0,1
390405,True,0,No user reviews,0,0,0
390406,True,0,No user reviews,0,0,0
390407,True,0,1 user reviews,0,1,1
390408,True,0,No user reviews,0,0,0
390409,True,0,No user reviews,0,0,0
390410,True,0,No user reviews,0,0,0
390411,True,0,2 user reviews,1,1,2
390412,True,0,2 user reviews,2,0,2
390413,True,0,No user reviews,0,0,0
390414,True,0,No user reviews,0,0,0
390415,True,0,No user reviews,0,0,0
390416,True,0,No user reviews,0,0,0
390417,True,0,1 user reviews,1,0,1
390418,True,0,No user reviews,0,0,0
390419,True,0,No user reviews,0,0,0
390420,True,0,No user reviews,0,0,0
390421,True,0,No user reviews,0,0,0
390422,True,0,No user reviews,0,0,0
390423,True,0,1 user reviews,1,0,1
390424,True,0,No user reviews,0,0,0
390425,True,0,No user reviews,0,0,0
390426,True,0,No user reviews,0,0,0
390427,True,0,No user reviews,0,0,0
390428,True,0,No user reviews,0,0,0
390429,True,0,3 user reviews,3,0,3
390430,True,0,3 user reviews,2,1,3
390431,True,0,No user reviews,0,0,0
390432,True,0,2 user reviews,2,0,2
390433,True,0,1 user reviews,0,1,1
390434,True,0,1 user reviews,1,0,1
390435,True,0,6 user reviews,6,0,6
390436,True,0,No user reviews,0,0,0
390437,True,0,No user reviews,0,0,0
390438,True,0,No user reviews,0,0,0
390439,True,0,2 user reviews,2,0,2
390440,True,0,No user reviews,0,0,0
390441,True,0,1 user reviews,1,0,1
390442,True,0,No user reviews,0,0,0
390443,True,0,No user reviews,0,0,0
390444,True,0,1 user reviews,1,0,1
390445,True,0,4 user reviews,3,1,4
390446,True,0,No user reviews,0,0,0
390447,True,0,1 user reviews,1,0,1
390448,True,0,No user reviews,0,0,0
390449,True,0,No user reviews,0,0,0
390450,True,0,No user reviews,0,0,0
390451,True,0,4 user reviews,4,0,4
390452,True,0,No user reviews,0,0,0
390453,True,0,No user reviews,0,0,0
390454,True,0,No user reviews,0,0,0
390455,True,0,No user reviews,0,0,0
390456,True,0,No user reviews,0,0,0
390457,True,0,No user reviews,0,0,0
390458,True,0,No user reviews,0,0,0
390459,True,0,1 user reviews,1,0,1
390460,True,0,5 user reviews,3,2,5
390470,True,0,2 user reviews,2,0,2
390480,True,0,No user reviews,0,0,0
390490,True,0,3 user reviews,3,0,3
390510,True,4,Mostly Negative,11,26,37
390520,True,8,Very Positive,607,74,681
390540,True,0,6 user reviews,3,3,6
390560,True,8,Very Positive,316,47,363
390570,True,4,Mostly Negative,9,16,25
390580,True,7,Positive,15,0,15
390590,True,0,No user reviews,0,0,0
390610,True,8,Very Positive,131,10,141
390620,True,0,2 user reviews,2,0,2
390630,True,0,No user reviews,0,0,0
390640,True,0,No user reviews,0,0,0
390650,True,0,7 user reviews,6,1,7
390651,True,7,Positive,16,2,18
390652,True,7,Positive,14,1,15
390653,True,0,4 user reviews,4,0,4
390654,True,0,5 user reviews,4,1,5
390655,True,7,Positive,26,2,28
390656,True,0,8 user reviews,7,1,8
390657,True,0,7 user reviews,7,0,7
390658,True,0,2 user reviews,2,0,2
390659,True,0,2 user reviews,2,0,2
390660,True,6,Mostly Positive,103,37,140
390670,True,8,Very Positive,43,9,52
390680,True,7,Positive,11,0,11
390690,True,0,No user reviews,0,0,0
390710,True,8,Very Positive,83,8,91
390720,True,8,Very Positive,177,10,187
390730,True,8,Very Positive,112,6,118
390740,True,0,6 user reviews,3,3,6
390750,True,0,2 user reviews,2,0,2
390760,True,0,No user reviews,0,0,0
390790,True,0,No user reviews,0,0,0
390791,True,0,No user reviews,0,0,0
390792,True,0,No user reviews,0,0,0
390800,True,0,No user reviews,0,0,0
390870,True,6,Mostly Positive,18,7,25
390880,True,5,Mixed,22,19,41
390890,True,8,Very Positive,51,3,54
390910,True,6,Mostly Positive,35,11,46
390920,True,7,Positive,25,3,28
390930,True,6,Mostly Positive,9,3,12
390940,True,6,Mostly Positive,10,4,14
390960,True,0,No user reviews,0,0,0
390980,True,0,3 user reviews,3,0,3
391000,True,7,Positive,26,3,29
391010,True,0,No user reviews,0,0,0
391030,True,7,Positive,18,2,20
391040,True,8,Very Positive,906,176,1082
391050,True,7,Positive,12,3,15
391070,True,4,Mostly Negative,115,262,377
391080,True,0,1 user reviews,1,0,1
391100,True,0,2 user reviews,1,1,2
391120,True,0,9 user reviews,5,4,9
391130,True,0,5 user reviews,2,3,5
391140,True,7,Positive,29,4,33
391150,True,0,No user reviews,0,0,0
391160,True,6,Mostly Positive,57,22,79
391170,True,8,Very Positive,106,17,123
391180,True,7,Positive,11,2,13
391190,True,0,1 user reviews,1,0,1
391200,True,0,No user reviews,0,0,0
391210,True,0,1 user reviews,1,0,1
391220,True,8,Very Positive,14739,1395,16134
391240,True,0,3 user reviews,3,0,3
391250,True,8,Very Positive,65,11,76
391260,True,5,Mixed,299,140,439
391270,True,7,Positive,36,7,43
391280,True,5,Mixed,93,55,148
391290,True,0,2 user reviews,2,0,2
391310,True,8,Very Positive,47,8,55
391340,True,4,Mostly Negative,9,18,27
391380,True,0,3 user reviews,2,1,3
391390,True,7,Positive,10,2,12
391400,True,0,1 user reviews,0,1,1
391410,True,0,2 user reviews,0,2,2
391420,True,6,Mostly Positive,133,44,177
391440,True,5,Mixed,14,12,26
391450,True,0,No user reviews,0,0,0
391460,True,5,Mixed,83,51,134
391470,True,0,No user reviews,0,0,0
391480,True,0,No user reviews,0,0,0
391490,True,8,Very Positive,90,12,102
391510,True,7,Positive,16,0,16
391520,True,0,6 user reviews,3,3,6
391530,True,0,7 user reviews,5,2,7
391540,True,9,Overwhelmingly Positive,73575,3012,76587
391550,True,5,Mixed,8,7,15
391570,True,9,Overwhelmingly Positive,1086,35,1121
391580,True,8,Very Positive,51,7,58
391590,True,5,Mixed,5,6,11
391600,True,5,Mixed,13,12,25
391610,True,0,1 user reviews,1,0,1
391630,True,0,2 user reviews,1,1,2
391640,True,5,Mixed,9,5,14
391650,True,0,2 user reviews,2,0,2
391660,True,7,Positive,17,2,19
391680,True,8,Very Positive,754,49,803
391720,True,8,Very Positive,3648,462,4110
391730,True,8,Very Positive,1075,128,1203
391740,True,5,Mixed,14,17,31
391750,True,0,No user reviews,0,0,0
391780,True,0,6 user reviews,6,0,6
391820,True,4,Mostly Negative,4,12,16
391830,True,0,1 user reviews,1,0,1
391840,True,0,No user reviews,0,0,0
391860,True,5,Mixed,8,7,15
391880,True,0,4 user reviews,4,0,4
391900,True,0,3 user reviews,3,0,3
391910,True,0,6 user reviews,1,5,6
391920,True,0,No user reviews,0,0,0
391930,True,0,2 user reviews,2,0,2
391940,True,0,No user reviews,0,0,0
391950,True,0,1 user reviews,1,0,1
391960,True,0,1 user reviews,1,0,1
392000,True,8,Very Positive,157,37,194
392020,True,8,Very Positive,61,5,66
392030,True,7,Positive,22,2,24
392040,True,7,Positive,13,3,16
392060,True,0,No user reviews,0,0,0
392070,True,8,Very Positive,70,11,81
392080,True,6,Mostly Positive,137,48,185
392090,True,0,2 user reviews,1,1,2
392100,True,0,4 user reviews,4,0,4
392110,True,8,Very Positive,4814,1050,5864
392120,True,0,7 user reviews,1,6,7
392150,True,0,4 user reviews,3,1,4
392160,True,6,Mostly Positive,3256,1270,4526
392190,True,6,Mostly Positive,42,18,60
392230,True,0,2 user reviews,2,0,2
392240,True,0,No user reviews,0,0,0
392260,True,6,Mostly Positive,61,20,81
392280,True,5,Mixed,50,48,98
392290,True,0,No user reviews,0,0,0
392300,True,0,No user reviews,0,0,0
392320,True,0,No user reviews,0,0,0
392330,True,7,Positive,32,3,35
392340,True,0,No user reviews,0,0,0
392370,True,0,4 user reviews,3,1,4
392390,True,0,No user reviews,0,0,0
392400,True,0,3 user reviews,2,1,3
392410,True,6,Mostly Positive,39,12,51
392420,True,0,1 user reviews,1,0,1
392430,True,0,2 user reviews,1,1,2
392440,True,0,No user reviews,0,0,0
392450,True,0,3 user reviews,2,1,3
392470,True,8,Very Positive,311,61,372
392580,True,5,Mixed,263,113,376
392600,True,0,4 user reviews,3,1,4
392610,True,7,Positive,11,1,12
392620,True,7,Positive,12,2,14
392630,True,0,2 user reviews,2,0,2
392640,True,0,No user reviews,0,0,0
392641,True,0,No user reviews,0,0,0
392642,True,0,1 user reviews,1,0,1
392643,True,0,1 user reviews,1,0,1
392644,True,0,No user reviews,0,0,0
392645,True,0,1 user reviews,1,0,1
392646,True,0,No user reviews,0,0,0
392647,True,0,No user reviews,0,0,0
392660,True,0,No user reviews,0,0,0
392670,True,0,4 user reviews,4,0,4
392680,True,6,Mostly Positive,18,5,23
392690,True,0,1 user reviews,1,0,1
392720,True,0,No user reviews,0,0,0
392730,True,0,4 user reviews,2,2,4
392760,True,0,2 user reviews,1,1,2
392780,True,0,9 user reviews,7,2,9
392790,True,6,Mostly Positive,13,4,17
392810,True,0,No user reviews,0,0,0
392820,True,5,Mixed,11,13,24
392830,True,0,No user reviews,0,0,0
392840,True,0,No user reviews,0,0,0
392860,True,7,Positive,12,0,12
392880,True,0,1 user reviews,0,1,1
392890,True,0,7 user reviews,0,7,7
392900,True,0,4 user reviews,2,2,4
392920,True,5,Mixed,16,9,25
392930,True,5,Mixed,8,9,17
392940,True,5,Mixed,11,5,16
392950,True,8,Very Positive,76,10,86
392960,True,0,No user reviews,0,0,0
392970,True,8,Very Positive,100,11,111
392980,True,0,No user reviews,0,0,0
393010,True,9,Overwhelmingly Positive,1038,41,1079
393020,True,0,9 user reviews,7,2,9
393021,True,0,4 user reviews,2,2,4
393022,True,0,No user reviews,0,0,0
393023,True,0,1 user reviews,1,0,1
393024,True,0,3 user reviews,0,3,3
393025,True,0,2 user reviews,0,2,2
393026,True,0,7 user reviews,5,2,7
393040,True,0,5 user reviews,2,3,5
393041,True,0,3 user reviews,1,2,3
393042,True,0,6 user reviews,1,5,6
393043,True,0,4 user reviews,3,1,4
393080,True,5,Mixed,674,556,1230
393100,True,0,No user reviews,0,0,0
393150,True,5,Mixed,18,8,26
393160,True,0,No user reviews,0,0,0
393170,True,0,4 user reviews,4,0,4
393190,True,8,Very Positive,119,7,126
393200,True,8,Very Positive,310,49,359
393220,True,7,Positive,21,2,23
393230,True,3,Negative,2,16,18
393240,True,5,Mixed,6,4,10
393250,True,0,No user reviews,0,0,0
393270,True,0,No user reviews,0,0,0
393280,True,0,No user reviews,0,0,0
393290,True,4,Mostly Negative,3,7,10
393320,True,7,Positive,9,1,10
393330,True,0,5 user reviews,2,3,5
393340,True,0,4 user reviews,1,3,4
393350,True,6,Mostly Positive,16,6,22
393360,True,0,2 user reviews,1,1,2
393380,True,8,Very Positive,26109,2918,29027
393390,True,4,Mostly Negative,17,26,43
393400,True,0,No user reviews,0,0,0
393410,True,0,2 user reviews,1,1,2
393420,True,5,Mixed,2910,1666,4576
393430,True,8,Very Positive,113,25,138
393460,True,4,Mostly Negative,4,7,11
393480,True,7,Positive,11,1,12
393500,True,0,1 user reviews,1,0,1
393510,True,0,3 user reviews,3,0,3
393520,True,8,Very Positive,1049,175,1224
393530,True,5,Mixed,14,7,21
393540,True,0,3 user reviews,1,2,3
393550,True,6,Mostly Positive,13,5,18
393560,True,0,4 user reviews,4,0,4
393600,True,0,6 user reviews,6,0,6
393610,True,6,Mostly Positive,54,22,76
393630,True,0,1 user reviews,1,0,1
393640,True,0,2 user reviews,2,0,2
393650,True,0,2 user reviews,2,0,2
393660,True,5,Mixed,7,6,13
393690,True,0,No user reviews,0,0,0
393700,True,0,1 user reviews,0,1,1
393710,True,0,No user reviews,0,0,0
393720,True,0,No user reviews,0,0,0
393730,True,0,2 user reviews,1,1,2
393740,True,0,4 user reviews,2,2,4
393750,True,5,Mixed,72,36,108
393770,True,0,2 user reviews,2,0,2
393790,True,0,3 user reviews,3,0,3
393800,True,6,Mostly Positive,17,5,22
393820,True,3,Negative,3,19,22
393830,True,0,5 user reviews,2,3,5
393831,True,0,6 user reviews,5,1,6
393850,True,0,No user reviews,0,0,0
393860,True,5,Mixed,6,6,12
393910,True,0,No user reviews,0,0,0
393920,True,5,Mixed,65,69,134
393930,True,0,3 user reviews,0,3,3
393950,True,0,1 user reviews,1,0,1
393970,True,0,8 user reviews,6,2,8
393980,True,8,Very Positive,156,30,186
393990,True,0,No user reviews,0,0,0
394000,True,0,2 user reviews,2,0,2
394010,True,0,6 user reviews,1,5,6
394030,True,7,Positive,20,1,21
394040,True,0,No user reviews,0,0,0
394050,True,0,No user reviews,0,0,0
394060,True,0,1 user reviews,0,1,1
394061,True,0,No user reviews,0,0,0
394080,True,0,1 user reviews,1,0,1
394090,True,0,2 user reviews,2,0,2
394120,True,0,3 user reviews,1,2,3
394130,True,8,Very Positive,76,4,80
394140,True,6,Mostly Positive,17,5,22
394160,True,8,Very Positive,185,27,212
394170,True,0,No user reviews,0,0,0
394190,True,0,No user reviews,0,0,0
394200,True,0,No user reviews,0,0,0
394201,True,0,No user reviews,0,0,0
394220,True,8,Very Positive,60,14,74
394230,True,5,Mixed,1430,785,2215
394250,True,6,Mostly Positive,14,5,19
394260,True,0,6 user reviews,5,1,6
394270,True,0,6 user reviews,3,3,6
394280,True,5,Mixed,15,16,31
394290,True,7,Positive,20,1,21
394310,True,6,Mostly Positive,1607,664,2271
394320,True,5,Mixed,175,180,355
394321,True,4,Mostly Negative,17,29,46
394340,True,0,2 user reviews,2,0,2
394350,True,0,No user reviews,0,0,0
394360,True,8,Very Positive,38159,3669,41828
394370,True,0,No user reviews,0,0,0
394380,True,4,Mostly Negative,4,7,11
394390,True,7,Positive,11,2,13
394400,True,0,2 user reviews,0,2,2
394410,True,0,No user reviews,0,0,0
394420,True,0,1 user reviews,0,1,1
394421,True,0,No user reviews,0,0,0
394422,True,0,No user reviews,0,0,0
394423,True,0,No user reviews,0,0,0
394424,True,0,No user reviews,0,0,0
394425,True,0,No user reviews,0,0,0
394426,True,0,No user reviews,0,0,0
394427,True,0,No user reviews,0,0,0
394430,True,7,Positive,11,2,13
394450,True,5,Mixed,219,118,337
394480,True,0,1 user reviews,0,1,1
394490,True,4,Mostly Negative,11,25,36
394510,True,8,Very Positive,4653,444,5097
394540,True,6,Mostly Positive,131,45,176
394550,True,7,Positive,44,2,46
394560,True,0,1 user reviews,1,0,1
394561,True,0,1 user reviews,1,0,1
394600,True,6,Mostly Positive,89,29,118
394650,True,0,2 user reviews,1,1,2
394680,True,6,Mostly Positive,51,18,69
394690,True,8,Very Positive,4861,590,5451
394700,True,6,Mostly Positive,49,15,64
394710,True,0,No user reviews,0,0,0
394720,True,0,No user reviews,0,0,0
394750,True,0,1 user reviews,1,0,1
394760,True,6,Mostly Positive,564,205,769
394770,True,0,5 user reviews,0,5,5
394782,True,0,No user reviews,0,0,0
394783,True,0,No user reviews,0,0,0
394790,True,0,No user reviews,0,0,0
394810,True,0,No user reviews,0,0,0
394811,True,0,2 user reviews,1,1,2
394840,True,4,Mostly Negative,12,24,36
394850,True,6,Mostly Positive,68,19,87
394870,True,6,Mostly Positive,199,75,274
394890,True,0,5 user reviews,5,0,5
394900,True,6,Mostly Positive,7,3,10
394910,True,0,5 user reviews,1,4,5
394920,True,5,Mixed,12,8,20
394930,True,0,7 user reviews,3,4,7
394940,True,5,Mixed,9,5,14
394950,True,0,6 user reviews,6,0,6
394960,True,0,2 user reviews,2,0,2
394970,True,9,Overwhelmingly Positive,1840,92,1932
394990,True,0,1 user reviews,0,1,1
395020,True,0,3 user reviews,3,0,3
395040,True,0,No user reviews,0,0,0
395050,True,0,4 user reviews,4,0,4
395051,True,0,No user reviews,0,0,0
395060,True,0,No user reviews,0,0,0
395070,True,0,No user reviews,0,0,0
395100,True,0,4 user reviews,2,2,4
395140,True,7,Positive,10,0,10
395150,True,5,Mixed,6,8,14
395160,True,5,Mixed,72,65,137
395170,True,8,Very Positive,756,89,845
395180,True,8,Very Positive,881,211,1092
395190,True,0,7 user reviews,7,0,7
395200,True,6,Mostly Positive,505,147,652
395210,True,0,No user reviews,0,0,0
395230,True,7,Positive,26,3,29
395231,True,7,Positive,9,1,10
395232,True,7,Positive,18,3,21
395233,True,7,Positive,22,2,24
395234,True,7,Positive,17,2,19
395235,True,7,Positive,16,1,17
395236,True,7,Positive,12,1,13
395237,True,7,Positive,11,1,12
395238,True,7,Positive,11,0,11
395239,True,7,Positive,21,4,25
395250,True,6,Mostly Positive,20,8,28
395260,True,7,Positive,14,1,15
395270,True,6,Mostly Positive,144,40,184
395290,True,0,No user reviews,0,0,0
395300,True,0,No user reviews,0,0,0
395310,True,0,2 user reviews,0,2,2
395350,True,5,Mixed,115,76,191
395370,True,0,No user reviews,0,0,0
395380,True,5,Mixed,13,7,20
395400,True,5,Mixed,7,8,15
395410,True,0,6 user reviews,3,3,6
395420,True,6,Mostly Positive,49,18,67
395440,True,0,No user reviews,0,0,0
395441,True,0,2 user reviews,2,0,2
395450,True,0,No user reviews,0,0,0
395460,True,0,3 user reviews,2,1,3
395470,True,5,Mixed,18,13,31
395480,True,0,2 user reviews,2,0,2
395500,True,8,Very Positive,119,21,140
395510,True,0,No user reviews,0,0,0
395520,True,7,Positive,26,6,32
395530,True,0,5 user reviews,5,0,5
395550,True,0,8 user reviews,7,1,8
395560,True,4,Mostly Negative,18,29,47
395570,True,5,Mixed,93,74,167
395580,True,0,4 user reviews,3,1,4
395600,True,6,Mostly Positive,36,14,50
395620,True,8,Very Positive,135,25,160
395640,True,0,2 user reviews,0,2,2
395690,True,0,No user reviews,0,0,0
395700,True,0,1 user reviews,1,0,1
395760,True,6,Mostly Positive,42,14,56
395830,True,0,No user reviews,0,0,0
395850,True,8,Very Positive,205,40,245
395860,True,6,Mostly Positive,63,23,86
395880,True,5,Mixed,6,4,10
395890,True,0,8 user reviews,6,2,8
395900,True,5,Mixed,42,30,72
395910,True,0,6 user reviews,2,4,6
395920,True,0,3 user reviews,3,0,3
395930,True,6,Mostly Positive,13,4,17
395940,True,0,2 user reviews,2,0,2
395950,True,0,4 user reviews,4,0,4
395960,True,0,4 user reviews,2,2,4
395970,True,0,No user reviews,0,0,0
395990,True,7,Positive,12,1,13
396010,True,0,1 user reviews,1,0,1
396030,True,6,Mostly Positive,15,5,20
396060,True,0,6 user reviews,5,1,6
396090,True,6,Mostly Positive,106,43,149
396160,True,4,Mostly Negative,86,173,259
396170,True,7,Positive,11,2,13
396171,True,4,Mostly Negative,14,24,38
396172,True,5,Mixed,12,18,30
396173,True,0,7 user reviews,5,2,7
396190,True,0,No user reviews,0,0,0
396220,True,0,No user reviews,0,0,0
396230,True,8,Very Positive,118,29,147
396240,True,0,No user reviews,0,0,0
396250,True,0,No user reviews,0,0,0
396260,True,7,Positive,27,3,30
396280,True,7,Positive,17,3,20
396290,True,0,No user reviews,0,0,0
396310,True,8,Very Positive,214,40,254
396320,True,6,Mostly Positive,10,3,13
396350,True,8,Very Positive,260,10,270
396360,True,5,Mixed,40,25,65
396420,True,0,No user reviews,0,0,0
396430,True,0,No user reviews,0,0,0
396431,True,0,No user reviews,0,0,0
396432,True,0,No user reviews,0,0,0
396433,True,0,No user reviews,0,0,0
396434,True,0,1 user reviews,0,1,1
396435,True,0,1 user reviews,0,1,1
396440,True,0,1 user reviews,1,0,1
396450,True,0,5 user reviews,3,2,5
396460,True,0,3 user reviews,3,0,3
396470,True,0,No user reviews,0,0,0
396480,True,6,Mostly Positive,344,96,440
396490,True,0,No user reviews,0,0,0
396510,True,0,No user reviews,0,0,0
396520,True,0,No user reviews,0,0,0
396530,True,3,Negative,0,11,11
396540,True,0,No user reviews,0,0,0
396560,True,6,Mostly Positive,44,18,62
396590,True,6,Mostly Positive,18,6,24
396610,True,0,2 user reviews,0,2,2
396620,True,0,No user reviews,0,0,0
396640,True,8,Very Positive,157,22,179
396650,True,9,Overwhelmingly Positive,1069,45,1114
396660,True,5,Mixed,36,19,55
396680,True,5,Mixed,28,15,43
396690,True,0,3 user reviews,3,0,3
396700,True,0,6 user reviews,5,1,6
396710,True,8,Very Positive,296,23,319
396730,True,0,1 user reviews,0,1,1
396740,True,0,No user reviews,0,0,0
396750,True,6,Mostly Positive,2904,763,3667
396760,True,0,1 user reviews,1,0,1
396780,True,0,No user reviews,0,0,0
396790,True,6,Mostly Positive,201,76,277
396800,True,8,Very Positive,91,14,105
396810,True,0,3 user reviews,3,0,3
396820,True,0,6 user reviews,3,3,6
396830,True,5,Mixed,11,12,23
396850,True,4,Mostly Negative,9,16,25
396860,True,8,Very Positive,125,19,144
396870,True,5,Mixed,7,6,13
396890,True,8,Very Positive,133,24,157
396900,True,8,Very Positive,1232,170,1402
396910,True,0,No user reviews,0,0,0
396920,True,0,9 user reviews,9,0,9
396930,True,0,8 user reviews,4,4,8
396940,True,0,8 user reviews,8,0,8
396960,True,0,No user reviews,0,0,0
396990,True,7,Positive,11,0,11
397000,True,0,1 user reviews,1,0,1
397010,True,0,No user reviews,0,0,0
397020,True,0,2 user reviews,1,1,2
397030,True,7,Positive,37,2,39
397040,True,0,No user reviews,0,0,0
397050,True,0,No user reviews,0,0,0
397060,True,8,Very Positive,455,81,536
397080,True,0,No user reviews,0,0,0
397090,True,6,Mostly Positive,24,9,33
397100,True,7,Positive,10,1,11
397120,True,0,3 user reviews,1,2,3
397121,True,0,8 user reviews,5,3,8
397122,True,0,2 user reviews,1,1,2
397124,True,0,No user reviews,0,0,0
397125,True,0,8 user reviews,6,2,8
397140,True,0,No user reviews,0,0,0
397150,True,5,Mixed,104,66,170
397160,True,8,Very Positive,126,26,152
397170,True,0,No user reviews,0,0,0
397180,True,6,Mostly Positive,18,6,24
397190,True,6,Mostly Positive,41,12,53
397200,True,5,Mixed,8,8,16
397210,True,5,Mixed,32,16,48
397220,True,0,1 user reviews,1,0,1
397230,True,0,No user reviews,0,0,0
397240,True,0,8 user reviews,5,3,8
397270,True,8,Very Positive,275,30,305
397310,True,5,Mixed,39,18,57
397320,True,3,Negative,2,10,12
397330,True,8,Very Positive,66,12,78
397340,True,8,Very Positive,3967,343,4310
397350,True,9,Overwhelmingly Positive,478,22,500
397360,True,0,1 user reviews,0,1,1
397370,True,0,7 user reviews,6,1,7
397380,True,0,3 user reviews,3,0,3
397381,True,0,3 user reviews,3,0,3
397390,True,5,Mixed,114,53,167
397400,True,7,Positive,9,1,10
397420,True,5,Mixed,21,25,46
397430,True,8,Very Positive,471,30,501
397440,True,0,5 user reviews,4,1,5
397460,True,9,Overwhelmingly Positive,762,31,793
397500,True,5,Mixed,108,52,160
397530,True,0,No user reviews,0,0,0
397540,True,8,Very Positive,15346,2873,18219
397550,True,7,Positive,9,1,10
397570,True,6,Mostly Positive,46,12,58
397580,True,4,Mostly Negative,6,11,17
397600,True,7,Positive,11,0,11
397610,True,0,No user reviews,0,0,0
397640,True,0,6 user reviews,4,2,6
397660,True,6,Mostly Positive,7,3,10
397670,True,0,6 user reviews,1,5,6
397680,True,0,1 user reviews,1,0,1
397690,True,8,Very Positive,133,30,163
397700,True,0,3 user reviews,0,3,3
397720,True,0,3 user reviews,2,1,3
397730,True,0,No user reviews,0,0,0
397740,True,9,Overwhelmingly Positive,1120,26,1146
397750,True,8,Very Positive,58,12,70
397760,True,0,2 user reviews,1,1,2
397770,True,5,Mixed,6,4,10
397780,True,6,Mostly Positive,77,20,97
397790,True,0,No user reviews,0,0,0
397800,True,0,7 user reviews,1,6,7
397810,True,0,No user reviews,0,0,0
397820,True,5,Mixed,11,13,24
397830,True,0,No user reviews,0,0,0
397840,True,5,Mixed,20,12,32
397850,True,0,6 user reviews,6,0,6
397860,True,0,5 user reviews,4,1,5
397870,True,6,Mostly Positive,13,4,17
397880,True,0,No user reviews,0,0,0
397900,True,0,1 user reviews,0,1,1
397910,True,0,4 user reviews,4,0,4
397920,True,0,1 user reviews,1,0,1
397930,True,0,6 user reviews,6,0,6
397940,True,5,Mixed,14,10,24
397950,True,8,Very Positive,4211,380,4591
397960,True,0,9 user reviews,7,2,9
397970,True,6,Mostly Positive,14,4,18
397990,True,0,5 user reviews,5,0,5
398000,True,8,Very Positive,142,0,142
398020,True,5,Mixed,8,9,17
398030,True,8,Very Positive,73,5,78
398070,True,6,Mostly Positive,14,4,18
398100,True,6,Mostly Positive,277,71,348
398110,True,0,5 user reviews,3,2,5
398120,True,4,Mostly Negative,10,20,30
398140,True,5,Mixed,8,10,18
398150,True,0,8 user reviews,6,2,8
398170,True,8,Very Positive,186,40,226
398180,True,5,Mixed,91,47,138
398210,True,3,Negative,1,16,17
398240,True,0,8 user reviews,6,2,8
398250,True,7,Positive,12,0,12
398260,True,0,3 user reviews,3,0,3
398280,True,0,No user reviews,0,0,0
398310,True,0,1 user reviews,1,0,1
398430,True,0,No user reviews,0,0,0
398440,True,0,No user reviews,0,0,0
398450,True,0,4 user reviews,2,2,4
398460,True,6,Mostly Positive,13,4,17
398470,True,0,1 user reviews,0,1,1
398471,True,0,2 user reviews,1,1,2
398472,True,0,No user reviews,0,0,0
398473,True,0,1 user reviews,0,1,1
398480,True,0,6 user reviews,2,4,6
398520,True,0,3 user reviews,3,0,3
398530,True,0,7 user reviews,4,3,7
398590,True,0,No user reviews,0,0,0
398600,True,0,No user reviews,0,0,0
398620,True,0,5 user reviews,5,0,5
398630,True,5,Mixed,8,5,13
398640,True,5,Mixed,33,41,74
398670,True,0,6 user reviews,3,3,6
398680,True,5,Mixed,9,5,14
398710,True,8,Very Positive,1263,115,1378
398810,True,6,Mostly Positive,81,21,102
398820,True,5,Mixed,6,4,10
398830,True,0,1 user reviews,0,1,1
398840,True,0,2 user reviews,0,2,2
398850,True,9,Overwhelmingly Positive,1503,70,1573
398860,True,0,1 user reviews,1,0,1
398890,True,0,1 user reviews,0,1,1
398900,True,0,1 user reviews,1,0,1
398910,True,0,No user reviews,0,0,0
398911,True,7,Positive,18,1,19
398913,True,8,Very Positive,50,1,51
398915,True,6,Mostly Positive,18,5,23
398916,True,7,Positive,20,1,21
398917,True,7,Positive,12,0,12
398920,True,0,1 user reviews,1,0,1
398930,True,5,Mixed,11,7,18
398940,True,6,Mostly Positive,9,3,12
398950,True,0,1 user reviews,0,1,1
398960,True,7,Positive,11,0,11
398970,True,5,Mixed,5,6,11
398980,True,8,Very Positive,68,8,76
398990,True,0,No user reviews,0,0,0
399000,True,0,1 user reviews,1,0,1
399010,True,0,No user reviews,0,0,0
399020,True,0,1 user reviews,1,0,1
399021,True,0,1 user reviews,1,0,1
399040,True,7,Positive,36,7,43
399070,True,8,Very Positive,171,24,195
399090,True,0,2 user reviews,0,2,2
399110,True,0,No user reviews,0,0,0
399120,True,5,Mixed,447,254,701
399130,True,5,Mixed,30,23,53
399140,True,7,Positive,27,5,32
399180,True,0,5 user reviews,2,3,5
399230,True,4,Mostly Negative,12,33,45
399240,True,0,7 user reviews,4,3,7
399260,True,0,6 user reviews,5,1,6
399270,True,0,5 user reviews,3,2,5
399280,True,0,No user reviews,0,0,0
399290,True,0,No user reviews,0,0,0
399300,True,0,No user reviews,0,0,0
399310,True,0,No user reviews,0,0,0
399320,True,0,No user reviews,0,0,0
399330,True,0,No user reviews,0,0,0
399340,True,0,No user reviews,0,0,0
399420,True,0,4 user reviews,1,3,4
399430,True,5,Mixed,52,30,82
399460,True,0,No user reviews,0,0,0
399520,True,0,2 user reviews,2,0,2
399530,True,0,3 user reviews,3,0,3
399550,True,0,1 user reviews,0,1,1
399560,True,0,No user reviews,0,0,0
399570,True,0,No user reviews,0,0,0
399600,True,7,Positive,25,3,28
399610,True,5,Mixed,12,6,18
399620,True,4,Mostly Negative,26,53,79
399640,True,8,Very Positive,245,19,264
399660,True,0,1 user reviews,1,0,1
399670,True,8,Very Positive,1454,226,1680
399680,True,0,No user reviews,0,0,0
399720,True,7,Positive,39,2,41
399730,True,8,Very Positive,182,19,201
399750,True,0,No user reviews,0,0,0
399760,True,0,No user reviews,0,0,0
399780,True,8,Very Positive,69,3,72
399790,True,4,Mostly Negative,104,227,331
399810,True,6,Mostly Positive,1671,630,2301
399820,True,8,Very Positive,486,101,587
399830,True,0,3 user reviews,3,0,3
399831,True,0,5 user reviews,5,0,5
399832,True,0,No user reviews,0,0,0
399833,True,0,5 user reviews,5,0,5
399834,True,0,4 user reviews,4,0,4
399835,True,0,1 user reviews,1,0,1
399836,True,0,No user reviews,0,0,0
399837,True,0,No user reviews,0,0,0
399840,True,0,No user reviews,0,0,0
399860,True,0,4 user reviews,4,0,4
399870,True,0,1 user reviews,0,1,1
399880,True,0,5 user reviews,5,0,5
399890,True,8,Very Positive,62,15,77
399900,True,0,5 user reviews,2,3,5
399910,True,7,Positive,9,1,10
399920,True,0,6 user reviews,5,1,6
399940,True,0,1 user reviews,0,1,1
400020,True,8,Very Positive,291,58,349
400030,True,0,4 user reviews,0,4,4
400040,True,7,Positive,9,1,10
400050,True,0,No user reviews,0,0,0
400070,True,0,No user reviews,0,0,0
400080,True,8,Very Positive,193,34,227
400110,True,8,Very Positive,171,42,213
400120,True,0,No user reviews,0,0,0
400130,True,0,8 user reviews,7,1,8
400160,True,8,Very Positive,190,19,209
400170,True,6,Mostly Positive,370,148,518
400180,True,6,Mostly Positive,109,40,149
400200,True,4,Mostly Negative,18,29,47
400220,True,7,Positive,8,2,10
400230,True,0,2 user reviews,1,1,2
400240,True,5,Mixed,151,68,219
400250,True,5,Mixed,106,89,195
400280,True,0,9 user reviews,7,2,9
400320,True,0,No user reviews,0,0,0
400330,True,0,4 user reviews,1,3,4
400350,True,6,Mostly Positive,19,7,26
400360,True,5,Mixed,34,23,57
400370,True,7,Positive,27,3,30
400380,True,0,8 user reviews,5,3,8
400390,True,0,No user reviews,0,0,0
400400,True,7,Positive,14,0,14
400410,True,0,3 user reviews,3,0,3
400420,True,0,1 user reviews,1,0,1
400430,True,8,Very Positive,192,36,228
400450,True,8,Very Positive,185,39,224
400460,True,0,No user reviews,0,0,0
400470,True,5,Mixed,43,20,63
400480,True,0,No user reviews,0,0,0
400490,True,8,Very Positive,59,13,72
400500,True,4,Mostly Negative,8,13,21
400510,True,5,Mixed,47,49,96
400551,True,6,Mostly Positive,222,61,283
400560,True,0,No user reviews,0,0,0
400570,True,0,1 user reviews,1,0,1
400580,True,8,Very Positive,152,18,170
400600,True,0,2 user reviews,2,0,2
400630,True,8,Very Positive,695,43,738
400650,True,0,3 user reviews,2,1,3
400660,True,8,Very Positive,242,31,273
400690,True,0,No user reviews,0,0,0
400710,True,7,Positive,10,1,11
400720,True,0,3 user reviews,2,1,3
400721,True,0,4 user reviews,4,0,4
400740,True,2,Very Negative,10,46,56
400750,True,0,No user reviews,0,0,0
400760,True,8,Very Positive,61,13,74
400770,True,0,No user reviews,0,0,0
400780,True,0,3 user reviews,2,1,3
400790,True,8,Very Positive,100,8,108
400800,True,5,Mixed,117,54,171
400810,True,0,No user reviews,0,0,0
400820,True,0,2 user reviews,0,2,2
400821,True,0,No user reviews,0,0,0
400822,True,0,No user reviews,0,0,0
400840,True,0,5 user reviews,4,1,5
400841,True,0,4 user reviews,4,0,4
400842,True,7,Positive,12,1,13
400850,True,0,No user reviews,0,0,0
400880,True,4,Mostly Negative,4,13,17
400890,True,0,5 user reviews,4,1,5
400891,True,0,No user reviews,0,0,0
400892,True,0,3 user reviews,3,0,3
400893,True,0,2 user reviews,2,0,2
400894,True,0,1 user reviews,1,0,1
400895,True,0,No user reviews,0,0,0
400896,True,0,3 user reviews,2,1,3
400897,True,0,No user reviews,0,0,0
400898,True,0,No user reviews,0,0,0
400899,True,0,1 user reviews,1,0,1
400900,True,0,No user reviews,0,0,0
400901,True,0,No user reviews,0,0,0
400902,True,0,No user reviews,0,0,0
400903,True,0,No user reviews,0,0,0
400904,True,0,No user reviews,0,0,0
400905,True,0,No user reviews,0,0,0
400906,True,0,No user reviews,0,0,0
400907,True,0,No user reviews,0,0,0
400908,True,0,No user reviews,0,0,0
400909,True,0,1 user reviews,1,0,1
400910,True,9,Overwhelmingly Positive,1669,49,1718
400920,True,0,No user reviews,0,0,0
400921,True,0,No user reviews,0,0,0
400922,True,0,1 user reviews,1,0,1
400923,True,0,No user reviews,0,0,0
400924,True,0,No user reviews,0,0,0
400925,True,0,No user reviews,0,0,0
400926,True,0,No user reviews,0,0,0
400927,True,0,No user reviews,0,0,0
400928,True,0,No user reviews,0,0,0
400929,True,0,No user reviews,0,0,0
400930,True,0,No user reviews,0,0,0
400931,True,0,No user reviews,0,0,0
400932,True,0,No user reviews,0,0,0
400933,True,0,No user reviews,0,0,0
400934,True,0,No user reviews,0,0,0
400935,True,0,No user reviews,0,0,0
400936,True,0,No user reviews,0,0,0
400937,True,0,No user reviews,0,0,0
400938,True,0,No user reviews,0,0,0
400939,True,0,No user reviews,0,0,0
400940,True,6,Mostly Positive,711,198,909
400950,True,0,No user reviews,0,0,0
400960,True,0,No user reviews,0,0,0
400961,True,0,No user reviews,0,0,0
400962,True,0,1 user reviews,1,0,1
400963,True,0,No user reviews,0,0,0
400964,True,0,No user reviews,0,0,0
400965,True,0,No user reviews,0,0,0
400966,True,0,No user reviews,0,0,0
400967,True,0,No user reviews,0,0,0
400968,True,0,No user reviews,0,0,0
400969,True,0,No user reviews,0,0,0
400970,True,0,No user reviews,0,0,0
400971,True,0,No user reviews,0,0,0
400972,True,0,No user reviews,0,0,0
400973,True,0,No user reviews,0,0,0
400974,True,0,No user reviews,0,0,0
400975,True,0,No user reviews,0,0,0
400976,True,0,No user reviews,0,0,0
400977,True,0,No user reviews,0,0,0
400978,True,0,No user reviews,0,0,0
400979,True,0,No user reviews,0,0,0
400980,True,0,No user reviews,0,0,0
400981,True,0,No user reviews,0,0,0
400982,True,0,No user reviews,0,0,0
400983,True,0,No user reviews,0,0,0
400984,True,0,No user reviews,0,0,0
400985,True,0,No user reviews,0,0,0
400986,True,0,No user reviews,0,0,0
400987,True,0,No user reviews,0,0,0
400988,True,0,1 user reviews,1,0,1
400989,True,0,No user reviews,0,0,0
400990,True,0,No user reviews,0,0,0
400991,True,0,No user reviews,0,0,0
400992,True,0,No user reviews,0,0,0
400993,True,0,No user reviews,0,0,0
400994,True,0,No user reviews,0,0,0
400995,True,0,No user reviews,0,0,0
400996,True,0,No user reviews,0,0,0
400997,True,0,No user reviews,0,0,0
400998,True,0,1 user reviews,1,0,1
400999,True,0,5 user reviews,2,3,5
401000,True,0,No user reviews,0,0,0
401001,True,0,No user reviews,0,0,0
401002,True,0,No user reviews,0,0,0
401003,True,0,No user reviews,0,0,0
401004,True,0,No user reviews,0,0,0
401005,True,0,No user reviews,0,0,0
401006,True,0,No user reviews,0,0,0
401007,True,0,No user reviews,0,0,0
401008,True,0,2 user reviews,0,2,2
401009,True,0,No user reviews,0,0,0
401010,True,0,No user reviews,0,0,0
401011,True,0,No user reviews,0,0,0
401012,True,0,No user reviews,0,0,0
401013,True,0,No user reviews,0,0,0
401014,True,0,1 user reviews,1,0,1
401015,True,0,No user reviews,0,0,0
401016,True,0,No user reviews,0,0,0
401017,True,0,No user reviews,0,0,0
401018,True,0,No user reviews,0,0,0
401019,True,0,No user reviews,0,0,0
401020,True,0,No user reviews,0,0,0
401021,True,0,No user reviews,0,0,0
401022,True,0,No user reviews,0,0,0
401023,True,0,No user reviews,0,0,0
401024,True,0,1 user reviews,1,0,1
401025,True,0,No user reviews,0,0,0
401026,True,0,No user reviews,0,0,0
401027,True,0,No user reviews,0,0,0
401028,True,0,No user reviews,0,0,0
401029,True,0,No user reviews,0,0,0
401030,True,0,No user reviews,0,0,0
401031,True,0,No user reviews,0,0,0
401032,True,0,No user reviews,0,0,0
401033,True,0,No user reviews,0,0,0
401034,True,0,No user reviews,0,0,0
401035,True,0,No user reviews,0,0,0
401036,True,0,No user reviews,0,0,0
401037,True,0,No user reviews,0,0,0
401038,True,0,No user reviews,0,0,0
401039,True,0,No user reviews,0,0,0
401040,True,0,No user reviews,0,0,0
401041,True,0,No user reviews,0,0,0
401042,True,0,No user reviews,0,0,0
401043,True,0,No user reviews,0,0,0
401044,True,0,No user reviews,0,0,0
401045,True,0,No user reviews,0,0,0
401046,True,0,No user reviews,0,0,0
401047,True,0,No user reviews,0,0,0
401048,True,0,No user reviews,0,0,0
401049,True,0,No user reviews,0,0,0
401050,True,0,No user reviews,0,0,0
401051,True,0,No user reviews,0,0,0
401052,True,0,No user reviews,0,0,0
401053,True,0,No user reviews,0,0,0
401054,True,0,No user reviews,0,0,0
401055,True,0,No user reviews,0,0,0
401056,True,0,No user reviews,0,0,0
401057,True,0,No user reviews,0,0,0
401058,True,0,No user reviews,0,0,0
401059,True,0,No user reviews,0,0,0
401060,True,0,No user reviews,0,0,0
401061,True,0,No user reviews,0,0,0
401062,True,0,No user reviews,0,0,0
401063,True,0,1 user reviews,1,0,1
401064,True,0,No user reviews,0,0,0
401065,True,0,No user reviews,0,0,0
401066,True,0,No user reviews,0,0,0
401067,True,0,No user reviews,0,0,0
401068,True,0,No user reviews,0,0,0
401069,True,0,No user reviews,0,0,0
401070,True,0,No user reviews,0,0,0
401071,True,0,No user reviews,0,0,0
401072,True,0,No user reviews,0,0,0
401073,True,0,No user reviews,0,0,0
401074,True,0,No user reviews,0,0,0
401075,True,0,No user reviews,0,0,0
401076,True,0,No user reviews,0,0,0
401077,True,0,No user reviews,0,0,0
401078,True,0,No user reviews,0,0,0
401079,True,0,No user reviews,0,0,0
401080,True,0,1 user reviews,0,1,1
401081,True,0,No user reviews,0,0,0
401082,True,0,No user reviews,0,0,0
401090,True,6,Mostly Positive,58,22,80
401120,True,7,Positive,21,4,25
401170,True,0,2 user reviews,1,1,2
401190,True,5,Mixed,954,476,1430
401200,True,0,5 user reviews,5,0,5
401210,True,0,2 user reviews,1,1,2
401220,True,0,No user reviews,0,0,0
401250,True,5,Mixed,17,16,33
401270,True,0,5 user reviews,5,0,5
401280,True,7,Positive,15,1,16
401290,True,7,Positive,29,3,32
401300,True,0,No user reviews,0,0,0
401310,True,0,3 user reviews,1,2,3
401320,True,5,Mixed,14,8,22
401330,True,5,Mixed,6,7,13
401340,True,0,No user reviews,0,0,0
401341,True,0,No user reviews,0,0,0
401350,True,0,No user reviews,0,0,0
401360,True,6,Mostly Positive,146,53,199
401380,True,0,No user reviews,0,0,0
401390,True,0,No user reviews,0,0,0
401391,True,0,No user reviews,0,0,0
401400,True,0,No user reviews,0,0,0
401420,True,0,1 user reviews,0,1,1
401430,True,0,2 user reviews,0,2,2
401440,True,0,No user reviews,0,0,0
401450,True,0,No user reviews,0,0,0
401460,True,0,No user reviews,0,0,0
401470,True,0,No user reviews,0,0,0
401490,True,0,No user reviews,0,0,0
401500,True,0,No user reviews,0,0,0
401510,True,0,5 user reviews,5,0,5
401530,True,0,No user reviews,0,0,0
401540,True,0,No user reviews,0,0,0
401550,True,0,6 user reviews,5,1,6
401560,True,0,6 user reviews,3,3,6
401580,True,0,No user reviews,0,0,0
401590,True,0,4 user reviews,4,0,4
401600,True,0,No user reviews,0,0,0
401610,True,0,No user reviews,0,0,0
401626,True,0,6 user reviews,5,1,6
401635,True,8,Very Positive,71,9,80
401640,True,0,6 user reviews,6,0,6
401650,True,5,Mixed,164,163,327
401660,True,7,Positive,25,2,27
401670,True,0,No user reviews,0,0,0
401680,True,8,Very Positive,863,67,930
401690,True,5,Mixed,92,61,153
401700,True,0,No user reviews,0,0,0
401710,True,6,Mostly Positive,256,109,365
401740,True,0,No user reviews,0,0,0
401760,True,6,Mostly Positive,27,10,37
401780,True,0,8 user reviews,3,5,8
401800,True,6,Mostly Positive,14,5,19
401810,True,8,Very Positive,251,19,270
401820,True,5,Mixed,51,23,74
401840,True,7,Positive,14,2,16
401860,True,0,No user reviews,0,0,0
401870,True,0,No user reviews,0,0,0
401890,True,5,Mixed,51,29,80
401910,True,7,Positive,31,4,35
401920,True,8,Very Positive,3072,259,3331
401970,True,0,2 user reviews,1,1,2
401990,True,0,5 user reviews,5,0,5
402020,True,6,Mostly Positive,1037,401,1438
402030,True,6,Mostly Positive,9,3,12
402040,True,6,Mostly Positive,182,69,251
402050,True,0,No user reviews,0,0,0
402060,True,6,Mostly Positive,74,27,101
402080,True,0,No user reviews,0,0,0
402110,True,0,No user reviews,0,0,0
402120,True,8,Very Positive,180,35,215
402130,True,5,Mixed,122,143,265
402150,True,5,Mixed,15,9,24
402160,True,5,Mixed,96,103,199
402170,True,4,Mostly Negative,6,13,19
402180,True,8,Very Positive,922,170,1092
402190,True,4,Mostly Negative,3,10,13
402210,True,7,Positive,36,6,42
402220,True,6,Mostly Positive,21,6,27
402230,True,0,No user reviews,0,0,0
402240,True,0,No user reviews,0,0,0
402260,True,8,Very Positive,273,65,338
402270,True,0,No user reviews,0,0,0
402290,True,7,Positive,21,5,26
402300,True,5,Mixed,22,14,36
402310,True,6,Mostly Positive,150,48,198
402330,True,8,Very Positive,768,94,862
402340,True,7,Positive,19,2,21
402350,True,0,3 user reviews,3,0,3
402370,True,0,No user reviews,0,0,0
402390,True,0,8 user reviews,6,2,8
402410,True,0,No user reviews,0,0,0
402430,True,8,Very Positive,345,22,367
402460,True,4,Mostly Negative,4,11,15
402470,True,0,No user reviews,0,0,0
402471,True,0,No user reviews,0,0,0
402472,True,0,No user reviews,0,0,0
402473,True,0,No user reviews,0,0,0
402474,True,0,No user reviews,0,0,0
402475,True,0,No user reviews,0,0,0
402476,True,0,No user reviews,0,0,0
402477,True,0,No user reviews,0,0,0
402478,True,0,No user reviews,0,0,0
402479,True,0,No user reviews,0,0,0
402480,True,0,No user reviews,0,0,0
402481,True,0,No user reviews,0,0,0
402482,True,0,No user reviews,0,0,0
402483,True,0,No user reviews,0,0,0
402484,True,0,No user reviews,0,0,0
402485,True,0,No user reviews,0,0,0
402486,True,0,No user reviews,0,0,0
402487,True,0,No user reviews,0,0,0
402488,True,0,No user reviews,0,0,0
402489,True,0,No user reviews,0,0,0
402490,True,0,No user reviews,0,0,0
402491,True,0,No user reviews,0,0,0
402492,True,0,No user reviews,0,0,0
402493,True,0,No user reviews,0,0,0
402494,True,0,No user reviews,0,0,0
402495,True,0,No user reviews,0,0,0
402520,True,0,No user reviews,0,0,0
402530,True,8,Very Positive,234,16,250
402560,True,6,Mostly Positive,54,23,77
402570,True,8,Very Positive,732,62,794
402590,True,0,6 user reviews,4,2,6
402591,True,0,No user reviews,0,0,0
402592,True,0,No user reviews,0,0,0
402593,True,0,No user reviews,0,0,0
402594,True,0,No user reviews,0,0,0
402595,True,0,No user reviews,0,0,0
402596,True,0,No user reviews,0,0,0
402597,True,0,No user reviews,0,0,0
402598,True,0,No user reviews,0,0,0
402599,True,0,No user reviews,0,0,0
402600,True,0,No user reviews,0,0,0
402601,True,0,1 user reviews,1,0,1
402602,True,0,No user reviews,0,0,0
402603,True,0,No user reviews,0,0,0
402604,True,0,No user reviews,0,0,0
402605,True,0,No user reviews,0,0,0
402606,True,0,No user reviews,0,0,0
402607,True,0,No user reviews,0,0,0
402608,True,0,No user reviews,0,0,0
402609,True,0,No user reviews,0,0,0
402620,True,8,Very Positive,448,11,459
402630,True,8,Very Positive,54,5,59
402640,True,0,1 user reviews,1,0,1
402650,True,0,No user reviews,0,0,0
402660,True,0,8 user reviews,8,0,8
402670,True,0,3 user reviews,2,1,3
402680,True,0,1 user reviews,1,0,1
402690,True,0,1 user reviews,1,0,1
402700,True,0,9 user reviews,7,2,9
402710,True,5,Mixed,3355,2237,5592
402730,True,0,6 user reviews,1,5,6
402731,True,0,No user reviews,0,0,0
402732,True,0,No user reviews,0,0,0
402740,True,0,No user reviews,0,0,0
402750,True,5,Mixed,78,41,119
402800,True,5,Mixed,18,23,41
402840,True,6,Mostly Positive,18,6,24
402850,True,5,Mixed,18,8,26
402880,True,6,Mostly Positive,225,71,296
402890,True,0,2 user reviews,2,0,2
402910,True,0,2 user reviews,1,1,2
402940,True,0,4 user reviews,4,0,4
402950,True,0,No user reviews,0,0,0
402970,True,0,1 user reviews,1,0,1
402980,True,4,Mostly Negative,3,8,11
402990,True,0,6 user reviews,5,1,6
403010,True,0,7 user reviews,4,3,7
403020,True,0,No user reviews,0,0,0
403030,True,0,2 user reviews,2,0,2
403040,True,0,8 user reviews,5,3,8
403050,True,0,1 user reviews,1,0,1
403051,True,0,5 user reviews,5,0,5
403052,True,0,2 user reviews,2,0,2
403060,True,0,1 user reviews,1,0,1
403061,True,0,4 user reviews,3,1,4
403062,True,0,1 user reviews,0,1,1
403063,True,0,7 user reviews,7,0,7
403070,True,7,Positive,29,5,34
403080,True,0,No user reviews,0,0,0
403090,True,7,Positive,12,0,12
403100,True,7,Positive,10,2,12
403120,True,6,Mostly Positive,548,226,774
403140,True,0,No user reviews,0,0,0
403150,True,6,Mostly Positive,51,21,72
403151,True,7,Positive,12,2,14
403152,True,0,9 user reviews,9,0,9
403153,True,7,Positive,22,2,24
403170,True,0,2 user reviews,2,0,2
403180,True,8,Very Positive,155,33,188
403190,True,6,Mostly Positive,3003,958,3961
403200,True,4,Mostly Negative,4,16,20
403210,True,0,No user reviews,0,0,0
403220,True,0,6 user reviews,6,0,6
403230,True,0,3 user reviews,2,1,3
403240,True,0,No user reviews,0,0,0
403260,True,0,No user reviews,0,0,0
403270,True,7,Positive,15,0,15
403280,True,0,No user reviews,0,0,0
403290,True,6,Mostly Positive,69,18,87
403300,True,0,2 user reviews,2,0,2
403320,True,0,No user reviews,0,0,0
403350,True,0,5 user reviews,5,0,5
403351,True,0,4 user reviews,4,0,4
403390,True,4,Mostly Negative,4,7,11
403400,True,8,Very Positive,120,18,138
403410,True,8,Very Positive,71,14,85
403430,True,8,Very Positive,255,35,290
403440,True,4,Mostly Negative,3,7,10
403450,True,0,No user reviews,0,0,0
403451,True,0,No user reviews,0,0,0
403452,True,0,No user reviews,0,0,0
403453,True,0,No user reviews,0,0,0
403454,True,0,1 user reviews,1,0,1
403455,True,0,1 user reviews,1,0,1
403456,True,0,2 user reviews,1,1,2
403457,True,0,1 user reviews,1,0,1
403460,True,0,2 user reviews,1,1,2
403470,True,0,3 user reviews,2,1,3
403480,True,0,No user reviews,0,0,0
403490,True,0,7 user reviews,4,3,7
403500,True,0,4 user reviews,4,0,4
403510,True,6,Mostly Positive,38,13,51
403520,True,0,No user reviews,0,0,0
403540,True,0,No user reviews,0,0,0
403550,True,0,No user reviews,0,0,0
403560,True,4,Mostly Negative,40,106,146
403590,True,4,Mostly Negative,46,109,155
403630,True,0,No user reviews,0,0,0
403640,True,8,Very Positive,8408,1769,10177
403660,True,5,Mixed,9,13,22
403670,True,5,Mixed,21,12,33
403680,True,0,6 user reviews,3,3,6
403690,True,0,1 user reviews,1,0,1
403700,True,8,Very Positive,190,31,221
403740,True,5,Mixed,41,28,69
403750,True,0,No user reviews,0,0,0
403760,True,0,No user reviews,0,0,0
403761,True,0,No user reviews,0,0,0
403762,True,0,No user reviews,0,0,0
403763,True,0,No user reviews,0,0,0
403764,True,0,No user reviews,0,0,0
403765,True,0,No user reviews,0,0,0
403766,True,0,No user reviews,0,0,0
403767,True,0,No user reviews,0,0,0
403768,True,0,No user reviews,0,0,0
403769,True,0,No user reviews,0,0,0
403770,True,0,No user reviews,0,0,0
403780,True,6,Mostly Positive,10,3,13
403810,True,0,4 user reviews,3,1,4
403830,True,8,Very Positive,189,10,199
403840,True,0,8 user reviews,7,1,8
403850,True,5,Mixed,5,7,12
403860,True,4,Mostly Negative,15,35,50
403870,True,7,Positive,20,5,25
403880,True,5,Mixed,15,21,36
403890,True,0,2 user reviews,1,1,2
403900,True,5,Mixed,38,45,83
403910,True,0,3 user reviews,2,1,3
403940,True,5,Mixed,75,42,117
403950,True,8,Very Positive,309,31,340
403970,True,6,Mostly Positive,243,98,341
403980,True,2,Very Negative,11,66,77
403990,True,0,3 user reviews,3,0,3
404010,True,5,Mixed,219,315,534
404011,True,5,Mixed,559,800,1359
404012,True,5,Mixed,472,305,777
404013,True,8,Very Positive,288,57,345
404014,True,8,Very Positive,236,29,265
404015,True,0,8 user reviews,8,0,8
404030,True,7,Positive,21,3,24
404040,True,8,Very Positive,188,16,204
404050,True,5,Mixed,58,28,86
404060,True,0,No user reviews,0,0,0
404070,True,5,Mixed,9,6,15
404080,True,5,Mixed,70,81,151
404100,True,6,Mostly Positive,23,6,29
404110,True,0,No user reviews,0,0,0
404130,True,0,No user reviews,0,0,0
404131,True,0,No user reviews,0,0,0
404140,True,0,No user reviews,0,0,0
404141,True,0,No user reviews,0,0,0
404142,True,0,No user reviews,0,0,0
404170,True,8,Very Positive,48,4,52
404180,True,6,Mostly Positive,31,8,39
404190,True,0,No user reviews,0,0,0
404200,True,6,Mostly Positive,179,50,229
404210,True,0,No user reviews,0,0,0
404211,True,0,5 user reviews,5,0,5
404212,True,0,2 user reviews,2,0,2
404213,True,0,1 user reviews,1,0,1
404214,True,0,1 user reviews,1,0,1
404215,True,0,1 user reviews,1,0,1
404216,True,0,2 user reviews,2,0,2
404217,True,0,1 user reviews,1,0,1
404218,True,0,1 user reviews,1,0,1
404219,True,0,No user reviews,0,0,0
404220,True,0,No user reviews,0,0,0
404230,True,3,Negative,2,9,11
404240,True,0,4 user reviews,1,3,4
404250,True,7,Positive,30,2,32
404270,True,7,Positive,16,1,17
404280,True,6,Mostly Positive,17,5,22
404281,True,0,8 user reviews,7,1,8
404282,True,0,6 user reviews,6,0,6
404283,True,0,5 user reviews,4,1,5
404284,True,0,5 user reviews,5,0,5
404290,True,0,3 user reviews,1,2,3
404300,True,0,3 user reviews,2,1,3
404301,True,0,No user reviews,0,0,0
404302,True,0,No user reviews,0,0,0
404303,True,0,No user reviews,0,0,0
404304,True,0,No user reviews,0,0,0
404305,True,0,No user reviews,0,0,0
404306,True,0,No user reviews,0,0,0
404307,True,0,No user reviews,0,0,0
404308,True,0,No user reviews,0,0,0
404309,True,0,No user reviews,0,0,0
404310,True,0,No user reviews,0,0,0
404311,True,0,No user reviews,0,0,0
404312,True,0,No user reviews,0,0,0
404313,True,0,No user reviews,0,0,0
404320,True,0,No user reviews,0,0,0
404330,True,0,No user reviews,0,0,0
404331,True,0,No user reviews,0,0,0
404332,True,0,No user reviews,0,0,0
404333,True,0,No user reviews,0,0,0
404334,True,0,No user reviews,0,0,0
404335,True,0,No user reviews,0,0,0
404336,True,0,No user reviews,0,0,0
404337,True,0,No user reviews,0,0,0
404340,True,0,No user reviews,0,0,0
404350,True,0,No user reviews,0,0,0
404370,True,0,No user reviews,0,0,0
404380,True,0,No user reviews,0,0,0
404390,True,0,6 user reviews,6,0,6
404400,True,7,Positive,8,2,10
404410,True,8,Very Positive,67,5,72
404420,True,0,9 user reviews,6,3,9
404430,True,8,Very Positive,94,4,98
404450,True,0,2 user reviews,2,0,2
404460,True,0,7 user reviews,7,0,7
404480,True,7,Positive,10,0,10
404510,True,6,Mostly Positive,20,6,26
404530,True,8,Very Positive,268,45,313
404540,True,8,Very Positive,622,60,682
404550,True,5,Mixed,42,20,62
404570,True,7,Positive,12,1,13
404580,True,0,1 user reviews,0,1,1
404590,True,5,Mixed,425,258,683
404610,True,0,No user reviews,0,0,0
404620,True,6,Mostly Positive,444,128,572
404630,True,0,8 user reviews,3,5,8
404640,True,4,Mostly Negative,12,39,51
404650,True,0,No user reviews,0,0,0
404660,True,0,6 user reviews,4,2,6
404670,True,0,1 user reviews,1,0,1
404680,True,8,Very Positive,1160,130,1290
404690,True,8,Very Positive,92,20,112
404700,True,7,Positive,38,6,44
404730,True,8,Very Positive,462,60,522
404750,True,0,2 user reviews,1,1,2
404760,True,0,No user reviews,0,0,0
404770,True,5,Mixed,76,46,122
404790,True,7,Positive,9,1,10
404800,True,0,1 user reviews,1,0,1
404820,True,8,Very Positive,86,9,95
404840,True,0,8 user reviews,8,0,8
404850,True,0,5 user reviews,5,0,5
404860,True,5,Mixed,8,5,13
404890,True,5,Mixed,6,4,10
404910,True,0,No user reviews,0,0,0
404920,True,4,Mostly Negative,28,43,71
404930,True,0,1 user reviews,1,0,1
404960,True,6,Mostly Positive,29,9,38
404980,True,0,1 user reviews,1,0,1
404981,True,0,3 user reviews,3,0,3
404982,True,0,3 user reviews,2,1,3
404990,True,0,No user reviews,0,0,0
405000,True,6,Mostly Positive,36,10,46
405010,True,6,Mostly Positive,22,9,31
405032,True,7,Positive,14,3,17
405050,True,4,Mostly Negative,4,7,11
405070,True,0,4 user reviews,1,3,4
405080,True,5,Mixed,57,42,99
405100,True,0,No user reviews,0,0,0
405130,True,7,Positive,26,6,32
405170,True,8,Very Positive,582,68,650
405180,True,8,Very Positive,84,17,101
405190,True,0,6 user reviews,1,5,6
405210,True,0,No user reviews,0,0,0
405220,True,0,1 user reviews,0,1,1
405230,True,0,No user reviews,0,0,0
405240,True,5,Mixed,8,7,15
405260,True,0,No user reviews,0,0,0
405270,True,0,No user reviews,0,0,0
405290,True,8,Very Positive,313,22,335
405310,True,6,Mostly Positive,598,184,782
405340,True,5,Mixed,11,9,20
405350,True,0,No user reviews,0,0,0
405360,True,5,Mixed,19,19,38
405370,True,5,Mixed,154,92,246
405430,True,8,Very Positive,42,9,51
405440,True,0,5 user reviews,3,2,5
405450,True,0,2 user reviews,2,0,2
405460,True,0,1 user reviews,1,0,1
405470,True,0,9 user reviews,5,4,9
405480,True,0,6 user reviews,3,3,6
405500,True,6,Mostly Positive,84,28,112
405515,True,0,3 user reviews,3,0,3
405520,True,0,5 user reviews,3,2,5
405530,True,0,4 user reviews,4,0,4
405540,True,6,Mostly Positive,24,10,34
405550,True,7,Positive,22,4,26
405590,True,0,5 user reviews,5,0,5
405610,True,5,Mixed,43,61,104
405640,True,8,Very Positive,4748,251,4999
405650,True,6,Mostly Positive,31,12,43
405660,True,0,No user reviews,0,0,0
405670,True,6,Mostly Positive,26,11,37
405680,True,0,No user reviews,0,0,0
405690,True,0,No user reviews,0,0,0
405700,True,0,1 user reviews,1,0,1
405710,True,6,Mostly Positive,922,247,1169
405720,True,7,Positive,10,0,10
405730,True,0,7 user reviews,2,5,7
405760,True,5,Mixed,6,4,10
405780,True,6,Mostly Positive,99,31,130
405810,True,0,5 user reviews,1,4,5
405820,True,9,Overwhelmingly Positive,1453,70,1523
405830,True,8,Very Positive,918,56,974
405840,True,0,No user reviews,0,0,0
405860,True,0,4 user reviews,4,0,4
405900,True,8,Very Positive,1559,177,1736
405920,True,5,Mixed,13,6,19
405930,True,0,No user reviews,0,0,0
405940,True,0,No user reviews,0,0,0
405950,True,8,Very Positive,51,4,55
405960,True,5,Mixed,10,15,25
405970,True,6,Mostly Positive,19,8,27
406020,True,7,Positive,10,0,10
406030,True,0,1 user reviews,0,1,1
406040,True,0,2 user reviews,1,1,2
406050,True,0,1 user reviews,1,0,1
406060,True,0,No user reviews,0,0,0
406071,True,0,3 user reviews,3,0,3
406072,True,0,1 user reviews,0,1,1
406073,True,0,3 user reviews,2,1,3
406074,True,0,No user reviews,0,0,0
406075,True,0,No user reviews,0,0,0
406076,True,0,No user reviews,0,0,0
406077,True,0,1 user reviews,1,0,1
406078,True,0,No user reviews,0,0,0
406080,True,5,Mixed,67,53,120
406090,True,0,5 user reviews,2,3,5
406100,True,0,No user reviews,0,0,0
406110,True,6,Mostly Positive,15,4,19
406120,True,0,4 user reviews,3,1,4
406130,True,8,Very Positive,198,46,244
406140,True,0,3 user reviews,3,0,3
406150,True,9,Overwhelmingly Positive,6344,297,6641
406160,True,0,No user reviews,0,0,0
406170,True,5,Mixed,47,42,89
406190,True,0,3 user reviews,2,1,3
406210,True,8,Very Positive,113,7,120
406220,True,7,Positive,35,6,41
406230,True,0,No user reviews,0,0,0
406240,True,0,No user reviews,0,0,0
406260,True,0,7 user reviews,6,1,7
406261,True,0,No user reviews,0,0,0
406262,True,0,No user reviews,0,0,0
406263,True,0,No user reviews,0,0,0
406280,True,5,Mixed,11,14,25
406290,True,8,Very Positive,731,108,839
406300,True,0,5 user reviews,4,1,5
406310,True,5,Mixed,16,13,29
406340,True,0,No user reviews,0,0,0
406350,True,8,Very Positive,445,85,530
406370,True,0,No user reviews,0,0,0
406400,True,0,3 user reviews,2,1,3
406410,True,4,Mostly Negative,5,9,14
406420,True,0,No user reviews,0,0,0
406421,True,0,1 user reviews,1,0,1
406422,True,0,No user reviews,0,0,0
406440,True,0,3 user reviews,3,0,3
406460,True,0,5 user reviews,5,0,5
406470,True,0,3 user reviews,3,0,3
406480,True,0,No user reviews,0,0,0
406490,True,0,No user reviews,0,0,0
406500,True,0,No user reviews,0,0,0
406510,True,0,No user reviews,0,0,0
406520,True,0,4 user reviews,4,0,4
406521,True,0,3 user reviews,3,0,3
406540,True,8,Very Positive,78,7,85
406550,True,8,Very Positive,412,14,426
406560,True,5,Mixed,67,45,112
406570,True,0,No user reviews,0,0,0
406580,True,5,Mixed,33,21,54
406590,True,8,Very Positive,71,17,88
406600,True,8,Very Positive,57,7,64
406610,True,4,Mostly Negative,7,16,23
406620,True,4,Mostly Negative,8,14,22
406650,True,6,Mostly Positive,38,11,49
406660,True,0,No user reviews,0,0,0
406670,True,6,Mostly Positive,7,3,10
406690,True,0,1 user reviews,1,0,1
406700,True,0,2 user reviews,2,0,2
406710,True,5,Mixed,6,4,10
406720,True,5,Mixed,39,38,77
406730,True,5,Mixed,10,9,19
406760,True,0,1 user reviews,0,1,1
406770,True,0,No user reviews,0,0,0
406780,True,7,Positive,14,2,16
406820,True,0,1 user reviews,1,0,1
406830,True,0,1 user reviews,1,0,1
406840,True,0,No user reviews,0,0,0
406850,True,8,Very Positive,108,26,134
406860,True,5,Mixed,26,14,40
406870,True,8,Very Positive,163,14,177
406890,True,0,No user reviews,0,0,0
406910,True,0,No user reviews,0,0,0
406920,True,7,Positive,19,0,19
406930,True,0,4 user reviews,2,2,4
406940,True,5,Mixed,38,18,56
406950,True,7,Positive,8,2,10
406960,True,0,8 user reviews,7,1,8
406970,True,5,Mixed,303,138,441
407000,True,4,Mostly Negative,6,18,24
407010,True,0,No user reviews,0,0,0
407011,True,0,No user reviews,0,0,0
407020,True,8,Very Positive,63,15,78
407040,True,0,No user reviews,0,0,0
407050,True,0,2 user reviews,2,0,2
407060,True,7,Positive,12,3,15
407070,True,0,4 user reviews,4,0,4
407080,True,6,Mostly Positive,10,3,13
407090,True,0,No user reviews,0,0,0
407100,True,0,5 user reviews,5,0,5
407110,True,7,Positive,13,1,14
407120,True,0,2 user reviews,1,1,2
407130,True,8,Very Positive,923,135,1058
407140,True,0,2 user reviews,0,2,2
407150,True,0,4 user reviews,1,3,4
407190,True,0,9 user reviews,4,5,9
407200,True,7,Positive,14,0,14
407210,True,0,No user reviews,0,0,0
407230,True,5,Mixed,134,73,207
407240,True,0,No user reviews,0,0,0
407250,True,0,No user reviews,0,0,0
407290,True,5,Mixed,29,17,46
407300,True,5,Mixed,68,30,98
407310,True,8,Very Positive,128,8,136
407320,True,7,Positive,14,1,15
407330,True,8,Very Positive,610,43,653
407340,True,8,Very Positive,72,4,76
407380,True,7,Positive,24,1,25
407400,True,0,No user reviews,0,0,0
407420,True,5,Mixed,139,166,305
407450,True,0,1 user reviews,1,0,1
407451,True,0,No user reviews,0,0,0
407460,True,0,1 user reviews,1,0,1
407474,True,4,Mostly Negative,4,9,13
407475,True,4,Mostly Negative,8,24,32
407480,True,0,No user reviews,0,0,0
407510,True,5,Mixed,26,28,54
407530,True,5,Mixed,790,375,1165
407540,True,0,No user reviews,0,0,0
407560,True,5,Mixed,304,155,459
407570,True,0,No user reviews,0,0,0
407600,True,5,Mixed,24,21,45
407620,True,5,Mixed,22,28,50
407630,True,6,Mostly Positive,12,4,16
407660,True,0,No user reviews,0,0,0
407680,True,5,Mixed,9,8,17
407690,True,5,Mixed,34,46,80
407700,True,4,Mostly Negative,3,9,12
407710,True,5,Mixed,28,16,44
407720,True,5,Mixed,18,19,37
407730,True,5,Mixed,16,15,31
407760,True,0,No user reviews,0,0,0
407780,True,8,Very Positive,133,12,145
407800,True,0,No user reviews,0,0,0
407810,True,8,Very Positive,482,113,595
407820,True,0,No user reviews,0,0,0
407821,True,0,1 user reviews,1,0,1
407822,True,0,1 user reviews,1,0,1
407823,True,0,1 user reviews,1,0,1
407830,True,0,1 user reviews,0,1,1
407840,True,5,Mixed,1036,968,2004
407870,True,0,No user reviews,0,0,0
407880,True,6,Mostly Positive,10,3,13
407890,True,0,5 user reviews,4,1,5
407891,True,0,No user reviews,0,0,0
407892,True,0,No user reviews,0,0,0
407900,True,7,Positive,42,4,46
407920,True,0,8 user reviews,8,0,8
407940,True,7,Positive,10,2,12
407960,True,0,No user reviews,0,0,0
407980,True,6,Mostly Positive,87,32,119
408000,True,6,Mostly Positive,71,23,94
408010,True,0,No user reviews,0,0,0
408030,True,7,Positive,49,0,49
408040,True,0,2 user reviews,1,1,2
408041,True,0,1 user reviews,1,0,1
408050,True,0,No user reviews,0,0,0
408060,True,7,Positive,38,0,38
408070,True,0,1 user reviews,1,0,1
408090,True,0,No user reviews,0,0,0
408100,True,0,7 user reviews,4,3,7
408101,True,0,7 user reviews,3,4,7
408102,True,0,9 user reviews,7,2,9
408110,True,7,Positive,25,5,30
408120,True,5,Mixed,197,88,285
408140,True,0,No user reviews,0,0,0
408150,True,0,No user reviews,0,0,0
408160,True,0,No user reviews,0,0,0
408170,True,0,9 user reviews,9,0,9
408180,True,0,No user reviews,0,0,0
408210,True,0,No user reviews,0,0,0
408220,True,0,5 user reviews,4,1,5
408240,True,0,5 user reviews,4,1,5
408250,True,5,Mixed,77,71,148
408260,True,0,No user reviews,0,0,0
408280,True,8,Very Positive,322,72,394
408300,True,7,Positive,28,1,29
408330,True,0,No user reviews,0,0,0
408340,True,7,Positive,25,3,28
408360,True,7,Positive,12,1,13
408370,True,0,5 user reviews,5,0,5
408380,True,0,No user reviews,0,0,0
408381,True,0,No user reviews,0,0,0
408390,True,0,No user reviews,0,0,0
408400,True,7,Positive,38,8,46
408410,True,8,Very Positive,528,39,567
408430,True,0,No user reviews,0,0,0
408440,True,0,9 user reviews,1,8,9
408450,True,0,4 user reviews,3,1,4
408470,True,0,No user reviews,0,0,0
408500,True,7,Positive,27,6,33
408510,True,0,1 user reviews,1,0,1
408520,True,8,Very Positive,552,53,605
408530,True,0,No user reviews,0,0,0
408550,True,0,2 user reviews,2,0,2
408560,True,0,No user reviews,0,0,0
408580,True,0,No user reviews,0,0,0
408590,True,0,7 user reviews,6,1,7
408600,True,0,6 user reviews,6,0,6
408610,True,8,Very Positive,168,15,183
408630,True,0,No user reviews,0,0,0
408640,True,5,Mixed,63,45,108
408650,True,6,Mostly Positive,76,29,105
408660,True,0,No user reviews,0,0,0
408680,True,0,No user reviews,0,0,0
408690,True,0,No user reviews,0,0,0
408710,True,7,Positive,11,1,12
408730,True,7,Positive,16,3,19
408740,True,4,Mostly Negative,130,242,372
408750,True,0,4 user reviews,4,0,4
408760,True,5,Mixed,39,39,78
408770,True,6,Mostly Positive,30,10,40
408900,True,8,Very Positive,170,39,209
408920,True,5,Mixed,33,18,51
408930,True,7,Positive,19,2,21
408940,True,0,No user reviews,0,0,0
408960,True,6,Mostly Positive,102,26,128
408970,True,7,Positive,14,1,15
408980,True,0,No user reviews,0,0,0
408982,True,0,No user reviews,0,0,0
408983,True,0,No user reviews,0,0,0
408984,True,0,No user reviews,0,0,0
408990,True,5,Mixed,167,236,403
409000,True,5,Mixed,116,64,180
409020,True,0,No user reviews,0,0,0
409040,True,6,Mostly Positive,10,4,14
409060,True,0,No user reviews,0,0,0
409070,True,7,Positive,9,2,11
409090,True,5,Mixed,19,11,30
409100,True,8,Very Positive,268,39,307
409110,True,0,No user reviews,0,0,0
409111,True,0,No user reviews,0,0,0
409130,True,0,No user reviews,0,0,0
409140,True,0,No user reviews,0,0,0
409141,True,0,1 user reviews,1,0,1
409142,True,6,Mostly Positive,7,3,10
409150,True,0,No user reviews,0,0,0
409160,True,8,Very Positive,111,5,116
409170,True,5,Mixed,11,10,21
409180,True,0,2 user reviews,2,0,2
409190,True,0,No user reviews,0,0,0
409191,True,0,No user reviews,0,0,0
409192,True,0,No user reviews,0,0,0
409193,True,0,No user reviews,0,0,0
409194,True,0,No user reviews,0,0,0
409200,True,0,1 user reviews,0,1,1
409201,True,0,No user reviews,0,0,0
409202,True,0,No user reviews,0,0,0
409203,True,0,No user reviews,0,0,0
409204,True,0,No user reviews,0,0,0
409210,True,8,Very Positive,177,7,184
409230,True,0,3 user reviews,2,1,3
409240,True,0,No user reviews,0,0,0
409241,True,0,No user reviews,0,0,0
409250,True,0,No user reviews,0,0,0
409251,True,0,No user reviews,0,0,0
409252,True,0,No user reviews,0,0,0
409253,True,0,No user reviews,0,0,0
409254,True,0,No user reviews,0,0,0
409255,True,0,No user reviews,0,0,0
409256,True,0,No user reviews,0,0,0
409257,True,0,No user reviews,0,0,0
409280,True,5,Mixed,7,6,13
409290,True,5,Mixed,11,5,16
409320,True,5,Mixed,66,31,97
409330,True,0,1 user reviews,1,0,1
409340,True,5,Mixed,18,14,32
409360,True,7,Positive,8,2,10
409380,True,8,Very Positive,47,6,53
409390,True,5,Mixed,19,13,32
409410,True,5,Mixed,8,8,16
409420,True,5,Mixed,5,7,12
409430,True,0,No user reviews,0,0,0
409450,True,8,Very Positive,233,40,273
409460,True,5,Mixed,6,8,14
409470,True,0,1 user reviews,1,0,1
409480,True,0,3 user reviews,3,0,3
409490,True,5,Mixed,7,7,14
409500,True,0,No user reviews,0,0,0
409510,True,4,Mostly Negative,3,9,12
409520,True,5,Mixed,15,17,32
409550,True,0,No user reviews,0,0,0
409551,True,0,No user reviews,0,0,0
409552,True,0,2 user reviews,2,0,2
409560,True,5,Mixed,11,5,16
409570,True,0,1 user reviews,1,0,1
409580,True,0,5 user reviews,1,4,5
409590,True,6,Mostly Positive,1298,457,1755
409600,True,5,Mixed,26,15,41
409610,True,0,1 user reviews,1,0,1
409630,True,5,Mixed,7,5,12
409650,True,0,No user reviews,0,0,0
409651,True,0,1 user reviews,1,0,1
409652,True,0,No user reviews,0,0,0
409653,True,0,No user reviews,0,0,0
409660,True,8,Very Positive,428,31,459
409670,True,0,6 user reviews,5,1,6
409690,True,0,5 user reviews,4,1,5
409710,True,6,Mostly Positive,7430,2807,10237
409720,True,5,Mixed,2511,1687,4198
409730,True,6,Mostly Positive,15,4,19
409740,True,0,No user reviews,0,0,0
409750,True,0,4 user reviews,4,0,4
409760,True,0,7 user reviews,5,2,7
409790,True,0,No user reviews,0,0,0
409850,True,6,Mostly Positive,155,50,205
409870,True,8,Very Positive,183,16,199
409890,True,6,Mostly Positive,155,63,218
409910,True,8,Very Positive,100,19,119
409920,True,8,Very Positive,135,10,145
409960,True,0,No user reviews,0,0,0
409970,True,0,No user reviews,0,0,0
409980,True,0,No user reviews,0,0,0
409990,True,0,No user reviews,0,0,0
410000,True,0,8 user reviews,7,1,8
410030,True,0,No user reviews,0,0,0
410040,True,0,1 user reviews,0,1,1
410050,True,5,Mixed,6,4,10
410100,True,0,4 user reviews,1,3,4
410110,True,6,Mostly Positive,561,189,750
410120,True,0,8 user reviews,4,4,8
410130,True,0,2 user reviews,2,0,2
410150,True,7,Positive,16,0,16
410170,True,0,No user reviews,0,0,0
410210,True,4,Mostly Negative,74,182,256
410220,True,0,No user reviews,0,0,0
410250,True,0,No user reviews,0,0,0
410260,True,0,No user reviews,0,0,0
410280,True,0,No user reviews,0,0,0
410290,True,0,4 user reviews,3,1,4
410300,True,0,No user reviews,0,0,0
410301,True,0,No user reviews,0,0,0
410302,True,0,No user reviews,0,0,0
410303,True,0,No user reviews,0,0,0
410310,True,0,No user reviews,0,0,0
410311,True,0,No user reviews,0,0,0
410320,True,9,Overwhelmingly Positive,3473,135,3608
410330,True,0,6 user reviews,4,2,6
410340,True,8,Very Positive,1472,141,1613
410350,True,0,No user reviews,0,0,0
410370,True,0,No user reviews,0,0,0
410380,True,6,Mostly Positive,22,6,28
410390,True,7,Positive,9,2,11
410420,True,0,8 user reviews,8,0,8
410430,True,5,Mixed,49,46,95
410440,True,6,Mostly Positive,11,3,14
410450,True,0,1 user reviews,0,1,1
410460,True,0,No user reviews,0,0,0
410470,True,0,1 user reviews,1,0,1
410480,True,0,3 user reviews,3,0,3
410490,True,0,8 user reviews,1,7,8
410530,True,0,4 user reviews,3,1,4
410531,True,0,4 user reviews,3,1,4
410540,True,0,4 user reviews,1,3,4
410550,True,0,3 user reviews,2,1,3
410570,True,6,Mostly Positive,94,31,125
410610,True,0,No user reviews,0,0,0
410620,True,0,No user reviews,0,0,0
410630,True,0,No user reviews,0,0,0
410640,True,0,No user reviews,0,0,0
410641,True,0,No user reviews,0,0,0
410650,True,0,No user reviews,0,0,0
410651,True,0,No user reviews,0,0,0
410652,True,0,No user reviews,0,0,0
410653,True,0,No user reviews,0,0,0
410654,True,0,No user reviews,0,0,0
410660,True,0,5 user reviews,4,1,5
410670,True,8,Very Positive,498,52,550
410680,True,0,1 user reviews,1,0,1
410690,True,0,No user reviews,0,0,0
410700,True,0,No user reviews,0,0,0
410710,True,8,Very Positive,588,55,643
410750,True,0,No user reviews,0,0,0
410760,True,0,No user reviews,0,0,0
410770,True,7,Positive,15,3,18
410780,True,7,Positive,22,1,23
410790,True,7,Positive,29,1,30
410800,True,0,No user reviews,0,0,0
410810,True,0,No user reviews,0,0,0
410820,True,8,Very Positive,203,12,215
410830,True,8,Very Positive,44,8,52
410840,True,6,Mostly Positive,149,51,200
410850,True,5,Mixed,309,173,482
410890,True,8,Very Positive,295,5,300
410900,True,8,Very Positive,2136,270,2406
410910,True,6,Mostly Positive,21,6,27
410920,True,0,No user reviews,0,0,0
410940,True,0,No user reviews,0,0,0
410950,True,0,No user reviews,0,0,0
410970,True,8,Very Positive,115,13,128
410980,True,9,Overwhelmingly Positive,477,25,502
410990,True,5,Mixed,27,32,59
411000,True,8,Very Positive,233,29,262
411010,True,0,3 user reviews,2,1,3
411020,True,0,2 user reviews,1,1,2
411030,True,0,No user reviews,0,0,0
411040,True,0,No user reviews,0,0,0
411050,True,0,No user reviews,0,0,0
411060,True,0,7 user reviews,7,0,7
411070,True,0,2 user reviews,0,2,2
411080,True,6,Mostly Positive,123,31,154
411100,True,0,2 user reviews,1,1,2
411110,True,0,7 user reviews,6,1,7
411120,True,8,Very Positive,45,11,56
411130,True,0,5 user reviews,3,2,5
411150,True,0,1 user reviews,1,0,1
411180,True,0,1 user reviews,1,0,1
411181,True,0,1 user reviews,1,0,1
411182,True,0,No user reviews,0,0,0
411183,True,0,No user reviews,0,0,0
411184,True,0,No user reviews,0,0,0
411185,True,0,No user reviews,0,0,0
411186,True,0,No user reviews,0,0,0
411187,True,0,No user reviews,0,0,0
411188,True,0,No user reviews,0,0,0
411189,True,0,1 user reviews,1,0,1
411190,True,0,No user reviews,0,0,0
411191,True,0,No user reviews,0,0,0
411192,True,0,No user reviews,0,0,0
411193,True,0,No user reviews,0,0,0
411194,True,0,No user reviews,0,0,0
411300,True,5,Mixed,2363,1185,3548
411310,True,8,Very Positive,60,8,68
411320,True,7,Positive,27,3,30
411330,True,6,Mostly Positive,117,42,159
411340,True,0,1 user reviews,1,0,1
411350,True,0,No user reviews,0,0,0
411370,True,8,Very Positive,645,48,693
411380,True,7,Positive,12,1,13
411390,True,0,1 user reviews,0,1,1
411400,True,0,7 user reviews,6,1,7
411401,True,0,4 user reviews,4,0,4
411410,True,0,No user reviews,0,0,0
411420,True,5,Mixed,6,5,11
411460,True,0,8 user reviews,6,2,8
411470,True,0,5 user reviews,5,0,5
411480,True,5,Mixed,13,6,19
411510,True,0,No user reviews,0,0,0
411520,True,0,5 user reviews,2,3,5
411530,True,0,7 user reviews,6,1,7
411550,True,5,Mixed,6,4,10
411560,True,8,Very Positive,686,122,808
411570,True,8,Very Positive,107,13,120
411580,True,0,No user reviews,0,0,0
411590,True,6,Mostly Positive,17,5,22
411600,True,4,Mostly Negative,19,31,50
411610,True,7,Positive,12,0,12
411620,True,5,Mixed,16,11,27
411630,True,5,Mixed,5,6,11
411650,True,6,Mostly Positive,26,11,37
411680,True,7,Positive,30,3,33
411690,True,6,Mostly Positive,14,5,19
411720,True,0,1 user reviews,1,0,1
411730,True,0,1 user reviews,1,0,1
411740,True,0,7 user reviews,4,3,7
411750,True,6,Mostly Positive,29,8,37
411760,True,6,Mostly Positive,54,22,76
411820,True,0,4 user reviews,3,1,4
411830,True,8,Very Positive,1402,77,1479
411850,True,0,No user reviews,0,0,0
411860,True,0,No user reviews,0,0,0
411870,True,7,Positive,12,0,12
411880,True,0,1 user reviews,1,0,1
411890,True,7,Positive,32,5,37
411891,True,6,Mostly Positive,41,16,57
411892,True,6,Mostly Positive,43,12,55
411893,True,8,Very Positive,171,12,183
411894,True,7,Positive,41,3,44
411900,True,0,5 user reviews,1,4,5
411901,True,0,3 user reviews,2,1,3
411910,True,6,Mostly Positive,28,10,38
411911,True,0,9 user reviews,9,0,9
411920,True,6,Mostly Positive,15,4,19
411930,True,7,Positive,30,4,34
411950,True,8,Very Positive,208,9,217
411960,True,9,Overwhelmingly Positive,1737,25,1762
411970,True,8,Very Positive,372,14,386
411980,True,8,Very Positive,85,3,88
412000,True,0,No user reviews,0,0,0
412010,True,0,9 user reviews,2,7,9
412020,True,8,Very Positive,8677,1769,10446
412050,True,8,Very Positive,247,42,289
412080,True,0,No user reviews,0,0,0
412090,True,4,Mostly Negative,5,8,13
412170,True,8,Very Positive,58,11,69
412210,True,0,6 user reviews,3,3,6
412220,True,0,No user reviews,0,0,0
412230,True,0,4 user reviews,2,2,4
412250,True,0,5 user reviews,3,2,5
412270,True,6,Mostly Positive,26,9,35
412290,True,4,Mostly Negative,4,11,15
412310,True,6,Mostly Positive,40,13,53
412330,True,7,Positive,17,2,19
412331,True,0,9 user reviews,8,1,9
412332,True,6,Mostly Positive,19,7,26
412333,True,7,Positive,20,4,24
412350,True,0,No user reviews,0,0,0
412351,True,0,No user reviews,0,0,0
412352,True,0,1 user reviews,0,1,1
412360,True,0,4 user reviews,4,0,4
412370,True,0,7 user reviews,4,3,7
412380,True,0,6 user reviews,5,1,6
412390,True,0,No user reviews,0,0,0
412400,True,5,Mixed,10,14,24
412410,True,5,Mixed,14,13,27
412430,True,0,No user reviews,0,0,0
412440,True,0,4 user reviews,1,3,4
412450,True,5,Mixed,455,323,778
412460,True,4,Mostly Negative,35,64,99
412470,True,0,5 user reviews,3,2,5
412480,True,7,Positive,22,2,24
412490,True,0,6 user reviews,3,3,6
412520,True,5,Mixed,95,41,136
412530,True,5,Mixed,6,4,10
412540,True,0,4 user reviews,2,2,4
412550,True,0,No user reviews,0,0,0
412560,True,0,1 user reviews,0,1,1
412580,True,7,Positive,12,1,13
412590,True,0,No user reviews,0,0,0
412600,True,4,Mostly Negative,14,22,36
412620,True,8,Very Positive,67,2,69
412630,True,0,1 user reviews,0,1,1
412640,True,0,2 user reviews,1,1,2
412660,True,6,Mostly Positive,44,17,61
412670,True,8,Very Positive,186,4,190
412680,True,0,No user reviews,0,0,0
412720,True,8,Very Positive,417,66,483
412730,True,0,8 user reviews,0,8,8
412740,True,6,Mostly Positive,1651,421,2072
412760,True,0,3 user reviews,3,0,3
412770,True,8,Very Positive,187,44,231
412790,True,6,Mostly Positive,86,29,115
412820,True,0,No user reviews,0,0,0
412821,True,0,No user reviews,0,0,0
412830,True,9,Overwhelmingly Positive,1919,84,2003
412870,True,0,1 user reviews,1,0,1
412880,True,5,Mixed,840,529,1369
412900,True,0,1 user reviews,1,0,1
412930,True,7,Positive,11,1,12
412940,True,0,2 user reviews,1,1,2
412950,True,0,No user reviews,0,0,0
412951,True,0,No user reviews,0,0,0
412960,True,0,1 user reviews,0,1,1
412970,True,0,5 user reviews,2,3,5
412980,True,0,No user reviews,0,0,0
412990,True,0,No user reviews,0,0,0
413000,True,0,No user reviews,0,0,0
413001,True,0,No user reviews,0,0,0
413010,True,0,No user reviews,0,0,0
413030,True,5,Mixed,37,22,59
413040,True,0,1 user reviews,1,0,1
413060,True,0,3 user reviews,2,1,3
413080,True,0,No user reviews,0,0,0
413090,True,0,No user reviews,0,0,0
413100,True,0,No user reviews,0,0,0
413110,True,5,Mixed,44,40,84
413120,True,0,No user reviews,0,0,0
413150,True,9,Overwhelmingly Positive,124540,1518,126058
413160,True,8,Very Positive,59,4,63
413170,True,0,3 user reviews,1,2,3
413180,True,0,No user reviews,0,0,0
413210,True,0,4 user reviews,4,0,4
413220,True,7,Positive,10,1,11
413230,True,7,Positive,13,0,13
413240,True,6,Mostly Positive,8,3,11
413250,True,0,No user reviews,0,0,0
413260,True,0,5 user reviews,5,0,5
413290,True,5,Mixed,34,17,51
413330,True,0,4 user reviews,3,1,4
413340,True,0,No user reviews,0,0,0
413350,True,0,1 user reviews,0,1,1
413360,True,5,Mixed,133,82,215
413370,True,8,Very Positive,234,32,266
413380,True,0,9 user reviews,2,7,9
413390,True,4,Mostly Negative,5,8,13
413410,True,9,Overwhelmingly Positive,7116,194,7310
413420,True,9,Overwhelmingly Positive,5362,145,5507
413440,True,0,No user reviews,0,0,0
413470,True,0,2 user reviews,1,1,2
413480,True,7,Positive,9,2,11
413490,True,0,3 user reviews,1,2,3
413500,True,7,Positive,9,1,10
413510,True,6,Mostly Positive,7,3,10
413540,True,7,Positive,10,0,10
413570,True,0,No user reviews,0,0,0
413580,True,7,Positive,10,1,11
413590,True,0,No user reviews,0,0,0
413600,True,5,Mixed,7,5,12
413610,True,7,Positive,13,3,16
413620,True,0,No user reviews,0,0,0
413650,True,0,No user reviews,0,0,0
413661,True,0,No user reviews,0,0,0
413680,True,6,Mostly Positive,40,17,57
413690,True,0,No user reviews,0,0,0
413700,True,0,9 user reviews,9,0,9
413710,True,5,Mixed,392,276,668
413720,True,0,No user reviews,0,0,0
413730,True,0,No user reviews,0,0,0
413740,True,5,Mixed,9,7,16
413750,True,0,1 user reviews,1,0,1
413760,True,0,2 user reviews,1,1,2
413770,True,0,No user reviews,0,0,0
413790,True,0,4 user reviews,4,0,4
413800,True,0,No user reviews,0,0,0
413801,True,0,No user reviews,0,0,0
413810,True,0,No user reviews,0,0,0
413811,True,0,No user reviews,0,0,0
413812,True,0,No user reviews,0,0,0
413813,True,0,No user reviews,0,0,0
413814,True,0,No user reviews,0,0,0
413815,True,0,No user reviews,0,0,0
413816,True,0,No user reviews,0,0,0
413817,True,0,No user reviews,0,0,0
413830,True,5,Mixed,6,5,11
413850,True,7,Positive,12,0,12
413851,True,0,2 user reviews,2,0,2
413852,True,0,1 user reviews,1,0,1
413853,True,0,1 user reviews,1,0,1
413854,True,0,1 user reviews,1,0,1
413855,True,0,1 user reviews,1,0,1
413856,True,0,1 user reviews,1,0,1
413857,True,0,1 user reviews,0,1,1
413858,True,0,1 user reviews,1,0,1
413859,True,0,2 user reviews,2,0,2
413870,True,7,Positive,43,5,48
413890,True,0,No user reviews,0,0,0
413891,True,0,No user reviews,0,0,0
413892,True,0,No user reviews,0,0,0
413893,True,0,No user reviews,0,0,0
413894,True,0,No user reviews,0,0,0
413895,True,0,No user reviews,0,0,0
413900,True,0,2 user reviews,2,0,2
413910,True,0,2 user reviews,2,0,2
413911,True,0,No user reviews,0,0,0
413912,True,0,No user reviews,0,0,0
413913,True,0,No user reviews,0,0,0
413914,True,0,No user reviews,0,0,0
413920,True,0,No user reviews,0,0,0
413930,True,0,2 user reviews,2,0,2
413931,True,0,No user reviews,0,0,0
413932,True,0,No user reviews,0,0,0
413940,True,0,3 user reviews,3,0,3
413950,True,0,2 user reviews,2,0,2
413960,True,0,No user reviews,0,0,0
413961,True,0,No user reviews,0,0,0
413962,True,0,No user reviews,0,0,0
413963,True,0,No user reviews,0,0,0
413964,True,0,No user reviews,0,0,0
413965,True,0,No user reviews,0,0,0
413966,True,0,No user reviews,0,0,0
413967,True,0,No user reviews,0,0,0
413970,True,0,No user reviews,0,0,0
413971,True,0,No user reviews,0,0,0
413972,True,0,No user reviews,0,0,0
413973,True,0,No user reviews,0,0,0
413974,True,0,No user reviews,0,0,0
413975,True,0,No user reviews,0,0,0
413990,True,0,8 user reviews,8,0,8
413991,True,7,Positive,10,0,10
414010,True,0,1 user reviews,1,0,1
414030,True,0,No user reviews,0,0,0
414050,True,0,No user reviews,0,0,0
414060,True,0,8 user reviews,3,5,8
414080,True,5,Mixed,67,50,117
414090,True,0,5 user reviews,2,3,5
414100,True,0,8 user reviews,7,1,8
414110,True,0,5 user reviews,5,0,5
414120,True,8,Very Positive,130,17,147
414130,True,5,Mixed,118,91,209
414140,True,0,3 user reviews,1,2,3
414150,True,8,Very Positive,65,9,74
414160,True,0,8 user reviews,7,1,8
414180,True,0,4 user reviews,4,0,4
414190,True,6,Mostly Positive,208,65,273
414210,True,0,1 user reviews,1,0,1
414230,True,0,1 user reviews,1,0,1
414231,True,0,3 user reviews,1,2,3
414232,True,0,3 user reviews,2,1,3
414233,True,0,No user reviews,0,0,0
414234,True,0,No user reviews,0,0,0
414235,True,0,2 user reviews,0,2,2
414236,True,0,No user reviews,0,0,0
414237,True,0,1 user reviews,1,0,1
414238,True,0,No user reviews,0,0,0
414240,True,0,No user reviews,0,0,0
414250,True,0,No user reviews,0,0,0
414260,True,5,Mixed,14,8,22
414300,True,0,No user reviews,0,0,0
414301,True,0,No user reviews,0,0,0
414310,True,0,4 user reviews,4,0,4
414330,True,4,Mostly Negative,8,14,22
414340,True,8,Very Positive,15175,1355,16530
414360,True,0,3 user reviews,3,0,3
414370,True,7,Positive,13,1,14
414460,True,0,No user reviews,0,0,0
414470,True,6,Mostly Positive,14,6,20
414480,True,0,No user reviews,0,0,0
414490,True,7,Positive,18,0,18
414500,True,0,3 user reviews,0,3,3
414510,True,8,Very Positive,213,42,255
414530,True,0,2 user reviews,1,1,2
414550,True,5,Mixed,42,23,65
414570,True,0,No user reviews,0,0,0
414580,True,0,8 user reviews,4,4,8
414590,True,0,No user reviews,0,0,0
414600,True,0,1 user reviews,1,0,1
414601,True,0,4 user reviews,4,0,4
414602,True,0,No user reviews,0,0,0
414603,True,0,No user reviews,0,0,0
414610,True,0,1 user reviews,1,0,1
414620,True,0,1 user reviews,1,0,1
414640,True,0,1 user reviews,1,0,1
414650,True,0,No user reviews,0,0,0
414651,True,4,Mostly Negative,5,10,15
414660,True,8,Very Positive,89,16,105
414670,True,0,7 user reviews,7,0,7
414671,True,0,3 user reviews,3,0,3
414672,True,0,7 user reviews,7,0,7
414673,True,0,3 user reviews,3,0,3
414674,True,0,2 user reviews,2,0,2
414675,True,0,4 user reviews,4,0,4
414680,True,0,1 user reviews,1,0,1
414700,True,8,Very Positive,3396,706,4102
414710,True,0,No user reviews,0,0,0
414720,True,8,Very Positive,272,46,318
414730,True,0,5 user reviews,4,1,5
414740,True,5,Mixed,489,438,927
414750,True,0,3 user reviews,2,1,3
414760,True,0,9 user reviews,8,1,9
414770,True,0,3 user reviews,1,2,3
414780,True,0,5 user reviews,5,0,5
414790,True,0,3 user reviews,3,0,3
414810,True,0,6 user reviews,5,1,6
414830,True,0,3 user reviews,2,1,3
414831,True,0,No user reviews,0,0,0
414832,True,0,No user reviews,0,0,0
414840,True,0,No user reviews,0,0,0
414841,True,0,No user reviews,0,0,0
414842,True,0,No user reviews,0,0,0
414843,True,0,No user reviews,0,0,0
414844,True,0,No user reviews,0,0,0
414845,True,0,No user reviews,0,0,0
414850,True,0,2 user reviews,2,0,2
414860,True,0,4 user reviews,2,2,4
414861,True,0,No user reviews,0,0,0
414870,True,8,Very Positive,649,89,738
414880,True,0,2 user reviews,2,0,2
414890,True,0,No user reviews,0,0,0
414900,True,0,No user reviews,0,0,0
414901,True,0,No user reviews,0,0,0
414902,True,0,No user reviews,0,0,0
414920,True,6,Mostly Positive,92,29,121
414950,True,5,Mixed,77,35,112
415000,True,7,Positive,31,0,31
415010,True,5,Mixed,19,22,41
415030,True,6,Mostly Positive,158,57,215
415040,True,0,2 user reviews,2,0,2
415070,True,0,No user reviews,0,0,0
415080,True,3,Negative,4,30,34
415090,True,7,Positive,15,1,16
415100,True,0,No user reviews,0,0,0
415101,True,0,No user reviews,0,0,0
415102,True,0,No user reviews,0,0,0
415103,True,0,No user reviews,0,0,0
415104,True,0,No user reviews,0,0,0
415105,True,0,No user reviews,0,0,0
415106,True,0,No user reviews,0,0,0
415107,True,0,No user reviews,0,0,0
415110,True,0,No user reviews,0,0,0
415111,True,0,No user reviews,0,0,0
415112,True,0,No user reviews,0,0,0
415113,True,0,No user reviews,0,0,0
415120,True,0,No user reviews,0,0,0
415140,True,0,9 user reviews,8,1,9
415150,True,7,Positive,37,9,46
415170,True,8,Very Positive,182,9,191
415180,True,7,Positive,37,2,39
415200,True,8,Very Positive,2817,293,3110
415220,True,0,No user reviews,0,0,0
415221,True,0,No user reviews,0,0,0
415240,True,8,Very Positive,60,12,72
415270,True,7,Positive,16,3,19
415300,True,6,Mostly Positive,121,43,164
415310,True,0,No user reviews,0,0,0
415320,True,0,1 user reviews,1,0,1
415330,True,0,3 user reviews,2,1,3
415340,True,0,2 user reviews,2,0,2
415350,True,8,Very Positive,89,19,108
415360,True,0,No user reviews,0,0,0
415390,True,0,7 user reviews,6,1,7
415400,True,6,Mostly Positive,44,15,59
415410,True,0,No user reviews,0,0,0
415420,True,8,Very Positive,316,45,361
415430,True,0,No user reviews,0,0,0
415431,True,0,2 user reviews,2,0,2
415440,True,0,No user reviews,0,0,0
415480,True,8,Very Positive,286,51,337
415530,True,0,3 user reviews,3,0,3
415540,True,0,No user reviews,0,0,0
415550,True,0,No user reviews,0,0,0
415560,True,0,No user reviews,0,0,0
415570,True,0,2 user reviews,1,1,2
415580,True,0,No user reviews,0,0,0
415590,True,5,Mixed,452,204,656
415600,True,8,Very Positive,58,11,69
415610,True,6,Mostly Positive,35,9,44
415620,True,0,No user reviews,0,0,0
415660,True,0,No user reviews,0,0,0
415670,True,8,Very Positive,54,3,57
415680,True,8,Very Positive,159,5,164
415700,True,7,Positive,28,4,32
415710,True,7,Positive,20,0,20
415720,True,0,No user reviews,0,0,0
415730,True,0,No user reviews,0,0,0
415740,True,6,Mostly Positive,176,57,233
415750,True,0,No user reviews,0,0,0
415760,True,0,No user reviews,0,0,0
415780,True,0,No user reviews,0,0,0
415790,True,0,No user reviews,0,0,0
415800,True,7,Positive,36,3,39
415830,True,7,Positive,41,7,48
415840,True,4,Mostly Negative,15,23,38
415850,True,8,Very Positive,143,31,174
415860,True,0,9 user reviews,4,5,9
415870,True,0,No user reviews,0,0,0
415880,True,8,Very Positive,326,62,388
415900,True,0,3 user reviews,2,1,3
415910,True,7,Positive,41,7,48
415920,True,8,Very Positive,136,4,140
415950,True,5,Mixed,68,49,117
415960,True,7,Positive,20,4,24
415980,True,0,3 user reviews,2,1,3
415990,True,7,Positive,15,3,18
416000,True,8,Very Positive,137,7,144
416020,True,4,Mostly Negative,13,26,39
416030,True,0,9 user reviews,8,1,9
416040,True,5,Mixed,7,8,15
416060,True,5,Mixed,46,30,76
416080,True,5,Mixed,57,39,96
416090,True,0,2 user reviews,1,1,2
416100,True,0,No user reviews,0,0,0
416110,True,8,Very Positive,50,5,55
416120,True,0,6 user reviews,4,2,6
416130,True,5,Mixed,11,6,17
416160,True,0,1 user reviews,0,1,1
416170,True,3,Negative,0,11,11
416180,True,7,Positive,18,3,21
416190,True,6,Mostly Positive,56,17,73
416200,True,5,Mixed,5,5,10
416210,True,5,Mixed,374,162,536
416220,True,0,6 user reviews,1,5,6
416240,True,8,Very Positive,62,5,67
416250,True,7,Positive,16,3,19
416260,True,0,7 user reviews,2,5,7
416290,True,0,7 user reviews,2,5,7
416310,True,5,Mixed,7,5,12
416320,True,0,8 user reviews,6,2,8
416330,True,0,7 user reviews,4,3,7
416340,True,7,Positive,10,2,12
416350,True,0,4 user reviews,1,3,4
416360,True,8,Very Positive,66,1,67
416370,True,5,Mixed,7,7,14
416380,True,6,Mostly Positive,53,19,72
416390,True,0,4 user reviews,3,1,4
416400,True,5,Mixed,6,4,10
416410,True,0,No user reviews,0,0,0
416420,True,7,Positive,13,3,16
416421,True,5,Mixed,6,6,12
416422,True,7,Positive,17,0,17
416423,True,0,No user reviews,0,0,0
416424,True,4,Mostly Negative,51,105,156
416430,True,0,3 user reviews,0,3,3
416440,True,0,No user reviews,0,0,0
416450,True,0,3 user reviews,2,1,3
416480,True,5,Mixed,19,27,46
416520,True,0,1 user reviews,1,0,1
416530,True,7,Positive,21,2,23
416550,True,8,Very Positive,72,4,76
416560,True,0,4 user reviews,3,1,4
416590,True,6,Mostly Positive,547,139,686
416600,True,8,Very Positive,581,51,632
416610,True,0,8 user reviews,0,8,8
416630,True,5,Mixed,17,25,42
416640,True,8,Very Positive,85,21,106
416650,True,0,No user reviews,0,0,0
416670,True,0,1 user reviews,1,0,1
416680,True,8,Very Positive,617,46,663
416690,True,0,3 user reviews,3,0,3
416700,True,0,2 user reviews,1,1,2
416710,True,0,1 user reviews,1,0,1
416711,True,0,No user reviews,0,0,0
416712,True,0,No user reviews,0,0,0
416713,True,0,No user reviews,0,0,0
416720,True,0,6 user reviews,4,2,6
416750,True,0,2 user reviews,2,0,2
416760,True,5,Mixed,19,14,33
416770,True,8,Very Positive,436,35,471
416790,True,8,Very Positive,160,18,178
416800,True,5,Mixed,13,6,19
416830,True,7,Positive,31,4,35
416840,True,0,1 user reviews,0,1,1
416850,True,5,Mixed,6,4,10
416870,True,8,Very Positive,71,7,78
416880,True,0,No user reviews,0,0,0
416900,True,0,5 user reviews,5,0,5
416920,True,0,5 user reviews,5,0,5
416940,True,7,Positive,10,1,11
417020,True,0,No user reviews,0,0,0
417060,True,0,8 user reviews,4,4,8
417080,True,0,2 user reviews,2,0,2
417110,True,8,Very Positive,69,12,81
417130,True,0,No user reviews,0,0,0
417150,True,7,Positive,33,7,40
417160,True,0,6 user reviews,5,1,6
417190,True,0,No user reviews,0,0,0
417200,True,6,Mostly Positive,19,8,27
417230,True,0,No user reviews,0,0,0
417260,True,0,5 user reviews,5,0,5
417280,True,0,No user reviews,0,0,0
417290,True,8,Very Positive,1262,131,1393
417300,True,0,6 user reviews,3,3,6
417310,True,5,Mixed,13,7,20
417330,True,0,No user reviews,0,0,0
417340,True,0,No user reviews,0,0,0
417350,True,0,3 user reviews,0,3,3
417380,True,6,Mostly Positive,22,7,29
417390,True,0,2 user reviews,1,1,2
417400,True,6,Mostly Positive,8,3,11
417410,True,7,Positive,10,0,10
417420,True,0,No user reviews,0,0,0
417430,True,5,Mixed,21,21,42
417461,True,8,Very Positive,186,34,220
417462,True,5,Mixed,70,77,147
417463,True,8,Very Positive,81,8,89
417464,True,8,Very Positive,147,20,167
417465,True,8,Very Positive,98,8,106
417480,True,0,2 user reviews,0,2,2
417520,True,0,No user reviews,0,0,0
417540,True,0,6 user reviews,4,2,6
417550,True,0,No user reviews,0,0,0
417560,True,0,8 user reviews,7,1,8
417570,True,0,1 user reviews,1,0,1
417580,True,7,Positive,16,1,17
417590,True,0,9 user reviews,8,1,9
417600,True,0,No user reviews,0,0,0
417610,True,0,4 user reviews,4,0,4
417620,True,0,1 user reviews,1,0,1
417630,True,0,No user reviews,0,0,0
417640,True,0,No user reviews,0,0,0
417650,True,0,1 user reviews,1,0,1
417660,True,0,No user reviews,0,0,0
417670,True,0,1 user reviews,1,0,1
417680,True,0,2 user reviews,1,1,2
417690,True,0,No user reviews,0,0,0
417700,True,0,1 user reviews,1,0,1
417720,True,0,1 user reviews,1,0,1
417730,True,0,7 user reviews,5,2,7
417740,True,0,6 user reviews,5,1,6
417750,True,6,Mostly Positive,186,78,264
417770,True,0,No user reviews,0,0,0
417790,True,0,4 user reviews,4,0,4
417800,True,0,No user reviews,0,0,0
417810,True,0,No user reviews,0,0,0
417820,True,0,No user reviews,0,0,0
417840,True,0,6 user reviews,0,6,6
417850,True,0,2 user reviews,1,1,2
417851,True,0,No user reviews,0,0,0
417860,True,8,Very Positive,200,35,235
417880,True,6,Mostly Positive,526,212,738
417890,True,0,7 user reviews,7,0,7
417900,True,0,8 user reviews,7,1,8
417910,True,5,Mixed,46,39,85
417920,True,4,Mostly Negative,3,7,10
417950,True,0,No user reviews,0,0,0
417961,True,0,No user reviews,0,0,0
417962,True,0,No user reviews,0,0,0
417963,True,0,No user reviews,0,0,0
417964,True,0,No user reviews,0,0,0
417965,True,0,No user reviews,0,0,0
417966,True,0,No user reviews,0,0,0
417967,True,0,No user reviews,0,0,0
417968,True,0,No user reviews,0,0,0
417971,True,0,No user reviews,0,0,0
417972,True,0,No user reviews,0,0,0
417973,True,0,No user reviews,0,0,0
417974,True,0,No user reviews,0,0,0
417980,True,7,Positive,17,2,19
417990,True,8,Very Positive,216,47,263
418000,True,0,No user reviews,0,0,0
418010,True,0,No user reviews,0,0,0
418020,True,0,No user reviews,0,0,0
418030,True,6,Mostly Positive,2873,1119,3992
418040,True,8,Very Positive,214,26,240
418050,True,0,9 user reviews,7,2,9
418060,True,6,Mostly Positive,26,11,37
418070,True,8,Very Positive,1261,106,1367
418080,True,0,No user reviews,0,0,0
418090,True,0,No user reviews,0,0,0
418110,True,0,No user reviews,0,0,0
418120,True,8,Very Positive,137,34,171
418130,True,0,No user reviews,0,0,0
418140,True,0,1 user reviews,1,0,1
418150,True,6,Mostly Positive,67,21,88
418160,True,0,9 user reviews,8,1,9
418170,True,0,2 user reviews,0,2,2
418180,True,5,Mixed,407,200,607
418190,True,8,Very Positive,312,25,337
418200,True,0,No user reviews,0,0,0
418240,True,9,Overwhelmingly Positive,4863,220,5083
418250,True,5,Mixed,117,69,186
418260,True,5,Mixed,6,4,10
418270,True,5,Mixed,17,8,25
418280,True,5,Mixed,6,9,15
418290,True,0,2 user reviews,1,1,2
418300,True,8,Very Positive,122,26,148
418320,True,0,4 user reviews,4,0,4
418340,True,8,Very Positive,4694,1122,5816
418350,True,0,No user reviews,0,0,0
418360,True,7,Positive,21,2,23
418370,True,8,Very Positive,7709,611,8320
418380,True,7,Positive,21,3,24
418430,True,0,No user reviews,0,0,0
418440,True,8,Very Positive,98,9,107
418460,True,8,Very Positive,15494,2281,17775
418480,True,0,No user reviews,0,0,0
418520,True,8,Very Positive,57,1,58
418530,True,8,Very Positive,2869,324,3193
418550,True,0,No user reviews,0,0,0
418566,True,0,No user reviews,0,0,0
418580,True,0,1 user reviews,1,0,1
418610,True,5,Mixed,20,21,41
418620,True,8,Very Positive,191,35,226
418640,True,0,8 user reviews,4,4,8
418650,True,9,Overwhelmingly Positive,1906,85,1991
418670,True,6,Mostly Positive,43,11,54
418720,True,0,No user reviews,0,0,0
418750,True,7,Positive,11,0,11
418760,True,0,2 user reviews,1,1,2
418770,True,0,1 user reviews,1,0,1
418780,True,0,1 user reviews,1,0,1
418790,True,0,2 user reviews,2,0,2
418800,True,0,5 user reviews,4,1,5
418810,True,5,Mixed,24,36,60
418820,True,0,9 user reviews,9,0,9
418840,True,0,No user reviews,0,0,0
418880,True,0,No user reviews,0,0,0
418881,True,0,No user reviews,0,0,0
418890,True,7,Positive,43,1,44
418900,True,0,5 user reviews,5,0,5
418910,True,5,Mixed,58,60,118
418940,True,5,Mixed,8,4,12
418950,True,8,Very Positive,174,39,213
418960,True,0,3 user reviews,0,3,3
418990,True,5,Mixed,45,31,76
419020,True,6,Mostly Positive,13,4,17
419040,True,0,No user reviews,0,0,0
419050,True,0,No user reviews,0,0,0
419060,True,0,No user reviews,0,0,0
419070,True,8,Very Positive,113,5,118
419080,True,5,Mixed,9,9,18
419090,True,5,Mixed,7,5,12
419110,True,0,9 user reviews,9,0,9
419120,True,0,No user reviews,0,0,0
419130,True,7,Positive,21,4,25
419170,True,0,2 user reviews,1,1,2
419180,True,0,1 user reviews,1,0,1
419190,True,0,1 user reviews,0,1,1
419200,True,0,1 user reviews,0,1,1
419210,True,0,No user reviews,0,0,0
419220,True,7,Positive,19,0,19
419230,True,0,5 user reviews,0,5,5
419240,True,5,Mixed,5,6,11
419250,True,0,2 user reviews,1,1,2
419270,True,0,No user reviews,0,0,0
419290,True,0,1 user reviews,1,0,1
419300,True,0,4 user reviews,4,0,4
419310,True,0,2 user reviews,2,0,2
419320,True,0,No user reviews,0,0,0
419330,True,0,No user reviews,0,0,0
419340,True,7,Positive,32,1,33
419350,True,0,No user reviews,0,0,0
419360,True,7,Positive,13,0,13
419400,True,0,No user reviews,0,0,0
419420,True,0,No user reviews,0,0,0
419440,True,0,No user reviews,0,0,0
419450,True,0,3 user reviews,0,3,3
419460,True,8,Very Positive,716,90,806
419480,True,6,Mostly Positive,1218,369,1587
419490,True,0,No user reviews,0,0,0
419500,True,0,8 user reviews,6,2,8
419540,True,0,No user reviews,0,0,0
419550,True,0,No user reviews,0,0,0
419551,True,0,No user reviews,0,0,0
419552,True,0,No user reviews,0,0,0
419553,True,0,No user reviews,0,0,0
419554,True,0,No user reviews,0,0,0
419560,True,0,No user reviews,0,0,0
419570,True,0,4 user reviews,2,2,4
419580,True,0,9 user reviews,8,1,9
419590,True,0,9 user reviews,7,2,9
419600,True,0,6 user reviews,3,3,6
419601,True,0,No user reviews,0,0,0
419602,True,0,No user reviews,0,0,0
419603,True,0,No user reviews,0,0,0
419604,True,0,No user reviews,0,0,0
419605,True,0,No user reviews,0,0,0
419610,True,0,1 user reviews,1,0,1
419611,True,0,No user reviews,0,0,0
419612,True,0,No user reviews,0,0,0
419620,True,0,1 user reviews,1,0,1
419621,True,0,No user reviews,0,0,0
419622,True,0,No user reviews,0,0,0
419623,True,0,No user reviews,0,0,0
419624,True,0,No user reviews,0,0,0
419625,True,0,No user reviews,0,0,0
419626,True,0,No user reviews,0,0,0
419627,True,0,No user reviews,0,0,0
419628,True,0,No user reviews,0,0,0
419629,True,0,No user reviews,0,0,0
419630,True,0,No user reviews,0,0,0
419631,True,0,No user reviews,0,0,0
419640,True,0,2 user reviews,1,1,2
419641,True,0,No user reviews,0,0,0
419642,True,0,No user reviews,0,0,0
419643,True,0,No user reviews,0,0,0
419644,True,0,No user reviews,0,0,0
419650,True,7,Positive,15,0,15
419660,True,0,7 user reviews,7,0,7
419670,True,0,No user reviews,0,0,0
419690,True,0,No user reviews,0,0,0
419700,True,5,Mixed,10,5,15
419710,True,0,8 user reviews,8,0,8
419720,True,0,No user reviews,0,0,0
419730,True,0,No user reviews,0,0,0
419750,True,0,No user reviews,0,0,0
419760,True,0,No user reviews,0,0,0
419770,True,0,No user reviews,0,0,0
419780,True,0,No user reviews,0,0,0
419790,True,0,No user reviews,0,0,0
419810,True,7,Positive,28,2,30
419820,True,0,No user reviews,0,0,0
419830,True,0,No user reviews,0,0,0
419840,True,0,No user reviews,0,0,0
419850,True,0,No user reviews,0,0,0
419860,True,0,No user reviews,0,0,0
419870,True,0,No user reviews,0,0,0
419880,True,0,No user reviews,0,0,0
419890,True,0,1 user reviews,0,1,1
419910,True,0,No user reviews,0,0,0
419951,True,0,3 user reviews,3,0,3
419980,True,0,2 user reviews,2,0,2
419990,True,7,Positive,20,1,21
420000,True,6,Mostly Positive,321,106,427
420020,True,0,4 user reviews,4,0,4
420030,True,7,Positive,13,1,14
420040,True,0,No user reviews,0,0,0
420050,True,0,No user reviews,0,0,0
420060,True,6,Mostly Positive,127,44,171
420070,True,5,Mixed,31,18,49
420090,True,0,No user reviews,0,0,0
420100,True,8,Very Positive,50,11,61
420110,True,9,Overwhelmingly Positive,2179,64,2243
420130,True,0,No user reviews,0,0,0
420140,True,0,No user reviews,0,0,0
420160,True,0,6 user reviews,3,3,6
420170,True,0,6 user reviews,5,1,6
420180,True,6,Mostly Positive,49,15,64
420210,True,0,8 user reviews,5,3,8
420250,True,0,1 user reviews,1,0,1
420270,True,4,Mostly Negative,12,25,37
420290,True,8,Very Positive,6859,1121,7980
420300,True,0,2 user reviews,0,2,2
420310,True,0,2 user reviews,1,1,2
420320,True,0,No user reviews,0,0,0
420322,True,0,No user reviews,0,0,0
420330,True,0,7 user reviews,3,4,7
420340,True,0,No user reviews,0,0,0
420360,True,0,9 user reviews,9,0,9
420370,True,0,4 user reviews,3,1,4
420380,True,7,Positive,14,3,17
420390,True,0,2 user reviews,1,1,2
420410,True,0,No user reviews,0,0,0
420440,True,8,Very Positive,623,104,727
420450,True,0,No user reviews,0,0,0
420460,True,0,No user reviews,0,0,0
420461,True,0,No user reviews,0,0,0
420462,True,0,No user reviews,0,0,0
420463,True,0,No user reviews,0,0,0
420490,True,5,Mixed,31,20,51
420491,True,0,No user reviews,0,0,0
420492,True,0,No user reviews,0,0,0
420493,True,0,No user reviews,0,0,0
420494,True,0,No user reviews,0,0,0
420500,True,5,Mixed,7,4,11
420520,True,8,Very Positive,219,31,250
420530,True,9,Overwhelmingly Positive,9432,186,9618
420540,True,0,No user reviews,0,0,0
420550,True,5,Mixed,44,23,67
420560,True,0,No user reviews,0,0,0
420570,True,7,Positive,15,1,16
420610,True,5,Mixed,197,147,344
420630,True,5,Mixed,8,4,12
420640,True,6,Mostly Positive,16,5,21
420660,True,8,Very Positive,70,8,78
420670,True,3,Negative,2,10,12
420680,True,8,Very Positive,121,13,134
420690,True,0,No user reviews,0,0,0
420730,True,0,No user reviews,0,0,0
420731,True,0,No user reviews,0,0,0
420740,True,8,Very Positive,709,56,765
420760,True,0,No user reviews,0,0,0
420770,True,6,Mostly Positive,58,17,75
420780,True,0,1 user reviews,1,0,1
420781,True,0,5 user reviews,5,0,5
420790,True,6,Mostly Positive,11,4,15
420810,True,0,1 user reviews,1,0,1
420821,True,0,5 user reviews,5,0,5
420822,True,0,No user reviews,0,0,0
420823,True,0,1 user reviews,0,1,1
420824,True,0,No user reviews,0,0,0
420825,True,0,No user reviews,0,0,0
420826,True,0,No user reviews,0,0,0
420828,True,0,No user reviews,0,0,0
420829,True,0,No user reviews,0,0,0
420840,True,8,Very Positive,147,8,155
420850,True,5,Mixed,26,13,39
420880,True,0,2 user reviews,0,2,2
420890,True,0,No user reviews,0,0,0
420900,True,0,5 user reviews,5,0,5
420920,True,5,Mixed,14,12,26
420930,True,8,Very Positive,499,88,587
420950,True,6,Mostly Positive,52,16,68
420970,True,0,5 user reviews,5,0,5
420980,True,8,Very Positive,147,12,159
421010,True,0,No user reviews,0,0,0
421020,True,6,Mostly Positive,1923,544,2467
421040,True,8,Very Positive,1067,211,1278
421050,True,8,Very Positive,476,116,592
421060,True,5,Mixed,12,10,22
421070,True,0,No user reviews,0,0,0
421080,True,0,No user reviews,0,0,0
421090,True,0,No user reviews,0,0,0
421100,True,0,No user reviews,0,0,0
421120,True,9,Overwhelmingly Positive,713,37,750
421130,True,0,No user reviews,0,0,0
421131,True,0,No user reviews,0,0,0
421140,True,0,5 user reviews,4,1,5
421160,True,0,No user reviews,0,0,0
421161,True,0,No user reviews,0,0,0
421162,True,0,No user reviews,0,0,0
421163,True,0,6 user reviews,4,2,6
421164,True,0,1 user reviews,0,1,1
421165,True,0,No user reviews,0,0,0
421166,True,0,5 user reviews,4,1,5
421170,True,6,Mostly Positive,573,172,745
421180,True,0,3 user reviews,1,2,3
421200,True,0,No user reviews,0,0,0
421210,True,0,3 user reviews,2,1,3
421220,True,0,1 user reviews,1,0,1
421230,True,0,No user reviews,0,0,0
421240,True,0,1 user reviews,1,0,1
421250,True,0,No user reviews,0,0,0
421260,True,8,Very Positive,58,4,62
421270,True,0,No user reviews,0,0,0
421271,True,0,No user reviews,0,0,0
421272,True,0,No user reviews,0,0,0
421273,True,0,No user reviews,0,0,0
421274,True,0,No user reviews,0,0,0
421275,True,0,No user reviews,0,0,0
421280,True,0,No user reviews,0,0,0
421290,True,0,2 user reviews,2,0,2
421300,True,0,1 user reviews,1,0,1
421310,True,0,No user reviews,0,0,0
421320,True,0,No user reviews,0,0,0
421330,True,0,No user reviews,0,0,0
421340,True,0,1 user reviews,1,0,1
421350,True,0,1 user reviews,1,0,1
421360,True,0,No user reviews,0,0,0
421370,True,0,7 user reviews,7,0,7
421380,True,0,1 user reviews,1,0,1
421390,True,0,1 user reviews,1,0,1
421400,True,0,No user reviews,0,0,0
421410,True,0,No user reviews,0,0,0
421420,True,0,1 user reviews,0,1,1
421430,True,0,3 user reviews,3,0,3
421440,True,0,No user reviews,0,0,0
421450,True,0,3 user reviews,3,0,3
421460,True,0,2 user reviews,2,0,2
421470,True,0,5 user reviews,5,0,5
421480,True,0,3 user reviews,3,0,3
421490,True,0,3 user reviews,3,0,3
421500,True,0,1 user reviews,0,1,1
421510,True,0,No user reviews,0,0,0
421520,True,0,1 user reviews,1,0,1
421530,True,0,3 user reviews,3,0,3
421540,True,0,No user reviews,0,0,0
421550,True,0,No user reviews,0,0,0
421560,True,0,8 user reviews,7,1,8
421570,True,0,No user reviews,0,0,0
421580,True,0,1 user reviews,1,0,1
421590,True,0,No user reviews,0,0,0
421600,True,5,Mixed,30,19,49
421610,True,7,Positive,21,4,25
421620,True,0,6 user reviews,3,3,6
421630,True,8,Very Positive,128,4,132
421640,True,0,No user reviews,0,0,0
421650,True,5,Mixed,113,137,250
421660,True,8,Very Positive,152,7,159
421670,True,7,Positive,20,0,20
421700,True,8,Very Positive,202,25,227
421710,True,7,Positive,9,1,10
421720,True,0,No user reviews,0,0,0
421730,True,0,No user reviews,0,0,0
421740,True,8,Very Positive,180,42,222
421760,True,0,4 user reviews,3,1,4
421770,True,0,6 user reviews,5,1,6
421771,True,0,2 user reviews,2,0,2
421780,True,0,No user reviews,0,0,0
421790,True,5,Mixed,9,7,16
421800,True,0,6 user reviews,6,0,6
421810,True,5,Mixed,92,45,137
421830,True,0,No user reviews,0,0,0
421860,True,0,1 user reviews,1,0,1
421870,True,0,9 user reviews,7,2,9
421880,True,5,Mixed,11,10,21
421890,True,5,Mixed,6,9,15
421900,True,5,Mixed,18,16,34
421910,True,7,Positive,18,3,21
421920,True,0,No user reviews,0,0,0
421940,True,0,5 user reviews,5,0,5
421950,True,0,3 user reviews,3,0,3
422010,True,0,2 user reviews,2,0,2
422020,True,5,Mixed,18,8,26
422030,True,0,6 user reviews,3,3,6
422080,True,0,No user reviews,0,0,0
422100,True,3,Negative,1,16,17
422110,True,8,Very Positive,103,5,108
422120,True,0,1 user reviews,1,0,1
422130,True,5,Mixed,21,28,49
422140,True,4,Mostly Negative,5,9,14
422160,True,0,No user reviews,0,0,0
422170,True,0,No user reviews,0,0,0
422180,True,0,4 user reviews,4,0,4
422181,True,0,3 user reviews,3,0,3
422182,True,0,2 user reviews,2,0,2
422190,True,0,1 user reviews,1,0,1
422191,True,0,No user reviews,0,0,0
422192,True,0,No user reviews,0,0,0
422193,True,0,No user reviews,0,0,0
422200,True,0,No user reviews,0,0,0
422201,True,0,No user reviews,0,0,0
422210,True,0,8 user reviews,1,7,8
422220,True,7,Positive,33,2,35
422230,True,0,No user reviews,0,0,0
422250,True,5,Mixed,16,24,40
422270,True,4,Mostly Negative,5,15,20
422280,True,0,No user reviews,0,0,0
422290,True,0,No user reviews,0,0,0
422300,True,6,Mostly Positive,15,4,19
422310,True,0,No user reviews,0,0,0
422360,True,0,No user reviews,0,0,0
422400,True,8,Very Positive,228,20,248
422420,True,2,Very Negative,40,262,302
422473,True,0,9 user reviews,7,2,9
422500,True,6,Mostly Positive,27,9,36
422510,True,8,Very Positive,226,13,239
422530,True,0,1 user reviews,1,0,1
422540,True,0,9 user reviews,5,4,9
422550,True,0,1 user reviews,1,0,1
422580,True,0,6 user reviews,5,1,6
422610,True,6,Mostly Positive,18,7,25
422630,True,0,No user reviews,0,0,0
422640,True,4,Mostly Negative,13,22,35
422650,True,5,Mixed,8,9,17
422670,True,0,3 user reviews,3,0,3
422690,True,0,1 user reviews,0,1,1
422691,True,0,1 user reviews,1,0,1
422760,True,8,Very Positive,53,13,66
422810,True,6,Mostly Positive,665,249,914
422860,True,8,Very Positive,140,18,158
422890,True,0,No user reviews,0,0,0
422900,True,8,Very Positive,569,51,620
422910,True,8,Very Positive,251,6,257
422920,True,8,Very Positive,104,12,116
422940,True,5,Mixed,46,38,84
422950,True,0,No user reviews,0,0,0
422960,True,0,No user reviews,0,0,0
422961,True,0,No user reviews,0,0,0
422970,True,9,Overwhelmingly Positive,3470,127,3597
422980,True,0,9 user reviews,5,4,9
423000,True,0,No user reviews,0,0,0
423010,True,7,Positive,14,1,15
423011,True,0,No user reviews,0,0,0
423012,True,0,No user reviews,0,0,0
423013,True,0,No user reviews,0,0,0
423014,True,0,No user reviews,0,0,0
423015,True,0,No user reviews,0,0,0
423016,True,0,No user reviews,0,0,0
423017,True,0,No user reviews,0,0,0
423018,True,0,No user reviews,0,0,0
423019,True,0,No user reviews,0,0,0
423020,True,0,No user reviews,0,0,0
423021,True,0,No user reviews,0,0,0
423022,True,0,No user reviews,0,0,0
423023,True,0,No user reviews,0,0,0
423024,True,0,No user reviews,0,0,0
423025,True,0,No user reviews,0,0,0
423026,True,0,No user reviews,0,0,0
423027,True,0,No user reviews,0,0,0
423028,True,0,No user reviews,0,0,0
423029,True,0,No user reviews,0,0,0
423030,True,0,No user reviews,0,0,0
423031,True,0,No user reviews,0,0,0
423032,True,0,No user reviews,0,0,0
423033,True,0,No user reviews,0,0,0
423034,True,0,No user reviews,0,0,0
423035,True,0,No user reviews,0,0,0
423036,True,0,No user reviews,0,0,0
423037,True,0,No user reviews,0,0,0
423038,True,0,No user reviews,0,0,0
423039,True,0,No user reviews,0,0,0
423040,True,0,No user reviews,0,0,0
423041,True,0,No user reviews,0,0,0
423042,True,0,No user reviews,0,0,0
423043,True,0,No user reviews,0,0,0
423044,True,0,No user reviews,0,0,0
423045,True,0,No user reviews,0,0,0
423046,True,0,No user reviews,0,0,0
423047,True,0,No user reviews,0,0,0
423048,True,0,No user reviews,0,0,0
423049,True,0,No user reviews,0,0,0
423050,True,0,No user reviews,0,0,0
423051,True,0,No user reviews,0,0,0
423052,True,0,No user reviews,0,0,0
423053,True,0,No user reviews,0,0,0
423054,True,0,No user reviews,0,0,0
423055,True,0,No user reviews,0,0,0
423056,True,0,No user reviews,0,0,0
423057,True,0,No user reviews,0,0,0
423058,True,0,No user reviews,0,0,0
423059,True,0,No user reviews,0,0,0
423060,True,0,No user reviews,0,0,0
423061,True,0,No user reviews,0,0,0
423062,True,0,No user reviews,0,0,0
423063,True,0,No user reviews,0,0,0
423064,True,0,No user reviews,0,0,0
423065,True,0,No user reviews,0,0,0
423066,True,0,No user reviews,0,0,0
423067,True,0,No user reviews,0,0,0
423068,True,0,No user reviews,0,0,0
423069,True,0,No user reviews,0,0,0
423070,True,0,No user reviews,0,0,0
423071,True,0,No user reviews,0,0,0
423072,True,0,No user reviews,0,0,0
423073,True,0,No user reviews,0,0,0
423074,True,0,No user reviews,0,0,0
423110,True,0,No user reviews,0,0,0
423120,True,8,Very Positive,184,30,214
423130,True,0,No user reviews,0,0,0
423180,True,0,2 user reviews,0,2,2
423220,True,0,5 user reviews,5,0,5
423230,True,8,Very Positive,3338,251,3589
423240,True,0,No user reviews,0,0,0
423270,True,0,8 user reviews,4,4,8
423320,True,8,Very Positive,64,14,78
423330,True,0,No user reviews,0,0,0
423363,True,6,Mostly Positive,9,3,12
423364,True,0,5 user reviews,3,2,5
423365,True,0,6 user reviews,6,0,6
423366,True,0,4 user reviews,4,0,4
423367,True,0,6 user reviews,4,2,6
423368,True,0,3 user reviews,2,1,3
423369,True,0,5 user reviews,4,1,5
423370,True,0,No user reviews,0,0,0
423410,True,0,No user reviews,0,0,0
423440,True,7,Positive,37,1,38
423450,True,0,No user reviews,0,0,0
423490,True,6,Mostly Positive,157,41,198
423550,True,6,Mostly Positive,26,11,37
423580,True,8,Very Positive,1205,226,1431
423590,True,8,Very Positive,154,33,187
423600,True,7,Positive,9,2,11
423610,True,6,Mostly Positive,32,13,45
423620,True,5,Mixed,139,63,202
423630,True,8,Very Positive,75,1,76
423640,True,0,No user reviews,0,0,0
423650,True,5,Mixed,24,17,41
423670,True,0,No user reviews,0,0,0
423700,True,4,Mostly Negative,7,23,30
423710,True,5,Mixed,40,52,92
423720,True,0,2 user reviews,1,1,2
423730,True,0,4 user reviews,3,1,4
423740,True,5,Mixed,11,7,18
423750,True,6,Mostly Positive,14,6,20
423760,True,0,3 user reviews,1,2,3
423770,True,6,Mostly Positive,58,18,76
423780,True,0,2 user reviews,1,1,2
423800,True,5,Mixed,24,13,37
423810,True,5,Mixed,40,26,66
423840,True,0,9 user reviews,3,6,9
423850,True,0,7 user reviews,6,1,7
423851,True,5,Mixed,7,4,11
423852,True,0,9 user reviews,8,1,9
423853,True,0,7 user reviews,7,0,7
423870,True,7,Positive,13,2,15
423880,True,7,Positive,27,3,30
423890,True,5,Mixed,11,8,19
423900,True,5,Mixed,12,6,18
423950,True,5,Mixed,83,54,137
424000,True,3,Negative,1,12,13
424010,True,0,9 user reviews,7,2,9
424020,True,7,Positive,10,0,10
424030,True,8,Very Positive,2569,467,3036
424040,True,7,Positive,12,2,14
424050,True,0,No user reviews,0,0,0
424060,True,4,Mostly Negative,3,7,10
424070,True,0,No user reviews,0,0,0
424100,True,0,4 user reviews,4,0,4
424120,True,0,2 user reviews,2,0,2
424170,True,6,Mostly Positive,18,7,25
424200,True,7,Positive,17,0,17
424210,True,0,No user reviews,0,0,0
424220,True,0,No user reviews,0,0,0
424240,True,0,No user reviews,0,0,0
424250,True,6,Mostly Positive,212,72,284
424260,True,5,Mixed,6,9,15
424280,True,8,Very Positive,102,3,105
424320,True,0,6 user reviews,5,1,6
424370,True,5,Mixed,13303,10076,23379
424580,True,0,1 user reviews,1,0,1
424590,True,5,Mixed,57,73,130
424610,True,0,No user reviews,0,0,0
424640,True,7,Positive,9,2,11
424690,True,0,No user reviews,0,0,0
424750,True,0,4 user reviews,4,0,4
424760,True,5,Mixed,13,12,25
424780,True,0,No user reviews,0,0,0
424800,True,0,No user reviews,0,0,0
424830,True,0,2 user reviews,1,1,2
424840,True,8,Very Positive,5162,544,5706
424850,True,0,5 user reviews,1,4,5
424860,True,0,2 user reviews,1,1,2
424870,True,0,8 user reviews,6,2,8
424880,True,0,2 user reviews,1,1,2
424950,True,0,No user reviews,0,0,0
425010,True,0,3 user reviews,2,1,3
425020,True,0,No user reviews,0,0,0
425030,True,0,1 user reviews,0,1,1
425040,True,7,Positive,10,0,10
425060,True,0,No user reviews,0,0,0
425070,True,7,Positive,32,6,38
425090,True,0,No user reviews,0,0,0
425100,True,0,No user reviews,0,0,0
425110,True,4,Mostly Negative,23,49,72
425120,True,7,Positive,35,0,35
425130,True,0,6 user reviews,4,2,6
425140,True,0,3 user reviews,3,0,3
425141,True,0,1 user reviews,1,0,1
425150,True,5,Mixed,7,9,16
425160,True,7,Positive,18,2,20
425170,True,0,1 user reviews,1,0,1
425180,True,0,2 user reviews,0,2,2
425181,True,0,No user reviews,0,0,0
425182,True,0,No user reviews,0,0,0
425190,True,0,1 user reviews,0,1,1
425200,True,0,No user reviews,0,0,0
425210,True,6,Mostly Positive,348,94,442
425220,True,6,Mostly Positive,326,93,419
425230,True,0,4 user reviews,3,1,4
425240,True,5,Mixed,19,14,33
425260,True,0,6 user reviews,4,2,6
425270,True,0,3 user reviews,3,0,3
425300,True,0,6 user reviews,0,6,6
425310,True,4,Mostly Negative,4,8,12
425330,True,7,Positive,10,0,10
425340,True,8,Very Positive,52,5,57
425360,True,7,Positive,46,0,46
425370,True,0,No user reviews,0,0,0
425380,True,0,No user reviews,0,0,0
425400,True,0,2 user reviews,2,0,2
425410,True,7,Positive,16,1,17
425420,True,0,No user reviews,0,0,0
425440,True,6,Mostly Positive,8,3,11
425450,True,6,Mostly Positive,8,3,11
425460,True,5,Mixed,16,7,23
425490,True,0,No user reviews,0,0,0
425500,True,0,1 user reviews,1,0,1
425530,True,0,2 user reviews,2,0,2
425540,True,5,Mixed,24,12,36
425541,True,0,1 user reviews,1,0,1
425542,True,0,3 user reviews,3,0,3
425544,True,0,2 user reviews,2,0,2
425550,True,0,1 user reviews,0,1,1
425560,True,0,1 user reviews,1,0,1
425570,True,0,No user reviews,0,0,0
425580,True,9,Overwhelmingly Positive,4998,120,5118
425600,True,8,Very Positive,58,8,66
425620,True,0,No user reviews,0,0,0
425630,True,0,No user reviews,0,0,0
425650,True,8,Very Positive,103,7,110
425670,True,8,Very Positive,204,37,241
425680,True,0,No user reviews,0,0,0
425681,True,0,No user reviews,0,0,0
425682,True,0,No user reviews,0,0,0
425683,True,0,No user reviews,0,0,0
425684,True,0,No user reviews,0,0,0
425685,True,0,No user reviews,0,0,0
425686,True,0,No user reviews,0,0,0
425687,True,0,No user reviews,0,0,0
425688,True,0,No user reviews,0,0,0
425689,True,0,No user reviews,0,0,0
425690,True,0,No user reviews,0,0,0
425710,True,0,No user reviews,0,0,0
425720,True,8,Very Positive,220,41,261
425750,True,0,1 user reviews,1,0,1
425760,True,0,3 user reviews,2,1,3
425770,True,8,Very Positive,107,1,108
425780,True,0,3 user reviews,0,3,3
425790,True,0,2 user reviews,0,2,2
425791,True,0,7 user reviews,2,5,7
425820,True,7,Positive,37,8,45
425840,True,8,Very Positive,181,40,221
425860,True,0,4 user reviews,3,1,4
425870,True,0,2 user reviews,0,2,2
425900,True,0,8 user reviews,6,2,8
425910,True,0,No user reviews,0,0,0
425920,True,0,No user reviews,0,0,0
425930,True,0,No user reviews,0,0,0
425940,True,0,No user reviews,0,0,0
425960,True,6,Mostly Positive,14,4,18
425961,True,0,No user reviews,0,0,0
425970,True,0,1 user reviews,1,0,1
425980,True,0,8 user reviews,7,1,8
425981,True,0,2 user reviews,1,1,2
425982,True,0,No user reviews,0,0,0
425990,True,0,2 user reviews,2,0,2
426000,True,8,Very Positive,2467,405,2872
426010,True,4,Mostly Negative,11,24,35
426040,True,5,Mixed,7,4,11
426050,True,7,Positive,15,0,15
426060,True,0,1 user reviews,0,1,1
426080,True,0,1 user reviews,0,1,1
426081,True,0,No user reviews,0,0,0
426100,True,4,Mostly Negative,18,44,62
426110,True,0,No user reviews,0,0,0
426120,True,0,No user reviews,0,0,0
426170,True,5,Mixed,12,7,19
426180,True,0,No user reviews,0,0,0
426181,True,0,No user reviews,0,0,0
426190,True,6,Mostly Positive,32,13,45
426200,True,0,No user reviews,0,0,0
426210,True,5,Mixed,7,8,15
426220,True,0,No user reviews,0,0,0
426230,True,0,No user reviews,0,0,0
426240,True,7,Positive,10,1,11
426270,True,0,No user reviews,0,0,0
426290,True,7,Positive,30,7,37
426310,True,5,Mixed,107,46,153
426320,True,0,No user reviews,0,0,0
426321,True,5,Mixed,109,76,185
426330,True,8,Very Positive,117,12,129
426340,True,0,No user reviews,0,0,0
426350,True,0,1 user reviews,1,0,1
426360,True,0,2 user reviews,2,0,2
426370,True,0,No user reviews,0,0,0
426380,True,0,1 user reviews,1,0,1
426400,True,0,3 user reviews,3,0,3
426410,True,0,No user reviews,0,0,0
426420,True,7,Positive,20,2,22
426430,True,0,1 user reviews,1,0,1
426440,True,7,Positive,11,1,12
426450,True,0,No user reviews,0,0,0
426460,True,0,4 user reviews,4,0,4
426470,True,0,2 user reviews,2,0,2
426480,True,0,1 user reviews,1,0,1
426490,True,0,1 user reviews,1,0,1
426500,True,0,1 user reviews,1,0,1
426510,True,0,1 user reviews,1,0,1
426520,True,0,1 user reviews,1,0,1
426530,True,0,No user reviews,0,0,0
426540,True,0,1 user reviews,1,0,1
426560,True,0,1 user reviews,1,0,1
426580,True,0,No user reviews,0,0,0
426590,True,3,Negative,6,33,39
426610,True,0,No user reviews,0,0,0
426630,True,6,Mostly Positive,166,60,226
426650,True,0,No user reviews,0,0,0
426660,True,0,No user reviews,0,0,0
426690,True,8,Very Positive,68,3,71
426700,True,0,No user reviews,0,0,0
426710,True,0,No user reviews,0,0,0
426720,True,0,No user reviews,0,0,0
426730,True,8,Very Positive,51,1,52
426740,True,0,No user reviews,0,0,0
426741,True,0,No user reviews,0,0,0
426742,True,0,No user reviews,0,0,0
426743,True,0,No user reviews,0,0,0
426750,True,0,No user reviews,0,0,0
426790,True,8,Very Positive,754,82,836
426810,True,0,No user reviews,0,0,0
426820,True,0,2 user reviews,2,0,2
426860,True,5,Mixed,22,17,39
426900,True,0,No user reviews,0,0,0
426920,True,0,2 user reviews,2,0,2
426921,True,0,1 user reviews,1,0,1
426922,True,0,1 user reviews,1,0,1
426923,True,0,1 user reviews,1,0,1
426924,True,0,1 user reviews,1,0,1
426925,True,0,2 user reviews,2,0,2
426926,True,0,1 user reviews,1,0,1
426927,True,0,1 user reviews,1,0,1
426928,True,0,2 user reviews,2,0,2
426929,True,0,1 user reviews,1,0,1
426930,True,6,Mostly Positive,22,8,30
426951,True,0,7 user reviews,6,1,7
426952,True,0,5 user reviews,5,0,5
426960,True,0,No user reviews,0,0,0
426980,True,0,No user reviews,0,0,0
426990,True,0,1 user reviews,1,0,1
426991,True,0,1 user reviews,1,0,1
426992,True,0,1 user reviews,1,0,1
426993,True,0,1 user reviews,1,0,1
426994,True,0,1 user reviews,1,0,1
426995,True,0,1 user reviews,1,0,1
426996,True,0,1 user reviews,1,0,1
426997,True,0,1 user reviews,1,0,1
426998,True,0,1 user reviews,1,0,1
426999,True,0,1 user reviews,1,0,1
427000,True,0,1 user reviews,1,0,1
427001,True,0,1 user reviews,1,0,1
427002,True,0,1 user reviews,1,0,1
427003,True,0,1 user reviews,1,0,1
427004,True,0,2 user reviews,2,0,2
427005,True,0,5 user reviews,5,0,5
427006,True,0,1 user reviews,1,0,1
427007,True,0,2 user reviews,2,0,2
427008,True,0,1 user reviews,1,0,1
427020,True,0,No user reviews,0,0,0
427030,True,8,Very Positive,125,20,145
427040,True,0,5 user reviews,0,5,5
427050,True,0,6 user reviews,3,3,6
427080,True,0,No user reviews,0,0,0
427090,True,0,No user reviews,0,0,0
427100,True,5,Mixed,495,329,824
427190,True,8,Very Positive,1462,120,1582
427240,True,8,Very Positive,290,40,330
427250,True,6,Mostly Positive,801,203,1004
427270,True,5,Mixed,63,36,99
427290,True,6,Mostly Positive,3440,1208,4648
427300,True,0,3 user reviews,3,0,3
427310,True,0,3 user reviews,3,0,3
427320,True,0,2 user reviews,1,1,2
427340,True,0,No user reviews,0,0,0
427350,True,0,1 user reviews,1,0,1
427360,True,0,No user reviews,0,0,0
427370,True,0,No user reviews,0,0,0
427380,True,0,3 user reviews,3,0,3
427390,True,0,No user reviews,0,0,0
427400,True,0,1 user reviews,0,1,1
427460,True,0,No user reviews,0,0,0
427470,True,6,Mostly Positive,192,65,257
427480,True,5,Mixed,17,15,32
427490,True,8,Very Positive,327,67,394
427510,True,6,Mostly Positive,183,47,230
427520,True,9,Overwhelmingly Positive,46522,520,47042
427550,True,6,Mostly Positive,21,9,30
427560,True,0,3 user reviews,0,3,3
427561,True,7,Positive,11,1,12
427570,True,5,Mixed,60,49,109
427601,True,0,No user reviews,0,0,0
427603,True,0,No user reviews,0,0,0
427610,True,0,8 user reviews,3,5,8
427630,True,0,No user reviews,0,0,0
427640,True,6,Mostly Positive,11,4,15
427650,True,0,2 user reviews,2,0,2
427660,True,5,Mixed,68,31,99
427670,True,0,No user reviews,0,0,0
427671,True,0,No user reviews,0,0,0
427672,True,0,No user reviews,0,0,0
427673,True,0,No user reviews,0,0,0
427674,True,0,No user reviews,0,0,0
427675,True,0,No user reviews,0,0,0
427676,True,0,No user reviews,0,0,0
427677,True,0,No user reviews,0,0,0
427678,True,0,No user reviews,0,0,0
427679,True,0,No user reviews,0,0,0
427680,True,6,Mostly Positive,37,10,47
427700,True,8,Very Positive,90,4,94
427720,True,0,9 user reviews,8,1,9
427730,True,6,Mostly Positive,6069,2083,8152
427750,True,0,2 user reviews,2,0,2
427760,True,8,Very Positive,418,65,483
427770,True,0,7 user reviews,7,0,7
427780,True,5,Mixed,8,10,18
427790,True,0,1 user reviews,1,0,1
427810,True,5,Mixed,122,56,178
427820,True,8,Very Positive,499,87,586
427830,True,0,1 user reviews,1,0,1
427860,True,5,Mixed,43,21,64
427880,True,5,Mixed,365,182,547
427890,True,7,Positive,14,2,16
427910,True,5,Mixed,89,44,133
427920,True,8,Very Positive,489,81,570
427930,True,5,Mixed,13,8,21
427940,True,0,No user reviews,0,0,0
427950,True,5,Mixed,110,94,204
427970,True,0,4 user reviews,1,3,4
427980,True,8,Very Positive,116,27,143
428010,True,7,Positive,19,0,19
428020,True,0,7 user reviews,5,2,7
428030,True,0,No user reviews,0,0,0
428040,True,7,Positive,22,2,24
428050,True,0,No user reviews,0,0,0
428060,True,0,9 user reviews,9,0,9
428080,True,8,Very Positive,296,9,305
428090,True,0,No user reviews,0,0,0
428100,True,7,Positive,41,6,47
428110,True,0,9 user reviews,6,3,9
428130,True,0,3 user reviews,3,0,3
428140,True,0,8 user reviews,8,0,8
428170,True,7,Positive,9,2,11
428180,True,5,Mixed,28,18,46
428190,True,4,Mostly Negative,23,65,88
428200,True,5,Mixed,18,8,26
428210,True,4,Mostly Negative,7,13,20
428220,True,6,Mostly Positive,38,13,51
428230,True,0,3 user reviews,2,1,3
428240,True,0,2 user reviews,2,0,2
428250,True,0,9 user reviews,3,6,9
428260,True,0,7 user reviews,3,4,7
428270,True,0,9 user reviews,5,4,9
428280,True,7,Positive,15,1,16
428310,True,0,1 user reviews,1,0,1
428311,True,0,2 user reviews,2,0,2
428312,True,0,2 user reviews,2,0,2
428320,True,0,No user reviews,0,0,0
428340,True,8,Very Positive,89,11,100
428350,True,6,Mostly Positive,35,9,44
428370,True,6,Mostly Positive,501,150,651
428400,True,0,6 user reviews,6,0,6
428410,True,0,5 user reviews,3,2,5
428420,True,4,Mostly Negative,7,13,20
428440,True,5,Mixed,44,30,74
428460,True,7,Positive,36,6,42
428490,True,6,Mostly Positive,10,3,13
428500,True,0,2 user reviews,1,1,2
428501,True,0,2 user reviews,0,2,2
428510,True,5,Mixed,9,5,14
428520,True,0,6 user reviews,1,5,6
428530,True,0,8 user reviews,7,1,8
428540,True,6,Mostly Positive,42,11,53
428550,True,8,Very Positive,2860,188,3048
428560,True,0,No user reviews,0,0,0
428561,True,0,No user reviews,0,0,0
428562,True,0,No user reviews,0,0,0
428563,True,0,No user reviews,0,0,0
428564,True,0,No user reviews,0,0,0
428590,True,0,3 user reviews,0,3,3
428600,True,0,2 user reviews,2,0,2
428601,True,0,3 user reviews,3,0,3
428602,True,0,6 user reviews,6,0,6
428603,True,0,1 user reviews,1,0,1
428604,True,0,1 user reviews,1,0,1
428605,True,0,1 user reviews,1,0,1
428610,True,5,Mixed,31,15,46
428630,True,4,Mostly Negative,22,48,70
428660,True,8,Very Positive,998,148,1146
428690,True,6,Mostly Positive,4128,1433,5561
428710,True,0,No user reviews,0,0,0
428720,True,0,No user reviews,0,0,0
428730,True,5,Mixed,51,24,75
428740,True,0,3 user reviews,1,2,3
428750,True,8,Very Positive,321,14,335
428760,True,0,6 user reviews,3,3,6
428770,True,0,No user reviews,0,0,0
428780,True,0,2 user reviews,2,0,2
428800,True,4,Mostly Negative,16,37,53
428810,True,5,Mixed,6,5,11
428820,True,0,No user reviews,0,0,0
428821,True,0,No user reviews,0,0,0
428830,True,7,Positive,37,2,39
428840,True,0,No user reviews,0,0,0
428860,True,8,Very Positive,102,18,120
428870,True,0,5 user reviews,4,1,5
428880,True,8,Very Positive,226,33,259
428890,True,0,1 user reviews,1,0,1
428900,True,8,Very Positive,241,49,290
428920,True,0,4 user reviews,3,1,4
428930,True,0,1 user reviews,1,0,1
428940,True,0,2 user reviews,0,2,2
428950,True,5,Mixed,38,44,82
428970,True,0,No user reviews,0,0,0
428980,True,0,6 user reviews,2,4,6
429010,True,0,1 user reviews,1,0,1
429011,True,0,1 user reviews,1,0,1
429020,True,4,Mostly Negative,8,13,21
429040,True,0,9 user reviews,6,3,9
429050,True,8,Very Positive,2023,429,2452
429060,True,4,Mostly Negative,6,17,23
429110,True,0,2 user reviews,1,1,2
429120,True,0,6 user reviews,3,3,6
429160,True,0,2 user reviews,0,2,2
429180,True,4,Mostly Negative,4,11,15
429200,True,5,Mixed,10,5,15
429220,True,5,Mixed,12,8,20
429250,True,0,2 user reviews,2,0,2
429260,True,0,6 user reviews,6,0,6
429270,True,0,3 user reviews,3,0,3
429280,True,5,Mixed,10,5,15
429300,True,7,Positive,14,0,14
429310,True,0,No user reviews,0,0,0
429330,True,8,Very Positive,77,8,85
429350,True,0,9 user reviews,8,1,9
429360,True,7,Positive,35,1,36
429380,True,0,No user reviews,0,0,0
429390,True,5,Mixed,38,19,57
429400,True,0,No user reviews,0,0,0
429430,True,0,3 user reviews,2,1,3
429450,True,0,9 user reviews,4,5,9
429460,True,0,1 user reviews,1,0,1
429461,True,0,No user reviews,0,0,0
429462,True,0,No user reviews,0,0,0
429470,True,8,Very Positive,393,25,418
429480,True,0,1 user reviews,0,1,1
429490,True,5,Mixed,65,34,99
429520,True,0,5 user reviews,4,1,5
429530,True,6,Mostly Positive,52,14,66
429540,True,0,No user reviews,0,0,0
429570,True,6,Mostly Positive,1302,455,1757
429580,True,5,Mixed,39,21,60
429590,True,0,No user reviews,0,0,0
429600,True,5,Mixed,32,14,46
429610,True,8,Very Positive,65,14,79
429620,True,5,Mixed,119,85,204
429630,True,0,1 user reviews,1,0,1
429660,True,8,Very Positive,3570,268,3838
429680,True,5,Mixed,5,6,11
429690,True,7,Positive,36,1,37
429700,True,5,Mixed,66,51,117
429710,True,0,No user reviews,0,0,0
429711,True,0,2 user reviews,2,0,2
429720,True,8,Very Positive,489,39,528
429730,True,5,Mixed,6,8,14
429760,True,0,No user reviews,0,0,0
429780,True,6,Mostly Positive,195,81,276
429790,True,6,Mostly Positive,39,14,53
429800,True,0,5 user reviews,5,0,5
429810,True,0,3 user reviews,3,0,3
429820,True,0,2 user reviews,2,0,2
429830,True,8,Very Positive,123,14,137
429870,True,0,No user reviews,0,0,0
429871,True,0,No user reviews,0,0,0
429872,True,0,1 user reviews,1,0,1
429880,True,0,No user reviews,0,0,0
429881,True,0,No user reviews,0,0,0
429890,True,0,No user reviews,0,0,0
429900,True,0,1 user reviews,1,0,1
429901,True,0,1 user reviews,1,0,1
429902,True,0,No user reviews,0,0,0
429903,True,0,No user reviews,0,0,0
429904,True,0,No user reviews,0,0,0
429905,True,0,No user reviews,0,0,0
429906,True,0,No user reviews,0,0,0
429907,True,0,No user reviews,0,0,0
429908,True,0,1 user reviews,1,0,1
429920,True,0,No user reviews,0,0,0
429940,True,7,Positive,13,2,15
429950,True,0,1 user reviews,0,1,1
429960,True,0,3 user reviews,2,1,3
430000,True,0,No user reviews,0,0,0
430020,True,5,Mixed,58,45,103
430040,True,0,No user reviews,0,0,0
430050,True,0,3 user reviews,3,0,3
430060,True,0,4 user reviews,3,1,4
430061,True,0,No user reviews,0,0,0
430070,True,6,Mostly Positive,81,34,115
430080,True,5,Mixed,16,12,28
430090,True,0,1 user reviews,1,0,1
430091,True,0,1 user reviews,1,0,1
430092,True,0,1 user reviews,1,0,1
430093,True,0,1 user reviews,1,0,1
430094,True,4,Mostly Negative,7,11,18
430100,True,0,5 user reviews,4,1,5
430110,True,0,No user reviews,0,0,0
430120,True,0,3 user reviews,3,0,3
430170,True,0,2 user reviews,0,2,2
430180,True,0,2 user reviews,2,0,2
430181,True,0,No user reviews,0,0,0
430182,True,0,No user reviews,0,0,0
430190,True,0,1 user reviews,1,0,1
430200,True,0,3 user reviews,3,0,3
430210,True,6,Mostly Positive,569,191,760
430220,True,0,No user reviews,0,0,0
430230,True,0,8 user reviews,7,1,8
430240,True,0,7 user reviews,3,4,7
430250,True,0,No user reviews,0,0,0
430260,True,5,Mixed,6,5,11
430261,True,0,7 user reviews,7,0,7
430280,True,0,2 user reviews,0,2,2
430290,True,7,Positive,17,2,19
430300,True,0,7 user reviews,5,2,7
430310,True,0,No user reviews,0,0,0
430311,True,0,No user reviews,0,0,0
430312,True,0,No user reviews,0,0,0
430313,True,0,No user reviews,0,0,0
430314,True,0,1 user reviews,1,0,1
430315,True,0,No user reviews,0,0,0
430316,True,0,No user reviews,0,0,0
430317,True,0,No user reviews,0,0,0
430318,True,0,No user reviews,0,0,0
430319,True,0,1 user reviews,1,0,1
430320,True,0,1 user reviews,1,0,1
430321,True,0,1 user reviews,1,0,1
430322,True,0,1 user reviews,0,1,1
430323,True,0,No user reviews,0,0,0
430324,True,0,4 user reviews,4,0,4
430330,True,0,No user reviews,0,0,0
430340,True,0,No user reviews,0,0,0
430341,True,0,No user reviews,0,0,0
430342,True,0,No user reviews,0,0,0
430343,True,0,No user reviews,0,0,0
430344,True,0,No user reviews,0,0,0
430345,True,0,No user reviews,0,0,0
430346,True,0,No user reviews,0,0,0
430347,True,0,No user reviews,0,0,0
430349,True,0,1 user reviews,0,1,1
430350,True,0,No user reviews,0,0,0
430351,True,0,No user reviews,0,0,0
430353,True,0,No user reviews,0,0,0
430354,True,0,No user reviews,0,0,0
430370,True,0,No user reviews,0,0,0
430390,True,0,No user reviews,0,0,0
430400,True,0,No user reviews,0,0,0
430410,True,5,Mixed,31,15,46
430430,True,0,No user reviews,0,0,0
430480,True,0,No user reviews,0,0,0
430890,True,0,No user reviews,0,0,0
430930,True,5,Mixed,10,5,15
430940,True,0,No user reviews,0,0,0
430960,True,8,Very Positive,1177,62,1239
431030,True,0,1 user reviews,0,1,1
431050,True,0,No user reviews,0,0,0
431060,True,0,No user reviews,0,0,0
431120,True,8,Very Positive,100,18,118
431180,True,8,Very Positive,866,81,947
431190,True,0,5 user reviews,3,2,5
431191,True,0,4 user reviews,2,2,4
431200,True,7,Positive,11,1,12
431220,True,0,7 user reviews,7,0,7
431230,True,7,Positive,30,5,35
431240,True,8,Very Positive,15957,1784,17741
431250,True,6,Mostly Positive,99,25,124
431260,True,6,Mostly Positive,153,59,212
431280,True,7,Positive,21,1,22
431290,True,0,5 user reviews,3,2,5
431300,True,0,3 user reviews,2,1,3
431320,True,0,No user reviews,0,0,0
431330,True,0,7 user reviews,2,5,7
431340,True,0,1 user reviews,1,0,1
431350,True,0,2 user reviews,2,0,2
431360,True,0,5 user reviews,2,3,5
431370,True,7,Positive,8,2,10
431390,True,6,Mostly Positive,13,4,17
431410,True,0,7 user reviews,4,3,7
431420,True,0,No user reviews,0,0,0
431430,True,7,Positive,14,3,17
431450,True,6,Mostly Positive,118,42,160
431460,True,5,Mixed,20,11,31
431470,True,0,1 user reviews,0,1,1
431490,True,0,8 user reviews,8,0,8
431500,True,0,6 user reviews,5,1,6
431510,True,5,Mixed,8,4,12
431540,True,7,Positive,14,3,17
431570,True,0,5 user reviews,1,4,5
431590,True,8,Very Positive,98,12,110
431600,True,8,Very Positive,412,70,482
431610,True,0,3 user reviews,2,1,3
431620,True,7,Positive,31,0,31
431621,True,7,Positive,23,1,24
431630,True,7,Positive,12,3,15
431640,True,4,Mostly Negative,12,25,37
431650,True,5,Mixed,179,90,269
431680,True,5,Mixed,4,6,10
431700,True,8,Very Positive,93,4,97
431710,True,8,Very Positive,160,19,179
431730,True,9,Overwhelmingly Positive,2217,14,2231
431740,True,0,2 user reviews,1,1,2
431750,True,8,Very Positive,60,15,75
431770,True,8,Very Positive,87,7,94
431780,True,0,No user reviews,0,0,0
431790,True,0,1 user reviews,0,1,1
431800,True,0,2 user reviews,1,1,2
431810,True,5,Mixed,42,25,67
431820,True,0,No user reviews,0,0,0
431830,True,7,Positive,8,2,10
431840,True,6,Mostly Positive,40,15,55
431850,True,6,Mostly Positive,20,7,27
431860,True,0,5 user reviews,0,5,5
431870,True,5,Mixed,28,13,41
431910,True,8,Very Positive,59,14,73
431930,True,8,Very Positive,83,8,91
431940,True,8,Very Positive,68,14,82
431950,True,0,No user reviews,0,0,0
431960,True,9,Overwhelmingly Positive,60662,973,61635
431980,True,0,1 user reviews,0,1,1
432010,True,8,Very Positive,432,105,537
432030,True,0,5 user reviews,4,1,5
432060,True,0,No user reviews,0,0,0
432080,True,0,No user reviews,0,0,0
432100,True,8,Very Positive,324,56,380
432110,True,5,Mixed,5,7,12
432130,True,7,Positive,18,4,22
432170,True,5,Mixed,9,7,16
432180,True,5,Mixed,8,7,15
432190,True,8,Very Positive,55,6,61
432200,True,0,No user reviews,0,0,0
432210,True,0,6 user reviews,4,2,6
432220,True,0,2 user reviews,1,1,2
432230,True,0,5 user reviews,2,3,5
432240,True,5,Mixed,10,13,23
432250,True,6,Mostly Positive,43,17,60
432260,True,7,Positive,15,3,18
432270,True,0,4 user reviews,1,3,4
432280,True,0,9 user reviews,7,2,9
432290,True,0,No user reviews,0,0,0
432310,True,0,No user reviews,0,0,0
432330,True,5,Mixed,31,16,47
432350,True,9,Overwhelmingly Positive,1476,15,1491
432370,True,6,Mostly Positive,37,11,48
432380,True,7,Positive,20,2,22
432390,True,0,1 user reviews,1,0,1
432410,True,0,5 user reviews,1,4,5
432420,True,5,Mixed,5,5,10
432440,True,0,4 user reviews,3,1,4
432450,True,0,1 user reviews,1,0,1
432470,True,4,Mostly Negative,14,40,54
432480,True,0,2 user reviews,1,1,2
432490,True,5,Mixed,7,4,11
432500,True,4,Mostly Negative,15,25,40
432510,True,0,1 user reviews,1,0,1
432530,True,0,No user reviews,0,0,0
432540,True,0,No user reviews,0,0,0
432580,True,0,No user reviews,0,0,0
432590,True,4,Mostly Negative,7,13,20
432600,True,0,No user reviews,0,0,0
432610,True,0,3 user reviews,1,2,3
432620,True,0,3 user reviews,3,0,3
432630,True,0,No user reviews,0,0,0
432640,True,0,9 user reviews,3,6,9
432650,True,0,No user reviews,0,0,0
432660,True,0,1 user reviews,0,1,1
432670,True,0,1 user reviews,1,0,1
432710,True,0,No user reviews,0,0,0
432720,True,5,Mixed,14,7,21
432760,True,0,3 user reviews,3,0,3
432770,True,0,9 user reviews,8,1,9
432780,True,5,Mixed,6,6,12
432790,True,0,1 user reviews,0,1,1
432800,True,0,No user reviews,0,0,0
432810,True,0,No user reviews,0,0,0
432840,True,0,No user reviews,0,0,0
432850,True,0,No user reviews,0,0,0
432870,True,6,Mostly Positive,25,7,32
432890,True,0,9 user reviews,8,1,9
432940,True,6,Mostly Positive,50,16,66
432950,True,7,Positive,13,3,16
432970,True,0,No user reviews,0,0,0
432980,True,8,Very Positive,77,2,79
432990,True,0,3 user reviews,3,0,3
433000,True,8,Very Positive,218,14,232
433020,True,0,1 user reviews,1,0,1
433021,True,0,No user reviews,0,0,0
433040,True,7,Positive,14,0,14
433050,True,0,No user reviews,0,0,0
433080,True,4,Mostly Negative,204,334,538
433090,True,4,Mostly Negative,334,514,848
433091,True,6,Mostly Positive,201,60,261
433100,True,6,Mostly Positive,404,154,558
433110,True,5,Mixed,6,4,10
433120,True,0,6 user reviews,2,4,6
433130,True,0,6 user reviews,1,5,6
433170,True,6,Mostly Positive,351,94,445
433180,True,0,No user reviews,0,0,0
433190,True,5,Mixed,47,25,72
433200,True,0,No user reviews,0,0,0
433210,True,0,No user reviews,0,0,0
433241,True,6,Mostly Positive,15,6,21
433242,True,5,Mixed,9,5,14
433270,True,8,Very Positive,104,2,106
433280,True,6,Mostly Positive,203,64,267
433290,True,7,Positive,45,2,47
433300,True,5,Mixed,198,162,360
433320,True,5,Mixed,106,142,248
433340,True,9,Overwhelmingly Positive,25501,666,26167
433350,True,5,Mixed,9,8,17
433360,True,0,8 user reviews,4,4,8
433370,True,0,No user reviews,0,0,0
433380,True,6,Mostly Positive,37,13,50
433390,True,0,No user reviews,0,0,0
433400,True,6,Mostly Positive,16,6,22
433420,True,0,1 user reviews,0,1,1
433430,True,7,Positive,17,0,17
433450,True,5,Mixed,26,13,39
433480,True,0,4 user reviews,4,0,4
433490,True,7,Positive,11,1,12
433500,True,7,Positive,34,0,34
433520,True,7,Positive,15,1,16
433530,True,6,Mostly Positive,1209,326,1535
433550,True,9,Overwhelmingly Positive,886,44,930
433560,True,0,No user reviews,0,0,0
433570,True,0,4 user reviews,1,3,4
433580,True,7,Positive,17,3,20
433590,True,7,Positive,14,3,17
433600,True,8,Very Positive,121,30,151
433630,True,6,Mostly Positive,28,9,37
433640,True,0,No user reviews,0,0,0
433650,True,5,Mixed,6,9,15
433660,True,0,4 user reviews,4,0,4
433670,True,3,Negative,1,24,25
433700,True,7,Positive,22,3,25
433710,True,0,No user reviews,0,0,0
433730,True,5,Mixed,193,151,344
433740,True,0,4 user reviews,1,3,4
433741,True,0,5 user reviews,2,3,5
433742,True,0,3 user reviews,0,3,3
433743,True,0,2 user reviews,1,1,2
433744,True,0,5 user reviews,1,4,5
433745,True,0,3 user reviews,1,2,3
433746,True,6,Mostly Positive,12,4,16
433747,True,0,5 user reviews,4,1,5
433750,True,5,Mixed,17,14,31
433780,True,0,2 user reviews,2,0,2
433790,True,0,8 user reviews,3,5,8
433800,True,4,Mostly Negative,6,11,17
433830,True,0,4 user reviews,2,2,4
433840,True,4,Mostly Negative,5,8,13
433850,True,5,Mixed,19772,19519,39291
433860,True,0,No user reviews,0,0,0
433890,True,7,Positive,12,3,15
433900,True,5,Mixed,14,12,26
433910,True,8,Very Positive,587,102,689
433920,True,7,Positive,44,5,49
433930,True,4,Mostly Negative,5,8,13
433950,True,9,Overwhelmingly Positive,2836,74,2910
433960,True,0,4 user reviews,3,1,4
433970,True,0,No user reviews,0,0,0
434000,True,8,Very Positive,238,30,268
434020,True,8,Very Positive,147,33,180
434030,True,6,Mostly Positive,714,208,922
434040,True,7,Positive,22,2,24
434041,True,7,Positive,14,1,15
434050,True,6,Mostly Positive,862,221,1083
434060,True,0,4 user reviews,3,1,4
434061,True,7,Positive,22,5,27
434062,True,7,Positive,9,2,11
434064,True,4,Mostly Negative,9,25,34
434065,True,7,Positive,15,2,17
434066,True,7,Positive,44,4,48
434067,True,6,Mostly Positive,23,9,32
434068,True,5,Mixed,24,15,39
434069,True,5,Mixed,9,11,20
434070,True,0,5 user reviews,3,2,5
434090,True,4,Mostly Negative,4,14,18
434120,True,0,2 user reviews,1,1,2
434130,True,0,4 user reviews,4,0,4
434140,True,0,2 user reviews,1,1,2
434150,True,5,Mixed,7,10,17
434160,True,6,Mostly Positive,21,9,30
434170,True,9,Overwhelmingly Positive,1902,57,1959
434180,True,0,No user reviews,0,0,0
434190,True,6,Mostly Positive,19,7,26
434210,True,8,Very Positive,112,8,120
434220,True,7,Positive,15,1,16
434230,True,0,8 user reviews,7,1,8
434240,True,0,1 user reviews,1,0,1
434250,True,6,Mostly Positive,250,67,317
434260,True,8,Very Positive,980,207,1187
434270,True,0,5 user reviews,2,3,5
434280,True,0,No user reviews,0,0,0
434290,True,5,Mixed,64,28,92
434300,True,0,2 user reviews,2,0,2
434310,True,6,Mostly Positive,11,3,14
434340,True,0,1 user reviews,1,0,1
434350,True,0,7 user reviews,7,0,7
434360,True,4,Mostly Negative,12,21,33
434370,True,8,Very Positive,120,5,125
434390,True,0,4 user reviews,4,0,4
434400,True,0,2 user reviews,2,0,2
434410,True,8,Very Positive,94,4,98
434420,True,5,Mixed,284,153,437
434430,True,0,5 user reviews,4,1,5
434460,True,8,Very Positive,600,67,667
434470,True,0,5 user reviews,4,1,5
434480,True,0,1 user reviews,0,1,1
434490,True,0,6 user reviews,6,0,6
434500,True,0,8 user reviews,2,6,8
434510,True,0,8 user reviews,8,0,8
434520,True,0,4 user reviews,3,1,4
434530,True,7,Positive,14,1,15
434540,True,0,1 user reviews,0,1,1
434550,True,0,No user reviews,0,0,0
434570,True,9,Overwhelmingly Positive,8755,396,9151
434580,True,0,No user reviews,0,0,0
434600,True,0,9 user reviews,7,2,9
434610,True,4,Mostly Negative,12,21,33
434620,True,6,Mostly Positive,77,31,108
434630,True,0,No user reviews,0,0,0
434631,True,0,1 user reviews,1,0,1
434632,True,0,No user reviews,0,0,0
434633,True,0,No user reviews,0,0,0
434640,True,0,1 user reviews,1,0,1
434650,True,6,Mostly Positive,835,223,1058
434660,True,7,Positive,44,1,45
434680,True,5,Mixed,19,10,29
434700,True,0,4 user reviews,2,2,4
434730,True,6,Mostly Positive,787,236,1023
434740,True,6,Mostly Positive,55,15,70
434750,True,7,Positive,19,0,19
434760,True,0,No user reviews,0,0,0
434780,True,4,Mostly Negative,5,11,16
434790,True,0,5 user reviews,1,4,5
434800,True,0,6 user reviews,1,5,6
434820,True,7,Positive,17,3,20
434840,True,0,No user reviews,0,0,0
434860,True,0,4 user reviews,3,1,4
434870,True,0,3 user reviews,2,1,3
434880,True,5,Mixed,35,20,55
434890,True,6,Mostly Positive,11,4,15
434900,True,7,Positive,18,0,18
434901,True,6,Mostly Positive,15,5,20
434910,True,7,Positive,17,3,20
434920,True,6,Mostly Positive,14,6,20
434930,True,4,Mostly Negative,4,7,11
434940,True,0,3 user reviews,1,2,3
434941,True,0,4 user reviews,1,3,4
434942,True,0,3 user reviews,1,2,3
434943,True,0,5 user reviews,2,3,5
434944,True,0,6 user reviews,4,2,6
434950,True,0,No user reviews,0,0,0
434960,True,0,1 user reviews,0,1,1
434970,True,0,2 user reviews,1,1,2
434980,True,7,Positive,9,1,10
435000,True,6,Mostly Positive,23,6,29
435010,True,7,Positive,8,2,10
435020,True,6,Mostly Positive,66,28,94
435030,True,7,Positive,32,2,34
435040,True,7,Positive,13,2,15
435050,True,0,3 user reviews,1,2,3
435060,True,0,No user reviews,0,0,0
435070,True,0,9 user reviews,4,5,9
435080,True,0,1 user reviews,1,0,1
435090,True,0,No user reviews,0,0,0
435100,True,5,Mixed,36,16,52
435110,True,0,No user reviews,0,0,0
435111,True,7,Positive,33,8,41
435120,True,8,Very Positive,771,72,843
435130,True,0,No user reviews,0,0,0
435140,True,0,6 user reviews,6,0,6
435150,True,9,Overwhelmingly Positive,45093,1991,47084
435160,True,0,No user reviews,0,0,0
435170,True,0,No user reviews,0,0,0
435171,True,0,No user reviews,0,0,0
435172,True,0,No user reviews,0,0,0
435173,True,0,No user reviews,0,0,0
435174,True,0,No user reviews,0,0,0
435175,True,0,No user reviews,0,0,0
435176,True,0,No user reviews,0,0,0
435177,True,0,No user reviews,0,0,0
435190,True,0,7 user reviews,4,3,7
435200,True,0,2 user reviews,1,1,2
435210,True,7,Positive,9,1,10
435220,True,0,No user reviews,0,0,0
435230,True,5,Mixed,4,6,10
435240,True,0,No user reviews,0,0,0
435250,True,6,Mostly Positive,23,8,31
435260,True,6,Mostly Positive,13,4,17
435300,True,8,Very Positive,422,28,450
435330,True,0,No user reviews,0,0,0
435340,True,0,No user reviews,0,0,0
435360,True,7,Positive,38,2,40
435370,True,0,No user reviews,0,0,0
435380,True,0,No user reviews,0,0,0
435390,True,0,No user reviews,0,0,0
435400,True,9,Overwhelmingly Positive,2050,66,2116
435410,True,0,No user reviews,0,0,0
435420,True,5,Mixed,13,10,23
435440,True,0,2 user reviews,2,0,2
435450,True,0,No user reviews,0,0,0
435460,True,7,Positive,39,2,41
435480,True,5,Mixed,67,39,106
435490,True,8,Very Positive,180,16,196
435500,True,0,No user reviews,0,0,0
435510,True,0,No user reviews,0,0,0
435511,True,0,No user reviews,0,0,0
435512,True,0,No user reviews,0,0,0
435519,True,0,No user reviews,0,0,0
435520,True,0,No user reviews,0,0,0
435530,True,6,Mostly Positive,1068,322,1390
435550,True,0,No user reviews,0,0,0
435570,True,0,3 user reviews,2,1,3
435600,True,0,4 user reviews,2,2,4
435610,True,0,No user reviews,0,0,0
435730,True,0,3 user reviews,3,0,3
435740,True,0,No user reviews,0,0,0
435750,True,0,No user reviews,0,0,0
435760,True,0,No user reviews,0,0,0
435770,True,0,No user reviews,0,0,0
435780,True,0,2 user reviews,0,2,2
435790,True,7,Positive,38,3,41
435800,True,7,Positive,30,3,33
435820,True,0,No user reviews,0,0,0
435840,True,7,Positive,34,1,35
435881,True,8,Very Positive,1271,231,1502
435890,True,0,1 user reviews,0,1,1
435910,True,7,Positive,40,3,43
435960,True,0,No user reviews,0,0,0
435961,True,0,No user reviews,0,0,0
435963,True,0,No user reviews,0,0,0
435970,True,7,Positive,30,0,30
436000,True,6,Mostly Positive,39,13,52
436030,True,5,Mixed,34,22,56
436040,True,5,Mixed,5,5,10
436050,True,0,9 user reviews,5,4,9
436060,True,0,6 user reviews,5,1,6
436070,True,7,Positive,20,2,22
436080,True,8,Very Positive,52,9,61
436081,True,7,Positive,37,6,43
436082,True,8,Very Positive,45,8,53
436090,True,7,Positive,24,0,24
436110,True,7,Positive,12,3,15
436120,True,4,Mostly Negative,74,113,187
436121,True,4,Mostly Negative,9,22,31
436130,True,0,No user reviews,0,0,0
436140,True,7,Positive,10,2,12
436150,True,6,Mostly Positive,29,11,40
436160,True,0,4 user reviews,2,2,4
436170,True,0,No user reviews,0,0,0
436180,True,5,Mixed,26,21,47
436190,True,0,No user reviews,0,0,0
436220,True,8,Very Positive,112,8,120
436230,True,5,Mixed,106,49,155
436240,True,5,Mixed,9,5,14
436250,True,0,1 user reviews,1,0,1
436251,True,0,No user reviews,0,0,0
436260,True,4,Mostly Negative,5,8,13
436270,True,5,Mixed,12,7,19
436280,True,5,Mixed,8,6,14
436290,True,5,Mixed,135,62,197
436310,True,0,No user reviews,0,0,0
436320,True,8,Very Positive,1313,246,1559
436340,True,0,2 user reviews,2,0,2
436350,True,0,6 user reviews,5,1,6
436360,True,0,4 user reviews,3,1,4
436390,True,8,Very Positive,116,11,127
436400,True,7,Positive,22,4,26
436410,True,0,6 user reviews,1,5,6
436420,True,0,1 user reviews,1,0,1
436430,True,0,4 user reviews,4,0,4
436460,True,0,No user reviews,0,0,0
436470,True,7,Positive,13,1,14
436480,True,5,Mixed,10,6,16
436490,True,6,Mostly Positive,103,31,134
436500,True,6,Mostly Positive,295,84,379
436510,True,0,7 user reviews,5,2,7
436520,True,5,Mixed,665,600,1265
436530,True,6,Mostly Positive,32,11,43
436550,True,0,9 user reviews,7,2,9
436560,True,5,Mixed,287,258,545
436570,True,0,No user reviews,0,0,0
436571,True,0,5 user reviews,5,0,5
436572,True,4,Mostly Negative,4,8,12
436573,True,0,1 user reviews,1,0,1
436574,True,0,1 user reviews,1,0,1
436575,True,0,1 user reviews,1,0,1
436576,True,0,No user reviews,0,0,0
436577,True,0,No user reviews,0,0,0
436578,True,0,No user reviews,0,0,0
436579,True,0,1 user reviews,1,0,1
436580,True,0,1 user reviews,1,0,1
436581,True,0,No user reviews,0,0,0
436582,True,0,No user reviews,0,0,0
436583,True,0,No user reviews,0,0,0
436584,True,0,No user reviews,0,0,0
436585,True,0,No user reviews,0,0,0
436586,True,0,No user reviews,0,0,0
436587,True,0,No user reviews,0,0,0
436588,True,0,1 user reviews,0,1,1
436589,True,0,No user reviews,0,0,0
436590,True,0,No user reviews,0,0,0
436591,True,0,No user reviews,0,0,0
436592,True,0,No user reviews,0,0,0
436593,True,0,1 user reviews,1,0,1
436594,True,0,2 user reviews,1,1,2
436595,True,0,No user reviews,0,0,0
436596,True,0,No user reviews,0,0,0
436597,True,0,1 user reviews,1,0,1
436598,True,0,2 user reviews,2,0,2
436599,True,0,No user reviews,0,0,0
436600,True,0,No user reviews,0,0,0
436601,True,0,No user reviews,0,0,0
436602,True,0,No user reviews,0,0,0
436603,True,0,1 user reviews,1,0,1
436604,True,0,1 user reviews,1,0,1
436605,True,0,2 user reviews,2,0,2
436606,True,0,1 user reviews,1,0,1
436607,True,0,No user reviews,0,0,0
436608,True,0,No user reviews,0,0,0
436609,True,0,No user reviews,0,0,0
436610,True,0,No user reviews,0,0,0
436611,True,0,No user reviews,0,0,0
436612,True,0,1 user reviews,1,0,1
436613,True,0,No user reviews,0,0,0
436614,True,0,No user reviews,0,0,0
436615,True,0,No user reviews,0,0,0
436616,True,0,No user reviews,0,0,0
436617,True,0,2 user reviews,1,1,2
436618,True,0,No user reviews,0,0,0
436619,True,0,No user reviews,0,0,0
436620,True,0,No user reviews,0,0,0
436621,True,0,No user reviews,0,0,0
436622,True,0,1 user reviews,1,0,1
436623,True,0,No user reviews,0,0,0
436624,True,0,No user reviews,0,0,0
436625,True,0,No user reviews,0,0,0
436626,True,0,No user reviews,0,0,0
436627,True,0,1 user reviews,0,1,1
436628,True,0,No user reviews,0,0,0
436629,True,0,No user reviews,0,0,0
436630,True,0,2 user reviews,2,0,2
436631,True,0,No user reviews,0,0,0
436632,True,0,1 user reviews,1,0,1
436633,True,0,1 user reviews,1,0,1
436634,True,0,No user reviews,0,0,0
436635,True,0,No user reviews,0,0,0
436636,True,0,1 user reviews,0,1,1
436637,True,0,No user reviews,0,0,0
436638,True,0,No user reviews,0,0,0
436639,True,0,No user reviews,0,0,0
436640,True,0,1 user reviews,1,0,1
436641,True,0,1 user reviews,1,0,1
436642,True,0,No user reviews,0,0,0
436643,True,0,2 user reviews,1,1,2
436644,True,0,2 user reviews,2,0,2
436645,True,0,No user reviews,0,0,0
436646,True,0,No user reviews,0,0,0
436647,True,0,No user reviews,0,0,0
436648,True,0,No user reviews,0,0,0
436649,True,0,No user reviews,0,0,0
436650,True,0,No user reviews,0,0,0
436651,True,0,No user reviews,0,0,0
436652,True,0,1 user reviews,1,0,1
436653,True,0,No user reviews,0,0,0
436654,True,0,No user reviews,0,0,0
436655,True,0,No user reviews,0,0,0
436656,True,0,No user reviews,0,0,0
436657,True,0,No user reviews,0,0,0
436658,True,0,3 user reviews,3,0,3
436659,True,0,No user reviews,0,0,0
436660,True,0,No user reviews,0,0,0
436661,True,0,No user reviews,0,0,0
436662,True,0,No user reviews,0,0,0
436663,True,0,No user reviews,0,0,0
436664,True,0,No user reviews,0,0,0
436665,True,0,1 user reviews,1,0,1
436666,True,0,No user reviews,0,0,0
436667,True,0,No user reviews,0,0,0
436668,True,0,No user reviews,0,0,0
436669,True,0,No user reviews,0,0,0
436670,True,9,Overwhelmingly Positive,565,29,594
436680,True,0,1 user reviews,0,1,1
436690,True,6,Mostly Positive,12,5,17
436700,True,0,No user reviews,0,0,0
436710,True,0,No user reviews,0,0,0
436720,True,0,No user reviews,0,0,0
436730,True,0,No user reviews,0,0,0
436740,True,0,No user reviews,0,0,0
436790,True,0,2 user reviews,2,0,2
436800,True,0,No user reviews,0,0,0
436810,True,0,No user reviews,0,0,0
436820,True,7,Positive,20,0,20
436850,True,0,1 user reviews,1,0,1
436860,True,5,Mixed,13,14,27
436870,True,5,Mixed,7,4,11
436880,True,0,No user reviews,0,0,0
436890,True,0,1 user reviews,1,0,1
436910,True,0,No user reviews,0,0,0
436920,True,0,No user reviews,0,0,0
436940,True,7,Positive,41,4,45
436950,True,0,2 user reviews,1,1,2
436990,True,0,No user reviews,0,0,0
437000,True,6,Mostly Positive,49,15,64
437010,True,0,No user reviews,0,0,0
437020,True,7,Positive,40,3,43
437030,True,6,Mostly Positive,9,3,12
437050,True,0,No user reviews,0,0,0
437060,True,7,Positive,9,1,10
437070,True,8,Very Positive,49,7,56
437080,True,5,Mixed,25,12,37
437090,True,0,2 user reviews,1,1,2
437100,True,7,Positive,16,2,18
437110,True,0,2 user reviews,1,1,2
437140,True,4,Mostly Negative,3,8,11
437150,True,0,No user reviews,0,0,0
437160,True,8,Very Positive,136,8,144
437170,True,0,7 user reviews,5,2,7
437180,True,0,3 user reviews,3,0,3
437210,True,0,9 user reviews,6,3,9
437220,True,5,Mixed,4984,3549,8533
437230,True,6,Mostly Positive,10,4,14
437231,True,5,Mixed,9,5,14
437233,True,5,Mixed,11,12,23
437240,True,0,3 user reviews,3,0,3
437250,True,8,Very Positive,217,42,259
437260,True,0,No user reviews,0,0,0
437300,True,0,No user reviews,0,0,0
437301,True,0,No user reviews,0,0,0
437302,True,0,No user reviews,0,0,0
437303,True,0,No user reviews,0,0,0
437340,True,0,2 user reviews,2,0,2
437360,True,0,4 user reviews,4,0,4
437380,True,0,5 user reviews,5,0,5
437390,True,7,Positive,9,2,11
437400,True,0,No user reviews,0,0,0
437410,True,0,No user reviews,0,0,0
437420,True,8,Very Positive,60,10,70
437430,True,0,3 user reviews,3,0,3
437440,True,0,No user reviews,0,0,0
437520,True,7,Positive,38,1,39
437530,True,5,Mixed,35,17,52
437550,True,7,Positive,32,7,39
437560,True,0,3 user reviews,3,0,3
437570,True,8,Very Positive,353,50,403
437580,True,0,No user reviews,0,0,0
437590,True,0,9 user reviews,8,1,9
437610,True,7,Positive,36,3,39
437620,True,0,No user reviews,0,0,0
437630,True,8,Very Positive,205,46,251
437640,True,0,No user reviews,0,0,0
437641,True,0,No user reviews,0,0,0
437642,True,0,No user reviews,0,0,0
437660,True,0,2 user reviews,1,1,2
437690,True,7,Positive,24,5,29
437700,True,5,Mixed,154,113,267
437701,True,6,Mostly Positive,46,13,59
437702,True,6,Mostly Positive,29,12,41
437710,True,0,3 user reviews,3,0,3
437720,True,0,1 user reviews,1,0,1
437730,True,6,Mostly Positive,18,5,23
437740,True,4,Mostly Negative,5,11,16
437750,True,0,7 user reviews,6,1,7
437790,True,0,1 user reviews,1,0,1
437800,True,0,No user reviews,0,0,0
437860,True,0,No user reviews,0,0,0
437870,True,5,Mixed,36,47,83
437880,True,0,7 user reviews,7,0,7
437900,True,0,9 user reviews,6,3,9
437920,True,8,Very Positive,737,121,858
437930,True,0,1 user reviews,1,0,1
437940,True,0,No user reviews,0,0,0
437950,True,0,No user reviews,0,0,0
437960,True,0,No user reviews,0,0,0
437970,True,0,No user reviews,0,0,0
437980,True,0,No user reviews,0,0,0
437990,True,0,No user reviews,0,0,0
438000,True,7,Positive,13,3,16
438010,True,4,Mostly Negative,8,20,28
438020,True,2,Very Negative,10,44,54
438030,True,4,Mostly Negative,34,65,99
438040,True,5,Mixed,37,16,53
438050,True,0,No user reviews,0,0,0
438060,True,0,No user reviews,0,0,0
438061,True,0,No user reviews,0,0,0
438062,True,0,No user reviews,0,0,0
438070,True,0,No user reviews,0,0,0
438071,True,0,No user reviews,0,0,0
438080,True,8,Very Positive,99,21,120
438090,True,0,3 user reviews,0,3,3
438100,True,8,Very Positive,100,17,117
438110,True,0,5 user reviews,2,3,5
438120,True,0,No user reviews,0,0,0
438130,True,8,Very Positive,117,10,127
438140,True,8,Very Positive,46,9,55
438150,True,5,Mixed,18,11,29
438160,True,0,3 user reviews,3,0,3
438170,True,0,No user reviews,0,0,0
438180,True,5,Mixed,78,36,114
438200,True,0,No user reviews,0,0,0
438210,True,0,No user reviews,0,0,0
438220,True,0,6 user reviews,4,2,6
438230,True,0,No user reviews,0,0,0
438240,True,0,1 user reviews,1,0,1
438250,True,0,No user reviews,0,0,0
438260,True,6,Mostly Positive,7,3,10
438270,True,8,Very Positive,1008,78,1086
438300,True,5,Mixed,10,6,16
438310,True,5,Mixed,10,9,19
438320,True,8,Very Positive,61,7,68
438330,True,0,No user reviews,0,0,0
438340,True,5,Mixed,37,29,66
438350,True,7,Positive,17,2,19
438360,True,0,4 user reviews,2,2,4
438380,True,0,No user reviews,0,0,0
438390,True,0,No user reviews,0,0,0
438420,True,5,Mixed,92,48,140
438430,True,6,Mostly Positive,65,19,84
438440,True,0,3 user reviews,3,0,3
438450,True,7,Positive,27,0,27
438460,True,7,Positive,22,2,24
438480,True,8,Very Positive,243,59,302
438490,True,8,Very Positive,1243,196,1439
438510,True,0,No user reviews,0,0,0
438520,True,0,No user reviews,0,0,0
438530,True,0,No user reviews,0,0,0
438550,True,0,2 user reviews,1,1,2
438560,True,5,Mixed,16,9,25
438590,True,0,No user reviews,0,0,0
438600,True,0,4 user reviews,4,0,4
438640,True,6,Mostly Positive,956,278,1234
438650,True,5,Mixed,7,6,13
438660,True,0,8 user reviews,7,1,8
438680,True,6,Mostly Positive,10,3,13
438690,True,6,Mostly Positive,525,177,702
438700,True,0,No user reviews,0,0,0
438710,True,0,6 user reviews,6,0,6
438720,True,0,1 user reviews,1,0,1
438730,True,5,Mixed,9,8,17
438740,True,6,Mostly Positive,9762,3676,13438
438770,True,0,2 user reviews,0,2,2
438780,True,0,2 user reviews,0,2,2
438790,True,0,6 user reviews,2,4,6
438800,True,0,4 user reviews,2,2,4
438801,True,0,3 user reviews,3,0,3
438802,True,0,3 user reviews,3,0,3
438810,True,0,No user reviews,0,0,0
438820,True,6,Mostly Positive,11,4,15
438831,True,0,No user reviews,0,0,0
438840,True,0,3 user reviews,1,2,3
438850,True,0,No user reviews,0,0,0
438860,True,0,No user reviews,0,0,0
438870,True,0,1 user reviews,1,0,1
438900,True,0,No user reviews,0,0,0
438901,True,0,No user reviews,0,0,0
438902,True,0,No user reviews,0,0,0
438903,True,0,No user reviews,0,0,0
438904,True,0,No user reviews,0,0,0
438905,True,0,No user reviews,0,0,0
438906,True,0,No user reviews,0,0,0
438910,True,0,7 user reviews,2,5,7
438920,True,7,Positive,27,4,31
438940,True,7,Positive,11,1,12
438950,True,0,No user reviews,0,0,0
438951,True,0,No user reviews,0,0,0
438960,True,0,No user reviews,0,0,0
438980,True,0,4 user reviews,4,0,4
438990,True,0,No user reviews,0,0,0
439030,True,0,No user reviews,0,0,0
439050,True,0,No user reviews,0,0,0
439070,True,0,No user reviews,0,0,0
439090,True,0,No user reviews,0,0,0
439110,True,0,No user reviews,0,0,0
439130,True,0,No user reviews,0,0,0
439150,True,0,No user reviews,0,0,0
439170,True,0,No user reviews,0,0,0
439190,True,8,Very Positive,840,146,986
439230,True,0,No user reviews,0,0,0
439231,True,0,No user reviews,0,0,0
439232,True,0,No user reviews,0,0,0
439240,True,0,No user reviews,0,0,0
439241,True,5,Mixed,25,28,53
439250,True,8,Very Positive,106,6,112
439260,True,7,Positive,26,2,28
439310,True,6,Mostly Positive,61,25,86
439330,True,0,3 user reviews,3,0,3
439340,True,5,Mixed,319,149,468
439350,True,0,1 user reviews,1,0,1
439360,True,0,No user reviews,0,0,0
439370,True,6,Mostly Positive,57,18,75
439390,True,0,No user reviews,0,0,0
439400,True,0,No user reviews,0,0,0
439410,True,0,No user reviews,0,0,0
439420,True,0,6 user reviews,3,3,6
439440,True,6,Mostly Positive,12,4,16
439450,True,0,7 user reviews,7,0,7
439460,True,4,Mostly Negative,23,35,58
439470,True,0,No user reviews,0,0,0
439480,True,7,Positive,33,0,33
439490,True,8,Very Positive,166,2,168
439500,True,0,1 user reviews,1,0,1
439501,True,0,2 user reviews,2,0,2
439510,True,0,1 user reviews,1,0,1
439530,True,5,Mixed,6,5,11
439540,True,7,Positive,11,0,11
439541,True,0,3 user reviews,2,1,3
439550,True,4,Mostly Negative,13,20,33
439560,True,0,3 user reviews,3,0,3
439570,True,0,No user reviews,0,0,0
439580,True,0,1 user reviews,1,0,1
439590,True,0,No user reviews,0,0,0
439600,True,0,No user reviews,0,0,0
439610,True,0,2 user reviews,1,1,2
439620,True,0,No user reviews,0,0,0
439630,True,0,6 user reviews,5,1,6
439640,True,0,4 user reviews,4,0,4
439650,True,8,Very Positive,84,10,94
439660,True,0,1 user reviews,1,0,1
439680,True,0,No user reviews,0,0,0
439690,True,0,No user reviews,0,0,0
439710,True,0,No user reviews,0,0,0
439720,True,5,Mixed,46,29,75
439730,True,0,5 user reviews,4,1,5
439740,True,0,No user reviews,0,0,0
439750,True,6,Mostly Positive,21,7,28
439760,True,0,No user reviews,0,0,0
439770,True,6,Mostly Positive,33,10,43
439780,True,0,No user reviews,0,0,0
439790,True,0,No user reviews,0,0,0
439800,True,6,Mostly Positive,8,3,11
439830,True,0,No user reviews,0,0,0
439860,True,0,No user reviews,0,0,0
439880,True,7,Positive,9,1,10
439890,True,8,Very Positive,117,20,137
439900,True,0,2 user reviews,2,0,2
439910,True,6,Mostly Positive,66,18,84
439920,True,6,Mostly Positive,64,23,87
439930,True,4,Mostly Negative,8,19,27
439940,True,7,Positive,8,2,10
439950,True,4,Mostly Negative,18,29,47
439960,True,0,9 user reviews,5,4,9
440000,True,0,No user reviews,0,0,0
440020,True,4,Mostly Negative,22,39,61
440030,True,0,2 user reviews,1,1,2
440040,True,0,2 user reviews,1,1,2
440050,True,0,2 user reviews,0,2,2
440090,True,0,9 user reviews,7,2,9
440100,True,0,3 user reviews,2,1,3
440120,True,0,No user reviews,0,0,0
440130,True,7,Positive,15,1,16
440140,True,0,6 user reviews,4,2,6
440150,True,7,Positive,21,0,21
440160,True,7,Positive,26,5,31
440170,True,0,No user reviews,0,0,0
440180,True,0,No user reviews,0,0,0
440200,True,0,2 user reviews,2,0,2
440210,True,0,1 user reviews,0,1,1
440240,True,0,3 user reviews,3,0,3
440250,True,7,Positive,17,0,17
440280,True,7,Positive,12,2,14
440310,True,9,Overwhelmingly Positive,518,10,528
440340,True,5,Mixed,26,13,39
440350,True,0,No user reviews,0,0,0
440370,True,0,1 user reviews,1,0,1
440380,True,0,2 user reviews,2,0,2
440390,True,0,No user reviews,0,0,0
440400,True,5,Mixed,9,6,15
440410,True,6,Mostly Positive,7,3,10
440420,True,8,Very Positive,199,23,222
440430,True,0,No user reviews,0,0,0
440431,True,0,No user reviews,0,0,0
440432,True,0,No user reviews,0,0,0
440433,True,0,No user reviews,0,0,0
440434,True,0,No user reviews,0,0,0
440435,True,0,No user reviews,0,0,0
440436,True,0,No user reviews,0,0,0
440437,True,0,No user reviews,0,0,0
440438,True,0,No user reviews,0,0,0
440450,True,5,Mixed,17,11,28
440470,True,0,4 user reviews,0,4,4
440500,True,0,No user reviews,0,0,0
440520,True,5,Mixed,101,116,217
440530,True,0,No user reviews,0,0,0
440540,True,9,Overwhelmingly Positive,529,23,552
440550,True,8,Very Positive,108,13,121
440630,True,8,Very Positive,486,78,564
440640,True,7,Positive,13,2,15
440650,True,8,Very Positive,2306,228,2534
440660,True,7,Positive,13,1,14
440690,True,6,Mostly Positive,12,4,16
440720,True,0,4 user reviews,1,3,4
440730,True,5,Mixed,198,142,340
440740,True,0,3 user reviews,2,1,3
440750,True,0,6 user reviews,5,1,6
440760,True,6,Mostly Positive,151,39,190
440770,True,0,6 user reviews,1,5,6
440790,True,0,3 user reviews,1,2,3
440800,True,0,5 user reviews,4,1,5
440810,True,4,Mostly Negative,5,13,18
440820,True,8,Very Positive,111,0,111
440860,True,0,2 user reviews,2,0,2
440870,True,5,Mixed,9,5,14
440880,True,8,Very Positive,273,23,296
440900,True,6,Mostly Positive,17253,4656,21909
440911,True,0,No user reviews,0,0,0
440914,True,0,No user reviews,0,0,0
440930,True,8,Very Positive,52,9,61
440950,True,5,Mixed,7,6,13
440960,True,7,Positive,41,7,48
440961,True,7,Positive,34,6,40
440962,True,7,Positive,34,2,36
440980,True,0,No user reviews,0,0,0
441010,True,8,Very Positive,152,14,166
441020,True,0,No user reviews,0,0,0
441040,True,0,No user reviews,0,0,0
441050,True,8,Very Positive,249,18,267
441060,True,6,Mostly Positive,17,6,23
441080,True,0,1 user reviews,1,0,1
441090,True,0,No user reviews,0,0,0
441100,True,0,6 user reviews,6,0,6
441110,True,7,Positive,14,0,14
441120,True,0,2 user reviews,2,0,2
441130,True,0,No user reviews,0,0,0
441140,True,0,No user reviews,0,0,0
441150,True,0,No user reviews,0,0,0
441160,True,7,Positive,19,0,19
441170,True,0,3 user reviews,3,0,3
441180,True,0,3 user reviews,3,0,3
441190,True,0,2 user reviews,0,2,2
441200,True,0,No user reviews,0,0,0
441210,True,0,No user reviews,0,0,0
441230,True,7,Positive,20,4,24
441250,True,5,Mixed,16,17,33
441260,True,0,1 user reviews,1,0,1
441270,True,0,8 user reviews,7,1,8
441280,True,8,Very Positive,135,11,146
441290,True,0,No user reviews,0,0,0
441300,True,0,1 user reviews,1,0,1
441301,True,0,No user reviews,0,0,0
441340,True,6,Mostly Positive,584,228,812
441350,True,6,Mostly Positive,39,14,53
441370,True,0,No user reviews,0,0,0
441380,True,5,Mixed,127,70,197
441420,True,0,No user reviews,0,0,0
441430,True,0,No user reviews,0,0,0
441440,True,5,Mixed,43,20,63
441450,True,5,Mixed,10,7,17
441451,True,0,No user reviews,0,0,0
441452,True,0,No user reviews,0,0,0
441453,True,0,No user reviews,0,0,0
441454,True,0,No user reviews,0,0,0
441455,True,0,No user reviews,0,0,0
441456,True,0,No user reviews,0,0,0
441457,True,0,No user reviews,0,0,0
441470,True,0,No user reviews,0,0,0
441480,True,0,4 user reviews,3,1,4
441490,True,0,No user reviews,0,0,0
441510,True,0,6 user reviews,5,1,6
441520,True,0,No user reviews,0,0,0
441540,True,8,Very Positive,72,0,72
441550,True,8,Very Positive,360,56,416
441560,True,0,No user reviews,0,0,0
441600,True,8,Very Positive,336,56,392
441610,True,0,1 user reviews,1,0,1
441630,True,0,No user reviews,0,0,0
441640,True,0,9 user reviews,1,8,9
441670,True,6,Mostly Positive,63,20,83
441680,True,5,Mixed,15,10,25
441690,True,0,No user reviews,0,0,0
441700,True,8,Very Positive,48,9,57
441710,True,0,4 user reviews,4,0,4
441720,True,5,Mixed,9,12,21
441730,True,5,Mixed,13,16,29
441750,True,0,No user reviews,0,0,0
441760,True,0,No user reviews,0,0,0
441770,True,7,Positive,41,2,43
441780,True,0,No user reviews,0,0,0
441781,True,0,No user reviews,0,0,0
441782,True,0,3 user reviews,3,0,3
441790,True,4,Mostly Negative,171,352,523
441810,True,0,No user reviews,0,0,0
441830,True,6,Mostly Positive,622,259,881
441850,True,0,1 user reviews,0,1,1
441870,True,6,Mostly Positive,871,355,1226
441910,True,0,No user reviews,0,0,0
441920,True,5,Mixed,188,180,368
441930,True,0,No user reviews,0,0,0
441940,True,0,7 user reviews,7,0,7
441950,True,0,1 user reviews,1,0,1
441960,True,0,1 user reviews,1,0,1
441990,True,0,No user reviews,0,0,0
442000,True,3,Negative,1,16,17
442010,True,5,Mixed,324,169,493
442020,True,0,No user reviews,0,0,0
442050,True,5,Mixed,21,20,41
442051,True,6,Mostly Positive,74,27,101
442052,True,6,Mostly Positive,50,14,64
442070,True,8,Very Positive,410,40,450
442080,True,6,Mostly Positive,315,121,436
442090,True,0,1 user reviews,1,0,1
442100,True,0,No user reviews,0,0,0
442101,True,0,No user reviews,0,0,0
442120,True,8,Very Positive,313,21,334
442140,True,0,8 user reviews,5,3,8
442180,True,0,3 user reviews,0,3,3
442190,True,0,5 user reviews,2,3,5
442210,True,8,Very Positive,70,6,76
442220,True,0,7 user reviews,5,2,7
442230,True,0,No user reviews,0,0,0
442240,True,0,No user reviews,0,0,0
442260,True,0,8 user reviews,7,1,8
442280,True,0,No user reviews,0,0,0
442290,True,5,Mixed,23,12,35
442310,True,0,No user reviews,0,0,0
442311,True,0,No user reviews,0,0,0
442312,True,0,No user reviews,0,0,0
442313,True,0,No user reviews,0,0,0
442314,True,0,No user reviews,0,0,0
442315,True,0,No user reviews,0,0,0
442316,True,0,No user reviews,0,0,0
442317,True,0,No user reviews,0,0,0
442318,True,0,No user reviews,0,0,0
442319,True,0,No user reviews,0,0,0
442320,True,0,No user reviews,0,0,0
442321,True,0,No user reviews,0,0,0
442322,True,0,No user reviews,0,0,0
442323,True,0,No user reviews,0,0,0
442324,True,0,No user reviews,0,0,0
442325,True,0,No user reviews,0,0,0
442326,True,0,No user reviews,0,0,0
442327,True,0,No user reviews,0,0,0
442328,True,0,No user reviews,0,0,0
442329,True,0,No user reviews,0,0,0
442330,True,0,No user reviews,0,0,0
442331,True,0,No user reviews,0,0,0
442332,True,0,No user reviews,0,0,0
442333,True,0,No user reviews,0,0,0
442334,True,0,No user reviews,0,0,0
442335,True,0,No user reviews,0,0,0
442336,True,0,No user reviews,0,0,0
442337,True,0,No user reviews,0,0,0
442338,True,0,No user reviews,0,0,0
442339,True,0,No user reviews,0,0,0
442360,True,0,No user reviews,0,0,0
442500,True,6,Mostly Positive,295,94,389
442510,True,0,No user reviews,0,0,0
442660,True,5,Mixed,31,19,50
442690,True,0,No user reviews,0,0,0
442700,True,0,No user reviews,0,0,0
442710,True,0,4 user reviews,4,0,4
442720,True,0,No user reviews,0,0,0
442760,True,0,2 user reviews,0,2,2
442770,True,0,9 user reviews,4,5,9
442780,True,6,Mostly Positive,857,282,1139
442790,True,0,No user reviews,0,0,0
442810,True,0,3 user reviews,0,3,3
442830,True,0,2 user reviews,2,0,2
442840,True,0,1 user reviews,1,0,1
442860,True,0,No user reviews,0,0,0
442890,True,5,Mixed,27,18,45
442900,True,0,No user reviews,0,0,0
442990,True,0,No user reviews,0,0,0
443000,True,8,Very Positive,51,12,63
443020,True,6,Mostly Positive,49,15,64
443030,True,0,No user reviews,0,0,0
443050,True,0,No user reviews,0,0,0
443070,True,0,4 user reviews,0,4,4
443080,True,5,Mixed,9,10,19
443100,True,0,No user reviews,0,0,0
443110,True,0,1 user reviews,1,0,1
443180,True,0,No user reviews,0,0,0
443190,True,0,No user reviews,0,0,0
443200,True,0,No user reviews,0,0,0
443201,True,0,No user reviews,0,0,0
443202,True,0,No user reviews,0,0,0
443204,True,0,No user reviews,0,0,0
443205,True,0,No user reviews,0,0,0
443206,True,0,No user reviews,0,0,0
443230,True,0,No user reviews,0,0,0
443240,True,0,No user reviews,0,0,0
443250,True,5,Mixed,7,4,11
443260,True,5,Mixed,21,13,34
443270,True,0,No user reviews,0,0,0
443300,True,0,1 user reviews,1,0,1
443320,True,0,No user reviews,0,0,0
443330,True,6,Mostly Positive,47,19,66
443360,True,5,Mixed,6,7,13
443370,True,5,Mixed,14,11,25
443380,True,8,Very Positive,44,6,50
443390,True,0,3 user reviews,3,0,3
443400,True,0,3 user reviews,3,0,3
443420,True,6,Mostly Positive,35,11,46
443430,True,7,Positive,10,1,11
443440,True,0,No user reviews,0,0,0
443450,True,5,Mixed,20,9,29
443460,True,7,Positive,14,2,16
443470,True,0,No user reviews,0,0,0
443510,True,0,No user reviews,0,0,0
443530,True,0,No user reviews,0,0,0
443550,True,0,No user reviews,0,0,0
443570,True,0,9 user reviews,6,3,9
443580,True,6,Mostly Positive,14,6,20
443590,True,0,No user reviews,0,0,0
443620,True,6,Mostly Positive,15,4,19
443630,True,7,Positive,16,3,19
443640,True,0,No user reviews,0,0,0
443650,True,6,Mostly Positive,42,16,58
443660,True,0,No user reviews,0,0,0
443670,True,0,No user reviews,0,0,0
443680,True,0,9 user reviews,6,3,9
443690,True,0,4 user reviews,4,0,4
443691,True,7,Positive,34,7,41
443700,True,6,Mostly Positive,9,3,12
443710,True,0,1 user reviews,0,1,1
443720,True,7,Positive,9,2,11
443730,True,8,Very Positive,77,13,90
443740,True,0,No user reviews,0,0,0
443750,True,0,No user reviews,0,0,0
443760,True,0,2 user reviews,2,0,2
443770,True,0,No user reviews,0,0,0
443780,True,0,1 user reviews,0,1,1
443790,True,0,No user reviews,0,0,0
443800,True,5,Mixed,29,16,45
443810,True,6,Mostly Positive,1626,592,2218
443830,True,5,Mixed,10,7,17
443840,True,0,No user reviews,0,0,0
443850,True,5,Mixed,6,6,12
443860,True,8,Very Positive,85,12,97
443880,True,7,Positive,36,4,40
443890,True,7,Positive,28,4,32
443900,True,4,Mostly Negative,6,11,17
443910,True,0,1 user reviews,1,0,1
443970,True,5,Mixed,71,34,105
443980,True,5,Mixed,19,9,28
444000,True,8,Very Positive,79,8,87
444020,True,0,6 user reviews,3,3,6
444030,True,0,1 user reviews,0,1,1
444031,True,0,No user reviews,0,0,0
444032,True,0,No user reviews,0,0,0
444040,True,0,No user reviews,0,0,0
444090,True,6,Mostly Positive,2752,809,3561
444130,True,6,Mostly Positive,38,15,53
444140,True,8,Very Positive,214,23,237
444160,True,5,Mixed,20,24,44
444170,True,7,Positive,38,2,40
444180,True,5,Mixed,32,15,47
444190,True,7,Positive,10,2,12
444200,True,6,Mostly Positive,122,51,173
444210,True,0,4 user reviews,0,4,4
444220,True,5,Mixed,50,42,92
444250,True,0,8 user reviews,6,2,8
444260,True,5,Mixed,63,49,112
444270,True,6,Mostly Positive,13,4,17
444280,True,7,Positive,30,5,35
444320,True,5,Mixed,12,16,28
444330,True,0,1 user reviews,1,0,1
444350,True,4,Mostly Negative,23,82,105
444360,True,0,1 user reviews,1,0,1
444390,True,0,2 user reviews,2,0,2
444410,True,5,Mixed,7,5,12
444420,True,3,Negative,2,12,14
444430,True,0,7 user reviews,5,2,7
444440,True,5,Mixed,6,9,15
444450,True,0,No user reviews,0,0,0
444460,True,3,Negative,3,23,26
444470,True,0,4 user reviews,3,1,4
444480,True,5,Mixed,50,31,81
444490,True,6,Mostly Positive,119,46,165
444510,True,0,No user reviews,0,0,0
444520,True,5,Mixed,7,6,13
444530,True,7,Positive,31,3,34
444540,True,0,No user reviews,0,0,0
444550,True,7,Positive,8,2,10
444560,True,0,2 user reviews,1,1,2
444580,True,4,Mostly Negative,26,47,73
444590,True,8,Very Positive,194,41,235
444600,True,0,No user reviews,0,0,0
444610,True,0,1 user reviews,1,0,1
444611,True,0,1 user reviews,1,0,1
444620,True,0,1 user reviews,1,0,1
444640,True,8,Very Positive,218,36,254
444650,True,5,Mixed,16,20,36
444660,True,0,No user reviews,0,0,0
444670,True,8,Very Positive,58,8,66
444680,True,7,Positive,12,2,14
444690,True,5,Mixed,40,31,71
444700,True,0,No user reviews,0,0,0
444710,True,7,Positive,17,0,17
444720,True,5,Mixed,85,60,145
444740,True,0,3 user reviews,1,2,3
444750,True,0,No user reviews,0,0,0
444760,True,0,1 user reviews,1,0,1
444770,True,8,Very Positive,43,7,50
444780,True,0,No user reviews,0,0,0
444800,True,8,Very Positive,119,13,132
444820,True,0,2 user reviews,2,0,2
444830,True,0,8 user reviews,6,2,8
444870,True,0,3 user reviews,2,1,3
444880,True,6,Mostly Positive,85,30,115
444890,True,0,2 user reviews,1,1,2
444910,True,0,No user reviews,0,0,0
444930,True,8,Very Positive,55,7,62
444940,True,8,Very Positive,109,17,126
444950,True,0,2 user reviews,1,1,2
444970,True,6,Mostly Positive,68,23,91
444980,True,0,No user reviews,0,0,0
444990,True,0,2 user reviews,0,2,2
445000,True,0,5 user reviews,4,1,5
445020,True,5,Mixed,111,58,169
445040,True,7,Positive,41,3,44
445050,True,0,2 user reviews,1,1,2
445070,True,6,Mostly Positive,12,5,17
445080,True,0,No user reviews,0,0,0
445110,True,8,Very Positive,164,18,182
445130,True,5,Mixed,8,4,12
445140,True,5,Mixed,22,11,33
445150,True,0,No user reviews,0,0,0
445170,True,7,Positive,10,0,10
445180,True,0,No user reviews,0,0,0
445190,True,8,Very Positive,1077,219,1296
445200,True,0,No user reviews,0,0,0
445210,True,5,Mixed,9,4,13
445220,True,8,Very Positive,3780,385,4165
445230,True,0,8 user reviews,5,3,8
445260,True,7,Positive,13,0,13
445261,True,0,5 user reviews,4,1,5
445262,True,0,No user reviews,0,0,0
445280,True,0,No user reviews,0,0,0
445310,True,5,Mixed,151,110,261
445320,True,0,1 user reviews,1,0,1
445321,True,0,2 user reviews,1,1,2
445330,True,0,No user reviews,0,0,0
445340,True,0,3 user reviews,3,0,3
445341,True,0,1 user reviews,1,0,1
445350,True,0,8 user reviews,2,6,8
445380,True,0,2 user reviews,1,1,2
445390,True,0,No user reviews,0,0,0
445420,True,7,Positive,38,7,45
445430,True,7,Positive,11,2,13
445440,True,0,No user reviews,0,0,0
445450,True,0,No user reviews,0,0,0
445490,True,0,No user reviews,0,0,0
445550,True,0,2 user reviews,2,0,2
445600,True,5,Mixed,26,15,41
445670,True,5,Mixed,5,7,12
445680,True,0,9 user reviews,9,0,9
445690,True,6,Mostly Positive,76,24,100
445700,True,0,No user reviews,0,0,0
445710,True,0,No user reviews,0,0,0
445720,True,4,Mostly Negative,6,17,23
445750,True,8,Very Positive,51,9,60
445770,True,8,Very Positive,150,25,175
445780,True,0,No user reviews,0,0,0
445790,True,0,No user reviews,0,0,0
445800,True,8,Very Positive,83,15,98
445840,True,0,1 user reviews,1,0,1
445850,True,0,No user reviews,0,0,0
445860,True,6,Mostly Positive,20,7,27
445870,True,0,9 user reviews,7,2,9
445890,True,0,8 user reviews,8,0,8
445900,True,0,No user reviews,0,0,0
445920,True,0,2 user reviews,2,0,2
445930,True,0,No user reviews,0,0,0
445931,True,0,No user reviews,0,0,0
445950,True,7,Positive,9,1,10
445980,True,8,Very Positive,3291,272,3563
445990,True,5,Mixed,21,11,32
446000,True,6,Mostly Positive,107,33,140
446010,True,0,5 user reviews,2,3,5
446020,True,6,Mostly Positive,2191,631,2822
446040,True,7,Positive,40,9,49
446050,True,0,4 user reviews,1,3,4
446060,True,7,Positive,23,1,24
446070,True,7,Positive,9,1,10
446080,True,0,No user reviews,0,0,0
446090,True,0,5 user reviews,5,0,5
446100,True,7,Positive,29,7,36
446110,True,0,1 user reviews,1,0,1
446120,True,6,Mostly Positive,170,45,215
446132,True,0,No user reviews,0,0,0
446135,True,0,No user reviews,0,0,0
446142,True,0,No user reviews,0,0,0
446150,True,0,No user reviews,0,0,0
446240,True,5,Mixed,10,7,17
446250,True,7,Positive,8,2,10
446270,True,0,1 user reviews,1,0,1
446310,True,8,Very Positive,83,5,88
446320,True,0,No user reviews,0,0,0
446330,True,8,Very Positive,67,4,71
446340,True,0,No user reviews,0,0,0
446350,True,0,No user reviews,0,0,0
446360,True,0,1 user reviews,1,0,1
446361,True,0,No user reviews,0,0,0
446362,True,0,No user reviews,0,0,0
446363,True,0,No user reviews,0,0,0
446364,True,0,No user reviews,0,0,0
446365,True,0,No user reviews,0,0,0
446366,True,0,No user reviews,0,0,0
446367,True,0,No user reviews,0,0,0
446368,True,0,No user reviews,0,0,0
446369,True,0,No user reviews,0,0,0
446380,True,8,Very Positive,126,22,148
446390,True,6,Mostly Positive,186,75,261
446430,True,0,1 user reviews,0,1,1
446440,True,0,1 user reviews,0,1,1
446450,True,0,5 user reviews,1,4,5
446460,True,0,5 user reviews,4,1,5
446470,True,0,6 user reviews,3,3,6
446480,True,0,6 user reviews,1,5,6
446490,True,4,Mostly Negative,3,7,10
446510,True,0,2 user reviews,2,0,2
446520,True,5,Mixed,6,4,10
446530,True,0,No user reviews,0,0,0
446540,True,5,Mixed,31,24,55
446550,True,5,Mixed,30,16,46
446560,True,6,Mostly Positive,193,74,267
446570,True,0,4 user reviews,0,4,4
446590,True,5,Mixed,22,17,39
446600,True,8,Very Positive,55,11,66
446610,True,5,Mixed,15,11,26
446620,True,8,Very Positive,172,15,187
446640,True,8,Very Positive,123,7,130
446650,True,0,No user reviews,0,0,0
446690,True,0,No user reviews,0,0,0
446710,True,0,No user reviews,0,0,0
446720,True,0,No user reviews,0,0,0
446740,True,0,6 user reviews,5,1,6
446750,True,7,Positive,17,0,17
446760,True,7,Positive,14,2,16
446770,True,0,3 user reviews,3,0,3
446780,True,4,Mostly Negative,27,54,81
446790,True,5,Mixed,283,153,436
446800,True,6,Mostly Positive,2900,729,3629
446810,True,8,Very Positive,102,23,125
446830,True,7,Positive,39,4,43
446840,True,8,Very Positive,65,1,66
446850,True,7,Positive,15,1,16
446860,True,0,No user reviews,0,0,0
446870,True,4,Mostly Negative,3,9,12
446880,True,0,No user reviews,0,0,0
446882,True,0,No user reviews,0,0,0
446890,True,0,1 user reviews,1,0,1
446900,True,0,2 user reviews,0,2,2
446910,True,7,Positive,44,1,45
446950,True,0,No user reviews,0,0,0
446960,True,0,1 user reviews,1,0,1
446980,True,7,Positive,28,5,33
446990,True,7,Positive,41,8,49
447000,True,7,Positive,15,1,16
447010,True,0,No user reviews,0,0,0
447020,True,8,Very Positive,5193,441,5634
447040,True,8,Very Positive,10257,2446,12703
447080,True,0,No user reviews,0,0,0
447100,True,4,Mostly Negative,5,13,18
447120,True,8,Very Positive,280,65,345
447150,True,8,Very Positive,791,45,836
447170,True,5,Mixed,62,33,95
447180,True,5,Mixed,39,23,62
447190,True,8,Very Positive,76,15,91
447200,True,8,Very Positive,72,9,81
447210,True,7,Positive,33,3,36
447220,True,0,9 user reviews,9,0,9
447240,True,7,Positive,13,1,14
447250,True,0,1 user reviews,1,0,1
447260,True,0,No user reviews,0,0,0
447261,True,0,No user reviews,0,0,0
447270,True,0,2 user reviews,2,0,2
447290,True,8,Very Positive,403,90,493
447300,True,0,No user reviews,0,0,0
447310,True,6,Mostly Positive,33,12,45
447330,True,0,No user reviews,0,0,0
447340,True,0,No user reviews,0,0,0
447400,True,0,6 user reviews,6,0,6
447410,True,7,Positive,12,0,12
447440,True,0,No user reviews,0,0,0
447480,True,0,1 user reviews,1,0,1
447500,True,4,Mostly Negative,132,303,435
447510,True,8,Very Positive,82,3,85
447530,True,9,Overwhelmingly Positive,6987,201,7188
447540,True,0,2 user reviews,0,2,2
447570,True,0,6 user reviews,6,0,6
447680,True,0,No user reviews,0,0,0
447681,True,0,No user reviews,0,0,0
447682,True,0,No user reviews,0,0,0
447683,True,0,No user reviews,0,0,0
447684,True,0,No user reviews,0,0,0
447685,True,0,No user reviews,0,0,0
447686,True,0,No user reviews,0,0,0
447687,True,0,No user reviews,0,0,0
447690,True,6,Mostly Positive,22,7,29
447700,True,7,Positive,34,6,40
447740,True,0,No user reviews,0,0,0
447760,True,0,No user reviews,0,0,0
447780,True,8,Very Positive,102,19,121
447800,True,6,Mostly Positive,45,13,58
447820,True,8,Very Positive,7670,1203,8873
447840,True,0,No user reviews,0,0,0
447850,True,4,Mostly Negative,3,8,11
447860,True,5,Mixed,9,7,16
447870,True,0,No user reviews,0,0,0
447890,True,6,Mostly Positive,123,45,168
447920,True,0,7 user reviews,1,6,7
447930,True,0,2 user reviews,2,0,2
447940,True,0,5 user reviews,1,4,5
447950,True,7,Positive,20,2,22
447960,True,5,Mixed,15,10,25
447980,True,0,8 user reviews,8,0,8
447990,True,0,1 user reviews,1,0,1
448000,True,5,Mixed,27,32,59
448010,True,7,Positive,11,0,11
448020,True,4,Mostly Negative,17,28,45
448050,True,7,Positive,12,2,14
448060,True,4,Mostly Negative,5,13,18
448070,True,5,Mixed,31,44,75
448080,True,8,Very Positive,125,7,132
448090,True,0,8 user reviews,4,4,8
448100,True,0,No user reviews,0,0,0
448110,True,0,6 user reviews,4,2,6
448140,True,0,3 user reviews,0,3,3
448150,True,5,Mixed,17,8,25
448160,True,7,Positive,35,4,39
448170,True,7,Positive,32,8,40
448180,True,0,5 user reviews,5,0,5
448182,True,0,8 user reviews,8,0,8
448183,True,0,2 user reviews,2,0,2
448184,True,4,Mostly Negative,20,31,51
448185,True,0,5 user reviews,4,1,5
448186,True,7,Positive,12,3,15
448187,True,0,No user reviews,0,0,0
448188,True,7,Positive,13,3,16
448189,True,0,No user reviews,0,0,0
448190,True,5,Mixed,23,16,39
448191,True,7,Positive,11,0,11
448192,True,5,Mixed,10,9,19
448194,True,0,6 user reviews,6,0,6
448195,True,0,6 user reviews,6,0,6
448198,True,6,Mostly Positive,10,3,13
448199,True,0,3 user reviews,3,0,3
448200,True,0,No user reviews,0,0,0
448201,True,0,No user reviews,0,0,0
448202,True,0,1 user reviews,1,0,1
448203,True,0,2 user reviews,1,1,2
448204,True,0,1 user reviews,1,0,1
448205,True,0,No user reviews,0,0,0
448206,True,0,No user reviews,0,0,0
448207,True,0,No user reviews,0,0,0
448208,True,0,No user reviews,0,0,0
448209,True,0,No user reviews,0,0,0
448212,True,0,No user reviews,0,0,0
448230,True,0,9 user reviews,4,5,9
448240,True,5,Mixed,153,122,275
448270,True,0,No user reviews,0,0,0
448280,True,8,Very Positive,1270,149,1419
448290,True,8,Very Positive,211,40,251
448300,True,0,1 user reviews,0,1,1
448310,True,0,3 user reviews,1,2,3
448320,True,6,Mostly Positive,113,30,143
448370,True,8,Very Positive,625,39,664
448380,True,7,Positive,11,1,12
448390,True,0,No user reviews,0,0,0
448400,True,8,Very Positive,56,11,67
448440,True,5,Mixed,36,35,71
448450,True,0,1 user reviews,1,0,1
448460,True,0,No user reviews,0,0,0
448470,True,5,Mixed,17,14,31
448480,True,5,Mixed,5,5,10
448500,True,7,Positive,15,1,16
448510,True,8,Very Positive,3198,239,3437
448520,True,0,8 user reviews,8,0,8
448530,True,0,8 user reviews,7,1,8
448540,True,5,Mixed,15,14,29
448550,True,0,4 user reviews,3,1,4
448560,True,5,Mixed,22,24,46
448570,True,0,No user reviews,0,0,0
448580,True,8,Very Positive,109,16,125
448610,True,5,Mixed,30,19,49
448620,True,4,Mostly Negative,7,16,23
448630,True,4,Mostly Negative,9,19,28
448640,True,7,Positive,16,4,20
448650,True,6,Mostly Positive,15,4,19
448670,True,5,Mixed,18,16,34
448690,True,0,9 user reviews,4,5,9
448710,True,0,2 user reviews,2,0,2
448720,True,6,Mostly Positive,7,3,10
448730,True,5,Mixed,6,4,10
448750,True,0,9 user reviews,5,4,9
448760,True,0,1 user reviews,1,0,1
448780,True,6,Mostly Positive,211,72,283
448790,True,0,7 user reviews,3,4,7
448800,True,7,Positive,24,4,28
448810,True,0,7 user reviews,6,1,7
448820,True,0,8 user reviews,5,3,8
448830,True,5,Mixed,16,9,25
448850,True,8,Very Positive,834,52,886
448860,True,0,No user reviews,0,0,0
448880,True,0,3 user reviews,1,2,3
448910,True,8,Very Positive,58,11,69
448930,True,0,No user reviews,0,0,0
448960,True,7,Positive,11,1,12
448980,True,0,No user reviews,0,0,0
448990,True,0,2 user reviews,1,1,2
449000,True,0,No user reviews,0,0,0
449010,True,0,No user reviews,0,0,0
449011,True,0,No user reviews,0,0,0
449020,True,0,4 user reviews,3,1,4
449040,True,6,Mostly Positive,19,5,24
449050,True,0,2 user reviews,1,1,2
449060,True,8,Very Positive,60,11,71
449070,True,0,7 user reviews,2,5,7
449080,True,0,No user reviews,0,0,0
449090,True,6,Mostly Positive,26,11,37
449100,True,0,8 user reviews,6,2,8
449120,True,0,9 user reviews,5,4,9
449130,True,0,No user reviews,0,0,0
449140,True,7,Positive,29,3,32
449150,True,0,5 user reviews,4,1,5
449160,True,0,5 user reviews,5,0,5
449170,True,7,Positive,29,1,30
449180,True,0,3 user reviews,3,0,3
449190,True,0,No user reviews,0,0,0
449200,True,5,Mixed,10,15,25
449210,True,8,Very Positive,182,23,205
449220,True,7,Positive,22,3,25
449230,True,3,Negative,0,14,14
449240,True,0,5 user reviews,5,0,5
449250,True,8,Very Positive,144,9,153
449300,True,5,Mixed,102,83,185
449310,True,0,3 user reviews,2,1,3
449320,True,0,9 user reviews,6,3,9
449330,True,0,5 user reviews,3,2,5
449340,True,7,Positive,13,0,13
449350,True,5,Mixed,7,7,14
449360,True,7,Positive,17,0,17
449370,True,0,1 user reviews,1,0,1
449380,True,7,Positive,10,1,11
449390,True,0,5 user reviews,3,2,5
449391,True,0,4 user reviews,3,1,4
449392,True,0,2 user reviews,2,0,2
449393,True,5,Mixed,9,8,17
449394,True,0,2 user reviews,2,0,2
449400,True,0,2 user reviews,2,0,2
449420,True,0,No user reviews,0,0,0
449450,True,6,Mostly Positive,7,3,10
449460,True,5,Mixed,35,21,56
449470,True,0,2 user reviews,2,0,2
449480,True,0,No user reviews,0,0,0
449500,True,0,3 user reviews,0,3,3
449510,True,5,Mixed,26,15,41
449520,True,0,4 user reviews,2,2,4
449530,True,5,Mixed,73,37,110
449540,True,8,Very Positive,1414,175,1589
449550,True,8,Very Positive,80,3,83
449560,True,0,1 user reviews,1,0,1
449570,True,0,1 user reviews,1,0,1
449600,True,0,No user reviews,0,0,0
449601,True,0,No user reviews,0,0,0
449602,True,0,No user reviews,0,0,0
449603,True,0,No user reviews,0,0,0
449604,True,0,No user reviews,0,0,0
449605,True,0,No user reviews,0,0,0
449610,True,8,Very Positive,364,40,404
449610,True,8,Very Positive,364,40,404
449640,True,6,Mostly Positive,19,5,24
449670,True,5,Mixed,9,4,13
449671,True,0,6 user reviews,4,2,6
449680,True,8,Very Positive,140,33,173
449690,True,5,Mixed,13,9,22
449700,True,0,6 user reviews,6,0,6
449710,True,6,Mostly Positive,165,60,225
449720,True,7,Positive,8,2,10
449730,True,8,Very Positive,91,12,103
449740,True,0,No user reviews,0,0,0
449760,True,6,Mostly Positive,21,9,30
449770,True,0,2 user reviews,2,0,2
449780,True,0,No user reviews,0,0,0
449800,True,8,Very Positive,1409,321,1730
449820,True,5,Mixed,23,25,48
449900,True,0,No user reviews,0,0,0
449910,True,0,No user reviews,0,0,0
449920,True,0,No user reviews,0,0,0
449930,True,0,1 user reviews,1,0,1
449940,True,5,Mixed,7,5,12
449950,True,0,3 user reviews,3,0,3
449960,True,8,Very Positive,3401,349,3750
449970,True,0,No user reviews,0,0,0
449980,True,8,Very Positive,220,27,247
449981,True,5,Mixed,13,9,22
449990,True,0,No user reviews,0,0,0
450010,True,6,Mostly Positive,7,3,10
450020,True,0,1 user reviews,0,1,1
450030,True,0,6 user reviews,1,5,6
450040,True,4,Mostly Negative,2,8,10
450050,True,5,Mixed,12,16,28
450060,True,5,Mixed,11,12,23
450070,True,0,No user reviews,0,0,0
450080,True,0,8 user reviews,5,3,8
450090,True,0,No user reviews,0,0,0
450091,True,0,No user reviews,0,0,0
450092,True,0,No user reviews,0,0,0
450093,True,0,No user reviews,0,0,0
450094,True,0,No user reviews,0,0,0
450095,True,0,No user reviews,0,0,0
450096,True,0,No user reviews,0,0,0
450097,True,0,No user reviews,0,0,0
450098,True,0,No user reviews,0,0,0
450099,True,0,No user reviews,0,0,0
450100,True,0,2 user reviews,2,0,2
450110,True,7,Positive,10,2,12
450120,True,7,Positive,34,7,41
450130,True,0,6 user reviews,2,4,6
450140,True,8,Very Positive,51,1,52
450150,True,0,1 user reviews,1,0,1
450170,True,6,Mostly Positive,51,17,68
450190,True,5,Mixed,30,13,43
450200,True,0,No user reviews,0,0,0
450210,True,0,No user reviews,0,0,0
450220,True,7,Positive,19,1,20
450230,True,0,1 user reviews,1,0,1
450240,True,0,No user reviews,0,0,0
450250,True,6,Mostly Positive,15,4,19
450260,True,0,3 user reviews,0,3,3
450270,True,0,No user reviews,0,0,0
450280,True,0,No user reviews,0,0,0
450290,True,5,Mixed,6,8,14
450300,True,0,No user reviews,0,0,0
450310,True,0,1 user reviews,1,0,1
450320,True,0,No user reviews,0,0,0
450330,True,0,No user reviews,0,0,0
450340,True,0,No user reviews,0,0,0
450341,True,0,No user reviews,0,0,0
450342,True,0,No user reviews,0,0,0
450350,True,0,No user reviews,0,0,0
450370,True,0,No user reviews,0,0,0
450390,True,8,Very Positive,94,2,96
450430,True,0,No user reviews,0,0,0
450440,True,8,Very Positive,84,12,96
450460,True,0,No user reviews,0,0,0
450470,True,0,No user reviews,0,0,0
450480,True,0,3 user reviews,1,2,3
450500,True,8,Very Positive,193,17,210
450510,True,0,No user reviews,0,0,0
450530,True,0,7 user reviews,1,6,7
450540,True,9,Overwhelmingly Positive,6655,226,6881
450550,True,8,Very Positive,109,7,116
450570,True,0,8 user reviews,1,7,8
450590,True,4,Mostly Negative,7,17,24
450600,True,5,Mixed,8,9,17
450630,True,0,9 user reviews,7,2,9
450650,True,0,7 user reviews,7,0,7
450660,True,8,Very Positive,251,30,281
450670,True,6,Mostly Positive,82,32,114
450700,True,6,Mostly Positive,89,31,120
450740,True,4,Mostly Negative,6,10,16
450750,True,0,6 user reviews,5,1,6
450760,True,0,6 user reviews,6,0,6
450770,True,0,No user reviews,0,0,0
450780,True,0,No user reviews,0,0,0
450790,True,6,Mostly Positive,111,30,141
450810,True,0,5 user reviews,5,0,5
450811,True,0,6 user reviews,5,1,6
450812,True,7,Positive,22,1,23
450820,True,5,Mixed,10,6,16
450850,True,4,Mostly Negative,6,10,16
450860,True,5,Mixed,51,34,85
450870,True,0,No user reviews,0,0,0
450880,True,0,1 user reviews,1,0,1
450881,True,0,No user reviews,0,0,0
450890,True,0,No user reviews,0,0,0
450950,True,8,Very Positive,76,5,81
450960,True,6,Mostly Positive,10,3,13
450980,True,0,No user reviews,0,0,0
451000,True,0,9 user reviews,8,1,9
451010,True,8,Very Positive,118,16,134
451020,True,8,Very Positive,1513,211,1724
451030,True,0,9 user reviews,9,0,9
451040,True,0,1 user reviews,1,0,1
451050,True,8,Very Positive,48,3,51
451060,True,0,2 user reviews,0,2,2
451080,True,6,Mostly Positive,17,7,24
451100,True,0,4 user reviews,4,0,4
451110,True,0,2 user reviews,0,2,2
451130,True,0,2 user reviews,1,1,2
451140,True,6,Mostly Positive,14,4,18
451160,True,0,3 user reviews,3,0,3
451180,True,0,6 user reviews,1,5,6
451200,True,0,8 user reviews,8,0,8
451210,True,0,4 user reviews,1,3,4
451230,True,0,1 user reviews,0,1,1
451241,True,0,No user reviews,0,0,0
451280,True,0,2 user reviews,1,1,2
451290,True,0,9 user reviews,9,0,9
451310,True,6,Mostly Positive,16,6,22
451320,True,5,Mixed,25,14,39
451330,True,0,No user reviews,0,0,0
451340,True,5,Mixed,2658,1328,3986
451350,True,0,6 user reviews,3,3,6
451360,True,0,No user reviews,0,0,0
451370,True,0,4 user reviews,4,0,4
451380,True,0,No user reviews,0,0,0
451400,True,5,Mixed,18,14,32
451410,True,0,3 user reviews,2,1,3
451421,True,0,No user reviews,0,0,0
451422,True,0,No user reviews,0,0,0
451430,True,0,1 user reviews,0,1,1
451440,True,0,No user reviews,0,0,0
451442,True,0,2 user reviews,1,1,2
451443,True,0,1 user reviews,0,1,1
451450,True,0,7 user reviews,5,2,7
451460,True,0,No user reviews,0,0,0
451461,True,0,No user reviews,0,0,0
451462,True,0,No user reviews,0,0,0
451463,True,0,No user reviews,0,0,0
451464,True,0,No user reviews,0,0,0
451465,True,0,No user reviews,0,0,0
451466,True,0,No user reviews,0,0,0
451467,True,0,No user reviews,0,0,0
451468,True,0,No user reviews,0,0,0
451469,True,0,No user reviews,0,0,0
451480,True,0,3 user reviews,1,2,3
451490,True,0,4 user reviews,4,0,4
451500,True,0,1 user reviews,1,0,1
451510,True,0,No user reviews,0,0,0
451520,True,8,Very Positive,665,114,779
451540,True,0,2 user reviews,2,0,2
451560,True,0,2 user reviews,0,2,2
451570,True,6,Mostly Positive,55,15,70
451580,True,0,No user reviews,0,0,0
451590,True,0,No user reviews,0,0,0
451600,True,8,Very Positive,100,7,107
451630,True,7,Positive,12,1,13
451640,True,7,Positive,35,4,39
451650,True,8,Very Positive,217,53,270
451660,True,5,Mixed,9,10,19
451670,True,3,Negative,2,16,18
451680,True,0,No user reviews,0,0,0
451690,True,0,7 user reviews,4,3,7
451700,True,0,1 user reviews,1,0,1
451710,True,0,1 user reviews,1,0,1
451730,True,0,No user reviews,0,0,0
451760,True,9,Overwhelmingly Positive,670,25,695
451780,True,6,Mostly Positive,150,62,212
451790,True,0,No user reviews,0,0,0
451800,True,0,8 user reviews,5,3,8
451810,True,0,No user reviews,0,0,0
451820,True,0,No user reviews,0,0,0
451840,True,8,Very Positive,461,89,550
451870,True,0,9 user reviews,6,3,9
451880,True,6,Mostly Positive,78,24,102
451900,True,5,Mixed,10,8,18
451920,True,5,Mixed,35,21,56
451930,True,7,Positive,11,1,12
451940,True,0,1 user reviews,1,0,1
451950,True,0,7 user reviews,1,6,7
451960,True,0,2 user reviews,1,1,2
451980,True,0,9 user reviews,9,0,9
451990,True,6,Mostly Positive,67,20,87
452000,True,5,Mixed,6,7,13
452040,True,0,No user reviews,0,0,0
452050,True,0,No user reviews,0,0,0
452060,True,8,Very Positive,915,134,1049
452070,True,0,3 user reviews,0,3,3
452080,True,0,No user reviews,0,0,0
452100,True,0,1 user reviews,1,0,1
452110,True,0,No user reviews,0,0,0
452120,True,7,Positive,18,4,22
452130,True,0,No user reviews,0,0,0
452140,True,0,No user reviews,0,0,0
452150,True,0,No user reviews,0,0,0
452160,True,0,No user reviews,0,0,0
452170,True,0,No user reviews,0,0,0
452180,True,0,2 user reviews,2,0,2
452190,True,0,No user reviews,0,0,0
452191,True,0,No user reviews,0,0,0
452192,True,0,No user reviews,0,0,0
452193,True,0,No user reviews,0,0,0
452200,True,0,No user reviews,0,0,0
452201,True,0,No user reviews,0,0,0
452220,True,0,No user reviews,0,0,0
452230,True,0,2 user reviews,2,0,2
452240,True,0,7 user reviews,7,0,7
452250,True,0,1 user reviews,0,1,1
452251,True,0,1 user reviews,0,1,1
452260,True,0,No user reviews,0,0,0
452270,True,0,2 user reviews,1,1,2
452280,True,0,1 user reviews,1,0,1
452290,True,0,No user reviews,0,0,0
452300,True,0,No user reviews,0,0,0
452320,True,6,Mostly Positive,9,3,12
452330,True,0,No user reviews,0,0,0
452340,True,5,Mixed,8,12,20
452350,True,0,1 user reviews,1,0,1
452360,True,0,2 user reviews,1,1,2
452370,True,0,No user reviews,0,0,0
452380,True,0,No user reviews,0,0,0
452410,True,7,Positive,19,4,23
452420,True,8,Very Positive,70,16,86
452430,True,6,Mostly Positive,48,20,68
452440,True,8,Very Positive,128,10,138
452450,True,5,Mixed,11,15,26
452470,True,0,No user reviews,0,0,0
452490,True,0,9 user reviews,6,3,9
452510,True,8,Very Positive,349,25,374
452520,True,0,8 user reviews,2,6,8
452521,True,6,Mostly Positive,8,3,11
452522,True,5,Mixed,6,7,13
452523,True,0,1 user reviews,1,0,1
452530,True,8,Very Positive,66,8,74
452540,True,8,Very Positive,218,33,251
452570,True,9,Overwhelmingly Positive,519,14,533
452600,True,0,No user reviews,0,0,0
452610,True,0,No user reviews,0,0,0
452620,True,0,1 user reviews,1,0,1
452630,True,0,No user reviews,0,0,0
452640,True,0,1 user reviews,0,1,1
452650,True,0,6 user reviews,2,4,6
452660,True,0,1 user reviews,1,0,1
452670,True,0,2 user reviews,2,0,2
452680,True,0,No user reviews,0,0,0
452690,True,0,No user reviews,0,0,0
452700,True,0,1 user reviews,1,0,1
452710,True,0,2 user reviews,2,0,2
452740,True,0,2 user reviews,2,0,2
452750,True,0,No user reviews,0,0,0
452760,True,0,3 user reviews,3,0,3
452770,True,0,9 user reviews,8,1,9
452771,True,0,8 user reviews,4,4,8
452800,True,0,No user reviews,0,0,0
452810,True,0,No user reviews,0,0,0
452850,True,0,No user reviews,0,0,0
452860,True,8,Very Positive,88,7,95
452890,True,0,No user reviews,0,0,0
452900,True,0,1 user reviews,1,0,1
452920,True,0,2 user reviews,2,0,2
452930,True,0,2 user reviews,1,1,2
452940,True,7,Positive,33,0,33
452950,True,0,9 user reviews,3,6,9
452960,True,6,Mostly Positive,39,11,50
452970,True,5,Mixed,48,27,75
452980,True,0,5 user reviews,3,2,5
452981,True,0,3 user reviews,3,0,3
452982,True,0,3 user reviews,3,0,3
453000,True,0,No user reviews,0,0,0
453020,True,7,Positive,19,2,21
453030,True,0,4 user reviews,3,1,4
453060,True,0,No user reviews,0,0,0
453090,True,8,Very Positive,2020,145,2165
453100,True,8,Very Positive,56,10,66
453130,True,6,Mostly Positive,7,3,10
453150,True,0,No user reviews,0,0,0
453160,True,0,2 user reviews,2,0,2
453170,True,0,8 user reviews,6,2,8
453190,True,0,No user reviews,0,0,0
453200,True,0,4 user reviews,3,1,4
453220,True,0,7 user reviews,5,2,7
453240,True,0,6 user reviews,3,3,6
453250,True,0,3 user reviews,3,0,3
453260,True,0,No user reviews,0,0,0
453270,True,5,Mixed,40,23,63
453280,True,8,Very Positive,61,11,72
453290,True,6,Mostly Positive,130,36,166
453300,True,6,Mostly Positive,51,14,65
453310,True,8,Very Positive,126,31,157
453320,True,0,2 user reviews,2,0,2
453330,True,0,5 user reviews,4,1,5
453340,True,9,Overwhelmingly Positive,639,27,666
453350,True,0,8 user reviews,2,6,8
453360,True,5,Mixed,37,25,62
453370,True,0,No user reviews,0,0,0
453380,True,7,Positive,12,1,13
453390,True,7,Positive,21,3,24
453400,True,7,Positive,33,2,35
453410,True,0,1 user reviews,0,1,1
453420,True,0,No user reviews,0,0,0
453440,True,0,6 user reviews,5,1,6
453450,True,6,Mostly Positive,10,3,13
453460,True,0,3 user reviews,2,1,3
453470,True,0,No user reviews,0,0,0
453480,True,8,Very Positive,159,39,198
453490,True,0,No user reviews,0,0,0
453500,True,7,Positive,12,2,14
453510,True,0,6 user reviews,6,0,6
453590,True,0,1 user reviews,1,0,1
453620,True,7,Positive,10,2,12
453630,True,0,4 user reviews,2,2,4
453640,True,0,No user reviews,0,0,0
453650,True,7,Positive,14,2,16
453660,True,0,9 user reviews,6,3,9
453670,True,3,Negative,4,24,28
453680,True,6,Mostly Positive,28,10,38
453690,True,8,Very Positive,169,38,207
453700,True,0,7 user reviews,6,1,7
453710,True,7,Positive,39,9,48
453720,True,6,Mostly Positive,51,19,70
453730,True,4,Mostly Negative,3,7,10
453740,True,7,Positive,10,2,12
453750,True,6,Mostly Positive,236,72,308
453760,True,0,No user reviews,0,0,0
453770,True,6,Mostly Positive,8,3,11
453780,True,7,Positive,12,0,12
453790,True,8,Very Positive,91,8,99
453810,True,5,Mixed,9,7,16
453820,True,3,Negative,6,36,42
453830,True,0,5 user reviews,5,0,5
453840,True,0,No user reviews,0,0,0
453850,True,5,Mixed,22,26,48
453860,True,0,No user reviews,0,0,0
453870,True,6,Mostly Positive,17,7,24
453880,True,0,3 user reviews,2,1,3
453890,True,7,Positive,10,2,12
453900,True,0,No user reviews,0,0,0
453910,True,7,Positive,14,3,17
453920,True,0,6 user reviews,6,0,6
453950,True,7,Positive,9,2,11
453960,True,5,Mixed,33,22,55
453980,True,0,6 user reviews,1,5,6
453990,True,7,Positive,37,1,38
454000,True,0,No user reviews,0,0,0
454010,True,0,No user reviews,0,0,0
454030,True,5,Mixed,17,10,27
454060,True,6,Mostly Positive,505,133,638
454070,True,5,Mixed,84,59,143
454080,True,5,Mixed,5,6,11
454100,True,5,Mixed,77,35,112
454110,True,0,No user reviews,0,0,0
454120,True,0,No user reviews,0,0,0
454130,True,5,Mixed,9,4,13
454140,True,8,Very Positive,128,13,141
454160,True,8,Very Positive,63,3,66
454170,True,0,4 user reviews,4,0,4
454180,True,5,Mixed,44,21,65
454190,True,8,Very Positive,61,6,67
454200,True,4,Mostly Negative,8,15,23
454220,True,6,Mostly Positive,43,17,60
454230,True,4,Mostly Negative,3,8,11
454240,True,0,2 user reviews,2,0,2
454250,True,8,Very Positive,187,38,225
454260,True,0,4 user reviews,2,2,4
454280,True,0,No user reviews,0,0,0
454300,True,0,No user reviews,0,0,0
454320,True,8,Very Positive,73,7,80
454330,True,0,6 user reviews,4,2,6
454340,True,0,No user reviews,0,0,0
454350,True,5,Mixed,328,373,701
454360,True,0,No user reviews,0,0,0
454370,True,0,6 user reviews,3,3,6
454380,True,8,Very Positive,63,1,64
454390,True,0,3 user reviews,3,0,3
454410,True,8,Very Positive,95,22,117
454420,True,0,1 user reviews,1,0,1
454430,True,0,1 user reviews,0,1,1
454440,True,0,No user reviews,0,0,0
454450,True,0,4 user reviews,4,0,4
454460,True,5,Mixed,11,5,16
454480,True,0,1 user reviews,0,1,1
454490,True,0,No user reviews,0,0,0
454510,True,8,Very Positive,67,8,75
454520,True,0,5 user reviews,2,3,5
454530,True,8,Very Positive,69,6,75
454540,True,0,5 user reviews,0,5,5
454550,True,5,Mixed,37,20,57
454560,True,4,Mostly Negative,7,11,18
454570,True,5,Mixed,13,10,23
454580,True,6,Mostly Positive,10,4,14
454590,True,0,No user reviews,0,0,0
454600,True,0,4 user reviews,1,3,4
454610,True,5,Mixed,11,10,21
454630,True,0,8 user reviews,7,1,8
454640,True,0,No user reviews,0,0,0
454650,True,8,Very Positive,6308,1264,7572
454660,True,0,1 user reviews,1,0,1
454670,True,0,2 user reviews,2,0,2
454680,True,4,Mostly Negative,4,7,11
454690,True,0,7 user reviews,5,2,7
454700,True,0,2 user reviews,0,2,2
454720,True,0,7 user reviews,4,3,7
454730,True,0,4 user reviews,0,4,4
454740,True,0,3 user reviews,3,0,3
454750,True,0,4 user reviews,4,0,4
454760,True,0,No user reviews,0,0,0
454770,True,7,Positive,13,3,16
454780,True,0,2 user reviews,2,0,2
454790,True,7,Positive,20,1,21
454791,True,0,1 user reviews,1,0,1
454800,True,0,7 user reviews,4,3,7
454830,True,0,3 user reviews,3,0,3
454870,True,0,7 user reviews,5,2,7
454890,True,8,Very Positive,92,21,113
454900,True,7,Positive,30,4,34
454910,True,0,No user reviews,0,0,0
454920,True,0,No user reviews,0,0,0
454950,True,8,Very Positive,136,34,170
454960,True,0,4 user reviews,4,0,4
454970,True,0,4 user reviews,3,1,4
454980,True,0,1 user reviews,1,0,1
455000,True,0,1 user reviews,0,1,1
455020,True,0,No user reviews,0,0,0
455030,True,0,No user reviews,0,0,0
455040,True,8,Very Positive,307,72,379
455041,True,7,Positive,37,1,38
455050,True,0,4 user reviews,3,1,4
455080,True,0,6 user reviews,5,1,6
455100,True,7,Positive,15,2,17
455110,True,5,Mixed,6,5,11
455120,True,5,Mixed,220,162,382
455130,True,0,No user reviews,0,0,0
455150,True,0,No user reviews,0,0,0
455160,True,0,No user reviews,0,0,0
455170,True,0,No user reviews,0,0,0
455190,True,7,Positive,8,2,10
455200,True,4,Mostly Negative,4,7,11
455220,True,5,Mixed,11,5,16
455222,True,0,2 user reviews,1,1,2
455223,True,0,6 user reviews,5,1,6
455224,True,0,2 user reviews,2,0,2
455230,True,0,8 user reviews,7,1,8
455250,True,0,No user reviews,0,0,0
455270,True,0,6 user reviews,4,2,6
455280,True,0,1 user reviews,1,0,1
455290,True,0,2 user reviews,2,0,2
455300,True,0,No user reviews,0,0,0
455310,True,6,Mostly Positive,15,5,20
455320,True,0,1 user reviews,0,1,1
455340,True,5,Mixed,17,11,28
455360,True,0,No user reviews,0,0,0
455370,True,0,7 user reviews,7,0,7
455380,True,0,No user reviews,0,0,0
455400,True,8,Very Positive,396,22,418
455411,True,0,No user reviews,0,0,0
455440,True,0,9 user reviews,6,3,9
455451,True,0,No user reviews,0,0,0
455460,True,0,8 user reviews,5,3,8
455470,True,0,1 user reviews,1,0,1
455480,True,0,1 user reviews,0,1,1
455490,True,5,Mixed,29,15,44
455510,True,0,No user reviews,0,0,0
455520,True,7,Positive,10,2,12
455521,True,0,No user reviews,0,0,0
455530,True,0,4 user reviews,4,0,4
455560,True,0,No user reviews,0,0,0
455561,True,0,No user reviews,0,0,0
455562,True,0,No user reviews,0,0,0
455570,True,8,Very Positive,47,8,55
455572,True,8,Very Positive,57,8,65
455574,True,0,5 user reviews,2,3,5
455576,True,0,3 user reviews,2,1,3
455578,True,0,1 user reviews,0,1,1
455580,True,6,Mostly Positive,7,3,10
455590,True,0,6 user reviews,5,1,6
455610,True,5,Mixed,12,11,23
455611,True,0,2 user reviews,1,1,2
455612,True,0,1 user reviews,0,1,1
455620,True,0,No user reviews,0,0,0
455630,True,0,No user reviews,0,0,0
455640,True,0,3 user reviews,2,1,3
455660,True,0,No user reviews,0,0,0
455670,True,0,No user reviews,0,0,0
455690,True,7,Positive,22,2,24
455700,True,5,Mixed,14,8,22
455710,True,5,Mixed,8,7,15
455720,True,0,5 user reviews,3,2,5
455740,True,0,1 user reviews,1,0,1
455750,True,0,1 user reviews,1,0,1
455760,True,0,No user reviews,0,0,0
455770,True,0,7 user reviews,6,1,7
455810,True,0,8 user reviews,5,3,8
455820,True,8,Very Positive,444,55,499
455830,True,0,8 user reviews,6,2,8
455900,True,0,No user reviews,0,0,0
455910,True,5,Mixed,428,189,617
455920,True,0,No user reviews,0,0,0
455940,True,4,Mostly Negative,7,11,18
455950,True,0,No user reviews,0,0,0
455960,True,5,Mixed,10,12,22
455970,True,0,8 user reviews,3,5,8
455980,True,8,Very Positive,676,143,819
455990,True,0,2 user reviews,2,0,2
456000,True,0,No user reviews,0,0,0
456020,True,0,No user reviews,0,0,0
456030,True,0,No user reviews,0,0,0
456050,True,0,7 user reviews,6,1,7
456090,True,0,8 user reviews,1,7,8
456100,True,0,No user reviews,0,0,0
456110,True,0,No user reviews,0,0,0
456120,True,0,No user reviews,0,0,0
456130,True,0,5 user reviews,4,1,5
456140,True,0,No user reviews,0,0,0
456150,True,0,2 user reviews,0,2,2
456160,True,0,4 user reviews,2,2,4
456170,True,6,Mostly Positive,52,15,67
456180,True,5,Mixed,41,28,69
456200,True,0,3 user reviews,3,0,3
456210,True,0,5 user reviews,3,2,5
456220,True,4,Mostly Negative,7,14,21
456221,True,0,2 user reviews,0,2,2
456230,True,0,1 user reviews,1,0,1
456231,True,0,1 user reviews,0,1,1
456250,True,0,No user reviews,0,0,0
456280,True,4,Mostly Negative,38,65,103
456290,True,0,No user reviews,0,0,0
456370,True,0,No user reviews,0,0,0
456390,True,0,6 user reviews,6,0,6
456400,True,0,No user reviews,0,0,0
456410,True,0,No user reviews,0,0,0
456420,True,0,6 user reviews,0,6,6
456430,True,8,Very Positive,138,17,155
456440,True,0,3 user reviews,2,1,3
456450,True,0,3 user reviews,0,3,3
456470,True,7,Positive,9,2,11
456480,True,0,5 user reviews,4,1,5
456510,True,0,2 user reviews,2,0,2
456540,True,6,Mostly Positive,66,25,91
456560,True,0,No user reviews,0,0,0
456600,True,7,Positive,12,0,12
456630,True,8,Very Positive,152,38,190
456640,True,0,No user reviews,0,0,0
456660,True,0,6 user reviews,3,3,6
456670,True,8,Very Positive,1230,210,1440
456690,True,0,1 user reviews,1,0,1
456730,True,0,2 user reviews,2,0,2
456740,True,0,4 user reviews,4,0,4
456750,True,9,Overwhelmingly Positive,2280,87,2367
456760,True,7,Positive,16,3,19
456780,True,5,Mixed,22,12,34
456800,True,0,7 user reviews,7,0,7
456801,True,0,No user reviews,0,0,0
456802,True,0,No user reviews,0,0,0
456810,True,5,Mixed,22,11,33
456820,True,0,4 user reviews,3,1,4
456821,True,0,No user reviews,0,0,0
456830,True,7,Positive,12,1,13
456880,True,0,No user reviews,0,0,0
456890,True,0,No user reviews,0,0,0
456891,True,0,No user reviews,0,0,0
456910,True,0,2 user reviews,2,0,2
456920,True,0,1 user reviews,1,0,1
456960,True,0,No user reviews,0,0,0
456980,True,6,Mostly Positive,11,4,15
457000,True,0,No user reviews,0,0,0
457010,True,6,Mostly Positive,101,37,138
457030,True,0,No user reviews,0,0,0
457040,True,0,No user reviews,0,0,0
457070,True,0,No user reviews,0,0,0
457080,True,0,1 user reviews,1,0,1
457082,True,0,No user reviews,0,0,0
457083,True,0,No user reviews,0,0,0
457084,True,0,1 user reviews,0,1,1
457085,True,0,5 user reviews,2,3,5
457086,True,6,Mostly Positive,19,7,26
457087,True,0,8 user reviews,6,2,8
457088,True,0,No user reviews,0,0,0
457090,True,0,5 user reviews,4,1,5
457100,True,0,No user reviews,0,0,0
457120,True,0,7 user reviews,6,1,7
457130,True,7,Positive,30,6,36
457140,True,9,Overwhelmingly Positive,19653,822,20475
457160,True,7,Positive,27,3,30
457162,True,8,Very Positive,111,15,126
457180,True,0,1 user reviews,0,1,1
457190,True,8,Very Positive,58,2,60
457191,True,8,Very Positive,84,12,96
457192,True,8,Very Positive,156,26,182
457194,True,7,Positive,34,6,40
457195,True,8,Very Positive,131,15,146
457196,True,8,Very Positive,49,6,55
457197,True,8,Very Positive,224,21,245
457198,True,8,Very Positive,74,7,81
457199,True,8,Very Positive,58,6,64
457200,True,0,7 user reviews,3,4,7
457201,True,0,9 user reviews,6,3,9
457210,True,9,Overwhelmingly Positive,682,29,711
457220,True,0,1 user reviews,1,0,1
457221,True,0,No user reviews,0,0,0
457222,True,0,No user reviews,0,0,0
457223,True,0,No user reviews,0,0,0
457224,True,0,No user reviews,0,0,0
457230,True,0,1 user reviews,1,0,1
457320,True,8,Very Positive,326,30,356
457330,True,5,Mixed,50,34,84
457340,True,6,Mostly Positive,32,9,41
457350,True,0,No user reviews,0,0,0
457360,True,0,No user reviews,0,0,0
457370,True,7,Positive,15,2,17
457380,True,5,Mixed,35,17,52
457410,True,0,No user reviews,0,0,0
457420,True,0,1 user reviews,1,0,1
457450,True,5,Mixed,4,6,10
457470,True,0,No user reviews,0,0,0
457480,True,6,Mostly Positive,91,27,118
457490,True,8,Very Positive,49,9,58
457520,True,5,Mixed,37,16,53
457530,True,8,Very Positive,84,19,103
457550,True,7,Positive,26,3,29
457560,True,0,No user reviews,0,0,0
457570,True,8,Very Positive,109,17,126
457580,True,6,Mostly Positive,103,35,138
457590,True,0,No user reviews,0,0,0
457600,True,5,Mixed,67,34,101
457610,True,0,4 user reviews,1,3,4
457650,True,0,2 user reviews,1,1,2
457660,True,5,Mixed,10,5,15
457670,True,0,No user reviews,0,0,0
457680,True,6,Mostly Positive,167,51,218
457690,True,5,Mixed,4,6,10
457710,True,4,Mostly Negative,29,102,131
457720,True,0,4 user reviews,3,1,4
457730,True,5,Mixed,109,79,188
457760,True,5,Mixed,359,155,514
457770,True,7,Positive,12,1,13
457790,True,0,No user reviews,0,0,0
457810,True,5,Mixed,5,6,11
457820,True,5,Mixed,13,12,25
457830,True,0,No user reviews,0,0,0
457840,True,7,Positive,21,2,23
457841,True,7,Positive,15,3,18
457842,True,7,Positive,31,4,35
457860,True,8,Very Positive,355,60,415
457870,True,0,3 user reviews,1,2,3
457890,True,8,Very Positive,57,5,62
457960,True,8,Very Positive,506,57,563
457980,True,0,6 user reviews,2,4,6
457990,True,0,1 user reviews,1,0,1
458000,True,6,Mostly Positive,248,96,344
458010,True,0,No user reviews,0,0,0
458030,True,0,5 user reviews,4,1,5
458040,True,7,Positive,8,2,10
458060,True,4,Mostly Negative,5,17,22
458080,True,0,No user reviews,0,0,0
458100,True,0,3 user reviews,1,2,3
458110,True,0,2 user reviews,1,1,2
458120,True,0,No user reviews,0,0,0
458160,True,0,4 user reviews,4,0,4
458170,True,7,Positive,13,0,13
458190,True,0,6 user reviews,2,4,6
458200,True,0,2 user reviews,1,1,2
458230,True,0,2 user reviews,1,1,2
458250,True,0,1 user reviews,1,0,1
458260,True,0,2 user reviews,2,0,2
458270,True,0,1 user reviews,1,0,1
458280,True,0,1 user reviews,1,0,1
458290,True,0,8 user reviews,5,3,8
458300,True,0,1 user reviews,1,0,1
458310,True,0,1 user reviews,1,0,1
458320,True,0,1 user reviews,1,0,1
458330,True,7,Positive,33,8,41
458360,True,7,Positive,13,0,13
458370,True,5,Mixed,10,6,16
458380,True,7,Positive,31,4,35
458400,True,0,1 user reviews,1,0,1
458410,True,0,No user reviews,0,0,0
458420,True,5,Mixed,11,6,17
458440,True,0,No user reviews,0,0,0
458441,True,0,No user reviews,0,0,0
458442,True,0,No user reviews,0,0,0
458443,True,0,No user reviews,0,0,0
458444,True,0,No user reviews,0,0,0
458445,True,0,2 user reviews,2,0,2
458450,True,0,4 user reviews,1,3,4
458460,True,0,No user reviews,0,0,0
458470,True,8,Very Positive,134,6,140
458480,True,8,Very Positive,62,7,69
458490,True,5,Mixed,9,6,15
458500,True,0,1 user reviews,0,1,1
458510,True,5,Mixed,7,4,11
458520,True,6,Mostly Positive,22,7,29
458530,True,0,4 user reviews,2,2,4
458540,True,7,Positive,16,1,17
458560,True,0,1 user reviews,0,1,1
458580,True,8,Very Positive,154,34,188
458590,True,0,1 user reviews,1,0,1
458600,True,4,Mostly Negative,9,14,23
458620,True,0,No user reviews,0,0,0
458630,True,5,Mixed,46,30,76
458640,True,5,Mixed,14,7,21
458660,True,6,Mostly Positive,9,3,12
458670,True,0,No user reviews,0,0,0
458680,True,7,Positive,28,3,31
458700,True,5,Mixed,8,4,12
458710,True,9,Overwhelmingly Positive,1053,54,1107
458730,True,8,Very Positive,276,56,332
458740,True,0,1 user reviews,1,0,1
458750,True,7,Positive,32,2,34
458760,True,7,Positive,12,0,12
458770,True,5,Mixed,77,62,139
458790,True,7,Positive,16,0,16
458800,True,0,No user reviews,0,0,0
458810,True,0,No user reviews,0,0,0
458820,True,0,2 user reviews,0,2,2
458830,True,5,Mixed,81,60,141
458840,True,5,Mixed,11,10,21
458841,True,0,6 user reviews,5,1,6
458860,True,7,Positive,17,0,17
458870,True,0,No user reviews,0,0,0
458880,True,0,No user reviews,0,0,0
458890,True,0,No user reviews,0,0,0
458910,True,0,2 user reviews,2,0,2
458920,True,5,Mixed,79,70,149
458930,True,0,No user reviews,0,0,0
458960,True,5,Mixed,9,8,17
458970,True,0,No user reviews,0,0,0
458990,True,5,Mixed,8,10,18
459010,True,8,Very Positive,262,39,301
459020,True,5,Mixed,15,14,29
459040,True,0,6 user reviews,3,3,6
459050,True,0,No user reviews,0,0,0
459070,True,0,1 user reviews,1,0,1
459080,True,5,Mixed,43,53,96
459090,True,8,Very Positive,173,16,189
459110,True,0,No user reviews,0,0,0
459120,True,6,Mostly Positive,30,9,39
459130,True,6,Mostly Positive,14,5,19
459140,True,7,Positive,15,1,16
459150,True,7,Positive,12,1,13
459160,True,0,5 user reviews,4,1,5
459170,True,0,8 user reviews,2,6,8
459210,True,0,No user reviews,0,0,0
459220,True,8,Very Positive,2417,257,2674
459240,True,0,3 user reviews,3,0,3
459260,True,5,Mixed,12,12,24
459280,True,6,Mostly Positive,8,3,11
459290,True,0,5 user reviews,4,1,5
459310,True,5,Mixed,65,39,104
459320,True,0,No user reviews,0,0,0
459330,True,0,No user reviews,0,0,0
459350,True,7,Positive,27,4,31
459360,True,0,7 user reviews,4,3,7
459361,True,0,4 user reviews,1,3,4
459362,True,0,2 user reviews,2,0,2
459363,True,0,No user reviews,0,0,0
459370,True,7,Positive,13,2,15
459380,True,0,No user reviews,0,0,0
459410,True,0,5 user reviews,2,3,5
459450,True,7,Positive,13,1,14
459460,True,0,No user reviews,0,0,0
459470,True,5,Mixed,19,18,37
459480,True,0,1 user reviews,1,0,1
459490,True,0,2 user reviews,2,0,2
459500,True,0,8 user reviews,5,3,8
459520,True,7,Positive,9,1,10
459540,True,6,Mostly Positive,31,11,42
459550,True,6,Mostly Positive,50,18,68
459560,True,0,No user reviews,0,0,0
459580,True,0,9 user reviews,9,0,9
459590,True,0,No user reviews,0,0,0
459610,True,7,Positive,17,3,20
459630,True,0,6 user reviews,1,5,6
459640,True,5,Mixed,8,4,12
459670,True,0,No user reviews,0,0,0
459680,True,6,Mostly Positive,28,10,38
459730,True,0,2 user reviews,2,0,2
459740,True,0,No user reviews,0,0,0
459741,True,0,No user reviews,0,0,0
459742,True,0,No user reviews,0,0,0
459743,True,0,No user reviews,0,0,0
459744,True,0,No user reviews,0,0,0
459750,True,0,6 user reviews,6,0,6
459760,True,0,7 user reviews,4,3,7
459770,True,0,No user reviews,0,0,0
459780,True,0,4 user reviews,4,0,4
459790,True,0,6 user reviews,6,0,6
459820,True,8,Very Positive,206,37,243
459830,True,6,Mostly Positive,17,5,22
459850,True,0,2 user reviews,2,0,2
459851,True,0,4 user reviews,4,0,4
459852,True,0,3 user reviews,3,0,3
459853,True,0,5 user reviews,4,1,5
459870,True,0,5 user reviews,3,2,5
459880,True,5,Mixed,6,4,10
459890,True,0,No user reviews,0,0,0
459900,True,0,No user reviews,0,0,0
459910,True,7,Positive,11,0,11
459940,True,5,Mixed,105,49,154
460010,True,0,3 user reviews,3,0,3
460030,True,0,2 user reviews,2,0,2
460040,True,0,No user reviews,0,0,0
460060,True,5,Mixed,17,8,25
460070,True,0,1 user reviews,0,1,1
460090,True,0,No user reviews,0,0,0
460110,True,0,No user reviews,0,0,0
460120,True,8,Very Positive,1234,79,1313
460140,True,7,Positive,17,0,17
460150,True,5,Mixed,15,9,24
460160,True,8,Very Positive,136,14,150
460190,True,0,7 user reviews,7,0,7
460210,True,0,4 user reviews,4,0,4
460220,True,8,Very Positive,50,4,54
460230,True,6,Mostly Positive,48,15,63
460240,True,0,2 user reviews,1,1,2
460250,True,7,Positive,19,1,20
460260,True,0,1 user reviews,1,0,1
460280,True,0,No user reviews,0,0,0
460300,True,0,No user reviews,0,0,0
460320,True,0,No user reviews,0,0,0
460340,True,6,Mostly Positive,61,18,79
460350,True,0,No user reviews,0,0,0
460390,True,7,Positive,36,2,38
460420,True,7,Positive,23,0,23
460430,True,8,Very Positive,536,44,580
460440,True,0,1 user reviews,1,0,1
460450,True,0,No user reviews,0,0,0
460460,True,0,No user reviews,0,0,0
460470,True,7,Positive,9,1,10
460500,True,0,No user reviews,0,0,0
460510,True,0,2 user reviews,1,1,2
460540,True,0,1 user reviews,1,0,1
460560,True,0,8 user reviews,8,0,8
460570,True,0,No user reviews,0,0,0
460580,True,5,Mixed,6,6,12
460590,True,0,1 user reviews,1,0,1
460630,True,7,Positive,31,0,31
460640,True,5,Mixed,22,21,43
460650,True,5,Mixed,11,10,21
460670,True,0,No user reviews,0,0,0
460690,True,0,No user reviews,0,0,0
460700,True,8,Very Positive,225,52,277
460710,True,0,2 user reviews,2,0,2
460730,True,0,No user reviews,0,0,0
460740,True,0,No user reviews,0,0,0
460750,True,7,Positive,19,4,23
460760,True,0,1 user reviews,1,0,1
460780,True,8,Very Positive,61,4,65
460790,True,8,Very Positive,4094,425,4519
460810,True,8,Very Positive,1888,220,2108
460830,True,0,1 user reviews,1,0,1
460840,True,0,No user reviews,0,0,0
460850,True,0,8 user reviews,8,0,8
460870,True,8,Very Positive,159,30,189
460880,True,0,No user reviews,0,0,0
460890,True,7,Positive,8,2,10
460910,True,6,Mostly Positive,11,3,14
460920,True,6,Mostly Positive,3974,1055,5029
460930,True,6,Mostly Positive,11491,3325,14816
460940,True,5,Mixed,11,9,20
460950,True,9,Overwhelmingly Positive,10153,198,10351
460960,True,8,Very Positive,128,8,136
460970,True,7,Positive,12,3,15
460980,True,0,No user reviews,0,0,0
460990,True,5,Mixed,16,8,24
461010,True,8,Very Positive,50,12,62
461020,True,0,No user reviews,0,0,0
461030,True,5,Mixed,9,4,13
461040,True,7,Positive,14,2,16
461050,True,0,1 user reviews,1,0,1
461060,True,0,No user reviews,0,0,0
461090,True,0,No user reviews,0,0,0
461100,True,0,No user reviews,0,0,0
461110,True,0,No user reviews,0,0,0
461120,True,0,No user reviews,0,0,0
461130,True,0,3 user reviews,3,0,3
461150,True,0,No user reviews,0,0,0
461160,True,7,Positive,9,1,10
461170,True,8,Very Positive,131,17,148
461180,True,0,2 user reviews,2,0,2
461190,True,0,No user reviews,0,0,0
461200,True,0,2 user reviews,2,0,2
461210,True,5,Mixed,24,18,42
461220,True,8,Very Positive,71,8,79
461230,True,8,Very Positive,58,11,69
461240,True,7,Positive,12,2,14
461241,True,7,Positive,9,1,10
461242,True,8,Very Positive,94,8,102
461243,True,0,6 user reviews,5,1,6
461244,True,8,Very Positive,263,15,278
461245,True,7,Positive,9,1,10
461246,True,7,Positive,10,1,11
461247,True,7,Positive,18,0,18
461248,True,7,Positive,30,2,32
461249,True,8,Very Positive,113,4,117
461250,True,0,4 user reviews,4,0,4
461280,True,0,3 user reviews,3,0,3
461300,True,0,No user reviews,0,0,0
461320,True,0,3 user reviews,2,1,3
461330,True,0,No user reviews,0,0,0
461340,True,7,Positive,15,2,17
461350,True,6,Mostly Positive,7,3,10
461360,True,7,Positive,13,3,16
461370,True,0,4 user reviews,2,2,4
461380,True,5,Mixed,11,11,22
461390,True,0,9 user reviews,3,6,9
461400,True,5,Mixed,8,12,20
461410,True,7,Positive,42,7,49
461420,True,0,No user reviews,0,0,0
461430,True,5,Mixed,1134,580,1714
461440,True,0,No user reviews,0,0,0
461470,True,0,No user reviews,0,0,0
461480,True,7,Positive,12,1,13
461490,True,5,Mixed,19,17,36
461500,True,7,Positive,29,7,36
461510,True,5,Mixed,9,5,14
461520,True,4,Mostly Negative,10,40,50
461530,True,0,No user reviews,0,0,0
461540,True,0,No user reviews,0,0,0
461550,True,0,No user reviews,0,0,0
461560,True,8,Very Positive,101,7,108
461580,True,0,2 user reviews,1,1,2
461590,True,0,4 user reviews,3,1,4
461600,True,0,1 user reviews,1,0,1
461610,True,0,No user reviews,0,0,0
461620,True,8,Very Positive,377,60,437
461640,True,8,Very Positive,337,53,390
461650,True,5,Mixed,10,5,15
461660,True,0,No user reviews,0,0,0
461680,True,4,Mostly Negative,14,26,40
461700,True,8,Very Positive,240,16,256
461710,True,7,Positive,19,2,21
461730,True,6,Mostly Positive,55,19,74
461740,True,7,Positive,28,0,28
461750,True,0,1 user reviews,1,0,1
461760,True,0,9 user reviews,4,5,9
461780,True,4,Mostly Negative,20,53,73
461800,True,8,Very Positive,127,22,149
461810,True,7,Positive,22,3,25
461820,True,0,2 user reviews,1,1,2
461830,True,0,2 user reviews,1,1,2
461840,True,8,Very Positive,746,52,798
461850,True,0,4 user reviews,2,2,4
461860,True,5,Mixed,6,5,11
461870,True,5,Mixed,574,639,1213
461880,True,4,Mostly Negative,5,16,21
461890,True,5,Mixed,68,36,104
461900,True,5,Mixed,28,14,42
461930,True,0,No user reviews,0,0,0
461931,True,0,No user reviews,0,0,0
461932,True,0,No user reviews,0,0,0
461933,True,0,No user reviews,0,0,0
461934,True,0,No user reviews,0,0,0
461935,True,0,No user reviews,0,0,0
461940,True,4,Mostly Negative,4,10,14
461950,True,6,Mostly Positive,453,171,624
461970,True,0,No user reviews,0,0,0
461990,True,0,2 user reviews,0,2,2
462000,True,8,Very Positive,70,10,80
462050,True,5,Mixed,5,5,10
462070,True,0,8 user reviews,3,5,8
462081,True,0,4 user reviews,4,0,4
462082,True,0,No user reviews,0,0,0
462083,True,0,1 user reviews,1,0,1
462084,True,0,No user reviews,0,0,0
462085,True,0,No user reviews,0,0,0
462086,True,0,No user reviews,0,0,0
462087,True,0,1 user reviews,1,0,1
462088,True,0,No user reviews,0,0,0
462089,True,0,No user reviews,0,0,0
462100,True,8,Very Positive,137,26,163
462110,True,0,7 user reviews,3,4,7
462130,True,0,5 user reviews,5,0,5
462140,True,0,4 user reviews,3,1,4
462170,True,0,5 user reviews,5,0,5
462210,True,0,No user reviews,0,0,0
462211,True,0,3 user reviews,1,2,3
462212,True,0,1 user reviews,1,0,1
462213,True,0,No user reviews,0,0,0
462214,True,0,No user reviews,0,0,0
462220,True,7,Positive,9,2,11
462240,True,6,Mostly Positive,10,4,14
462250,True,0,1 user reviews,1,0,1
462260,True,6,Mostly Positive,28,9,37
462261,True,7,Positive,31,6,37
462280,True,0,5 user reviews,4,1,5
462290,True,5,Mixed,10,8,18
462310,True,0,No user reviews,0,0,0
462351,True,0,No user reviews,0,0,0
462360,True,0,No user reviews,0,0,0
462380,True,0,No user reviews,0,0,0
462390,True,0,6 user reviews,6,0,6
462391,True,0,4 user reviews,4,0,4
462400,True,0,1 user reviews,0,1,1
462440,True,4,Mostly Negative,73,120,193
462460,True,0,8 user reviews,6,2,8
462480,True,7,Positive,31,4,35
462520,True,7,Positive,13,2,15
462530,True,0,1 user reviews,0,1,1
462540,True,0,No user reviews,0,0,0
462550,True,0,1 user reviews,1,0,1
462570,True,0,8 user reviews,6,2,8
462580,True,0,3 user reviews,1,2,3
462590,True,7,Positive,12,0,12
462600,True,0,6 user reviews,5,1,6
462601,True,0,No user reviews,0,0,0
462603,True,0,No user reviews,0,0,0
462604,True,0,No user reviews,0,0,0
462605,True,0,2 user reviews,2,0,2
462610,True,5,Mixed,7,4,11
462611,True,0,4 user reviews,4,0,4
462620,True,7,Positive,30,2,32
462630,True,0,2 user reviews,2,0,2
462640,True,5,Mixed,10,5,15
462660,True,0,No user reviews,0,0,0
462670,True,0,3 user reviews,3,0,3
462680,True,6,Mostly Positive,144,41,185
462700,True,5,Mixed,24,16,40
462720,True,0,No user reviews,0,0,0
462730,True,5,Mixed,17,10,27
462740,True,0,1 user reviews,1,0,1
462770,True,8,Very Positive,3427,381,3808
462780,True,8,Very Positive,1875,311,2186
462830,True,4,Mostly Negative,11,29,40
462860,True,6,Mostly Positive,19,8,27
462880,True,0,5 user reviews,5,0,5
462910,True,0,3 user reviews,3,0,3
462920,True,5,Mixed,16,20,36
462930,True,5,Mixed,81,42,123
462940,True,6,Mostly Positive,77,23,100
462950,True,5,Mixed,7,7,14
462960,True,5,Mixed,92,41,133
462990,True,8,Very Positive,166,13,179
463000,True,0,1 user reviews,0,1,1
463010,True,0,5 user reviews,2,3,5
463020,True,7,Positive,12,0,12
463030,True,5,Mixed,92,54,146
463060,True,0,3 user reviews,2,1,3
463070,True,7,Positive,27,1,28
463080,True,0,No user reviews,0,0,0
463090,True,0,1 user reviews,1,0,1
463100,True,0,4 user reviews,0,4,4
463110,True,6,Mostly Positive,93,34,127
463120,True,0,No user reviews,0,0,0
463130,True,0,No user reviews,0,0,0
463140,True,0,No user reviews,0,0,0
463150,True,6,Mostly Positive,183,47,230
463160,True,6,Mostly Positive,62,20,82
463170,True,5,Mixed,56,43,99
463180,True,0,8 user reviews,5,3,8
463190,True,0,No user reviews,0,0,0
463200,True,0,1 user reviews,1,0,1
463210,True,8,Very Positive,230,50,280
463220,True,6,Mostly Positive,111,39,150
463240,True,0,6 user reviews,6,0,6
463250,True,0,2 user reviews,1,1,2
463270,True,8,Very Positive,557,68,625
463290,True,8,Very Positive,88,7,95
463310,True,0,No user reviews,0,0,0
463320,True,5,Mixed,9,13,22
463330,True,0,No user reviews,0,0,0
463350,True,6,Mostly Positive,153,63,216
463360,True,0,1 user reviews,1,0,1
463390,True,7,Positive,13,2,15
463400,True,7,Positive,13,3,16
463410,True,0,No user reviews,0,0,0
463430,True,0,6 user reviews,2,4,6
463440,True,0,1 user reviews,0,1,1
463450,True,0,4 user reviews,4,0,4
463460,True,5,Mixed,9,6,15
463470,True,6,Mostly Positive,7,3,10
463480,True,0,5 user reviews,4,1,5
463490,True,0,No user reviews,0,0,0
463510,True,0,8 user reviews,4,4,8
463530,True,9,Overwhelmingly Positive,2323,107,2430
463540,True,0,No user reviews,0,0,0
463590,True,7,Positive,11,1,12
463600,True,0,No user reviews,0,0,0
463610,True,0,No user reviews,0,0,0
463630,True,0,1 user reviews,1,0,1
463640,True,6,Mostly Positive,10,3,13
463650,True,0,6 user reviews,6,0,6
463670,True,0,9 user reviews,5,4,9
463690,True,0,No user reviews,0,0,0
463700,True,8,Very Positive,73,11,84
463710,True,4,Mostly Negative,3,8,11
463720,True,8,Very Positive,161,26,187
463740,True,8,Very Positive,248,8,256
463750,True,7,Positive,19,0,19
463760,True,6,Mostly Positive,21,7,28
463780,True,0,No user reviews,0,0,0
463790,True,5,Mixed,8,5,13
463791,True,7,Positive,41,6,47
463792,True,0,No user reviews,0,0,0
463794,True,0,4 user reviews,4,0,4
463795,True,6,Mostly Positive,46,19,65
463796,True,0,9 user reviews,7,2,9
463797,True,6,Mostly Positive,7,3,10
463798,True,0,9 user reviews,5,4,9
463799,True,7,Positive,11,2,13
463800,True,8,Very Positive,50,10,60
463810,True,0,3 user reviews,3,0,3
463830,True,0,2 user reviews,0,2,2
463850,True,6,Mostly Positive,92,28,120
463860,True,5,Mixed,24,28,52
463870,True,5,Mixed,7,4,11
463880,True,5,Mixed,10,7,17
463900,True,0,No user reviews,0,0,0
463901,True,0,No user reviews,0,0,0
463902,True,0,No user reviews,0,0,0
463903,True,0,No user reviews,0,0,0
463904,True,0,No user reviews,0,0,0
463920,True,0,4 user reviews,1,3,4
463930,True,8,Very Positive,169,6,175
463940,True,0,No user reviews,0,0,0
463950,True,0,No user reviews,0,0,0
463951,True,0,No user reviews,0,0,0
463980,True,8,Very Positive,143,27,170
463990,True,0,No user reviews,0,0,0
464000,True,6,Mostly Positive,24,8,32
464020,True,0,5 user reviews,2,3,5
464040,True,0,No user reviews,0,0,0
464050,True,0,3 user reviews,2,1,3
464060,True,8,Very Positive,2667,254,2921
464070,True,0,3 user reviews,2,1,3
464080,True,6,Mostly Positive,30,9,39
464100,True,5,Mixed,55,28,83
464110,True,0,5 user reviews,5,0,5
464120,True,0,9 user reviews,8,1,9
464130,True,0,No user reviews,0,0,0
464140,True,0,No user reviews,0,0,0
464150,True,6,Mostly Positive,157,44,201
464160,True,0,1 user reviews,1,0,1
464170,True,5,Mixed,20,16,36
464180,True,0,No user reviews,0,0,0
464190,True,0,1 user reviews,1,0,1
464200,True,0,4 user reviews,2,2,4
464201,True,0,5 user reviews,4,1,5
464202,True,0,7 user reviews,5,2,7
464203,True,0,No user reviews,0,0,0
464204,True,0,3 user reviews,1,2,3
464205,True,0,3 user reviews,1,2,3
464206,True,0,2 user reviews,1,1,2
464210,True,0,2 user reviews,2,0,2
464220,True,0,3 user reviews,3,0,3
464230,True,6,Mostly Positive,16,6,22
464240,True,5,Mixed,11,5,16
464250,True,0,No user reviews,0,0,0
464260,True,7,Positive,19,3,22
464270,True,0,No user reviews,0,0,0
464290,True,0,No user reviews,0,0,0
464300,True,0,3 user reviews,2,1,3
464310,True,0,No user reviews,0,0,0
464320,True,0,No user reviews,0,0,0
464330,True,0,No user reviews,0,0,0
464340,True,5,Mixed,231,292,523
464350,True,8,Very Positive,713,88,801
464360,True,9,Overwhelmingly Positive,748,38,786
464380,True,3,Negative,2,10,12
464390,True,0,No user reviews,0,0,0
464400,True,7,Positive,22,1,23
464410,True,6,Mostly Positive,7,3,10
464420,True,0,9 user reviews,7,2,9
464430,True,0,9 user reviews,9,0,9
464440,True,5,Mixed,15,10,25
464450,True,8,Very Positive,181,9,190
464460,True,0,No user reviews,0,0,0
464470,True,5,Mixed,72,87,159
464490,True,7,Positive,29,1,30
464500,True,7,Positive,27,1,28
464510,True,0,1 user reviews,1,0,1
464511,True,0,1 user reviews,1,0,1
464512,True,0,1 user reviews,1,0,1
464513,True,0,1 user reviews,1,0,1
464520,True,0,1 user reviews,1,0,1
464521,True,0,No user reviews,0,0,0
464522,True,0,1 user reviews,1,0,1
464523,True,0,1 user reviews,1,0,1
464524,True,0,1 user reviews,1,0,1
464525,True,0,No user reviews,0,0,0
464530,True,5,Mixed,9,5,14
464540,True,0,3 user reviews,1,2,3
464550,True,0,No user reviews,0,0,0
464560,True,0,No user reviews,0,0,0
464580,True,0,No user reviews,0,0,0
464590,True,6,Mostly Positive,10,3,13
464591,True,0,7 user reviews,7,0,7
464610,True,0,5 user reviews,5,0,5
464620,True,8,Very Positive,349,25,374
464630,True,0,5 user reviews,0,5,5
464640,True,0,No user reviews,0,0,0
464650,True,7,Positive,24,4,28
464660,True,0,3 user reviews,3,0,3
464670,True,0,8 user reviews,6,2,8
464680,True,0,1 user reviews,0,1,1
464681,True,0,No user reviews,0,0,0
464690,True,3,Negative,5,23,28
464700,True,0,5 user reviews,2,3,5
464720,True,0,2 user reviews,2,0,2
464730,True,0,1 user reviews,1,0,1
464740,True,0,2 user reviews,2,0,2
464760,True,4,Mostly Negative,7,11,18
464780,True,7,Positive,17,2,19
464790,True,0,No user reviews,0,0,0
464800,True,0,1 user reviews,0,1,1
464810,True,0,No user reviews,0,0,0
464820,True,0,6 user reviews,0,6,6
464840,True,7,Positive,32,5,37
464850,True,5,Mixed,146,96,242
464860,True,0,No user reviews,0,0,0
464880,True,6,Mostly Positive,314,90,404
464890,True,5,Mixed,16,8,24
464900,True,7,Positive,28,0,28
464920,True,8,Very Positive,4723,977,5700
464930,True,0,No user reviews,0,0,0
464940,True,0,2 user reviews,2,0,2
464950,True,0,3 user reviews,3,0,3
464960,True,7,Positive,40,2,42
464970,True,0,No user reviews,0,0,0
465000,True,5,Mixed,22,11,33
465010,True,0,2 user reviews,1,1,2
465020,True,8,Very Positive,99,8,107
465040,True,0,1 user reviews,1,0,1
465050,True,0,2 user reviews,2,0,2
465060,True,0,5 user reviews,5,0,5
465070,True,7,Positive,10,0,10
465090,True,0,1 user reviews,0,1,1
465100,True,8,Very Positive,128,17,145
465120,True,0,No user reviews,0,0,0
465130,True,7,Positive,17,3,20
465150,True,7,Positive,21,4,25
465170,True,5,Mixed,30,19,49
465180,True,7,Positive,17,1,18
465190,True,0,7 user reviews,3,4,7
465200,True,8,Very Positive,178,8,186
465210,True,0,No user reviews,0,0,0
465220,True,0,7 user reviews,7,0,7
465230,True,0,1 user reviews,1,0,1
465240,True,8,Very Positive,601,113,714
465250,True,5,Mixed,13,6,19
465280,True,6,Mostly Positive,61,19,80
465290,True,0,No user reviews,0,0,0
465291,True,0,No user reviews,0,0,0
465292,True,0,1 user reviews,1,0,1
465310,True,7,Positive,18,3,21
465320,True,0,No user reviews,0,0,0
465340,True,0,No user reviews,0,0,0
465360,True,7,Positive,29,7,36
465400,True,0,No user reviews,0,0,0
465410,True,0,No user reviews,0,0,0
465420,True,0,No user reviews,0,0,0
465440,True,0,1 user reviews,1,0,1
465450,True,6,Mostly Positive,16,6,22
465460,True,0,No user reviews,0,0,0
465470,True,0,No user reviews,0,0,0
465480,True,8,Very Positive,50,0,50
465490,True,8,Very Positive,557,88,645
465510,True,4,Mostly Negative,6,15,21
465520,True,7,Positive,38,3,41
465530,True,0,No user reviews,0,0,0
465540,True,5,Mixed,6,8,14
465550,True,0,No user reviews,0,0,0
465560,True,0,No user reviews,0,0,0
465570,True,0,No user reviews,0,0,0
465600,True,0,5 user reviews,4,1,5
465610,True,0,No user reviews,0,0,0
465630,True,0,No user reviews,0,0,0
465650,True,8,Very Positive,374,28,402
465660,True,5,Mixed,33,28,61
465670,True,0,3 user reviews,3,0,3
465680,True,0,No user reviews,0,0,0
465691,True,0,1 user reviews,1,0,1
465710,True,0,No user reviews,0,0,0
465720,True,5,Mixed,29,14,43
465730,True,0,1 user reviews,1,0,1
465750,True,0,7 user reviews,6,1,7
465760,True,5,Mixed,33,24,57
465780,True,8,Very Positive,327,74,401
465830,True,0,No user reviews,0,0,0
465831,True,0,No user reviews,0,0,0
465832,True,0,No user reviews,0,0,0
465833,True,0,No user reviews,0,0,0
465834,True,0,No user reviews,0,0,0
465840,True,7,Positive,20,5,25
465860,True,0,3 user reviews,2,1,3
465870,True,5,Mixed,8,5,13
465890,True,7,Positive,11,0,11
465900,True,7,Positive,9,1,10
465920,True,0,4 user reviews,4,0,4
465930,True,5,Mixed,13,8,21
465940,True,0,No user reviews,0,0,0
465950,True,0,No user reviews,0,0,0
465960,True,0,4 user reviews,2,2,4
465970,True,0,2 user reviews,2,0,2
465980,True,7,Positive,35,1,36
465990,True,0,6 user reviews,4,2,6
466000,True,7,Positive,20,0,20
466010,True,0,6 user reviews,6,0,6
466020,True,0,8 user reviews,8,0,8
466030,True,0,7 user reviews,7,0,7
466040,True,0,1 user reviews,1,0,1
466050,True,0,7 user reviews,7,0,7
466060,True,0,8 user reviews,8,0,8
466070,True,0,1 user reviews,1,0,1
466080,True,0,2 user reviews,2,0,2
466100,True,0,7 user reviews,5,2,7
466110,True,8,Very Positive,332,25,357
466130,True,8,Very Positive,110,21,131
466160,True,7,Positive,13,0,13
466170,True,5,Mixed,9,4,13
466200,True,0,2 user reviews,2,0,2
466210,True,0,8 user reviews,3,5,8
466220,True,5,Mixed,96,71,167
466240,True,5,Mixed,491,233,724
466250,True,0,No user reviews,0,0,0
466260,True,0,No user reviews,0,0,0
466270,True,7,Positive,16,3,19
466280,True,0,3 user reviews,2,1,3
466290,True,0,3 user reviews,3,0,3
466300,True,8,Very Positive,1081,69,1150
466350,True,5,Mixed,24,20,44
466360,True,0,No user reviews,0,0,0
466380,True,0,1 user reviews,1,0,1
466390,True,0,7 user reviews,7,0,7
466420,True,5,Mixed,9,7,16
466430,True,8,Very Positive,52,1,53
466440,True,0,No user reviews,0,0,0
466450,True,0,No user reviews,0,0,0
466460,True,0,No user reviews,0,0,0
466490,True,4,Mostly Negative,10,19,29
466500,True,5,Mixed,429,326,755
466510,True,0,No user reviews,0,0,0
466520,True,6,Mostly Positive,14,6,20
466530,True,0,No user reviews,0,0,0
466540,True,6,Mostly Positive,9,3,12
466541,True,0,5 user reviews,4,1,5
466542,True,7,Positive,10,2,12
466543,True,5,Mixed,6,8,14
466544,True,7,Positive,18,3,21
466545,True,7,Positive,15,3,18
466546,True,5,Mixed,12,15,27
466547,True,6,Mostly Positive,7,3,10
466548,True,7,Positive,9,2,11
466549,True,5,Mixed,9,6,15
466550,True,6,Mostly Positive,9,3,12
466551,True,0,6 user reviews,4,2,6
466560,True,8,Very Positive,9228,1507,10735
466580,True,0,2 user reviews,1,1,2
466590,True,0,No user reviews,0,0,0
466630,True,9,Overwhelmingly Positive,657,18,675
466660,True,8,Very Positive,54,12,66
466710,True,7,Positive,13,0,13
466720,True,0,No user reviews,0,0,0
466730,True,5,Mixed,15,14,29
466740,True,6,Mostly Positive,115,42,157
466770,True,0,5 user reviews,5,0,5
466780,True,5,Mixed,6,8,14
466800,True,8,Very Positive,111,27,138
466810,True,7,Positive,19,1,20
466820,True,7,Positive,14,0,14
466840,True,5,Mixed,50,39,89
466860,True,5,Mixed,13,6,19
466870,True,8,Very Positive,104,17,121
466890,True,3,Negative,5,27,32
466900,True,0,2 user reviews,2,0,2
466910,True,6,Mostly Positive,25,7,32
466920,True,6,Mostly Positive,24,9,33
466930,True,0,No user reviews,0,0,0
466940,True,5,Mixed,107,83,190
466960,True,0,No user reviews,0,0,0
466980,True,6,Mostly Positive,54,19,73
467000,True,5,Mixed,32,31,63
467010,True,4,Mostly Negative,8,16,24
467030,True,0,No user reviews,0,0,0
467031,True,0,No user reviews,0,0,0
467032,True,0,No user reviews,0,0,0
467033,True,0,No user reviews,0,0,0
467034,True,0,No user reviews,0,0,0
467035,True,0,No user reviews,0,0,0
467036,True,0,No user reviews,0,0,0
467037,True,0,No user reviews,0,0,0
467038,True,0,No user reviews,0,0,0
467039,True,0,No user reviews,0,0,0
467040,True,0,No user reviews,0,0,0
467041,True,0,No user reviews,0,0,0
467042,True,0,No user reviews,0,0,0
467043,True,0,No user reviews,0,0,0
467044,True,0,No user reviews,0,0,0
467045,True,0,No user reviews,0,0,0
467046,True,0,No user reviews,0,0,0
467047,True,0,No user reviews,0,0,0
467048,True,0,No user reviews,0,0,0
467049,True,0,No user reviews,0,0,0
467050,True,0,No user reviews,0,0,0
467051,True,0,No user reviews,0,0,0
467070,True,0,No user reviews,0,0,0
467090,True,0,6 user reviews,5,1,6
467100,True,0,No user reviews,0,0,0
467110,True,0,No user reviews,0,0,0
467120,True,0,2 user reviews,2,0,2
467130,True,0,1 user reviews,1,0,1
467140,True,0,1 user reviews,1,0,1
467160,True,0,2 user reviews,2,0,2
467170,True,0,5 user reviews,4,1,5
467180,True,0,No user reviews,0,0,0
467190,True,0,No user reviews,0,0,0
467200,True,0,No user reviews,0,0,0
467210,True,8,Very Positive,74,4,78
467220,True,0,6 user reviews,4,2,6
467230,True,0,5 user reviews,5,0,5
467260,True,0,1 user reviews,1,0,1
467270,True,6,Mostly Positive,28,9,37
467290,True,7,Positive,35,6,41
467300,True,0,6 user reviews,6,0,6
467310,True,0,4 user reviews,1,3,4
467320,True,8,Very Positive,47,11,58
467330,True,7,Positive,21,4,25
467340,True,0,No user reviews,0,0,0
467350,True,0,4 user reviews,2,2,4
467360,True,7,Positive,23,4,27
467370,True,5,Mixed,13,13,26
467380,True,7,Positive,29,2,31
467390,True,5,Mixed,35,29,64
467400,True,6,Mostly Positive,22,6,28
467430,True,5,Mixed,13,6,19
467440,True,0,1 user reviews,1,0,1
467470,True,7,Positive,13,0,13
467480,True,0,9 user reviews,5,4,9
467490,True,7,Positive,20,2,22
467500,True,0,1 user reviews,1,0,1
467510,True,0,3 user reviews,3,0,3
467511,True,0,2 user reviews,2,0,2
467512,True,0,3 user reviews,2,1,3
467513,True,0,No user reviews,0,0,0
467514,True,0,No user reviews,0,0,0
467515,True,0,4 user reviews,1,3,4
467516,True,0,No user reviews,0,0,0
467517,True,0,1 user reviews,1,0,1
467518,True,0,No user reviews,0,0,0
467520,True,5,Mixed,111,133,244
467540,True,0,No user reviews,0,0,0
467570,True,4,Mostly Negative,42,75,117
467600,True,0,2 user reviews,2,0,2
467620,True,0,3 user reviews,3,0,3
467650,True,0,1 user reviews,1,0,1
467660,True,6,Mostly Positive,297,88,385
467680,True,6,Mostly Positive,86,31,117
467700,True,0,No user reviews,0,0,0
467710,True,7,Positive,8,2,10
467720,True,5,Mixed,15,8,23
467740,True,0,No user reviews,0,0,0
467750,True,0,No user reviews,0,0,0
467760,True,8,Very Positive,91,7,98
467770,True,0,3 user reviews,3,0,3
467780,True,7,Positive,25,0,25
467790,True,0,3 user reviews,2,1,3
467810,True,7,Positive,36,1,37
467820,True,8,Very Positive,202,20,222
467850,True,5,Mixed,58,27,85
467870,True,0,No user reviews,0,0,0
467890,True,5,Mixed,14,10,24
467900,True,5,Mixed,31,22,53
467910,True,5,Mixed,15,9,24
467930,True,6,Mostly Positive,137,40,177
467940,True,0,7 user reviews,7,0,7
467950,True,6,Mostly Positive,30,12,42
467960,True,5,Mixed,98,79,177
467970,True,0,No user reviews,0,0,0
467980,True,8,Very Positive,279,15,294
467990,True,5,Mixed,72,37,109
468000,True,5,Mixed,42,51,93
468010,True,0,No user reviews,0,0,0
468020,True,0,No user reviews,0,0,0
468040,True,0,No user reviews,0,0,0
468050,True,8,Very Positive,75,4,79
468060,True,8,Very Positive,148,4,152
468070,True,5,Mixed,41,21,62
468080,True,0,2 user reviews,1,1,2
468100,True,6,Mostly Positive,37,12,49
468110,True,7,Positive,10,0,10
468130,True,0,3 user reviews,3,0,3
468140,True,0,No user reviews,0,0,0
468150,True,0,5 user reviews,3,2,5
468160,True,5,Mixed,21,18,39
468170,True,7,Positive,13,3,16
468180,True,0,No user reviews,0,0,0
468190,True,0,No user reviews,0,0,0
468240,True,8,Very Positive,52,6,58
468250,True,6,Mostly Positive,77,28,105
468270,True,0,No user reviews,0,0,0
468280,True,7,Positive,17,2,19
468310,True,7,Positive,17,4,21
468320,True,0,5 user reviews,2,3,5
468330,True,0,5 user reviews,4,1,5
468350,True,0,2 user reviews,1,1,2
468360,True,0,No user reviews,0,0,0
468410,True,8,Very Positive,332,47,379
468420,True,0,No user reviews,0,0,0
468430,True,0,No user reviews,0,0,0
468460,True,0,8 user reviews,6,2,8
468490,True,5,Mixed,76,33,109
468510,True,5,Mixed,5,7,12
468520,True,0,No user reviews,0,0,0
468530,True,7,Positive,28,6,34
468540,True,0,1 user reviews,1,0,1
468550,True,7,Positive,30,0,30
468560,True,5,Mixed,10,15,25
468570,True,5,Mixed,15,22,37
468580,True,0,1 user reviews,1,0,1
468600,True,0,1 user reviews,1,0,1
468610,True,0,No user reviews,0,0,0
468630,True,0,No user reviews,0,0,0
468650,True,0,1 user reviews,0,1,1
468670,True,7,Positive,18,4,22
468680,True,0,No user reviews,0,0,0
468690,True,0,1 user reviews,0,1,1
468700,True,7,Positive,12,2,14
468720,True,0,2 user reviews,1,1,2
468721,True,0,3 user reviews,3,0,3
468722,True,0,No user reviews,0,0,0
468723,True,7,Positive,17,2,19
468724,True,0,No user reviews,0,0,0
468726,True,7,Positive,40,8,48
468727,True,0,6 user reviews,6,0,6
468728,True,0,No user reviews,0,0,0
468729,True,0,1 user reviews,1,0,1
468730,True,6,Mostly Positive,8,3,11
468731,True,0,4 user reviews,4,0,4
468732,True,0,No user reviews,0,0,0
468733,True,5,Mixed,14,9,23
468734,True,0,3 user reviews,2,1,3
468735,True,0,1 user reviews,1,0,1
468736,True,0,3 user reviews,2,1,3
468737,True,7,Positive,21,1,22
468739,True,0,No user reviews,0,0,0
468740,True,7,Positive,18,3,21
468750,True,0,No user reviews,0,0,0
468780,True,0,6 user reviews,6,0,6
468790,True,0,No user reviews,0,0,0
468800,True,5,Mixed,22,12,34
468820,True,8,Very Positive,119,10,129
468890,True,0,No user reviews,0,0,0
468900,True,0,3 user reviews,1,2,3
468920,True,8,Very Positive,897,133,1030
468930,True,5,Mixed,27,17,44
469050,True,0,No user reviews,0,0,0
469520,True,0,No user reviews,0,0,0
469530,True,0,No user reviews,0,0,0
469540,True,0,No user reviews,0,0,0
469550,True,0,5 user reviews,4,1,5
469560,True,5,Mixed,7,5,12
469600,True,6,Mostly Positive,939,263,1202
469610,True,6,Mostly Positive,813,280,1093
469650,True,0,1 user reviews,0,1,1
469660,True,7,Positive,45,1,46
469670,True,0,1 user reviews,1,0,1
469680,True,0,No user reviews,0,0,0
469710,True,7,Positive,16,4,20
469720,True,8,Very Positive,206,36,242
469730,True,8,Very Positive,205,26,231
469740,True,0,1 user reviews,1,0,1
469750,True,0,No user reviews,0,0,0
469780,True,0,1 user reviews,1,0,1
469790,True,8,Very Positive,191,3,194
469800,True,6,Mostly Positive,98,28,126
469820,True,8,Very Positive,2875,275,3150
469850,True,0,1 user reviews,1,0,1
469880,True,0,No user reviews,0,0,0
469890,True,8,Very Positive,56,12,68
469900,True,5,Mixed,5,6,11
469910,True,0,No user reviews,0,0,0
469920,True,6,Mostly Positive,389,114,503
469930,True,0,No user reviews,0,0,0
469940,True,0,No user reviews,0,0,0
469980,True,6,Mostly Positive,9,3,12
469990,True,0,8 user reviews,5,3,8
470000,True,0,2 user reviews,2,0,2
470011,True,0,2 user reviews,2,0,2
470012,True,0,1 user reviews,1,0,1
470020,True,0,1 user reviews,0,1,1
470030,True,0,1 user reviews,1,0,1
470040,True,5,Mixed,8,9,17
470060,True,6,Mostly Positive,31,9,40
470070,True,4,Mostly Negative,52,147,199
470080,True,0,No user reviews,0,0,0
470090,True,7,Positive,13,2,15
470110,True,0,3 user reviews,3,0,3
470120,True,0,1 user reviews,1,0,1
470130,True,0,No user reviews,0,0,0
470140,True,0,1 user reviews,1,0,1
470150,True,0,No user reviews,0,0,0
470151,True,0,1 user reviews,0,1,1
470160,True,0,No user reviews,0,0,0
470170,True,5,Mixed,8,8,16
470180,True,0,No user reviews,0,0,0
470190,True,0,7 user reviews,7,0,7
470200,True,0,No user reviews,0,0,0
470210,True,6,Mostly Positive,33,9,42
470220,True,6,Mostly Positive,8417,2995,11412
470230,True,0,No user reviews,0,0,0
470240,True,0,3 user reviews,2,1,3
470250,True,0,9 user reviews,8,1,9
470260,True,6,Mostly Positive,713,212,925
470270,True,6,Mostly Positive,40,15,55
470280,True,4,Mostly Negative,4,15,19
470290,True,0,No user reviews,0,0,0
470291,True,0,No user reviews,0,0,0
470292,True,0,No user reviews,0,0,0
470300,True,6,Mostly Positive,32,11,43
470310,True,8,Very Positive,999,57,1056
470320,True,0,No user reviews,0,0,0
470330,True,0,No user reviews,0,0,0
470340,True,0,No user reviews,0,0,0
470350,True,0,No user reviews,0,0,0
470360,True,0,No user reviews,0,0,0
470370,True,0,No user reviews,0,0,0
470380,True,0,No user reviews,0,0,0
470390,True,0,No user reviews,0,0,0
470400,True,0,No user reviews,0,0,0
470410,True,0,No user reviews,0,0,0
470420,True,0,No user reviews,0,0,0
470430,True,0,No user reviews,0,0,0
470440,True,7,Positive,11,0,11
470450,True,6,Mostly Positive,9,3,12
470470,True,7,Positive,23,0,23
470480,True,7,Positive,8,2,10
470490,True,5,Mixed,6,4,10
470500,True,0,No user reviews,0,0,0
470540,True,0,No user reviews,0,0,0
470570,True,0,No user reviews,0,0,0
470580,True,7,Positive,12,1,13
470590,True,7,Positive,23,3,26
470610,True,0,1 user reviews,1,0,1
470670,True,0,1 user reviews,1,0,1
470690,True,7,Positive,19,0,19
470691,True,0,4 user reviews,3,1,4
470740,True,6,Mostly Positive,62,21,83
470750,True,5,Mixed,16,10,26
470760,True,0,6 user reviews,4,2,6
470770,True,0,No user reviews,0,0,0
470780,True,8,Very Positive,51,1,52
470800,True,0,No user reviews,0,0,0
470870,True,0,No user reviews,0,0,0
470890,True,0,4 user reviews,0,4,4
471010,True,6,Mostly Positive,292,83,375
471160,True,5,Mixed,15,7,22
471170,True,6,Mostly Positive,19,6,25
471200,True,0,3 user reviews,3,0,3
471220,True,0,3 user reviews,2,1,3
471230,True,0,No user reviews,0,0,0
471240,True,0,3 user reviews,3,0,3
471250,True,0,No user reviews,0,0,0
471260,True,6,Mostly Positive,16,5,21
471270,True,0,7 user reviews,5,2,7
471310,True,0,1 user reviews,0,1,1
471320,True,0,No user reviews,0,0,0
471330,True,8,Very Positive,143,35,178
471350,True,6,Mostly Positive,11,4,15
471380,True,5,Mixed,9,5,14
471390,True,0,3 user reviews,2,1,3
471400,True,0,4 user reviews,4,0,4
471410,True,0,No user reviews,0,0,0
471420,True,0,No user reviews,0,0,0
471450,True,0,No user reviews,0,0,0
471520,True,0,No user reviews,0,0,0
471550,True,6,Mostly Positive,596,156,752
471570,True,7,Positive,36,1,37
471580,True,0,2 user reviews,1,1,2
471610,True,0,No user reviews,0,0,0
471630,True,0,2 user reviews,2,0,2
471640,True,0,7 user reviews,5,2,7
471650,True,5,Mixed,12,16,28
471660,True,8,Very Positive,300,42,342
471700,True,5,Mixed,13,6,19
471710,True,8,Very Positive,99,0,99
471730,True,0,9 user reviews,6,3,9
471740,True,0,1 user reviews,1,0,1
471741,True,0,5 user reviews,5,0,5
471750,True,0,No user reviews,0,0,0
471760,True,0,No user reviews,0,0,0
471770,True,0,6 user reviews,4,2,6
471800,True,0,No user reviews,0,0,0
471810,True,8,Very Positive,110,9,119
471870,True,0,1 user reviews,1,0,1
471880,True,0,No user reviews,0,0,0
471890,True,0,4 user reviews,4,0,4
471891,True,6,Mostly Positive,36,12,48
471893,True,0,No user reviews,0,0,0
471894,True,0,1 user reviews,1,0,1
471895,True,0,1 user reviews,1,0,1
471896,True,0,No user reviews,0,0,0
471897,True,0,No user reviews,0,0,0
471898,True,0,No user reviews,0,0,0
471899,True,6,Mostly Positive,18,6,24
471900,True,0,No user reviews,0,0,0
471920,True,8,Very Positive,56,8,64
472030,True,0,No user reviews,0,0,0
472060,True,0,3 user reviews,3,0,3
472070,True,7,Positive,18,2,20
472350,True,7,Positive,28,4,32
472420,True,8,Very Positive,60,12,72
472490,True,7,Positive,13,2,15
472630,True,0,No user reviews,0,0,0
472670,True,0,No user reviews,0,0,0
472671,True,0,1 user reviews,1,0,1
472680,True,5,Mixed,8,5,13
472690,True,0,7 user reviews,6,1,7
472720,True,0,4 user reviews,3,1,4
472740,True,0,3 user reviews,0,3,3
472750,True,0,No user reviews,0,0,0
472770,True,0,7 user reviews,7,0,7
472810,True,0,3 user reviews,3,0,3
472811,True,0,3 user reviews,3,0,3
472830,True,0,2 user reviews,1,1,2
472840,True,0,6 user reviews,2,4,6
472841,True,0,No user reviews,0,0,0
472850,True,0,No user reviews,0,0,0
472860,True,0,5 user reviews,4,1,5
472861,True,0,No user reviews,0,0,0
472870,True,8,Very Positive,190,0,190
473050,True,0,1 user reviews,0,1,1
473090,True,0,No user reviews,0,0,0
473100,True,0,No user reviews,0,0,0
473110,True,0,No user reviews,0,0,0
473120,True,0,No user reviews,0,0,0
473140,True,0,3 user reviews,0,3,3
473410,True,0,No user reviews,0,0,0
473420,True,0,1 user reviews,1,0,1
473430,True,0,4 user reviews,3,1,4
473440,True,0,3 user reviews,2,1,3
473441,True,0,1 user reviews,1,0,1
473442,True,0,2 user reviews,2,0,2
473443,True,0,3 user reviews,3,0,3
473444,True,7,Positive,10,0,10
473445,True,0,1 user reviews,1,0,1
473446,True,0,3 user reviews,3,0,3
473447,True,0,4 user reviews,4,0,4
473450,True,6,Mostly Positive,62,21,83
473460,True,0,3 user reviews,3,0,3
473470,True,5,Mixed,39,24,63
473480,True,0,3 user reviews,2,1,3
473510,True,7,Positive,15,2,17
473520,True,5,Mixed,7,7,14
473530,True,7,Positive,25,2,27
473540,True,0,5 user reviews,1,4,5
473550,True,0,1 user reviews,0,1,1
473560,True,5,Mixed,58,55,113
473590,True,0,No user reviews,0,0,0
473600,True,0,No user reviews,0,0,0
473610,True,4,Mostly Negative,12,25,37
473660,True,0,No user reviews,0,0,0
473670,True,5,Mixed,28,29,57
473690,True,6,Mostly Positive,4192,1749,5941
473720,True,7,Positive,11,0,11
473770,True,8,Very Positive,528,30,558
473780,True,0,8 user reviews,7,1,8
473790,True,0,No user reviews,0,0,0
473810,True,4,Mostly Negative,6,16,22
473840,True,7,Positive,11,2,13
473850,True,6,Mostly Positive,93,39,132
473870,True,0,2 user reviews,2,0,2
473871,True,0,6 user reviews,6,0,6
473900,True,0,7 user reviews,0,7,7
473910,True,5,Mixed,89,54,143
473920,True,8,Very Positive,103,1,104
473950,True,8,Very Positive,280,11,291
473960,True,0,No user reviews,0,0,0
473970,True,5,Mixed,49,32,81
473980,True,0,No user reviews,0,0,0
474010,True,0,6 user reviews,1,5,6
474020,True,6,Mostly Positive,77,23,100
474030,True,0,No user reviews,0,0,0
474050,True,0,5 user reviews,2,3,5
474210,True,8,Very Positive,390,46,436
474220,True,8,Very Positive,75,10,85
474230,True,0,7 user reviews,7,0,7
474240,True,0,8 user reviews,2,6,8
474260,True,0,No user reviews,0,0,0
474620,True,7,Positive,9,1,10
474720,True,0,4 user reviews,3,1,4
474730,True,0,6 user reviews,4,2,6
474740,True,6,Mostly Positive,47,15,62
474750,True,8,Very Positive,1879,273,2152
474760,True,5,Mixed,12,9,21
474761,True,7,Positive,34,7,41
474762,True,5,Mixed,16,20,36
474763,True,8,Very Positive,64,16,80
474764,True,7,Positive,22,5,27
474765,True,7,Positive,21,5,26
474766,True,7,Positive,23,3,26
474770,True,0,No user reviews,0,0,0
474780,True,0,6 user reviews,0,6,6
474800,True,0,1 user reviews,0,1,1
474801,True,5,Mixed,4,6,10
474802,True,0,No user reviews,0,0,0
474803,True,0,1 user reviews,1,0,1
474810,True,0,4 user reviews,3,1,4
474830,True,6,Mostly Positive,12,4,16
474850,True,0,No user reviews,0,0,0
474860,True,0,No user reviews,0,0,0
474880,True,0,3 user reviews,2,1,3
474890,True,6,Mostly Positive,65,19,84
474910,True,5,Mixed,22,15,37
474930,True,0,1 user reviews,1,0,1
474960,True,8,Very Positive,2957,638,3595
474980,True,8,Very Positive,60,8,68
475010,True,0,1 user reviews,1,0,1
475050,True,0,5 user reviews,2,3,5
475070,True,0,No user reviews,0,0,0
475080,True,0,4 user reviews,1,3,4
475090,True,4,Mostly Negative,6,14,20
475110,True,0,No user reviews,0,0,0
475130,True,0,8 user reviews,6,2,8
475131,True,0,8 user reviews,8,0,8
475132,True,0,8 user reviews,6,2,8
475150,True,8,Very Positive,4084,429,4513
475180,True,4,Mostly Negative,49,166,215
475190,True,8,Very Positive,815,97,912
475210,True,0,3 user reviews,3,0,3
475220,True,0,5 user reviews,0,5,5
475230,True,0,3 user reviews,3,0,3
475240,True,6,Mostly Positive,124,32,156
475280,True,0,No user reviews,0,0,0
475290,True,0,No user reviews,0,0,0
475300,True,0,No user reviews,0,0,0
475320,True,0,No user reviews,0,0,0
475330,True,0,No user reviews,0,0,0
475340,True,0,No user reviews,0,0,0
475350,True,0,1 user reviews,1,0,1
475360,True,0,1 user reviews,1,0,1
475370,True,0,No user reviews,0,0,0
475380,True,0,No user reviews,0,0,0
475390,True,0,1 user reviews,1,0,1
475400,True,0,No user reviews,0,0,0
475410,True,0,No user reviews,0,0,0
475420,True,0,No user reviews,0,0,0
475430,True,5,Mixed,168,96,264
475450,True,0,No user reviews,0,0,0
475460,True,0,1 user reviews,1,0,1
475490,True,6,Mostly Positive,290,76,366
475520,True,6,Mostly Positive,7,3,10
475530,True,0,1 user reviews,1,0,1
475550,True,6,Mostly Positive,1474,372,1846
475620,True,0,7 user reviews,6,1,7
475630,True,5,Mixed,16,8,24
475960,True,7,Positive,16,1,17
476000,True,0,6 user reviews,6,0,6
476010,True,0,1 user reviews,1,0,1
476020,True,5,Mixed,26,15,41
476030,True,0,7 user reviews,2,5,7
476040,True,0,5 user reviews,4,1,5
476041,True,0,No user reviews,0,0,0
476050,True,0,No user reviews,0,0,0
476051,True,0,No user reviews,0,0,0
476052,True,0,No user reviews,0,0,0
476240,True,8,Very Positive,282,14,296
476250,True,0,No user reviews,0,0,0
476350,True,0,No user reviews,0,0,0
476351,True,0,1 user reviews,1,0,1
476352,True,0,2 user reviews,2,0,2
476353,True,0,2 user reviews,1,1,2
476354,True,0,No user reviews,0,0,0
476355,True,0,No user reviews,0,0,0
476356,True,0,No user reviews,0,0,0
476357,True,0,No user reviews,0,0,0
476370,True,0,2 user reviews,1,1,2
476390,True,0,No user reviews,0,0,0
476391,True,0,No user reviews,0,0,0
476392,True,0,No user reviews,0,0,0
476400,True,0,No user reviews,0,0,0
476410,True,7,Positive,31,0,31
476420,True,5,Mixed,76,36,112
476430,True,0,9 user reviews,9,0,9
476440,True,0,No user reviews,0,0,0
476450,True,6,Mostly Positive,18,7,25
476460,True,7,Positive,11,0,11
476470,True,0,1 user reviews,1,0,1
476480,True,5,Mixed,20,19,39
476490,True,8,Very Positive,76,7,83
476500,True,0,No user reviews,0,0,0
476510,True,7,Positive,12,3,15
476520,True,0,No user reviews,0,0,0
476530,True,8,Very Positive,291,29,320
476540,True,0,No user reviews,0,0,0
476561,True,0,No user reviews,0,0,0
476570,True,0,No user reviews,0,0,0
476600,True,5,Mixed,4773,3801,8574
476620,True,6,Mostly Positive,949,324,1273
476650,True,8,Very Positive,150,31,181
476670,True,0,3 user reviews,2,1,3
476680,True,0,No user reviews,0,0,0
476690,True,0,No user reviews,0,0,0
476700,True,6,Mostly Positive,228,71,299
476710,True,0,8 user reviews,1,7,8
476860,True,0,1 user reviews,0,1,1
476861,True,0,2 user reviews,2,0,2
476862,True,0,7 user reviews,5,2,7
476863,True,0,3 user reviews,3,0,3
476864,True,7,Positive,19,0,19
476865,True,0,4 user reviews,4,0,4
476866,True,0,2 user reviews,2,0,2
476867,True,7,Positive,12,0,12
476868,True,7,Positive,19,0,19
476869,True,7,Positive,16,1,17
476870,True,0,9 user reviews,9,0,9
476871,True,7,Positive,14,2,16
476910,True,0,No user reviews,0,0,0
476920,True,5,Mixed,28,31,59
476940,True,0,1 user reviews,1,0,1
476950,True,0,No user reviews,0,0,0
476951,True,0,No user reviews,0,0,0
476952,True,0,No user reviews,0,0,0
477000,True,0,1 user reviews,0,1,1
477010,True,0,2 user reviews,1,1,2
477020,True,0,8 user reviews,8,0,8
477030,True,0,6 user reviews,5,1,6
477040,True,0,No user reviews,0,0,0
477050,True,0,3 user reviews,3,0,3
477130,True,0,4 user reviews,4,0,4
477140,True,0,2 user reviews,1,1,2
477150,True,0,No user reviews,0,0,0
477151,True,0,No user reviews,0,0,0
477160,True,8,Very Positive,13942,776,14718
477170,True,5,Mixed,16,8,24
477180,True,4,Mostly Negative,3,7,10
477190,True,0,3 user reviews,3,0,3
477200,True,0,8 user reviews,8,0,8
477220,True,0,No user reviews,0,0,0
477240,True,0,No user reviews,0,0,0
477260,True,0,No user reviews,0,0,0
477270,True,8,Very Positive,401,93,494
477290,True,6,Mostly Positive,9,3,12
477310,True,7,Positive,38,1,39
477720,True,0,7 user reviews,5,2,7
477730,True,6,Mostly Positive,311,116,427
477740,True,9,Overwhelmingly Positive,1215,56,1271
477750,True,5,Mixed,11,9,20
477760,True,0,No user reviews,0,0,0
477770,True,8,Very Positive,529,115,644
477780,True,0,No user reviews,0,0,0
477781,True,0,No user reviews,0,0,0
477790,True,0,6 user reviews,5,1,6
477800,True,0,1 user reviews,0,1,1
477810,True,0,No user reviews,0,0,0
477820,True,0,5 user reviews,5,0,5
477830,True,0,No user reviews,0,0,0
477840,True,0,No user reviews,0,0,0
477870,True,8,Very Positive,288,71,359
477880,True,0,No user reviews,0,0,0
477881,True,0,4 user reviews,3,1,4
477890,True,0,3 user reviews,2,1,3
477900,True,7,Positive,31,4,35
477910,True,0,2 user reviews,2,0,2
477940,True,0,7 user reviews,2,5,7
477941,True,0,1 user reviews,1,0,1
477942,True,0,1 user reviews,0,1,1
477950,True,0,8 user reviews,7,1,8
477990,True,0,No user reviews,0,0,0
478000,True,0,1 user reviews,0,1,1
478010,True,0,7 user reviews,3,4,7
478020,True,0,2 user reviews,2,0,2
478030,True,0,3 user reviews,3,0,3
478031,True,0,No user reviews,0,0,0
478032,True,0,1 user reviews,1,0,1
478033,True,0,4 user reviews,4,0,4
478034,True,0,1 user reviews,1,0,1
478035,True,0,No user reviews,0,0,0
478036,True,0,No user reviews,0,0,0
478037,True,0,No user reviews,0,0,0
478038,True,0,No user reviews,0,0,0
478039,True,0,No user reviews,0,0,0
478040,True,0,2 user reviews,2,0,2
478041,True,0,No user reviews,0,0,0
478042,True,0,No user reviews,0,0,0
478043,True,0,No user reviews,0,0,0
478044,True,0,No user reviews,0,0,0
478045,True,0,No user reviews,0,0,0
478046,True,0,No user reviews,0,0,0
478047,True,0,No user reviews,0,0,0
478048,True,0,No user reviews,0,0,0
478049,True,0,3 user reviews,3,0,3
478050,True,0,No user reviews,0,0,0
478051,True,0,No user reviews,0,0,0
478052,True,0,No user reviews,0,0,0
478053,True,0,1 user reviews,1,0,1
478054,True,0,No user reviews,0,0,0
478055,True,0,No user reviews,0,0,0
478056,True,0,No user reviews,0,0,0
478057,True,0,1 user reviews,1,0,1
478058,True,0,No user reviews,0,0,0
478200,True,0,No user reviews,0,0,0
478210,True,4,Mostly Negative,7,13,20
478300,True,0,No user reviews,0,0,0
478301,True,0,No user reviews,0,0,0
478950,True,5,Mixed,42,20,62
478960,True,0,1 user reviews,1,0,1
478970,True,0,No user reviews,0,0,0
478980,True,0,7 user reviews,6,1,7
478990,True,0,No user reviews,0,0,0
479000,True,7,Positive,24,6,30
479010,True,6,Mostly Positive,90,27,117
479020,True,5,Mixed,36,19,55
479040,True,5,Mixed,10,7,17
479060,True,0,9 user reviews,7,2,9
479061,True,0,4 user reviews,3,1,4
479100,True,5,Mixed,38,40,78
479110,True,0,9 user reviews,8,1,9
479120,True,0,No user reviews,0,0,0
479130,True,5,Mixed,65,28,93
479140,True,7,Positive,13,2,15
479150,True,0,1 user reviews,1,0,1
479170,True,0,1 user reviews,0,1,1
479180,True,0,5 user reviews,0,5,5
479190,True,0,No user reviews,0,0,0
479200,True,0,2 user reviews,1,1,2
479220,True,0,No user reviews,0,0,0
479230,True,0,4 user reviews,3,1,4
479270,True,0,2 user reviews,1,1,2
479310,True,0,2 user reviews,2,0,2
479330,True,5,Mixed,11,5,16
479990,True,5,Mixed,34,16,50
480410,True,0,6 user reviews,5,1,6
480430,True,6,Mostly Positive,207,55,262
480450,True,8,Very Positive,85,3,88
480470,True,0,No user reviews,0,0,0
480480,True,8,Very Positive,48,12,60
480490,True,8,Very Positive,10291,1135,11426
480500,True,5,Mixed,8,4,12
480520,True,0,8 user reviews,6,2,8
480530,True,5,Mixed,29,16,45
480540,True,0,6 user reviews,5,1,6
480550,True,0,5 user reviews,5,0,5
480560,True,0,No user reviews,0,0,0
480580,True,0,6 user reviews,4,2,6
480590,True,0,3 user reviews,3,0,3
480591,True,0,1 user reviews,1,0,1
480592,True,0,1 user reviews,1,0,1
480593,True,0,1 user reviews,1,0,1
480594,True,0,1 user reviews,1,0,1
480595,True,0,1 user reviews,1,0,1
480600,True,0,No user reviews,0,0,0
480630,True,5,Mixed,315,453,768
480631,True,4,Mostly Negative,420,645,1065
480640,True,5,Mixed,210,124,334
480650,True,8,Very Positive,1293,267,1560
480690,True,7,Positive,31,3,34
480710,True,0,1 user reviews,0,1,1
480720,True,0,2 user reviews,1,1,2
480721,True,0,No user reviews,0,0,0
480722,True,0,No user reviews,0,0,0
480770,True,0,1 user reviews,1,0,1
480780,True,4,Mostly Negative,6,17,23
480900,True,5,Mixed,15,13,28
481080,True,7,Positive,11,1,12
481090,True,6,Mostly Positive,78,28,106
481110,True,5,Mixed,235,117,352
481120,True,0,1 user reviews,1,0,1
481121,True,0,No user reviews,0,0,0
481122,True,0,7 user reviews,6,1,7
481170,True,0,No user reviews,0,0,0
481171,True,0,No user reviews,0,0,0
481172,True,0,4 user reviews,4,0,4
481180,True,8,Very Positive,124,29,153
481190,True,5,Mixed,100,98,198
481360,True,0,8 user reviews,6,2,8
481420,True,5,Mixed,22,14,36
481490,True,0,3 user reviews,3,0,3
481510,True,8,Very Positive,6460,418,6878
481600,True,5,Mixed,11,5,16
481750,True,0,No user reviews,0,0,0
481870,True,5,Mixed,84,42,126
481900,True,0,No user reviews,0,0,0
481910,True,0,No user reviews,0,0,0
481930,True,0,No user reviews,0,0,0
481940,True,0,No user reviews,0,0,0
481950,True,0,4 user reviews,4,0,4
482040,True,0,No user reviews,0,0,0
482050,True,0,No user reviews,0,0,0
482060,True,0,No user reviews,0,0,0
482070,True,0,No user reviews,0,0,0
482210,True,0,5 user reviews,4,1,5
482220,True,0,No user reviews,0,0,0
482221,True,0,2 user reviews,2,0,2
482222,True,0,3 user reviews,3,0,3
482223,True,0,No user reviews,0,0,0
482224,True,0,No user reviews,0,0,0
482300,True,5,Mixed,150,76,226
482330,True,5,Mixed,16,11,27
482340,True,0,No user reviews,0,0,0
482370,True,0,No user reviews,0,0,0
482390,True,0,2 user reviews,2,0,2
482400,True,0,No user reviews,0,0,0
482410,True,0,1 user reviews,1,0,1
482420,True,6,Mostly Positive,11,4,15
482450,True,8,Very Positive,201,21,222
482460,True,0,5 user reviews,3,2,5
482470,True,0,No user reviews,0,0,0
482480,True,0,No user reviews,0,0,0
482490,True,0,No user reviews,0,0,0
482500,True,0,No user reviews,0,0,0
482510,True,0,No user reviews,0,0,0
482520,True,0,No user reviews,0,0,0
482530,True,0,No user reviews,0,0,0
482540,True,0,No user reviews,0,0,0
482550,True,0,No user reviews,0,0,0
482560,True,0,No user reviews,0,0,0
482570,True,0,No user reviews,0,0,0
482580,True,0,No user reviews,0,0,0
482590,True,0,No user reviews,0,0,0
482600,True,0,No user reviews,0,0,0
482610,True,0,No user reviews,0,0,0
482620,True,0,No user reviews,0,0,0
482630,True,0,No user reviews,0,0,0
482640,True,0,No user reviews,0,0,0
482650,True,0,No user reviews,0,0,0
482660,True,0,No user reviews,0,0,0
482670,True,0,No user reviews,0,0,0
482680,True,0,No user reviews,0,0,0
482690,True,0,No user reviews,0,0,0
482700,True,0,No user reviews,0,0,0
482710,True,0,No user reviews,0,0,0
482720,True,0,No user reviews,0,0,0
482770,True,0,No user reviews,0,0,0
482850,True,0,No user reviews,0,0,0
482870,True,0,No user reviews,0,0,0
482890,True,3,Negative,5,22,27
482920,True,5,Mixed,8,4,12
482990,True,7,Positive,45,3,48
483280,True,0,No user reviews,0,0,0
483300,True,0,No user reviews,0,0,0
483420,True,8,Very Positive,211,25,236
483450,True,5,Mixed,15,22,37
483490,True,0,4 user reviews,4,0,4
483670,True,0,No user reviews,0,0,0
483680,True,0,1 user reviews,1,0,1
483690,True,0,No user reviews,0,0,0
483700,True,0,No user reviews,0,0,0
483710,True,0,No user reviews,0,0,0
483720,True,0,No user reviews,0,0,0
483730,True,0,No user reviews,0,0,0
483740,True,0,No user reviews,0,0,0
483770,True,5,Mixed,53,67,120
483790,True,0,4 user reviews,4,0,4
483800,True,0,No user reviews,0,0,0
483810,True,0,1 user reviews,1,0,1
483820,True,0,1 user reviews,1,0,1
483830,True,0,No user reviews,0,0,0
483840,True,8,Very Positive,185,43,228
483850,True,5,Mixed,9,4,13
483870,True,0,No user reviews,0,0,0
483880,True,0,No user reviews,0,0,0
483890,True,0,No user reviews,0,0,0
483900,True,0,No user reviews,0,0,0
483910,True,0,No user reviews,0,0,0
483920,True,0,No user reviews,0,0,0
483940,True,0,No user reviews,0,0,0
483941,True,0,1 user reviews,1,0,1
483950,True,8,Very Positive,84,11,95
483960,True,5,Mixed,92,56,148
483970,True,8,Very Positive,42,8,50
483980,True,9,Overwhelmingly Positive,942,29,971
484340,True,0,No user reviews,0,0,0
484350,True,6,Mostly Positive,104,38,142
484360,True,0,No user reviews,0,0,0
484390,True,0,8 user reviews,8,0,8
484810,True,0,1 user reviews,1,0,1
484820,True,0,No user reviews,0,0,0
484830,True,6,Mostly Positive,8,3,11
484840,True,0,8 user reviews,7,1,8
484860,True,5,Mixed,8,4,12
484870,True,8,Very Positive,357,43,400
484890,True,0,7 user reviews,5,2,7
484900,True,6,Mostly Positive,474,159,633
484910,True,0,No user reviews,0,0,0
484920,True,0,No user reviews,0,0,0
484930,True,7,Positive,12,3,15
484940,True,0,No user reviews,0,0,0
484950,True,5,Mixed,86,48,134
484970,True,0,4 user reviews,4,0,4
484990,True,0,1 user reviews,1,0,1
485000,True,5,Mixed,7,4,11
485010,True,0,No user reviews,0,0,0
485020,True,0,No user reviews,0,0,0
485030,True,6,Mostly Positive,100,28,128
485040,True,8,Very Positive,118,20,138
485050,True,0,No user reviews,0,0,0
485070,True,0,No user reviews,0,0,0
485080,True,5,Mixed,13,7,20
485090,True,0,No user reviews,0,0,0
485100,True,0,No user reviews,0,0,0
485110,True,7,Positive,11,2,13
485120,True,7,Positive,34,2,36
485130,True,0,No user reviews,0,0,0
485140,True,0,No user reviews,0,0,0
485141,True,0,1 user reviews,0,1,1
485142,True,0,No user reviews,0,0,0
485143,True,0,No user reviews,0,0,0
485144,True,0,1 user reviews,1,0,1
485145,True,0,1 user reviews,1,0,1
485146,True,0,No user reviews,0,0,0
485150,True,0,5 user reviews,2,3,5
485160,True,0,9 user reviews,7,2,9
485170,True,0,No user reviews,0,0,0
485180,True,0,No user reviews,0,0,0
485190,True,0,No user reviews,0,0,0
485200,True,0,No user reviews,0,0,0
485210,True,0,No user reviews,0,0,0
485230,True,0,2 user reviews,1,1,2
485240,True,5,Mixed,14,12,26
485250,True,0,No user reviews,0,0,0
485260,True,0,4 user reviews,3,1,4
485270,True,0,8 user reviews,1,7,8
485280,True,7,Positive,42,0,42
485290,True,0,9 user reviews,9,0,9
485300,True,0,No user reviews,0,0,0
485301,True,0,No user reviews,0,0,0
485302,True,0,No user reviews,0,0,0
485310,True,5,Mixed,11,13,24
485330,True,4,Mostly Negative,15,31,46
485340,True,6,Mostly Positive,10,3,13
485350,True,5,Mixed,56,25,81
485360,True,8,Very Positive,43,9,52
485370,True,5,Mixed,79,37,116
485380,True,8,Very Positive,986,227,1213
485390,True,0,2 user reviews,0,2,2
485430,True,0,4 user reviews,2,2,4
485440,True,4,Mostly Negative,17,30,47
485450,True,5,Mixed,71,47,118
485460,True,8,Very Positive,527,129,656
485490,True,8,Very Positive,52,12,64
485500,True,5,Mixed,9,7,16
485510,True,8,Very Positive,3890,943,4833
485560,True,0,4 user reviews,4,0,4
485570,True,0,4 user reviews,4,0,4
485590,True,0,3 user reviews,2,1,3
485600,True,7,Positive,26,5,31
485610,True,7,Positive,30,5,35
485620,True,6,Mostly Positive,22,7,29
485630,True,5,Mixed,8,10,18
485640,True,5,Mixed,11,5,16
485650,True,0,5 user reviews,2,3,5
485660,True,0,9 user reviews,3,6,9
485670,True,5,Mixed,35,47,82
485680,True,7,Positive,18,1,19
485690,True,5,Mixed,122,62,184
485710,True,0,No user reviews,0,0,0
485720,True,0,No user reviews,0,0,0
485730,True,6,Mostly Positive,43,15,58
485740,True,5,Mixed,15,8,23
485750,True,5,Mixed,8,6,14
485760,True,0,No user reviews,0,0,0
485770,True,0,No user reviews,0,0,0
485790,True,0,3 user reviews,1,2,3
485800,True,0,2 user reviews,1,1,2
485810,True,0,No user reviews,0,0,0
485820,True,5,Mixed,19,21,40
485830,True,5,Mixed,6,7,13
485840,True,0,No user reviews,0,0,0
485860,True,5,Mixed,46,37,83
485870,True,8,Very Positive,99,19,118
485880,True,7,Positive,37,2,39
485890,True,5,Mixed,192,186,378
485900,True,8,Very Positive,119,22,141
485920,True,5,Mixed,8,6,14
485950,True,4,Mostly Negative,16,46,62
485960,True,0,No user reviews,0,0,0
485970,True,7,Positive,9,1,10
485980,True,8,Very Positive,699,135,834
485990,True,0,1 user reviews,1,0,1
486000,True,0,No user reviews,0,0,0
486001,True,0,No user reviews,0,0,0
486002,True,0,1 user reviews,1,0,1
486003,True,0,3 user reviews,3,0,3
486004,True,0,2 user reviews,1,1,2
486005,True,0,2 user reviews,1,1,2
486006,True,0,5 user reviews,4,1,5
486007,True,0,1 user reviews,1,0,1
486008,True,0,No user reviews,0,0,0
486009,True,0,No user reviews,0,0,0
486010,True,0,No user reviews,0,0,0
486011,True,0,No user reviews,0,0,0
486012,True,0,No user reviews,0,0,0
486020,True,0,4 user reviews,2,2,4
486040,True,0,2 user reviews,2,0,2
486050,True,0,No user reviews,0,0,0
486100,True,0,5 user reviews,1,4,5
486110,True,0,1 user reviews,1,0,1
486120,True,0,3 user reviews,1,2,3
486130,True,0,5 user reviews,2,3,5
486140,True,0,3 user reviews,2,1,3
486150,True,4,Mostly Negative,6,10,16
486160,True,0,No user reviews,0,0,0
486170,True,0,6 user reviews,1,5,6
486180,True,0,3 user reviews,3,0,3
486190,True,0,3 user reviews,3,0,3
486200,True,0,No user reviews,0,0,0
486210,True,0,No user reviews,0,0,0
486220,True,0,2 user reviews,2,0,2
486230,True,6,Mostly Positive,7,3,10
486270,True,0,No user reviews,0,0,0
486290,True,7,Positive,21,0,21
486300,True,4,Mostly Negative,3,8,11
486310,True,8,Very Positive,1684,180,1864
486320,True,0,1 user reviews,1,0,1
486350,True,0,2 user reviews,2,0,2
486360,True,0,7 user reviews,6,1,7
486370,True,7,Positive,20,4,24
486380,True,8,Very Positive,75,2,77
486420,True,0,No user reviews,0,0,0
486430,True,0,No user reviews,0,0,0
486440,True,7,Positive,19,4,23
486460,True,0,No user reviews,0,0,0
486470,True,5,Mixed,8,8,16
486480,True,0,8 user reviews,0,8,8
486490,True,0,9 user reviews,6,3,9
486500,True,0,2 user reviews,0,2,2
486510,True,8,Very Positive,147,26,173
486520,True,0,No user reviews,0,0,0
486530,True,0,No user reviews,0,0,0
486540,True,5,Mixed,25,12,37
486550,True,0,2 user reviews,0,2,2
486560,True,0,No user reviews,0,0,0
486570,True,5,Mixed,118,59,177
486571,True,5,Mixed,9,5,14
486590,True,0,No user reviews,0,0,0
486610,True,0,No user reviews,0,0,0
486630,True,0,5 user reviews,4,1,5
486640,True,0,5 user reviews,2,3,5
486650,True,6,Mostly Positive,172,44,216
486660,True,0,4 user reviews,4,0,4
486670,True,0,4 user reviews,2,2,4
486690,True,0,7 user reviews,4,3,7
486710,True,0,No user reviews,0,0,0
486720,True,8,Very Positive,309,38,347
486760,True,0,1 user reviews,0,1,1
486770,True,0,1 user reviews,1,0,1
486780,True,8,Very Positive,349,72,421
486810,True,7,Positive,24,5,29
486830,True,0,No user reviews,0,0,0
486850,True,5,Mixed,5,5,10
486860,True,8,Very Positive,259,38,297
486880,True,4,Mostly Negative,2,8,10
486890,True,0,1 user reviews,1,0,1
486940,True,0,4 user reviews,4,0,4
486960,True,0,No user reviews,0,0,0
486970,True,5,Mixed,10,15,25
486990,True,0,5 user reviews,2,3,5
487000,True,8,Very Positive,399,87,486
487010,True,0,1 user reviews,1,0,1
487020,True,7,Positive,13,1,14
487030,True,6,Mostly Positive,10,4,14
487040,True,6,Mostly Positive,10,4,14
487050,True,0,1 user reviews,1,0,1
487120,True,5,Mixed,1749,950,2699
487130,True,0,1 user reviews,1,0,1
487150,True,0,5 user reviews,3,2,5
487160,True,7,Positive,39,3,42
487180,True,5,Mixed,11,5,16
487210,True,6,Mostly Positive,95,27,122
487220,True,6,Mostly Positive,113,44,157
487240,True,7,Positive,10,0,10
487250,True,0,7 user reviews,5,2,7
487270,True,4,Mostly Negative,2,8,10
487280,True,8,Very Positive,56,7,63
487300,True,0,2 user reviews,2,0,2
487320,True,0,6 user reviews,3,3,6
487330,True,5,Mixed,13,7,20
487350,True,7,Positive,10,0,10
487370,True,5,Mixed,12,6,18
487380,True,0,8 user reviews,6,2,8
487390,True,0,No user reviews,0,0,0
487410,True,0,No user reviews,0,0,0
487420,True,0,5 user reviews,3,2,5
487430,True,8,Very Positive,169,12,181
487460,True,0,2 user reviews,2,0,2
487470,True,0,No user reviews,0,0,0
487480,True,0,1 user reviews,1,0,1
487490,True,0,No user reviews,0,0,0
487500,True,0,No user reviews,0,0,0
487510,True,0,No user reviews,0,0,0
487520,True,0,No user reviews,0,0,0
487530,True,5,Mixed,5,7,12
487540,True,0,No user reviews,0,0,0
487570,True,0,5 user reviews,4,1,5
487580,True,0,9 user reviews,5,4,9
487590,True,0,8 user reviews,7,1,8
487600,True,0,7 user reviews,6,1,7
487610,True,0,No user reviews,0,0,0
487630,True,5,Mixed,5,7,12
487680,True,0,No user reviews,0,0,0
487700,True,8,Very Positive,184,11,195
487710,True,0,No user reviews,0,0,0
487720,True,5,Mixed,341,447,788
487730,True,0,4 user reviews,4,0,4
487740,True,0,No user reviews,0,0,0
487770,True,6,Mostly Positive,26,7,33
487780,True,0,No user reviews,0,0,0
487800,True,0,No user reviews,0,0,0
487820,True,0,No user reviews,0,0,0
487840,True,0,No user reviews,0,0,0
487860,True,0,No user reviews,0,0,0
487880,True,0,No user reviews,0,0,0
487900,True,0,No user reviews,0,0,0
487920,True,0,No user reviews,0,0,0
487990,True,0,1 user reviews,1,0,1
488000,True,0,No user reviews,0,0,0
488010,True,0,2 user reviews,1,1,2
488020,True,0,2 user reviews,1,1,2
488040,True,6,Mostly Positive,47,14,61
488050,True,0,4 user reviews,3,1,4
488060,True,8,Very Positive,137,29,166
488070,True,0,7 user reviews,3,4,7
488080,True,0,1 user reviews,1,0,1
488110,True,0,No user reviews,0,0,0
488120,True,0,No user reviews,0,0,0
488130,True,0,No user reviews,0,0,0
488140,True,0,No user reviews,0,0,0
488150,True,5,Mixed,16,8,24
488160,True,0,No user reviews,0,0,0
488190,True,0,No user reviews,0,0,0
488210,True,5,Mixed,19,17,36
488220,True,0,2 user reviews,2,0,2
488250,True,0,1 user reviews,1,0,1
488260,True,0,1 user reviews,1,0,1
488280,True,8,Very Positive,88,17,105
488300,True,6,Mostly Positive,143,38,181
488310,True,9,Overwhelmingly Positive,1142,59,1201
488320,True,0,No user reviews,0,0,0
488330,True,0,1 user reviews,0,1,1
488340,True,7,Positive,26,3,29
488350,True,4,Mostly Negative,13,34,47
488360,True,5,Mixed,10,14,24
488370,True,0,1 user reviews,1,0,1
488380,True,0,No user reviews,0,0,0
488390,True,0,3 user reviews,3,0,3
488400,True,0,No user reviews,0,0,0
488430,True,0,No user reviews,0,0,0
488440,True,0,4 user reviews,2,2,4
488460,True,0,2 user reviews,2,0,2
488470,True,7,Positive,16,1,17
488480,True,0,2 user reviews,2,0,2
488500,True,0,1 user reviews,1,0,1
488520,True,0,5 user reviews,5,0,5
488530,True,0,No user reviews,0,0,0
488550,True,8,Very Positive,283,27,310
488560,True,0,1 user reviews,1,0,1
488580,True,6,Mostly Positive,21,6,27
488590,True,7,Positive,20,2,22
488620,True,0,No user reviews,0,0,0
488630,True,0,No user reviews,0,0,0
488640,True,0,No user reviews,0,0,0
488650,True,0,2 user reviews,2,0,2
488660,True,8,Very Positive,118,26,144
488690,True,7,Positive,16,4,20
488700,True,0,1 user reviews,1,0,1
488730,True,6,Mostly Positive,72,27,99
488750,True,0,1 user reviews,1,0,1
488760,True,8,Very Positive,88,14,102
488770,True,6,Mostly Positive,126,35,161
488790,True,6,Mostly Positive,5339,1678,7017
488800,True,0,No user reviews,0,0,0
488810,True,0,7 user reviews,6,1,7
488811,True,0,6 user reviews,5,1,6
488812,True,0,5 user reviews,4,1,5
488820,True,0,3 user reviews,3,0,3
488821,True,0,2 user reviews,0,2,2
488822,True,0,2 user reviews,1,1,2
488823,True,0,2 user reviews,2,0,2
488824,True,0,2 user reviews,1,1,2
488850,True,0,No user reviews,0,0,0
488860,True,0,No user reviews,0,0,0
488890,True,7,Positive,13,3,16
488910,True,0,3 user reviews,2,1,3
488920,True,6,Mostly Positive,181,49,230
488930,True,0,No user reviews,0,0,0
488950,True,5,Mixed,55,29,84
488960,True,7,Positive,11,1,12
488970,True,0,No user reviews,0,0,0
488980,True,0,No user reviews,0,0,0
488981,True,0,No user reviews,0,0,0
488990,True,0,No user reviews,0,0,0
488991,True,0,No user reviews,0,0,0
488992,True,0,No user reviews,0,0,0
488993,True,0,No user reviews,0,0,0
488994,True,0,No user reviews,0,0,0
488995,True,0,No user reviews,0,0,0
488996,True,0,1 user reviews,1,0,1
488997,True,0,No user reviews,0,0,0
488998,True,0,No user reviews,0,0,0
488999,True,0,No user reviews,0,0,0
489000,True,0,2 user reviews,0,2,2
489010,True,0,No user reviews,0,0,0
489020,True,5,Mixed,48,39,87
489030,True,0,No user reviews,0,0,0
489040,True,0,8 user reviews,8,0,8
489050,True,0,6 user reviews,2,4,6
489070,True,4,Mostly Negative,4,8,12
489080,True,0,2 user reviews,1,1,2
489090,True,0,No user reviews,0,0,0
489100,True,0,8 user reviews,7,1,8
489110,True,7,Positive,34,0,34
489120,True,0,5 user reviews,5,0,5
489140,True,8,Very Positive,300,37,337
489160,True,0,4 user reviews,3,1,4
489170,True,5,Mixed,28,15,43
489180,True,5,Mixed,45,21,66
489200,True,0,No user reviews,0,0,0
489220,True,5,Mixed,6,4,10
489240,True,0,7 user reviews,0,7,7
489250,True,0,No user reviews,0,0,0
489260,True,5,Mixed,26,19,45
489300,True,0,No user reviews,0,0,0
489320,True,0,No user reviews,0,0,0
489330,True,0,No user reviews,0,0,0
489350,True,0,No user reviews,0,0,0
489360,True,6,Mostly Positive,281,97,378
489370,True,5,Mixed,68,40,108
489380,True,8,Very Positive,355,32,387
489400,True,0,8 user reviews,6,2,8
489410,True,0,No user reviews,0,0,0
489440,True,6,Mostly Positive,23,6,29
489450,True,0,No user reviews,0,0,0
489460,True,6,Mostly Positive,200,82,282
489470,True,4,Mostly Negative,11,20,31
489490,True,0,2 user reviews,1,1,2
489500,True,0,No user reviews,0,0,0
489520,True,8,Very Positive,433,94,527
489530,True,0,2 user reviews,1,1,2
489540,True,0,No user reviews,0,0,0
489560,True,0,1 user reviews,1,0,1
489570,True,5,Mixed,20,17,37
489580,True,6,Mostly Positive,12,5,17
489590,True,0,2 user reviews,2,0,2
489600,True,6,Mostly Positive,251,99,350
489610,True,8,Very Positive,123,18,141
489620,True,0,No user reviews,0,0,0
489630,True,8,Very Positive,1348,332,1680
489640,True,0,No user reviews,0,0,0
489650,True,0,No user reviews,0,0,0
489660,True,6,Mostly Positive,30,10,40
489670,True,0,No user reviews,0,0,0
489700,True,0,3 user reviews,1,2,3
489720,True,7,Positive,16,2,18
489730,True,0,1 user reviews,1,0,1
489740,True,0,8 user reviews,6,2,8
489750,True,0,6 user reviews,2,4,6
489760,True,7,Positive,24,2,26
489780,True,0,1 user reviews,1,0,1
489810,True,0,5 user reviews,5,0,5
489830,True,8,Very Positive,29179,1905,31084
489890,True,5,Mixed,9,6,15
489900,True,0,2 user reviews,1,1,2
489910,True,0,5 user reviews,5,0,5
489920,True,0,No user reviews,0,0,0
489930,True,8,Very Positive,48,12,60
489940,True,5,Mixed,5648,3399,9047
489950,True,0,No user reviews,0,0,0
489970,True,0,No user reviews,0,0,0
489971,True,0,No user reviews,0,0,0
489972,True,0,No user reviews,0,0,0
489973,True,0,No user reviews,0,0,0
489974,True,0,No user reviews,0,0,0
489975,True,0,No user reviews,0,0,0
489976,True,0,No user reviews,0,0,0
489977,True,0,No user reviews,0,0,0
489978,True,0,No user reviews,0,0,0
489980,True,0,No user reviews,0,0,0
489990,True,0,No user reviews,0,0,0
490040,True,0,9 user reviews,8,1,9
490060,True,5,Mixed,20,15,35
490070,True,0,No user reviews,0,0,0
490071,True,0,No user reviews,0,0,0
490072,True,0,No user reviews,0,0,0
490073,True,0,No user reviews,0,0,0
490074,True,0,No user reviews,0,0,0
490075,True,0,No user reviews,0,0,0
490076,True,0,No user reviews,0,0,0
490080,True,5,Mixed,15,21,36
490090,True,6,Mostly Positive,19,8,27
490100,True,7,Positive,30,0,30
490130,True,0,1 user reviews,1,0,1
490160,True,7,Positive,32,1,33
490170,True,7,Positive,16,1,17
490180,True,0,5 user reviews,5,0,5
490190,True,0,1 user reviews,1,0,1
490191,True,0,1 user reviews,1,0,1
490192,True,0,No user reviews,0,0,0
490220,True,8,Very Positive,86,8,94
490230,True,7,Positive,21,1,22
490240,True,0,No user reviews,0,0,0
490250,True,7,Positive,18,4,22
490260,True,7,Positive,16,0,16
490270,True,7,Positive,33,1,34
490280,True,8,Very Positive,149,24,173
490300,True,0,4 user reviews,3,1,4
490310,True,0,5 user reviews,5,0,5
490320,True,0,8 user reviews,8,0,8
490330,True,5,Mixed,17,9,26
490360,True,0,No user reviews,0,0,0
490370,True,8,Very Positive,136,24,160
490380,True,3,Negative,4,20,24
490390,True,5,Mixed,7,4,11
490410,True,0,No user reviews,0,0,0
490411,True,0,No user reviews,0,0,0
490412,True,0,No user reviews,0,0,0
490430,True,0,1 user reviews,1,0,1
490450,True,6,Mostly Positive,117,45,162
490480,True,0,No user reviews,0,0,0
490490,True,8,Very Positive,135,16,151
490500,True,0,No user reviews,0,0,0
490510,True,0,7 user reviews,7,0,7
490520,True,0,No user reviews,0,0,0
490530,True,0,No user reviews,0,0,0
490540,True,0,No user reviews,0,0,0
490550,True,0,No user reviews,0,0,0
490560,True,0,No user reviews,0,0,0
490570,True,0,No user reviews,0,0,0
490580,True,0,No user reviews,0,0,0
490590,True,0,No user reviews,0,0,0
490600,True,0,No user reviews,0,0,0
490610,True,0,No user reviews,0,0,0
490620,True,0,No user reviews,0,0,0
490630,True,0,No user reviews,0,0,0
490640,True,0,No user reviews,0,0,0
490650,True,5,Mixed,719,621,1340
490660,True,0,No user reviews,0,0,0
490670,True,0,No user reviews,0,0,0
490680,True,0,No user reviews,0,0,0
490690,True,7,Positive,11,2,13
490700,True,0,No user reviews,0,0,0
490710,True,0,No user reviews,0,0,0
490720,True,0,No user reviews,0,0,0
490730,True,0,No user reviews,0,0,0
490740,True,0,No user reviews,0,0,0
490750,True,0,No user reviews,0,0,0
490760,True,0,No user reviews,0,0,0
490770,True,0,No user reviews,0,0,0
490780,True,0,No user reviews,0,0,0
490790,True,0,No user reviews,0,0,0
490800,True,0,No user reviews,0,0,0
490810,True,0,No user reviews,0,0,0
490820,True,8,Very Positive,66,16,82
490830,True,0,No user reviews,0,0,0
490850,True,0,2 user reviews,2,0,2
490860,True,7,Positive,27,3,30
490870,True,0,7 user reviews,5,2,7
490880,True,6,Mostly Positive,12,5,17
490890,True,6,Mostly Positive,24,8,32
490910,True,0,3 user reviews,2,1,3
490920,True,8,Very Positive,488,36,524
490930,True,6,Mostly Positive,90,25,115
490950,True,8,Very Positive,56,6,62
490980,True,6,Mostly Positive,31,10,41
490990,True,4,Mostly Negative,13,28,41
491000,True,6,Mostly Positive,93,30,123
491010,True,6,Mostly Positive,12,5,17
491020,True,0,2 user reviews,1,1,2
491040,True,8,Very Positive,401,21,422
491060,True,7,Positive,13,3,16
491070,True,0,3 user reviews,2,1,3
491090,True,5,Mixed,65,45,110
491100,True,0,1 user reviews,1,0,1
491110,True,0,5 user reviews,5,0,5
491130,True,7,Positive,14,2,16
491160,True,5,Mixed,20,10,30
491180,True,0,8 user reviews,5,3,8
491210,True,7,Positive,13,3,16
491220,True,6,Mostly Positive,7,3,10
491230,True,0,No user reviews,0,0,0
491240,True,7,Positive,12,0,12
491260,True,5,Mixed,35,21,56
491280,True,4,Mostly Negative,50,85,135
491290,True,0,3 user reviews,2,1,3
491300,True,0,No user reviews,0,0,0
491310,True,0,No user reviews,0,0,0
491320,True,0,No user reviews,0,0,0
491330,True,8,Very Positive,88,5,93
491340,True,0,1 user reviews,1,0,1
491350,True,7,Positive,24,2,26
491370,True,0,No user reviews,0,0,0
491380,True,0,No user reviews,0,0,0
491390,True,0,8 user reviews,8,0,8
491400,True,0,4 user reviews,3,1,4
491401,True,0,No user reviews,0,0,0
491402,True,0,No user reviews,0,0,0
491403,True,0,1 user reviews,1,0,1
491410,True,0,1 user reviews,0,1,1
491420,True,0,4 user reviews,3,1,4
491440,True,0,9 user reviews,7,2,9
491460,True,0,No user reviews,0,0,0
491470,True,5,Mixed,22,10,32
491480,True,0,No user reviews,0,0,0
491490,True,5,Mixed,10,5,15
491491,True,0,7 user reviews,6,1,7
491492,True,0,8 user reviews,6,2,8
491493,True,0,2 user reviews,2,0,2
491494,True,6,Mostly Positive,8,3,11
491495,True,5,Mixed,15,9,24
491496,True,0,4 user reviews,1,3,4
491498,True,0,8 user reviews,7,1,8
491499,True,0,4 user reviews,2,2,4
491500,True,0,No user reviews,0,0,0
491510,True,5,Mixed,10,6,16
491520,True,4,Mostly Negative,19,30,49
491530,True,6,Mostly Positive,229,94,323
491540,True,0,No user reviews,0,0,0
491550,True,0,No user reviews,0,0,0
491560,True,5,Mixed,9,7,16
491580,True,5,Mixed,6,4,10
491600,True,0,No user reviews,0,0,0
491610,True,0,No user reviews,0,0,0
491611,True,0,No user reviews,0,0,0
491612,True,0,No user reviews,0,0,0
491613,True,0,No user reviews,0,0,0
491620,True,7,Positive,26,6,32
491640,True,0,No user reviews,0,0,0
491650,True,5,Mixed,13,12,25
491660,True,0,6 user reviews,5,1,6
491670,True,6,Mostly Positive,18,7,25
491680,True,0,No user reviews,0,0,0
491690,True,0,3 user reviews,3,0,3
491700,True,0,9 user reviews,5,4,9
491710,True,0,8 user reviews,1,7,8
491720,True,0,8 user reviews,8,0,8
491740,True,0,2 user reviews,1,1,2
491770,True,4,Mostly Negative,16,36,52
491780,True,0,1 user reviews,1,0,1
491790,True,0,1 user reviews,0,1,1
491800,True,0,6 user reviews,1,5,6
491830,True,7,Positive,10,1,11
491840,True,0,No user reviews,0,0,0
491940,True,0,No user reviews,0,0,0
491950,True,8,Very Positive,3496,324,3820
491960,True,0,No user reviews,0,0,0
491970,True,0,No user reviews,0,0,0
491980,True,0,No user reviews,0,0,0
491990,True,0,No user reviews,0,0,0
492000,True,0,No user reviews,0,0,0
492010,True,0,No user reviews,0,0,0
492020,True,0,No user reviews,0,0,0
492030,True,0,No user reviews,0,0,0
492040,True,0,No user reviews,0,0,0
492050,True,0,No user reviews,0,0,0
492060,True,0,No user reviews,0,0,0
492070,True,0,1 user reviews,1,0,1
492080,True,5,Mixed,18,8,26
492090,True,6,Mostly Positive,12,5,17
492100,True,0,No user reviews,0,0,0
492140,True,6,Mostly Positive,32,9,41
492150,True,5,Mixed,98,44,142
492160,True,0,6 user reviews,2,4,6
492170,True,0,9 user reviews,4,5,9
492180,True,7,Positive,18,2,20
492200,True,0,3 user reviews,3,0,3
492220,True,5,Mixed,47,24,71
492230,True,5,Mixed,165,89,254
492250,True,0,No user reviews,0,0,0
492260,True,0,No user reviews,0,0,0
492270,True,5,Mixed,28,18,46
492280,True,5,Mixed,8,5,13
492290,True,6,Mostly Positive,96,28,124
492320,True,0,No user reviews,0,0,0
492330,True,0,1 user reviews,0,1,1
492331,True,0,No user reviews,0,0,0
492340,True,8,Very Positive,57,10,67
492360,True,0,No user reviews,0,0,0
492370,True,6,Mostly Positive,44,14,58
492380,True,0,No user reviews,0,0,0
492390,True,0,1 user reviews,1,0,1
492391,True,0,1 user reviews,0,1,1
492392,True,0,No user reviews,0,0,0
492400,True,0,3 user reviews,2,1,3
492410,True,6,Mostly Positive,12,4,16
492430,True,5,Mixed,17,13,30
492470,True,7,Positive,12,2,14
492480,True,0,5 user reviews,5,0,5
492490,True,4,Mostly Negative,9,17,26
492500,True,6,Mostly Positive,103,30,133
492510,True,7,Positive,16,4,20
492520,True,0,No user reviews,0,0,0
492530,True,7,Positive,38,8,46
492540,True,0,No user reviews,0,0,0
492560,True,0,1 user reviews,1,0,1
492580,True,0,1 user reviews,0,1,1
492581,True,0,2 user reviews,1,1,2
492590,True,0,No user reviews,0,0,0
492600,True,0,4 user reviews,1,3,4
492610,True,0,9 user reviews,3,6,9
492620,True,0,No user reviews,0,0,0
492630,True,8,Very Positive,209,33,242
492640,True,0,3 user reviews,3,0,3
492670,True,0,5 user reviews,5,0,5
492680,True,7,Positive,29,7,36
492690,True,7,Positive,10,0,10
492700,True,0,7 user reviews,7,0,7
492710,True,6,Mostly Positive,53,18,71
492720,True,8,Very Positive,4447,674,5121
492740,True,8,Very Positive,73,16,89
492750,True,0,6 user reviews,5,1,6
492760,True,8,Very Positive,59,9,68
492800,True,0,5 user reviews,3,2,5
492810,True,0,No user reviews,0,0,0
492820,True,0,4 user reviews,4,0,4
492821,True,0,3 user reviews,3,0,3
492822,True,0,4 user reviews,4,0,4
492830,True,0,3 user reviews,1,2,3
492840,True,0,No user reviews,0,0,0
492850,True,6,Mostly Positive,7,3,10
492860,True,0,1 user reviews,1,0,1
492870,True,5,Mixed,17,9,26
492880,True,0,No user reviews,0,0,0
492890,True,0,5 user reviews,4,1,5
492891,True,0,3 user reviews,2,1,3
492892,True,0,2 user reviews,2,0,2
492940,True,0,1 user reviews,1,0,1
492941,True,0,No user reviews,0,0,0
492942,True,0,No user reviews,0,0,0
492943,True,0,1 user reviews,1,0,1
492944,True,0,No user reviews,0,0,0
492945,True,0,1 user reviews,1,0,1
492946,True,0,1 user reviews,1,0,1
492947,True,0,No user reviews,0,0,0
492948,True,0,No user reviews,0,0,0
492949,True,0,No user reviews,0,0,0
492950,True,0,1 user reviews,0,1,1
492951,True,0,No user reviews,0,0,0
492952,True,0,1 user reviews,1,0,1
492953,True,0,No user reviews,0,0,0
492954,True,0,2 user reviews,2,0,2
492955,True,0,No user reviews,0,0,0
492956,True,0,No user reviews,0,0,0
492957,True,0,No user reviews,0,0,0
492958,True,0,2 user reviews,2,0,2
492959,True,0,No user reviews,0,0,0
492960,True,0,No user reviews,0,0,0
492961,True,0,No user reviews,0,0,0
492962,True,0,1 user reviews,1,0,1
492963,True,0,2 user reviews,2,0,2
492964,True,0,No user reviews,0,0,0
492965,True,0,No user reviews,0,0,0
492966,True,0,No user reviews,0,0,0
492967,True,0,No user reviews,0,0,0
492968,True,0,5 user reviews,3,2,5
492969,True,0,No user reviews,0,0,0
492970,True,0,No user reviews,0,0,0
492971,True,4,Mostly Negative,4,8,12
492972,True,0,No user reviews,0,0,0
492973,True,0,2 user reviews,1,1,2
492974,True,0,No user reviews,0,0,0
492975,True,0,No user reviews,0,0,0
492976,True,0,No user reviews,0,0,0
492977,True,0,1 user reviews,1,0,1
492978,True,0,No user reviews,0,0,0
492979,True,0,No user reviews,0,0,0
492980,True,0,No user reviews,0,0,0
492981,True,0,5 user reviews,5,0,5
492982,True,0,No user reviews,0,0,0
492983,True,0,1 user reviews,1,0,1
492984,True,0,No user reviews,0,0,0
492985,True,0,3 user reviews,3,0,3
492986,True,0,1 user reviews,1,0,1
492987,True,0,2 user reviews,1,1,2
492988,True,0,No user reviews,0,0,0
492989,True,0,No user reviews,0,0,0
493000,True,0,6 user reviews,2,4,6
493040,True,0,5 user reviews,4,1,5
493060,True,8,Very Positive,90,15,105
493070,True,0,8 user reviews,8,0,8
493080,True,8,Very Positive,135,14,149
493090,True,0,No user reviews,0,0,0
493100,True,7,Positive,22,4,26
493110,True,0,9 user reviews,8,1,9
493130,True,0,No user reviews,0,0,0
493150,True,0,3 user reviews,3,0,3
493160,True,0,No user reviews,0,0,0
493180,True,7,Positive,18,3,21
493190,True,8,Very Positive,89,1,90
493200,True,8,Very Positive,1005,129,1134
493210,True,0,No user reviews,0,0,0
493220,True,6,Mostly Positive,28,11,39
493230,True,0,3 user reviews,3,0,3
493240,True,0,2 user reviews,2,0,2
493290,True,6,Mostly Positive,12,4,16
493300,True,0,1 user reviews,1,0,1
493301,True,0,No user reviews,0,0,0
493310,True,7,Positive,22,4,26
493320,True,6,Mostly Positive,13,4,17
493330,True,0,2 user reviews,2,0,2
493340,True,8,Very Positive,15412,1926,17338
493360,True,0,No user reviews,0,0,0
493370,True,5,Mixed,10,8,18
493380,True,0,8 user reviews,6,2,8
493400,True,0,No user reviews,0,0,0
493410,True,6,Mostly Positive,13,5,18
493420,True,0,3 user reviews,2,1,3
493430,True,0,6 user reviews,6,0,6
493440,True,0,No user reviews,0,0,0
493450,True,5,Mixed,22,13,35
493480,True,0,No user reviews,0,0,0
493490,True,5,Mixed,974,487,1461
493500,True,0,5 user reviews,0,5,5
493520,True,8,Very Positive,7274,929,8203
493530,True,6,Mostly Positive,90,36,126
493540,True,8,Very Positive,104,18,122
493580,True,5,Mixed,27,36,63
493600,True,0,No user reviews,0,0,0
493610,True,0,7 user reviews,3,4,7
493620,True,6,Mostly Positive,7,3,10
493630,True,0,No user reviews,0,0,0
493640,True,0,No user reviews,0,0,0
493650,True,4,Mostly Negative,15,38,53
493670,True,0,3 user reviews,3,0,3
493700,True,7,Positive,9,1,10
493710,True,5,Mixed,12,6,18
493720,True,6,Mostly Positive,173,48,221
493770,True,0,3 user reviews,1,2,3
493780,True,0,1 user reviews,0,1,1
493790,True,5,Mixed,14,8,22
493810,True,0,1 user reviews,1,0,1
493820,True,0,1 user reviews,0,1,1
493840,True,5,Mixed,450,313,763
493850,True,0,No user reviews,0,0,0
493860,True,0,No user reviews,0,0,0
493880,True,4,Mostly Negative,4,12,16
493900,True,8,Very Positive,3510,247,3757
493910,True,0,No user reviews,0,0,0
493920,True,0,1 user reviews,1,0,1
493940,True,0,No user reviews,0,0,0
493950,True,7,Positive,38,0,38
493970,True,0,No user reviews,0,0,0
493980,True,0,3 user reviews,3,0,3
494000,True,0,4 user reviews,2,2,4
494020,True,0,1 user reviews,0,1,1
494040,True,0,3 user reviews,2,1,3
494050,True,5,Mixed,10,10,20
494074,True,0,No user reviews,0,0,0
494080,True,0,4 user reviews,3,1,4
494090,True,0,9 user reviews,4,5,9
494100,True,7,Positive,48,1,49
494110,True,0,No user reviews,0,0,0
494120,True,0,2 user reviews,1,1,2
494140,True,0,8 user reviews,3,5,8
494150,True,9,Overwhelmingly Positive,1390,56,1446
494160,True,0,6 user reviews,5,1,6
494170,True,7,Positive,17,4,21
494200,True,0,No user reviews,0,0,0
494220,True,0,1 user reviews,1,0,1
494230,True,8,Very Positive,171,14,185
494240,True,0,No user reviews,0,0,0
494250,True,0,No user reviews,0,0,0
494260,True,0,No user reviews,0,0,0
494270,True,0,No user reviews,0,0,0
494290,True,5,Mixed,6,4,10
494300,True,0,No user reviews,0,0,0
494310,True,7,Positive,40,1,41
494320,True,5,Mixed,43,31,74
494340,True,0,No user reviews,0,0,0
494350,True,4,Mostly Negative,7,11,18
494360,True,7,Positive,43,2,45
494370,True,6,Mostly Positive,15,4,19
494380,True,0,6 user reviews,1,5,6
494390,True,0,No user reviews,0,0,0
494391,True,0,4 user reviews,4,0,4
494392,True,0,9 user reviews,5,4,9
494400,True,0,No user reviews,0,0,0
494410,True,0,No user reviews,0,0,0
494420,True,7,Positive,10,0,10
494430,True,8,Very Positive,423,71,494
494440,True,5,Mixed,15,21,36
494450,True,5,Mixed,24,26,50
494460,True,5,Mixed,17,21,38
494470,True,5,Mixed,23,24,47
494480,True,0,1 user reviews,1,0,1
494510,True,0,2 user reviews,1,1,2
494520,True,0,4 user reviews,4,0,4
494521,True,0,1 user reviews,0,1,1
494522,True,5,Mixed,7,4,11
494523,True,7,Positive,11,2,13
494524,True,0,9 user reviews,6,3,9
494525,True,0,9 user reviews,2,7,9
494526,True,0,4 user reviews,2,2,4
494527,True,0,1 user reviews,1,0,1
494529,True,4,Mostly Negative,6,18,24
494530,True,4,Mostly Negative,3,10,13
494550,True,0,1 user reviews,0,1,1
494570,True,0,1 user reviews,1,0,1
494580,True,5,Mixed,25,11,36
494600,True,7,Positive,34,6,40
494630,True,5,Mixed,69,49,118
494640,True,0,No user reviews,0,0,0
494650,True,0,1 user reviews,1,0,1
494670,True,5,Mixed,69,70,139
494680,True,7,Positive,41,3,44
494700,True,5,Mixed,11,5,16
494710,True,0,No user reviews,0,0,0
494720,True,8,Very Positive,152,9,161
494740,True,7,Positive,25,4,29
494770,True,0,No user reviews,0,0,0
494780,True,0,8 user reviews,5,3,8
494790,True,0,1 user reviews,1,0,1
494810,True,8,Very Positive,148,20,168
494820,True,0,No user reviews,0,0,0
494830,True,5,Mixed,43,23,66
494840,True,6,Mostly Positive,2556,686,3242
494850,True,0,1 user reviews,0,1,1
494880,True,0,No user reviews,0,0,0
494881,True,0,1 user reviews,1,0,1
494900,True,7,Positive,20,3,23
494950,True,0,No user reviews,0,0,0
494960,True,8,Very Positive,59,10,69
494970,True,0,4 user reviews,3,1,4
494980,True,0,7 user reviews,4,3,7
494990,True,5,Mixed,6,9,15
495010,True,0,3 user reviews,2,1,3
495030,True,0,1 user reviews,1,0,1
495050,True,8,Very Positive,303,42,345
495090,True,5,Mixed,6,6,12
495110,True,8,Very Positive,154,14,168
495140,True,5,Mixed,360,164,524
495160,True,6,Mostly Positive,103,34,137
495200,True,0,3 user reviews,1,2,3
495230,True,0,3 user reviews,2,1,3
495270,True,0,No user reviews,0,0,0
495280,True,8,Very Positive,520,48,568
495290,True,8,Very Positive,93,13,106
495300,True,5,Mixed,11,7,18
495320,True,5,Mixed,6,5,11
495330,True,0,No user reviews,0,0,0
495350,True,5,Mixed,41,26,67
495360,True,0,2 user reviews,1,1,2
495361,True,0,No user reviews,0,0,0
495370,True,7,Positive,8,2,10
495371,True,0,9 user reviews,4,5,9
495380,True,5,Mixed,10,8,18
495390,True,0,5 user reviews,3,2,5
495400,True,0,No user reviews,0,0,0
495410,True,0,7 user reviews,7,0,7
495420,True,8,Very Positive,2820,578,3398
495450,True,0,No user reviews,0,0,0
495460,True,0,No user reviews,0,0,0
495470,True,0,No user reviews,0,0,0
495480,True,5,Mixed,75,44,119
495510,True,0,3 user reviews,2,1,3
495520,True,0,1 user reviews,1,0,1
495540,True,0,1 user reviews,0,1,1
495550,True,0,2 user reviews,2,0,2
495560,True,5,Mixed,403,211,614
495570,True,6,Mostly Positive,14,6,20
495580,True,5,Mixed,48,41,89
495600,True,0,2 user reviews,2,0,2
495620,True,0,No user reviews,0,0,0
495630,True,0,3 user reviews,3,0,3
495640,True,0,No user reviews,0,0,0
495680,True,6,Mostly Positive,7,3,10
495700,True,7,Positive,30,4,34
495720,True,8,Very Positive,86,14,100
495730,True,0,1 user reviews,0,1,1
495750,True,0,No user reviews,0,0,0
495760,True,6,Mostly Positive,9,3,12
495770,True,0,1 user reviews,0,1,1
495780,True,7,Positive,36,8,44
495790,True,0,No user reviews,0,0,0
495800,True,0,No user reviews,0,0,0
495820,True,0,5 user reviews,5,0,5
495830,True,7,Positive,8,2,10
495860,True,0,No user reviews,0,0,0
495880,True,0,No user reviews,0,0,0
495890,True,9,Overwhelmingly Positive,3619,165,3784
495900,True,6,Mostly Positive,23,6,29
495910,True,6,Mostly Positive,36,14,50
495920,True,7,Positive,9,2,11
495930,True,6,Mostly Positive,19,7,26
495950,True,3,Negative,4,17,21
495951,True,0,6 user reviews,3,3,6
495953,True,0,2 user reviews,1,1,2
495954,True,0,2 user reviews,1,1,2
495960,True,5,Mixed,10,9,19
495980,True,5,Mixed,32,18,50
495990,True,7,Positive,25,6,31
496000,True,0,4 user reviews,3,1,4
496010,True,0,No user reviews,0,0,0
496030,True,0,9 user reviews,7,2,9
496040,True,6,Mostly Positive,34,9,43
496070,True,0,No user reviews,0,0,0
496080,True,0,3 user reviews,2,1,3
496090,True,0,No user reviews,0,0,0
496100,True,2,Very Negative,10,65,75
496101,True,4,Mostly Negative,10,20,30
496102,True,0,4 user reviews,4,0,4
496103,True,7,Positive,22,5,27
496104,True,0,4 user reviews,4,0,4
496120,True,7,Positive,25,2,27
496160,True,0,No user reviews,0,0,0
496180,True,0,No user reviews,0,0,0
496190,True,7,Positive,9,2,11
496200,True,0,No user reviews,0,0,0
496210,True,0,No user reviews,0,0,0
496220,True,0,No user reviews,0,0,0
496230,True,0,5 user reviews,2,3,5
496240,True,6,Mostly Positive,3310,1079,4389
496250,True,8,Very Positive,135,23,158
496260,True,8,Very Positive,62,4,66
496290,True,5,Mixed,8,4,12
496300,True,8,Very Positive,2352,354,2706
496310,True,5,Mixed,6,6,12
496320,True,0,1 user reviews,1,0,1
496330,True,0,No user reviews,0,0,0
496340,True,5,Mixed,41,25,66
496350,True,7,Positive,35,3,38
496360,True,0,3 user reviews,0,3,3
496380,True,0,4 user reviews,2,2,4
496390,True,0,7 user reviews,4,3,7
496400,True,5,Mixed,7,10,17
496410,True,0,No user reviews,0,0,0
496430,True,0,3 user reviews,3,0,3
496431,True,6,Mostly Positive,7,3,10
496432,True,7,Positive,10,2,12
496434,True,0,No user reviews,0,0,0
496435,True,0,2 user reviews,1,1,2
496436,True,0,No user reviews,0,0,0
496437,True,0,No user reviews,0,0,0
496438,True,0,3 user reviews,3,0,3
496439,True,0,2 user reviews,2,0,2
496440,True,0,2 user reviews,1,1,2
496450,True,6,Mostly Positive,33,9,42
496460,True,5,Mixed,1019,685,1704
496480,True,0,9 user reviews,6,3,9
496490,True,5,Mixed,32,28,60
496510,True,5,Mixed,15,7,22
496520,True,0,2 user reviews,0,2,2
496530,True,5,Mixed,6,6,12
496540,True,7,Positive,12,3,15
496550,True,5,Mixed,88,130,218
496570,True,0,No user reviews,0,0,0
496580,True,7,Positive,33,1,34
496590,True,0,2 user reviews,1,1,2
496610,True,0,4 user reviews,2,2,4
496620,True,8,Very Positive,358,83,441
496630,True,7,Positive,42,5,47
496640,True,4,Mostly Negative,12,19,31
496650,True,4,Mostly Negative,8,19,27
496660,True,0,9 user reviews,4,5,9
496670,True,0,6 user reviews,3,3,6
496680,True,4,Mostly Negative,26,71,97
496690,True,0,3 user reviews,1,2,3
496710,True,0,1 user reviews,0,1,1
496720,True,0,No user reviews,0,0,0
496730,True,5,Mixed,104,57,161
496740,True,6,Mostly Positive,43,12,55
496750,True,4,Mostly Negative,14,29,43
496760,True,7,Positive,43,4,47
496790,True,0,4 user reviews,3,1,4
496800,True,0,3 user reviews,3,0,3
496810,True,8,Very Positive,397,71,468
496820,True,0,4 user reviews,2,2,4
496840,True,0,No user reviews,0,0,0
496850,True,0,4 user reviews,4,0,4
496890,True,6,Mostly Positive,244,62,306
496900,True,0,No user reviews,0,0,0
496910,True,5,Mixed,7,8,15
496930,True,5,Mixed,13,7,20
496940,True,0,2 user reviews,2,0,2
496950,True,5,Mixed,6,6,12
496960,True,4,Mostly Negative,3,7,10
496970,True,0,No user reviews,0,0,0
496971,True,0,1 user reviews,1,0,1
496972,True,0,3 user reviews,3,0,3
496980,True,0,9 user reviews,5,4,9
496990,True,0,8 user reviews,5,3,8
497000,True,0,5 user reviews,2,3,5
497010,True,0,1 user reviews,1,0,1
497020,True,5,Mixed,7,4,11
497040,True,6,Mostly Positive,8,3,11
497050,True,5,Mixed,11,11,22
497060,True,0,1 user reviews,1,0,1
497080,True,7,Positive,24,5,29
497090,True,0,No user reviews,0,0,0
497100,True,5,Mixed,16,7,23
497110,True,0,No user reviews,0,0,0
497140,True,0,No user reviews,0,0,0
497150,True,6,Mostly Positive,12,5,17
497160,True,0,No user reviews,0,0,0
497170,True,0,5 user reviews,5,0,5
497180,True,8,Very Positive,1005,187,1192
497190,True,0,4 user reviews,4,0,4
497200,True,0,No user reviews,0,0,0
497230,True,0,No user reviews,0,0,0
497240,True,0,3 user reviews,1,2,3
497260,True,0,6 user reviews,4,2,6
497270,True,6,Mostly Positive,10,4,14
497280,True,0,4 user reviews,2,2,4
497290,True,0,No user reviews,0,0,0
497300,True,0,7 user reviews,3,4,7
497310,True,0,4 user reviews,3,1,4
497320,True,0,No user reviews,0,0,0
497330,True,0,No user reviews,0,0,0
497360,True,5,Mixed,11,10,21
497380,True,0,No user reviews,0,0,0
497400,True,6,Mostly Positive,109,44,153
497420,True,7,Positive,18,4,22
497430,True,0,No user reviews,0,0,0
497440,True,5,Mixed,35,45,80
497450,True,7,Positive,31,6,37
497460,True,7,Positive,41,4,45
497470,True,5,Mixed,15,17,32
497480,True,0,1 user reviews,1,0,1
497490,True,0,1 user reviews,1,0,1
497510,True,7,Positive,16,1,17
497520,True,0,1 user reviews,1,0,1
497521,True,0,1 user reviews,1,0,1
497540,True,0,No user reviews,0,0,0
497560,True,0,8 user reviews,2,6,8
497580,True,5,Mixed,14,15,29
497590,True,0,1 user reviews,1,0,1
497600,True,0,No user reviews,0,0,0
497610,True,0,1 user reviews,1,0,1
497611,True,0,4 user reviews,3,1,4
497620,True,0,5 user reviews,5,0,5
497621,True,0,1 user reviews,1,0,1
497630,True,0,1 user reviews,0,1,1
497640,True,7,Positive,14,3,17
497660,True,5,Mixed,7,4,11
497670,True,7,Positive,10,2,12
497680,True,6,Mostly Positive,22,9,31
497690,True,7,Positive,21,0,21
497700,True,7,Positive,32,8,40
497710,True,0,7 user reviews,5,2,7
497720,True,5,Mixed,11,12,23
497730,True,5,Mixed,47,21,68
497760,True,0,3 user reviews,2,1,3
497770,True,0,No user reviews,0,0,0
497780,True,8,Very Positive,164,4,168
497790,True,0,6 user reviews,6,0,6
497800,True,8,Very Positive,130,4,134
497810,True,0,No user reviews,0,0,0
497811,True,0,No user reviews,0,0,0
497812,True,0,No user reviews,0,0,0
497813,True,0,No user reviews,0,0,0
497820,True,0,6 user reviews,6,0,6
497840,True,0,No user reviews,0,0,0
497841,True,0,No user reviews,0,0,0
497842,True,0,No user reviews,0,0,0
497850,True,8,Very Positive,183,44,227
497860,True,0,1 user reviews,1,0,1
497870,True,0,No user reviews,0,0,0
497880,True,0,5 user reviews,2,3,5
497890,True,0,No user reviews,0,0,0
497900,True,0,2 user reviews,1,1,2
497910,True,0,No user reviews,0,0,0
497930,True,0,No user reviews,0,0,0
497940,True,0,3 user reviews,1,2,3
497960,True,0,No user reviews,0,0,0
497970,True,7,Positive,22,2,24
497990,True,0,5 user reviews,4,1,5
498000,True,0,7 user reviews,5,2,7
498010,True,0,No user reviews,0,0,0
498020,True,0,7 user reviews,7,0,7
498030,True,0,2 user reviews,1,1,2
498040,True,0,No user reviews,0,0,0
498050,True,0,6 user reviews,1,5,6
498100,True,0,No user reviews,0,0,0
498101,True,0,No user reviews,0,0,0
498102,True,0,No user reviews,0,0,0
498110,True,0,2 user reviews,2,0,2
498140,True,0,No user reviews,0,0,0
498141,True,0,No user reviews,0,0,0
498142,True,0,No user reviews,0,0,0
498190,True,7,Positive,32,8,40
498200,True,0,No user reviews,0,0,0
498210,True,0,7 user reviews,5,2,7
498220,True,0,1 user reviews,0,1,1
498221,True,0,No user reviews,0,0,0
498222,True,0,No user reviews,0,0,0
498223,True,0,No user reviews,0,0,0
498230,True,0,1 user reviews,1,0,1
498240,True,6,Mostly Positive,3345,942,4287
498250,True,0,No user reviews,0,0,0
498260,True,0,No user reviews,0,0,0
498270,True,0,No user reviews,0,0,0
498280,True,0,8 user reviews,2,6,8
498290,True,0,1 user reviews,1,0,1
498300,True,4,Mostly Negative,5,9,14
498310,True,7,Positive,31,1,32
498320,True,0,No user reviews,0,0,0
498330,True,8,Very Positive,374,36,410
498340,True,5,Mixed,36,21,57
498360,True,0,2 user reviews,2,0,2
498370,True,0,2 user reviews,0,2,2
498380,True,0,6 user reviews,6,0,6
498390,True,0,2 user reviews,2,0,2
498400,True,0,2 user reviews,2,0,2
498410,True,0,No user reviews,0,0,0
498420,True,0,No user reviews,0,0,0
498450,True,0,4 user reviews,2,2,4
498460,True,0,4 user reviews,0,4,4
498470,True,7,Positive,44,0,44
498500,True,5,Mixed,64,29,93
498510,True,0,No user reviews,0,0,0
498520,True,7,Positive,9,2,11
498540,True,0,5 user reviews,3,2,5
498550,True,4,Mostly Negative,4,7,11
498570,True,8,Very Positive,79,13,92
498580,True,5,Mixed,6,7,13
498590,True,0,1 user reviews,1,0,1
498600,True,0,1 user reviews,0,1,1
498620,True,0,4 user reviews,3,1,4
498630,True,0,9 user reviews,2,7,9
498640,True,0,No user reviews,0,0,0
498660,True,8,Very Positive,53,10,63
498680,True,0,4 user reviews,1,3,4
498700,True,0,6 user reviews,4,2,6
498710,True,0,No user reviews,0,0,0
498720,True,0,6 user reviews,4,2,6
498730,True,0,No user reviews,0,0,0
498740,True,0,1 user reviews,1,0,1
498760,True,0,3 user reviews,3,0,3
498770,True,0,6 user reviews,6,0,6
498790,True,0,6 user reviews,3,3,6
498830,True,0,5 user reviews,5,0,5
498840,True,0,3 user reviews,1,2,3
498850,True,0,5 user reviews,4,1,5
498870,True,6,Mostly Positive,175,63,238
498880,True,0,No user reviews,0,0,0
498890,True,0,No user reviews,0,0,0
498900,True,0,No user reviews,0,0,0
498910,True,0,No user reviews,0,0,0
498930,True,0,No user reviews,0,0,0
498940,True,0,8 user reviews,4,4,8
498950,True,0,No user reviews,0,0,0
498960,True,0,No user reviews,0,0,0
498980,True,6,Mostly Positive,15,6,21
498990,True,0,9 user reviews,8,1,9
499010,True,0,No user reviews,0,0,0
499060,True,0,No user reviews,0,0,0
499070,True,6,Mostly Positive,10,3,13
499100,True,7,Positive,27,6,33
499110,True,7,Positive,16,1,17
499120,True,7,Positive,15,2,17
499130,True,0,No user reviews,0,0,0
499140,True,7,Positive,14,0,14
499150,True,0,No user reviews,0,0,0
499160,True,0,No user reviews,0,0,0
499200,True,0,No user reviews,0,0,0
499210,True,4,Mostly Negative,5,10,15
499220,True,0,No user reviews,0,0,0
499221,True,0,No user reviews,0,0,0
499222,True,0,No user reviews,0,0,0
499223,True,0,No user reviews,0,0,0
499224,True,0,No user reviews,0,0,0
499230,True,6,Mostly Positive,35,14,49
499250,True,0,1 user reviews,1,0,1
499270,True,0,No user reviews,0,0,0
499280,True,0,No user reviews,0,0,0
499300,True,0,No user reviews,0,0,0
499320,True,0,No user reviews,0,0,0
499330,True,5,Mixed,5,5,10
499340,True,7,Positive,19,1,20
499360,True,0,No user reviews,0,0,0
499370,True,7,Positive,13,2,15
499400,True,7,Positive,35,7,42
499410,True,7,Positive,9,1,10
499420,True,0,7 user reviews,3,4,7
499440,True,9,Overwhelmingly Positive,1343,38,1381
499450,True,0,No user reviews,0,0,0
499460,True,8,Very Positive,67,16,83
499500,True,0,No user reviews,0,0,0
499510,True,0,6 user reviews,5,1,6
499520,True,8,Very Positive,2587,380,2967
499530,True,0,3 user reviews,0,3,3
499540,True,0,2 user reviews,1,1,2
499550,True,0,5 user reviews,4,1,5
499560,True,0,No user reviews,0,0,0
499570,True,0,No user reviews,0,0,0
499571,True,0,No user reviews,0,0,0
499572,True,0,No user reviews,0,0,0
499573,True,0,No user reviews,0,0,0
499580,True,0,No user reviews,0,0,0
499590,True,5,Mixed,14,8,22
499600,True,0,No user reviews,0,0,0
499610,True,5,Mixed,9,10,19
499620,True,8,Very Positive,142,35,177
499650,True,0,No user reviews,0,0,0
499660,True,8,Very Positive,851,200,1051
499670,True,0,No user reviews,0,0,0
499690,True,0,No user reviews,0,0,0
499700,True,0,No user reviews,0,0,0
499710,True,0,No user reviews,0,0,0
499720,True,0,No user reviews,0,0,0
499730,True,0,No user reviews,0,0,0
499740,True,0,No user reviews,0,0,0
499750,True,0,No user reviews,0,0,0
499760,True,6,Mostly Positive,16,5,21
499790,True,0,No user reviews,0,0,0
499800,True,0,No user reviews,0,0,0
499810,True,0,No user reviews,0,0,0
499820,True,0,No user reviews,0,0,0
499830,True,0,No user reviews,0,0,0
499840,True,0,No user reviews,0,0,0
499850,True,0,No user reviews,0,0,0
499860,True,0,No user reviews,0,0,0
499870,True,0,No user reviews,0,0,0
499880,True,0,No user reviews,0,0,0
499890,True,8,Very Positive,87,10,97
499900,True,0,3 user reviews,1,2,3
499910,True,8,Very Positive,68,4,72
499930,True,0,No user reviews,0,0,0
499940,True,5,Mixed,8,6,14
499950,True,0,No user reviews,0,0,0
500080,True,0,1 user reviews,1,0,1
500090,True,0,2 user reviews,2,0,2
500100,True,0,3 user reviews,3,0,3
500110,True,7,Positive,24,4,28
500120,True,0,3 user reviews,2,1,3
500140,True,0,5 user reviews,2,3,5
500150,True,0,No user reviews,0,0,0
500160,True,0,1 user reviews,1,0,1
500170,True,4,Mostly Negative,6,16,22
500180,True,0,2 user reviews,2,0,2
500190,True,5,Mixed,24,13,37
500202,True,0,1 user reviews,0,1,1
500203,True,0,No user reviews,0,0,0
500204,True,0,No user reviews,0,0,0
500205,True,0,No user reviews,0,0,0
500206,True,0,No user reviews,0,0,0
500208,True,7,Positive,9,1,10
500210,True,0,4 user reviews,3,1,4
500211,True,6,Mostly Positive,20,8,28
500212,True,0,5 user reviews,4,1,5
500213,True,0,No user reviews,0,0,0
500214,True,0,9 user reviews,6,3,9
500215,True,0,1 user reviews,0,1,1
500216,True,0,1 user reviews,1,0,1
500217,True,0,No user reviews,0,0,0
500218,True,6,Mostly Positive,18,6,24
500219,True,0,No user reviews,0,0,0
500220,True,0,4 user reviews,3,1,4
500230,True,5,Mixed,17,8,25
500232,True,5,Mixed,9,6,15
500233,True,7,Positive,12,2,14
500234,True,7,Positive,13,3,16
500235,True,0,7 user reviews,5,2,7
500236,True,0,3 user reviews,1,2,3
500237,True,7,Positive,10,1,11
500238,True,0,2 user reviews,2,0,2
500239,True,5,Mixed,11,7,18
500240,True,0,1 user reviews,0,1,1
500241,True,0,8 user reviews,7,1,8
500242,True,0,2 user reviews,0,2,2
500243,True,0,5 user reviews,3,2,5
500244,True,7,Positive,9,2,11
500245,True,0,1 user reviews,1,0,1
500246,True,0,1 user reviews,1,0,1
500247,True,6,Mostly Positive,10,3,13
500248,True,5,Mixed,8,4,12
500249,True,0,4 user reviews,3,1,4
500250,True,0,1 user reviews,1,0,1
500260,True,8,Very Positive,202,49,251
500270,True,5,Mixed,30,26,56
500271,True,6,Mostly Positive,22,7,29
500272,True,6,Mostly Positive,34,10,44
500280,True,0,No user reviews,0,0,0
500290,True,6,Mostly Positive,17,5,22
500310,True,0,No user reviews,0,0,0
500320,True,5,Mixed,15,9,24
500330,True,0,No user reviews,0,0,0
500340,True,7,Positive,9,1,10
500350,True,0,5 user reviews,4,1,5
500360,True,0,1 user reviews,1,0,1
500370,True,0,8 user reviews,7,1,8
500380,True,0,No user reviews,0,0,0
500390,True,0,2 user reviews,2,0,2
500391,True,0,2 user reviews,1,1,2
500392,True,0,3 user reviews,3,0,3
500400,True,0,1 user reviews,0,1,1
500410,True,0,No user reviews,0,0,0
500420,True,6,Mostly Positive,24,8,32
500440,True,0,No user reviews,0,0,0
500460,True,7,Positive,16,0,16
500461,True,0,1 user reviews,1,0,1
500470,True,7,Positive,26,2,28
500480,True,5,Mixed,21,10,31
500490,True,0,No user reviews,0,0,0
500500,True,6,Mostly Positive,128,42,170
500510,True,0,No user reviews,0,0,0
500540,True,0,6 user reviews,4,2,6
500550,True,0,7 user reviews,6,1,7
500570,True,0,2 user reviews,1,1,2
500580,True,7,Positive,46,2,48
500590,True,7,Positive,20,0,20
500620,True,7,Positive,14,3,17
500650,True,0,1 user reviews,1,0,1
500660,True,0,No user reviews,0,0,0
500670,True,8,Very Positive,122,6,128
500680,True,0,6 user reviews,6,0,6
500690,True,7,Positive,21,1,22
500710,True,5,Mixed,76,74,150
500740,True,0,No user reviews,0,0,0
500750,True,0,5 user reviews,3,2,5
500760,True,0,2 user reviews,1,1,2
500770,True,0,No user reviews,0,0,0
500790,True,0,1 user reviews,1,0,1
500800,True,0,No user reviews,0,0,0
500810,True,8,Very Positive,433,85,518
500830,True,0,No user reviews,0,0,0
500840,True,0,No user reviews,0,0,0
500850,True,0,No user reviews,0,0,0
500860,True,0,No user reviews,0,0,0
500870,True,5,Mixed,41,24,65
500880,True,0,8 user reviews,7,1,8
500890,True,0,No user reviews,0,0,0
500910,True,0,No user reviews,0,0,0
500920,True,0,2 user reviews,1,1,2
500940,True,0,8 user reviews,6,2,8
500970,True,0,No user reviews,0,0,0
500980,True,0,5 user reviews,0,5,5
501000,True,0,No user reviews,0,0,0
501020,True,5,Mixed,12,6,18
501030,True,6,Mostly Positive,13,4,17
501040,True,0,7 user reviews,7,0,7
501050,True,0,1 user reviews,1,0,1
501060,True,0,6 user reviews,0,6,6
501080,True,6,Mostly Positive,649,213,862
501090,True,6,Mostly Positive,26,7,33
501110,True,5,Mixed,46,23,69
501120,True,8,Very Positive,146,19,165
501130,True,0,No user reviews,0,0,0
501150,True,0,No user reviews,0,0,0
501151,True,0,No user reviews,0,0,0
501170,True,0,2 user reviews,2,0,2
501171,True,0,1 user reviews,1,0,1
501172,True,0,No user reviews,0,0,0
501180,True,5,Mixed,8,4,12
501190,True,5,Mixed,48,24,72
501210,True,8,Very Positive,144,25,169
501220,True,5,Mixed,17,12,29
501230,True,0,No user reviews,0,0,0
501240,True,0,No user reviews,0,0,0
501250,True,0,No user reviews,0,0,0
501260,True,0,2 user reviews,2,0,2
501270,True,0,4 user reviews,3,1,4
501280,True,0,No user reviews,0,0,0
501290,True,0,No user reviews,0,0,0
501300,True,8,Very Positive,6443,421,6864
501310,True,0,4 user reviews,3,1,4
501320,True,5,Mixed,200,94,294
501350,True,6,Mostly Positive,51,17,68
501360,True,0,No user reviews,0,0,0
501380,True,0,No user reviews,0,0,0
501410,True,0,5 user reviews,4,1,5
501420,True,0,No user reviews,0,0,0
501430,True,6,Mostly Positive,13,4,17
501440,True,0,9 user reviews,3,6,9
501450,True,0,6 user reviews,5,1,6
501460,True,0,1 user reviews,1,0,1
501470,True,0,No user reviews,0,0,0
501480,True,6,Mostly Positive,10,3,13
501490,True,0,No user reviews,0,0,0
501500,True,0,4 user reviews,4,0,4
501510,True,0,1 user reviews,1,0,1
501530,True,7,Positive,17,2,19
501570,True,0,2 user reviews,2,0,2
501580,True,0,3 user reviews,3,0,3
501590,True,8,Very Positive,1174,235,1409
501600,True,0,1 user reviews,0,1,1
501610,True,0,4 user reviews,3,1,4
501620,True,5,Mixed,7,5,12
501630,True,6,Mostly Positive,16,5,21
501640,True,0,6 user reviews,4,2,6
501670,True,0,5 user reviews,5,0,5
501671,True,0,4 user reviews,4,0,4
501680,True,0,No user reviews,0,0,0
501730,True,0,No user reviews,0,0,0
501740,True,0,9 user reviews,2,7,9
501750,True,0,6 user reviews,6,0,6
501760,True,5,Mixed,32,32,64
501790,True,8,Very Positive,223,27,250
501820,True,0,No user reviews,0,0,0
501840,True,6,Mostly Positive,42,13,55
501850,True,0,No user reviews,0,0,0
501860,True,5,Mixed,36,27,63
501870,True,0,No user reviews,0,0,0
501890,True,0,No user reviews,0,0,0
501891,True,0,No user reviews,0,0,0
501930,True,6,Mostly Positive,16,5,21
501940,True,5,Mixed,11,9,20
501950,True,5,Mixed,18,8,26
501970,True,7,Positive,33,5,38
501990,True,8,Very Positive,58,11,69
502010,True,7,Positive,16,1,17
502050,True,0,No user reviews,0,0,0
502070,True,0,No user reviews,0,0,0
502090,True,4,Mostly Negative,3,8,11
502100,True,5,Mixed,11,5,16
502120,True,7,Positive,20,3,23
502130,True,0,No user reviews,0,0,0
502140,True,5,Mixed,21,26,47
502150,True,7,Positive,9,1,10
502200,True,0,2 user reviews,1,1,2
502210,True,7,Positive,27,4,31
502230,True,8,Very Positive,74,6,80
502240,True,5,Mixed,18,23,41
502250,True,0,No user reviews,0,0,0
502260,True,0,No user reviews,0,0,0
502280,True,6,Mostly Positive,631,181,812
502300,True,5,Mixed,9,7,16
502310,True,0,No user reviews,0,0,0
502320,True,5,Mixed,19,9,28
502340,True,6,Mostly Positive,9,3,12
502350,True,0,No user reviews,0,0,0
502360,True,0,No user reviews,0,0,0
502361,True,0,No user reviews,0,0,0
502370,True,8,Very Positive,512,81,593
502380,True,0,4 user reviews,1,3,4
502390,True,0,No user reviews,0,0,0
502400,True,5,Mixed,11,6,17
502410,True,5,Mixed,5,6,11
502420,True,5,Mixed,13,16,29
502430,True,0,9 user reviews,5,4,9
502440,True,0,6 user reviews,2,4,6
502450,True,0,4 user reviews,0,4,4
502460,True,0,3 user reviews,3,0,3
502480,True,0,5 user reviews,3,2,5
502490,True,7,Positive,18,4,22
502500,True,8,Very Positive,5279,948,6227
502510,True,0,No user reviews,0,0,0
502520,True,8,Very Positive,2746,382,3128
502530,True,0,9 user reviews,7,2,9
502540,True,7,Positive,13,2,15
502550,True,5,Mixed,7,4,11
502560,True,0,2 user reviews,2,0,2
502570,True,7,Positive,44,2,46
502580,True,0,No user reviews,0,0,0
502590,True,0,No user reviews,0,0,0
502600,True,0,7 user reviews,4,3,7
502610,True,0,No user reviews,0,0,0
502620,True,0,No user reviews,0,0,0
502630,True,0,No user reviews,0,0,0
502650,True,5,Mixed,13,7,20
502700,True,0,8 user reviews,7,1,8
502710,True,5,Mixed,87,38,125
502720,True,6,Mostly Positive,28,12,40
502730,True,0,No user reviews,0,0,0
502740,True,8,Very Positive,128,14,142
502750,True,8,Very Positive,142,9,151
502770,True,6,Mostly Positive,204,58,262
502780,True,0,6 user reviews,5,1,6
502790,True,5,Mixed,6,5,11
502800,True,9,Overwhelmingly Positive,938,48,986
502810,True,0,4 user reviews,0,4,4
502820,True,6,Mostly Positive,420,173,593
502830,True,0,1 user reviews,1,0,1
502840,True,0,No user reviews,0,0,0
502841,True,0,1 user reviews,1,0,1
502842,True,0,1 user reviews,1,0,1
502860,True,0,3 user reviews,3,0,3
502870,True,7,Positive,37,6,43
502880,True,4,Mostly Negative,4,16,20
502890,True,7,Positive,15,2,17
502891,True,0,8 user reviews,8,0,8
502900,True,0,No user reviews,0,0,0
502910,True,0,6 user reviews,1,5,6
502920,True,0,6 user reviews,6,0,6
502930,True,0,No user reviews,0,0,0
502940,True,8,Very Positive,271,36,307
502960,True,0,No user reviews,0,0,0
502970,True,0,7 user reviews,6,1,7
502980,True,0,1 user reviews,1,0,1
502990,True,0,1 user reviews,0,1,1
503010,True,5,Mixed,8,9,17
503020,True,0,1 user reviews,1,0,1
503040,True,0,No user reviews,0,0,0
503050,True,0,1 user reviews,1,0,1
503060,True,0,7 user reviews,7,0,7
503070,True,0,9 user reviews,8,1,9
503080,True,0,4 user reviews,3,1,4
503090,True,0,4 user reviews,1,3,4
503100,True,6,Mostly Positive,35,15,50
503110,True,0,3 user reviews,3,0,3
503130,True,0,6 user reviews,5,1,6
503140,True,0,6 user reviews,6,0,6
503150,True,7,Positive,12,1,13
503160,True,0,No user reviews,0,0,0
503170,True,0,No user reviews,0,0,0
503180,True,8,Very Positive,90,19,109
503210,True,6,Mostly Positive,43,16,59
503220,True,4,Mostly Negative,4,9,13
503240,True,5,Mixed,17,20,37
503250,True,0,No user reviews,0,0,0
503260,True,0,No user reviews,0,0,0
503280,True,7,Positive,23,4,27
503290,True,0,6 user reviews,4,2,6
503300,True,6,Mostly Positive,561,144,705
503310,True,0,No user reviews,0,0,0
503320,True,0,6 user reviews,4,2,6
503340,True,7,Positive,34,6,40
503350,True,6,Mostly Positive,594,154,748
503370,True,5,Mixed,48,55,103
503380,True,0,2 user reviews,1,1,2
503390,True,5,Mixed,7,7,14
503400,True,8,Very Positive,298,15,313
503410,True,5,Mixed,8,4,12
503420,True,0,No user reviews,0,0,0
503430,True,0,2 user reviews,2,0,2
503440,True,0,No user reviews,0,0,0
503450,True,0,3 user reviews,1,2,3
503460,True,5,Mixed,11,8,19
503470,True,0,No user reviews,0,0,0
503480,True,5,Mixed,16,11,27
503490,True,0,No user reviews,0,0,0
503500,True,0,No user reviews,0,0,0
503550,True,6,Mostly Positive,35,11,46
503560,True,8,Very Positive,2979,458,3437
503580,True,8,Very Positive,583,113,696
503620,True,6,Mostly Positive,410,129,539
503630,True,0,5 user reviews,5,0,5
503650,True,7,Positive,9,1,10
503660,True,0,No user reviews,0,0,0
503670,True,0,No user reviews,0,0,0
503680,True,0,4 user reviews,4,0,4
503690,True,0,4 user reviews,3,1,4
503700,True,0,2 user reviews,0,2,2
503710,True,5,Mixed,6,4,10
503720,True,0,9 user reviews,6,3,9
503730,True,0,3 user reviews,1,2,3
503740,True,0,No user reviews,0,0,0
503750,True,0,1 user reviews,1,0,1
503760,True,0,No user reviews,0,0,0
503770,True,8,Very Positive,265,42,307
503780,True,0,5 user reviews,2,3,5
503790,True,0,No user reviews,0,0,0
503800,True,0,No user reviews,0,0,0
503810,True,0,No user reviews,0,0,0
503820,True,6,Mostly Positive,8,3,11
503830,True,5,Mixed,8,12,20
503860,True,7,Positive,23,0,23
503880,True,0,No user reviews,0,0,0
503890,True,0,No user reviews,0,0,0
503900,True,0,4 user reviews,1,3,4
503920,True,0,No user reviews,0,0,0
503930,True,0,No user reviews,0,0,0
503940,True,6,Mostly Positive,1813,470,2283
503950,True,6,Mostly Positive,13,4,17
503960,True,6,Mostly Positive,14,5,19
503980,True,0,6 user reviews,5,1,6
503990,True,0,No user reviews,0,0,0
504000,True,7,Positive,37,5,42
504010,True,5,Mixed,10,5,15
504030,True,0,No user reviews,0,0,0
504050,True,5,Mixed,519,241,760
504070,True,0,No user reviews,0,0,0
504090,True,7,Positive,14,0,14
504100,True,5,Mixed,8,8,16
504110,True,5,Mixed,8,5,13
504120,True,0,No user reviews,0,0,0
504130,True,6,Mostly Positive,241,74,315
504170,True,0,No user reviews,0,0,0
504200,True,0,No user reviews,0,0,0
504210,True,9,Overwhelmingly Positive,1251,61,1312
504220,True,0,No user reviews,0,0,0
504230,True,9,Overwhelmingly Positive,11039,273,11312
504240,True,0,1 user reviews,0,1,1
504260,True,0,5 user reviews,3,2,5
504270,True,0,No user reviews,0,0,0
504280,True,5,Mixed,7,6,13
504300,True,0,No user reviews,0,0,0
504310,True,5,Mixed,22,15,37
504350,True,0,No user reviews,0,0,0
504370,True,8,Very Positive,8524,1202,9726
504380,True,0,7 user reviews,6,1,7
504390,True,8,Very Positive,94,13,107
504400,True,6,Mostly Positive,40,11,51
504410,True,5,Mixed,15,9,24
504420,True,6,Mostly Positive,13,4,17
504430,True,6,Mostly Positive,11,3,14
504450,True,0,8 user reviews,3,5,8
504460,True,0,9 user reviews,8,1,9
504470,True,4,Mostly Negative,4,7,11
504490,True,0,7 user reviews,3,4,7
504500,True,0,4 user reviews,3,1,4
504510,True,0,No user reviews,0,0,0
504520,True,0,No user reviews,0,0,0
504530,True,0,No user reviews,0,0,0
504540,True,0,No user reviews,0,0,0
504550,True,0,5 user reviews,5,0,5
504560,True,5,Mixed,15,7,22
504570,True,0,1 user reviews,1,0,1
504580,True,0,4 user reviews,4,0,4
504590,True,0,No user reviews,0,0,0
504610,True,0,No user reviews,0,0,0
504620,True,0,3 user reviews,3,0,3
504630,True,0,2 user reviews,1,1,2
504640,True,0,4 user reviews,4,0,4
504650,True,6,Mostly Positive,50,16,66
504660,True,0,2 user reviews,1,1,2
504670,True,0,6 user reviews,4,2,6
504680,True,8,Very Positive,181,7,188
504690,True,7,Positive,18,3,21
504700,True,7,Positive,17,1,18
504710,True,5,Mixed,25,31,56
504720,True,5,Mixed,30,36,66
504740,True,0,No user reviews,0,0,0
504750,True,0,7 user reviews,5,2,7
504770,True,8,Very Positive,435,35,470
504790,True,7,Positive,25,1,26
504800,True,7,Positive,39,8,47
504810,True,5,Mixed,10,6,16
504840,True,7,Positive,10,0,10
504850,True,0,6 user reviews,5,1,6
504870,True,0,No user reviews,0,0,0
504880,True,6,Mostly Positive,15,4,19
504920,True,6,Mostly Positive,39,12,51
504930,True,0,1 user reviews,1,0,1
504950,True,0,No user reviews,0,0,0
504970,True,0,No user reviews,0,0,0
504980,True,5,Mixed,7,4,11
504990,True,0,No user reviews,0,0,0
505015,True,0,1 user reviews,1,0,1
505020,True,0,6 user reviews,4,2,6
505040,True,8,Very Positive,885,49,934
505060,True,8,Very Positive,192,13,205
505070,True,7,Positive,19,3,22
505080,True,5,Mixed,24,13,37
505090,True,5,Mixed,18,20,38
505100,True,0,2 user reviews,2,0,2
505110,True,0,4 user reviews,4,0,4
505120,True,0,9 user reviews,5,4,9
505130,True,0,No user reviews,0,0,0
505140,True,0,6 user reviews,3,3,6
505150,True,7,Positive,25,1,26
505170,True,6,Mostly Positive,629,193,822
505210,True,5,Mixed,49,22,71
505220,True,0,7 user reviews,4,3,7
505230,True,8,Very Positive,1611,133,1744
505240,True,0,No user reviews,0,0,0
505260,True,0,No user reviews,0,0,0
505270,True,0,4 user reviews,3,1,4
505290,True,0,2 user reviews,2,0,2
505330,True,6,Mostly Positive,44,17,61
505340,True,0,1 user reviews,1,0,1
505350,True,0,No user reviews,0,0,0
505380,True,0,No user reviews,0,0,0
505390,True,0,No user reviews,0,0,0
505400,True,0,8 user reviews,8,0,8
505410,True,0,1 user reviews,0,1,1
505420,True,0,7 user reviews,1,6,7
505430,True,0,No user reviews,0,0,0
505450,True,0,No user reviews,0,0,0
505451,True,0,No user reviews,0,0,0
505460,True,6,Mostly Positive,5328,1411,6739
505470,True,0,No user reviews,0,0,0
505480,True,0,No user reviews,0,0,0
505490,True,0,No user reviews,0,0,0
505500,True,0,No user reviews,0,0,0
505510,True,0,No user reviews,0,0,0
505520,True,0,No user reviews,0,0,0
505530,True,0,No user reviews,0,0,0
505540,True,6,Mostly Positive,70,26,96
505550,True,5,Mixed,6,5,11
505560,True,0,4 user reviews,3,1,4
505580,True,0,No user reviews,0,0,0
505590,True,0,No user reviews,0,0,0
505600,True,0,No user reviews,0,0,0
505610,True,0,4 user reviews,2,2,4
505620,True,0,No user reviews,0,0,0
505630,True,8,Very Positive,257,39,296
505640,True,8,Very Positive,256,53,309
505650,True,0,No user reviews,0,0,0
505660,True,7,Positive,14,0,14
505680,True,6,Mostly Positive,10,3,13
505700,True,8,Very Positive,138,5,143
505720,True,0,No user reviews,0,0,0
505730,True,6,Mostly Positive,132,48,180
505740,True,6,Mostly Positive,77,29,106
505750,True,7,Positive,21,4,25
505780,True,0,No user reviews,0,0,0
505790,True,0,No user reviews,0,0,0
505890,True,0,No user reviews,0,0,0
506030,True,0,5 user reviews,1,4,5
506040,True,6,Mostly Positive,13,4,17
506080,True,5,Mixed,6,4,10
506090,True,0,4 user reviews,2,2,4
506100,True,0,8 user reviews,4,4,8
506110,True,0,No user reviews,0,0,0
506120,True,0,No user reviews,0,0,0
506140,True,6,Mostly Positive,23,7,30
506150,True,7,Positive,10,1,11
506160,True,0,6 user reviews,3,3,6
506180,True,0,No user reviews,0,0,0
506210,True,0,No user reviews,0,0,0
506220,True,0,1 user reviews,1,0,1
506230,True,0,1 user reviews,1,0,1
506240,True,0,4 user reviews,3,1,4
506250,True,0,No user reviews,0,0,0
506260,True,5,Mixed,12,8,20
506270,True,0,No user reviews,0,0,0
506280,True,0,No user reviews,0,0,0
506300,True,0,4 user reviews,4,0,4
506310,True,0,No user reviews,0,0,0
506330,True,0,No user reviews,0,0,0
506340,True,0,No user reviews,0,0,0
506350,True,0,1 user reviews,1,0,1
506360,True,0,3 user reviews,2,1,3
506370,True,0,No user reviews,0,0,0
506380,True,0,No user reviews,0,0,0
506390,True,0,No user reviews,0,0,0
506400,True,0,No user reviews,0,0,0
506410,True,0,No user reviews,0,0,0
506440,True,0,1 user reviews,1,0,1
506450,True,0,No user reviews,0,0,0
506460,True,0,6 user reviews,6,0,6
506470,True,0,4 user reviews,3,1,4
506480,True,0,No user reviews,0,0,0
506500,True,6,Mostly Positive,252,94,346
506510,True,8,Very Positive,107,7,114
506540,True,4,Mostly Negative,5,17,22
506550,True,6,Mostly Positive,14,4,18
506570,True,0,5 user reviews,2,3,5
506590,True,6,Mostly Positive,17,7,24
506600,True,0,No user reviews,0,0,0
506610,True,8,Very Positive,3773,330,4103
506620,True,0,No user reviews,0,0,0
506640,True,0,No user reviews,0,0,0
506660,True,0,2 user reviews,0,2,2
506670,True,7,Positive,14,2,16
506700,True,0,5 user reviews,5,0,5
506720,True,0,No user reviews,0,0,0
506730,True,5,Mixed,142,90,232
506750,True,5,Mixed,6,4,10
506760,True,5,Mixed,7,9,16
506770,True,0,5 user reviews,4,1,5
506780,True,7,Positive,14,0,14
506800,True,5,Mixed,28,41,69
506801,True,0,No user reviews,0,0,0
506802,True,0,No user reviews,0,0,0
506803,True,0,No user reviews,0,0,0
506804,True,0,No user reviews,0,0,0
506830,True,0,5 user reviews,4,1,5
506840,True,0,7 user reviews,3,4,7
506850,True,0,2 user reviews,2,0,2
506860,True,0,No user reviews,0,0,0
506870,True,8,Very Positive,385,39,424
506900,True,6,Mostly Positive,198,74,272
506910,True,0,4 user reviews,4,0,4
506920,True,0,1 user reviews,1,0,1
506930,True,0,9 user reviews,4,5,9
506940,True,0,No user reviews,0,0,0
506960,True,0,5 user reviews,2,3,5
506970,True,5,Mixed,797,527,1324
506971,True,8,Very Positive,801,127,928
506980,True,0,No user reviews,0,0,0
507010,True,6,Mostly Positive,1099,373,1472
507020,True,0,2 user reviews,2,0,2
507030,True,7,Positive,8,2,10
507040,True,0,No user reviews,0,0,0
507050,True,0,9 user reviews,2,7,9
507060,True,0,9 user reviews,8,1,9
507070,True,7,Positive,29,1,30
507080,True,7,Positive,16,2,18
507120,True,5,Mixed,19,9,28
507130,True,0,No user reviews,0,0,0
507140,True,0,5 user reviews,4,1,5
507180,True,0,No user reviews,0,0,0
507210,True,0,3 user reviews,1,2,3
507270,True,0,2 user reviews,1,1,2
507300,True,0,3 user reviews,1,2,3
507310,True,0,No user reviews,0,0,0
507340,True,0,4 user reviews,2,2,4
507360,True,0,4 user reviews,1,3,4
507380,True,5,Mixed,6,6,12
507390,True,5,Mixed,67,63,130
507400,True,0,6 user reviews,5,1,6
507430,True,0,No user reviews,0,0,0
507440,True,0,5 user reviews,1,4,5
507450,True,0,No user reviews,0,0,0
507470,True,0,No user reviews,0,0,0
507480,True,0,No user reviews,0,0,0
507490,True,8,Very Positive,1075,229,1304
507510,True,5,Mixed,57,64,121
507520,True,8,Very Positive,43,10,53
507530,True,0,No user reviews,0,0,0
507540,True,0,No user reviews,0,0,0
507570,True,0,No user reviews,0,0,0
507580,True,0,No user reviews,0,0,0
507590,True,0,No user reviews,0,0,0
507591,True,0,No user reviews,0,0,0
507592,True,0,No user reviews,0,0,0
507593,True,0,No user reviews,0,0,0
507594,True,0,No user reviews,0,0,0
507620,True,0,No user reviews,0,0,0
507630,True,0,No user reviews,0,0,0
507640,True,0,No user reviews,0,0,0
507641,True,0,No user reviews,0,0,0
507642,True,0,1 user reviews,0,1,1
507643,True,0,No user reviews,0,0,0
507670,True,0,No user reviews,0,0,0
507680,True,0,No user reviews,0,0,0
507690,True,0,No user reviews,0,0,0
507691,True,0,No user reviews,0,0,0
507692,True,0,No user reviews,0,0,0
507720,True,0,No user reviews,0,0,0
507730,True,0,No user reviews,0,0,0
507740,True,0,4 user reviews,4,0,4
507750,True,0,No user reviews,0,0,0
507760,True,0,No user reviews,0,0,0
507770,True,0,No user reviews,0,0,0
507820,True,0,No user reviews,0,0,0
507830,True,0,No user reviews,0,0,0
507840,True,0,No user reviews,0,0,0
507850,True,0,No user reviews,0,0,0
507860,True,0,No user reviews,0,0,0
507870,True,0,No user reviews,0,0,0
507880,True,0,No user reviews,0,0,0
507881,True,0,No user reviews,0,0,0
507882,True,0,No user reviews,0,0,0
507890,True,0,No user reviews,0,0,0
507891,True,0,No user reviews,0,0,0
507892,True,0,No user reviews,0,0,0
507900,True,0,No user reviews,0,0,0
507901,True,0,No user reviews,0,0,0
507910,True,0,No user reviews,0,0,0
507911,True,0,No user reviews,0,0,0
507920,True,0,No user reviews,0,0,0
507921,True,0,No user reviews,0,0,0
507930,True,0,1 user reviews,0,1,1
507931,True,0,No user reviews,0,0,0
507980,True,0,No user reviews,0,0,0
507990,True,0,No user reviews,0,0,0
508000,True,0,1 user reviews,1,0,1
508010,True,0,No user reviews,0,0,0
508020,True,0,No user reviews,0,0,0
508030,True,0,No user reviews,0,0,0
508080,True,0,No user reviews,0,0,0
508090,True,0,No user reviews,0,0,0
508100,True,0,No user reviews,0,0,0
508101,True,0,No user reviews,0,0,0
508110,True,0,1 user reviews,0,1,1
508120,True,0,No user reviews,0,0,0
508130,True,0,No user reviews,0,0,0
508131,True,0,No user reviews,0,0,0
508132,True,0,No user reviews,0,0,0
508140,True,5,Mixed,127,65,192
508150,True,5,Mixed,30,14,44
508160,True,0,2 user reviews,2,0,2
508161,True,7,Positive,22,0,22
508162,True,0,5 user reviews,5,0,5
508163,True,0,5 user reviews,5,0,5
508165,True,0,2 user reviews,2,0,2
508170,True,6,Mostly Positive,77,20,97
508180,True,6,Mostly Positive,31,13,44
508190,True,5,Mixed,178,95,273
508200,True,0,8 user reviews,3,5,8
508230,True,5,Mixed,24,12,36
508250,True,0,No user reviews,0,0,0
508260,True,7,Positive,36,8,44
508270,True,0,No user reviews,0,0,0
508271,True,0,No user reviews,0,0,0
508280,True,0,3 user reviews,3,0,3
508290,True,5,Mixed,20,26,46
508300,True,5,Mixed,32,27,59
508320,True,0,No user reviews,0,0,0
508330,True,0,1 user reviews,1,0,1
508340,True,5,Mixed,7,5,12
508350,True,0,9 user reviews,6,3,9
508390,True,0,9 user reviews,8,1,9
508400,True,5,Mixed,25,36,61
508401,True,5,Mixed,25,23,48
508402,True,6,Mostly Positive,49,15,64
508403,True,7,Positive,40,8,48
508404,True,0,No user reviews,0,0,0
508405,True,0,1 user reviews,1,0,1
508410,True,5,Mixed,15,8,23
508420,True,0,No user reviews,0,0,0
508430,True,0,No user reviews,0,0,0
508440,True,9,Overwhelmingly Positive,23177,494,23671
508450,True,5,Mixed,104,101,205
508460,True,0,No user reviews,0,0,0
508470,True,0,No user reviews,0,0,0
508490,True,0,No user reviews,0,0,0
508510,True,0,No user reviews,0,0,0
508520,True,0,4 user reviews,4,0,4
508530,True,7,Positive,25,0,25
508540,True,0,5 user reviews,2,3,5
508550,True,6,Mostly Positive,325,107,432
508560,True,0,2 user reviews,1,1,2
508561,True,0,No user reviews,0,0,0
508580,True,6,Mostly Positive,16,5,21
508590,True,0,6 user reviews,0,6,6
508600,True,6,Mostly Positive,192,56,248
508610,True,0,3 user reviews,2,1,3
508620,True,0,No user reviews,0,0,0
508630,True,0,1 user reviews,0,1,1
508640,True,0,No user reviews,0,0,0
508650,True,0,6 user reviews,4,2,6
508660,True,3,Negative,0,11,11
508680,True,0,2 user reviews,1,1,2
508690,True,0,8 user reviews,3,5,8
508710,True,6,Mostly Positive,12,5,17
508730,True,0,7 user reviews,4,3,7
508740,True,5,Mixed,29,23,52
508760,True,0,7 user reviews,5,2,7
508770,True,0,1 user reviews,0,1,1
508771,True,0,2 user reviews,1,1,2
508772,True,0,1 user reviews,1,0,1
508780,True,0,No user reviews,0,0,0
508790,True,8,Very Positive,59,3,62
508800,True,0,No user reviews,0,0,0
508810,True,0,No user reviews,0,0,0
508820,True,5,Mixed,9,4,13
508830,True,0,1 user reviews,1,0,1
508840,True,6,Mostly Positive,49,15,64
508860,True,0,No user reviews,0,0,0
508890,True,0,1 user reviews,1,0,1
508900,True,9,Overwhelmingly Positive,727,24,751
508910,True,0,6 user reviews,5,1,6
508920,True,0,No user reviews,0,0,0
508930,True,0,6 user reviews,2,4,6
508940,True,0,6 user reviews,5,1,6
508950,True,0,4 user reviews,3,1,4
508980,True,8,Very Positive,218,37,255
508990,True,8,Very Positive,78,4,82
509020,True,0,1 user reviews,1,0,1
509030,True,0,1 user reviews,1,0,1
509031,True,0,1 user reviews,1,0,1
509032,True,0,No user reviews,0,0,0
509050,True,0,1 user reviews,1,0,1
509060,True,0,6 user reviews,6,0,6
509061,True,0,No user reviews,0,0,0
509070,True,5,Mixed,11,6,17
509090,True,0,No user reviews,0,0,0
509100,True,0,No user reviews,0,0,0
509110,True,8,Very Positive,54,7,61
509120,True,0,2 user reviews,1,1,2
509130,True,7,Positive,14,3,17
509140,True,0,No user reviews,0,0,0
509160,True,7,Positive,10,1,11
509170,True,0,2 user reviews,2,0,2
509190,True,0,3 user reviews,2,1,3
509200,True,0,No user reviews,0,0,0
509210,True,5,Mixed,14,8,22
509220,True,8,Very Positive,585,58,643
509230,True,0,6 user reviews,4,2,6
509250,True,8,Very Positive,432,61,493
509260,True,5,Mixed,5,6,11
509290,True,6,Mostly Positive,17,7,24
509300,True,0,No user reviews,0,0,0
509310,True,0,2 user reviews,2,0,2
509340,True,0,3 user reviews,3,0,3
509350,True,8,Very Positive,49,2,51
509360,True,5,Mixed,25,11,36
509380,True,0,No user reviews,0,0,0
509390,True,0,8 user reviews,4,4,8
509400,True,0,5 user reviews,4,1,5
509420,True,0,6 user reviews,1,5,6
509430,True,7,Positive,13,0,13
509440,True,3,Negative,2,10,12
509450,True,0,6 user reviews,3,3,6
509500,True,0,2 user reviews,2,0,2
509510,True,0,No user reviews,0,0,0
509520,True,0,1 user reviews,1,0,1
509521,True,0,No user reviews,0,0,0
509522,True,0,1 user reviews,1,0,1
509530,True,0,No user reviews,0,0,0
509540,True,6,Mostly Positive,50,15,65
509560,True,0,No user reviews,0,0,0
509570,True,8,Very Positive,120,12,132
509580,True,6,Mostly Positive,390,141,531
509590,True,0,3 user reviews,3,0,3
509600,True,5,Mixed,19,9,28
509610,True,4,Mostly Negative,4,11,15
509620,True,0,3 user reviews,3,0,3
509630,True,0,3 user reviews,2,1,3
509631,True,0,3 user reviews,1,2,3
509632,True,0,3 user reviews,2,1,3
509633,True,0,No user reviews,0,0,0
509634,True,0,No user reviews,0,0,0
509635,True,0,No user reviews,0,0,0
509636,True,0,No user reviews,0,0,0
509637,True,0,7 user reviews,7,0,7
509638,True,0,No user reviews,0,0,0
509639,True,0,No user reviews,0,0,0
509640,True,0,No user reviews,0,0,0
509641,True,0,No user reviews,0,0,0
509642,True,0,5 user reviews,5,0,5
509643,True,0,1 user reviews,1,0,1
509644,True,0,No user reviews,0,0,0
509645,True,0,2 user reviews,1,1,2
509646,True,0,No user reviews,0,0,0
509647,True,0,6 user reviews,4,2,6
509648,True,0,1 user reviews,1,0,1
509649,True,0,4 user reviews,4,0,4
509650,True,0,No user reviews,0,0,0
509651,True,0,No user reviews,0,0,0
509652,True,0,No user reviews,0,0,0
509653,True,0,No user reviews,0,0,0
509654,True,0,3 user reviews,3,0,3
509655,True,0,No user reviews,0,0,0
509656,True,0,No user reviews,0,0,0
509657,True,0,No user reviews,0,0,0
509658,True,0,No user reviews,0,0,0
509659,True,0,No user reviews,0,0,0
509660,True,0,1 user reviews,1,0,1
509661,True,0,No user reviews,0,0,0
509662,True,0,2 user reviews,2,0,2
509663,True,0,No user reviews,0,0,0
509664,True,0,2 user reviews,2,0,2
509665,True,0,1 user reviews,1,0,1
509666,True,0,No user reviews,0,0,0
509667,True,0,No user reviews,0,0,0
509668,True,0,No user reviews,0,0,0
509669,True,0,No user reviews,0,0,0
509670,True,0,No user reviews,0,0,0
509671,True,0,No user reviews,0,0,0
509672,True,0,No user reviews,0,0,0
509673,True,0,No user reviews,0,0,0
509674,True,0,No user reviews,0,0,0
509675,True,0,1 user reviews,1,0,1
509676,True,0,No user reviews,0,0,0
509677,True,0,1 user reviews,1,0,1
509678,True,0,No user reviews,0,0,0
509679,True,0,No user reviews,0,0,0
509680,True,0,2 user reviews,2,0,2
509681,True,0,1 user reviews,0,1,1
509682,True,0,No user reviews,0,0,0
509683,True,0,1 user reviews,1,0,1
509684,True,0,No user reviews,0,0,0
509685,True,0,No user reviews,0,0,0
509686,True,0,1 user reviews,1,0,1
509687,True,0,1 user reviews,1,0,1
509688,True,0,2 user reviews,2,0,2
509689,True,0,1 user reviews,1,0,1
509690,True,0,No user reviews,0,0,0
509691,True,0,No user reviews,0,0,0
509692,True,0,2 user reviews,2,0,2
509693,True,0,No user reviews,0,0,0
509694,True,0,1 user reviews,1,0,1
509695,True,0,No user reviews,0,0,0
509696,True,0,No user reviews,0,0,0
509697,True,0,No user reviews,0,0,0
509698,True,0,No user reviews,0,0,0
509699,True,0,2 user reviews,2,0,2
509700,True,0,No user reviews,0,0,0
509701,True,0,No user reviews,0,0,0
509702,True,0,No user reviews,0,0,0
509703,True,0,No user reviews,0,0,0
509704,True,0,No user reviews,0,0,0
509705,True,0,No user reviews,0,0,0
509706,True,0,No user reviews,0,0,0
509707,True,0,No user reviews,0,0,0
509708,True,0,No user reviews,0,0,0
509709,True,0,1 user reviews,1,0,1
509710,True,0,3 user reviews,1,2,3
509711,True,0,No user reviews,0,0,0
509712,True,0,No user reviews,0,0,0
509713,True,0,2 user reviews,1,1,2
509714,True,0,4 user reviews,2,2,4
509715,True,0,1 user reviews,1,0,1
509716,True,0,1 user reviews,1,0,1
509717,True,0,2 user reviews,1,1,2
509718,True,0,1 user reviews,1,0,1
509719,True,0,No user reviews,0,0,0
509720,True,0,No user reviews,0,0,0
509721,True,0,No user reviews,0,0,0
509722,True,0,No user reviews,0,0,0
509723,True,0,No user reviews,0,0,0
509724,True,0,4 user reviews,3,1,4
509725,True,0,No user reviews,0,0,0
509726,True,0,No user reviews,0,0,0
509727,True,0,No user reviews,0,0,0
509728,True,0,No user reviews,0,0,0
509729,True,0,No user reviews,0,0,0
509730,True,0,No user reviews,0,0,0
509731,True,0,No user reviews,0,0,0
509732,True,0,No user reviews,0,0,0
509733,True,0,No user reviews,0,0,0
509734,True,0,No user reviews,0,0,0
509735,True,0,No user reviews,0,0,0
509736,True,0,No user reviews,0,0,0
509737,True,0,1 user reviews,1,0,1
509738,True,0,No user reviews,0,0,0
509739,True,0,1 user reviews,1,0,1
509740,True,0,No user reviews,0,0,0
509741,True,0,No user reviews,0,0,0
509742,True,0,No user reviews,0,0,0
509743,True,0,1 user reviews,1,0,1
509744,True,0,No user reviews,0,0,0
509745,True,0,No user reviews,0,0,0
509746,True,0,No user reviews,0,0,0
509747,True,0,No user reviews,0,0,0
509748,True,0,No user reviews,0,0,0
509749,True,0,No user reviews,0,0,0
509770,True,5,Mixed,38,17,55
509780,True,7,Positive,13,1,14
509800,True,0,No user reviews,0,0,0
509810,True,0,No user reviews,0,0,0
509820,True,7,Positive,10,1,11
509830,True,0,1 user reviews,0,1,1
509840,True,6,Mostly Positive,44,13,57
509850,True,0,9 user reviews,7,2,9
509860,True,0,No user reviews,0,0,0
509880,True,0,No user reviews,0,0,0
509890,True,0,No user reviews,0,0,0
509900,True,0,No user reviews,0,0,0
509910,True,0,3 user reviews,2,1,3
509920,True,0,4 user reviews,2,2,4
509930,True,0,2 user reviews,0,2,2
509950,True,0,No user reviews,0,0,0
509960,True,0,7 user reviews,3,4,7
509980,True,6,Mostly Positive,2202,732,2934
510000,True,0,No user reviews,0,0,0
510040,True,7,Positive,21,1,22
510050,True,7,Positive,15,1,16
510060,True,7,Positive,20,0,20
510070,True,7,Positive,9,2,11
510080,True,0,9 user reviews,5,4,9
510090,True,0,1 user reviews,1,0,1
510100,True,0,No user reviews,0,0,0
510110,True,0,4 user reviews,2,2,4
510120,True,4,Mostly Negative,3,10,13
510130,True,0,No user reviews,0,0,0
510140,True,0,1 user reviews,1,0,1
510150,True,0,No user reviews,0,0,0
510160,True,0,No user reviews,0,0,0
510180,True,0,No user reviews,0,0,0
510190,True,0,No user reviews,0,0,0
510200,True,0,4 user reviews,2,2,4
510230,True,0,No user reviews,0,0,0
510240,True,7,Positive,13,3,16
510250,True,7,Positive,17,1,18
510270,True,0,No user reviews,0,0,0
510271,True,0,No user reviews,0,0,0
510280,True,0,3 user reviews,3,0,3
510290,True,6,Mostly Positive,23,6,29
510310,True,0,No user reviews,0,0,0
510320,True,7,Positive,10,2,12
510330,True,0,2 user reviews,0,2,2
510340,True,0,No user reviews,0,0,0
510350,True,0,No user reviews,0,0,0
510360,True,0,8 user reviews,3,5,8
510370,True,0,No user reviews,0,0,0
510380,True,0,6 user reviews,1,5,6
510390,True,0,9 user reviews,5,4,9
510400,True,0,1 user reviews,1,0,1
510410,True,5,Mixed,10,5,15
510420,True,8,Very Positive,571,32,603
510430,True,0,6 user reviews,6,0,6
510450,True,0,No user reviews,0,0,0
510470,True,0,No user reviews,0,0,0
510480,True,0,No user reviews,0,0,0
510490,True,8,Very Positive,236,57,293
510500,True,8,Very Positive,410,79,489
510510,True,5,Mixed,272,232,504
510520,True,8,Very Positive,69,8,77
510530,True,0,2 user reviews,2,0,2
510540,True,8,Very Positive,128,6,134
510550,True,0,8 user reviews,4,4,8
510570,True,5,Mixed,21,13,34
510590,True,7,Positive,41,7,48
510600,True,0,No user reviews,0,0,0
510610,True,0,1 user reviews,1,0,1
510620,True,8,Very Positive,82,7,89
510630,True,0,8 user reviews,6,2,8
510640,True,0,No user reviews,0,0,0
510650,True,6,Mostly Positive,39,13,52
510660,True,7,Positive,8,2,10
510670,True,0,No user reviews,0,0,0
510680,True,0,9 user reviews,9,0,9
510690,True,0,No user reviews,0,0,0
510700,True,0,7 user reviews,5,2,7
510710,True,0,No user reviews,0,0,0
510720,True,0,No user reviews,0,0,0
510730,True,0,1 user reviews,0,1,1
510740,True,7,Positive,16,3,19
510750,True,0,1 user reviews,0,1,1
510780,True,5,Mixed,5,5,10
510790,True,0,2 user reviews,1,1,2
510800,True,0,2 user reviews,2,0,2
510820,True,0,No user reviews,0,0,0
510830,True,0,8 user reviews,8,0,8
510840,True,0,8 user reviews,6,2,8
510850,True,5,Mixed,27,16,43
510910,True,6,Mostly Positive,31,11,42
510930,True,6,Mostly Positive,65,17,82
510940,True,0,1 user reviews,0,1,1
510950,True,0,No user reviews,0,0,0
510960,True,0,2 user reviews,2,0,2
510970,True,0,No user reviews,0,0,0
510980,True,0,No user reviews,0,0,0
510990,True,0,8 user reviews,7,1,8
511000,True,0,No user reviews,0,0,0
511010,True,0,9 user reviews,5,4,9
511070,True,0,2 user reviews,2,0,2
511090,True,5,Mixed,8,4,12
511110,True,0,No user reviews,0,0,0
511120,True,0,3 user reviews,2,1,3
511130,True,0,1 user reviews,1,0,1
511131,True,0,No user reviews,0,0,0
511140,True,8,Very Positive,82,9,91
511160,True,6,Mostly Positive,12,5,17
511170,True,0,2 user reviews,1,1,2
511190,True,5,Mixed,8,4,12
511200,True,0,1 user reviews,1,0,1
511230,True,0,3 user reviews,2,1,3
511240,True,0,2 user reviews,2,0,2
511250,True,0,7 user reviews,7,0,7
511270,True,0,No user reviews,0,0,0
511280,True,0,No user reviews,0,0,0
511300,True,0,3 user reviews,3,0,3
511301,True,0,1 user reviews,1,0,1
511310,True,3,Negative,2,13,15
511320,True,7,Positive,9,2,11
511330,True,5,Mixed,6,8,14
511340,True,5,Mixed,21,15,36
511350,True,8,Very Positive,118,4,122
511360,True,0,No user reviews,0,0,0
511370,True,7,Positive,18,1,19
511380,True,7,Positive,15,0,15
511390,True,0,3 user reviews,3,0,3
511400,True,0,No user reviews,0,0,0
511410,True,0,No user reviews,0,0,0
511420,True,0,No user reviews,0,0,0
511430,True,5,Mixed,36,19,55
511450,True,0,2 user reviews,2,0,2
511460,True,0,8 user reviews,4,4,8
511470,True,9,Overwhelmingly Positive,1021,26,1047
511480,True,0,No user reviews,0,0,0
511490,True,0,5 user reviews,3,2,5
511500,True,5,Mixed,16,8,24
511540,True,8,Very Positive,43,10,53
511560,True,5,Mixed,8,5,13
511570,True,7,Positive,37,5,42
511600,True,0,8 user reviews,5,3,8
511610,True,0,3 user reviews,2,1,3
511630,True,7,Positive,35,5,40
511650,True,0,No user reviews,0,0,0
511660,True,5,Mixed,7,9,16
511670,True,0,4 user reviews,2,2,4
511680,True,8,Very Positive,555,44,599
511690,True,0,5 user reviews,4,1,5
511700,True,7,Positive,10,0,10
511710,True,0,No user reviews,0,0,0
511720,True,5,Mixed,14,16,30
511730,True,0,No user reviews,0,0,0
511740,True,8,Very Positive,698,94,792
511750,True,0,6 user reviews,5,1,6
511760,True,0,2 user reviews,1,1,2
511780,True,0,No user reviews,0,0,0
511781,True,0,No user reviews,0,0,0
511782,True,0,No user reviews,0,0,0
511790,True,5,Mixed,13,10,23
511800,True,0,4 user reviews,4,0,4
511810,True,0,1 user reviews,0,1,1
511820,True,5,Mixed,6,5,11
511830,True,0,6 user reviews,2,4,6
511840,True,0,No user reviews,0,0,0
511850,True,0,No user reviews,0,0,0
511880,True,0,No user reviews,0,0,0
511920,True,0,2 user reviews,2,0,2
511930,True,0,No user reviews,0,0,0
511940,True,0,8 user reviews,7,1,8
511950,True,0,No user reviews,0,0,0
511960,True,0,3 user reviews,2,1,3
511970,True,0,No user reviews,0,0,0
512000,True,7,Positive,14,1,15
512010,True,0,9 user reviews,9,0,9
512020,True,5,Mixed,27,12,39
512030,True,0,No user reviews,0,0,0
512032,True,4,Mostly Negative,91,281,372
512033,True,5,Mixed,141,186,327
512034,True,5,Mixed,200,115,315
512035,True,5,Mixed,103,95,198
512060,True,8,Very Positive,347,19,366
512070,True,0,1 user reviews,1,0,1
512080,True,6,Mostly Positive,82,30,112
512090,True,0,3 user reviews,1,2,3
512100,True,7,Positive,14,1,15
512110,True,6,Mostly Positive,8,3,11
512120,True,7,Positive,9,2,11
512140,True,0,No user reviews,0,0,0
512150,True,7,Positive,23,0,23
512160,True,5,Mixed,31,18,49
512170,True,0,2 user reviews,1,1,2
512180,True,8,Very Positive,266,9,275
512190,True,0,No user reviews,0,0,0
512220,True,8,Very Positive,308,36,344
512230,True,7,Positive,22,1,23
512240,True,7,Positive,31,2,33
512250,True,8,Very Positive,2049,202,2251
512260,True,7,Positive,26,4,30
512270,True,0,No user reviews,0,0,0
512290,True,0,No user reviews,0,0,0
512300,True,8,Very Positive,163,25,188
512310,True,0,2 user reviews,2,0,2
512311,True,0,No user reviews,0,0,0
512312,True,0,No user reviews,0,0,0
512313,True,0,2 user reviews,1,1,2
512314,True,0,1 user reviews,1,0,1
512315,True,0,No user reviews,0,0,0
512340,True,5,Mixed,16,12,28
512350,True,5,Mixed,24,20,44
512360,True,0,No user reviews,0,0,0
512370,True,0,3 user reviews,3,0,3
512380,True,0,No user reviews,0,0,0
512400,True,0,6 user reviews,1,5,6
512410,True,0,9 user reviews,3,6,9
512420,True,7,Positive,8,2,10
512430,True,5,Mixed,12,11,23
512460,True,8,Very Positive,82,5,87
512470,True,6,Mostly Positive,28,9,37
512480,True,0,No user reviews,0,0,0
512490,True,8,Very Positive,281,5,286
512500,True,0,No user reviews,0,0,0
512530,True,0,No user reviews,0,0,0
512540,True,6,Mostly Positive,1452,533,1985
512550,True,0,4 user reviews,2,2,4
512560,True,0,2 user reviews,0,2,2
512600,True,7,Positive,26,5,31
512610,True,0,6 user reviews,4,2,6
512620,True,0,4 user reviews,4,0,4
512621,True,5,Mixed,6,4,10
512622,True,0,3 user reviews,3,0,3
512630,True,0,No user reviews,0,0,0
512640,True,5,Mixed,7,6,13
512670,True,0,1 user reviews,1,0,1
512680,True,0,6 user reviews,6,0,6
512700,True,0,1 user reviews,0,1,1
512710,True,0,No user reviews,0,0,0
512720,True,0,No user reviews,0,0,0
512740,True,7,Positive,18,3,21
512750,True,7,Positive,11,0,11
512770,True,0,5 user reviews,5,0,5
512790,True,8,Very Positive,1155,105,1260
512810,True,0,No user reviews,0,0,0
512830,True,0,7 user reviews,4,3,7
512850,True,0,No user reviews,0,0,0
512870,True,0,No user reviews,0,0,0
512880,True,0,1 user reviews,1,0,1
512890,True,8,Very Positive,115,4,119
512900,True,9,Overwhelmingly Positive,4580,147,4727
512920,True,0,1 user reviews,0,1,1
512930,True,0,No user reviews,0,0,0
512940,True,0,9 user reviews,4,5,9
512950,True,0,1 user reviews,1,0,1
512970,True,0,No user reviews,0,0,0
512980,True,0,No user reviews,0,0,0
512990,True,0,No user reviews,0,0,0
513000,True,5,Mixed,19,24,43
513010,True,0,3 user reviews,3,0,3
513030,True,5,Mixed,13,6,19
513031,True,5,Mixed,7,5,12
513032,True,4,Mostly Negative,4,14,18
513033,True,5,Mixed,12,9,21
513034,True,5,Mixed,11,5,16
513040,True,0,No user reviews,0,0,0
513050,True,0,7 user reviews,2,5,7
513060,True,0,6 user reviews,5,1,6
513090,True,0,1 user reviews,1,0,1
513091,True,0,No user reviews,0,0,0
513092,True,0,No user reviews,0,0,0
513093,True,0,4 user reviews,3,1,4
513094,True,0,No user reviews,0,0,0
513095,True,0,3 user reviews,1,2,3
513096,True,0,1 user reviews,1,0,1
513097,True,0,No user reviews,0,0,0
513098,True,0,No user reviews,0,0,0
513099,True,0,No user reviews,0,0,0
513100,True,0,No user reviews,0,0,0
513101,True,0,No user reviews,0,0,0
513102,True,0,No user reviews,0,0,0
513103,True,0,No user reviews,0,0,0
513104,True,0,No user reviews,0,0,0
513105,True,0,No user reviews,0,0,0
513106,True,0,1 user reviews,1,0,1
513107,True,0,1 user reviews,1,0,1
513108,True,0,1 user reviews,1,0,1
513109,True,0,No user reviews,0,0,0
513110,True,0,7 user reviews,7,0,7
513111,True,0,1 user reviews,0,1,1
513112,True,0,No user reviews,0,0,0
513113,True,0,No user reviews,0,0,0
513114,True,0,2 user reviews,1,1,2
513115,True,0,No user reviews,0,0,0
513116,True,0,2 user reviews,2,0,2
513117,True,0,2 user reviews,2,0,2
513118,True,0,No user reviews,0,0,0
513119,True,0,2 user reviews,2,0,2
513140,True,0,5 user reviews,3,2,5
513150,True,0,2 user reviews,1,1,2
513160,True,0,No user reviews,0,0,0
513170,True,0,4 user reviews,3,1,4
513190,True,6,Mostly Positive,21,7,28
513200,True,0,No user reviews,0,0,0
513210,True,0,2 user reviews,1,1,2
513230,True,4,Mostly Negative,74,121,195
513240,True,0,6 user reviews,3,3,6
513250,True,0,9 user reviews,9,0,9
513260,True,0,1 user reviews,1,0,1
513270,True,5,Mixed,11,6,17
513280,True,0,No user reviews,0,0,0
513290,True,5,Mixed,108,120,228
513300,True,0,9 user reviews,7,2,9
513310,True,0,No user reviews,0,0,0
513320,True,5,Mixed,32,47,79
513330,True,5,Mixed,36,54,90
513340,True,7,Positive,16,2,18
513360,True,8,Very Positive,83,11,94
513370,True,3,Negative,3,21,24
513420,True,5,Mixed,12,13,25
513430,True,5,Mixed,11,6,17
513440,True,0,No user reviews,0,0,0
513450,True,8,Very Positive,115,16,131
513460,True,5,Mixed,10,8,18
513470,True,0,No user reviews,0,0,0
513480,True,8,Very Positive,58,8,66
513490,True,0,No user reviews,0,0,0
513500,True,7,Positive,16,4,20
513510,True,8,Very Positive,1384,167,1551
513520,True,5,Mixed,8,4,12
513550,True,0,3 user reviews,3,0,3
513560,True,5,Mixed,21,19,40
513570,True,2,Very Negative,9,43,52
513580,True,0,6 user reviews,2,4,6
513590,True,4,Mostly Negative,9,18,27
513600,True,0,2 user reviews,2,0,2
513610,True,0,8 user reviews,6,2,8
513620,True,5,Mixed,15,22,37
513650,True,5,Mixed,71,38,109
513660,True,0,No user reviews,0,0,0
513670,True,0,No user reviews,0,0,0
513680,True,0,7 user reviews,4,3,7
513690,True,5,Mixed,31,21,52
513710,True,5,Mixed,11188,4824,16012
513720,True,6,Mostly Positive,14,6,20
513730,True,7,Positive,40,1,41
513740,True,4,Mostly Negative,4,12,16
513760,True,0,2 user reviews,2,0,2
513770,True,5,Mixed,4,6,10
513780,True,8,Very Positive,149,34,183
513790,True,5,Mixed,9,5,14
513800,True,7,Positive,26,0,26
513810,True,0,7 user reviews,2,5,7
513820,True,0,3 user reviews,2,1,3
513840,True,0,5 user reviews,5,0,5
513860,True,6,Mostly Positive,12,5,17
513880,True,5,Mixed,12,6,18
513890,True,8,Very Positive,141,13,154
513920,True,0,7 user reviews,6,1,7
513930,True,4,Mostly Negative,6,17,23
513960,True,0,3 user reviews,3,0,3
513980,True,6,Mostly Positive,13,4,17
513990,True,5,Mixed,17,11,28
514010,True,6,Mostly Positive,14,6,20
514020,True,0,No user reviews,0,0,0
514040,True,0,No user reviews,0,0,0
514050,True,0,7 user reviews,7,0,7
514070,True,0,No user reviews,0,0,0
514080,True,5,Mixed,8,6,14
514090,True,8,Very Positive,53,6,59
514100,True,0,No user reviews,0,0,0
514110,True,0,No user reviews,0,0,0
514120,True,0,No user reviews,0,0,0
514140,True,5,Mixed,8,5,13
514150,True,5,Mixed,13,9,22
514160,True,7,Positive,33,0,33
514170,True,5,Mixed,11,6,17
514180,True,7,Positive,16,4,20
514190,True,0,4 user reviews,4,0,4
514200,True,0,3 user reviews,2,1,3
514210,True,0,No user reviews,0,0,0
514220,True,0,2 user reviews,2,0,2
514230,True,0,No user reviews,0,0,0
514240,True,5,Mixed,31,40,71
514290,True,5,Mixed,30,38,68
514310,True,8,Very Positive,271,19,290
514320,True,0,No user reviews,0,0,0
514330,True,7,Positive,18,4,22
514331,True,0,1 user reviews,1,0,1
514332,True,0,1 user reviews,0,1,1
514340,True,7,Positive,16,1,17
514350,True,0,8 user reviews,6,2,8
514360,True,0,1 user reviews,0,1,1
514370,True,0,8 user reviews,6,2,8
514390,True,0,2 user reviews,1,1,2
514400,True,5,Mixed,7,5,12
514410,True,4,Mostly Negative,9,24,33
514450,True,0,6 user reviews,5,1,6
514460,True,4,Mostly Negative,9,14,23
514470,True,0,2 user reviews,2,0,2
514480,True,0,8 user reviews,6,2,8
514490,True,0,5 user reviews,2,3,5
514500,True,6,Mostly Positive,237,96,333
514510,True,0,1 user reviews,0,1,1
514520,True,0,3 user reviews,2,1,3
514530,True,0,3 user reviews,2,1,3
514540,True,0,2 user reviews,2,0,2
514550,True,0,3 user reviews,1,2,3
514570,True,5,Mixed,5,6,11
514580,True,7,Positive,35,3,38
514590,True,0,No user reviews,0,0,0
514600,True,0,No user reviews,0,0,0
514620,True,0,9 user reviews,9,0,9
514630,True,0,2 user reviews,0,2,2
514640,True,0,5 user reviews,4,1,5
514650,True,0,9 user reviews,8,1,9
514660,True,6,Mostly Positive,24,9,33
514670,True,5,Mixed,25,17,42
514690,True,0,No user reviews,0,0,0
514700,True,6,Mostly Positive,25,8,33
514720,True,0,4 user reviews,3,1,4
514730,True,0,3 user reviews,3,0,3
514740,True,0,2 user reviews,2,0,2
514750,True,7,Positive,12,1,13
514760,True,0,4 user reviews,4,0,4
514770,True,0,2 user reviews,2,0,2
514780,True,0,9 user reviews,3,6,9
514800,True,0,2 user reviews,1,1,2
514810,True,6,Mostly Positive,11,4,15
514820,True,0,1 user reviews,0,1,1
514830,True,6,Mostly Positive,14,6,20
514870,True,0,2 user reviews,2,0,2
514890,True,6,Mostly Positive,27,7,34
514900,True,6,Mostly Positive,1376,354,1730
514920,True,6,Mostly Positive,198,53,251
514930,True,0,2 user reviews,1,1,2
514970,True,4,Mostly Negative,9,14,23
514990,True,5,Mixed,47,24,71
515000,True,7,Positive,10,1,11
515010,True,0,9 user reviews,9,0,9
515020,True,7,Positive,14,0,14
515040,True,8,Very Positive,929,125,1054
515050,True,0,No user reviews,0,0,0
515060,True,0,6 user reviews,5,1,6
515090,True,0,7 user reviews,4,3,7
515100,True,0,6 user reviews,2,4,6
515110,True,0,4 user reviews,4,0,4
515120,True,0,2 user reviews,1,1,2
515130,True,0,8 user reviews,8,0,8
515140,True,0,2 user reviews,1,1,2
515150,True,0,3 user reviews,2,1,3
515160,True,0,3 user reviews,3,0,3
515170,True,0,5 user reviews,0,5,5
515171,True,0,3 user reviews,1,2,3
515180,True,6,Mostly Positive,871,235,1106
515190,True,5,Mixed,42,25,67
515191,True,6,Mostly Positive,301,86,387
515200,True,0,3 user reviews,0,3,3
515220,True,8,Very Positive,955,164,1119
515230,True,0,No user reviews,0,0,0
515240,True,0,1 user reviews,1,0,1
515260,True,6,Mostly Positive,59,19,78
515270,True,0,9 user reviews,8,1,9
515280,True,0,No user reviews,0,0,0
515300,True,4,Mostly Negative,3,8,11
515320,True,0,No user reviews,0,0,0
515330,True,0,No user reviews,0,0,0
515340,True,0,No user reviews,0,0,0
515350,True,0,No user reviews,0,0,0
515360,True,0,No user reviews,0,0,0
515370,True,0,No user reviews,0,0,0
515380,True,0,No user reviews,0,0,0
515390,True,0,No user reviews,0,0,0
515400,True,0,No user reviews,0,0,0
515410,True,0,No user reviews,0,0,0
515430,True,0,No user reviews,0,0,0
515440,True,0,No user reviews,0,0,0
515450,True,0,No user reviews,0,0,0
515460,True,0,No user reviews,0,0,0
515470,True,5,Mixed,25,31,56
515480,True,0,No user reviews,0,0,0
515490,True,0,No user reviews,0,0,0
515500,True,0,No user reviews,0,0,0
515510,True,0,No user reviews,0,0,0
515530,True,0,No user reviews,0,0,0
515540,True,0,No user reviews,0,0,0
515550,True,0,No user reviews,0,0,0
515560,True,0,No user reviews,0,0,0
515570,True,8,Very Positive,83,8,91
515580,True,0,No user reviews,0,0,0
515590,True,0,No user reviews,0,0,0
515600,True,0,No user reviews,0,0,0
515610,True,0,No user reviews,0,0,0
515620,True,0,No user reviews,0,0,0
515630,True,0,No user reviews,0,0,0
515640,True,0,No user reviews,0,0,0
515641,True,0,No user reviews,0,0,0
515642,True,0,No user reviews,0,0,0
515650,True,8,Very Positive,85,8,93
515660,True,0,No user reviews,0,0,0
515670,True,0,No user reviews,0,0,0
515680,True,0,5 user reviews,1,4,5
515690,True,5,Mixed,8,12,20
515700,True,0,2 user reviews,1,1,2
515710,True,8,Very Positive,80,17,97
515740,True,6,Mostly Positive,7,3,10
515750,True,0,No user reviews,0,0,0
515760,True,0,No user reviews,0,0,0
515761,True,0,No user reviews,0,0,0
515762,True,0,No user reviews,0,0,0
515763,True,0,No user reviews,0,0,0
515764,True,0,No user reviews,0,0,0
515765,True,0,No user reviews,0,0,0
515766,True,0,No user reviews,0,0,0
515767,True,0,No user reviews,0,0,0
515768,True,0,No user reviews,0,0,0
515769,True,0,No user reviews,0,0,0
515770,True,0,No user reviews,0,0,0
515771,True,0,No user reviews,0,0,0
515772,True,0,No user reviews,0,0,0
515800,True,0,No user reviews,0,0,0
515850,True,0,No user reviews,0,0,0
515880,True,0,No user reviews,0,0,0
515890,True,0,No user reviews,0,0,0
515900,True,0,2 user reviews,0,2,2
515910,True,5,Mixed,11,9,20
515950,True,0,No user reviews,0,0,0
515960,True,0,No user reviews,0,0,0
515970,True,0,No user reviews,0,0,0
515980,True,5,Mixed,24,19,43
515990,True,0,No user reviews,0,0,0
516000,True,0,1 user reviews,1,0,1
516010,True,0,No user reviews,0,0,0
516020,True,0,No user reviews,0,0,0
516030,True,5,Mixed,9,4,13
516040,True,5,Mixed,8,5,13
516050,True,0,1 user reviews,1,0,1
516090,True,0,No user reviews,0,0,0
516100,True,0,No user reviews,0,0,0
516110,True,8,Very Positive,342,29,371
516120,True,0,5 user reviews,5,0,5
516130,True,6,Mostly Positive,89,26,115
516250,True,0,9 user reviews,2,7,9
516260,True,0,No user reviews,0,0,0
516261,True,0,No user reviews,0,0,0
516262,True,0,No user reviews,0,0,0
516263,True,0,No user reviews,0,0,0
516264,True,0,No user reviews,0,0,0
516265,True,0,No user reviews,0,0,0
516266,True,0,No user reviews,0,0,0
516267,True,0,No user reviews,0,0,0
516268,True,0,No user reviews,0,0,0
516269,True,0,No user reviews,0,0,0
516270,True,0,No user reviews,0,0,0
516271,True,0,No user reviews,0,0,0
516272,True,0,No user reviews,0,0,0
516280,True,0,No user reviews,0,0,0
516281,True,0,No user reviews,0,0,0
516282,True,0,No user reviews,0,0,0
516283,True,0,No user reviews,0,0,0
516284,True,0,No user reviews,0,0,0
516285,True,0,No user reviews,0,0,0
516286,True,0,No user reviews,0,0,0
516287,True,0,1 user reviews,1,0,1
516288,True,0,No user reviews,0,0,0
516289,True,0,No user reviews,0,0,0
516290,True,0,No user reviews,0,0,0
516291,True,0,No user reviews,0,0,0
516292,True,0,No user reviews,0,0,0
516320,True,0,No user reviews,0,0,0
516330,True,0,1 user reviews,1,0,1
516331,True,0,2 user reviews,1,1,2
516340,True,0,No user reviews,0,0,0
516350,True,0,No user reviews,0,0,0
516360,True,0,No user reviews,0,0,0
516370,True,0,2 user reviews,2,0,2
516380,True,0,No user reviews,0,0,0
516400,True,0,No user reviews,0,0,0
516410,True,0,2 user reviews,2,0,2
516430,True,7,Positive,29,5,34
516440,True,0,2 user reviews,2,0,2
516450,True,0,9 user reviews,8,1,9
516460,True,0,1 user reviews,0,1,1
516470,True,0,6 user reviews,3,3,6
516480,True,8,Very Positive,180,2,182
516490,True,0,No user reviews,0,0,0
516500,True,7,Positive,12,2,14
516510,True,0,2 user reviews,2,0,2
516520,True,0,4 user reviews,4,0,4
516530,True,0,1 user reviews,0,1,1
516550,True,7,Positive,9,1,10
516560,True,0,6 user reviews,5,1,6
516570,True,7,Positive,11,0,11
516580,True,7,Positive,16,2,18
516590,True,6,Mostly Positive,61,20,81
516600,True,7,Positive,24,1,25
516610,True,0,4 user reviews,2,2,4
516620,True,0,No user reviews,0,0,0
516621,True,0,No user reviews,0,0,0
516622,True,0,No user reviews,0,0,0
516630,True,0,No user reviews,0,0,0
516640,True,0,3 user reviews,2,1,3
516650,True,5,Mixed,6,4,10
516660,True,0,No user reviews,0,0,0
516670,True,0,No user reviews,0,0,0
516680,True,0,4 user reviews,0,4,4
516710,True,0,1 user reviews,0,1,1
516740,True,0,1 user reviews,1,0,1
516750,True,8,Very Positive,10379,965,11344
516760,True,7,Positive,16,0,16
516770,True,0,2 user reviews,2,0,2
516780,True,0,No user reviews,0,0,0
516790,True,0,8 user reviews,5,3,8
516810,True,0,3 user reviews,3,0,3
516820,True,7,Positive,28,2,30
516830,True,0,No user reviews,0,0,0
516840,True,7,Positive,36,2,38
516850,True,0,No user reviews,0,0,0
516860,True,0,No user reviews,0,0,0
516870,True,0,2 user reviews,1,1,2
516890,True,0,7 user reviews,6,1,7
516900,True,0,3 user reviews,3,0,3
516910,True,0,1 user reviews,1,0,1
516920,True,0,6 user reviews,5,1,6
516930,True,0,No user reviews,0,0,0
516940,True,6,Mostly Positive,24,7,31
516950,True,0,4 user reviews,2,2,4
516960,True,0,3 user reviews,3,0,3
516970,True,0,No user reviews,0,0,0
516971,True,0,No user reviews,0,0,0
516972,True,0,No user reviews,0,0,0
516973,True,0,No user reviews,0,0,0
516974,True,0,No user reviews,0,0,0
516975,True,0,No user reviews,0,0,0
516976,True,0,No user reviews,0,0,0
516977,True,0,No user reviews,0,0,0
516978,True,0,No user reviews,0,0,0
516979,True,0,No user reviews,0,0,0
516980,True,0,No user reviews,0,0,0
516981,True,0,No user reviews,0,0,0
516982,True,0,No user reviews,0,0,0
516990,True,0,No user reviews,0,0,0
517000,True,8,Very Positive,52,11,63
517010,True,0,5 user reviews,1,4,5
517020,True,5,Mixed,25,16,41
517030,True,0,3 user reviews,3,0,3
517050,True,0,No user reviews,0,0,0
517060,True,0,9 user reviews,4,5,9
517100,True,6,Mostly Positive,8,3,11
517110,True,0,4 user reviews,0,4,4
517130,True,8,Very Positive,334,48,382
517140,True,0,8 user reviews,5,3,8
517160,True,8,Very Positive,303,67,370
517170,True,7,Positive,30,6,36
517190,True,0,1 user reviews,1,0,1
517210,True,7,Positive,10,2,12
517220,True,6,Mostly Positive,19,6,25
517230,True,0,No user reviews,0,0,0
517240,True,0,7 user reviews,3,4,7
517250,True,0,No user reviews,0,0,0
517270,True,0,4 user reviews,2,2,4
517280,True,0,4 user reviews,3,1,4
517290,True,0,No user reviews,0,0,0
517291,True,0,No user reviews,0,0,0
517292,True,0,No user reviews,0,0,0
517300,True,0,5 user reviews,1,4,5
517320,True,0,1 user reviews,1,0,1
517330,True,6,Mostly Positive,47,13,60
517340,True,0,4 user reviews,2,2,4
517350,True,5,Mixed,16,7,23
517360,True,5,Mixed,24,13,37
517370,True,6,Mostly Positive,81,24,105
517390,True,0,No user reviews,0,0,0
517400,True,0,8 user reviews,1,7,8
517410,True,0,No user reviews,0,0,0
517450,True,0,1 user reviews,1,0,1
517460,True,5,Mixed,6,5,11
517470,True,7,Positive,10,1,11
517480,True,0,3 user reviews,0,3,3
517500,True,0,3 user reviews,0,3,3
517510,True,0,8 user reviews,7,1,8
517530,True,0,No user reviews,0,0,0
517550,True,0,No user reviews,0,0,0
517560,True,0,1 user reviews,1,0,1
517620,True,0,4 user reviews,4,0,4
517630,True,5,Mixed,3197,2433,5630
517640,True,0,No user reviews,0,0,0
517660,True,0,3 user reviews,2,1,3
517670,True,8,Very Positive,65,12,77
517680,True,0,1 user reviews,1,0,1
517690,True,0,No user reviews,0,0,0
517710,True,8,Very Positive,1622,236,1858
517720,True,6,Mostly Positive,135,57,192
517730,True,0,No user reviews,0,0,0
517750,True,0,2 user reviews,1,1,2
517751,True,0,No user reviews,0,0,0
517752,True,0,1 user reviews,1,0,1
517760,True,0,No user reviews,0,0,0
517761,True,0,No user reviews,0,0,0
517762,True,0,No user reviews,0,0,0
517770,True,0,No user reviews,0,0,0
517780,True,6,Mostly Positive,86,25,111
517790,True,8,Very Positive,400,35,435
517810,True,6,Mostly Positive,149,59,208
517830,True,0,No user reviews,0,0,0
517831,True,5,Mixed,16,16,32
517910,True,7,Positive,20,2,22
517930,True,7,Positive,17,1,18
517960,True,0,6 user reviews,5,1,6
517970,True,0,7 user reviews,6,1,7
517990,True,0,8 user reviews,4,4,8
518000,True,0,4 user reviews,4,0,4
518020,True,0,No user reviews,0,0,0
518030,True,8,Very Positive,943,180,1123
518040,True,8,Very Positive,50,3,53
518060,True,6,Mostly Positive,242,88,330
518070,True,0,No user reviews,0,0,0
518080,True,0,No user reviews,0,0,0
518110,True,5,Mixed,11,10,21
518120,True,0,1 user reviews,1,0,1
518130,True,0,8 user reviews,5,3,8
518140,True,0,4 user reviews,2,2,4
518150,True,8,Very Positive,422,91,513
518190,True,0,3 user reviews,2,1,3
518200,True,0,No user reviews,0,0,0
518210,True,0,No user reviews,0,0,0
518211,True,0,No user reviews,0,0,0
518212,True,0,No user reviews,0,0,0
518213,True,0,No user reviews,0,0,0
518214,True,0,No user reviews,0,0,0
518215,True,0,No user reviews,0,0,0
518220,True,0,No user reviews,0,0,0
518230,True,0,1 user reviews,0,1,1
518240,True,0,No user reviews,0,0,0
518250,True,0,1 user reviews,1,0,1
518260,True,0,No user reviews,0,0,0
518270,True,0,No user reviews,0,0,0
518280,True,7,Positive,17,1,18
518320,True,0,9 user reviews,5,4,9
518360,True,0,4 user reviews,4,0,4
518370,True,0,1 user reviews,1,0,1
518390,True,0,No user reviews,0,0,0
518400,True,0,No user reviews,0,0,0
518410,True,0,No user reviews,0,0,0
518420,True,0,No user reviews,0,0,0
518430,True,0,No user reviews,0,0,0
518440,True,8,Very Positive,53,1,54
518450,True,0,4 user reviews,3,1,4
518460,True,0,5 user reviews,3,2,5
518470,True,0,No user reviews,0,0,0
518480,True,0,8 user reviews,8,0,8
518490,True,0,No user reviews,0,0,0
518500,True,0,1 user reviews,1,0,1
518510,True,0,No user reviews,0,0,0
518520,True,0,1 user reviews,1,0,1
518530,True,0,No user reviews,0,0,0
518540,True,0,No user reviews,0,0,0
518550,True,0,No user reviews,0,0,0
518560,True,0,No user reviews,0,0,0
518570,True,0,No user reviews,0,0,0
518580,True,8,Very Positive,75,4,79
518610,True,0,8 user reviews,6,2,8
518620,True,5,Mixed,6,5,11
518630,True,0,No user reviews,0,0,0
518640,True,0,No user reviews,0,0,0
518650,True,7,Positive,18,1,19
518660,True,5,Mixed,7,9,16
518670,True,8,Very Positive,59,8,67
518680,True,0,1 user reviews,1,0,1
518690,True,5,Mixed,14,8,22
518710,True,0,4 user reviews,4,0,4
518720,True,6,Mostly Positive,101,36,137
518730,True,8,Very Positive,78,7,85
518740,True,0,1 user reviews,1,0,1
518760,True,0,No user reviews,0,0,0
518780,True,0,No user reviews,0,0,0
518790,True,8,Very Positive,13151,2394,15545
518800,True,0,5 user reviews,1,4,5
518810,True,0,No user reviews,0,0,0
518811,True,0,No user reviews,0,0,0
518820,True,0,No user reviews,0,0,0
518821,True,0,No user reviews,0,0,0
518822,True,0,No user reviews,0,0,0
518823,True,0,No user reviews,0,0,0
518824,True,0,No user reviews,0,0,0
518825,True,0,No user reviews,0,0,0
518826,True,0,No user reviews,0,0,0
518827,True,0,No user reviews,0,0,0
518828,True,0,No user reviews,0,0,0
518829,True,0,No user reviews,0,0,0
518830,True,0,No user reviews,0,0,0
518831,True,0,No user reviews,0,0,0
518832,True,0,No user reviews,0,0,0
518833,True,0,No user reviews,0,0,0
518834,True,0,No user reviews,0,0,0
518835,True,0,No user reviews,0,0,0
518836,True,0,No user reviews,0,0,0
518837,True,0,No user reviews,0,0,0
518838,True,0,No user reviews,0,0,0
518839,True,0,No user reviews,0,0,0
518840,True,0,No user reviews,0,0,0
518841,True,0,No user reviews,0,0,0
518842,True,0,No user reviews,0,0,0
518843,True,0,No user reviews,0,0,0
518844,True,0,No user reviews,0,0,0
518845,True,0,No user reviews,0,0,0
518846,True,0,No user reviews,0,0,0
518847,True,0,No user reviews,0,0,0
518848,True,0,No user reviews,0,0,0
518849,True,0,No user reviews,0,0,0
518850,True,0,No user reviews,0,0,0
518851,True,0,No user reviews,0,0,0
518852,True,0,No user reviews,0,0,0
518853,True,0,No user reviews,0,0,0
518854,True,0,No user reviews,0,0,0
518855,True,0,No user reviews,0,0,0
518856,True,0,No user reviews,0,0,0
518857,True,0,No user reviews,0,0,0
518858,True,0,No user reviews,0,0,0
518859,True,0,No user reviews,0,0,0
518860,True,0,No user reviews,0,0,0
518861,True,0,No user reviews,0,0,0
518862,True,0,No user reviews,0,0,0
518863,True,0,No user reviews,0,0,0
518864,True,0,No user reviews,0,0,0
518865,True,0,No user reviews,0,0,0
518866,True,0,No user reviews,0,0,0
518867,True,0,No user reviews,0,0,0
518868,True,0,No user reviews,0,0,0
518869,True,0,No user reviews,0,0,0
518870,True,0,No user reviews,0,0,0
518871,True,0,No user reviews,0,0,0
518872,True,0,No user reviews,0,0,0
518873,True,0,No user reviews,0,0,0
518874,True,0,No user reviews,0,0,0
518875,True,0,No user reviews,0,0,0
518876,True,0,No user reviews,0,0,0
518877,True,0,No user reviews,0,0,0
518878,True,0,No user reviews,0,0,0
518879,True,0,No user reviews,0,0,0
518880,True,0,No user reviews,0,0,0
518881,True,0,No user reviews,0,0,0
518882,True,0,No user reviews,0,0,0
518883,True,0,No user reviews,0,0,0
518884,True,0,No user reviews,0,0,0
518885,True,0,No user reviews,0,0,0
518886,True,0,No user reviews,0,0,0
518887,True,0,No user reviews,0,0,0
518888,True,0,No user reviews,0,0,0
518889,True,0,No user reviews,0,0,0
518890,True,0,No user reviews,0,0,0
518891,True,0,No user reviews,0,0,0
518892,True,0,No user reviews,0,0,0
518893,True,0,No user reviews,0,0,0
518894,True,0,No user reviews,0,0,0
518895,True,0,No user reviews,0,0,0
518896,True,0,No user reviews,0,0,0
518897,True,0,No user reviews,0,0,0
518898,True,0,No user reviews,0,0,0
518899,True,0,No user reviews,0,0,0
518900,True,0,No user reviews,0,0,0
518901,True,0,No user reviews,0,0,0
518902,True,0,No user reviews,0,0,0
518903,True,0,No user reviews,0,0,0
518904,True,0,No user reviews,0,0,0
518905,True,0,No user reviews,0,0,0
518906,True,0,No user reviews,0,0,0
518907,True,0,No user reviews,0,0,0
518908,True,0,No user reviews,0,0,0
518909,True,0,No user reviews,0,0,0
518910,True,6,Mostly Positive,183,48,231
518920,True,5,Mixed,148,83,231
518940,True,0,No user reviews,0,0,0
518941,True,0,No user reviews,0,0,0
518942,True,0,No user reviews,0,0,0
518943,True,0,No user reviews,0,0,0
518944,True,0,No user reviews,0,0,0
518945,True,0,No user reviews,0,0,0
518946,True,0,No user reviews,0,0,0
518947,True,0,No user reviews,0,0,0
518948,True,0,No user reviews,0,0,0
518949,True,0,No user reviews,0,0,0
518950,True,0,No user reviews,0,0,0
518951,True,0,No user reviews,0,0,0
518952,True,0,No user reviews,0,0,0
518953,True,0,No user reviews,0,0,0
518954,True,0,No user reviews,0,0,0
518955,True,0,No user reviews,0,0,0
518956,True,0,No user reviews,0,0,0
518957,True,0,No user reviews,0,0,0
518958,True,0,No user reviews,0,0,0
518959,True,0,No user reviews,0,0,0
518960,True,0,No user reviews,0,0,0
518961,True,0,No user reviews,0,0,0
518962,True,0,No user reviews,0,0,0
518963,True,0,No user reviews,0,0,0
518964,True,0,No user reviews,0,0,0
518965,True,0,No user reviews,0,0,0
518966,True,0,No user reviews,0,0,0
518967,True,0,No user reviews,0,0,0
518968,True,0,No user reviews,0,0,0
518969,True,0,No user reviews,0,0,0
518970,True,0,No user reviews,0,0,0
518971,True,0,No user reviews,0,0,0
518972,True,0,No user reviews,0,0,0
518973,True,0,No user reviews,0,0,0
518974,True,0,No user reviews,0,0,0
518975,True,0,No user reviews,0,0,0
518976,True,0,No user reviews,0,0,0
518977,True,0,No user reviews,0,0,0
518978,True,0,No user reviews,0,0,0
518979,True,0,No user reviews,0,0,0
518980,True,0,No user reviews,0,0,0
518981,True,0,No user reviews,0,0,0
518982,True,0,No user reviews,0,0,0
518983,True,0,No user reviews,0,0,0
518984,True,0,No user reviews,0,0,0
518985,True,0,No user reviews,0,0,0
518986,True,0,No user reviews,0,0,0
518987,True,0,No user reviews,0,0,0
518988,True,0,No user reviews,0,0,0
518989,True,0,No user reviews,0,0,0
518990,True,0,No user reviews,0,0,0
518991,True,0,No user reviews,0,0,0
518992,True,0,No user reviews,0,0,0
518993,True,0,No user reviews,0,0,0
518994,True,0,No user reviews,0,0,0
518995,True,0,No user reviews,0,0,0
518996,True,0,No user reviews,0,0,0
518997,True,0,No user reviews,0,0,0
518998,True,0,No user reviews,0,0,0
518999,True,0,No user reviews,0,0,0
519000,True,0,No user reviews,0,0,0
519001,True,0,No user reviews,0,0,0
519002,True,0,No user reviews,0,0,0
519003,True,0,No user reviews,0,0,0
519004,True,0,No user reviews,0,0,0
519005,True,0,No user reviews,0,0,0
519006,True,0,No user reviews,0,0,0
519007,True,0,No user reviews,0,0,0
519008,True,0,No user reviews,0,0,0
519009,True,0,No user reviews,0,0,0
519010,True,0,No user reviews,0,0,0
519011,True,0,No user reviews,0,0,0
519012,True,0,No user reviews,0,0,0
519020,True,0,3 user reviews,2,1,3
519030,True,5,Mixed,22,13,35
519050,True,0,No user reviews,0,0,0
519070,True,0,No user reviews,0,0,0
519080,True,6,Mostly Positive,46,12,58
519100,True,0,No user reviews,0,0,0
519110,True,0,3 user reviews,3,0,3
519140,True,6,Mostly Positive,15,4,19
519160,True,5,Mixed,6,5,11
519170,True,0,1 user reviews,0,1,1
519180,True,3,Negative,2,20,22
519190,True,5,Mixed,1789,1224,3013
519200,True,0,9 user reviews,8,1,9
519210,True,0,No user reviews,0,0,0
519211,True,0,No user reviews,0,0,0
519212,True,0,No user reviews,0,0,0
519213,True,0,No user reviews,0,0,0
519214,True,0,No user reviews,0,0,0
519215,True,0,No user reviews,0,0,0
519216,True,0,No user reviews,0,0,0
519217,True,0,No user reviews,0,0,0
519218,True,0,No user reviews,0,0,0
519219,True,0,No user reviews,0,0,0
519220,True,0,No user reviews,0,0,0
519230,True,0,No user reviews,0,0,0
519240,True,0,2 user reviews,2,0,2
519250,True,0,No user reviews,0,0,0
519260,True,0,No user reviews,0,0,0
519270,True,0,No user reviews,0,0,0
519280,True,0,1 user reviews,1,0,1
519290,True,0,No user reviews,0,0,0
519300,True,0,2 user reviews,0,2,2
519310,True,0,No user reviews,0,0,0
519320,True,0,No user reviews,0,0,0
519330,True,0,No user reviews,0,0,0
519340,True,0,No user reviews,0,0,0
519350,True,0,No user reviews,0,0,0
519360,True,0,No user reviews,0,0,0
519370,True,0,No user reviews,0,0,0
519380,True,0,No user reviews,0,0,0
519390,True,0,No user reviews,0,0,0
519400,True,0,No user reviews,0,0,0
519410,True,0,No user reviews,0,0,0
519420,True,0,No user reviews,0,0,0
519430,True,0,No user reviews,0,0,0
519440,True,0,No user reviews,0,0,0
519450,True,0,No user reviews,0,0,0
519460,True,0,No user reviews,0,0,0
519461,True,0,No user reviews,0,0,0
519470,True,0,No user reviews,0,0,0
519471,True,0,No user reviews,0,0,0
519472,True,0,No user reviews,0,0,0
519480,True,0,No user reviews,0,0,0
519481,True,0,No user reviews,0,0,0
519482,True,0,No user reviews,0,0,0
519483,True,0,No user reviews,0,0,0
519490,True,0,6 user reviews,2,4,6
519510,True,0,No user reviews,0,0,0
519511,True,0,No user reviews,0,0,0
519512,True,0,No user reviews,0,0,0
519513,True,0,No user reviews,0,0,0
519514,True,0,No user reviews,0,0,0
519520,True,0,No user reviews,0,0,0
519521,True,0,No user reviews,0,0,0
519522,True,0,No user reviews,0,0,0
519530,True,0,No user reviews,0,0,0
519540,True,0,4 user reviews,4,0,4
519550,True,0,1 user reviews,0,1,1
519560,True,0,3 user reviews,1,2,3
519561,True,0,No user reviews,0,0,0
519562,True,0,No user reviews,0,0,0
519563,True,0,No user reviews,0,0,0
519564,True,0,No user reviews,0,0,0
519565,True,0,No user reviews,0,0,0
519566,True,0,No user reviews,0,0,0
519567,True,0,No user reviews,0,0,0
519568,True,0,No user reviews,0,0,0
519569,True,0,No user reviews,0,0,0
519570,True,0,No user reviews,0,0,0
519571,True,0,No user reviews,0,0,0
519572,True,0,No user reviews,0,0,0
519573,True,0,No user reviews,0,0,0
519574,True,0,No user reviews,0,0,0
519575,True,0,No user reviews,0,0,0
519576,True,0,No user reviews,0,0,0
519577,True,0,No user reviews,0,0,0
519578,True,0,No user reviews,0,0,0
519580,True,0,No user reviews,0,0,0
519581,True,0,No user reviews,0,0,0
519582,True,0,No user reviews,0,0,0
519583,True,0,No user reviews,0,0,0
519584,True,0,No user reviews,0,0,0
519585,True,0,No user reviews,0,0,0
519586,True,0,No user reviews,0,0,0
519587,True,0,No user reviews,0,0,0
519588,True,0,No user reviews,0,0,0
519589,True,0,No user reviews,0,0,0
519590,True,0,No user reviews,0,0,0
519600,True,0,No user reviews,0,0,0
519601,True,0,No user reviews,0,0,0
519602,True,0,No user reviews,0,0,0
519603,True,0,No user reviews,0,0,0
519604,True,0,No user reviews,0,0,0
519605,True,0,No user reviews,0,0,0
519606,True,0,No user reviews,0,0,0
519607,True,0,No user reviews,0,0,0
519608,True,0,No user reviews,0,0,0
519609,True,0,No user reviews,0,0,0
519610,True,0,No user reviews,0,0,0
519611,True,0,No user reviews,0,0,0
519612,True,0,No user reviews,0,0,0
519620,True,0,No user reviews,0,0,0
519621,True,0,No user reviews,0,0,0
519622,True,0,No user reviews,0,0,0
519623,True,0,No user reviews,0,0,0
519624,True,0,No user reviews,0,0,0
519625,True,0,No user reviews,0,0,0
519626,True,0,No user reviews,0,0,0
519627,True,0,No user reviews,0,0,0
519628,True,0,No user reviews,0,0,0
519629,True,0,No user reviews,0,0,0
519630,True,0,No user reviews,0,0,0
519631,True,0,No user reviews,0,0,0
519632,True,0,No user reviews,0,0,0
519633,True,0,No user reviews,0,0,0
519634,True,0,No user reviews,0,0,0
519640,True,0,No user reviews,0,0,0
519641,True,0,No user reviews,0,0,0
519642,True,0,No user reviews,0,0,0
519643,True,0,No user reviews,0,0,0
519644,True,0,No user reviews,0,0,0
519645,True,0,No user reviews,0,0,0
519646,True,0,No user reviews,0,0,0
519647,True,0,No user reviews,0,0,0
519648,True,0,No user reviews,0,0,0
519649,True,0,No user reviews,0,0,0
519650,True,0,No user reviews,0,0,0
519651,True,0,No user reviews,0,0,0
519652,True,0,No user reviews,0,0,0
519653,True,0,No user reviews,0,0,0
519654,True,0,No user reviews,0,0,0
519655,True,0,No user reviews,0,0,0
519670,True,0,No user reviews,0,0,0
519671,True,0,No user reviews,0,0,0
519672,True,0,No user reviews,0,0,0
519673,True,0,No user reviews,0,0,0
519674,True,0,No user reviews,0,0,0
519675,True,0,No user reviews,0,0,0
519676,True,0,No user reviews,0,0,0
519677,True,0,No user reviews,0,0,0
519678,True,0,No user reviews,0,0,0
519679,True,0,No user reviews,0,0,0
519680,True,0,No user reviews,0,0,0
519681,True,0,No user reviews,0,0,0
519682,True,0,No user reviews,0,0,0
519683,True,0,No user reviews,0,0,0
519684,True,0,No user reviews,0,0,0
519685,True,0,No user reviews,0,0,0
519686,True,0,No user reviews,0,0,0
519687,True,0,No user reviews,0,0,0
519688,True,0,No user reviews,0,0,0
519689,True,0,No user reviews,0,0,0
519690,True,0,No user reviews,0,0,0
519691,True,0,No user reviews,0,0,0
519692,True,0,No user reviews,0,0,0
519693,True,0,No user reviews,0,0,0
519694,True,0,No user reviews,0,0,0
519695,True,0,No user reviews,0,0,0
519696,True,0,No user reviews,0,0,0
519697,True,0,No user reviews,0,0,0
519698,True,0,No user reviews,0,0,0
519700,True,0,No user reviews,0,0,0
519701,True,0,No user reviews,0,0,0
519702,True,0,No user reviews,0,0,0
519703,True,0,No user reviews,0,0,0
519704,True,0,No user reviews,0,0,0
519705,True,0,No user reviews,0,0,0
519706,True,0,No user reviews,0,0,0
519707,True,0,No user reviews,0,0,0
519708,True,0,No user reviews,0,0,0
519709,True,0,No user reviews,0,0,0
519710,True,0,No user reviews,0,0,0
519711,True,0,No user reviews,0,0,0
519712,True,0,No user reviews,0,0,0
519713,True,0,No user reviews,0,0,0
519714,True,0,No user reviews,0,0,0
519715,True,0,No user reviews,0,0,0
519720,True,0,No user reviews,0,0,0
519721,True,0,No user reviews,0,0,0
519722,True,0,No user reviews,0,0,0
519723,True,0,No user reviews,0,0,0
519724,True,0,No user reviews,0,0,0
519725,True,0,No user reviews,0,0,0
519726,True,0,No user reviews,0,0,0
519727,True,0,No user reviews,0,0,0
519728,True,0,No user reviews,0,0,0
519729,True,0,No user reviews,0,0,0
519730,True,0,No user reviews,0,0,0
519731,True,0,No user reviews,0,0,0
519732,True,0,No user reviews,0,0,0
519733,True,0,No user reviews,0,0,0
519734,True,0,No user reviews,0,0,0
519735,True,0,No user reviews,0,0,0
519736,True,0,No user reviews,0,0,0
519737,True,0,No user reviews,0,0,0
519738,True,0,No user reviews,0,0,0
519740,True,0,No user reviews,0,0,0
519741,True,0,No user reviews,0,0,0
519742,True,0,No user reviews,0,0,0
519743,True,0,No user reviews,0,0,0
519744,True,0,No user reviews,0,0,0
519745,True,0,No user reviews,0,0,0
519746,True,0,No user reviews,0,0,0
519747,True,0,No user reviews,0,0,0
519748,True,0,No user reviews,0,0,0
519749,True,0,No user reviews,0,0,0
519750,True,0,No user reviews,0,0,0
519751,True,0,No user reviews,0,0,0
519752,True,0,No user reviews,0,0,0
519753,True,0,No user reviews,0,0,0
519754,True,0,No user reviews,0,0,0
519755,True,0,No user reviews,0,0,0
519756,True,0,No user reviews,0,0,0
519760,True,0,No user reviews,0,0,0
519761,True,0,No user reviews,0,0,0
519762,True,0,No user reviews,0,0,0
519763,True,0,No user reviews,0,0,0
519764,True,0,No user reviews,0,0,0
519765,True,0,No user reviews,0,0,0
519766,True,0,No user reviews,0,0,0
519767,True,0,No user reviews,0,0,0
519768,True,0,No user reviews,0,0,0
519769,True,0,No user reviews,0,0,0
519770,True,0,No user reviews,0,0,0
519780,True,0,No user reviews,0,0,0
519781,True,0,No user reviews,0,0,0
519782,True,0,No user reviews,0,0,0
519783,True,0,No user reviews,0,0,0
519784,True,0,No user reviews,0,0,0
519785,True,0,No user reviews,0,0,0
519786,True,0,No user reviews,0,0,0
519787,True,0,No user reviews,0,0,0
519788,True,0,No user reviews,0,0,0
519789,True,0,No user reviews,0,0,0
519790,True,0,No user reviews,0,0,0
519791,True,0,No user reviews,0,0,0
519800,True,0,No user reviews,0,0,0
519801,True,0,No user reviews,0,0,0
519802,True,0,No user reviews,0,0,0
519803,True,0,No user reviews,0,0,0
519804,True,0,No user reviews,0,0,0
519805,True,0,No user reviews,0,0,0
519806,True,0,No user reviews,0,0,0
519807,True,0,No user reviews,0,0,0
519808,True,0,No user reviews,0,0,0
519809,True,0,No user reviews,0,0,0
519810,True,0,No user reviews,0,0,0
519820,True,0,No user reviews,0,0,0
519821,True,0,No user reviews,0,0,0
519822,True,0,No user reviews,0,0,0
519823,True,0,No user reviews,0,0,0
519824,True,0,No user reviews,0,0,0
519825,True,0,No user reviews,0,0,0
519826,True,0,No user reviews,0,0,0
519827,True,0,No user reviews,0,0,0
519828,True,0,No user reviews,0,0,0
519829,True,0,No user reviews,0,0,0
519830,True,0,No user reviews,0,0,0
519831,True,0,No user reviews,0,0,0
519832,True,0,No user reviews,0,0,0
519833,True,0,No user reviews,0,0,0
519834,True,0,No user reviews,0,0,0
519835,True,0,No user reviews,0,0,0
519836,True,0,No user reviews,0,0,0
519840,True,0,No user reviews,0,0,0
519841,True,0,No user reviews,0,0,0
519842,True,0,No user reviews,0,0,0
519843,True,0,No user reviews,0,0,0
519844,True,0,No user reviews,0,0,0
519845,True,0,No user reviews,0,0,0
519846,True,0,No user reviews,0,0,0
519847,True,0,No user reviews,0,0,0
519848,True,0,No user reviews,0,0,0
519849,True,0,No user reviews,0,0,0
519850,True,0,No user reviews,0,0,0
519851,True,0,No user reviews,0,0,0
519852,True,0,No user reviews,0,0,0
519853,True,0,No user reviews,0,0,0
519854,True,0,No user reviews,0,0,0
519855,True,0,No user reviews,0,0,0
519856,True,0,No user reviews,0,0,0
519857,True,0,No user reviews,0,0,0
519858,True,0,No user reviews,0,0,0
519860,True,9,Overwhelmingly Positive,7384,128,7512
519870,True,0,4 user reviews,3,1,4
519880,True,0,No user reviews,0,0,0
519890,True,0,2 user reviews,1,1,2
519940,True,6,Mostly Positive,10,3,13
519950,True,0,No user reviews,0,0,0
519980,True,5,Mixed,7,4,11
519990,True,0,6 user reviews,2,4,6
520010,True,8,Very Positive,748,56,804
520030,True,0,No user reviews,0,0,0
520040,True,0,5 user reviews,3,2,5
520050,True,0,No user reviews,0,0,0
520051,True,0,No user reviews,0,0,0
520052,True,0,No user reviews,0,0,0
520053,True,0,No user reviews,0,0,0
520054,True,0,No user reviews,0,0,0
520055,True,0,No user reviews,0,0,0
520056,True,0,No user reviews,0,0,0
520057,True,0,No user reviews,0,0,0
520058,True,0,No user reviews,0,0,0
520059,True,0,No user reviews,0,0,0
520060,True,0,No user reviews,0,0,0
520061,True,0,No user reviews,0,0,0
520080,True,0,2 user reviews,1,1,2
520090,True,0,No user reviews,0,0,0
520100,True,0,No user reviews,0,0,0
520101,True,0,No user reviews,0,0,0
520102,True,0,No user reviews,0,0,0
520103,True,0,No user reviews,0,0,0
520104,True,0,No user reviews,0,0,0
520105,True,0,No user reviews,0,0,0
520106,True,0,No user reviews,0,0,0
520107,True,0,No user reviews,0,0,0
520108,True,0,No user reviews,0,0,0
520109,True,0,No user reviews,0,0,0
520110,True,0,No user reviews,0,0,0
520111,True,0,No user reviews,0,0,0
520112,True,0,No user reviews,0,0,0
520120,True,0,8 user reviews,5,3,8
520150,True,7,Positive,17,3,20
520160,True,0,No user reviews,0,0,0
520180,True,0,No user reviews,0,0,0
520190,True,0,No user reviews,0,0,0
520200,True,0,No user reviews,0,0,0
520210,True,4,Mostly Negative,3,7,10
520230,True,0,2 user reviews,2,0,2
520250,True,5,Mixed,13,8,21
520260,True,0,No user reviews,0,0,0
520270,True,6,Mostly Positive,30,12,42
520290,True,7,Positive,19,4,23
520300,True,0,3 user reviews,3,0,3
520310,True,0,1 user reviews,0,1,1
520320,True,0,1 user reviews,1,0,1
520340,True,0,No user reviews,0,0,0
520350,True,0,9 user reviews,5,4,9
520360,True,0,2 user reviews,2,0,2
520370,True,0,5 user reviews,4,1,5
520380,True,5,Mixed,14,12,26
520390,True,0,No user reviews,0,0,0
520420,True,0,No user reviews,0,0,0
520430,True,0,1 user reviews,1,0,1
520440,True,8,Very Positive,1612,85,1697
520470,True,6,Mostly Positive,24,8,32
520480,True,0,4 user reviews,4,0,4
520500,True,0,6 user reviews,4,2,6
520510,True,0,3 user reviews,2,1,3
520520,True,0,6 user reviews,2,4,6
520530,True,5,Mixed,14,20,34
520540,True,0,5 user reviews,5,0,5
520550,True,8,Very Positive,64,13,77
520570,True,0,No user reviews,0,0,0
520580,True,0,No user reviews,0,0,0
520590,True,0,No user reviews,0,0,0
520600,True,8,Very Positive,105,17,122
520610,True,6,Mostly Positive,22,9,31
520620,True,0,2 user reviews,2,0,2
520630,True,0,2 user reviews,0,2,2
520640,True,0,1 user reviews,1,0,1
520641,True,0,4 user reviews,4,0,4
520642,True,0,2 user reviews,2,0,2
520643,True,0,1 user reviews,1,0,1
520644,True,0,1 user reviews,1,0,1
520645,True,0,1 user reviews,1,0,1
520646,True,0,1 user reviews,1,0,1
520660,True,5,Mixed,11,5,16
520670,True,7,Positive,27,6,33
520680,True,5,Mixed,5,7,12
520700,True,0,No user reviews,0,0,0
520710,True,0,No user reviews,0,0,0
520720,True,6,Mostly Positive,469,164,633
520740,True,0,No user reviews,0,0,0
520750,True,7,Positive,11,1,12
520760,True,0,No user reviews,0,0,0
520761,True,0,No user reviews,0,0,0
520762,True,0,No user reviews,0,0,0
520763,True,0,No user reviews,0,0,0
520764,True,0,No user reviews,0,0,0
520765,True,0,No user reviews,0,0,0
520766,True,0,No user reviews,0,0,0
520767,True,0,No user reviews,0,0,0
520768,True,0,No user reviews,0,0,0
520769,True,0,No user reviews,0,0,0
520770,True,0,No user reviews,0,0,0
520771,True,0,No user reviews,0,0,0
520772,True,0,No user reviews,0,0,0
520780,True,0,3 user reviews,3,0,3
520810,True,0,2 user reviews,0,2,2
520820,True,7,Positive,17,1,18
520830,True,0,No user reviews,0,0,0
520840,True,5,Mixed,8,7,15
520850,True,7,Positive,41,3,44
520860,True,5,Mixed,21,13,34
520870,True,0,No user reviews,0,0,0
520871,True,0,2 user reviews,1,1,2
520872,True,0,No user reviews,0,0,0
520873,True,0,No user reviews,0,0,0
520900,True,5,Mixed,6,4,10
520910,True,0,3 user reviews,3,0,3
520930,True,0,6 user reviews,5,1,6
520940,True,6,Mostly Positive,302,115,417
520950,True,5,Mixed,252,113,365
520960,True,6,Mostly Positive,7,3,10
520970,True,0,No user reviews,0,0,0
520990,True,6,Mostly Positive,48,17,65
521000,True,0,5 user reviews,3,2,5
521010,True,0,1 user reviews,1,0,1
521070,True,0,No user reviews,0,0,0
521090,True,5,Mixed,9,4,13
521100,True,4,Mostly Negative,7,12,19
521110,True,0,No user reviews,0,0,0
521120,True,0,No user reviews,0,0,0
521121,True,0,No user reviews,0,0,0
521130,True,7,Positive,14,2,16
521140,True,0,1 user reviews,0,1,1
521150,True,8,Very Positive,683,148,831
521160,True,5,Mixed,15,9,24
521170,True,0,No user reviews,0,0,0
521200,True,7,Positive,15,0,15
521210,True,7,Positive,10,1,11
521220,True,8,Very Positive,73,14,87
521230,True,0,7 user reviews,7,0,7
521250,True,0,No user reviews,0,0,0
521260,True,0,No user reviews,0,0,0
521270,True,0,No user reviews,0,0,0
521280,True,7,Positive,19,2,21
521290,True,0,No user reviews,0,0,0
521300,True,0,3 user reviews,3,0,3
521310,True,0,1 user reviews,0,1,1
521320,True,0,No user reviews,0,0,0
521330,True,0,2 user reviews,2,0,2
521340,True,5,Mixed,43,31,74
521350,True,8,Very Positive,176,36,212
521370,True,0,No user reviews,0,0,0
521380,True,0,No user reviews,0,0,0
521420,True,5,Mixed,5,5,10
521430,True,6,Mostly Positive,8,3,11
521440,True,0,No user reviews,0,0,0
521450,True,5,Mixed,11,12,23
521470,True,0,9 user reviews,9,0,9
521480,True,0,2 user reviews,1,1,2
521500,True,8,Very Positive,69,15,84
521510,True,0,3 user reviews,2,1,3
521530,True,0,No user reviews,0,0,0
521540,True,7,Positive,19,4,23
521550,True,0,2 user reviews,1,1,2
521560,True,6,Mostly Positive,14,5,19
521570,True,0,8 user reviews,8,0,8
521580,True,5,Mixed,8,5,13
521590,True,5,Mixed,16,10,26
521600,True,0,6 user reviews,6,0,6
521610,True,0,7 user reviews,7,0,7
521620,True,7,Positive,9,1,10
521630,True,8,Very Positive,92,23,115
521650,True,0,3 user reviews,1,2,3
521660,True,0,No user reviews,0,0,0
521670,True,0,No user reviews,0,0,0
521680,True,0,2 user reviews,0,2,2
521690,True,0,2 user reviews,2,0,2
521700,True,0,1 user reviews,1,0,1
521710,True,0,No user reviews,0,0,0
521720,True,0,4 user reviews,1,3,4
521730,True,0,No user reviews,0,0,0
521740,True,0,No user reviews,0,0,0
521750,True,0,4 user reviews,3,1,4
521760,True,0,6 user reviews,5,1,6
521770,True,0,No user reviews,0,0,0
521790,True,5,Mixed,53,26,79
521800,True,7,Positive,17,1,18
521840,True,8,Very Positive,263,4,267
521850,True,0,2 user reviews,1,1,2
521860,True,6,Mostly Positive,18,5,23
521880,True,6,Mostly Positive,13,5,18
521890,True,6,Mostly Positive,1327,466,1793
521900,True,0,No user reviews,0,0,0
521901,True,0,No user reviews,0,0,0
521902,True,0,No user reviews,0,0,0
521903,True,0,No user reviews,0,0,0
521904,True,0,No user reviews,0,0,0
521905,True,0,No user reviews,0,0,0
521906,True,0,No user reviews,0,0,0
521920,True,8,Very Positive,125,19,144
521950,True,8,Very Positive,125,28,153
521962,True,0,No user reviews,0,0,0
521970,True,0,2 user reviews,0,2,2
521980,True,4,Mostly Negative,12,22,34
521990,True,0,8 user reviews,6,2,8
522000,True,0,5 user reviews,4,1,5
522010,True,0,6 user reviews,6,0,6
522020,True,6,Mostly Positive,71,20,91
522030,True,5,Mixed,52,30,82
522040,True,8,Very Positive,224,9,233
522050,True,0,5 user reviews,1,4,5
522070,True,0,No user reviews,0,0,0
522080,True,0,5 user reviews,5,0,5
522090,True,4,Mostly Negative,4,13,17
522120,True,8,Very Positive,101,5,106
522130,True,7,Positive,18,1,19
522140,True,0,No user reviews,0,0,0
522170,True,0,1 user reviews,0,1,1
522190,True,0,No user reviews,0,0,0
522200,True,5,Mixed,7,9,16
522210,True,8,Very Positive,97,20,117
522220,True,0,9 user reviews,6,3,9
522230,True,0,No user reviews,0,0,0
522240,True,6,Mostly Positive,42,12,54
522250,True,5,Mixed,16,7,23
522280,True,0,1 user reviews,1,0,1
522300,True,7,Positive,13,3,16
522331,True,0,2 user reviews,2,0,2
522333,True,0,7 user reviews,4,3,7
522334,True,0,7 user reviews,5,2,7
522335,True,0,No user reviews,0,0,0
522340,True,7,Positive,24,1,25
522470,True,8,Very Positive,854,120,974
522480,True,0,No user reviews,0,0,0
522490,True,8,Very Positive,54,1,55
522500,True,0,8 user reviews,5,3,8
522530,True,0,5 user reviews,2,3,5
522570,True,5,Mixed,28,40,68
522590,True,4,Mostly Negative,7,15,22
522600,True,0,No user reviews,0,0,0
522610,True,0,8 user reviews,6,2,8
522620,True,0,No user reviews,0,0,0
522630,True,0,No user reviews,0,0,0
522650,True,0,2 user reviews,2,0,2
522651,True,0,2 user reviews,2,0,2
522652,True,0,2 user reviews,2,0,2
522660,True,0,6 user reviews,3,3,6
522680,True,0,No user reviews,0,0,0
522690,True,5,Mixed,6,8,14
522700,True,0,7 user reviews,4,3,7
522710,True,7,Positive,17,0,17
522730,True,7,Positive,10,1,11
522740,True,0,9 user reviews,5,4,9
522750,True,0,2 user reviews,1,1,2
522770,True,0,No user reviews,0,0,0
522771,True,0,No user reviews,0,0,0
522772,True,0,No user reviews,0,0,0
522773,True,0,No user reviews,0,0,0
522774,True,0,No user reviews,0,0,0
522775,True,0,No user reviews,0,0,0
522776,True,0,No user reviews,0,0,0
522777,True,0,No user reviews,0,0,0
522778,True,0,No user reviews,0,0,0
522779,True,0,No user reviews,0,0,0
522780,True,0,No user reviews,0,0,0
522781,True,0,No user reviews,0,0,0
522790,True,0,No user reviews,0,0,0
522791,True,0,No user reviews,0,0,0
522792,True,0,No user reviews,0,0,0
522793,True,0,No user reviews,0,0,0
522794,True,0,No user reviews,0,0,0
522795,True,0,No user reviews,0,0,0
522796,True,0,No user reviews,0,0,0
522797,True,0,No user reviews,0,0,0
522798,True,0,No user reviews,0,0,0
522799,True,0,No user reviews,0,0,0
522800,True,0,No user reviews,0,0,0
522801,True,0,No user reviews,0,0,0
522810,True,0,No user reviews,0,0,0
522811,True,0,No user reviews,0,0,0
522812,True,0,No user reviews,0,0,0
522813,True,0,No user reviews,0,0,0
522814,True,0,No user reviews,0,0,0
522815,True,0,No user reviews,0,0,0
522816,True,0,No user reviews,0,0,0
522817,True,0,No user reviews,0,0,0
522818,True,0,No user reviews,0,0,0
522819,True,0,No user reviews,0,0,0
522820,True,0,No user reviews,0,0,0
522830,True,0,No user reviews,0,0,0
522840,True,0,No user reviews,0,0,0
522841,True,0,No user reviews,0,0,0
522842,True,0,No user reviews,0,0,0
522843,True,0,No user reviews,0,0,0
522844,True,0,No user reviews,0,0,0
522845,True,0,No user reviews,0,0,0
522846,True,0,No user reviews,0,0,0
522847,True,0,No user reviews,0,0,0
522848,True,0,No user reviews,0,0,0
522849,True,0,No user reviews,0,0,0
522850,True,0,No user reviews,0,0,0
522851,True,0,No user reviews,0,0,0
522860,True,0,No user reviews,0,0,0
522861,True,0,No user reviews,0,0,0
522862,True,0,No user reviews,0,0,0
522863,True,0,No user reviews,0,0,0
522864,True,0,No user reviews,0,0,0
522865,True,0,No user reviews,0,0,0
522866,True,0,No user reviews,0,0,0
522867,True,0,No user reviews,0,0,0
522868,True,0,No user reviews,0,0,0
522869,True,0,No user reviews,0,0,0
522870,True,0,No user reviews,0,0,0
522871,True,0,No user reviews,0,0,0
522880,True,6,Mostly Positive,36,11,47
522890,True,0,2 user reviews,0,2,2
522900,True,0,6 user reviews,6,0,6
522910,True,0,No user reviews,0,0,0
522930,True,0,No user reviews,0,0,0
522940,True,0,No user reviews,0,0,0
522950,True,0,1 user reviews,1,0,1
522960,True,0,4 user reviews,1,3,4
522980,True,0,No user reviews,0,0,0
522990,True,0,8 user reviews,8,0,8
523000,True,8,Very Positive,285,19,304
523030,True,7,Positive,24,2,26
523040,True,0,1 user reviews,1,0,1
523050,True,0,7 user reviews,7,0,7
523060,True,0,4 user reviews,2,2,4
523070,True,0,No user reviews,0,0,0
523080,True,5,Mixed,17,16,33
523090,True,7,Positive,27,3,30
523110,True,5,Mixed,30,32,62
523120,True,5,Mixed,119,79,198
523130,True,5,Mixed,7,6,13
523150,True,7,Positive,27,4,31
523160,True,6,Mostly Positive,10,4,14
523170,True,0,1 user reviews,1,0,1
523180,True,5,Mixed,7,4,11
523190,True,0,1 user reviews,0,1,1
523210,True,8,Very Positive,735,110,845
523220,True,0,2 user reviews,1,1,2
523230,True,7,Positive,12,2,14
523240,True,0,1 user reviews,1,0,1
523250,True,0,No user reviews,0,0,0
523260,True,0,No user reviews,0,0,0
523300,True,0,No user reviews,0,0,0
523301,True,0,No user reviews,0,0,0
523320,True,0,No user reviews,0,0,0
523321,True,0,No user reviews,0,0,0
523322,True,0,No user reviews,0,0,0
523323,True,0,No user reviews,0,0,0
523324,True,0,No user reviews,0,0,0
523325,True,0,No user reviews,0,0,0
523326,True,0,No user reviews,0,0,0
523327,True,0,No user reviews,0,0,0
523328,True,0,No user reviews,0,0,0
523329,True,0,No user reviews,0,0,0
523330,True,0,No user reviews,0,0,0
523331,True,0,No user reviews,0,0,0
523332,True,0,No user reviews,0,0,0
523333,True,0,No user reviews,0,0,0
523334,True,0,No user reviews,0,0,0
523335,True,0,No user reviews,0,0,0
523336,True,0,No user reviews,0,0,0
523337,True,0,No user reviews,0,0,0
523338,True,0,No user reviews,0,0,0
523339,True,0,No user reviews,0,0,0
523340,True,0,1 user reviews,1,0,1
523350,True,0,No user reviews,0,0,0
523360,True,0,No user reviews,0,0,0
523370,True,0,No user reviews,0,0,0
523380,True,0,6 user reviews,4,2,6
523390,True,0,No user reviews,0,0,0
523410,True,5,Mixed,7,4,11
523440,True,0,5 user reviews,5,0,5
523460,True,0,No user reviews,0,0,0
523470,True,0,No user reviews,0,0,0
523480,True,0,No user reviews,0,0,0
523481,True,0,No user reviews,0,0,0
523482,True,0,No user reviews,0,0,0
523483,True,0,No user reviews,0,0,0
523484,True,0,No user reviews,0,0,0
523485,True,0,No user reviews,0,0,0
523486,True,0,No user reviews,0,0,0
523487,True,0,No user reviews,0,0,0
523488,True,0,No user reviews,0,0,0
523489,True,0,No user reviews,0,0,0
523490,True,0,No user reviews,0,0,0
523500,True,5,Mixed,5,5,10
523501,True,0,6 user reviews,6,0,6
523502,True,0,5 user reviews,5,0,5
523503,True,0,2 user reviews,2,0,2
523504,True,0,4 user reviews,4,0,4
523505,True,0,3 user reviews,3,0,3
523506,True,0,4 user reviews,3,1,4
523507,True,0,4 user reviews,2,2,4
523508,True,4,Mostly Negative,5,8,13
523510,True,0,5 user reviews,4,1,5
523511,True,0,8 user reviews,5,3,8
523521,True,0,5 user reviews,3,2,5
523530,True,0,2 user reviews,1,1,2
523531,True,0,5 user reviews,5,0,5
523532,True,0,6 user reviews,5,1,6
523533,True,0,4 user reviews,3,1,4
523534,True,0,1 user reviews,1,0,1
523550,True,0,3 user reviews,2,1,3
523560,True,0,3 user reviews,1,2,3
523570,True,0,No user reviews,0,0,0
523580,True,0,No user reviews,0,0,0
523581,True,0,No user reviews,0,0,0
523582,True,0,No user reviews,0,0,0
523583,True,0,No user reviews,0,0,0
523590,True,0,No user reviews,0,0,0
523600,True,6,Mostly Positive,116,32,148
523610,True,4,Mostly Negative,7,13,20
523640,True,4,Mostly Negative,32,49,81
523650,True,6,Mostly Positive,482,205,687
523660,True,8,Very Positive,772,69,841
523670,True,0,2 user reviews,2,0,2
523680,True,0,6 user reviews,6,0,6
523690,True,0,1 user reviews,1,0,1
523710,True,5,Mixed,98,47,145
523720,True,0,9 user reviews,9,0,9
523730,True,5,Mixed,9,6,15
523740,True,0,2 user reviews,2,0,2
523750,True,0,No user reviews,0,0,0
523760,True,7,Positive,16,2,18
523770,True,0,No user reviews,0,0,0
523780,True,8,Very Positive,2449,148,2597
523810,True,5,Mixed,26,13,39
523820,True,0,No user reviews,0,0,0
523821,True,0,No user reviews,0,0,0
523840,True,0,2 user reviews,2,0,2
523850,True,0,1 user reviews,0,1,1
523851,True,0,1 user reviews,0,1,1
523852,True,0,1 user reviews,0,1,1
523860,True,0,No user reviews,0,0,0
523870,True,0,5 user reviews,5,0,5
523880,True,0,1 user reviews,0,1,1
523890,True,0,2 user reviews,2,0,2
523900,True,0,3 user reviews,3,0,3
523910,True,0,No user reviews,0,0,0
523940,True,5,Mixed,7,5,12
523950,True,0,No user reviews,0,0,0
523960,True,0,No user reviews,0,0,0
523970,True,0,5 user reviews,4,1,5
523980,True,0,2 user reviews,2,0,2
524000,True,0,No user reviews,0,0,0
524010,True,5,Mixed,114,76,190
524020,True,0,1 user reviews,0,1,1
524030,True,0,1 user reviews,0,1,1
524040,True,0,1 user reviews,1,0,1
524041,True,0,No user reviews,0,0,0
524042,True,0,No user reviews,0,0,0
524043,True,0,1 user reviews,1,0,1
524050,True,0,9 user reviews,8,1,9
524060,True,0,8 user reviews,5,3,8
524080,True,0,No user reviews,0,0,0
524120,True,7,Positive,25,5,30
524130,True,0,No user reviews,0,0,0
524140,True,0,No user reviews,0,0,0
524150,True,0,No user reviews,0,0,0
524170,True,0,No user reviews,0,0,0
524171,True,0,No user reviews,0,0,0
524172,True,0,No user reviews,0,0,0
524173,True,0,No user reviews,0,0,0
524174,True,0,No user reviews,0,0,0
524175,True,0,No user reviews,0,0,0
524176,True,0,1 user reviews,1,0,1
524190,True,0,No user reviews,0,0,0
524200,True,6,Mostly Positive,10,4,14
524210,True,0,No user reviews,0,0,0
524220,True,8,Very Positive,21048,2571,23619
524240,True,0,4 user reviews,2,2,4
524250,True,8,Very Positive,47,3,50
524260,True,7,Positive,20,2,22
524270,True,7,Positive,21,2,23
524280,True,5,Mixed,6,7,13
524290,True,6,Mostly Positive,8,3,11
524300,True,0,7 user reviews,5,2,7
524310,True,6,Mostly Positive,11,3,14
524320,True,7,Positive,8,2,10
524330,True,8,Very Positive,77,12,89
524350,True,0,1 user reviews,1,0,1
524360,True,0,7 user reviews,7,0,7
524380,True,5,Mixed,49,60,109
524390,True,5,Mixed,33,22,55
524410,True,0,No user reviews,0,0,0
524420,True,0,4 user reviews,1,3,4
524430,True,7,Positive,13,3,16
524440,True,0,No user reviews,0,0,0
524450,True,0,No user reviews,0,0,0
524490,True,7,Positive,18,2,20
524520,True,8,Very Positive,46,11,57
524530,True,0,No user reviews,0,0,0
524540,True,7,Positive,31,6,37
524550,True,0,No user reviews,0,0,0
524560,True,7,Positive,31,5,36
524570,True,0,No user reviews,0,0,0
524580,True,8,Very Positive,403,85,488
524590,True,0,2 user reviews,2,0,2
524591,True,0,1 user reviews,0,1,1
524592,True,0,1 user reviews,0,1,1
524593,True,0,2 user reviews,1,1,2
524594,True,0,3 user reviews,2,1,3
524595,True,0,1 user reviews,0,1,1
524596,True,0,1 user reviews,0,1,1
524600,True,7,Positive,32,8,40
524610,True,0,4 user reviews,0,4,4
524630,True,0,No user reviews,0,0,0
524640,True,8,Very Positive,112,20,132
524650,True,0,9 user reviews,8,1,9
524660,True,5,Mixed,11,8,19
524690,True,7,Positive,17,1,18
524700,True,0,No user reviews,0,0,0
524710,True,0,No user reviews,0,0,0
524720,True,0,No user reviews,0,0,0
524730,True,0,No user reviews,0,0,0
524740,True,0,No user reviews,0,0,0
524750,True,0,No user reviews,0,0,0
524760,True,0,No user reviews,0,0,0
524770,True,0,No user reviews,0,0,0
524780,True,0,No user reviews,0,0,0
524790,True,0,No user reviews,0,0,0
524800,True,0,No user reviews,0,0,0
524820,True,0,No user reviews,0,0,0
524830,True,0,No user reviews,0,0,0
524840,True,0,No user reviews,0,0,0
524850,True,8,Very Positive,350,39,389
524860,True,0,No user reviews,0,0,0
524870,True,0,No user reviews,0,0,0
524880,True,0,No user reviews,0,0,0
524910,True,8,Very Positive,167,18,185
524920,True,7,Positive,14,0,14
524940,True,0,3 user reviews,1,2,3
524970,True,5,Mixed,11,5,16
524990,True,0,No user reviews,0,0,0
525000,True,7,Positive,20,4,24
525011,True,5,Mixed,15,17,32
525012,True,0,5 user reviews,2,3,5
525014,True,0,1 user reviews,1,0,1
525015,True,0,1 user reviews,1,0,1
525016,True,0,1 user reviews,1,0,1
525017,True,0,2 user reviews,2,0,2
525018,True,0,No user reviews,0,0,0
525019,True,0,4 user reviews,4,0,4
525020,True,0,No user reviews,0,0,0
525030,True,5,Mixed,27,13,40
525031,True,5,Mixed,20,19,39
525032,True,0,1 user reviews,1,0,1
525033,True,0,No user reviews,0,0,0
525034,True,0,1 user reviews,1,0,1
525035,True,0,No user reviews,0,0,0
525036,True,0,1 user reviews,1,0,1
525037,True,0,4 user reviews,4,0,4
525040,True,8,Very Positive,139,17,156
525050,True,0,8 user reviews,8,0,8
525070,True,0,No user reviews,0,0,0
525080,True,5,Mixed,8,8,16
525100,True,0,1 user reviews,0,1,1
525140,True,0,No user reviews,0,0,0
525150,True,7,Positive,12,2,14
525180,True,0,No user reviews,0,0,0
525183,True,0,No user reviews,0,0,0
525185,True,0,No user reviews,0,0,0
525186,True,0,No user reviews,0,0,0
525190,True,0,4 user reviews,3,1,4
525210,True,6,Mostly Positive,12,5,17
525220,True,0,No user reviews,0,0,0
525221,True,0,No user reviews,0,0,0
525240,True,5,Mixed,45,39,84
525280,True,0,9 user reviews,4,5,9
525281,True,0,3 user reviews,1,2,3
525282,True,0,5 user reviews,3,2,5
525283,True,0,4 user reviews,4,0,4
525284,True,0,5 user reviews,5,0,5
525290,True,6,Mostly Positive,14,4,18
525300,True,5,Mixed,6,4,10
525320,True,0,No user reviews,0,0,0
525330,True,0,No user reviews,0,0,0
525340,True,0,No user reviews,0,0,0
525350,True,5,Mixed,6,8,14
525360,True,5,Mixed,13,6,19
525370,True,0,1 user reviews,0,1,1
525380,True,5,Mixed,87,45,132
525390,True,0,No user reviews,0,0,0
525420,True,5,Mixed,6,8,14
525430,True,7,Positive,12,1,13
525440,True,0,2 user reviews,1,1,2
525441,True,0,No user reviews,0,0,0
525442,True,0,2 user reviews,1,1,2
525450,True,7,Positive,17,0,17
525470,True,0,3 user reviews,3,0,3
525471,True,0,No user reviews,0,0,0
525480,True,8,Very Positive,1076,161,1237
525490,True,0,No user reviews,0,0,0
525500,True,6,Mostly Positive,13,4,17
525510,True,8,Very Positive,475,23,498
525520,True,0,8 user reviews,4,4,8
525530,True,4,Mostly Negative,2,8,10
525540,True,0,No user reviews,0,0,0
525550,True,0,6 user reviews,5,1,6
525580,True,0,No user reviews,0,0,0
525590,True,0,1 user reviews,0,1,1
525600,True,0,5 user reviews,2,3,5
525610,True,5,Mixed,69,52,121
525620,True,8,Very Positive,219,27,246
525640,True,8,Very Positive,363,47,410
525650,True,0,No user reviews,0,0,0
525660,True,0,7 user reviews,2,5,7
525680,True,8,Very Positive,230,23,253
525690,True,7,Positive,28,2,30
525700,True,5,Mixed,192,149,341
525710,True,0,No user reviews,0,0,0
525720,True,8,Very Positive,152,17,169
525730,True,0,No user reviews,0,0,0
525740,True,7,Positive,10,2,12
525750,True,0,No user reviews,0,0,0
525760,True,0,5 user reviews,5,0,5
525780,True,0,6 user reviews,5,1,6
525790,True,0,No user reviews,0,0,0
525791,True,0,No user reviews,0,0,0
525792,True,0,No user reviews,0,0,0
525793,True,0,No user reviews,0,0,0
525794,True,0,No user reviews,0,0,0
525795,True,0,No user reviews,0,0,0
525796,True,0,No user reviews,0,0,0
525797,True,0,No user reviews,0,0,0
525798,True,0,No user reviews,0,0,0
525799,True,0,No user reviews,0,0,0
525800,True,0,No user reviews,0,0,0
525801,True,0,No user reviews,0,0,0
525802,True,0,No user reviews,0,0,0
525803,True,0,No user reviews,0,0,0
525810,True,0,No user reviews,0,0,0
525811,True,0,No user reviews,0,0,0
525812,True,0,No user reviews,0,0,0
525813,True,0,No user reviews,0,0,0
525814,True,0,No user reviews,0,0,0
525815,True,0,No user reviews,0,0,0
525816,True,0,No user reviews,0,0,0
525817,True,0,No user reviews,0,0,0
525818,True,0,No user reviews,0,0,0
525819,True,0,No user reviews,0,0,0
525820,True,0,No user reviews,0,0,0
525821,True,0,No user reviews,0,0,0
525822,True,0,No user reviews,0,0,0
525823,True,0,No user reviews,0,0,0
525830,True,0,No user reviews,0,0,0
525831,True,0,No user reviews,0,0,0
525832,True,0,No user reviews,0,0,0
525833,True,0,No user reviews,0,0,0
525834,True,0,No user reviews,0,0,0
525835,True,0,No user reviews,0,0,0
525836,True,0,No user reviews,0,0,0
525837,True,0,No user reviews,0,0,0
525838,True,0,No user reviews,0,0,0
525839,True,0,No user reviews,0,0,0
525840,True,0,No user reviews,0,0,0
525841,True,0,No user reviews,0,0,0
525842,True,0,No user reviews,0,0,0
525860,True,0,No user reviews,0,0,0
525870,True,0,2 user reviews,2,0,2
525900,True,0,No user reviews,0,0,0
525910,True,7,Positive,13,1,14
525920,True,5,Mixed,47,33,80
525930,True,0,No user reviews,0,0,0
525950,True,7,Positive,9,2,11
525960,True,0,No user reviews,0,0,0
525970,True,0,4 user reviews,4,0,4
525971,True,0,2 user reviews,2,0,2
525980,True,0,No user reviews,0,0,0
526020,True,0,No user reviews,0,0,0
526030,True,0,1 user reviews,0,1,1
526040,True,6,Mostly Positive,14,5,19
526060,True,8,Very Positive,74,5,79
526070,True,0,No user reviews,0,0,0
526080,True,0,No user reviews,0,0,0
526081,True,0,No user reviews,0,0,0
526082,True,0,No user reviews,0,0,0
526083,True,0,No user reviews,0,0,0
526084,True,0,No user reviews,0,0,0
526085,True,0,No user reviews,0,0,0
526086,True,0,No user reviews,0,0,0
526087,True,0,No user reviews,0,0,0
526088,True,0,No user reviews,0,0,0
526089,True,0,No user reviews,0,0,0
526090,True,0,2 user reviews,1,1,2
526120,True,0,No user reviews,0,0,0
526121,True,0,1 user reviews,1,0,1
526122,True,0,No user reviews,0,0,0
526130,True,7,Positive,14,2,16
526140,True,8,Very Positive,243,42,285
526150,True,0,No user reviews,0,0,0
526160,True,6,Mostly Positive,947,343,1290
526200,True,0,No user reviews,0,0,0
526201,True,0,No user reviews,0,0,0
526202,True,0,No user reviews,0,0,0
526203,True,0,No user reviews,0,0,0
526204,True,0,No user reviews,0,0,0
526205,True,0,No user reviews,0,0,0
526206,True,0,No user reviews,0,0,0
526207,True,0,No user reviews,0,0,0
526208,True,0,No user reviews,0,0,0
526209,True,0,No user reviews,0,0,0
526210,True,0,No user reviews,0,0,0
526211,True,0,No user reviews,0,0,0
526212,True,0,No user reviews,0,0,0
526220,True,0,3 user reviews,3,0,3
526221,True,0,1 user reviews,1,0,1
526222,True,0,1 user reviews,1,0,1
526223,True,0,No user reviews,0,0,0
526224,True,0,No user reviews,0,0,0
526225,True,0,No user reviews,0,0,0
526226,True,0,No user reviews,0,0,0
526227,True,0,1 user reviews,1,0,1
526228,True,0,1 user reviews,1,0,1
526229,True,0,No user reviews,0,0,0
526230,True,0,No user reviews,0,0,0
526231,True,0,No user reviews,0,0,0
526232,True,0,No user reviews,0,0,0
526240,True,6,Mostly Positive,29,8,37
526260,True,0,No user reviews,0,0,0
526290,True,0,4 user reviews,0,4,4
526300,True,0,2 user reviews,1,1,2
526301,True,0,4 user reviews,3,1,4
526310,True,5,Mixed,6,4,10
526320,True,0,No user reviews,0,0,0
526340,True,0,No user reviews,0,0,0
526350,True,0,No user reviews,0,0,0
526370,True,6,Mostly Positive,106,36,142
526400,True,0,No user reviews,0,0,0
526410,True,0,6 user reviews,5,1,6
526411,True,0,5 user reviews,5,0,5
526420,True,0,No user reviews,0,0,0
526430,True,0,No user reviews,0,0,0
526440,True,0,4 user reviews,3,1,4
526450,True,0,4 user reviews,0,4,4
526470,True,0,No user reviews,0,0,0
526490,True,8,Very Positive,128,3,131
526510,True,7,Positive,17,2,19
526520,True,0,No user reviews,0,0,0
526530,True,0,3 user reviews,1,2,3
526531,True,0,8 user reviews,0,8,8
526532,True,0,2 user reviews,0,2,2
526540,True,5,Mixed,18,12,30
526550,True,0,5 user reviews,3,2,5
526560,True,0,No user reviews,0,0,0
526561,True,0,1 user reviews,1,0,1
526562,True,0,No user reviews,0,0,0
526570,True,0,No user reviews,0,0,0
526571,True,0,1 user reviews,1,0,1
526572,True,0,No user reviews,0,0,0
526580,True,0,No user reviews,0,0,0
526590,True,5,Mixed,10,7,17
526600,True,5,Mixed,10,7,17
526640,True,0,1 user reviews,1,0,1
526670,True,0,No user reviews,0,0,0
526680,True,0,2 user reviews,2,0,2
526720,True,0,No user reviews,0,0,0
526730,True,0,No user reviews,0,0,0
526740,True,4,Mostly Negative,121,195,316
526750,True,4,Mostly Negative,9,19,28
526760,True,0,No user reviews,0,0,0
526770,True,0,No user reviews,0,0,0
526780,True,0,9 user reviews,9,0,9
526800,True,0,9 user reviews,8,1,9
526830,True,0,No user reviews,0,0,0
526840,True,0,1 user reviews,0,1,1
526860,True,0,1 user reviews,1,0,1
526870,True,9,Overwhelmingly Positive,13586,388,13974
526880,True,0,5 user reviews,2,3,5
526890,True,0,9 user reviews,9,0,9
526910,True,0,3 user reviews,3,0,3
526920,True,0,5 user reviews,3,2,5
526960,True,0,5 user reviews,0,5,5
526980,True,0,5 user reviews,3,2,5
527000,True,0,5 user reviews,5,0,5
527010,True,0,1 user reviews,1,0,1
527020,True,0,1 user reviews,1,0,1
527021,True,0,8 user reviews,8,0,8
527022,True,0,2 user reviews,2,0,2
527040,True,0,2 user reviews,0,2,2
527070,True,8,Very Positive,305,38,343
527080,True,0,No user reviews,0,0,0
527090,True,0,No user reviews,0,0,0
527100,True,6,Mostly Positive,1142,311,1453
527110,True,0,7 user reviews,6,1,7
527120,True,0,No user reviews,0,0,0
527150,True,8,Very Positive,51,4,55
527160,True,5,Mixed,80,53,133
527170,True,0,1 user reviews,1,0,1
527180,True,0,9 user reviews,7,2,9
527190,True,8,Very Positive,91,3,94
527200,True,0,4 user reviews,4,0,4
527201,True,0,1 user reviews,1,0,1
527202,True,0,1 user reviews,1,0,1
527203,True,0,2 user reviews,2,0,2
527204,True,0,1 user reviews,0,1,1
527205,True,0,2 user reviews,2,0,2
527210,True,0,3 user reviews,2,1,3
527220,True,0,No user reviews,0,0,0
527230,True,8,Very Positive,3863,520,4383
527240,True,5,Mixed,18,17,35
527250,True,0,9 user reviews,7,2,9
527260,True,0,5 user reviews,4,1,5
527270,True,8,Very Positive,517,61,578
527280,True,5,Mixed,112,56,168
527290,True,8,Very Positive,125,19,144
527300,True,0,1 user reviews,1,0,1
527310,True,7,Positive,10,2,12
527320,True,0,9 user reviews,7,2,9
527330,True,0,4 user reviews,2,2,4
527340,True,8,Very Positive,281,68,349
527350,True,5,Mixed,11,5,16
527360,True,0,1 user reviews,0,1,1
527370,True,0,1 user reviews,1,0,1
527380,True,7,Positive,11,1,12
527390,True,0,No user reviews,0,0,0
527400,True,0,No user reviews,0,0,0
527401,True,0,No user reviews,0,0,0
527402,True,0,No user reviews,0,0,0
527403,True,0,No user reviews,0,0,0
527404,True,0,No user reviews,0,0,0
527405,True,0,No user reviews,0,0,0
527406,True,0,No user reviews,0,0,0
527407,True,0,No user reviews,0,0,0
527410,True,0,No user reviews,0,0,0
527420,True,6,Mostly Positive,29,9,38
527430,True,6,Mostly Positive,3523,1300,4823
527440,True,7,Positive,28,4,32
527450,True,6,Mostly Positive,281,120,401
527470,True,6,Mostly Positive,34,9,43
527510,True,3,Negative,4,18,22
527520,True,0,4 user reviews,1,3,4
527530,True,0,1 user reviews,0,1,1
527560,True,0,No user reviews,0,0,0
527580,True,6,Mostly Positive,13,4,17
527590,True,0,No user reviews,0,0,0
527610,True,6,Mostly Positive,19,6,25
527620,True,0,8 user reviews,8,0,8
527630,True,0,No user reviews,0,0,0
527640,True,0,1 user reviews,1,0,1
527641,True,0,1 user reviews,1,0,1
527642,True,0,No user reviews,0,0,0
527643,True,0,No user reviews,0,0,0
527644,True,0,No user reviews,0,0,0
527645,True,0,No user reviews,0,0,0
527646,True,0,No user reviews,0,0,0
527650,True,0,No user reviews,0,0,0
527651,True,0,No user reviews,0,0,0
527652,True,0,No user reviews,0,0,0
527660,True,0,No user reviews,0,0,0
527661,True,0,No user reviews,0,0,0
527662,True,0,No user reviews,0,0,0
527663,True,0,No user reviews,0,0,0
527664,True,0,No user reviews,0,0,0
527665,True,0,No user reviews,0,0,0
527680,True,0,No user reviews,0,0,0
527700,True,8,Very Positive,184,24,208
527710,True,8,Very Positive,82,20,102
527720,True,7,Positive,23,2,25
527730,True,0,9 user reviews,5,4,9
527740,True,7,Positive,28,7,35
527750,True,5,Mixed,12,18,30
527760,True,5,Mixed,14,12,26
527770,True,5,Mixed,4,6,10
527790,True,0,2 user reviews,0,2,2
527800,True,0,3 user reviews,1,2,3
527810,True,0,6 user reviews,5,1,6
527820,True,7,Positive,18,0,18
527830,True,0,No user reviews,0,0,0
527831,True,0,No user reviews,0,0,0
527832,True,0,No user reviews,0,0,0
527833,True,0,No user reviews,0,0,0
527834,True,0,No user reviews,0,0,0
527835,True,0,No user reviews,0,0,0
527836,True,0,No user reviews,0,0,0
527837,True,0,No user reviews,0,0,0
527838,True,0,No user reviews,0,0,0
527839,True,0,No user reviews,0,0,0
527840,True,0,No user reviews,0,0,0
527841,True,0,No user reviews,0,0,0
527842,True,0,No user reviews,0,0,0
527860,True,0,No user reviews,0,0,0
527880,True,0,4 user reviews,2,2,4
527890,True,0,4 user reviews,3,1,4
527900,True,5,Mixed,6,4,10
527910,True,0,6 user reviews,5,1,6
527920,True,0,9 user reviews,8,1,9
527930,True,0,3 user reviews,1,2,3
527940,True,0,3 user reviews,3,0,3
527950,True,5,Mixed,4,6,10
527960,True,0,3 user reviews,3,0,3
527980,True,0,No user reviews,0,0,0
527990,True,5,Mixed,56,25,81
528000,True,0,No user reviews,0,0,0
528010,True,5,Mixed,11,11,22
528020,True,0,4 user reviews,3,1,4
528040,True,0,No user reviews,0,0,0
528050,True,7,Positive,12,0,12
528051,True,7,Positive,11,1,12
528052,True,0,4 user reviews,4,0,4
528053,True,0,8 user reviews,8,0,8
528055,True,7,Positive,18,1,19
528056,True,7,Positive,17,0,17
528057,True,7,Positive,18,1,19
528058,True,0,4 user reviews,3,1,4
528060,True,0,No user reviews,0,0,0
528070,True,6,Mostly Positive,9,3,12
528110,True,7,Positive,14,0,14
528120,True,7,Positive,31,3,34
528140,True,0,No user reviews,0,0,0
528160,True,5,Mixed,72,31,103
528180,True,5,Mixed,9,13,22
528190,True,0,4 user reviews,2,2,4
528200,True,8,Very Positive,465,110,575
528220,True,0,No user reviews,0,0,0
528230,True,9,Overwhelmingly Positive,3384,109,3493
528250,True,6,Mostly Positive,29,8,37
528260,True,6,Mostly Positive,34,11,45
528270,True,7,Positive,25,3,28
528280,True,0,No user reviews,0,0,0
528290,True,0,1 user reviews,1,0,1
528300,True,5,Mixed,32,14,46
528310,True,0,3 user reviews,1,2,3
528330,True,6,Mostly Positive,11,3,14
528340,True,0,No user reviews,0,0,0
528341,True,0,No user reviews,0,0,0
528342,True,0,No user reviews,0,0,0
528343,True,0,No user reviews,0,0,0
528344,True,0,No user reviews,0,0,0
528345,True,0,No user reviews,0,0,0
528346,True,0,No user reviews,0,0,0
528347,True,0,No user reviews,0,0,0
528348,True,0,No user reviews,0,0,0
528349,True,0,No user reviews,0,0,0
528350,True,0,No user reviews,0,0,0
528351,True,0,No user reviews,0,0,0
528352,True,0,No user reviews,0,0,0
528360,True,0,No user reviews,0,0,0
528361,True,0,No user reviews,0,0,0
528362,True,0,No user reviews,0,0,0
528363,True,0,No user reviews,0,0,0
528364,True,0,No user reviews,0,0,0
528365,True,0,No user reviews,0,0,0
528366,True,0,No user reviews,0,0,0
528367,True,0,No user reviews,0,0,0
528368,True,0,No user reviews,0,0,0
528369,True,0,No user reviews,0,0,0
528370,True,0,No user reviews,0,0,0
528371,True,0,No user reviews,0,0,0
528372,True,0,No user reviews,0,0,0
528380,True,0,No user reviews,0,0,0
528381,True,0,No user reviews,0,0,0
528382,True,0,No user reviews,0,0,0
528383,True,0,No user reviews,0,0,0
528384,True,0,No user reviews,0,0,0
528385,True,0,No user reviews,0,0,0
528386,True,0,No user reviews,0,0,0
528387,True,0,No user reviews,0,0,0
528388,True,0,No user reviews,0,0,0
528389,True,0,No user reviews,0,0,0
528390,True,0,No user reviews,0,0,0
528391,True,0,No user reviews,0,0,0
528392,True,0,No user reviews,0,0,0
528420,True,0,2 user reviews,2,0,2
528430,True,6,Mostly Positive,20,8,28
528450,True,0,2 user reviews,1,1,2
528460,True,5,Mixed,66,34,100
528480,True,0,1 user reviews,1,0,1
528490,True,0,1 user reviews,1,0,1
528510,True,6,Mostly Positive,35,15,50
528520,True,0,No user reviews,0,0,0
528530,True,0,No user reviews,0,0,0
528550,True,6,Mostly Positive,349,104,453
528580,True,0,1 user reviews,1,0,1
528590,True,7,Positive,14,1,15
528610,True,6,Mostly Positive,166,71,237
528620,True,5,Mixed,16,8,24
528630,True,0,No user reviews,0,0,0
528640,True,5,Mixed,31,37,68
528660,True,6,Mostly Positive,79,22,101
528670,True,0,3 user reviews,3,0,3
528690,True,0,No user reviews,0,0,0
528700,True,0,7 user reviews,7,0,7
528710,True,0,No user reviews,0,0,0
528720,True,7,Positive,27,2,29
528730,True,6,Mostly Positive,44,17,61
528740,True,4,Mostly Negative,6,12,18
528770,True,0,2 user reviews,2,0,2
528790,True,0,1 user reviews,0,1,1
528810,True,0,1 user reviews,1,0,1
528820,True,5,Mixed,18,17,35
528860,True,0,9 user reviews,9,0,9
528870,True,0,No user reviews,0,0,0
528880,True,0,No user reviews,0,0,0
528881,True,0,No user reviews,0,0,0
528882,True,0,No user reviews,0,0,0
528883,True,0,No user reviews,0,0,0
528884,True,0,No user reviews,0,0,0
528885,True,0,No user reviews,0,0,0
528890,True,0,No user reviews,0,0,0
528891,True,0,No user reviews,0,0,0
528892,True,0,No user reviews,0,0,0
528900,True,0,6 user reviews,2,4,6
528910,True,0,5 user reviews,2,3,5
528930,True,0,3 user reviews,1,2,3
528950,True,0,3 user reviews,3,0,3
528960,True,7,Positive,16,2,18
528970,True,0,7 user reviews,2,5,7
528980,True,5,Mixed,7,4,11
528990,True,0,8 user reviews,8,0,8
529010,True,0,4 user reviews,1,3,4
529020,True,7,Positive,33,5,38
529030,True,0,No user reviews,0,0,0
529040,True,0,7 user reviews,6,1,7
529050,True,7,Positive,16,0,16
529060,True,4,Mostly Negative,32,58,90
529070,True,0,No user reviews,0,0,0
529090,True,0,2 user reviews,1,1,2
529100,True,7,Positive,30,1,31
529110,True,5,Mixed,53,26,79
529130,True,5,Mixed,30,17,47
529140,True,0,3 user reviews,3,0,3
529150,True,7,Positive,27,0,27
529160,True,8,Very Positive,87,13,100
529170,True,0,1 user reviews,0,1,1
529180,True,5,Mixed,2395,1856,4251
529190,True,0,No user reviews,0,0,0
529200,True,0,No user reviews,0,0,0
529240,True,5,Mixed,31,42,73
529260,True,0,2 user reviews,1,1,2
529280,True,0,7 user reviews,4,3,7
529310,True,0,No user reviews,0,0,0
529350,True,0,6 user reviews,4,2,6
529360,True,6,Mostly Positive,22,6,28
529390,True,8,Very Positive,93,7,100
529400,True,0,No user reviews,0,0,0
529410,True,7,Positive,28,7,35
529420,True,0,2 user reviews,2,0,2
529430,True,0,1 user reviews,1,0,1
529440,True,8,Very Positive,281,31,312
529450,True,6,Mostly Positive,18,6,24
529470,True,0,1 user reviews,1,0,1
529490,True,5,Mixed,56,26,82
529500,True,5,Mixed,20,10,30
529520,True,8,Very Positive,358,21,379
529530,True,0,No user reviews,0,0,0
529531,True,0,No user reviews,0,0,0
529540,True,0,No user reviews,0,0,0
529550,True,0,No user reviews,0,0,0
529580,True,0,2 user reviews,1,1,2
529590,True,8,Very Positive,182,42,224
529600,True,0,No user reviews,0,0,0
529610,True,0,3 user reviews,3,0,3
529620,True,7,Positive,30,6,36
529630,True,5,Mixed,8,5,13
529640,True,0,No user reviews,0,0,0
529660,True,8,Very Positive,254,34,288
529670,True,0,3 user reviews,2,1,3
529680,True,0,No user reviews,0,0,0
529690,True,7,Positive,10,0,10
529700,True,7,Positive,45,4,49
529720,True,0,7 user reviews,4,3,7
529730,True,0,2 user reviews,2,0,2
529740,True,0,No user reviews,0,0,0
529750,True,0,1 user reviews,1,0,1
529760,True,5,Mixed,6,8,14
529770,True,0,5 user reviews,4,1,5
529780,True,7,Positive,20,4,24
529790,True,0,9 user reviews,7,2,9
529820,True,5,Mixed,5,6,11
529830,True,5,Mixed,33,17,50
529840,True,0,No user reviews,0,0,0
529850,True,0,No user reviews,0,0,0
529860,True,0,7 user reviews,4,3,7
529870,True,0,6 user reviews,4,2,6
529890,True,6,Mostly Positive,42,12,54
529900,True,8,Very Positive,60,15,75
529910,True,5,Mixed,54,66,120
529920,True,0,4 user reviews,1,3,4
529930,True,6,Mostly Positive,51,17,68
529940,True,0,3 user reviews,2,1,3
529950,True,8,Very Positive,85,11,96
529970,True,7,Positive,21,3,24
529980,True,0,No user reviews,0,0,0
530010,True,0,1 user reviews,1,0,1
530020,True,6,Mostly Positive,42,16,58
530030,True,0,No user reviews,0,0,0
530040,True,5,Mixed,44,39,83
530050,True,0,No user reviews,0,0,0
530060,True,5,Mixed,24,35,59
530070,True,6,Mostly Positive,1736,710,2446
530080,True,0,5 user reviews,1,4,5
530090,True,0,No user reviews,0,0,0
530110,True,5,Mixed,9,6,15
530120,True,8,Very Positive,323,13,336
530130,True,0,8 user reviews,7,1,8
530140,True,0,4 user reviews,4,0,4
530150,True,0,No user reviews,0,0,0
530151,True,0,No user reviews,0,0,0
530152,True,0,1 user reviews,1,0,1
530160,True,6,Mostly Positive,29,11,40
530170,True,0,1 user reviews,0,1,1
530180,True,0,2 user reviews,2,0,2
530190,True,0,No user reviews,0,0,0
530200,True,0,No user reviews,0,0,0
530210,True,0,No user reviews,0,0,0
530240,True,4,Mostly Negative,5,10,15
530250,True,0,No user reviews,0,0,0
530280,True,0,No user reviews,0,0,0
530290,True,0,3 user reviews,3,0,3
530300,True,0,3 user reviews,3,0,3
530310,True,0,2 user reviews,2,0,2
530320,True,9,Overwhelmingly Positive,767,19,786
530330,True,6,Mostly Positive,36,15,51
530340,True,0,No user reviews,0,0,0
530350,True,8,Very Positive,263,19,282
530360,True,7,Positive,19,1,20
530370,True,7,Positive,11,1,12
530390,True,8,Very Positive,347,16,363
530400,True,0,1 user reviews,1,0,1
530410,True,0,No user reviews,0,0,0
530420,True,0,No user reviews,0,0,0
530421,True,0,No user reviews,0,0,0
530422,True,0,No user reviews,0,0,0
530423,True,0,No user reviews,0,0,0
530424,True,0,No user reviews,0,0,0
530425,True,0,No user reviews,0,0,0
530426,True,0,No user reviews,0,0,0
530427,True,0,No user reviews,0,0,0
530428,True,0,No user reviews,0,0,0
530429,True,0,No user reviews,0,0,0
530430,True,0,No user reviews,0,0,0
530431,True,0,No user reviews,0,0,0
530432,True,0,No user reviews,0,0,0
530433,True,0,No user reviews,0,0,0
530434,True,0,No user reviews,0,0,0
530435,True,0,No user reviews,0,0,0
530436,True,0,No user reviews,0,0,0
530437,True,0,No user reviews,0,0,0
530438,True,0,No user reviews,0,0,0
530439,True,0,No user reviews,0,0,0
530440,True,0,No user reviews,0,0,0
530441,True,0,No user reviews,0,0,0
530442,True,0,No user reviews,0,0,0
530443,True,0,No user reviews,0,0,0
530444,True,0,No user reviews,0,0,0
530445,True,0,No user reviews,0,0,0
530446,True,0,No user reviews,0,0,0
530447,True,0,No user reviews,0,0,0
530448,True,0,No user reviews,0,0,0
530449,True,0,No user reviews,0,0,0
530450,True,0,No user reviews,0,0,0
530451,True,0,No user reviews,0,0,0
530452,True,0,No user reviews,0,0,0
530453,True,0,No user reviews,0,0,0
530454,True,0,No user reviews,0,0,0
530455,True,0,No user reviews,0,0,0
530456,True,0,No user reviews,0,0,0
530457,True,0,No user reviews,0,0,0
530458,True,0,No user reviews,0,0,0
530459,True,0,No user reviews,0,0,0
530460,True,0,No user reviews,0,0,0
530461,True,0,No user reviews,0,0,0
530462,True,0,No user reviews,0,0,0
530463,True,0,No user reviews,0,0,0
530464,True,0,No user reviews,0,0,0
530470,True,0,No user reviews,0,0,0
530480,True,0,1 user reviews,1,0,1
530490,True,0,1 user reviews,1,0,1
530500,True,0,2 user reviews,0,2,2
530510,True,7,Positive,13,3,16
530520,True,5,Mixed,7,6,13
530530,True,0,1 user reviews,0,1,1
530540,True,4,Mostly Negative,4,8,12
530550,True,0,7 user reviews,6,1,7
530560,True,4,Mostly Negative,54,143,197
530570,True,0,No user reviews,0,0,0
530580,True,6,Mostly Positive,21,8,29
530590,True,0,No user reviews,0,0,0
530595,True,0,5 user reviews,4,1,5
530596,True,0,6 user reviews,6,0,6
530597,True,0,5 user reviews,5,0,5
530598,True,0,4 user reviews,4,0,4
530599,True,0,6 user reviews,3,3,6
530600,True,0,No user reviews,0,0,0
530610,True,5,Mixed,38,18,56
530611,True,8,Very Positive,162,28,190
530620,True,8,Very Positive,164,28,192
530630,True,5,Mixed,96,65,161
530640,True,0,2 user reviews,2,0,2
530641,True,0,1 user reviews,1,0,1
530650,True,0,4 user reviews,2,2,4
530660,True,0,9 user reviews,9,0,9
530661,True,0,3 user reviews,3,0,3
530670,True,0,No user reviews,0,0,0
530671,True,0,No user reviews,0,0,0
530690,True,0,7 user reviews,6,1,7
530700,True,5,Mixed,7,4,11
530710,True,8,Very Positive,286,41,327
530711,True,8,Very Positive,776,92,868
530720,True,0,3 user reviews,2,1,3
530730,True,0,No user reviews,0,0,0
530760,True,5,Mixed,318,388,706
530780,True,5,Mixed,163,108,271
530810,True,0,No user reviews,0,0,0
530820,True,0,3 user reviews,1,2,3
530830,True,0,9 user reviews,7,2,9
530840,True,0,No user reviews,0,0,0
530860,True,0,4 user reviews,1,3,4
530870,True,0,No user reviews,0,0,0
530890,True,8,Very Positive,1176,209,1385
530920,True,6,Mostly Positive,96,27,123
530930,True,5,Mixed,15,12,27
530940,True,0,1 user reviews,1,0,1
530950,True,5,Mixed,79,37,116
530960,True,5,Mixed,51,31,82
530970,True,0,No user reviews,0,0,0
530990,True,0,No user reviews,0,0,0
531010,True,0,No user reviews,0,0,0
531050,True,5,Mixed,75,40,115
531060,True,0,No user reviews,0,0,0
531070,True,0,No user reviews,0,0,0
531080,True,0,7 user reviews,6,1,7
531110,True,7,Positive,10,2,12
531120,True,0,No user reviews,0,0,0
531130,True,8,Very Positive,300,24,324
531131,True,8,Very Positive,315,27,342
531140,True,6,Mostly Positive,19,7,26
531150,True,0,5 user reviews,5,0,5
531151,True,0,5 user reviews,5,0,5
531152,True,0,2 user reviews,2,0,2
531153,True,0,1 user reviews,1,0,1
531154,True,0,No user reviews,0,0,0
531155,True,0,1 user reviews,1,0,1
531156,True,0,2 user reviews,2,0,2
531157,True,0,2 user reviews,2,0,2
531158,True,0,1 user reviews,1,0,1
531159,True,0,No user reviews,0,0,0
531160,True,0,4 user reviews,4,0,4
531161,True,0,2 user reviews,2,0,2
531162,True,0,No user reviews,0,0,0
531163,True,0,4 user reviews,4,0,4
531164,True,0,No user reviews,0,0,0
531165,True,0,3 user reviews,2,1,3
531166,True,0,4 user reviews,4,0,4
531167,True,0,No user reviews,0,0,0
531168,True,0,No user reviews,0,0,0
531169,True,0,1 user reviews,1,0,1
531170,True,0,1 user reviews,1,0,1
531171,True,0,No user reviews,0,0,0
531172,True,0,No user reviews,0,0,0
531180,True,8,Very Positive,48,10,58
531190,True,0,1 user reviews,1,0,1
531200,True,0,2 user reviews,1,1,2
531210,True,0,No user reviews,0,0,0
531220,True,0,No user reviews,0,0,0
531240,True,0,3 user reviews,2,1,3
531270,True,6,Mostly Positive,182,78,260
531310,True,0,No user reviews,0,0,0
531340,True,0,No user reviews,0,0,0
531360,True,0,No user reviews,0,0,0
531390,True,0,No user reviews,0,0,0
531430,True,0,No user reviews,0,0,0
531450,True,0,No user reviews,0,0,0
531460,True,0,No user reviews,0,0,0
531480,True,0,5 user reviews,3,2,5
531500,True,0,1 user reviews,0,1,1
531510,True,9,Overwhelmingly Positive,4059,89,4148
531520,True,0,3 user reviews,1,2,3
531530,True,7,Positive,41,8,49
531540,True,0,3 user reviews,1,2,3
531550,True,0,No user reviews,0,0,0
531560,True,0,No user reviews,0,0,0
531570,True,0,No user reviews,0,0,0
531580,True,0,No user reviews,0,0,0
531590,True,0,1 user reviews,1,0,1
531600,True,0,No user reviews,0,0,0
531601,True,0,No user reviews,0,0,0
531630,True,0,No user reviews,0,0,0
531640,True,8,Very Positive,118,28,146
531650,True,0,No user reviews,0,0,0
531660,True,6,Mostly Positive,114,30,144
531680,True,8,Very Positive,134,33,167
531720,True,0,No user reviews,0,0,0
531730,True,7,Positive,33,1,34
531740,True,6,Mostly Positive,26,11,37
531750,True,0,No user reviews,0,0,0
531770,True,0,5 user reviews,5,0,5
531780,True,5,Mixed,9,5,14
531800,True,5,Mixed,8,4,12
531810,True,0,No user reviews,0,0,0
531830,True,0,No user reviews,0,0,0
531850,True,0,No user reviews,0,0,0
531860,True,0,1 user reviews,0,1,1
531870,True,0,No user reviews,0,0,0
531880,True,0,No user reviews,0,0,0
531890,True,0,3 user reviews,2,1,3
531910,True,7,Positive,19,1,20
531920,True,0,3 user reviews,2,1,3
531930,True,6,Mostly Positive,210,56,266
531940,True,0,No user reviews,0,0,0
531950,True,0,No user reviews,0,0,0
531960,True,5,Mixed,10,5,15
531980,True,5,Mixed,17,10,27
531990,True,0,No user reviews,0,0,0
532000,True,0,No user reviews,0,0,0
532010,True,0,No user reviews,0,0,0
532021,True,7,Positive,39,1,40
532030,True,4,Mostly Negative,19,32,51
532050,True,0,No user reviews,0,0,0
532060,True,0,No user reviews,0,0,0
532070,True,0,1 user reviews,1,0,1
532080,True,0,2 user reviews,1,1,2
532090,True,0,8 user reviews,7,1,8
532100,True,0,No user reviews,0,0,0
532110,True,9,Overwhelmingly Positive,725,34,759
532120,True,7,Positive,8,2,10
532140,True,0,No user reviews,0,0,0
532170,True,7,Positive,41,6,47
532180,True,0,No user reviews,0,0,0
532190,True,8,Very Positive,386,31,417
532200,True,0,No user reviews,0,0,0
532210,True,8,Very Positive,4617,1120,5737
532230,True,0,No user reviews,0,0,0
532240,True,0,2 user reviews,1,1,2
532260,True,4,Mostly Negative,4,9,13
532270,True,8,Very Positive,92,18,110
532280,True,0,No user reviews,0,0,0
532290,True,7,Positive,21,5,26
532310,True,0,No user reviews,0,0,0
532320,True,8,Very Positive,85,9,94
532330,True,0,No user reviews,0,0,0
532440,True,0,No user reviews,0,0,0
532470,True,0,7 user reviews,6,1,7
532540,True,0,1 user reviews,1,0,1
532550,True,0,No user reviews,0,0,0
532600,True,0,1 user reviews,0,1,1
532610,True,0,No user reviews,0,0,0
532620,True,0,3 user reviews,3,0,3
532621,True,0,2 user reviews,2,0,2
532660,True,0,8 user reviews,4,4,8
532670,True,0,3 user reviews,1,2,3
532690,True,5,Mixed,7,5,12
532700,True,0,4 user reviews,3,1,4
532720,True,7,Positive,10,0,10
532730,True,0,1 user reviews,1,0,1
532740,True,0,No user reviews,0,0,0
532750,True,6,Mostly Positive,29,8,37
532770,True,0,5 user reviews,5,0,5
532790,True,0,No user reviews,0,0,0
532800,True,0,3 user reviews,3,0,3
532810,True,0,No user reviews,0,0,0
532820,True,5,Mixed,5,5,10
532840,True,6,Mostly Positive,153,60,213
532850,True,0,1 user reviews,1,0,1
532860,True,0,No user reviews,0,0,0
532890,True,0,8 user reviews,5,3,8
532900,True,0,3 user reviews,3,0,3
532920,True,5,Mixed,49,24,73
532940,True,0,1 user reviews,1,0,1
532950,True,3,Negative,3,13,16
532970,True,0,No user reviews,0,0,0
532980,True,7,Positive,26,0,26
533010,True,5,Mixed,15,12,27
533030,True,0,4 user reviews,1,3,4
533040,True,0,9 user reviews,8,1,9
533050,True,6,Mostly Positive,8,3,11
533060,True,0,6 user reviews,5,1,6
533070,True,0,4 user reviews,4,0,4
533080,True,0,4 user reviews,2,2,4
533090,True,0,6 user reviews,4,2,6
533100,True,0,No user reviews,0,0,0
533110,True,5,Mixed,103,52,155
533140,True,0,No user reviews,0,0,0
533170,True,4,Mostly Negative,21,46,67
533180,True,3,Negative,1,14,15
533190,True,0,No user reviews,0,0,0
533200,True,0,No user reviews,0,0,0
533220,True,0,No user reviews,0,0,0
533230,True,0,No user reviews,0,0,0
533240,True,0,1 user reviews,1,0,1
533260,True,6,Mostly Positive,10,4,14
533280,True,0,No user reviews,0,0,0
533300,True,8,Very Positive,1595,145,1740
533310,True,0,No user reviews,0,0,0
533330,True,5,Mixed,14,16,30
533340,True,4,Mostly Negative,5,20,25
533360,True,0,No user reviews,0,0,0
533370,True,0,No user reviews,0,0,0
533371,True,0,No user reviews,0,0,0
533372,True,0,No user reviews,0,0,0
533373,True,0,No user reviews,0,0,0
533374,True,0,No user reviews,0,0,0
533375,True,0,No user reviews,0,0,0
533376,True,0,No user reviews,0,0,0
533377,True,0,No user reviews,0,0,0
533378,True,0,No user reviews,0,0,0
533379,True,0,No user reviews,0,0,0
533380,True,0,No user reviews,0,0,0
533381,True,0,No user reviews,0,0,0
533382,True,0,No user reviews,0,0,0
533390,True,0,No user reviews,0,0,0
533391,True,0,No user reviews,0,0,0
533392,True,0,No user reviews,0,0,0
533393,True,0,No user reviews,0,0,0
533394,True,0,No user reviews,0,0,0
533395,True,0,No user reviews,0,0,0
533396,True,0,No user reviews,0,0,0
533397,True,0,No user reviews,0,0,0
533398,True,0,No user reviews,0,0,0
533399,True,0,No user reviews,0,0,0
533400,True,0,No user reviews,0,0,0
533401,True,0,No user reviews,0,0,0
533402,True,0,No user reviews,0,0,0
533410,True,0,No user reviews,0,0,0
533411,True,0,No user reviews,0,0,0
533412,True,0,No user reviews,0,0,0
533413,True,0,No user reviews,0,0,0
533414,True,0,No user reviews,0,0,0
533415,True,0,No user reviews,0,0,0
533416,True,0,No user reviews,0,0,0
533417,True,0,No user reviews,0,0,0
533418,True,0,No user reviews,0,0,0
533419,True,0,No user reviews,0,0,0
533420,True,0,No user reviews,0,0,0
533421,True,0,No user reviews,0,0,0
533422,True,0,No user reviews,0,0,0
533430,True,0,No user reviews,0,0,0
533431,True,0,No user reviews,0,0,0
533432,True,0,No user reviews,0,0,0
533433,True,0,No user reviews,0,0,0
533434,True,0,No user reviews,0,0,0
533435,True,0,No user reviews,0,0,0
533436,True,0,No user reviews,0,0,0
533437,True,0,No user reviews,0,0,0
533438,True,0,No user reviews,0,0,0
533439,True,0,No user reviews,0,0,0
533440,True,0,No user reviews,0,0,0
533441,True,0,No user reviews,0,0,0
533442,True,0,No user reviews,0,0,0
533450,True,0,No user reviews,0,0,0
533451,True,0,No user reviews,0,0,0
533452,True,0,No user reviews,0,0,0
533453,True,0,No user reviews,0,0,0
533454,True,0,No user reviews,0,0,0
533455,True,0,No user reviews,0,0,0
533456,True,0,No user reviews,0,0,0
533457,True,0,No user reviews,0,0,0
533458,True,0,No user reviews,0,0,0
533459,True,0,No user reviews,0,0,0
533460,True,0,No user reviews,0,0,0
533461,True,0,No user reviews,0,0,0
533462,True,0,No user reviews,0,0,0
533470,True,0,1 user reviews,0,1,1
533480,True,5,Mixed,128,56,184
533520,True,0,1 user reviews,1,0,1
533530,True,0,1 user reviews,1,0,1
533540,True,0,No user reviews,0,0,0
533550,True,0,No user reviews,0,0,0
533551,True,0,No user reviews,0,0,0
533552,True,0,1 user reviews,1,0,1
533553,True,0,No user reviews,0,0,0
533554,True,0,No user reviews,0,0,0
533555,True,0,No user reviews,0,0,0
533556,True,0,1 user reviews,1,0,1
533557,True,0,6 user reviews,3,3,6
533558,True,0,3 user reviews,2,1,3
533559,True,0,No user reviews,0,0,0
533560,True,0,2 user reviews,2,0,2
533570,True,0,2 user reviews,1,1,2
533580,True,7,Positive,13,0,13
533590,True,0,No user reviews,0,0,0
533591,True,0,No user reviews,0,0,0
533592,True,0,No user reviews,0,0,0
533600,True,0,No user reviews,0,0,0
533601,True,0,3 user reviews,1,2,3
533602,True,0,7 user reviews,2,5,7
533630,True,0,1 user reviews,1,0,1
533660,True,0,No user reviews,0,0,0
533670,True,0,1 user reviews,1,0,1
533690,True,6,Mostly Positive,11,3,14
533700,True,0,No user reviews,0,0,0
533740,True,0,No user reviews,0,0,0
533750,True,0,No user reviews,0,0,0
533770,True,0,7 user reviews,5,2,7
533780,True,7,Positive,20,4,24
533800,True,0,No user reviews,0,0,0
533810,True,0,5 user reviews,5,0,5
533820,True,5,Mixed,9,4,13
533830,True,0,No user reviews,0,0,0
533840,True,0,No user reviews,0,0,0
533850,True,6,Mostly Positive,31,9,40
533860,True,0,9 user reviews,5,4,9
533870,True,0,1 user reviews,1,0,1
533880,True,0,1 user reviews,1,0,1
533890,True,0,4 user reviews,3,1,4
533920,True,0,3 user reviews,0,3,3
533950,True,6,Mostly Positive,33,11,44
533960,True,0,2 user reviews,2,0,2
533970,True,0,No user reviews,0,0,0
534000,True,8,Very Positive,45,10,55
534010,True,0,7 user reviews,3,4,7
534030,True,0,No user reviews,0,0,0
534050,True,0,No user reviews,0,0,0
534110,True,0,4 user reviews,4,0,4
534140,True,0,3 user reviews,3,0,3
534160,True,7,Positive,15,2,17
534180,True,0,No user reviews,0,0,0
534190,True,0,7 user reviews,6,1,7
534200,True,0,4 user reviews,2,2,4
534210,True,0,4 user reviews,2,2,4
534220,True,0,No user reviews,0,0,0
534230,True,8,Very Positive,67,15,82
534240,True,0,No user reviews,0,0,0
534260,True,0,1 user reviews,1,0,1
534270,True,0,5 user reviews,4,1,5
534280,True,0,No user reviews,0,0,0
534290,True,8,Very Positive,82,4,86
534300,True,0,No user reviews,0,0,0
534320,True,0,6 user reviews,1,5,6
534330,True,7,Positive,26,3,29
534331,True,6,Mostly Positive,406,169,575
534350,True,0,5 user reviews,2,3,5
534360,True,5,Mixed,16,11,27
534370,True,5,Mixed,152,77,229
534380,True,0,No user reviews,0,0,0
534430,True,0,6 user reviews,4,2,6
534440,True,7,Positive,16,2,18
534460,True,0,No user reviews,0,0,0
534480,True,5,Mixed,12,17,29
534550,True,8,Very Positive,660,56,716
534560,True,0,No user reviews,0,0,0
534570,True,5,Mixed,18,10,28
534580,True,0,No user reviews,0,0,0
534590,True,0,No user reviews,0,0,0
534600,True,0,1 user reviews,1,0,1
534610,True,0,No user reviews,0,0,0
534611,True,0,No user reviews,0,0,0
534612,True,0,No user reviews,0,0,0
534613,True,0,No user reviews,0,0,0
534614,True,0,No user reviews,0,0,0
534615,True,0,No user reviews,0,0,0
534616,True,0,No user reviews,0,0,0
534617,True,0,No user reviews,0,0,0
534618,True,0,No user reviews,0,0,0
534619,True,0,No user reviews,0,0,0
534620,True,0,No user reviews,0,0,0
534621,True,0,No user reviews,0,0,0
534622,True,0,No user reviews,0,0,0
534623,True,0,No user reviews,0,0,0
534624,True,0,No user reviews,0,0,0
534625,True,0,No user reviews,0,0,0
534626,True,0,No user reviews,0,0,0
534627,True,0,No user reviews,0,0,0
534628,True,0,No user reviews,0,0,0
534629,True,0,No user reviews,0,0,0
534630,True,0,No user reviews,0,0,0
534631,True,0,No user reviews,0,0,0
534632,True,0,No user reviews,0,0,0
534633,True,0,No user reviews,0,0,0
534634,True,0,No user reviews,0,0,0
534635,True,0,No user reviews,0,0,0
534636,True,0,No user reviews,0,0,0
534640,True,0,2 user reviews,2,0,2
534650,True,0,1 user reviews,1,0,1
534660,True,0,No user reviews,0,0,0
534670,True,0,No user reviews,0,0,0
534680,True,7,Positive,12,1,13
534690,True,0,No user reviews,0,0,0
534720,True,7,Positive,31,4,35
534740,True,0,4 user reviews,1,3,4
534750,True,6,Mostly Positive,12,4,16
534780,True,0,6 user reviews,6,0,6
534820,True,4,Mostly Negative,26,40,66
534830,True,0,No user reviews,0,0,0
534840,True,7,Positive,29,3,32
534850,True,0,No user reviews,0,0,0
534870,True,0,8 user reviews,6,2,8
534880,True,0,6 user reviews,5,1,6
534910,True,5,Mixed,8,9,17
534920,True,0,4 user reviews,3,1,4
534930,True,0,No user reviews,0,0,0
534931,True,0,No user reviews,0,0,0
534950,True,0,No user reviews,0,0,0
534970,True,0,No user reviews,0,0,0
534980,True,0,9 user reviews,6,3,9
534990,True,7,Positive,30,5,35
535000,True,0,7 user reviews,7,0,7
535010,True,0,4 user reviews,3,1,4
535020,True,0,No user reviews,0,0,0
535021,True,0,No user reviews,0,0,0
535022,True,0,No user reviews,0,0,0
535023,True,0,No user reviews,0,0,0
535024,True,0,No user reviews,0,0,0
535025,True,0,No user reviews,0,0,0
535026,True,0,No user reviews,0,0,0
535027,True,0,No user reviews,0,0,0
535028,True,0,No user reviews,0,0,0
535029,True,0,No user reviews,0,0,0
535030,True,0,No user reviews,0,0,0
535031,True,0,No user reviews,0,0,0
535032,True,0,No user reviews,0,0,0
535040,True,0,No user reviews,0,0,0
535041,True,0,No user reviews,0,0,0
535042,True,0,No user reviews,0,0,0
535043,True,0,No user reviews,0,0,0
535044,True,0,No user reviews,0,0,0
535045,True,0,No user reviews,0,0,0
535046,True,0,No user reviews,0,0,0
535047,True,0,No user reviews,0,0,0
535048,True,0,No user reviews,0,0,0
535049,True,0,No user reviews,0,0,0
535050,True,0,No user reviews,0,0,0
535051,True,0,No user reviews,0,0,0
535052,True,0,No user reviews,0,0,0
535060,True,0,No user reviews,0,0,0
535061,True,0,No user reviews,0,0,0
535062,True,0,No user reviews,0,0,0
535063,True,0,No user reviews,0,0,0
535064,True,0,No user reviews,0,0,0
535065,True,0,No user reviews,0,0,0
535066,True,0,No user reviews,0,0,0
535067,True,0,No user reviews,0,0,0
535068,True,0,No user reviews,0,0,0
535069,True,0,No user reviews,0,0,0
535070,True,0,No user reviews,0,0,0
535071,True,0,No user reviews,0,0,0
535072,True,0,No user reviews,0,0,0
535080,True,0,No user reviews,0,0,0
535081,True,0,No user reviews,0,0,0
535082,True,0,No user reviews,0,0,0
535083,True,0,No user reviews,0,0,0
535084,True,0,No user reviews,0,0,0
535085,True,0,No user reviews,0,0,0
535086,True,0,No user reviews,0,0,0
535087,True,0,No user reviews,0,0,0
535088,True,0,No user reviews,0,0,0
535089,True,0,No user reviews,0,0,0
535090,True,0,No user reviews,0,0,0
535091,True,0,No user reviews,0,0,0
535092,True,0,No user reviews,0,0,0
535100,True,0,No user reviews,0,0,0
535101,True,0,No user reviews,0,0,0
535102,True,0,No user reviews,0,0,0
535103,True,0,No user reviews,0,0,0
535104,True,0,No user reviews,0,0,0
535105,True,0,No user reviews,0,0,0
535106,True,0,No user reviews,0,0,0
535107,True,0,No user reviews,0,0,0
535108,True,0,No user reviews,0,0,0
535109,True,0,No user reviews,0,0,0
535110,True,0,No user reviews,0,0,0
535111,True,0,No user reviews,0,0,0
535112,True,0,No user reviews,0,0,0
535120,True,0,No user reviews,0,0,0
535130,True,0,1 user reviews,0,1,1
535140,True,0,No user reviews,0,0,0
535150,True,6,Mostly Positive,32,10,42
535170,True,0,1 user reviews,0,1,1
535180,True,0,No user reviews,0,0,0
535190,True,7,Positive,13,1,14
535200,True,0,4 user reviews,4,0,4
535201,True,0,1 user reviews,1,0,1
535202,True,0,3 user reviews,2,1,3
535230,True,8,Very Positive,3499,450,3949
535240,True,0,1 user reviews,1,0,1
535260,True,0,6 user reviews,4,2,6
535270,True,0,2 user reviews,1,1,2
535280,True,7,Positive,22,1,23
535290,True,0,No user reviews,0,0,0
535310,True,0,1 user reviews,1,0,1
535330,True,7,Positive,17,1,18
535350,True,0,6 user reviews,3,3,6
535370,True,0,1 user reviews,0,1,1
535380,True,7,Positive,17,1,18
535410,True,7,Positive,18,2,20
535420,True,0,No user reviews,0,0,0
535440,True,0,No user reviews,0,0,0
535450,True,0,No user reviews,0,0,0
535460,True,7,Positive,42,3,45
535470,True,0,No user reviews,0,0,0
535480,True,8,Very Positive,1189,244,1433
535490,True,5,Mixed,25,34,59
535510,True,0,2 user reviews,2,0,2
535520,True,6,Mostly Positive,324,91,415
535530,True,0,4 user reviews,2,2,4
535540,True,0,No user reviews,0,0,0
535580,True,0,No user reviews,0,0,0
535600,True,0,No user reviews,0,0,0
535610,True,0,No user reviews,0,0,0
535630,True,0,7 user reviews,6,1,7
535650,True,7,Positive,14,1,15
535660,True,0,No user reviews,0,0,0
535680,True,0,2 user reviews,2,0,2
535690,True,0,4 user reviews,3,1,4
535700,True,5,Mixed,9,11,20
535720,True,0,1 user reviews,1,0,1
535750,True,0,2 user reviews,1,1,2
535760,True,0,6 user reviews,5,1,6
535770,True,0,No user reviews,0,0,0
535771,True,0,No user reviews,0,0,0
535780,True,0,No user reviews,0,0,0
535790,True,0,No user reviews,0,0,0
535810,True,0,No user reviews,0,0,0
535820,True,5,Mixed,11,9,20
535830,True,0,No user reviews,0,0,0
535840,True,0,7 user reviews,7,0,7
535850,True,4,Mostly Negative,23,85,108
535870,True,0,No user reviews,0,0,0
535890,True,0,9 user reviews,7,2,9
535910,True,7,Positive,18,0,18
535920,True,0,No user reviews,0,0,0
535930,True,8,Very Positive,7244,559,7803
535950,True,0,1 user reviews,1,0,1
535960,True,0,No user reviews,0,0,0
535970,True,0,2 user reviews,2,0,2
535971,True,0,1 user reviews,1,0,1
535980,True,7,Positive,25,4,29
535990,True,0,No user reviews,0,0,0
535991,True,0,No user reviews,0,0,0
535992,True,0,No user reviews,0,0,0
535993,True,0,No user reviews,0,0,0
535994,True,0,No user reviews,0,0,0
535995,True,0,No user reviews,0,0,0
535996,True,0,No user reviews,0,0,0
535997,True,0,No user reviews,0,0,0
535998,True,0,No user reviews,0,0,0
535999,True,0,No user reviews,0,0,0
536000,True,0,No user reviews,0,0,0
536001,True,0,No user reviews,0,0,0
536002,True,0,No user reviews,0,0,0
536003,True,0,No user reviews,0,0,0
536010,True,0,1 user reviews,0,1,1
536040,True,5,Mixed,23,27,50
536050,True,0,No user reviews,0,0,0
536070,True,0,No user reviews,0,0,0
536071,True,0,No user reviews,0,0,0
536072,True,0,No user reviews,0,0,0
536073,True,0,No user reviews,0,0,0
536074,True,0,No user reviews,0,0,0
536075,True,0,No user reviews,0,0,0
536076,True,0,No user reviews,0,0,0
536077,True,0,No user reviews,0,0,0
536078,True,0,No user reviews,0,0,0
536079,True,0,No user reviews,0,0,0
536080,True,0,No user reviews,0,0,0
536081,True,0,No user reviews,0,0,0
536082,True,0,No user reviews,0,0,0
536083,True,0,No user reviews,0,0,0
536084,True,0,No user reviews,0,0,0
536085,True,0,No user reviews,0,0,0
536086,True,0,No user reviews,0,0,0
536087,True,0,No user reviews,0,0,0
536088,True,0,No user reviews,0,0,0
536089,True,0,No user reviews,0,0,0
536090,True,0,No user reviews,0,0,0
536091,True,0,No user reviews,0,0,0
536092,True,0,No user reviews,0,0,0
536093,True,0,No user reviews,0,0,0
536094,True,0,No user reviews,0,0,0
536095,True,0,No user reviews,0,0,0
536096,True,0,No user reviews,0,0,0
536097,True,0,No user reviews,0,0,0
536098,True,0,No user reviews,0,0,0
536099,True,0,No user reviews,0,0,0
536100,True,0,No user reviews,0,0,0
536101,True,0,No user reviews,0,0,0
536102,True,0,No user reviews,0,0,0
536103,True,0,No user reviews,0,0,0
536104,True,0,No user reviews,0,0,0
536105,True,0,No user reviews,0,0,0
536106,True,0,No user reviews,0,0,0
536107,True,0,No user reviews,0,0,0
536108,True,0,No user reviews,0,0,0
536110,True,0,No user reviews,0,0,0
536111,True,0,No user reviews,0,0,0
536112,True,0,No user reviews,0,0,0
536113,True,0,No user reviews,0,0,0
536114,True,0,No user reviews,0,0,0
536115,True,0,No user reviews,0,0,0
536116,True,0,No user reviews,0,0,0
536117,True,0,No user reviews,0,0,0
536118,True,0,No user reviews,0,0,0
536119,True,0,No user reviews,0,0,0
536120,True,0,No user reviews,0,0,0
536121,True,0,No user reviews,0,0,0
536122,True,0,No user reviews,0,0,0
536123,True,0,No user reviews,0,0,0
536124,True,0,No user reviews,0,0,0
536125,True,0,No user reviews,0,0,0
536126,True,0,No user reviews,0,0,0
536127,True,0,No user reviews,0,0,0
536128,True,0,No user reviews,0,0,0
536129,True,0,No user reviews,0,0,0
536130,True,0,No user reviews,0,0,0
536131,True,0,No user reviews,0,0,0
536132,True,0,No user reviews,0,0,0
536133,True,0,No user reviews,0,0,0
536134,True,0,No user reviews,0,0,0
536135,True,0,No user reviews,0,0,0
536136,True,0,No user reviews,0,0,0
536137,True,0,No user reviews,0,0,0
536138,True,0,No user reviews,0,0,0
536139,True,0,No user reviews,0,0,0
536140,True,0,No user reviews,0,0,0
536141,True,0,No user reviews,0,0,0
536142,True,0,No user reviews,0,0,0
536143,True,0,No user reviews,0,0,0
536144,True,0,No user reviews,0,0,0
536145,True,0,No user reviews,0,0,0
536146,True,0,No user reviews,0,0,0
536150,True,0,No user reviews,0,0,0
536210,True,0,1 user reviews,0,1,1
536220,True,6,Mostly Positive,2888,1116,4004
536230,True,0,2 user reviews,2,0,2
536270,True,6,Mostly Positive,709,205,914
536280,True,5,Mixed,62,40,102
536310,True,0,No user reviews,0,0,0
536320,True,4,Mostly Negative,8,17,25
536330,True,0,No user reviews,0,0,0
536340,True,4,Mostly Negative,5,8,13
536370,True,0,4 user reviews,3,1,4
536380,True,0,No user reviews,0,0,0
536390,True,0,No user reviews,0,0,0
536410,True,0,7 user reviews,2,5,7
536420,True,5,Mixed,19,9,28
536430,True,7,Positive,10,2,12
536450,True,5,Mixed,13,9,22
536460,True,0,No user reviews,0,0,0
536470,True,0,9 user reviews,8,1,9
536490,True,0,6 user reviews,3,3,6
536510,True,0,9 user reviews,4,5,9
536520,True,0,5 user reviews,3,2,5
536530,True,5,Mixed,9,6,15
536540,True,5,Mixed,7,8,15
536541,True,0,1 user reviews,1,0,1
536543,True,0,7 user reviews,6,1,7
536544,True,0,2 user reviews,1,1,2
536545,True,4,Mostly Negative,3,8,11
536546,True,0,1 user reviews,0,1,1
536547,True,0,No user reviews,0,0,0
536548,True,0,No user reviews,0,0,0
536549,True,0,2 user reviews,0,2,2
536550,True,0,No user reviews,0,0,0
536560,True,8,Very Positive,48,7,55
536570,True,0,4 user reviews,1,3,4
536571,True,0,No user reviews,0,0,0
536572,True,0,No user reviews,0,0,0
536573,True,0,9 user reviews,3,6,9
536574,True,0,3 user reviews,2,1,3
536575,True,0,7 user reviews,2,5,7
536576,True,4,Mostly Negative,7,14,21
536577,True,0,2 user reviews,2,0,2
536578,True,0,3 user reviews,2,1,3
536579,True,0,1 user reviews,1,0,1
536580,True,0,No user reviews,0,0,0
536590,True,0,4 user reviews,4,0,4
536610,True,6,Mostly Positive,18,5,23
536630,True,4,Mostly Negative,3,7,10
536640,True,4,Mostly Negative,15,25,40
536660,True,5,Mixed,29,39,68
536670,True,0,2 user reviews,2,0,2
536680,True,5,Mixed,7,8,15
536690,True,6,Mostly Positive,18,5,23
536730,True,0,2 user reviews,1,1,2
536740,True,0,No user reviews,0,0,0
536741,True,0,2 user reviews,2,0,2
536750,True,5,Mixed,9,4,13
536760,True,0,1 user reviews,1,0,1
536770,True,7,Positive,24,0,24
536780,True,6,Mostly Positive,38,12,50
536790,True,0,No user reviews,0,0,0
536800,True,0,No user reviews,0,0,0
536850,True,0,No user reviews,0,0,0
536860,True,0,No user reviews,0,0,0
536880,True,0,No user reviews,0,0,0
536890,True,8,Very Positive,199,31,230
536900,True,0,7 user reviews,7,0,7
536910,True,0,No user reviews,0,0,0
536920,True,0,1 user reviews,1,0,1
536950,True,0,No user reviews,0,0,0
536960,True,5,Mixed,10,5,15
536990,True,8,Very Positive,42,9,51
537000,True,6,Mostly Positive,37,12,49
537020,True,0,3 user reviews,3,0,3
537030,True,0,No user reviews,0,0,0
537050,True,0,5 user reviews,5,0,5
537060,True,0,No user reviews,0,0,0
537080,True,0,3 user reviews,2,1,3
537090,True,0,7 user reviews,4,3,7
537100,True,6,Mostly Positive,54,14,68
537110,True,8,Very Positive,607,32,639
537120,True,0,2 user reviews,2,0,2
537130,True,0,No user reviews,0,0,0
537140,True,7,Positive,17,2,19
537170,True,0,1 user reviews,0,1,1
537180,True,5,Mixed,52,47,99
537190,True,0,No user reviews,0,0,0
537200,True,0,1 user reviews,0,1,1
537210,True,0,No user reviews,0,0,0
537230,True,0,2 user reviews,2,0,2
537240,True,0,No user reviews,0,0,0
537280,True,5,Mixed,4,6,10
537320,True,0,No user reviews,0,0,0
537321,True,0,No user reviews,0,0,0
537322,True,0,No user reviews,0,0,0
537324,True,0,No user reviews,0,0,0
537325,True,0,No user reviews,0,0,0
537330,True,7,Positive,24,0,24
537340,True,6,Mostly Positive,389,139,528
537360,True,5,Mixed,6,6,12
537380,True,0,1 user reviews,1,0,1
537410,True,0,2 user reviews,1,1,2
537420,True,0,No user reviews,0,0,0
537421,True,0,No user reviews,0,0,0
537422,True,0,No user reviews,0,0,0
537430,True,5,Mixed,44,56,100
537450,True,5,Mixed,117,69,186
537510,True,0,No user reviews,0,0,0
537520,True,5,Mixed,22,21,43
537540,True,0,No user reviews,0,0,0
537570,True,0,No user reviews,0,0,0
537580,True,0,1 user reviews,1,0,1
537590,True,0,No user reviews,0,0,0
537630,True,8,Very Positive,65,14,79
537640,True,0,No user reviews,0,0,0
537641,True,0,No user reviews,0,0,0
537642,True,0,No user reviews,0,0,0
537643,True,0,No user reviews,0,0,0
537644,True,0,No user reviews,0,0,0
537645,True,0,No user reviews,0,0,0
537646,True,0,No user reviews,0,0,0
537647,True,0,No user reviews,0,0,0
537648,True,0,No user reviews,0,0,0
537649,True,0,No user reviews,0,0,0
537650,True,0,No user reviews,0,0,0
537651,True,0,No user reviews,0,0,0
537652,True,0,No user reviews,0,0,0
537660,True,0,8 user reviews,4,4,8
537670,True,0,3 user reviews,3,0,3
537700,True,0,9 user reviews,5,4,9
537740,True,5,Mixed,10,7,17
537750,True,0,2 user reviews,1,1,2
537760,True,0,5 user reviews,5,0,5
537770,True,0,5 user reviews,4,1,5
537780,True,0,8 user reviews,8,0,8
537790,True,0,4 user reviews,2,2,4
537800,True,8,Very Positive,3362,462,3824
537870,True,0,No user reviews,0,0,0
537890,True,0,No user reviews,0,0,0
537900,True,0,No user reviews,0,0,0
537910,True,0,3 user reviews,2,1,3
537920,True,0,3 user reviews,2,1,3
537940,True,0,1 user reviews,0,1,1
537960,True,0,No user reviews,0,0,0
537970,True,0,No user reviews,0,0,0
537990,True,6,Mostly Positive,34,13,47
538000,True,6,Mostly Positive,8,3,11
538020,True,5,Mixed,102,96,198
538021,True,5,Mixed,11,6,17
538030,True,0,No user reviews,0,0,0
538040,True,0,2 user reviews,2,0,2
538050,True,0,5 user reviews,2,3,5
538060,True,5,Mixed,14,9,23
538070,True,8,Very Positive,257,27,284
538080,True,0,4 user reviews,2,2,4
538090,True,0,2 user reviews,2,0,2
538100,True,8,Very Positive,861,119,980
538110,True,0,No user reviews,0,0,0
538120,True,0,No user reviews,0,0,0
538130,True,0,2 user reviews,2,0,2
538140,True,0,6 user reviews,6,0,6
538150,True,0,3 user reviews,3,0,3
538160,True,0,No user reviews,0,0,0
538170,True,0,3 user reviews,2,1,3
538180,True,0,No user reviews,0,0,0
538190,True,7,Positive,14,3,17
538200,True,0,1 user reviews,1,0,1
538210,True,0,No user reviews,0,0,0
538220,True,0,8 user reviews,8,0,8
538230,True,0,No user reviews,0,0,0
538240,True,0,No user reviews,0,0,0
538250,True,0,No user reviews,0,0,0
538260,True,0,No user reviews,0,0,0
538270,True,0,No user reviews,0,0,0
538280,True,0,No user reviews,0,0,0
538290,True,0,1 user reviews,1,0,1
538300,True,0,1 user reviews,1,0,1
538310,True,0,2 user reviews,2,0,2
538330,True,7,Positive,12,3,15
538340,True,0,No user reviews,0,0,0
538350,True,0,1 user reviews,0,1,1
538351,True,0,No user reviews,0,0,0
538352,True,0,No user reviews,0,0,0
538360,True,0,No user reviews,0,0,0
538370,True,0,No user reviews,0,0,0
538380,True,0,No user reviews,0,0,0
538390,True,0,1 user reviews,1,0,1
538400,True,0,No user reviews,0,0,0
538410,True,0,3 user reviews,2,1,3
538420,True,0,No user reviews,0,0,0
538430,True,0,1 user reviews,1,0,1
538440,True,0,No user reviews,0,0,0
538450,True,0,No user reviews,0,0,0
538460,True,0,2 user reviews,2,0,2
538470,True,0,3 user reviews,0,3,3
538480,True,0,No user reviews,0,0,0
538490,True,0,2 user reviews,1,1,2
538500,True,0,1 user reviews,1,0,1
538510,True,0,4 user reviews,1,3,4
538550,True,7,Positive,19,4,23
538560,True,3,Negative,0,12,12
538570,True,0,1 user reviews,1,0,1
538580,True,0,No user reviews,0,0,0
538590,True,4,Mostly Negative,6,10,16
538600,True,0,2 user reviews,2,0,2
538610,True,0,2 user reviews,2,0,2
538620,True,0,No user reviews,0,0,0
538630,True,0,No user reviews,0,0,0
538640,True,0,No user reviews,0,0,0
538650,True,0,No user reviews,0,0,0
538670,True,0,No user reviews,0,0,0
538680,True,9,Overwhelmingly Positive,1858,89,1947
538690,True,0,No user reviews,0,0,0
538700,True,0,No user reviews,0,0,0
538710,True,7,Positive,28,3,31
538720,True,0,4 user reviews,4,0,4
538740,True,0,No user reviews,0,0,0
538750,True,0,No user reviews,0,0,0
538760,True,6,Mostly Positive,22,8,30
538780,True,0,No user reviews,0,0,0
538790,True,5,Mixed,8,7,15
538810,True,5,Mixed,134,83,217
538840,True,5,Mixed,55,25,80
538860,True,0,No user reviews,0,0,0
538870,True,5,Mixed,88,55,143
538880,True,0,1 user reviews,1,0,1
538890,True,0,No user reviews,0,0,0
538900,True,0,2 user reviews,2,0,2
538910,True,0,6 user reviews,6,0,6
538920,True,4,Mostly Negative,5,13,18
538930,True,0,1 user reviews,1,0,1
538950,True,0,No user reviews,0,0,0
538960,True,0,No user reviews,0,0,0
538970,True,0,No user reviews,0,0,0
538980,True,0,No user reviews,0,0,0
538990,True,5,Mixed,28,18,46
539001,True,0,No user reviews,0,0,0
539010,True,0,4 user reviews,2,2,4
539030,True,0,No user reviews,0,0,0
539040,True,0,2 user reviews,2,0,2
539050,True,5,Mixed,22,18,40
539090,True,6,Mostly Positive,9,3,12
539190,True,0,1 user reviews,1,0,1
539230,True,0,No user reviews,0,0,0
539240,True,0,1 user reviews,1,0,1
539250,True,0,4 user reviews,4,0,4
539260,True,0,3 user reviews,3,0,3
539270,True,6,Mostly Positive,46,12,58
539280,True,5,Mixed,9,8,17
539290,True,4,Mostly Negative,6,11,17
539300,True,4,Mostly Negative,7,15,22
539310,True,0,No user reviews,0,0,0
539320,True,0,No user reviews,0,0,0
539330,True,8,Very Positive,67,15,82
539340,True,7,Positive,31,6,37
539370,True,0,2 user reviews,2,0,2
539380,True,5,Mixed,18,8,26
539400,True,8,Very Positive,50,10,60
539420,True,0,No user reviews,0,0,0
539440,True,5,Mixed,23,27,50
539450,True,7,Positive,8,2,10
539460,True,0,4 user reviews,3,1,4
539470,True,8,Very Positive,792,158,950
539560,True,0,5 user reviews,3,2,5
539591,True,0,1 user reviews,0,1,1
539595,True,0,2 user reviews,1,1,2
539640,True,0,9 user reviews,3,6,9
539650,True,5,Mixed,22,10,32
539660,True,7,Positive,46,2,48
539670,True,8,Very Positive,76,13,89
539690,True,0,3 user reviews,1,2,3
539720,True,8,Very Positive,215,36,251
539730,True,7,Positive,14,0,14
539750,True,5,Mixed,23,13,36
539780,True,0,1 user reviews,1,0,1
539790,True,0,1 user reviews,1,0,1
539800,True,0,2 user reviews,2,0,2
539810,True,0,1 user reviews,1,0,1
539820,True,0,2 user reviews,2,0,2
539830,True,0,2 user reviews,1,1,2
539840,True,0,2 user reviews,2,0,2
539850,True,0,3 user reviews,3,0,3
539860,True,0,1 user reviews,1,0,1
539870,True,0,1 user reviews,1,0,1
539880,True,0,2 user reviews,2,0,2
539890,True,0,2 user reviews,2,0,2
539900,True,0,2 user reviews,2,0,2
539910,True,0,3 user reviews,3,0,3
539920,True,0,2 user reviews,2,0,2
539930,True,0,2 user reviews,2,0,2
539940,True,0,1 user reviews,1,0,1
539950,True,0,2 user reviews,1,1,2
539960,True,0,1 user reviews,1,0,1
539970,True,0,1 user reviews,1,0,1
539980,True,7,Positive,12,1,13
540000,True,0,2 user reviews,2,0,2
540010,True,0,4 user reviews,3,1,4
540020,True,4,Mostly Negative,7,14,21
540030,True,0,No user reviews,0,0,0
540040,True,0,1 user reviews,1,0,1
540060,True,7,Positive,29,3,32
540070,True,0,2 user reviews,1,1,2
540071,True,0,No user reviews,0,0,0
540100,True,5,Mixed,47,36,83
540130,True,0,No user reviews,0,0,0
540150,True,0,5 user reviews,3,2,5
540160,True,0,No user reviews,0,0,0
540170,True,0,No user reviews,0,0,0
540180,True,3,Negative,4,17,21
540190,True,5,Mixed,10,5,15
540200,True,0,No user reviews,0,0,0
540210,True,0,No user reviews,0,0,0
540220,True,0,1 user reviews,0,1,1
540230,True,5,Mixed,6,4,10
540250,True,0,2 user reviews,1,1,2
540320,True,0,5 user reviews,3,2,5
540330,True,0,7 user reviews,1,6,7
540340,True,5,Mixed,54,35,89
540350,True,0,1 user reviews,1,0,1
540360,True,0,4 user reviews,3,1,4
540380,True,0,No user reviews,0,0,0
540390,True,0,No user reviews,0,0,0
540410,True,7,Positive,14,0,14
540420,True,0,1 user reviews,1,0,1
540430,True,0,No user reviews,0,0,0
540440,True,0,1 user reviews,1,0,1
540450,True,0,No user reviews,0,0,0
540460,True,0,1 user reviews,1,0,1
540470,True,0,No user reviews,0,0,0
540480,True,0,No user reviews,0,0,0
540490,True,0,No user reviews,0,0,0
540500,True,7,Positive,11,2,13
540510,True,8,Very Positive,173,34,207
540520,True,0,No user reviews,0,0,0
540550,True,5,Mixed,5,6,11
540590,True,0,3 user reviews,1,2,3
540610,True,8,Very Positive,430,64,494
540630,True,0,No user reviews,0,0,0
540640,True,0,9 user reviews,7,2,9
540650,True,0,7 user reviews,4,3,7
540660,True,7,Positive,16,3,19
540670,True,0,No user reviews,0,0,0
540680,True,0,2 user reviews,2,0,2
540681,True,0,No user reviews,0,0,0
540682,True,0,No user reviews,0,0,0
540690,True,5,Mixed,20,14,34
540710,True,7,Positive,38,1,39
540711,True,7,Positive,31,2,33
540720,True,7,Positive,10,1,11
540721,True,7,Positive,13,0,13
540730,True,0,8 user reviews,8,0,8
540740,True,5,Mixed,16,19,35
540770,True,0,4 user reviews,4,0,4
540780,True,7,Positive,17,0,17
540810,True,5,Mixed,251,153,404
540820,True,0,5 user reviews,5,0,5
540840,True,8,Very Positive,604,56,660
540850,True,0,No user reviews,0,0,0
540860,True,6,Mostly Positive,31,13,44
540870,True,6,Mostly Positive,14,6,20
540880,True,8,Very Positive,113,5,118
540900,True,0,7 user reviews,7,0,7
541120,True,0,No user reviews,0,0,0
541130,True,0,9 user reviews,7,2,9
541150,True,0,No user reviews,0,0,0
541160,True,0,9 user reviews,9,0,9
541170,True,0,No user reviews,0,0,0
541190,True,0,No user reviews,0,0,0
541200,True,8,Very Positive,550,39,589
541210,True,8,Very Positive,1614,276,1890
541220,True,0,No user reviews,0,0,0
541230,True,8,Very Positive,91,14,105
541240,True,0,7 user reviews,6,1,7
541250,True,0,No user reviews,0,0,0
541260,True,0,No user reviews,0,0,0
541270,True,0,7 user reviews,4,3,7
541280,True,0,No user reviews,0,0,0
541300,True,5,Mixed,388,239,627
541310,True,0,No user reviews,0,0,0
541330,True,0,No user reviews,0,0,0
541350,True,5,Mixed,14,8,22
541370,True,0,8 user reviews,1,7,8
541380,True,4,Mostly Negative,6,19,25
541400,True,0,4 user reviews,3,1,4
541410,True,0,2 user reviews,2,0,2
541420,True,0,5 user reviews,4,1,5
541430,True,0,No user reviews,0,0,0
541450,True,5,Mixed,32,17,49
541460,True,0,1 user reviews,1,0,1
541470,True,0,1 user reviews,0,1,1
541480,True,0,No user reviews,0,0,0
541490,True,0,No user reviews,0,0,0
541500,True,0,2 user reviews,1,1,2
541510,True,0,No user reviews,0,0,0
541520,True,0,No user reviews,0,0,0
541530,True,0,No user reviews,0,0,0
541540,True,0,1 user reviews,1,0,1
541550,True,0,No user reviews,0,0,0
541560,True,0,7 user reviews,4,3,7
541570,True,9,Overwhelmingly Positive,1781,68,1849
541580,True,0,No user reviews,0,0,0
541590,True,0,No user reviews,0,0,0
541600,True,0,No user reviews,0,0,0
541610,True,0,1 user reviews,1,0,1
541620,True,0,3 user reviews,2,1,3
541630,True,0,No user reviews,0,0,0
541640,True,6,Mostly Positive,34,9,43
541650,True,0,No user reviews,0,0,0
541660,True,7,Positive,24,4,28
541670,True,6,Mostly Positive,145,38,183
541680,True,0,No user reviews,0,0,0
541690,True,0,No user reviews,0,0,0
541700,True,0,No user reviews,0,0,0
541710,True,0,No user reviews,0,0,0
541720,True,5,Mixed,12,13,25
541750,True,0,No user reviews,0,0,0
541760,True,0,1 user reviews,1,0,1
541770,True,0,2 user reviews,0,2,2
541790,True,0,No user reviews,0,0,0
541800,True,0,5 user reviews,3,2,5
541810,True,0,No user reviews,0,0,0
541820,True,0,No user reviews,0,0,0
541830,True,0,3 user reviews,3,0,3
541880,True,0,No user reviews,0,0,0
541890,True,0,No user reviews,0,0,0
541910,True,0,No user reviews,0,0,0
541920,True,0,9 user reviews,2,7,9
541930,True,8,Very Positive,103,6,109
541940,True,0,No user reviews,0,0,0
541950,True,0,No user reviews,0,0,0
541960,True,0,No user reviews,0,0,0
541970,True,0,1 user reviews,0,1,1
541980,True,0,No user reviews,0,0,0
542021,True,0,No user reviews,0,0,0
542030,True,7,Positive,28,2,30
542040,True,0,1 user reviews,1,0,1
542050,True,8,Very Positive,388,34,422
542100,True,0,2 user reviews,1,1,2
542110,True,0,8 user reviews,3,5,8
542120,True,0,No user reviews,0,0,0
542130,True,0,4 user reviews,3,1,4
542140,True,0,No user reviews,0,0,0
542150,True,7,Positive,21,0,21
542160,True,7,Positive,16,3,19
542170,True,0,No user reviews,0,0,0
542190,True,0,1 user reviews,1,0,1
542200,True,8,Very Positive,84,9,93
542210,True,0,2 user reviews,2,0,2
542220,True,0,8 user reviews,8,0,8
542240,True,0,6 user reviews,5,1,6
542260,True,8,Very Positive,65,11,76
542270,True,0,3 user reviews,1,2,3
542280,True,0,8 user reviews,2,6,8
542290,True,7,Positive,27,2,29
542300,True,0,1 user reviews,1,0,1
542310,True,6,Mostly Positive,26,7,33
542320,True,0,No user reviews,0,0,0
542330,True,0,2 user reviews,2,0,2
542340,True,4,Mostly Negative,21,37,58
542350,True,6,Mostly Positive,45,18,63
542380,True,7,Positive,10,0,10
542390,True,0,No user reviews,0,0,0
542400,True,6,Mostly Positive,57,22,79
542410,True,4,Mostly Negative,4,8,12
542430,True,4,Mostly Negative,10,35,45
542440,True,0,No user reviews,0,0,0
542450,True,5,Mixed,13,10,23
542470,True,0,No user reviews,0,0,0
542480,True,0,No user reviews,0,0,0
542490,True,0,5 user reviews,5,0,5
542491,True,0,4 user reviews,4,0,4
542500,True,0,1 user reviews,1,0,1
542501,True,0,1 user reviews,1,0,1
542510,True,0,No user reviews,0,0,0
542520,True,7,Positive,24,3,27
542530,True,0,4 user reviews,1,3,4
542540,True,0,No user reviews,0,0,0
542541,True,0,No user reviews,0,0,0
542542,True,0,No user reviews,0,0,0
542550,True,7,Positive,18,2,20
542570,True,0,8 user reviews,6,2,8
542590,True,0,No user reviews,0,0,0
542600,True,0,1 user reviews,1,0,1
542610,True,0,No user reviews,0,0,0
542611,True,0,No user reviews,0,0,0
542612,True,0,No user reviews,0,0,0
542620,True,0,3 user reviews,2,1,3
542640,True,0,No user reviews,0,0,0
542650,True,3,Negative,2,9,11
542660,True,6,Mostly Positive,42,11,53
542670,True,0,6 user reviews,1,5,6
542680,True,5,Mixed,7,4,11
542690,True,0,2 user reviews,2,0,2
542710,True,0,3 user reviews,3,0,3
542720,True,0,1 user reviews,1,0,1
542730,True,0,2 user reviews,0,2,2
542740,True,0,1 user reviews,1,0,1
542750,True,0,1 user reviews,0,1,1
542770,True,8,Very Positive,164,14,178
542780,True,0,1 user reviews,1,0,1
542790,True,0,No user reviews,0,0,0
542810,True,0,No user reviews,0,0,0
542820,True,6,Mostly Positive,10,3,13
542830,True,0,2 user reviews,1,1,2
542840,True,0,No user reviews,0,0,0
542850,True,0,No user reviews,0,0,0
542870,True,0,No user reviews,0,0,0
542880,True,0,No user reviews,0,0,0
542890,True,0,No user reviews,0,0,0
542900,True,0,No user reviews,0,0,0
542910,True,0,5 user reviews,3,2,5
542930,True,0,1 user reviews,1,0,1
542940,True,0,No user reviews,0,0,0
542960,True,0,No user reviews,0,0,0
542970,True,0,1 user reviews,1,0,1
542971,True,0,No user reviews,0,0,0
542972,True,0,3 user reviews,3,0,3
542974,True,0,No user reviews,0,0,0
542975,True,0,No user reviews,0,0,0
543000,True,0,No user reviews,0,0,0
543001,True,0,No user reviews,0,0,0
543002,True,0,No user reviews,0,0,0
543003,True,0,No user reviews,0,0,0
543004,True,0,No user reviews,0,0,0
543005,True,0,No user reviews,0,0,0
543010,True,5,Mixed,112,58,170
543030,True,5,Mixed,30,22,52
543040,True,0,3 user reviews,3,0,3
543050,True,0,6 user reviews,3,3,6
543070,True,7,Positive,16,1,17
543080,True,0,3 user reviews,3,0,3
543090,True,0,1 user reviews,1,0,1
543100,True,5,Mixed,23,10,33
543110,True,0,3 user reviews,3,0,3
543120,True,0,1 user reviews,0,1,1
543140,True,5,Mixed,13,8,21
543150,True,0,No user reviews,0,0,0
543160,True,0,6 user reviews,2,4,6
543170,True,0,3 user reviews,2,1,3
543180,True,6,Mostly Positive,40,14,54
543190,True,0,6 user reviews,6,0,6
543191,True,0,7 user reviews,7,0,7
543192,True,7,Positive,14,0,14
543193,True,0,9 user reviews,8,1,9
543200,True,0,1 user reviews,1,0,1
543210,True,0,No user reviews,0,0,0
543220,True,0,No user reviews,0,0,0
543230,True,0,No user reviews,0,0,0
543240,True,6,Mostly Positive,69,20,89
543250,True,0,No user reviews,0,0,0
543260,True,8,Very Positive,490,56,546
543270,True,7,Positive,13,3,16
543290,True,0,5 user reviews,3,2,5
543300,True,0,2 user reviews,1,1,2
543310,True,0,No user reviews,0,0,0
543320,True,5,Mixed,6,6,12
543330,True,0,No user reviews,0,0,0
543340,True,0,1 user reviews,1,0,1
543350,True,5,Mixed,9,4,13
543360,True,0,8 user reviews,0,8,8
543380,True,0,6 user reviews,3,3,6
543390,True,5,Mixed,75,41,116
543410,True,6,Mostly Positive,10,3,13
543430,True,5,Mixed,8,4,12
543440,True,7,Positive,21,4,25
543460,True,5,Mixed,341,265,606
543470,True,0,1 user reviews,1,0,1
543510,True,5,Mixed,7,5,12
543520,True,0,3 user reviews,2,1,3
543530,True,7,Positive,12,1,13
543540,True,0,3 user reviews,1,2,3
543560,True,0,No user reviews,0,0,0
543580,True,7,Positive,22,4,26
543600,True,7,Positive,15,1,16
543610,True,0,1 user reviews,1,0,1
543620,True,0,No user reviews,0,0,0
543640,True,0,No user reviews,0,0,0
543650,True,0,6 user reviews,1,5,6
543660,True,0,1 user reviews,1,0,1
543670,True,0,2 user reviews,1,1,2
543690,True,0,No user reviews,0,0,0
543691,True,0,No user reviews,0,0,0
543692,True,0,No user reviews,0,0,0
543693,True,0,No user reviews,0,0,0
543700,True,0,No user reviews,0,0,0
543710,True,5,Mixed,9,4,13
543720,True,0,3 user reviews,3,0,3
543730,True,0,No user reviews,0,0,0
543740,True,0,4 user reviews,2,2,4
543750,True,0,No user reviews,0,0,0
543810,True,0,No user reviews,0,0,0
543811,True,0,1 user reviews,0,1,1
543820,True,0,No user reviews,0,0,0
543821,True,0,No user reviews,0,0,0
543822,True,0,No user reviews,0,0,0
543823,True,0,No user reviews,0,0,0
543840,True,0,No user reviews,0,0,0
543850,True,0,No user reviews,0,0,0
543860,True,0,No user reviews,0,0,0
543870,True,8,Very Positive,210,46,256
543890,True,0,No user reviews,0,0,0
543900,True,5,Mixed,1048,610,1658
543910,True,0,1 user reviews,1,0,1
543920,True,0,No user reviews,0,0,0
543930,True,0,2 user reviews,1,1,2
543940,True,0,3 user reviews,3,0,3
543950,True,0,2 user reviews,0,2,2
543960,True,0,No user reviews,0,0,0
543980,True,8,Very Positive,96,10,106
543990,True,0,No user reviews,0,0,0
544000,True,0,No user reviews,0,0,0
544010,True,0,No user reviews,0,0,0
544030,True,0,No user reviews,0,0,0
544060,True,0,No user reviews,0,0,0
544080,True,0,No user reviews,0,0,0
544100,True,0,No user reviews,0,0,0
544120,True,0,No user reviews,0,0,0
544130,True,0,3 user reviews,3,0,3
544140,True,0,1 user reviews,0,1,1
544150,True,0,1 user reviews,1,0,1
544160,True,0,No user reviews,0,0,0
544180,True,7,Positive,11,0,11
544190,True,5,Mixed,8,4,12
544210,True,0,No user reviews,0,0,0
544220,True,0,9 user reviews,3,6,9
544230,True,0,No user reviews,0,0,0
544240,True,0,4 user reviews,2,2,4
544250,True,0,No user reviews,0,0,0
544260,True,0,1 user reviews,1,0,1
544270,True,5,Mixed,13,7,20
544290,True,0,4 user reviews,4,0,4
544300,True,0,No user reviews,0,0,0
544310,True,8,Very Positive,126,6,132
544320,True,0,No user reviews,0,0,0
544330,True,8,Very Positive,513,77,590
544360,True,0,No user reviews,0,0,0
544370,True,0,1 user reviews,0,1,1
544380,True,0,2 user reviews,2,0,2
544390,True,8,Very Positive,475,40,515
544400,True,7,Positive,10,0,10
544410,True,5,Mixed,9,7,16
544420,True,0,No user reviews,0,0,0
544430,True,0,No user reviews,0,0,0
544440,True,5,Mixed,6,4,10
544450,True,0,No user reviews,0,0,0
544460,True,0,No user reviews,0,0,0
544470,True,0,No user reviews,0,0,0
544480,True,4,Mostly Negative,5,12,17
544490,True,0,No user reviews,0,0,0
544520,True,0,1 user reviews,1,0,1
544530,True,6,Mostly Positive,26,9,35
544540,True,7,Positive,22,3,25
544550,True,8,Very Positive,1441,326,1767
544560,True,0,2 user reviews,1,1,2
544561,True,0,No user reviews,0,0,0
544570,True,0,No user reviews,0,0,0
544571,True,0,No user reviews,0,0,0
544580,True,7,Positive,14,1,15
544590,True,0,2 user reviews,1,1,2
544600,True,7,Positive,27,5,32
544610,True,8,Very Positive,1057,167,1224
544620,True,0,No user reviews,0,0,0
544630,True,7,Positive,10,1,11
544650,True,6,Mostly Positive,13,5,18
544670,True,0,No user reviews,0,0,0
544671,True,0,No user reviews,0,0,0
544680,True,0,4 user reviews,1,3,4
544700,True,0,No user reviews,0,0,0
544710,True,7,Positive,18,2,20
544730,True,0,No user reviews,0,0,0
544750,True,8,Very Positive,2463,552,3015
544760,True,0,No user reviews,0,0,0
544770,True,0,1 user reviews,0,1,1
544790,True,5,Mixed,34,19,53
544800,True,0,6 user reviews,4,2,6
544810,True,0,No user reviews,0,0,0
544820,True,0,2 user reviews,2,0,2
544830,True,0,2 user reviews,2,0,2
544831,True,0,No user reviews,0,0,0
544832,True,0,1 user reviews,1,0,1
544840,True,0,5 user reviews,3,2,5
544850,True,0,No user reviews,0,0,0
544870,True,5,Mixed,9,7,16
544880,True,0,3 user reviews,1,2,3
544890,True,0,No user reviews,0,0,0
544900,True,0,No user reviews,0,0,0
544920,True,6,Mostly Positive,625,221,846
544940,True,0,2 user reviews,2,0,2
544960,True,0,No user reviews,0,0,0
544970,True,8,Very Positive,238,10,248
544980,True,0,2 user reviews,2,0,2
544990,True,0,No user reviews,0,0,0
545000,True,0,No user reviews,0,0,0
545010,True,0,No user reviews,0,0,0
545020,True,0,7 user reviews,7,0,7
545030,True,8,Very Positive,51,3,54
545040,True,8,Very Positive,103,8,111
545050,True,5,Mixed,120,79,199
545060,True,5,Mixed,7,4,11
545070,True,0,No user reviews,0,0,0
545090,True,7,Positive,25,5,30
545100,True,6,Mostly Positive,97,30,127
545110,True,6,Mostly Positive,19,8,27
545120,True,0,No user reviews,0,0,0
545130,True,4,Mostly Negative,7,12,19
545140,True,0,No user reviews,0,0,0
545150,True,5,Mixed,10,8,18
545170,True,0,2 user reviews,2,0,2
545180,True,8,Very Positive,51,11,62
545190,True,0,No user reviews,0,0,0
545200,True,5,Mixed,9,6,15
545210,True,5,Mixed,8,6,14
545240,True,0,No user reviews,0,0,0
545260,True,0,1 user reviews,0,1,1
545270,True,5,Mixed,260,148,408
545290,True,0,No user reviews,0,0,0
545310,True,0,No user reviews,0,0,0
545330,True,5,Mixed,14,18,32
545340,True,0,8 user reviews,8,0,8
545400,True,0,8 user reviews,6,2,8
545410,True,8,Very Positive,53,13,66
545430,True,7,Positive,41,2,43
545450,True,0,No user reviews,0,0,0
545470,True,0,4 user reviews,3,1,4
545480,True,0,No user reviews,0,0,0
545481,True,0,No user reviews,0,0,0
545482,True,0,No user reviews,0,0,0
545490,True,0,6 user reviews,0,6,6
545500,True,0,No user reviews,0,0,0
545510,True,0,No user reviews,0,0,0
545511,True,0,No user reviews,0,0,0
545512,True,0,No user reviews,0,0,0
545513,True,0,No user reviews,0,0,0
545514,True,0,No user reviews,0,0,0
545530,True,0,No user reviews,0,0,0
545531,True,0,No user reviews,0,0,0
545532,True,0,No user reviews,0,0,0
545533,True,0,No user reviews,0,0,0
545534,True,0,No user reviews,0,0,0
545540,True,8,Very Positive,252,45,297
545560,True,0,3 user reviews,3,0,3
545570,True,0,No user reviews,0,0,0
545580,True,5,Mixed,26,23,49
545590,True,7,Positive,14,1,15
545600,True,8,Very Positive,144,31,175
545610,True,0,No user reviews,0,0,0
545620,True,5,Mixed,12,8,20
545630,True,0,No user reviews,0,0,0
545640,True,0,6 user reviews,4,2,6
545650,True,5,Mixed,63,72,135
545660,True,0,5 user reviews,5,0,5
545670,True,7,Positive,10,2,12
545690,True,8,Very Positive,173,10,183
545700,True,0,5 user reviews,1,4,5
545720,True,0,5 user reviews,3,2,5
545750,True,0,No user reviews,0,0,0
545760,True,0,No user reviews,0,0,0
545800,True,5,Mixed,7,7,14
545810,True,0,No user reviews,0,0,0
545820,True,0,8 user reviews,4,4,8
545830,True,5,Mixed,8,10,18
545840,True,0,1 user reviews,1,0,1
545850,True,7,Positive,9,1,10
545860,True,5,Mixed,14,12,26
545880,True,0,3 user reviews,3,0,3
545890,True,0,9 user reviews,6,3,9
545910,True,0,1 user reviews,1,0,1
545920,True,0,6 user reviews,3,3,6
545930,True,4,Mostly Negative,4,9,13
545940,True,7,Positive,12,1,13
545960,True,7,Positive,30,4,34
545980,True,8,Very Positive,196,15,211
545990,True,0,No user reviews,0,0,0
546030,True,0,7 user reviews,3,4,7
546040,True,0,3 user reviews,1,2,3
546050,True,8,Very Positive,1391,166,1557
546070,True,6,Mostly Positive,22,8,30
546080,True,8,Very Positive,67,16,83
546090,True,8,Very Positive,69,6,75
546100,True,0,5 user reviews,5,0,5
546110,True,0,3 user reviews,2,1,3
546120,True,0,No user reviews,0,0,0
546140,True,0,No user reviews,0,0,0
546150,True,6,Mostly Positive,48,19,67
546160,True,7,Positive,10,1,11
546170,True,7,Positive,13,0,13
546180,True,0,7 user reviews,5,2,7
546200,True,7,Positive,18,3,21
546210,True,5,Mixed,12,10,22
546220,True,7,Positive,10,2,12
546230,True,5,Mixed,9,4,13
546240,True,0,9 user reviews,2,7,9
546260,True,7,Positive,12,1,13
546310,True,0,8 user reviews,5,3,8
546311,True,0,4 user reviews,4,0,4
546312,True,0,4 user reviews,2,2,4
546320,True,0,9 user reviews,7,2,9
546330,True,7,Positive,10,0,10
546340,True,4,Mostly Negative,4,11,15
546350,True,5,Mixed,40,24,64
546360,True,5,Mixed,5,7,12
546370,True,0,2 user reviews,2,0,2
546371,True,0,6 user reviews,2,4,6
546372,True,0,4 user reviews,3,1,4
546373,True,4,Mostly Negative,6,10,16
546374,True,0,1 user reviews,1,0,1
546390,True,7,Positive,37,1,38
546400,True,4,Mostly Negative,9,21,30
546410,True,7,Positive,13,2,15
546430,True,6,Mostly Positive,613,232,845
546440,True,0,2 user reviews,0,2,2
546460,True,7,Positive,11,0,11
546480,True,0,No user reviews,0,0,0
546490,True,5,Mixed,12,9,21
546500,True,0,No user reviews,0,0,0
546520,True,0,1 user reviews,1,0,1
546550,True,7,Positive,35,2,37
546560,True,9,Overwhelmingly Positive,24622,367,24989
546590,True,0,No user reviews,0,0,0
546600,True,0,3 user reviews,3,0,3
546610,True,0,3 user reviews,2,1,3
546650,True,5,Mixed,11,5,16
546660,True,0,8 user reviews,1,7,8
546670,True,0,No user reviews,0,0,0
546690,True,0,No user reviews,0,0,0
546700,True,6,Mostly Positive,33,14,47
546720,True,0,No user reviews,0,0,0
546730,True,0,No user reviews,0,0,0
546780,True,7,Positive,17,2,19
546790,True,0,9 user reviews,8,1,9
546800,True,0,1 user reviews,1,0,1
546810,True,0,4 user reviews,4,0,4
546820,True,0,9 user reviews,4,5,9
546830,True,0,No user reviews,0,0,0
546860,True,0,1 user reviews,1,0,1
546870,True,0,5 user reviews,3,2,5
546880,True,0,No user reviews,0,0,0
546890,True,0,1 user reviews,1,0,1
546900,True,5,Mixed,19,24,43
546930,True,5,Mixed,81,76,157
546940,True,0,No user reviews,0,0,0
546960,True,0,No user reviews,0,0,0
546980,True,4,Mostly Negative,19,43,62
546990,True,5,Mixed,6,7,13
547000,True,0,1 user reviews,0,1,1
547020,True,0,No user reviews,0,0,0
547040,True,5,Mixed,7,5,12
547050,True,7,Positive,36,5,41
547060,True,0,No user reviews,0,0,0
547070,True,0,3 user reviews,3,0,3
547090,True,0,6 user reviews,3,3,6
547100,True,0,No user reviews,0,0,0
547120,True,7,Positive,12,1,13
547130,True,0,4 user reviews,3,1,4
547140,True,0,6 user reviews,4,2,6
547150,True,0,9 user reviews,6,3,9
547170,True,0,No user reviews,0,0,0
547180,True,5,Mixed,7,4,11
547200,True,0,8 user reviews,7,1,8
547210,True,0,3 user reviews,3,0,3
547230,True,0,1 user reviews,1,0,1
547240,True,0,No user reviews,0,0,0
547250,True,0,5 user reviews,0,5,5
547260,True,0,1 user reviews,0,1,1
547270,True,0,No user reviews,0,0,0
547271,True,0,No user reviews,0,0,0
547272,True,0,No user reviews,0,0,0
547273,True,0,No user reviews,0,0,0
547280,True,0,6 user reviews,6,0,6
547310,True,5,Mixed,19,10,29
547340,True,8,Very Positive,77,13,90
547350,True,0,No user reviews,0,0,0
547360,True,6,Mostly Positive,163,41,204
547370,True,0,No user reviews,0,0,0
547390,True,7,Positive,22,0,22
547400,True,0,No user reviews,0,0,0
547410,True,5,Mixed,109,112,221
547430,True,0,2 user reviews,2,0,2
547440,True,0,No user reviews,0,0,0
547470,True,0,4 user reviews,3,1,4
547480,True,8,Very Positive,79,2,81
547490,True,0,1 user reviews,1,0,1
547500,True,8,Very Positive,47,7,54
547501,True,6,Mostly Positive,51,17,68
547502,True,8,Very Positive,275,49,324
547520,True,0,4 user reviews,2,2,4
547530,True,0,No user reviews,0,0,0
547540,True,0,1 user reviews,1,0,1
547550,True,0,No user reviews,0,0,0
547560,True,0,1 user reviews,1,0,1
547561,True,0,1 user reviews,0,1,1
547562,True,0,1 user reviews,0,1,1
547570,True,0,4 user reviews,4,0,4
547580,True,0,No user reviews,0,0,0
547590,True,8,Very Positive,151,27,178
547610,True,0,No user reviews,0,0,0
547620,True,0,No user reviews,0,0,0
547630,True,0,1 user reviews,1,0,1
547650,True,0,No user reviews,0,0,0
547660,True,0,No user reviews,0,0,0
547670,True,0,No user reviews,0,0,0
547680,True,6,Mostly Positive,166,53,219
547690,True,0,No user reviews,0,0,0
547691,True,0,No user reviews,0,0,0
547692,True,0,No user reviews,0,0,0
547693,True,0,No user reviews,0,0,0
547694,True,0,No user reviews,0,0,0
547695,True,0,No user reviews,0,0,0
547696,True,0,No user reviews,0,0,0
547697,True,0,No user reviews,0,0,0
547698,True,0,No user reviews,0,0,0
547699,True,0,No user reviews,0,0,0
547700,True,0,No user reviews,0,0,0
547701,True,0,No user reviews,0,0,0
547702,True,0,No user reviews,0,0,0
547710,True,0,5 user reviews,4,1,5
547720,True,0,No user reviews,0,0,0
547730,True,0,3 user reviews,1,2,3
547740,True,0,6 user reviews,3,3,6
547750,True,0,3 user reviews,2,1,3
547760,True,6,Mostly Positive,15,4,19
547800,True,0,No user reviews,0,0,0
547820,True,0,5 user reviews,2,3,5
547830,True,0,No user reviews,0,0,0
547840,True,5,Mixed,8,6,14
547850,True,8,Very Positive,45,10,55
547860,True,5,Mixed,502,404,906
547870,True,0,No user reviews,0,0,0
547880,True,0,6 user reviews,4,2,6
547900,True,8,Very Positive,157,32,189
547910,True,6,Mostly Positive,188,61,249
547920,True,0,2 user reviews,0,2,2
547930,True,5,Mixed,8,4,12
547960,True,0,5 user reviews,3,2,5
547970,True,7,Positive,9,2,11
547980,True,7,Positive,38,2,40
547990,True,5,Mixed,8,5,13
548000,True,0,No user reviews,0,0,0
548010,True,5,Mixed,14,8,22
548020,True,5,Mixed,24,22,46
548050,True,7,Positive,12,2,14
548070,True,0,No user reviews,0,0,0
548080,True,5,Mixed,10,6,16
548110,True,0,5 user reviews,5,0,5
548130,True,7,Positive,13,1,14
548160,True,0,No user reviews,0,0,0
548170,True,0,2 user reviews,2,0,2
548190,True,0,No user reviews,0,0,0
548200,True,0,No user reviews,0,0,0
548210,True,0,No user reviews,0,0,0
548220,True,0,2 user reviews,2,0,2
548230,True,7,Positive,39,5,44
548240,True,6,Mostly Positive,13,5,18
548250,True,0,No user reviews,0,0,0
548260,True,0,4 user reviews,2,2,4
548270,True,0,No user reviews,0,0,0
548280,True,0,No user reviews,0,0,0
548290,True,0,5 user reviews,4,1,5
548300,True,0,No user reviews,0,0,0
548320,True,5,Mixed,7,5,12
548330,True,7,Positive,17,1,18
548340,True,8,Very Positive,207,15,222
548350,True,0,6 user reviews,0,6,6
548360,True,0,9 user reviews,6,3,9
548370,True,5,Mixed,40,58,98
548380,True,0,3 user reviews,2,1,3
548390,True,0,5 user reviews,4,1,5
548400,True,0,No user reviews,0,0,0
548410,True,0,2 user reviews,0,2,2
548420,True,8,Very Positive,103,22,125
548421,True,6,Mostly Positive,85,25,110
548430,True,9,Overwhelmingly Positive,27724,770,28494
548440,True,0,No user reviews,0,0,0
548450,True,5,Mixed,8,4,12
548470,True,0,8 user reviews,5,3,8
548480,True,4,Mostly Negative,11,27,38
548490,True,0,1 user reviews,1,0,1
548500,True,7,Positive,29,4,33
548510,True,0,1 user reviews,0,1,1
548520,True,0,No user reviews,0,0,0
548521,True,0,No user reviews,0,0,0
548522,True,0,No user reviews,0,0,0
548523,True,0,No user reviews,0,0,0
548524,True,0,No user reviews,0,0,0
548525,True,0,No user reviews,0,0,0
548540,True,0,1 user reviews,0,1,1
548560,True,5,Mixed,36,19,55
548570,True,5,Mixed,3427,2101,5528
548630,True,0,1 user reviews,1,0,1
548640,True,0,No user reviews,0,0,0
548641,True,0,No user reviews,0,0,0
548642,True,0,No user reviews,0,0,0
548643,True,0,No user reviews,0,0,0
548644,True,0,No user reviews,0,0,0
548645,True,0,No user reviews,0,0,0
548646,True,0,No user reviews,0,0,0
548647,True,0,No user reviews,0,0,0
548648,True,0,No user reviews,0,0,0
548649,True,0,No user reviews,0,0,0
548650,True,6,Mostly Positive,20,7,27
548660,True,0,9 user reviews,8,1,9
548680,True,7,Positive,38,4,42
548690,True,0,No user reviews,0,0,0
548700,True,0,1 user reviews,1,0,1
548710,True,0,1 user reviews,1,0,1
548720,True,0,2 user reviews,2,0,2
548730,True,0,No user reviews,0,0,0
548740,True,0,7 user reviews,3,4,7
548750,True,0,No user reviews,0,0,0
548760,True,5,Mixed,13,15,28
548770,True,0,No user reviews,0,0,0
548790,True,0,No user reviews,0,0,0
548810,True,6,Mostly Positive,9,3,12
548820,True,0,No user reviews,0,0,0
548821,True,0,1 user reviews,0,1,1
548830,True,0,No user reviews,0,0,0
548831,True,0,No user reviews,0,0,0
548840,True,8,Very Positive,63,15,78
548850,True,0,3 user reviews,2,1,3
548860,True,5,Mixed,11,6,17
548910,True,0,No user reviews,0,0,0
548920,True,0,No user reviews,0,0,0
548970,True,0,No user reviews,0,0,0
548971,True,0,No user reviews,0,0,0
548972,True,0,No user reviews,0,0,0
548980,True,0,No user reviews,0,0,0
549000,True,7,Positive,14,2,16
549030,True,0,9 user reviews,3,6,9
549040,True,5,Mixed,22,32,54
549070,True,0,9 user reviews,8,1,9
549071,True,0,6 user reviews,6,0,6
549080,True,8,Very Positive,110,25,135
549090,True,0,2 user reviews,2,0,2
549100,True,6,Mostly Positive,39,15,54
549110,True,0,No user reviews,0,0,0
549111,True,0,2 user reviews,1,1,2
549112,True,0,1 user reviews,1,0,1
549113,True,0,3 user reviews,3,0,3
549160,True,7,Positive,37,7,44
549170,True,5,Mixed,31,18,49
549180,True,5,Mixed,21,13,34
549190,True,0,5 user reviews,5,0,5
549200,True,7,Positive,13,0,13
549220,True,0,1 user reviews,1,0,1
549230,True,0,No user reviews,0,0,0
549240,True,5,Mixed,45,23,68
549250,True,0,No user reviews,0,0,0
549260,True,6,Mostly Positive,188,48,236
549280,True,0,2 user reviews,0,2,2
549290,True,0,3 user reviews,3,0,3
549300,True,0,1 user reviews,1,0,1
549310,True,0,1 user reviews,1,0,1
549320,True,0,1 user reviews,1,0,1
549321,True,0,No user reviews,0,0,0
549322,True,0,No user reviews,0,0,0
549323,True,0,No user reviews,0,0,0
549324,True,0,No user reviews,0,0,0
549325,True,0,No user reviews,0,0,0
549326,True,0,No user reviews,0,0,0
549327,True,0,No user reviews,0,0,0
549328,True,0,No user reviews,0,0,0
549329,True,0,No user reviews,0,0,0
549330,True,0,No user reviews,0,0,0
549331,True,0,No user reviews,0,0,0
549332,True,0,No user reviews,0,0,0
549370,True,0,No user reviews,0,0,0
549380,True,0,No user reviews,0,0,0
549390,True,6,Mostly Positive,20,7,27
549400,True,6,Mostly Positive,18,7,25
549410,True,0,No user reviews,0,0,0
549420,True,0,No user reviews,0,0,0
549421,True,0,No user reviews,0,0,0
549422,True,0,No user reviews,0,0,0
549430,True,0,No user reviews,0,0,0
549440,True,0,No user reviews,0,0,0
549441,True,0,No user reviews,0,0,0
549442,True,0,No user reviews,0,0,0
549443,True,0,No user reviews,0,0,0
549450,True,0,1 user reviews,1,0,1
549460,True,0,No user reviews,0,0,0
549461,True,0,No user reviews,0,0,0
549462,True,0,No user reviews,0,0,0
549463,True,0,No user reviews,0,0,0
549470,True,0,No user reviews,0,0,0
549480,True,0,No user reviews,0,0,0
549481,True,0,No user reviews,0,0,0
549490,True,0,2 user reviews,2,0,2
549500,True,0,No user reviews,0,0,0
549501,True,0,No user reviews,0,0,0
549502,True,0,No user reviews,0,0,0
549510,True,0,3 user reviews,3,0,3
549520,True,0,1 user reviews,0,1,1
549521,True,0,No user reviews,0,0,0
549522,True,0,No user reviews,0,0,0
549530,True,0,No user reviews,0,0,0
549540,True,0,No user reviews,0,0,0
549541,True,0,No user reviews,0,0,0
549550,True,0,1 user reviews,1,0,1
549560,True,0,No user reviews,0,0,0
549561,True,0,No user reviews,0,0,0
549562,True,0,No user reviews,0,0,0
549570,True,0,No user reviews,0,0,0
549580,True,0,No user reviews,0,0,0
549581,True,0,No user reviews,0,0,0
549582,True,0,No user reviews,0,0,0
549590,True,0,2 user reviews,2,0,2
549600,True,0,No user reviews,0,0,0
549601,True,0,No user reviews,0,0,0
549602,True,0,No user reviews,0,0,0
549610,True,0,No user reviews,0,0,0
549620,True,0,No user reviews,0,0,0
549630,True,0,No user reviews,0,0,0
549640,True,0,No user reviews,0,0,0
549650,True,0,No user reviews,0,0,0
549660,True,0,1 user reviews,1,0,1
549670,True,0,7 user reviews,4,3,7
549680,True,7,Positive,25,6,31
549700,True,0,7 user reviews,4,3,7
549720,True,0,1 user reviews,0,1,1
549740,True,7,Positive,19,1,20
549750,True,0,2 user reviews,2,0,2
549760,True,7,Positive,11,2,13
549770,True,0,3 user reviews,1,2,3
549780,True,0,3 user reviews,2,1,3
549790,True,0,No user reviews,0,0,0
549800,True,0,No user reviews,0,0,0
549830,True,0,1 user reviews,0,1,1
549840,True,7,Positive,20,1,21
549850,True,7,Positive,24,4,28
549860,True,8,Very Positive,258,35,293
549880,True,0,1 user reviews,1,0,1
549890,True,0,No user reviews,0,0,0
549900,True,0,6 user reviews,5,1,6
549910,True,5,Mixed,16,7,23
549920,True,0,No user reviews,0,0,0
549940,True,0,No user reviews,0,0,0
549950,True,5,Mixed,6,7,13
549960,True,0,No user reviews,0,0,0
549970,True,0,No user reviews,0,0,0
549971,True,0,1 user reviews,1,0,1
549990,True,0,No user reviews,0,0,0
550010,True,8,Very Positive,718,129,847
550040,True,0,No user reviews,0,0,0
550050,True,7,Positive,11,0,11
550060,True,8,Very Positive,68,0,68
550070,True,0,No user reviews,0,0,0
550080,True,8,Very Positive,278,42,320
550140,True,0,No user reviews,0,0,0
550160,True,7,Positive,16,0,16
550170,True,7,Positive,16,0,16
550180,True,0,No user reviews,0,0,0
550200,True,0,2 user reviews,2,0,2
550210,True,0,8 user reviews,7,1,8
550220,True,0,1 user reviews,1,0,1
550240,True,0,9 user reviews,4,5,9
550260,True,0,No user reviews,0,0,0
550270,True,0,1 user reviews,1,0,1
550280,True,0,No user reviews,0,0,0
550290,True,0,No user reviews,0,0,0
550300,True,0,No user reviews,0,0,0
550310,True,8,Very Positive,94,23,117
550320,True,9,Overwhelmingly Positive,513,26,539
550330,True,0,2 user reviews,1,1,2
550331,True,7,Positive,10,0,10
550332,True,0,3 user reviews,2,1,3
550333,True,0,1 user reviews,1,0,1
550334,True,0,2 user reviews,2,0,2
550335,True,0,1 user reviews,1,0,1
550340,True,8,Very Positive,73,14,87
550350,True,0,1 user reviews,1,0,1
550360,True,5,Mixed,23,12,35
550370,True,0,No user reviews,0,0,0
550380,True,0,1 user reviews,1,0,1
550381,True,0,2 user reviews,2,0,2
550382,True,0,2 user reviews,2,0,2
550390,True,6,Mostly Positive,7,3,10
550400,True,7,Positive,13,0,13
550410,True,0,No user reviews,0,0,0
550420,True,0,8 user reviews,7,1,8
550440,True,0,3 user reviews,2,1,3
550450,True,5,Mixed,8,4,12
550460,True,0,3 user reviews,3,0,3
550461,True,0,8 user reviews,8,0,8
550470,True,0,No user reviews,0,0,0
550480,True,0,1 user reviews,1,0,1
550520,True,0,No user reviews,0,0,0
550530,True,0,No user reviews,0,0,0
550540,True,0,7 user reviews,4,3,7
550560,True,0,No user reviews,0,0,0
550580,True,6,Mostly Positive,29,10,39
550590,True,8,Very Positive,80,5,85
550600,True,0,2 user reviews,0,2,2
550640,True,0,No user reviews,0,0,0
550650,True,0,8 user reviews,5,3,8
550670,True,4,Mostly Negative,30,95,125
550680,True,0,No user reviews,0,0,0
550690,True,0,No user reviews,0,0,0
550700,True,0,No user reviews,0,0,0
550710,True,0,1 user reviews,1,0,1
550740,True,0,No user reviews,0,0,0
550760,True,0,No user reviews,0,0,0
550761,True,0,No user reviews,0,0,0
550762,True,0,No user reviews,0,0,0
550763,True,0,No user reviews,0,0,0
550764,True,0,No user reviews,0,0,0
550765,True,0,No user reviews,0,0,0
550766,True,0,No user reviews,0,0,0
550767,True,0,No user reviews,0,0,0
550768,True,0,No user reviews,0,0,0
550769,True,0,No user reviews,0,0,0
550770,True,0,No user reviews,0,0,0
550771,True,0,No user reviews,0,0,0
550772,True,0,No user reviews,0,0,0
550773,True,0,No user reviews,0,0,0
550774,True,0,No user reviews,0,0,0
550775,True,0,No user reviews,0,0,0
550776,True,0,No user reviews,0,0,0
550777,True,0,No user reviews,0,0,0
550778,True,0,No user reviews,0,0,0
550779,True,0,No user reviews,0,0,0
550780,True,0,No user reviews,0,0,0
550781,True,0,No user reviews,0,0,0
550782,True,0,No user reviews,0,0,0
550783,True,0,No user reviews,0,0,0
550784,True,0,No user reviews,0,0,0
550790,True,0,No user reviews,0,0,0
550800,True,0,3 user reviews,3,0,3
550810,True,7,Positive,31,6,37
550820,True,0,2 user reviews,2,0,2
550830,True,0,No user reviews,0,0,0
550840,True,5,Mixed,57,44,101
550850,True,0,No user reviews,0,0,0
550870,True,0,2 user reviews,1,1,2
550880,True,6,Mostly Positive,11,4,15
550890,True,0,3 user reviews,2,1,3
550900,True,0,No user reviews,0,0,0
550910,True,0,No user reviews,0,0,0
550930,True,0,4 user reviews,4,0,4
550990,True,7,Positive,23,1,24
551020,True,0,No user reviews,0,0,0
551030,True,0,No user reviews,0,0,0
551050,True,4,Mostly Negative,4,7,11
551060,True,0,5 user reviews,5,0,5
551070,True,0,No user reviews,0,0,0
551080,True,6,Mostly Positive,25,8,33
551100,True,0,5 user reviews,4,1,5
551110,True,8,Very Positive,161,29,190
551130,True,0,No user reviews,0,0,0
551150,True,0,8 user reviews,8,0,8
551160,True,0,1 user reviews,1,0,1
551170,True,8,Very Positive,125,28,153
551190,True,8,Very Positive,59,6,65
551200,True,0,No user reviews,0,0,0
551210,True,0,No user reviews,0,0,0
551220,True,0,No user reviews,0,0,0
551230,True,0,No user reviews,0,0,0
551240,True,0,No user reviews,0,0,0
551250,True,0,No user reviews,0,0,0
551260,True,0,6 user reviews,6,0,6
551290,True,0,No user reviews,0,0,0
551300,True,0,No user reviews,0,0,0
551310,True,0,No user reviews,0,0,0
551320,True,5,Mixed,8,4,12
551330,True,0,No user reviews,0,0,0
551340,True,0,No user reviews,0,0,0
551341,True,0,No user reviews,0,0,0
551342,True,0,No user reviews,0,0,0
551343,True,0,No user reviews,0,0,0
551344,True,0,No user reviews,0,0,0
551345,True,0,No user reviews,0,0,0
551346,True,0,No user reviews,0,0,0
551347,True,0,No user reviews,0,0,0
551348,True,0,No user reviews,0,0,0
551349,True,0,No user reviews,0,0,0
551350,True,0,No user reviews,0,0,0
551360,True,0,2 user reviews,2,0,2
551370,True,5,Mixed,46,25,71
551380,True,0,5 user reviews,5,0,5
551390,True,0,No user reviews,0,0,0
551391,True,0,No user reviews,0,0,0
551392,True,0,No user reviews,0,0,0
551393,True,0,No user reviews,0,0,0
551394,True,0,No user reviews,0,0,0
551395,True,0,No user reviews,0,0,0
551410,True,0,No user reviews,0,0,0
551440,True,5,Mixed,14,7,21
551450,True,8,Very Positive,170,18,188
551500,True,0,1 user reviews,0,1,1
551510,True,0,No user reviews,0,0,0
551520,True,0,9 user reviews,6,3,9
551530,True,0,No user reviews,0,0,0
551540,True,0,No user reviews,0,0,0
551550,True,4,Mostly Negative,3,8,11
551560,True,0,5 user reviews,5,0,5
551570,True,0,6 user reviews,6,0,6
551580,True,7,Positive,36,5,41
551590,True,0,No user reviews,0,0,0
551610,True,0,9 user reviews,1,8,9
551620,True,8,Very Positive,66,6,72
551630,True,5,Mixed,15,15,30
551650,True,0,7 user reviews,4,3,7
551670,True,0,2 user reviews,1,1,2
551680,True,0,4 user reviews,3,1,4
551690,True,6,Mostly Positive,81,23,104
551700,True,6,Mostly Positive,174,49,223
551710,True,0,No user reviews,0,0,0
551720,True,5,Mixed,13,7,20
551730,True,6,Mostly Positive,345,90,435
551740,True,0,4 user reviews,1,3,4
551750,True,0,8 user reviews,6,2,8
551770,True,8,Very Positive,614,140,754
551780,True,0,6 user reviews,3,3,6
551790,True,0,5 user reviews,4,1,5
551810,True,0,2 user reviews,2,0,2
551820,True,6,Mostly Positive,7,3,10
551821,True,7,Positive,12,3,15
551840,True,0,5 user reviews,4,1,5
551850,True,0,No user reviews,0,0,0
551860,True,6,Mostly Positive,347,118,465
551880,True,7,Positive,32,8,40
551890,True,0,No user reviews,0,0,0
551891,True,0,No user reviews,0,0,0
551892,True,0,No user reviews,0,0,0
551893,True,0,No user reviews,0,0,0
551894,True,0,No user reviews,0,0,0
551895,True,0,No user reviews,0,0,0
551896,True,0,No user reviews,0,0,0
551897,True,0,No user reviews,0,0,0
551898,True,0,No user reviews,0,0,0
551900,True,0,No user reviews,0,0,0
551910,True,0,No user reviews,0,0,0
551911,True,0,No user reviews,0,0,0
551912,True,0,No user reviews,0,0,0
551913,True,0,No user reviews,0,0,0
551914,True,0,No user reviews,0,0,0
551915,True,0,No user reviews,0,0,0
551916,True,0,No user reviews,0,0,0
551917,True,0,No user reviews,0,0,0
551918,True,0,No user reviews,0,0,0
551919,True,0,No user reviews,0,0,0
551930,True,5,Mixed,11,8,19
551940,True,0,No user reviews,0,0,0
551941,True,0,No user reviews,0,0,0
551942,True,0,No user reviews,0,0,0
551943,True,0,No user reviews,0,0,0
551944,True,0,No user reviews,0,0,0
551945,True,0,No user reviews,0,0,0
551946,True,0,No user reviews,0,0,0
551947,True,0,No user reviews,0,0,0
551948,True,0,No user reviews,0,0,0
551949,True,0,No user reviews,0,0,0
551950,True,0,No user reviews,0,0,0
551951,True,0,No user reviews,0,0,0
551952,True,0,No user reviews,0,0,0
551953,True,0,No user reviews,0,0,0
551954,True,0,No user reviews,0,0,0
551960,True,0,1 user reviews,1,0,1
551970,True,0,1 user reviews,1,0,1
551971,True,0,2 user reviews,1,1,2
552000,True,0,1 user reviews,1,0,1
552010,True,0,2 user reviews,0,2,2
552011,True,0,No user reviews,0,0,0
552020,True,0,No user reviews,0,0,0
552030,True,5,Mixed,34,18,52
552050,True,0,No user reviews,0,0,0
552060,True,7,Positive,34,8,42
552070,True,0,No user reviews,0,0,0
552080,True,9,Overwhelmingly Positive,516,13,529
552090,True,5,Mixed,16,11,27
552100,True,8,Very Positive,5996,527,6523
552110,True,0,2 user reviews,1,1,2
552120,True,6,Mostly Positive,8,3,11
552130,True,5,Mixed,50,72,122
552140,True,0,3 user reviews,2,1,3
552150,True,0,1 user reviews,0,1,1
552160,True,8,Very Positive,64,5,69
552190,True,0,1 user reviews,1,0,1
552200,True,0,8 user reviews,8,0,8
552210,True,0,1 user reviews,1,0,1
552220,True,0,1 user reviews,1,0,1
552230,True,0,7 user reviews,3,4,7
552240,True,0,1 user reviews,1,0,1
552270,True,0,6 user reviews,3,3,6
552280,True,7,Positive,16,4,20
552300,True,0,6 user reviews,2,4,6
552310,True,0,5 user reviews,2,3,5
552330,True,0,2 user reviews,2,0,2
552340,True,0,No user reviews,0,0,0
552350,True,5,Mixed,10,7,17
552360,True,0,1 user reviews,1,0,1
552370,True,7,Positive,10,1,11
552380,True,0,4 user reviews,3,1,4
552390,True,5,Mixed,17,17,34
552400,True,7,Positive,11,1,12
552410,True,5,Mixed,16,11,27
552440,True,8,Very Positive,356,69,425
552450,True,8,Very Positive,320,55,375
552460,True,8,Very Positive,95,10,105
552480,True,0,No user reviews,0,0,0
552490,True,0,No user reviews,0,0,0
552500,True,8,Very Positive,17410,2971,20381
552520,True,6,Mostly Positive,21927,6900,28827
552530,True,0,No user reviews,0,0,0
552540,True,0,4 user reviews,2,2,4
552550,True,0,3 user reviews,0,3,3
552570,True,0,3 user reviews,2,1,3
552580,True,5,Mixed,9,5,14
552590,True,8,Very Positive,1157,93,1250
552600,True,8,Very Positive,235,48,283
552610,True,0,7 user reviews,7,0,7
552620,True,8,Very Positive,1848,323,2171
552630,True,0,8 user reviews,6,2,8
552640,True,0,1 user reviews,1,0,1
552641,True,0,No user reviews,0,0,0
552642,True,0,No user reviews,0,0,0
552643,True,0,1 user reviews,1,0,1
552650,True,0,1 user reviews,1,0,1
552651,True,4,Mostly Negative,5,9,14
552652,True,0,No user reviews,0,0,0
552653,True,0,No user reviews,0,0,0
552660,True,0,1 user reviews,0,1,1
552670,True,0,1 user reviews,0,1,1
552680,True,0,No user reviews,0,0,0
552690,True,0,4 user reviews,4,0,4
552700,True,6,Mostly Positive,716,181,897
552720,True,6,Mostly Positive,7,3,10
552730,True,0,No user reviews,0,0,0
552750,True,0,No user reviews,0,0,0
552760,True,0,No user reviews,0,0,0
552770,True,0,2 user reviews,2,0,2
552780,True,7,Positive,10,2,12
552800,True,0,3 user reviews,3,0,3
552810,True,0,No user reviews,0,0,0
552820,True,0,1 user reviews,1,0,1
552830,True,0,No user reviews,0,0,0
552850,True,0,3 user reviews,3,0,3
552860,True,0,No user reviews,0,0,0
552870,True,0,4 user reviews,3,1,4
552880,True,8,Very Positive,114,12,126
552890,True,0,No user reviews,0,0,0
552900,True,0,1 user reviews,1,0,1
552910,True,4,Mostly Negative,4,7,11
552920,True,5,Mixed,270,149,419
552940,True,0,1 user reviews,1,0,1
552950,True,0,2 user reviews,1,1,2
552960,True,0,2 user reviews,0,2,2
552970,True,5,Mixed,44,21,65
552990,True,8,Very Positive,123,18,141
553000,True,5,Mixed,4,6,10
553020,True,0,4 user reviews,4,0,4
553030,True,5,Mixed,13,8,21
553040,True,0,6 user reviews,5,1,6
553050,True,5,Mixed,8,4,12
553070,True,0,1 user reviews,1,0,1
553071,True,0,No user reviews,0,0,0
553072,True,0,No user reviews,0,0,0
553073,True,0,1 user reviews,1,0,1
553074,True,0,2 user reviews,2,0,2
553075,True,0,2 user reviews,2,0,2
553080,True,0,No user reviews,0,0,0
553090,True,0,1 user reviews,1,0,1
553100,True,0,9 user reviews,1,8,9
553110,True,5,Mixed,6,9,15
553120,True,0,3 user reviews,3,0,3
553130,True,0,2 user reviews,1,1,2
553140,True,0,No user reviews,0,0,0
553150,True,0,7 user reviews,2,5,7
553160,True,0,6 user reviews,6,0,6
553170,True,0,1 user reviews,1,0,1
553180,True,0,4 user reviews,2,2,4
553190,True,0,1 user reviews,1,0,1
553200,True,0,No user reviews,0,0,0
553210,True,6,Mostly Positive,196,78,274
553220,True,0,No user reviews,0,0,0
553221,True,0,No user reviews,0,0,0
553222,True,0,No user reviews,0,0,0
553223,True,0,No user reviews,0,0,0
553224,True,0,No user reviews,0,0,0
553225,True,0,No user reviews,0,0,0
553226,True,0,No user reviews,0,0,0
553227,True,0,No user reviews,0,0,0
553228,True,0,No user reviews,0,0,0
553229,True,0,No user reviews,0,0,0
553230,True,0,No user reviews,0,0,0
553231,True,0,No user reviews,0,0,0
553232,True,0,No user reviews,0,0,0
553233,True,0,No user reviews,0,0,0
553234,True,0,No user reviews,0,0,0
553235,True,0,No user reviews,0,0,0
553236,True,0,No user reviews,0,0,0
553237,True,0,No user reviews,0,0,0
553238,True,0,No user reviews,0,0,0
553239,True,0,No user reviews,0,0,0
553240,True,0,No user reviews,0,0,0
553241,True,0,No user reviews,0,0,0
553242,True,0,No user reviews,0,0,0
553243,True,0,No user reviews,0,0,0
553244,True,0,No user reviews,0,0,0
553245,True,0,No user reviews,0,0,0
553260,True,5,Mixed,192,133,325
553270,True,0,No user reviews,0,0,0
553271,True,0,No user reviews,0,0,0
553280,True,8,Very Positive,441,83,524
553290,True,5,Mixed,10,13,23
553310,True,9,Overwhelmingly Positive,2296,77,2373
553320,True,5,Mixed,11,13,24
553330,True,0,2 user reviews,2,0,2
553340,True,7,Positive,25,6,31
553350,True,0,No user reviews,0,0,0
553360,True,0,No user reviews,0,0,0
553370,True,0,1 user reviews,1,0,1
553380,True,0,2 user reviews,2,0,2
553381,True,0,No user reviews,0,0,0
553382,True,0,No user reviews,0,0,0
553383,True,0,No user reviews,0,0,0
553384,True,0,No user reviews,0,0,0
553385,True,0,No user reviews,0,0,0
553386,True,0,No user reviews,0,0,0
553387,True,0,No user reviews,0,0,0
553410,True,0,8 user reviews,4,4,8
553420,True,0,No user reviews,0,0,0
553430,True,0,5 user reviews,3,2,5
553440,True,0,4 user reviews,4,0,4
553450,True,6,Mostly Positive,17,7,24
553470,True,5,Mixed,8,8,16
553480,True,8,Very Positive,162,27,189
553490,True,0,2 user reviews,1,1,2
553500,True,0,2 user reviews,2,0,2
553510,True,0,No user reviews,0,0,0
553520,True,6,Mostly Positive,190,69,259
553530,True,0,No user reviews,0,0,0
553540,True,0,No user reviews,0,0,0
553570,True,0,2 user reviews,0,2,2
553590,True,0,5 user reviews,5,0,5
553610,True,5,Mixed,12,6,18
553620,True,0,No user reviews,0,0,0
553630,True,0,2 user reviews,0,2,2
553640,True,8,Very Positive,1886,427,2313
553650,True,0,No user reviews,0,0,0
553660,True,6,Mostly Positive,50,17,67
553670,True,7,Positive,16,0,16
553680,True,0,1 user reviews,0,1,1
553690,True,0,8 user reviews,3,5,8
553700,True,0,2 user reviews,2,0,2
553720,True,0,1 user reviews,1,0,1
553750,True,0,3 user reviews,3,0,3
553760,True,8,Very Positive,77,3,80
553780,True,0,2 user reviews,2,0,2
553790,True,8,Very Positive,42,8,50
553800,True,5,Mixed,11,11,22
553820,True,6,Mostly Positive,11,4,15
553830,True,0,3 user reviews,1,2,3
553861,True,0,1 user reviews,1,0,1
553880,True,6,Mostly Positive,83,33,116
553910,True,0,2 user reviews,1,1,2
553920,True,5,Mixed,6,6,12
553930,True,0,No user reviews,0,0,0
553940,True,0,No user reviews,0,0,0
553950,True,7,Positive,20,1,21
553960,True,5,Mixed,19,15,34
553980,True,0,No user reviews,0,0,0
554000,True,8,Very Positive,162,4,166
554010,True,0,No user reviews,0,0,0
554011,True,0,No user reviews,0,0,0
554012,True,0,No user reviews,0,0,0
554013,True,0,No user reviews,0,0,0
554014,True,0,No user reviews,0,0,0
554015,True,0,No user reviews,0,0,0
554016,True,0,No user reviews,0,0,0
554017,True,0,No user reviews,0,0,0
554018,True,0,No user reviews,0,0,0
554019,True,0,No user reviews,0,0,0
554020,True,0,No user reviews,0,0,0
554021,True,0,No user reviews,0,0,0
554022,True,0,No user reviews,0,0,0
554023,True,0,No user reviews,0,0,0
554024,True,0,No user reviews,0,0,0
554025,True,0,No user reviews,0,0,0
554026,True,0,No user reviews,0,0,0
554027,True,0,No user reviews,0,0,0
554028,True,0,No user reviews,0,0,0
554029,True,0,No user reviews,0,0,0
554030,True,0,No user reviews,0,0,0
554031,True,0,No user reviews,0,0,0
554032,True,0,No user reviews,0,0,0
554040,True,0,No user reviews,0,0,0
554041,True,0,No user reviews,0,0,0
554042,True,0,No user reviews,0,0,0
554043,True,0,No user reviews,0,0,0
554044,True,0,No user reviews,0,0,0
554045,True,0,No user reviews,0,0,0
554046,True,0,No user reviews,0,0,0
554047,True,0,No user reviews,0,0,0
554048,True,0,No user reviews,0,0,0
554049,True,0,No user reviews,0,0,0
554050,True,0,No user reviews,0,0,0
554051,True,0,No user reviews,0,0,0
554052,True,0,No user reviews,0,0,0
554053,True,0,No user reviews,0,0,0
554054,True,0,No user reviews,0,0,0
554055,True,0,No user reviews,0,0,0
554056,True,0,No user reviews,0,0,0
554057,True,0,No user reviews,0,0,0
554058,True,0,No user reviews,0,0,0
554059,True,0,No user reviews,0,0,0
554060,True,0,No user reviews,0,0,0
554061,True,0,No user reviews,0,0,0
554062,True,0,No user reviews,0,0,0
554070,True,0,No user reviews,0,0,0
554071,True,0,No user reviews,0,0,0
554072,True,0,No user reviews,0,0,0
554073,True,0,No user reviews,0,0,0
554074,True,0,No user reviews,0,0,0
554075,True,0,No user reviews,0,0,0
554076,True,0,No user reviews,0,0,0
554077,True,0,No user reviews,0,0,0
554078,True,0,No user reviews,0,0,0
554079,True,0,No user reviews,0,0,0
554080,True,0,No user reviews,0,0,0
554081,True,0,No user reviews,0,0,0
554082,True,0,No user reviews,0,0,0
554083,True,0,No user reviews,0,0,0
554084,True,0,No user reviews,0,0,0
554085,True,0,No user reviews,0,0,0
554086,True,0,No user reviews,0,0,0
554087,True,0,No user reviews,0,0,0
554088,True,0,No user reviews,0,0,0
554089,True,0,No user reviews,0,0,0
554090,True,0,No user reviews,0,0,0
554091,True,0,No user reviews,0,0,0
554092,True,0,No user reviews,0,0,0
554100,True,0,No user reviews,0,0,0
554101,True,0,No user reviews,0,0,0
554102,True,0,No user reviews,0,0,0
554103,True,0,No user reviews,0,0,0
554104,True,0,No user reviews,0,0,0
554105,True,0,No user reviews,0,0,0
554106,True,0,No user reviews,0,0,0
554107,True,0,No user reviews,0,0,0
554108,True,0,No user reviews,0,0,0
554109,True,0,No user reviews,0,0,0
554110,True,0,No user reviews,0,0,0
554111,True,0,No user reviews,0,0,0
554112,True,0,No user reviews,0,0,0
554113,True,0,No user reviews,0,0,0
554114,True,0,No user reviews,0,0,0
554115,True,0,No user reviews,0,0,0
554116,True,0,No user reviews,0,0,0
554117,True,0,No user reviews,0,0,0
554118,True,0,No user reviews,0,0,0
554119,True,0,No user reviews,0,0,0
554120,True,0,No user reviews,0,0,0
554121,True,0,No user reviews,0,0,0
554122,True,0,No user reviews,0,0,0
554130,True,0,No user reviews,0,0,0
554140,True,0,3 user reviews,2,1,3
554150,True,7,Positive,31,3,34
554170,True,0,No user reviews,0,0,0
554171,True,0,No user reviews,0,0,0
554172,True,0,No user reviews,0,0,0
554173,True,0,No user reviews,0,0,0
554174,True,0,No user reviews,0,0,0
554175,True,0,No user reviews,0,0,0
554176,True,0,No user reviews,0,0,0
554177,True,0,No user reviews,0,0,0
554178,True,0,No user reviews,0,0,0
554179,True,0,No user reviews,0,0,0
554180,True,7,Positive,20,5,25
554200,True,0,No user reviews,0,0,0
554220,True,7,Positive,33,7,40
554260,True,0,No user reviews,0,0,0
554270,True,0,No user reviews,0,0,0
554271,True,0,No user reviews,0,0,0
554272,True,0,1 user reviews,0,1,1
554273,True,0,No user reviews,0,0,0
554280,True,7,Positive,27,5,32
554290,True,7,Positive,34,3,37
554310,True,6,Mostly Positive,105,27,132
554320,True,0,2 user reviews,2,0,2
554321,True,0,2 user reviews,2,0,2
554330,True,7,Positive,22,2,24
554340,True,0,No user reviews,0,0,0
554350,True,0,No user reviews,0,0,0
554360,True,0,No user reviews,0,0,0
554370,True,0,No user reviews,0,0,0
554371,True,0,No user reviews,0,0,0
554380,True,8,Very Positive,127,25,152
554381,True,6,Mostly Positive,223,63,286
554390,True,7,Positive,17,0,17
554470,True,7,Positive,19,2,21
554480,True,0,No user reviews,0,0,0
554500,True,0,No user reviews,0,0,0
554530,True,7,Positive,24,6,30
554540,True,0,No user reviews,0,0,0
554550,True,0,6 user reviews,3,3,6
554560,True,0,3 user reviews,3,0,3
554570,True,5,Mixed,24,24,48
554590,True,0,2 user reviews,1,1,2
554600,True,8,Very Positive,184,14,198
554610,True,0,No user reviews,0,0,0
554620,True,8,Very Positive,9767,793,10560
554640,True,0,2 user reviews,0,2,2
554650,True,0,No user reviews,0,0,0
554660,True,0,3 user reviews,3,0,3
554680,True,0,9 user reviews,6,3,9
554690,True,0,1 user reviews,1,0,1
554700,True,0,8 user reviews,7,1,8
554710,True,0,No user reviews,0,0,0
554720,True,0,No user reviews,0,0,0
554750,True,5,Mixed,65,46,111
554770,True,0,1 user reviews,0,1,1
554780,True,0,No user reviews,0,0,0
554790,True,5,Mixed,7,7,14
554791,True,5,Mixed,30,23,53
554800,True,7,Positive,26,6,32
554810,True,8,Very Positive,51,12,63
554820,True,6,Mostly Positive,18,5,23
554840,True,0,No user reviews,0,0,0
554850,True,0,No user reviews,0,0,0
554870,True,7,Positive,17,2,19
554920,True,0,1 user reviews,1,0,1
554940,True,0,4 user reviews,3,1,4
554950,True,7,Positive,21,1,22
554960,True,0,No user reviews,0,0,0
554980,True,0,4 user reviews,3,1,4
555000,True,8,Very Positive,226,22,248
555010,True,5,Mixed,28,13,41
555020,True,0,1 user reviews,1,0,1
555030,True,0,No user reviews,0,0,0
555040,True,0,No user reviews,0,0,0
555050,True,6,Mostly Positive,81,22,103
555060,True,6,Mostly Positive,41,11,52
555070,True,0,No user reviews,0,0,0
555080,True,0,No user reviews,0,0,0
555090,True,0,No user reviews,0,0,0
555100,True,0,2 user reviews,1,1,2
555110,True,0,No user reviews,0,0,0
555120,True,0,9 user reviews,9,0,9
555130,True,0,2 user reviews,0,2,2
555150,True,6,Mostly Positive,1043,287,1330
555160,True,8,Very Positive,12369,739,13108
555170,True,0,6 user reviews,4,2,6
555180,True,5,Mixed,15,14,29
555210,True,8,Very Positive,290,50,340
555220,True,9,Overwhelmingly Positive,1559,62,1621
555230,True,0,1 user reviews,0,1,1
555250,True,0,No user reviews,0,0,0
555260,True,4,Mostly Negative,3,8,11
555270,True,0,No user reviews,0,0,0
555280,True,5,Mixed,7,4,11
555290,True,8,Very Positive,53,13,66
555300,True,5,Mixed,19,11,30
555310,True,6,Mostly Positive,11,3,14
555320,True,6,Mostly Positive,39,12,51
555340,True,0,2 user reviews,2,0,2
555360,True,0,1 user reviews,1,0,1
555370,True,0,5 user reviews,2,3,5
555380,True,0,No user reviews,0,0,0
555400,True,8,Very Positive,105,26,131
555410,True,0,4 user reviews,3,1,4
555420,True,0,No user reviews,0,0,0
555440,True,6,Mostly Positive,2321,716,3037
555450,True,4,Mostly Negative,14,43,57
555500,True,0,No user reviews,0,0,0
555510,True,5,Mixed,147,111,258
555520,True,0,4 user reviews,4,0,4
555530,True,0,5 user reviews,3,2,5
555531,True,5,Mixed,11,5,16
555532,True,0,3 user reviews,1,2,3
555540,True,0,No user reviews,0,0,0
555550,True,0,No user reviews,0,0,0
555570,True,5,Mixed,389,515,904
555580,True,7,Positive,20,0,20
555590,True,0,No user reviews,0,0,0
555600,True,7,Positive,19,1,20
555610,True,6,Mostly Positive,20,8,28
555630,True,7,Positive,33,2,35
555640,True,8,Very Positive,47,3,50
555650,True,5,Mixed,12,9,21
555660,True,4,Mostly Negative,24,39,63
555670,True,0,8 user reviews,0,8,8
555680,True,0,No user reviews,0,0,0
555710,True,6,Mostly Positive,44,13,57
555720,True,0,7 user reviews,6,1,7
555730,True,7,Positive,8,2,10
555740,True,0,No user reviews,0,0,0
555750,True,5,Mixed,111,65,176
555760,True,0,4 user reviews,2,2,4
555770,True,0,1 user reviews,1,0,1
555790,True,0,No user reviews,0,0,0
555810,True,0,1 user reviews,1,0,1
555820,True,0,5 user reviews,0,5,5
555830,True,0,No user reviews,0,0,0
555840,True,0,No user reviews,0,0,0
555850,True,0,4 user reviews,1,3,4
555861,True,0,No user reviews,0,0,0
555865,True,0,No user reviews,0,0,0
555880,True,8,Very Positive,924,124,1048
555890,True,0,5 user reviews,4,1,5
555910,True,0,No user reviews,0,0,0
555920,True,3,Negative,1,16,17
555930,True,0,4 user reviews,2,2,4
555950,True,8,Very Positive,909,98,1007
555960,True,0,No user reviews,0,0,0
555970,True,7,Positive,17,1,18
556000,True,0,4 user reviews,0,4,4
556030,True,0,No user reviews,0,0,0
556050,True,8,Very Positive,136,8,144
556060,True,7,Positive,16,4,20
556090,True,0,No user reviews,0,0,0
556100,True,0,No user reviews,0,0,0
556130,True,0,2 user reviews,2,0,2
556140,True,7,Positive,23,3,26
556150,True,0,1 user reviews,1,0,1
556160,True,0,No user reviews,0,0,0
556170,True,0,1 user reviews,1,0,1
556180,True,6,Mostly Positive,106,33,139
556190,True,6,Mostly Positive,14,4,18
556200,True,0,1 user reviews,0,1,1
556210,True,6,Mostly Positive,9,3,12
556212,True,5,Mixed,60,37,97
556213,True,5,Mixed,24,17,41
556214,True,0,5 user reviews,4,1,5
556217,True,0,9 user reviews,2,7,9
556218,True,0,3 user reviews,3,0,3
556219,True,0,6 user reviews,0,6,6
556220,True,0,2 user reviews,2,0,2
556221,True,5,Mixed,27,22,49
556222,True,5,Mixed,26,17,43
556223,True,0,4 user reviews,4,0,4
556224,True,0,3 user reviews,0,3,3
556225,True,0,4 user reviews,1,3,4
556226,True,0,5 user reviews,1,4,5
556229,True,0,3 user reviews,3,0,3
556230,True,5,Mixed,35,19,54
556240,True,8,Very Positive,140,25,165
556250,True,0,4 user reviews,4,0,4
556260,True,0,6 user reviews,4,2,6
556270,True,0,No user reviews,0,0,0
556280,True,6,Mostly Positive,44,18,62
556290,True,0,No user reviews,0,0,0
556300,True,3,Negative,0,11,11
556310,True,0,2 user reviews,2,0,2
556340,True,8,Very Positive,87,21,108
556350,True,0,1 user reviews,1,0,1
556352,True,0,No user reviews,0,0,0
556390,True,0,2 user reviews,1,1,2
556391,True,4,Mostly Negative,10,31,41
556392,True,5,Mixed,13,6,19
556400,True,0,No user reviews,0,0,0
556401,True,0,No user reviews,0,0,0
556402,True,0,No user reviews,0,0,0
556403,True,0,No user reviews,0,0,0
556404,True,0,No user reviews,0,0,0
556405,True,0,No user reviews,0,0,0
556406,True,0,No user reviews,0,0,0
556407,True,0,No user reviews,0,0,0
556408,True,0,No user reviews,0,0,0
556409,True,0,No user reviews,0,0,0
556410,True,0,No user reviews,0,0,0
556411,True,0,No user reviews,0,0,0
556412,True,0,No user reviews,0,0,0
556413,True,0,No user reviews,0,0,0
556420,True,0,No user reviews,0,0,0
556430,True,0,No user reviews,0,0,0
556450,True,0,No user reviews,0,0,0
556460,True,0,No user reviews,0,0,0
556470,True,6,Mostly Positive,105,32,137
556480,True,5,Mixed,37,31,68
556490,True,0,No user reviews,0,0,0
556500,True,0,2 user reviews,2,0,2
556520,True,5,Mixed,6,4,10
556530,True,6,Mostly Positive,9,3,12
556540,True,0,7 user reviews,5,2,7
556550,True,5,Mixed,33,32,65
556560,True,0,No user reviews,0,0,0
556570,True,0,4 user reviews,4,0,4
556600,True,0,No user reviews,0,0,0
556610,True,0,No user reviews,0,0,0
556640,True,6,Mostly Positive,119,33,152
556650,True,0,9 user reviews,9,0,9
556660,True,0,No user reviews,0,0,0
556670,True,0,1 user reviews,0,1,1
556680,True,0,5 user reviews,1,4,5
556690,True,0,No user reviews,0,0,0
556700,True,0,5 user reviews,2,3,5
556710,True,5,Mixed,10,5,15
556720,True,0,No user reviews,0,0,0
556740,True,6,Mostly Positive,106,39,145
556750,True,0,1 user reviews,1,0,1
556760,True,0,8 user reviews,7,1,8
556770,True,0,7 user reviews,2,5,7
556780,True,5,Mixed,17,9,26
556800,True,0,No user reviews,0,0,0
556810,True,0,1 user reviews,1,0,1
556820,True,5,Mixed,224,140,364
556830,True,0,4 user reviews,4,0,4
556840,True,0,9 user reviews,3,6,9
556850,True,0,1 user reviews,0,1,1
556860,True,6,Mostly Positive,81,31,112
556870,True,5,Mixed,37,22,59
556880,True,7,Positive,11,1,12
556890,True,7,Positive,28,6,34
556900,True,7,Positive,15,1,16
556920,True,5,Mixed,7,4,11
556930,True,0,No user reviews,0,0,0
556950,True,0,No user reviews,0,0,0
556960,True,7,Positive,11,0,11
556970,True,8,Very Positive,352,63,415
556990,True,0,5 user reviews,4,1,5
557000,True,0,5 user reviews,5,0,5
557001,True,0,1 user reviews,1,0,1
557003,True,0,No user reviews,0,0,0
557020,True,0,1 user reviews,1,0,1
557030,True,4,Mostly Negative,5,8,13
557040,True,5,Mixed,33,22,55
557070,True,0,No user reviews,0,0,0
557080,True,0,No user reviews,0,0,0
557081,True,0,No user reviews,0,0,0
557082,True,0,No user reviews,0,0,0
557083,True,0,No user reviews,0,0,0
557084,True,0,No user reviews,0,0,0
557085,True,0,No user reviews,0,0,0
557086,True,0,No user reviews,0,0,0
557087,True,0,No user reviews,0,0,0
557090,True,0,No user reviews,0,0,0
557120,True,0,No user reviews,0,0,0
557121,True,0,No user reviews,0,0,0
557122,True,0,No user reviews,0,0,0
557123,True,0,No user reviews,0,0,0
557124,True,0,No user reviews,0,0,0
557125,True,0,No user reviews,0,0,0
557140,True,0,No user reviews,0,0,0
557150,True,0,No user reviews,0,0,0
557180,True,0,No user reviews,0,0,0
557190,True,0,7 user reviews,4,3,7
557200,True,0,No user reviews,0,0,0
557210,True,0,No user reviews,0,0,0
557220,True,0,No user reviews,0,0,0
557230,True,0,No user reviews,0,0,0
557240,True,7,Positive,9,2,11
557250,True,0,No user reviews,0,0,0
557260,True,4,Mostly Negative,4,14,18
557280,True,6,Mostly Positive,10,3,13
557290,True,0,1 user reviews,1,0,1
557300,True,0,1 user reviews,0,1,1
557320,True,0,No user reviews,0,0,0
557330,True,7,Positive,19,4,23
557340,True,9,Overwhelmingly Positive,8474,380,8854
557350,True,0,5 user reviews,1,4,5
557380,True,0,6 user reviews,5,1,6
557390,True,0,3 user reviews,2,1,3
557400,True,8,Very Positive,141,24,165
557410,True,8,Very Positive,114,20,134
557420,True,0,3 user reviews,2,1,3
557450,True,0,No user reviews,0,0,0
557460,True,0,5 user reviews,4,1,5
557470,True,0,No user reviews,0,0,0
557520,True,5,Mixed,53,36,89
557540,True,0,No user reviews,0,0,0
557560,True,0,No user reviews,0,0,0
557570,True,7,Positive,17,0,17
557580,True,6,Mostly Positive,17,6,23
557600,True,9,Overwhelmingly Positive,2113,100,2213
557630,True,8,Very Positive,128,1,129
557640,True,0,No user reviews,0,0,0
557670,True,0,No user reviews,0,0,0
557680,True,5,Mixed,8,6,14
557690,True,0,No user reviews,0,0,0
557700,True,5,Mixed,9,5,14
557710,True,0,No user reviews,0,0,0
557720,True,0,5 user reviews,4,1,5
557730,True,7,Positive,10,1,11
557750,True,7,Positive,43,2,45
557760,True,0,1 user reviews,1,0,1
557770,True,0,5 user reviews,2,3,5
557780,True,0,7 user reviews,5,2,7
557790,True,0,3 user reviews,3,0,3
557800,True,0,1 user reviews,1,0,1
557810,True,5,Mixed,8,12,20
557830,True,0,9 user reviews,6,3,9
557840,True,0,No user reviews,0,0,0
557850,True,7,Positive,10,1,11
557860,True,7,Positive,11,1,12
557880,True,0,4 user reviews,1,3,4
557890,True,0,3 user reviews,3,0,3
557900,True,5,Mixed,20,9,29
557910,True,0,No user reviews,0,0,0
557940,True,0,3 user reviews,2,1,3
557960,True,0,5 user reviews,3,2,5
557970,True,0,5 user reviews,5,0,5
557980,True,0,2 user reviews,2,0,2
558000,True,0,3 user reviews,2,1,3
558010,True,0,No user reviews,0,0,0
558050,True,0,3 user reviews,1,2,3
558060,True,0,3 user reviews,1,2,3
558080,True,0,6 user reviews,6,0,6
558100,True,8,Very Positive,245,17,262
558110,True,6,Mostly Positive,96,29,125
558120,True,0,No user reviews,0,0,0
558130,True,0,6 user reviews,4,2,6
558140,True,0,No user reviews,0,0,0
558150,True,0,No user reviews,0,0,0
558160,True,0,1 user reviews,1,0,1
558190,True,0,3 user reviews,3,0,3
558200,True,0,2 user reviews,1,1,2
558210,True,0,1 user reviews,0,1,1
558220,True,0,No user reviews,0,0,0
558230,True,0,No user reviews,0,0,0
558241,True,7,Positive,40,4,44
558242,True,7,Positive,23,3,26
558243,True,7,Positive,15,0,15
558244,True,8,Very Positive,290,24,314
558245,True,8,Very Positive,417,65,482
558260,True,6,Mostly Positive,110,46,156
558280,True,0,No user reviews,0,0,0
558290,True,0,2 user reviews,2,0,2
558300,True,0,3 user reviews,2,1,3
558301,True,0,1 user reviews,1,0,1
558302,True,0,1 user reviews,1,0,1
558310,True,0,No user reviews,0,0,0
558320,True,7,Positive,13,3,16
558340,True,5,Mixed,9,6,15
558370,True,6,Mostly Positive,16,6,22
558390,True,0,6 user reviews,1,5,6
558391,True,0,4 user reviews,2,2,4
558410,True,6,Mostly Positive,15,4,19
558420,True,8,Very Positive,1797,271,2068
558430,True,0,No user reviews,0,0,0
558440,True,0,2 user reviews,2,0,2
558450,True,8,Very Positive,69,12,81
558460,True,0,No user reviews,0,0,0
558480,True,4,Mostly Negative,3,7,10
558490,True,5,Mixed,16,12,28
558500,True,0,No user reviews,0,0,0
558510,True,0,No user reviews,0,0,0
558511,True,0,No user reviews,0,0,0
558512,True,0,No user reviews,0,0,0
558513,True,0,No user reviews,0,0,0
558514,True,0,No user reviews,0,0,0
558540,True,0,No user reviews,0,0,0
558630,True,0,No user reviews,0,0,0
558640,True,0,3 user reviews,3,0,3
558641,True,0,2 user reviews,2,0,2
558650,True,0,1 user reviews,0,1,1
558660,True,6,Mostly Positive,22,7,29
558670,True,0,5 user reviews,5,0,5
558680,True,0,No user reviews,0,0,0
558690,True,0,No user reviews,0,0,0
558710,True,0,No user reviews,0,0,0
558720,True,0,2 user reviews,1,1,2
558740,True,0,5 user reviews,1,4,5
558750,True,0,5 user reviews,5,0,5
558760,True,0,6 user reviews,3,3,6
558761,True,0,3 user reviews,1,2,3
558762,True,0,9 user reviews,6,3,9
558770,True,0,No user reviews,0,0,0
558780,True,6,Mostly Positive,36,10,46
558790,True,7,Positive,38,0,38
558830,True,0,No user reviews,0,0,0
558831,True,0,No user reviews,0,0,0
558832,True,0,No user reviews,0,0,0
558833,True,0,No user reviews,0,0,0
558834,True,0,No user reviews,0,0,0
558835,True,0,No user reviews,0,0,0
558836,True,0,No user reviews,0,0,0
558840,True,0,No user reviews,0,0,0
558850,True,5,Mixed,15,7,22
558870,True,4,Mostly Negative,16,46,62
558880,True,0,No user reviews,0,0,0
558910,True,0,1 user reviews,1,0,1
558911,True,0,No user reviews,0,0,0
558912,True,0,No user reviews,0,0,0
558913,True,0,No user reviews,0,0,0
558914,True,0,No user reviews,0,0,0
558915,True,0,No user reviews,0,0,0
558916,True,0,No user reviews,0,0,0
558917,True,0,No user reviews,0,0,0
558918,True,0,No user reviews,0,0,0
558919,True,0,No user reviews,0,0,0
558920,True,0,No user reviews,0,0,0
558921,True,0,No user reviews,0,0,0
558922,True,0,No user reviews,0,0,0
558923,True,0,No user reviews,0,0,0
558924,True,0,No user reviews,0,0,0
558925,True,0,No user reviews,0,0,0
558926,True,0,No user reviews,0,0,0
558927,True,0,No user reviews,0,0,0
558928,True,0,No user reviews,0,0,0
558929,True,0,No user reviews,0,0,0
558970,True,0,No user reviews,0,0,0
558980,True,0,No user reviews,0,0,0
558990,True,9,Overwhelmingly Positive,1560,44,1604
559010,True,7,Positive,13,0,13
559030,True,0,3 user reviews,2,1,3
559040,True,0,8 user reviews,5,3,8
559070,True,7,Positive,18,3,21
559100,True,6,Mostly Positive,974,310,1284
559130,True,5,Mixed,11,11,22
559140,True,0,4 user reviews,2,2,4
559150,True,0,2 user reviews,2,0,2
559170,True,0,No user reviews,0,0,0
559200,True,0,2 user reviews,0,2,2
559210,True,9,Overwhelmingly Positive,1855,34,1889
559250,True,0,3 user reviews,3,0,3
559260,True,6,Mostly Positive,64,22,86
559280,True,0,3 user reviews,2,1,3
559300,True,0,No user reviews,0,0,0
559310,True,5,Mixed,60,33,93
559330,True,8,Very Positive,306,13,319
559340,True,5,Mixed,55,64,119
559350,True,0,8 user reviews,6,2,8
559360,True,0,No user reviews,0,0,0
559390,True,0,No user reviews,0,0,0
559391,True,0,No user reviews,0,0,0
559430,True,7,Positive,16,2,18
559440,True,0,No user reviews,0,0,0
559450,True,0,2 user reviews,0,2,2
559470,True,0,1 user reviews,1,0,1
559480,True,0,No user reviews,0,0,0
559510,True,0,No user reviews,0,0,0
559520,True,0,No user reviews,0,0,0
559530,True,0,No user reviews,0,0,0
559540,True,0,No user reviews,0,0,0
559550,True,0,No user reviews,0,0,0
559560,True,0,No user reviews,0,0,0
559570,True,0,No user reviews,0,0,0
559580,True,0,No user reviews,0,0,0
559590,True,0,1 user reviews,1,0,1
559610,True,8,Very Positive,530,40,570
559620,True,8,Very Positive,134,7,141
559630,True,0,3 user reviews,2,1,3
559640,True,7,Positive,36,7,43
559650,True,8,Very Positive,1078,90,1168
559670,True,0,4 user reviews,4,0,4
559680,True,8,Very Positive,198,35,233
559690,True,0,No user reviews,0,0,0
559700,True,0,No user reviews,0,0,0
559780,True,0,No user reviews,0,0,0
559790,True,0,No user reviews,0,0,0
559800,True,0,No user reviews,0,0,0
559840,True,7,Positive,14,1,15
559850,True,7,Positive,13,1,14
559860,True,0,No user reviews,0,0,0
559870,True,6,Mostly Positive,47,16,63
559880,True,0,No user reviews,0,0,0
559890,True,0,1 user reviews,1,0,1
559900,True,4,Mostly Negative,5,12,17
559910,True,6,Mostly Positive,123,50,173
559920,True,0,2 user reviews,0,2,2
559930,True,0,9 user reviews,9,0,9
559950,True,0,3 user reviews,3,0,3
559960,True,8,Very Positive,49,9,58
559970,True,0,2 user reviews,2,0,2
559990,True,0,1 user reviews,1,0,1
560000,True,8,Very Positive,111,7,118
560010,True,0,7 user reviews,4,3,7
560040,True,0,1 user reviews,1,0,1
560050,True,7,Positive,40,3,43
560080,True,0,9 user reviews,6,3,9
560090,True,0,No user reviews,0,0,0
560100,True,0,1 user reviews,1,0,1
560101,True,0,No user reviews,0,0,0
560102,True,0,No user reviews,0,0,0
560110,True,0,No user reviews,0,0,0
560130,True,8,Very Positive,3545,568,4113
560140,True,0,No user reviews,0,0,0
560150,True,6,Mostly Positive,11,4,15
560170,True,6,Mostly Positive,190,79,269
560180,True,0,5 user reviews,5,0,5
560200,True,0,6 user reviews,4,2,6
560220,True,7,Positive,9,1,10
560230,True,0,4 user reviews,1,3,4
560240,True,0,No user reviews,0,0,0
560250,True,5,Mixed,40,19,59
560260,True,8,Very Positive,274,48,322
560300,True,7,Positive,33,2,35
560340,True,0,3 user reviews,1,2,3
560350,True,5,Mixed,18,12,30
560360,True,0,No user reviews,0,0,0
560370,True,5,Mixed,89,43,132
560390,True,0,No user reviews,0,0,0
560400,True,0,1 user reviews,1,0,1
560410,True,5,Mixed,8,4,12
560430,True,8,Very Positive,184,18,202
560450,True,0,No user reviews,0,0,0
560490,True,0,No user reviews,0,0,0
560500,True,0,No user reviews,0,0,0
560510,True,0,9 user reviews,7,2,9
560520,True,0,No user reviews,0,0,0
560550,True,7,Positive,16,1,17
560570,True,0,2 user reviews,0,2,2
560580,True,0,No user reviews,0,0,0
560581,True,0,1 user reviews,1,0,1
560582,True,0,No user reviews,0,0,0
560590,True,0,No user reviews,0,0,0
560600,True,0,6 user reviews,6,0,6
560610,True,0,No user reviews,0,0,0
560630,True,0,No user reviews,0,0,0
560640,True,5,Mixed,35,21,56
560660,True,0,No user reviews,0,0,0
560670,True,0,No user reviews,0,0,0
560680,True,0,No user reviews,0,0,0
560690,True,0,No user reviews,0,0,0
560691,True,0,No user reviews,0,0,0
560700,True,0,No user reviews,0,0,0
560710,True,0,6 user reviews,5,1,6
560720,True,7,Positive,32,7,39
560730,True,5,Mixed,8,11,19
560740,True,6,Mostly Positive,13,5,18
560750,True,5,Mixed,11,8,19
560760,True,5,Mixed,10,10,20
560770,True,0,2 user reviews,2,0,2
560780,True,0,No user reviews,0,0,0
560790,True,0,No user reviews,0,0,0
560800,True,0,No user reviews,0,0,0
560820,True,0,9 user reviews,5,4,9
560870,True,0,4 user reviews,2,2,4
560900,True,0,No user reviews,0,0,0
560920,True,0,No user reviews,0,0,0
560930,True,0,1 user reviews,0,1,1
560940,True,7,Positive,12,3,15
560941,True,5,Mixed,8,4,12
560960,True,0,2 user reviews,1,1,2
560970,True,0,2 user reviews,2,0,2
560980,True,0,No user reviews,0,0,0
560990,True,0,3 user reviews,3,0,3
561000,True,7,Positive,25,3,28
561010,True,0,9 user reviews,6,3,9
561030,True,0,2 user reviews,2,0,2
561040,True,7,Positive,12,0,12
561050,True,0,1 user reviews,0,1,1
561060,True,0,1 user reviews,0,1,1
561080,True,7,Positive,39,2,41
561100,True,0,7 user reviews,4,3,7
561110,True,0,1 user reviews,1,0,1
561120,True,5,Mixed,20,14,34
561130,True,0,No user reviews,0,0,0
561140,True,0,7 user reviews,3,4,7
561150,True,7,Positive,10,0,10
561190,True,7,Positive,27,2,29
561200,True,0,No user reviews,0,0,0
561201,True,0,No user reviews,0,0,0
561202,True,0,No user reviews,0,0,0
561203,True,0,No user reviews,0,0,0
561204,True,0,No user reviews,0,0,0
561205,True,0,No user reviews,0,0,0
561206,True,0,No user reviews,0,0,0
561230,True,5,Mixed,11,7,18
561240,True,0,No user reviews,0,0,0
561260,True,7,Positive,14,1,15
561290,True,0,No user reviews,0,0,0
561310,True,0,No user reviews,0,0,0
561330,True,0,No user reviews,0,0,0
561340,True,0,3 user reviews,2,1,3
561350,True,0,No user reviews,0,0,0
561360,True,7,Positive,14,3,17
561390,True,0,1 user reviews,1,0,1
561400,True,7,Positive,9,2,11
561420,True,5,Mixed,5,5,10
561440,True,0,4 user reviews,4,0,4
561450,True,0,5 user reviews,3,2,5
561460,True,0,No user reviews,0,0,0
561470,True,8,Very Positive,59,3,62
561480,True,7,Positive,24,3,27
561490,True,0,7 user reviews,1,6,7
561510,True,0,3 user reviews,3,0,3
561527,True,0,4 user reviews,4,0,4
561530,True,0,No user reviews,0,0,0
561531,True,0,No user reviews,0,0,0
561532,True,0,No user reviews,0,0,0
561533,True,0,No user reviews,0,0,0
561534,True,0,No user reviews,0,0,0
561535,True,0,No user reviews,0,0,0
561536,True,0,No user reviews,0,0,0
561537,True,0,No user reviews,0,0,0
561538,True,0,No user reviews,0,0,0
561539,True,0,No user reviews,0,0,0
561540,True,0,No user reviews,0,0,0
561541,True,0,No user reviews,0,0,0
561542,True,0,No user reviews,0,0,0
561543,True,0,No user reviews,0,0,0
561544,True,0,No user reviews,0,0,0
561545,True,0,No user reviews,0,0,0
561546,True,0,No user reviews,0,0,0
561547,True,0,No user reviews,0,0,0
561548,True,0,No user reviews,0,0,0
561549,True,0,1 user reviews,1,0,1
561550,True,0,No user reviews,0,0,0
561551,True,0,No user reviews,0,0,0
561552,True,0,No user reviews,0,0,0
561553,True,0,No user reviews,0,0,0
561554,True,0,No user reviews,0,0,0
561555,True,0,No user reviews,0,0,0
561556,True,0,No user reviews,0,0,0
561557,True,0,No user reviews,0,0,0
561558,True,0,No user reviews,0,0,0
561559,True,0,No user reviews,0,0,0
561560,True,0,No user reviews,0,0,0
561561,True,0,No user reviews,0,0,0
561566,True,0,No user reviews,0,0,0
561567,True,0,No user reviews,0,0,0
561580,True,0,No user reviews,0,0,0
561590,True,5,Mixed,15,12,27
561600,True,8,Very Positive,163,37,200
561610,True,5,Mixed,84,37,121
561630,True,4,Mostly Negative,31,71,102
561631,True,4,Mostly Negative,15,33,48
561650,True,4,Mostly Negative,65,128,193
561660,True,0,No user reviews,0,0,0
561680,True,7,Positive,15,0,15
561690,True,0,1 user reviews,0,1,1
561710,True,0,No user reviews,0,0,0
561720,True,0,No user reviews,0,0,0
561730,True,6,Mostly Positive,38,10,48
561740,True,8,Very Positive,128,23,151
561770,True,6,Mostly Positive,76,31,107
561800,True,0,No user reviews,0,0,0
561811,True,0,No user reviews,0,0,0
561816,True,0,No user reviews,0,0,0
561820,True,0,No user reviews,0,0,0
561830,True,0,No user reviews,0,0,0
561860,True,0,No user reviews,0,0,0
561900,True,0,No user reviews,0,0,0
561920,True,0,No user reviews,0,0,0
561930,True,0,5 user reviews,5,0,5
561950,True,0,No user reviews,0,0,0
561970,True,0,3 user reviews,1,2,3
561990,True,0,No user reviews,0,0,0
562000,True,0,No user reviews,0,0,0
562010,True,0,2 user reviews,1,1,2
562040,True,0,No user reviews,0,0,0
562050,True,4,Mostly Negative,4,7,11
562060,True,0,No user reviews,0,0,0
562080,True,0,No user reviews,0,0,0
562090,True,0,No user reviews,0,0,0
562160,True,6,Mostly Positive,19,7,26
562170,True,0,No user reviews,0,0,0
562210,True,5,Mixed,9,6,15
562220,True,8,Very Positive,896,71,967
562230,True,8,Very Positive,343,49,392
562240,True,0,9 user reviews,2,7,9
562250,True,8,Very Positive,43,10,53
562260,True,7,Positive,14,1,15
562270,True,0,4 user reviews,2,2,4
562280,True,7,Positive,20,4,24
562290,True,0,9 user reviews,5,4,9
562310,True,0,3 user reviews,3,0,3
562320,True,6,Mostly Positive,25,8,33
562330,True,7,Positive,11,2,13
562340,True,4,Mostly Negative,14,26,40
562350,True,0,No user reviews,0,0,0
562360,True,8,Very Positive,258,33,291
562370,True,0,2 user reviews,0,2,2
562372,True,0,7 user reviews,2,5,7
562373,True,7,Positive,35,3,38
562374,True,0,3 user reviews,2,1,3
562375,True,5,Mixed,10,12,22
562376,True,5,Mixed,7,5,12
562378,True,5,Mixed,6,5,11
562379,True,7,Positive,11,2,13
562380,True,7,Positive,9,1,10
562381,True,7,Positive,22,4,26
562382,True,0,9 user reviews,8,1,9
562384,True,0,8 user reviews,3,5,8
562385,True,0,1 user reviews,1,0,1
562386,True,7,Positive,13,1,14
562387,True,0,1 user reviews,1,0,1
562388,True,0,2 user reviews,2,0,2
562389,True,0,8 user reviews,7,1,8
562390,True,0,2 user reviews,2,0,2
562391,True,0,2 user reviews,0,2,2
562392,True,0,No user reviews,0,0,0
562393,True,0,No user reviews,0,0,0
562394,True,0,No user reviews,0,0,0
562395,True,0,No user reviews,0,0,0
562397,True,0,1 user reviews,1,0,1
562398,True,0,8 user reviews,8,0,8
562399,True,6,Mostly Positive,30,8,38
562410,True,8,Very Positive,189,12,201
562420,True,5,Mixed,34,24,58
562430,True,0,4 user reviews,3,1,4
562450,True,0,6 user reviews,2,4,6
562460,True,0,5 user reviews,5,0,5
562470,True,6,Mostly Positive,23,8,31
562480,True,7,Positive,24,1,25
562490,True,5,Mixed,6,4,10
562500,True,8,Very Positive,472,72,544
562510,True,0,9 user reviews,6,3,9
562520,True,0,2 user reviews,1,1,2
562540,True,5,Mixed,7,5,12
562560,True,0,No user reviews,0,0,0
562570,True,6,Mostly Positive,65,26,91
562590,True,5,Mixed,211,100,311
562600,True,0,2 user reviews,1,1,2
562630,True,0,1 user reviews,1,0,1
562640,True,5,Mixed,10,5,15
562660,True,0,3 user reviews,1,2,3
562680,True,0,4 user reviews,3,1,4
562690,True,0,7 user reviews,5,2,7
562700,True,4,Mostly Negative,11,19,30
562720,True,0,No user reviews,0,0,0
562730,True,6,Mostly Positive,11,3,14
562740,True,0,5 user reviews,4,1,5
562750,True,0,No user reviews,0,0,0
562780,True,0,No user reviews,0,0,0
562790,True,0,No user reviews,0,0,0
562800,True,5,Mixed,8,9,17
562810,True,5,Mixed,1220,1558,2778
562820,True,0,No user reviews,0,0,0
562840,True,5,Mixed,14,12,26
562860,True,9,Overwhelmingly Positive,2323,105,2428
562870,True,0,1 user reviews,1,0,1
562890,True,0,1 user reviews,1,0,1
562891,True,0,1 user reviews,1,0,1
563100,True,0,No user reviews,0,0,0
563101,True,0,No user reviews,0,0,0
563102,True,0,1 user reviews,1,0,1
563103,True,0,3 user reviews,3,0,3
563104,True,0,No user reviews,0,0,0
563105,True,0,1 user reviews,1,0,1
563106,True,0,4 user reviews,4,0,4
563107,True,0,3 user reviews,3,0,3
563110,True,0,No user reviews,0,0,0
563120,True,5,Mixed,17,13,30
563130,True,0,8 user reviews,7,1,8
563150,True,5,Mixed,8,5,13
563160,True,0,2 user reviews,0,2,2
563170,True,0,4 user reviews,4,0,4
563180,True,7,Positive,26,1,27
563190,True,7,Positive,36,4,40
563200,True,8,Very Positive,63,15,78
563210,True,4,Mostly Negative,4,7,11
563250,True,0,5 user reviews,4,1,5
563260,True,7,Positive,21,1,22
563270,True,6,Mostly Positive,9,3,12
563290,True,0,No user reviews,0,0,0
563300,True,0,2 user reviews,2,0,2
563320,True,4,Mostly Negative,12,21,33
563330,True,5,Mixed,10,9,19
563340,True,5,Mixed,14,20,34
563360,True,5,Mixed,52,30,82
563370,True,0,2 user reviews,2,0,2
563380,True,0,3 user reviews,3,0,3
563390,True,7,Positive,9,2,11
563400,True,0,1 user reviews,0,1,1
563410,True,0,8 user reviews,8,0,8
563420,True,5,Mixed,5,7,12
563430,True,0,3 user reviews,3,0,3
563440,True,0,No user reviews,0,0,0
563470,True,0,No user reviews,0,0,0
563490,True,3,Negative,2,12,14
563500,True,0,6 user reviews,3,3,6
563520,True,0,5 user reviews,5,0,5
563530,True,0,No user reviews,0,0,0
563550,True,7,Positive,39,9,48
563560,True,0,No user reviews,0,0,0
563590,True,0,No user reviews,0,0,0
563600,True,0,No user reviews,0,0,0
563610,True,0,2 user reviews,1,1,2
563630,True,0,No user reviews,0,0,0
563640,True,0,No user reviews,0,0,0
563650,True,0,No user reviews,0,0,0
563670,True,0,No user reviews,0,0,0
563680,True,0,9 user reviews,3,6,9
563690,True,0,No user reviews,0,0,0
563710,True,7,Positive,9,2,11
563720,True,0,No user reviews,0,0,0
563730,True,0,No user reviews,0,0,0
563740,True,0,3 user reviews,3,0,3
563750,True,5,Mixed,65,40,105
563760,True,5,Mixed,13,15,28
563770,True,0,No user reviews,0,0,0
563780,True,0,3 user reviews,3,0,3
563790,True,0,1 user reviews,1,0,1
563810,True,7,Positive,33,2,35
563830,True,7,Positive,16,2,18
563840,True,8,Very Positive,889,116,1005
563850,True,0,No user reviews,0,0,0
563860,True,7,Positive,10,2,12
563880,True,0,1 user reviews,1,0,1
563890,True,0,8 user reviews,7,1,8
563900,True,0,No user reviews,0,0,0
563910,True,0,2 user reviews,1,1,2
563920,True,0,No user reviews,0,0,0
563950,True,0,No user reviews,0,0,0
563980,True,0,No user reviews,0,0,0
563990,True,0,No user reviews,0,0,0
564010,True,4,Mostly Negative,6,12,18
564030,True,0,5 user reviews,4,1,5
564040,True,7,Positive,11,2,13
564050,True,8,Very Positive,150,25,175
564060,True,0,1 user reviews,0,1,1
564070,True,5,Mixed,5,5,10
564080,True,0,6 user reviews,6,0,6
564090,True,0,1 user reviews,1,0,1
564100,True,0,1 user reviews,1,0,1
564140,True,0,1 user reviews,0,1,1
564150,True,5,Mixed,100,44,144
564160,True,7,Positive,32,5,37
564170,True,0,5 user reviews,5,0,5
564180,True,7,Positive,15,0,15
564190,True,8,Very Positive,48,4,52
564200,True,0,No user reviews,0,0,0
564210,True,6,Mostly Positive,8,3,11
564230,True,8,Very Positive,1429,154,1583
564240,True,0,No user reviews,0,0,0
564250,True,0,3 user reviews,2,1,3
564251,True,0,6 user reviews,1,5,6
564260,True,0,1 user reviews,1,0,1
564270,True,0,No user reviews,0,0,0
564280,True,0,4 user reviews,3,1,4
564290,True,0,2 user reviews,1,1,2
564300,True,0,8 user reviews,7,1,8
564310,True,8,Very Positive,876,69,945
564320,True,0,No user reviews,0,0,0
564321,True,0,No user reviews,0,0,0
564322,True,0,No user reviews,0,0,0
564323,True,0,No user reviews,0,0,0
564324,True,0,No user reviews,0,0,0
564330,True,0,5 user reviews,5,0,5
564340,True,0,2 user reviews,0,2,2
564360,True,4,Mostly Negative,21,43,64
564380,True,0,No user reviews,0,0,0
564390,True,0,No user reviews,0,0,0
564400,True,0,1 user reviews,1,0,1
564420,True,0,5 user reviews,5,0,5
564440,True,0,2 user reviews,2,0,2
564450,True,0,2 user reviews,2,0,2
564470,True,6,Mostly Positive,26,7,33
564480,True,0,4 user reviews,4,0,4
564490,True,3,Negative,5,24,29
564520,True,0,9 user reviews,6,3,9
564530,True,8,Very Positive,593,75,668
564540,True,0,No user reviews,0,0,0
564550,True,0,No user reviews,0,0,0
564560,True,0,No user reviews,0,0,0
564561,True,0,No user reviews,0,0,0
564562,True,0,No user reviews,0,0,0
564563,True,0,No user reviews,0,0,0
564564,True,0,No user reviews,0,0,0
564565,True,0,No user reviews,0,0,0
564566,True,0,No user reviews,0,0,0
564567,True,0,No user reviews,0,0,0
564568,True,0,No user reviews,0,0,0
564569,True,0,No user reviews,0,0,0
564570,True,0,No user reviews,0,0,0
564571,True,0,No user reviews,0,0,0
564572,True,0,No user reviews,0,0,0
564573,True,0,No user reviews,0,0,0
564574,True,0,No user reviews,0,0,0
564575,True,0,No user reviews,0,0,0
564576,True,0,No user reviews,0,0,0
564577,True,0,No user reviews,0,0,0
564578,True,0,No user reviews,0,0,0
564579,True,0,No user reviews,0,0,0
564590,True,0,No user reviews,0,0,0
564591,True,0,No user reviews,0,0,0
564592,True,0,No user reviews,0,0,0
564593,True,0,No user reviews,0,0,0
564594,True,0,No user reviews,0,0,0
564595,True,0,No user reviews,0,0,0
564596,True,0,No user reviews,0,0,0
564597,True,0,No user reviews,0,0,0
564598,True,0,No user reviews,0,0,0
564599,True,0,No user reviews,0,0,0
564600,True,0,No user reviews,0,0,0
564601,True,0,No user reviews,0,0,0
564602,True,0,No user reviews,0,0,0
564603,True,0,No user reviews,0,0,0
564604,True,0,No user reviews,0,0,0
564605,True,0,No user reviews,0,0,0
564606,True,0,No user reviews,0,0,0
564607,True,0,No user reviews,0,0,0
564608,True,0,No user reviews,0,0,0
564609,True,0,No user reviews,0,0,0
564610,True,0,No user reviews,0,0,0
564620,True,0,No user reviews,0,0,0
564621,True,0,No user reviews,0,0,0
564622,True,0,No user reviews,0,0,0
564623,True,0,No user reviews,0,0,0
564624,True,0,No user reviews,0,0,0
564625,True,0,No user reviews,0,0,0
564626,True,0,No user reviews,0,0,0
564627,True,0,No user reviews,0,0,0
564628,True,0,No user reviews,0,0,0
564629,True,0,No user reviews,0,0,0
564630,True,0,No user reviews,0,0,0
564631,True,0,No user reviews,0,0,0
564632,True,0,No user reviews,0,0,0
564633,True,0,No user reviews,0,0,0
564634,True,0,No user reviews,0,0,0
564635,True,0,No user reviews,0,0,0
564636,True,0,No user reviews,0,0,0
564637,True,0,No user reviews,0,0,0
564638,True,0,No user reviews,0,0,0
564639,True,0,No user reviews,0,0,0
564640,True,0,No user reviews,0,0,0
564641,True,0,No user reviews,0,0,0
564650,True,0,No user reviews,0,0,0
564651,True,0,No user reviews,0,0,0
564652,True,0,No user reviews,0,0,0
564653,True,0,No user reviews,0,0,0
564654,True,0,No user reviews,0,0,0
564655,True,0,No user reviews,0,0,0
564656,True,0,No user reviews,0,0,0
564657,True,0,No user reviews,0,0,0
564658,True,0,No user reviews,0,0,0
564659,True,0,No user reviews,0,0,0
564660,True,0,No user reviews,0,0,0
564661,True,0,No user reviews,0,0,0
564662,True,0,No user reviews,0,0,0
564663,True,0,No user reviews,0,0,0
564664,True,0,No user reviews,0,0,0
564665,True,0,No user reviews,0,0,0
564670,True,0,1 user reviews,1,0,1
564680,True,0,7 user reviews,5,2,7
564681,True,0,2 user reviews,2,0,2
564690,True,0,No user reviews,0,0,0
564700,True,7,Positive,13,1,14
564710,True,8,Very Positive,479,33,512
564720,True,0,2 user reviews,0,2,2
564730,True,0,5 user reviews,3,2,5
564740,True,0,No user reviews,0,0,0
564750,True,0,8 user reviews,8,0,8
564770,True,0,No user reviews,0,0,0
564780,True,5,Mixed,16,12,28
564790,True,6,Mostly Positive,66,26,92
564791,True,6,Mostly Positive,41,12,53
564792,True,4,Mostly Negative,43,78,121
564793,True,4,Mostly Negative,7,15,22
564794,True,5,Mixed,19,20,39
564800,True,0,No user reviews,0,0,0
564810,True,7,Positive,22,0,22
564850,True,0,2 user reviews,2,0,2
564890,True,0,No user reviews,0,0,0
564900,True,4,Mostly Negative,5,17,22
564910,True,0,3 user reviews,2,1,3
564920,True,0,2 user reviews,1,1,2
564940,True,7,Positive,27,6,33
564950,True,5,Mixed,10,10,20
564960,True,5,Mixed,19,15,34
564980,True,0,1 user reviews,1,0,1
564990,True,0,2 user reviews,1,1,2
565000,True,0,3 user reviews,2,1,3
565001,True,0,6 user reviews,2,4,6
565002,True,0,2 user reviews,1,1,2
565020,True,0,No user reviews,0,0,0
565030,True,7,Positive,16,2,18
565040,True,6,Mostly Positive,17,6,23
565050,True,0,4 user reviews,3,1,4
565060,True,0,No user reviews,0,0,0
565070,True,0,No user reviews,0,0,0
565080,True,0,No user reviews,0,0,0
565090,True,0,No user reviews,0,0,0
565100,True,0,2 user reviews,2,0,2
565110,True,0,3 user reviews,3,0,3
565120,True,8,Very Positive,309,66,375
565140,True,0,4 user reviews,4,0,4
565170,True,6,Mostly Positive,71,19,90
565180,True,7,Positive,23,1,24
565190,True,7,Positive,15,0,15
565200,True,0,2 user reviews,2,0,2
565210,True,7,Positive,10,0,10
565220,True,0,4 user reviews,4,0,4
565230,True,0,6 user reviews,6,0,6
565240,True,0,2 user reviews,2,0,2
565250,True,0,2 user reviews,2,0,2
565261,True,0,6 user reviews,6,0,6
565290,True,0,No user reviews,0,0,0
565300,True,0,No user reviews,0,0,0
565301,True,0,No user reviews,0,0,0
565302,True,0,No user reviews,0,0,0
565303,True,0,No user reviews,0,0,0
565310,True,0,1 user reviews,1,0,1
565320,True,0,1 user reviews,1,0,1
565321,True,0,1 user reviews,1,0,1
565322,True,0,1 user reviews,1,0,1
565323,True,0,2 user reviews,2,0,2
565324,True,0,1 user reviews,0,1,1
565330,True,0,2 user reviews,0,2,2
565360,True,0,No user reviews,0,0,0
565370,True,0,No user reviews,0,0,0
565380,True,0,7 user reviews,3,4,7
565390,True,7,Positive,21,4,25
565410,True,5,Mixed,70,56,126
565420,True,0,1 user reviews,1,0,1
565440,True,0,No user reviews,0,0,0
565450,True,0,No user reviews,0,0,0
565460,True,0,No user reviews,0,0,0
565470,True,0,No user reviews,0,0,0
565480,True,0,No user reviews,0,0,0
565490,True,0,1 user reviews,0,1,1
565500,True,0,No user reviews,0,0,0
565510,True,0,1 user reviews,1,0,1
565520,True,0,8 user reviews,7,1,8
565530,True,0,No user reviews,0,0,0
565540,True,0,1 user reviews,1,0,1
565550,True,5,Mixed,36,18,54
565560,True,0,1 user reviews,1,0,1
565570,True,0,1 user reviews,1,0,1
565580,True,0,1 user reviews,1,0,1
565590,True,0,1 user reviews,1,0,1
565600,True,7,Positive,19,2,21
565610,True,8,Very Positive,63,2,65
565620,True,5,Mixed,14,17,31
565621,True,5,Mixed,12,9,21
565622,True,6,Mostly Positive,11,3,14
565630,True,0,8 user reviews,8,0,8
565640,True,0,2 user reviews,1,1,2
565650,True,0,3 user reviews,3,0,3
565660,True,6,Mostly Positive,8,3,11
565670,True,0,8 user reviews,5,3,8
565690,True,0,7 user reviews,7,0,7
565720,True,8,Very Positive,61,8,69
565730,True,0,No user reviews,0,0,0
565760,True,0,No user reviews,0,0,0
565770,True,0,2 user reviews,2,0,2
565800,True,0,No user reviews,0,0,0
565810,True,0,1 user reviews,1,0,1
565820,True,0,1 user reviews,1,0,1
565830,True,0,1 user reviews,1,0,1
565840,True,8,Very Positive,87,10,97
565860,True,6,Mostly Positive,110,33,143
565910,True,0,5 user reviews,4,1,5
565930,True,0,No user reviews,0,0,0
565931,True,0,No user reviews,0,0,0
565932,True,0,No user reviews,0,0,0
565933,True,0,No user reviews,0,0,0
565934,True,0,No user reviews,0,0,0
565935,True,0,No user reviews,0,0,0
565936,True,0,No user reviews,0,0,0
565937,True,0,No user reviews,0,0,0
565938,True,0,No user reviews,0,0,0
565939,True,0,No user reviews,0,0,0
565940,True,0,No user reviews,0,0,0
565950,True,0,No user reviews,0,0,0
565951,True,0,No user reviews,0,0,0
565952,True,0,No user reviews,0,0,0
565953,True,0,No user reviews,0,0,0
565954,True,0,No user reviews,0,0,0
565955,True,0,No user reviews,0,0,0
565956,True,0,No user reviews,0,0,0
565957,True,0,No user reviews,0,0,0
565958,True,0,No user reviews,0,0,0
565959,True,0,No user reviews,0,0,0
565960,True,0,No user reviews,0,0,0
565961,True,0,No user reviews,0,0,0
565980,True,6,Mostly Positive,20,7,27
565990,True,0,No user reviews,0,0,0
566010,True,0,1 user reviews,1,0,1
566020,True,0,No user reviews,0,0,0
566040,True,0,No user reviews,0,0,0
566050,True,8,Very Positive,375,22,397
566090,True,5,Mixed,303,148,451
566130,True,0,No user reviews,0,0,0
566140,True,0,1 user reviews,1,0,1
566150,True,0,No user reviews,0,0,0
566160,True,8,Very Positive,382,32,414
566170,True,0,1 user reviews,0,1,1
566180,True,0,4 user reviews,1,3,4
566190,True,5,Mixed,48,26,74
566200,True,0,4 user reviews,3,1,4
566250,True,0,2 user reviews,1,1,2
566260,True,0,2 user reviews,2,0,2
566270,True,5,Mixed,6,4,10
566280,True,0,1 user reviews,1,0,1
566320,True,0,4 user reviews,3,1,4
566330,True,0,No user reviews,0,0,0
566340,True,0,No user reviews,0,0,0
566350,True,0,3 user reviews,3,0,3
566380,True,0,1 user reviews,1,0,1
566390,True,0,No user reviews,0,0,0
566410,True,0,No user reviews,0,0,0
566420,True,0,6 user reviews,3,3,6
566430,True,5,Mixed,6,8,14
566440,True,5,Mixed,750,486,1236
566450,True,0,No user reviews,0,0,0
566460,True,0,No user reviews,0,0,0
566470,True,0,No user reviews,0,0,0
566480,True,0,No user reviews,0,0,0
566490,True,7,Positive,14,0,14
566510,True,0,No user reviews,0,0,0
566530,True,6,Mostly Positive,151,44,195
566540,True,8,Very Positive,157,36,193
566550,True,5,Mixed,20,28,48
566560,True,0,2 user reviews,1,1,2
566570,True,5,Mixed,14,12,26
566580,True,0,5 user reviews,3,2,5
566590,True,0,No user reviews,0,0,0
566640,True,0,No user reviews,0,0,0
566670,True,7,Positive,17,1,18
566680,True,0,No user reviews,0,0,0
566690,True,0,1 user reviews,1,0,1
566700,True,7,Positive,42,1,43
566710,True,0,1 user reviews,1,0,1
566720,True,0,No user reviews,0,0,0
566730,True,0,No user reviews,0,0,0
566750,True,0,7 user reviews,5,2,7
566760,True,0,No user reviews,0,0,0
566770,True,0,No user reviews,0,0,0
566780,True,6,Mostly Positive,24,8,32
566790,True,0,No user reviews,0,0,0
566800,True,0,No user reviews,0,0,0
566810,True,0,No user reviews,0,0,0
566840,True,0,No user reviews,0,0,0
566860,True,8,Very Positive,692,114,806
566870,True,6,Mostly Positive,12,5,17
566880,True,7,Positive,14,2,16
566890,True,7,Positive,15,1,16
566900,True,7,Positive,10,0,10
566910,True,0,1 user reviews,0,1,1
566930,True,0,5 user reviews,4,1,5
566940,True,0,7 user reviews,6,1,7
566970,True,6,Mostly Positive,12,5,17
566980,True,0,8 user reviews,8,0,8
567010,True,0,8 user reviews,7,1,8
567020,True,0,5 user reviews,2,3,5
567030,True,8,Very Positive,148,2,150
567040,True,4,Mostly Negative,6,13,19
567050,True,0,No user reviews,0,0,0
567060,True,8,Very Positive,76,19,95
567070,True,0,No user reviews,0,0,0
567080,True,8,Very Positive,52,7,59
567090,True,0,No user reviews,0,0,0
567110,True,0,No user reviews,0,0,0
567130,True,8,Very Positive,70,13,83
567140,True,7,Positive,13,3,16
567150,True,6,Mostly Positive,14,4,18
567160,True,7,Positive,34,3,37
567180,True,0,No user reviews,0,0,0
567200,True,5,Mixed,12,6,18
567210,True,0,8 user reviews,8,0,8
567220,True,5,Mixed,5,6,11
567230,True,0,No user reviews,0,0,0
567240,True,7,Positive,11,2,13
567260,True,5,Mixed,6,6,12
567280,True,8,Very Positive,158,29,187
567290,True,8,Very Positive,221,24,245
567320,True,4,Mostly Negative,17,26,43
567330,True,0,No user reviews,0,0,0
567340,True,7,Positive,31,1,32
567360,True,0,2 user reviews,1,1,2
567370,True,8,Very Positive,60,1,61
567380,True,9,Overwhelmingly Positive,516,22,538
567390,True,0,No user reviews,0,0,0
567391,True,0,No user reviews,0,0,0
567400,True,0,No user reviews,0,0,0
567410,True,0,No user reviews,0,0,0
567420,True,0,No user reviews,0,0,0
567421,True,0,No user reviews,0,0,0
567422,True,0,No user reviews,0,0,0
567430,True,0,No user reviews,0,0,0
567480,True,0,3 user reviews,2,1,3
567560,True,0,No user reviews,0,0,0
567580,True,6,Mostly Positive,68,25,93
567590,True,0,No user reviews,0,0,0
567600,True,0,9 user reviews,4,5,9
567610,True,0,4 user reviews,2,2,4
567620,True,0,No user reviews,0,0,0
567630,True,0,1 user reviews,0,1,1
567640,True,8,Very Positive,3558,398,3956
567660,True,0,4 user reviews,4,0,4
567670,True,8,Very Positive,193,22,215
567680,True,4,Mostly Negative,9,18,27
567690,True,0,No user reviews,0,0,0
567700,True,0,No user reviews,0,0,0
567730,True,7,Positive,30,4,34
567750,True,6,Mostly Positive,108,39,147
567780,True,5,Mixed,11,6,17
567800,True,8,Very Positive,61,12,73
567810,True,7,Positive,40,4,44
567820,True,0,No user reviews,0,0,0
567840,True,0,5 user reviews,3,2,5
567850,True,0,No user reviews,0,0,0
567860,True,0,2 user reviews,2,0,2
567890,True,5,Mixed,7,4,11
567900,True,0,No user reviews,0,0,0
567960,True,0,No user reviews,0,0,0
567970,True,0,No user reviews,0,0,0
567980,True,0,5 user reviews,5,0,5
567990,True,8,Very Positive,157,5,162
568010,True,7,Positive,12,1,13
568011,True,7,Positive,9,1,10
568012,True,0,3 user reviews,3,0,3
568013,True,0,2 user reviews,2,0,2
568020,True,7,Positive,45,2,47
568030,True,7,Positive,9,2,11
568040,True,8,Very Positive,101,15,116
568060,True,0,6 user reviews,6,0,6
568070,True,5,Mixed,10,6,16
568080,True,0,No user reviews,0,0,0
568090,True,8,Very Positive,1369,126,1495
568110,True,7,Positive,10,2,12
568120,True,0,No user reviews,0,0,0
568130,True,0,No user reviews,0,0,0
568150,True,0,2 user reviews,2,0,2
568160,True,0,6 user reviews,6,0,6
568170,True,0,No user reviews,0,0,0
568180,True,0,8 user reviews,8,0,8
568200,True,7,Positive,10,1,11
568210,True,0,No user reviews,0,0,0
568220,True,8,Very Positive,1331,221,1552
568240,True,0,1 user reviews,1,0,1
568250,True,0,6 user reviews,3,3,6
568290,True,0,7 user reviews,7,0,7
568300,True,0,No user reviews,0,0,0
568310,True,0,7 user reviews,7,0,7
568320,True,8,Very Positive,318,9,327
568330,True,0,2 user reviews,1,1,2
568370,True,7,Positive,18,2,20
568380,True,6,Mostly Positive,9,3,12
568400,True,0,6 user reviews,4,2,6
568420,True,0,No user reviews,0,0,0
568440,True,6,Mostly Positive,29,10,39
568460,True,7,Positive,11,1,12
568470,True,0,8 user reviews,4,4,8
568480,True,0,2 user reviews,2,0,2
568490,True,7,Positive,13,0,13
568500,True,0,8 user reviews,5,3,8
568540,True,0,No user reviews,0,0,0
568570,True,5,Mixed,785,370,1155
568580,True,5,Mixed,19,13,32
568590,True,0,No user reviews,0,0,0
568600,True,0,5 user reviews,5,0,5
568610,True,7,Positive,23,3,26
568620,True,0,No user reviews,0,0,0
568630,True,0,No user reviews,0,0,0
568640,True,0,4 user reviews,4,0,4
568660,True,0,No user reviews,0,0,0
568670,True,0,No user reviews,0,0,0
568690,True,0,1 user reviews,1,0,1
568700,True,0,No user reviews,0,0,0
568710,True,0,1 user reviews,0,1,1
568720,True,5,Mixed,16,21,37
568750,True,6,Mostly Positive,116,33,149
568760,True,0,No user reviews,0,0,0
568770,True,0,No user reviews,0,0,0
568780,True,6,Mostly Positive,8,3,11
568790,True,0,No user reviews,0,0,0
568800,True,0,2 user reviews,2,0,2
568830,True,7,Positive,10,1,11
568840,True,0,4 user reviews,4,0,4
568850,True,5,Mixed,12,6,18
568860,True,0,4 user reviews,1,3,4
568870,True,0,No user reviews,0,0,0
568880,True,0,No user reviews,0,0,0
568910,True,0,6 user reviews,3,3,6
568920,True,7,Positive,12,2,14
568930,True,6,Mostly Positive,94,32,126
568940,True,5,Mixed,18,10,28
568950,True,7,Positive,25,2,27
568960,True,5,Mixed,10,5,15
568970,True,5,Mixed,15,15,30
568980,True,0,9 user reviews,7,2,9
568990,True,0,9 user reviews,9,0,9
569000,True,0,6 user reviews,5,1,6
569010,True,0,1 user reviews,1,0,1
569030,True,0,1 user reviews,1,0,1
569050,True,0,3 user reviews,3,0,3
569080,True,0,No user reviews,0,0,0
569081,True,0,No user reviews,0,0,0
569082,True,0,No user reviews,0,0,0
569083,True,0,No user reviews,0,0,0
569084,True,0,No user reviews,0,0,0
569085,True,0,No user reviews,0,0,0
569086,True,0,No user reviews,0,0,0
569087,True,0,No user reviews,0,0,0
569088,True,0,No user reviews,0,0,0
569089,True,0,No user reviews,0,0,0
569090,True,0,No user reviews,0,0,0
569091,True,0,No user reviews,0,0,0
569092,True,0,No user reviews,0,0,0
569100,True,0,No user reviews,0,0,0
569110,True,0,No user reviews,0,0,0
569111,True,0,No user reviews,0,0,0
569112,True,0,No user reviews,0,0,0
569113,True,0,No user reviews,0,0,0
569114,True,0,No user reviews,0,0,0
569115,True,0,No user reviews,0,0,0
569116,True,0,No user reviews,0,0,0
569117,True,0,No user reviews,0,0,0
569118,True,0,No user reviews,0,0,0
569119,True,0,No user reviews,0,0,0
569120,True,0,No user reviews,0,0,0
569121,True,0,No user reviews,0,0,0
569122,True,0,No user reviews,0,0,0
569130,True,0,1 user reviews,1,0,1
569140,True,0,4 user reviews,4,0,4
569150,True,0,4 user reviews,4,0,4
569160,True,0,1 user reviews,1,0,1
569170,True,0,No user reviews,0,0,0
569180,True,4,Mostly Negative,3,7,10
569190,True,0,1 user reviews,1,0,1
569200,True,0,3 user reviews,3,0,3
569210,True,0,7 user reviews,4,3,7
569220,True,7,Positive,11,1,12
569240,True,0,No user reviews,0,0,0
569241,True,0,2 user reviews,1,1,2
569242,True,0,No user reviews,0,0,0
569243,True,0,3 user reviews,2,1,3
569244,True,0,No user reviews,0,0,0
569245,True,0,1 user reviews,1,0,1
569246,True,0,No user reviews,0,0,0
569247,True,0,No user reviews,0,0,0
569248,True,0,No user reviews,0,0,0
569249,True,0,No user reviews,0,0,0
569270,True,0,4 user reviews,4,0,4
569290,True,7,Positive,16,4,20
569310,True,0,No user reviews,0,0,0
569340,True,6,Mostly Positive,45,14,59
569350,True,0,5 user reviews,2,3,5
569360,True,7,Positive,15,1,16
569370,True,0,No user reviews,0,0,0
569380,True,7,Positive,12,2,14
569390,True,0,3 user reviews,0,3,3
569400,True,0,No user reviews,0,0,0
569410,True,0,1 user reviews,1,0,1
569420,True,0,7 user reviews,7,0,7
569430,True,5,Mixed,13,8,21
569470,True,0,No user reviews,0,0,0
569480,True,8,Very Positive,8051,835,8886
569500,True,0,2 user reviews,2,0,2
569510,True,0,No user reviews,0,0,0
569520,True,0,2 user reviews,2,0,2
569530,True,8,Very Positive,139,34,173
569570,True,6,Mostly Positive,8,3,11
569580,True,0,No user reviews,0,0,0
569590,True,0,4 user reviews,2,2,4
569600,True,0,No user reviews,0,0,0
569610,True,6,Mostly Positive,49,20,69
569620,True,0,No user reviews,0,0,0
569630,True,6,Mostly Positive,48,20,68
569640,True,5,Mixed,11,13,24
569650,True,0,No user reviews,0,0,0
569670,True,0,No user reviews,0,0,0
569680,True,0,No user reviews,0,0,0
569681,True,0,No user reviews,0,0,0
569682,True,0,No user reviews,0,0,0
569683,True,0,No user reviews,0,0,0
569684,True,0,No user reviews,0,0,0
569685,True,0,4 user reviews,3,1,4
569686,True,0,4 user reviews,3,1,4
569687,True,0,6 user reviews,5,1,6
569688,True,0,1 user reviews,1,0,1
569689,True,0,No user reviews,0,0,0
569690,True,0,No user reviews,0,0,0
569691,True,0,No user reviews,0,0,0
569692,True,0,No user reviews,0,0,0
569700,True,7,Positive,17,3,20
569710,True,0,5 user reviews,5,0,5
569711,True,0,1 user reviews,0,1,1
569712,True,0,5 user reviews,4,1,5
569713,True,0,1 user reviews,0,1,1
569714,True,0,2 user reviews,1,1,2
569715,True,0,1 user reviews,0,1,1
569716,True,0,9 user reviews,8,1,9
569717,True,0,4 user reviews,4,0,4
569720,True,0,1 user reviews,1,0,1
569740,True,0,No user reviews,0,0,0
569770,True,5,Mixed,45,33,78
569800,True,8,Very Positive,87,21,108
569810,True,8,Very Positive,47,5,52
569820,True,0,1 user reviews,1,0,1
569850,True,0,2 user reviews,2,0,2
569860,True,8,Very Positive,1307,108,1415
569870,True,0,5 user reviews,1,4,5
569880,True,0,No user reviews,0,0,0
569890,True,0,No user reviews,0,0,0
569900,True,0,No user reviews,0,0,0
569910,True,0,No user reviews,0,0,0
569911,True,0,No user reviews,0,0,0
569912,True,0,No user reviews,0,0,0
569913,True,0,No user reviews,0,0,0
569914,True,0,No user reviews,0,0,0
569915,True,0,No user reviews,0,0,0
569920,True,0,No user reviews,0,0,0
569930,True,0,No user reviews,0,0,0
569940,True,0,6 user reviews,5,1,6
569950,True,0,No user reviews,0,0,0
569970,True,5,Mixed,38,35,73
569980,True,0,No user reviews,0,0,0
570000,True,8,Very Positive,108,8,116
570010,True,0,No user reviews,0,0,0
570020,True,0,No user reviews,0,0,0
570030,True,0,No user reviews,0,0,0
570050,True,6,Mostly Positive,39,13,52
570060,True,0,2 user reviews,1,1,2
570080,True,0,No user reviews,0,0,0
570090,True,7,Positive,27,5,32
570120,True,0,2 user reviews,2,0,2
570150,True,7,Positive,9,2,11
570160,True,0,No user reviews,0,0,0
570170,True,0,1 user reviews,0,1,1
570180,True,0,1 user reviews,1,0,1
570181,True,0,3 user reviews,3,0,3
570190,True,0,2 user reviews,2,0,2
570200,True,0,2 user reviews,1,1,2
570210,True,0,5 user reviews,3,2,5
570220,True,6,Mostly Positive,26,9,35
570230,True,6,Mostly Positive,7,3,10
570240,True,0,No user reviews,0,0,0
570250,True,0,No user reviews,0,0,0
570260,True,0,1 user reviews,1,0,1
570270,True,0,No user reviews,0,0,0
570280,True,0,No user reviews,0,0,0
570290,True,0,2 user reviews,2,0,2
570310,True,7,Positive,21,2,23
570320,True,0,1 user reviews,0,1,1
570340,True,0,No user reviews,0,0,0
570350,True,5,Mixed,14,7,21
570360,True,0,6 user reviews,6,0,6
570361,True,0,6 user reviews,6,0,6
570362,True,0,5 user reviews,2,3,5
570363,True,0,2 user reviews,2,0,2
570370,True,0,4 user reviews,4,0,4
570380,True,0,7 user reviews,1,6,7
570420,True,6,Mostly Positive,71,30,101
570430,True,0,No user reviews,0,0,0
570450,True,0,No user reviews,0,0,0
570460,True,8,Very Positive,494,99,593
570470,True,5,Mixed,6,5,11
570480,True,0,No user reviews,0,0,0
570481,True,0,No user reviews,0,0,0
570490,True,8,Very Positive,79,2,81
570500,True,0,4 user reviews,1,3,4
570510,True,0,No user reviews,0,0,0
570520,True,0,1 user reviews,1,0,1
570530,True,0,4 user reviews,4,0,4
570540,True,0,8 user reviews,5,3,8
570560,True,0,No user reviews,0,0,0
570570,True,0,No user reviews,0,0,0
570571,True,0,1 user reviews,1,0,1
570572,True,0,No user reviews,0,0,0
570573,True,0,No user reviews,0,0,0
570574,True,0,No user reviews,0,0,0
570575,True,0,No user reviews,0,0,0
570580,True,7,Positive,28,3,31
570590,True,7,Positive,9,2,11
570600,True,0,2 user reviews,2,0,2
570620,True,0,No user reviews,0,0,0
570621,True,0,No user reviews,0,0,0
570622,True,0,No user reviews,0,0,0
570623,True,0,No user reviews,0,0,0
570624,True,0,No user reviews,0,0,0
570625,True,0,No user reviews,0,0,0
570626,True,0,No user reviews,0,0,0
570627,True,0,No user reviews,0,0,0
570628,True,0,No user reviews,0,0,0
570629,True,0,No user reviews,0,0,0
570630,True,0,No user reviews,0,0,0
570631,True,0,No user reviews,0,0,0
570632,True,0,No user reviews,0,0,0
570633,True,0,No user reviews,0,0,0
570634,True,0,No user reviews,0,0,0
570635,True,0,No user reviews,0,0,0
570636,True,0,No user reviews,0,0,0
570637,True,0,No user reviews,0,0,0
570638,True,0,No user reviews,0,0,0
570639,True,0,No user reviews,0,0,0
570640,True,0,No user reviews,0,0,0
570641,True,0,No user reviews,0,0,0
570660,True,5,Mixed,1303,768,2071
570670,True,0,No user reviews,0,0,0
570680,True,7,Positive,27,2,29
570690,True,3,Negative,0,13,13
570710,True,5,Mixed,17,25,42
570720,True,0,No user reviews,0,0,0
570750,True,0,No user reviews,0,0,0
570770,True,7,Positive,30,6,36
570780,True,6,Mostly Positive,38,12,50
570790,True,0,6 user reviews,2,4,6
570800,True,0,No user reviews,0,0,0
570810,True,0,8 user reviews,8,0,8
570820,True,0,2 user reviews,2,0,2
570830,True,0,No user reviews,0,0,0
570840,True,0,6 user reviews,6,0,6
570850,True,0,6 user reviews,4,2,6
570860,True,7,Positive,24,4,28
570890,True,0,3 user reviews,2,1,3
570900,True,7,Positive,36,0,36
570920,True,0,No user reviews,0,0,0
570930,True,7,Positive,19,0,19
570940,True,8,Very Positive,10314,2121,12435
570950,True,0,No user reviews,0,0,0
570960,True,5,Mixed,23,12,35
570970,True,5,Mixed,47,23,70
570980,True,0,6 user reviews,4,2,6
571010,True,7,Positive,18,3,21
571020,True,5,Mixed,14,11,25
571030,True,0,No user reviews,0,0,0
571031,True,0,No user reviews,0,0,0
571040,True,0,6 user reviews,3,3,6
571050,True,0,3 user reviews,1,2,3
571060,True,7,Positive,13,2,15
571080,True,0,1 user reviews,1,0,1
571090,True,0,No user reviews,0,0,0
571100,True,5,Mixed,10,8,18
571120,True,0,2 user reviews,2,0,2
571160,True,0,No user reviews,0,0,0
571170,True,0,No user reviews,0,0,0
571180,True,0,No user reviews,0,0,0
571210,True,7,Positive,40,0,40
571220,True,0,1 user reviews,1,0,1
571230,True,0,4 user reviews,4,0,4
571250,True,0,No user reviews,0,0,0
571260,True,8,Very Positive,352,62,414
571270,True,0,No user reviews,0,0,0
571290,True,0,No user reviews,0,0,0
571310,True,9,Overwhelmingly Positive,1171,50,1221
571330,True,0,1 user reviews,1,0,1
571340,True,5,Mixed,19,12,31
571350,True,7,Positive,24,4,28
571410,True,7,Positive,13,1,14
571430,True,7,Positive,33,3,36
571440,True,0,No user reviews,0,0,0
571470,True,0,No user reviews,0,0,0
571480,True,0,No user reviews,0,0,0
571490,True,0,No user reviews,0,0,0
571500,True,0,2 user reviews,2,0,2
571520,True,6,Mostly Positive,11,3,14
571530,True,8,Very Positive,216,16,232
571550,True,0,4 user reviews,2,2,4
571570,True,0,6 user reviews,4,2,6
571580,True,0,No user reviews,0,0,0
571600,True,7,Positive,33,2,35
571610,True,0,2 user reviews,2,0,2
571630,True,5,Mixed,9,4,13
571640,True,0,No user reviews,0,0,0
571660,True,0,4 user reviews,4,0,4
571670,True,0,1 user reviews,1,0,1
571680,True,0,4 user reviews,4,0,4
571690,True,0,3 user reviews,0,3,3
571700,True,0,No user reviews,0,0,0
571710,True,8,Very Positive,373,26,399
571720,True,6,Mostly Positive,40,17,57
571730,True,0,No user reviews,0,0,0
571740,True,8,Very Positive,4046,609,4655
571750,True,0,No user reviews,0,0,0
571760,True,6,Mostly Positive,9,3,12
571761,True,0,6 user reviews,5,1,6
571810,True,0,1 user reviews,0,1,1
571820,True,0,No user reviews,0,0,0
571850,True,0,1 user reviews,1,0,1
571860,True,5,Mixed,7,4,11
571870,True,5,Mixed,7,8,15
571880,True,9,Overwhelmingly Positive,820,17,837
571890,True,5,Mixed,19,10,29
571900,True,0,No user reviews,0,0,0
571920,True,0,No user reviews,0,0,0
571930,True,0,No user reviews,0,0,0
571940,True,0,No user reviews,0,0,0
571950,True,0,No user reviews,0,0,0
571960,True,0,3 user reviews,2,1,3
571970,True,0,No user reviews,0,0,0
571971,True,0,No user reviews,0,0,0
571980,True,0,No user reviews,0,0,0
571981,True,0,No user reviews,0,0,0
571990,True,0,1 user reviews,1,0,1
572000,True,0,3 user reviews,3,0,3
572010,True,4,Mostly Negative,5,16,21
572020,True,7,Positive,25,2,27
572030,True,0,No user reviews,0,0,0
572040,True,5,Mixed,5,6,11
572050,True,5,Mixed,16,14,30
572060,True,0,No user reviews,0,0,0
572070,True,0,No user reviews,0,0,0
572080,True,0,No user reviews,0,0,0
572090,True,0,No user reviews,0,0,0
572091,True,0,No user reviews,0,0,0
572092,True,0,No user reviews,0,0,0
572093,True,0,No user reviews,0,0,0
572094,True,0,No user reviews,0,0,0
572095,True,0,No user reviews,0,0,0
572096,True,0,No user reviews,0,0,0
572097,True,0,No user reviews,0,0,0
572098,True,0,No user reviews,0,0,0
572099,True,0,No user reviews,0,0,0
572100,True,0,No user reviews,0,0,0
572101,True,0,No user reviews,0,0,0
572102,True,0,No user reviews,0,0,0
572103,True,0,No user reviews,0,0,0
572104,True,0,No user reviews,0,0,0
572105,True,0,No user reviews,0,0,0
572106,True,0,No user reviews,0,0,0
572107,True,0,No user reviews,0,0,0
572108,True,0,No user reviews,0,0,0
572109,True,0,No user reviews,0,0,0
572110,True,0,No user reviews,0,0,0
572111,True,0,No user reviews,0,0,0
572120,True,0,No user reviews,0,0,0
572130,True,0,4 user reviews,4,0,4
572140,True,0,No user reviews,0,0,0
572150,True,0,No user reviews,0,0,0
572160,True,7,Positive,37,8,45
572170,True,0,2 user reviews,1,1,2
572180,True,0,7 user reviews,7,0,7
572190,True,0,No user reviews,0,0,0
572200,True,0,No user reviews,0,0,0
572210,True,0,2 user reviews,2,0,2
572220,True,8,Very Positive,119,9,128
572230,True,0,7 user reviews,1,6,7
572240,True,0,3 user reviews,2,1,3
572280,True,0,No user reviews,0,0,0
572290,True,0,2 user reviews,1,1,2
572300,True,6,Mostly Positive,38,14,52
572310,True,0,1 user reviews,1,0,1
572311,True,0,1 user reviews,1,0,1
572330,True,5,Mixed,27,13,40
572340,True,0,No user reviews,0,0,0
572350,True,0,3 user reviews,2,1,3
572370,True,0,No user reviews,0,0,0
572380,True,0,No user reviews,0,0,0
572381,True,0,1 user reviews,1,0,1
572382,True,0,No user reviews,0,0,0
572390,True,0,No user reviews,0,0,0
572400,True,0,No user reviews,0,0,0
572410,True,6,Mostly Positive,1636,618,2254
572420,True,0,No user reviews,0,0,0
572430,True,6,Mostly Positive,220,80,300
572460,True,0,No user reviews,0,0,0
572470,True,0,No user reviews,0,0,0
572480,True,0,1 user reviews,1,0,1
572490,True,0,No user reviews,0,0,0
572500,True,0,No user reviews,0,0,0
572520,True,6,Mostly Positive,51,18,69
572530,True,0,No user reviews,0,0,0
572540,True,7,Positive,23,2,25
572570,True,0,5 user reviews,5,0,5
572580,True,6,Mostly Positive,10,4,14
572600,True,5,Mixed,4120,2121,6241
572620,True,5,Mixed,26,13,39
572630,True,7,Positive,14,1,15
572640,True,0,7 user reviews,6,1,7
572660,True,0,5 user reviews,2,3,5
572700,True,8,Very Positive,51,5,56
572710,True,6,Mostly Positive,14,4,18
572720,True,5,Mixed,6,8,14
572730,True,7,Positive,37,2,39
572740,True,7,Positive,33,4,37
572750,True,0,No user reviews,0,0,0
572760,True,0,8 user reviews,8,0,8
572770,True,0,No user reviews,0,0,0
572780,True,0,No user reviews,0,0,0
572790,True,0,No user reviews,0,0,0
572800,True,0,No user reviews,0,0,0
572810,True,0,No user reviews,0,0,0
572820,True,0,No user reviews,0,0,0
572830,True,0,No user reviews,0,0,0
572840,True,0,No user reviews,0,0,0
572890,True,8,Very Positive,800,56,856
572910,True,0,5 user reviews,5,0,5
572930,True,0,No user reviews,0,0,0
572940,True,0,No user reviews,0,0,0
572941,True,0,No user reviews,0,0,0
572942,True,0,1 user reviews,1,0,1
572943,True,0,No user reviews,0,0,0
572944,True,0,No user reviews,0,0,0
572945,True,0,No user reviews,0,0,0
572946,True,0,No user reviews,0,0,0
572947,True,0,No user reviews,0,0,0
572948,True,0,No user reviews,0,0,0
572949,True,0,No user reviews,0,0,0
572950,True,0,No user reviews,0,0,0
572951,True,0,No user reviews,0,0,0
572960,True,0,3 user reviews,3,0,3
572961,True,0,No user reviews,0,0,0
572962,True,0,No user reviews,0,0,0
572963,True,0,No user reviews,0,0,0
572964,True,0,No user reviews,0,0,0
572965,True,0,1 user reviews,1,0,1
572966,True,0,No user reviews,0,0,0
572967,True,0,No user reviews,0,0,0
572968,True,0,No user reviews,0,0,0
572969,True,0,No user reviews,0,0,0
572970,True,0,No user reviews,0,0,0
572971,True,0,No user reviews,0,0,0
572972,True,0,1 user reviews,1,0,1
572980,True,0,5 user reviews,0,5,5
572990,True,0,2 user reviews,1,1,2
572991,True,0,No user reviews,0,0,0
572992,True,0,No user reviews,0,0,0
572993,True,0,No user reviews,0,0,0
572994,True,0,No user reviews,0,0,0
572995,True,0,No user reviews,0,0,0
572996,True,0,No user reviews,0,0,0
572997,True,0,No user reviews,0,0,0
572998,True,0,No user reviews,0,0,0
572999,True,0,No user reviews,0,0,0
573000,True,0,No user reviews,0,0,0
573001,True,0,No user reviews,0,0,0
573010,True,0,No user reviews,0,0,0
573020,True,0,2 user reviews,2,0,2
573021,True,0,No user reviews,0,0,0
573022,True,0,2 user reviews,2,0,2
573023,True,0,No user reviews,0,0,0
573024,True,0,No user reviews,0,0,0
573025,True,0,No user reviews,0,0,0
573026,True,0,No user reviews,0,0,0
573027,True,0,No user reviews,0,0,0
573028,True,0,No user reviews,0,0,0
573029,True,0,No user reviews,0,0,0
573030,True,0,No user reviews,0,0,0
573031,True,0,1 user reviews,1,0,1
573040,True,7,Positive,14,2,16
573050,True,7,Positive,14,1,15
573060,True,6,Mostly Positive,117,34,151
573070,True,5,Mixed,10,5,15
573080,True,6,Mostly Positive,30,12,42
573090,True,8,Very Positive,7617,584,8201
573100,True,6,Mostly Positive,2142,565,2707
573110,True,5,Mixed,13,7,20
573120,True,6,Mostly Positive,264,71,335
573130,True,8,Very Positive,142,29,171
573140,True,0,No user reviews,0,0,0
573150,True,0,No user reviews,0,0,0
573160,True,8,Very Positive,89,11,100
573170,True,8,Very Positive,193,8,201
573180,True,7,Positive,22,1,23
573190,True,0,1 user reviews,1,0,1
573210,True,5,Mixed,6,8,14
573220,True,0,No user reviews,0,0,0
573230,True,0,No user reviews,0,0,0
573250,True,0,No user reviews,0,0,0
573260,True,0,7 user reviews,3,4,7
573270,True,7,Positive,18,4,22
573280,True,0,No user reviews,0,0,0
573290,True,7,Positive,14,0,14
573300,True,7,Positive,17,3,20
573310,True,0,No user reviews,0,0,0
573320,True,8,Very Positive,341,26,367
573330,True,0,4 user reviews,1,3,4
573340,True,0,No user reviews,0,0,0
573350,True,0,2 user reviews,2,0,2
573360,True,7,Positive,11,0,11
573370,True,5,Mixed,9,5,14
573410,True,8,Very Positive,523,53,576
573460,True,0,5 user reviews,3,2,5
573470,True,0,1 user reviews,0,1,1
573480,True,0,No user reviews,0,0,0
573490,True,6,Mostly Positive,187,55,242
573500,True,0,No user reviews,0,0,0
573510,True,0,No user reviews,0,0,0
573511,True,0,1 user reviews,0,1,1
573512,True,0,1 user reviews,0,1,1
573513,True,0,No user reviews,0,0,0
573520,True,7,Positive,39,2,41
573530,True,0,5 user reviews,3,2,5
573540,True,0,No user reviews,0,0,0
573541,True,0,2 user reviews,2,0,2
573542,True,0,1 user reviews,1,0,1
573543,True,0,1 user reviews,1,0,1
573544,True,0,1 user reviews,1,0,1
573545,True,0,1 user reviews,1,0,1
573546,True,0,No user reviews,0,0,0
573548,True,0,2 user reviews,2,0,2
573550,True,7,Positive,13,1,14
573560,True,0,No user reviews,0,0,0
573570,True,0,3 user reviews,1,2,3
573580,True,0,3 user reviews,2,1,3
573600,True,5,Mixed,37,21,58
573610,True,0,1 user reviews,1,0,1
573620,True,0,1 user reviews,1,0,1
573630,True,0,No user reviews,0,0,0
573640,True,0,1 user reviews,0,1,1
573650,True,0,1 user reviews,0,1,1
573660,True,0,8 user reviews,0,8,8
573670,True,0,4 user reviews,4,0,4
573680,True,5,Mixed,22,25,47
573690,True,0,2 user reviews,2,0,2
573700,True,0,2 user reviews,2,0,2
573710,True,0,1 user reviews,1,0,1
573720,True,0,3 user reviews,3,0,3
573730,True,0,1 user reviews,1,0,1
573740,True,0,No user reviews,0,0,0
573750,True,0,1 user reviews,0,1,1
573760,True,0,5 user reviews,5,0,5
573770,True,7,Positive,13,1,14
573780,True,5,Mixed,38,19,57
573790,True,7,Positive,30,2,32
573800,True,0,No user reviews,0,0,0
573820,True,0,No user reviews,0,0,0
573821,True,0,No user reviews,0,0,0
573830,True,4,Mostly Negative,29,88,117
573832,True,5,Mixed,49,29,78
573850,True,0,No user reviews,0,0,0
573860,True,0,No user reviews,0,0,0
573870,True,0,No user reviews,0,0,0
573880,True,0,No user reviews,0,0,0
573890,True,0,No user reviews,0,0,0
573900,True,0,8 user reviews,8,0,8
573920,True,0,No user reviews,0,0,0
573960,True,0,5 user reviews,1,4,5
573980,True,0,No user reviews,0,0,0
573990,True,0,No user reviews,0,0,0
574010,True,6,Mostly Positive,12,4,16
574020,True,0,No user reviews,0,0,0
574030,True,5,Mixed,17,22,39
574040,True,0,2 user reviews,1,1,2
574050,True,5,Mixed,223,105,328
574070,True,0,No user reviews,0,0,0
574080,True,5,Mixed,123,128,251
574090,True,8,Very Positive,518,117,635
574110,True,0,No user reviews,0,0,0
574120,True,5,Mixed,12,7,19
574130,True,0,No user reviews,0,0,0
574140,True,6,Mostly Positive,39,15,54
574150,True,0,2 user reviews,2,0,2
574160,True,7,Positive,13,1,14
574170,True,0,3 user reviews,2,1,3
574180,True,0,No user reviews,0,0,0
574190,True,0,1 user reviews,1,0,1
574200,True,5,Mixed,30,15,45
574220,True,0,2 user reviews,2,0,2
574260,True,7,Positive,28,7,35
574270,True,7,Positive,21,5,26
574280,True,0,4 user reviews,3,1,4
574300,True,0,No user reviews,0,0,0
574310,True,8,Very Positive,94,20,114
574320,True,0,No user reviews,0,0,0
574330,True,0,2 user reviews,2,0,2
574340,True,0,No user reviews,0,0,0
574380,True,0,2 user reviews,2,0,2
574390,True,0,No user reviews,0,0,0
574400,True,0,1 user reviews,1,0,1
574410,True,0,1 user reviews,1,0,1
574420,True,0,6 user reviews,5,1,6
574440,True,0,No user reviews,0,0,0
574450,True,0,No user reviews,0,0,0
574460,True,0,No user reviews,0,0,0
574490,True,0,No user reviews,0,0,0
574500,True,0,9 user reviews,8,1,9
574520,True,0,2 user reviews,1,1,2
574530,True,0,No user reviews,0,0,0
574560,True,8,Very Positive,459,110,569
574570,True,6,Mostly Positive,12,5,17
574580,True,6,Mostly Positive,11,4,15
574590,True,0,5 user reviews,5,0,5
574640,True,6,Mostly Positive,30,11,41
574670,True,0,1 user reviews,0,1,1
574671,True,0,No user reviews,0,0,0
574672,True,0,No user reviews,0,0,0
574673,True,0,No user reviews,0,0,0
574674,True,0,No user reviews,0,0,0
574675,True,0,No user reviews,0,0,0
574676,True,0,No user reviews,0,0,0
574677,True,0,1 user reviews,0,1,1
574690,True,0,6 user reviews,5,1,6
574710,True,0,4 user reviews,1,3,4
574720,True,8,Very Positive,454,69,523
574730,True,0,No user reviews,0,0,0
574740,True,0,No user reviews,0,0,0
574750,True,0,No user reviews,0,0,0
574760,True,5,Mixed,349,329,678
574770,True,0,No user reviews,0,0,0
574780,True,0,No user reviews,0,0,0
574790,True,0,No user reviews,0,0,0
574820,True,8,Very Positive,65,7,72
574860,True,0,9 user reviews,3,6,9
574880,True,0,No user reviews,0,0,0
574890,True,7,Positive,16,3,19
574910,True,0,2 user reviews,2,0,2
574920,True,0,4 user reviews,3,1,4
574940,True,8,Very Positive,54,8,62
574950,True,0,No user reviews,0,0,0
574960,True,0,No user reviews,0,0,0
574961,True,0,1 user reviews,1,0,1
574962,True,0,No user reviews,0,0,0
574963,True,0,No user reviews,0,0,0
574964,True,0,No user reviews,0,0,0
574965,True,0,No user reviews,0,0,0
574966,True,0,No user reviews,0,0,0
574967,True,0,2 user reviews,2,0,2
574968,True,0,No user reviews,0,0,0
574970,True,0,No user reviews,0,0,0
574971,True,0,No user reviews,0,0,0
574972,True,0,No user reviews,0,0,0
574980,True,8,Very Positive,1056,86,1142
574990,True,0,1 user reviews,0,1,1
575000,True,0,No user reviews,0,0,0
575010,True,6,Mostly Positive,63,19,82
575030,True,0,1 user reviews,0,1,1
575040,True,0,No user reviews,0,0,0
575050,True,0,5 user reviews,5,0,5
575060,True,0,No user reviews,0,0,0
575080,True,0,1 user reviews,0,1,1
575090,True,0,9 user reviews,5,4,9
575100,True,0,2 user reviews,1,1,2
575110,True,0,9 user reviews,8,1,9
575160,True,4,Mostly Negative,5,11,16
575170,True,0,No user reviews,0,0,0
575180,True,0,1 user reviews,1,0,1
575190,True,0,No user reviews,0,0,0
575210,True,7,Positive,16,4,20
575220,True,0,No user reviews,0,0,0
575230,True,0,No user reviews,0,0,0
575240,True,0,No user reviews,0,0,0
575250,True,0,No user reviews,0,0,0
575260,True,0,No user reviews,0,0,0
575270,True,0,6 user reviews,4,2,6
575280,True,0,No user reviews,0,0,0
575290,True,6,Mostly Positive,8,3,11
575291,True,7,Positive,12,1,13
575300,True,7,Positive,9,2,11
575301,True,0,7 user reviews,3,4,7
575302,True,0,No user reviews,0,0,0
575330,True,8,Very Positive,151,20,171
575340,True,5,Mixed,22,11,33
575360,True,0,3 user reviews,2,1,3
575400,True,7,Positive,30,6,36
575420,True,7,Positive,21,3,24
575430,True,5,Mixed,14,7,21
575450,True,6,Mostly Positive,17,5,22
575480,True,8,Very Positive,68,4,72
575490,True,0,6 user reviews,4,2,6
575500,True,0,2 user reviews,0,2,2
575501,True,0,1 user reviews,0,1,1
575510,True,6,Mostly Positive,41,13,54
575540,True,5,Mixed,8,7,15
575550,True,8,Very Positive,655,126,781
575560,True,0,4 user reviews,2,2,4
575570,True,5,Mixed,26,16,42
575580,True,5,Mixed,13,6,19
575590,True,7,Positive,14,0,14
575600,True,5,Mixed,36,26,62
575610,True,0,No user reviews,0,0,0
575630,True,5,Mixed,6,4,10
575640,True,8,Very Positive,1110,126,1236
575650,True,8,Very Positive,109,16,125
575660,True,0,No user reviews,0,0,0
575670,True,7,Positive,9,2,11
575680,True,0,1 user reviews,1,0,1
575690,True,0,5 user reviews,5,0,5
575700,True,5,Mixed,18,13,31
575710,True,0,5 user reviews,5,0,5
575720,True,0,No user reviews,0,0,0
575750,True,0,4 user reviews,2,2,4
575760,True,0,3 user reviews,2,1,3
575770,True,0,No user reviews,0,0,0
575780,True,0,5 user reviews,3,2,5
575800,True,0,4 user reviews,3,1,4
575810,True,0,1 user reviews,1,0,1
575820,True,6,Mostly Positive,64,20,84
575830,True,5,Mixed,11,14,25
575840,True,0,6 user reviews,5,1,6
575850,True,5,Mixed,13,11,24
575860,True,0,9 user reviews,3,6,9
575880,True,0,3 user reviews,2,1,3
575890,True,5,Mixed,11,6,17
575900,True,7,Positive,16,3,19
575920,True,0,3 user reviews,2,1,3
575930,True,0,No user reviews,0,0,0
575940,True,8,Very Positive,55,8,63
575950,True,5,Mixed,89,55,144
575960,True,5,Mixed,18,18,36
575970,True,8,Very Positive,52,7,59
575990,True,0,9 user reviews,7,2,9
576020,True,0,5 user reviews,1,4,5
576030,True,8,Very Positive,160,19,179
576050,True,4,Mostly Negative,6,10,16
576060,True,0,6 user reviews,2,4,6
576090,True,0,No user reviews,0,0,0
576100,True,6,Mostly Positive,14,5,19
576110,True,0,4 user reviews,1,3,4
576120,True,0,7 user reviews,2,5,7
576130,True,8,Very Positive,45,7,52
576160,True,7,Positive,11,1,12
576180,True,0,No user reviews,0,0,0
576200,True,0,No user reviews,0,0,0
576210,True,0,No user reviews,0,0,0
576220,True,0,No user reviews,0,0,0
576230,True,0,No user reviews,0,0,0
576250,True,0,No user reviews,0,0,0
576260,True,5,Mixed,57,33,90
576270,True,0,No user reviews,0,0,0
576280,True,6,Mostly Positive,10,3,13
576290,True,0,2 user reviews,1,1,2
576300,True,0,7 user reviews,7,0,7
576310,True,5,Mixed,69,54,123
576320,True,5,Mixed,12,16,28
576330,True,0,1 user reviews,0,1,1
576370,True,0,5 user reviews,3,2,5
576380,True,0,3 user reviews,2,1,3
576390,True,0,9 user reviews,3,6,9
576400,True,5,Mixed,29,14,43
576410,True,6,Mostly Positive,23,6,29
576420,True,7,Positive,41,0,41
576440,True,2,Very Negative,9,42,51
576470,True,7,Positive,19,4,23
576480,True,0,9 user reviews,4,5,9
576500,True,7,Positive,42,0,42
576520,True,0,1 user reviews,0,1,1
576530,True,0,1 user reviews,0,1,1
576540,True,0,9 user reviews,4,5,9
576570,True,0,No user reviews,0,0,0
576580,True,0,No user reviews,0,0,0
576590,True,4,Mostly Negative,6,10,16
576610,True,0,1 user reviews,1,0,1
576611,True,0,No user reviews,0,0,0
576612,True,0,No user reviews,0,0,0
576613,True,0,No user reviews,0,0,0
576614,True,0,No user reviews,0,0,0
576615,True,0,1 user reviews,1,0,1
576616,True,0,No user reviews,0,0,0
576617,True,0,No user reviews,0,0,0
576620,True,6,Mostly Positive,28,9,37
576640,True,0,No user reviews,0,0,0
576650,True,0,6 user reviews,6,0,6
576660,True,0,2 user reviews,2,0,2
576670,True,0,1 user reviews,1,0,1
576680,True,0,No user reviews,0,0,0
576690,True,0,4 user reviews,1,3,4
576700,True,0,3 user reviews,0,3,3
576720,True,7,Positive,10,2,12
576730,True,6,Mostly Positive,7,3,10
576740,True,0,7 user reviews,7,0,7
576750,True,6,Mostly Positive,15,4,19
576770,True,8,Very Positive,510,39,549
576790,True,0,5 user reviews,4,1,5
576800,True,0,4 user reviews,2,2,4
576810,True,6,Mostly Positive,38,13,51
576820,True,0,3 user reviews,3,0,3
576840,True,7,Positive,11,1,12
576860,True,0,2 user reviews,2,0,2
576900,True,0,No user reviews,0,0,0
576910,True,0,No user reviews,0,0,0
576920,True,0,1 user reviews,1,0,1
576930,True,0,No user reviews,0,0,0
576940,True,0,No user reviews,0,0,0
576950,True,5,Mixed,21,11,32
576960,True,5,Mixed,18,8,26
576970,True,0,1 user reviews,1,0,1
576980,True,7,Positive,23,2,25
576990,True,0,No user reviews,0,0,0
577000,True,0,1 user reviews,1,0,1
577010,True,0,No user reviews,0,0,0
577020,True,0,4 user reviews,4,0,4
577030,True,0,2 user reviews,2,0,2
577080,True,5,Mixed,83,38,121
577100,True,0,1 user reviews,1,0,1
577110,True,0,No user reviews,0,0,0
577120,True,0,2 user reviews,1,1,2
577130,True,0,1 user reviews,1,0,1
577131,True,0,3 user reviews,3,0,3
577150,True,0,3 user reviews,3,0,3
577160,True,0,1 user reviews,1,0,1
577180,True,0,No user reviews,0,0,0
577200,True,0,No user reviews,0,0,0
577210,True,0,4 user reviews,3,1,4
577220,True,0,No user reviews,0,0,0
577230,True,6,Mostly Positive,132,54,186
577240,True,0,No user reviews,0,0,0
577260,True,0,No user reviews,0,0,0
577270,True,0,8 user reviews,8,0,8
577280,True,5,Mixed,6,5,11
577290,True,7,Positive,15,3,18
577310,True,0,2 user reviews,2,0,2
577311,True,0,1 user reviews,1,0,1
577312,True,0,1 user reviews,0,1,1
577320,True,0,2 user reviews,2,0,2
577330,True,0,7 user reviews,2,5,7
577350,True,6,Mostly Positive,106,45,151
577351,True,6,Mostly Positive,27,10,37
577352,True,7,Positive,20,0,20
577353,True,7,Positive,43,6,49
577354,True,6,Mostly Positive,49,21,70
577355,True,8,Very Positive,55,9,64
577356,True,6,Mostly Positive,46,16,62
577357,True,4,Mostly Negative,35,64,99
577358,True,5,Mixed,35,28,63
577359,True,5,Mixed,21,12,33
577360,True,6,Mostly Positive,10,3,13
577370,True,0,1 user reviews,1,0,1
577380,True,0,No user reviews,0,0,0
577390,True,0,No user reviews,0,0,0
577400,True,0,1 user reviews,1,0,1
577401,True,0,2 user reviews,0,2,2
577402,True,0,2 user reviews,2,0,2
577403,True,0,1 user reviews,1,0,1
577404,True,0,2 user reviews,1,1,2
577405,True,0,1 user reviews,1,0,1
577410,True,5,Mixed,110,50,160
577420,True,0,No user reviews,0,0,0
577421,True,0,No user reviews,0,0,0
577422,True,0,No user reviews,0,0,0
577423,True,0,No user reviews,0,0,0
577424,True,0,No user reviews,0,0,0
577425,True,0,No user reviews,0,0,0
577426,True,0,No user reviews,0,0,0
577427,True,0,No user reviews,0,0,0
577428,True,0,No user reviews,0,0,0
577429,True,0,No user reviews,0,0,0
577430,True,0,No user reviews,0,0,0
577431,True,0,No user reviews,0,0,0
577432,True,0,No user reviews,0,0,0
577433,True,0,No user reviews,0,0,0
577434,True,0,No user reviews,0,0,0
577440,True,7,Positive,18,3,21
577450,True,7,Positive,11,0,11
577460,True,5,Mixed,34,44,78
577470,True,6,Mostly Positive,12,5,17
577480,True,8,Very Positive,121,2,123
577490,True,7,Positive,17,1,18
577510,True,0,No user reviews,0,0,0
577511,True,0,No user reviews,0,0,0
577512,True,0,No user reviews,0,0,0
577513,True,0,No user reviews,0,0,0
577514,True,0,No user reviews,0,0,0
577515,True,0,No user reviews,0,0,0
577516,True,0,No user reviews,0,0,0
577517,True,0,No user reviews,0,0,0
577518,True,0,No user reviews,0,0,0
577519,True,0,No user reviews,0,0,0
577520,True,0,No user reviews,0,0,0
577521,True,0,No user reviews,0,0,0
577522,True,0,No user reviews,0,0,0
577530,True,8,Very Positive,81,13,94
577540,True,0,No user reviews,0,0,0
577560,True,0,2 user reviews,2,0,2
577570,True,0,1 user reviews,0,1,1
577580,True,6,Mostly Positive,11,4,15
577590,True,0,No user reviews,0,0,0
577600,True,0,4 user reviews,4,0,4
577610,True,0,No user reviews,0,0,0
577620,True,0,No user reviews,0,0,0
577630,True,0,No user reviews,0,0,0
577640,True,0,1 user reviews,0,1,1
577650,True,0,No user reviews,0,0,0
577670,True,5,Mixed,163,76,239
577690,True,8,Very Positive,521,31,552
577700,True,7,Positive,30,4,34
577710,True,0,No user reviews,0,0,0
577720,True,0,No user reviews,0,0,0
577730,True,6,Mostly Positive,74,24,98
577740,True,5,Mixed,17,12,29
577760,True,0,9 user reviews,9,0,9
577780,True,0,4 user reviews,3,1,4
577800,True,4,Mostly Negative,965,1907,2872
577810,True,0,1 user reviews,1,0,1
577850,True,7,Positive,19,3,22
577890,True,0,6 user reviews,0,6,6
577901,True,8,Very Positive,127,25,152
577910,True,7,Positive,20,0,20
577930,True,0,No user reviews,0,0,0
577940,True,8,Very Positive,1062,97,1159
577970,True,8,Very Positive,69,2,71
577980,True,5,Mixed,5,7,12
577990,True,7,Positive,41,6,47
578000,True,0,No user reviews,0,0,0
578010,True,4,Mostly Negative,3,7,10
578020,True,0,1 user reviews,1,0,1
578030,True,7,Positive,9,2,11
578050,True,0,No user reviews,0,0,0
578060,True,7,Positive,14,0,14
578070,True,0,No user reviews,0,0,0
578080,True,5,Mixed,144242,93342,237584
578110,True,0,No user reviews,0,0,0
578130,True,0,No user reviews,0,0,0
578140,True,0,4 user reviews,0,4,4
578190,True,0,4 user reviews,4,0,4
578210,True,6,Mostly Positive,206,79,285
578240,True,0,No user reviews,0,0,0
578270,True,0,No user reviews,0,0,0
578290,True,0,No user reviews,0,0,0
578300,True,7,Positive,21,0,21
578310,True,6,Mostly Positive,95,38,133
578320,True,7,Positive,10,0,10
578330,True,6,Mostly Positive,466,127,593
578340,True,0,5 user reviews,5,0,5
578350,True,7,Positive,26,6,32
578360,True,0,5 user reviews,3,2,5
578380,True,0,3 user reviews,3,0,3
578390,True,0,6 user reviews,2,4,6
578400,True,0,No user reviews,0,0,0
578410,True,0,No user reviews,0,0,0
578411,True,0,No user reviews,0,0,0
578412,True,0,No user reviews,0,0,0
578413,True,0,No user reviews,0,0,0
578414,True,0,No user reviews,0,0,0
578415,True,0,No user reviews,0,0,0
578420,True,7,Positive,12,0,12
578430,True,7,Positive,38,3,41
578440,True,0,No user reviews,0,0,0
578470,True,0,4 user reviews,4,0,4
578480,True,0,No user reviews,0,0,0
578500,True,0,No user reviews,0,0,0
578510,True,0,No user reviews,0,0,0
578540,True,0,No user reviews,0,0,0
578550,True,0,No user reviews,0,0,0
578560,True,0,3 user reviews,1,2,3
578570,True,0,No user reviews,0,0,0
578590,True,0,5 user reviews,0,5,5
578600,True,0,No user reviews,0,0,0
578610,True,0,7 user reviews,6,1,7
578620,True,9,Overwhelmingly Positive,4669,226,4895
578630,True,0,No user reviews,0,0,0
578650,True,8,Very Positive,1062,228,1290
578660,True,7,Positive,8,2,10
578670,True,0,1 user reviews,1,0,1
578680,True,0,No user reviews,0,0,0
578690,True,7,Positive,9,1,10
578710,True,0,No user reviews,0,0,0
578720,True,5,Mixed,256,125,381
578740,True,0,3 user reviews,1,2,3
578760,True,0,No user reviews,0,0,0
578770,True,0,3 user reviews,3,0,3
578800,True,5,Mixed,7,5,12
578820,True,0,No user reviews,0,0,0
578830,True,5,Mixed,17,11,28
578840,True,0,No user reviews,0,0,0
578850,True,8,Very Positive,186,16,202
578870,True,7,Positive,14,3,17
578880,True,0,5 user reviews,3,2,5
578890,True,0,7 user reviews,7,0,7
578900,True,8,Very Positive,268,11,279
578920,True,0,No user reviews,0,0,0
578930,True,8,Very Positive,97,3,100
578940,True,0,No user reviews,0,0,0
578970,True,0,3 user reviews,2,1,3
578980,True,0,1 user reviews,1,0,1
578990,True,0,6 user reviews,0,6,6
579020,True,5,Mixed,158,68,226
579030,True,0,No user reviews,0,0,0
579040,True,0,No user reviews,0,0,0
579050,True,0,8 user reviews,6,2,8
579080,True,0,1 user reviews,1,0,1
579090,True,0,No user reviews,0,0,0
579100,True,0,1 user reviews,0,1,1
579110,True,8,Very Positive,111,11,122
579120,True,5,Mixed,19,24,43
579130,True,0,8 user reviews,4,4,8
579140,True,0,No user reviews,0,0,0
579150,True,5,Mixed,9,5,14
579160,True,0,2 user reviews,1,1,2
579180,True,8,Very Positive,670,90,760
579210,True,0,8 user reviews,3,5,8
579230,True,7,Positive,31,4,35
579270,True,0,2 user reviews,2,0,2
579320,True,0,7 user reviews,6,1,7
579330,True,0,8 user reviews,1,7,8
579340,True,0,No user reviews,0,0,0
579341,True,0,No user reviews,0,0,0
579350,True,0,No user reviews,0,0,0
579351,True,0,No user reviews,0,0,0
579352,True,0,No user reviews,0,0,0
579353,True,0,No user reviews,0,0,0
579354,True,0,No user reviews,0,0,0
579355,True,0,No user reviews,0,0,0
579356,True,0,No user reviews,0,0,0
579357,True,0,No user reviews,0,0,0
579358,True,0,No user reviews,0,0,0
579359,True,0,No user reviews,0,0,0
579360,True,0,No user reviews,0,0,0
579361,True,0,No user reviews,0,0,0
579370,True,0,No user reviews,0,0,0
579371,True,0,No user reviews,0,0,0
579372,True,0,No user reviews,0,0,0
579373,True,0,No user reviews,0,0,0
579374,True,0,No user reviews,0,0,0
579375,True,0,No user reviews,0,0,0
579380,True,0,No user reviews,0,0,0
579381,True,0,No user reviews,0,0,0
579390,True,0,No user reviews,0,0,0
579391,True,0,No user reviews,0,0,0
579410,True,0,2 user reviews,2,0,2
579420,True,0,No user reviews,0,0,0
579421,True,0,No user reviews,0,0,0
579422,True,0,No user reviews,0,0,0
579423,True,0,No user reviews,0,0,0
579424,True,0,No user reviews,0,0,0
579425,True,0,No user reviews,0,0,0
579426,True,0,No user reviews,0,0,0
579427,True,0,No user reviews,0,0,0
579428,True,0,No user reviews,0,0,0
579429,True,0,No user reviews,0,0,0
579430,True,0,No user reviews,0,0,0
579431,True,0,No user reviews,0,0,0
579432,True,0,No user reviews,0,0,0
579440,True,0,No user reviews,0,0,0
579441,True,0,No user reviews,0,0,0
579442,True,0,No user reviews,0,0,0
579443,True,0,No user reviews,0,0,0
579444,True,0,No user reviews,0,0,0
579445,True,0,No user reviews,0,0,0
579446,True,0,No user reviews,0,0,0
579447,True,0,No user reviews,0,0,0
579448,True,0,No user reviews,0,0,0
579449,True,0,No user reviews,0,0,0
579450,True,0,No user reviews,0,0,0
579451,True,0,No user reviews,0,0,0
579452,True,0,No user reviews,0,0,0
579460,True,0,No user reviews,0,0,0
579470,True,0,No user reviews,0,0,0
579471,True,0,No user reviews,0,0,0
579472,True,0,No user reviews,0,0,0
579473,True,0,No user reviews,0,0,0
579474,True,0,No user reviews,0,0,0
579475,True,0,No user reviews,0,0,0
579480,True,0,No user reviews,0,0,0
579481,True,0,No user reviews,0,0,0
579482,True,0,No user reviews,0,0,0
579483,True,0,No user reviews,0,0,0
579484,True,0,No user reviews,0,0,0
579485,True,0,No user reviews,0,0,0
579490,True,7,Positive,17,4,21
579504,True,0,No user reviews,0,0,0
579505,True,0,No user reviews,0,0,0
579506,True,0,No user reviews,0,0,0
579507,True,0,No user reviews,0,0,0
579508,True,0,No user reviews,0,0,0
579510,True,0,2 user reviews,2,0,2
579520,True,0,No user reviews,0,0,0
579521,True,0,No user reviews,0,0,0
579522,True,0,No user reviews,0,0,0
579523,True,0,No user reviews,0,0,0
579530,True,0,No user reviews,0,0,0
579531,True,0,1 user reviews,1,0,1
579532,True,0,No user reviews,0,0,0
579533,True,0,No user reviews,0,0,0
579534,True,0,No user reviews,0,0,0
579535,True,0,No user reviews,0,0,0
579536,True,0,No user reviews,0,0,0
579537,True,0,No user reviews,0,0,0
579538,True,0,1 user reviews,0,1,1
579539,True,0,No user reviews,0,0,0
579540,True,0,No user reviews,0,0,0
579541,True,0,No user reviews,0,0,0
579550,True,0,No user reviews,0,0,0
579560,True,0,No user reviews,0,0,0
579580,True,0,1 user reviews,0,1,1
579600,True,0,No user reviews,0,0,0
579610,True,0,No user reviews,0,0,0
579620,True,0,No user reviews,0,0,0
579630,True,0,No user reviews,0,0,0
579640,True,0,2 user reviews,2,0,2
579650,True,0,No user reviews,0,0,0
579660,True,0,No user reviews,0,0,0
579680,True,0,No user reviews,0,0,0
579700,True,0,No user reviews,0,0,0
579720,True,6,Mostly Positive,10,4,14
579730,True,0,No user reviews,0,0,0
579740,True,0,No user reviews,0,0,0
579750,True,0,1 user reviews,0,1,1
579760,True,8,Very Positive,164,20,184
579780,True,6,Mostly Positive,15,6,21
579790,True,0,No user reviews,0,0,0
579800,True,0,2 user reviews,0,2,2
579820,True,5,Mixed,87,78,165
579840,True,6,Mostly Positive,103,30,133
579860,True,0,No user reviews,0,0,0
579870,True,0,2 user reviews,0,2,2
579890,True,0,1 user reviews,1,0,1
579920,True,7,Positive,26,4,30
579930,True,4,Mostly Negative,4,10,14
579940,True,8,Very Positive,140,21,161
579950,True,8,Very Positive,619,112,731
579960,True,0,1 user reviews,0,1,1
579970,True,0,No user reviews,0,0,0
579980,True,7,Positive,26,3,29
580010,True,7,Positive,12,2,14
580020,True,4,Mostly Negative,58,141,199
580040,True,5,Mixed,226,131,357
580050,True,0,6 user reviews,2,4,6
580051,True,0,8 user reviews,7,1,8
580060,True,0,No user reviews,0,0,0
580070,True,0,No user reviews,0,0,0
580080,True,0,No user reviews,0,0,0
580081,True,0,8 user reviews,4,4,8
580090,True,0,No user reviews,0,0,0
580100,True,5,Mixed,417,217,634
580110,True,0,No user reviews,0,0,0
580120,True,0,1 user reviews,1,0,1
580160,True,0,2 user reviews,2,0,2
580170,True,8,Very Positive,190,41,231
580180,True,0,9 user reviews,9,0,9
580200,True,8,Very Positive,975,227,1202
580210,True,0,No user reviews,0,0,0
580240,True,0,No user reviews,0,0,0
580250,True,0,No user reviews,0,0,0
580280,True,0,No user reviews,0,0,0
580290,True,0,No user reviews,0,0,0
580300,True,7,Positive,12,1,13
580310,True,0,5 user reviews,5,0,5
580320,True,5,Mixed,6,5,11
580410,True,5,Mixed,6,6,12
580420,True,7,Positive,13,2,15
580430,True,0,No user reviews,0,0,0
580440,True,0,No user reviews,0,0,0
580450,True,0,No user reviews,0,0,0
580460,True,0,No user reviews,0,0,0
580470,True,0,No user reviews,0,0,0
580480,True,0,2 user reviews,2,0,2
580500,True,0,No user reviews,0,0,0
580510,True,0,1 user reviews,1,0,1
580520,True,5,Mixed,14,7,21
580530,True,0,1 user reviews,0,1,1
580540,True,0,1 user reviews,0,1,1
580550,True,0,No user reviews,0,0,0
580560,True,0,2 user reviews,1,1,2
580570,True,0,8 user reviews,5,3,8
580590,True,0,3 user reviews,3,0,3
580600,True,6,Mostly Positive,257,84,341
580610,True,0,No user reviews,0,0,0
580620,True,6,Mostly Positive,23,6,29
580630,True,0,4 user reviews,4,0,4
580640,True,0,No user reviews,0,0,0
580660,True,0,No user reviews,0,0,0
580661,True,0,No user reviews,0,0,0
580680,True,5,Mixed,6,5,11
580700,True,0,1 user reviews,1,0,1
580710,True,6,Mostly Positive,144,56,200
580720,True,8,Very Positive,361,58,419
580730,True,5,Mixed,34,15,49
580731,True,7,Positive,34,3,37
580740,True,0,No user reviews,0,0,0
580760,True,0,No user reviews,0,0,0
580780,True,0,1 user reviews,1,0,1
580790,True,0,No user reviews,0,0,0
580800,True,0,No user reviews,0,0,0
580810,True,0,No user reviews,0,0,0
580820,True,5,Mixed,20,9,29
580830,True,0,3 user reviews,3,0,3
580831,True,0,2 user reviews,2,0,2
580832,True,0,3 user reviews,3,0,3
580833,True,7,Positive,11,0,11
580840,True,0,No user reviews,0,0,0
580850,True,0,No user reviews,0,0,0
580851,True,0,No user reviews,0,0,0
580852,True,0,No user reviews,0,0,0
580853,True,0,No user reviews,0,0,0
580854,True,0,No user reviews,0,0,0
580855,True,0,No user reviews,0,0,0
580856,True,0,No user reviews,0,0,0
580857,True,0,No user reviews,0,0,0
580858,True,0,No user reviews,0,0,0
580859,True,0,No user reviews,0,0,0
580860,True,0,No user reviews,0,0,0
580861,True,0,No user reviews,0,0,0
580870,True,0,8 user reviews,6,2,8
580880,True,0,5 user reviews,2,3,5
580890,True,7,Positive,18,4,22
580900,True,0,No user reviews,0,0,0
580910,True,0,8 user reviews,2,6,8
580920,True,0,No user reviews,0,0,0
580930,True,0,9 user reviews,4,5,9
580940,True,7,Positive,8,2,10
580950,True,0,8 user reviews,1,7,8
581030,True,5,Mixed,24,27,51
581060,True,0,2 user reviews,2,0,2
581080,True,0,No user reviews,0,0,0
581100,True,0,4 user reviews,3,1,4
581120,True,0,No user reviews,0,0,0
581130,True,0,No user reviews,0,0,0
581150,True,0,No user reviews,0,0,0
581200,True,5,Mixed,12,9,21
581210,True,0,3 user reviews,2,1,3
581220,True,4,Mostly Negative,18,41,59
581230,True,5,Mixed,15,10,25
581270,True,8,Very Positive,412,55,467
581300,True,5,Mixed,35,45,80
581310,True,5,Mixed,7,10,17
581320,True,8,Very Positive,24273,4112,28385
581330,True,0,No user reviews,0,0,0
581340,True,0,7 user reviews,4,3,7
581360,True,8,Very Positive,89,6,95
581370,True,5,Mixed,43,26,69
581380,True,0,8 user reviews,5,3,8
581390,True,0,No user reviews,0,0,0
581400,True,0,5 user reviews,5,0,5
581410,True,0,No user reviews,0,0,0
581420,True,0,No user reviews,0,0,0
581450,True,8,Very Positive,724,83,807
581460,True,0,7 user reviews,6,1,7
581490,True,0,No user reviews,0,0,0
581500,True,0,No user reviews,0,0,0
581510,True,0,2 user reviews,2,0,2
581520,True,6,Mostly Positive,42,15,57
581530,True,0,No user reviews,0,0,0
581590,True,6,Mostly Positive,8,3,11
581600,True,0,8 user reviews,4,4,8
581630,True,8,Very Positive,2647,499,3146
581650,True,0,9 user reviews,7,2,9
581660,True,0,No user reviews,0,0,0
581670,True,0,3 user reviews,2,1,3
581710,True,5,Mixed,5,5,10
581730,True,5,Mixed,17,8,25
581740,True,0,3 user reviews,0,3,3
581750,True,0,No user reviews,0,0,0
581760,True,8,Very Positive,71,6,77
581770,True,0,No user reviews,0,0,0
581771,True,0,No user reviews,0,0,0
581772,True,0,No user reviews,0,0,0
581773,True,0,No user reviews,0,0,0
581800,True,7,Positive,10,2,12
581810,True,0,6 user reviews,2,4,6
581820,True,6,Mostly Positive,13,4,17
581830,True,0,No user reviews,0,0,0
581831,True,0,No user reviews,0,0,0
581840,True,0,8 user reviews,8,0,8
581880,True,0,No user reviews,0,0,0
581910,True,6,Mostly Positive,10,3,13
581920,True,0,6 user reviews,2,4,6
581930,True,0,2 user reviews,0,2,2
581940,True,0,No user reviews,0,0,0
581950,True,0,1 user reviews,1,0,1
581951,True,0,No user reviews,0,0,0
581960,True,0,5 user reviews,4,1,5
581970,True,6,Mostly Positive,24,10,34
581980,True,4,Mostly Negative,5,16,21
581990,True,0,1 user reviews,1,0,1
582000,True,0,No user reviews,0,0,0
582010,True,8,Very Positive,52814,6194,59008
582030,True,0,1 user reviews,1,0,1
582040,True,7,Positive,16,1,17
582050,True,5,Mixed,7,6,13
582090,True,0,No user reviews,0,0,0
582100,True,0,No user reviews,0,0,0
582110,True,0,No user reviews,0,0,0
582120,True,0,No user reviews,0,0,0
582130,True,0,No user reviews,0,0,0
582140,True,0,No user reviews,0,0,0
582150,True,0,7 user reviews,4,3,7
582160,True,8,Very Positive,12860,2662,15522
582170,True,0,4 user reviews,3,1,4
582171,True,0,2 user reviews,2,0,2
582172,True,0,2 user reviews,2,0,2
582180,True,0,No user reviews,0,0,0
582200,True,0,4 user reviews,3,1,4
582210,True,7,Positive,17,2,19
582220,True,0,4 user reviews,2,2,4
582230,True,0,1 user reviews,1,0,1
582240,True,0,No user reviews,0,0,0
582260,True,5,Mixed,21,17,38
582270,True,8,Very Positive,1410,268,1678
582280,True,0,9 user reviews,7,2,9
582290,True,0,5 user reviews,1,4,5
582320,True,0,No user reviews,0,0,0
582330,True,8,Very Positive,128,15,143
582350,True,0,4 user reviews,4,0,4
582360,True,0,2 user reviews,2,0,2
582370,True,0,9 user reviews,8,1,9
582380,True,6,Mostly Positive,198,55,253
582390,True,0,3 user reviews,2,1,3
582400,True,0,No user reviews,0,0,0
582420,True,0,No user reviews,0,0,0
582440,True,0,1 user reviews,0,1,1
582450,True,0,No user reviews,0,0,0
582460,True,0,No user reviews,0,0,0
582490,True,0,No user reviews,0,0,0
582500,True,8,Very Positive,806,82,888
582510,True,0,4 user reviews,3,1,4
582520,True,0,No user reviews,0,0,0
582530,True,0,7 user reviews,7,0,7
582540,True,7,Positive,12,1,13
582550,True,8,Very Positive,1189,260,1449
582560,True,8,Very Positive,173,9,182
582570,True,7,Positive,10,2,12
582571,True,7,Positive,13,1,14
582572,True,0,6 user reviews,6,0,6
582573,True,7,Positive,9,2,11
582574,True,0,8 user reviews,5,3,8
582575,True,0,4 user reviews,2,2,4
582576,True,0,1 user reviews,1,0,1
582577,True,4,Mostly Negative,7,17,24
582578,True,0,4 user reviews,3,1,4
582600,True,8,Very Positive,387,53,440
582610,True,0,7 user reviews,3,4,7
582620,True,6,Mostly Positive,39,10,49
582640,True,0,No user reviews,0,0,0
582650,True,0,No user reviews,0,0,0
582660,True,6,Mostly Positive,13341,5203,18544
582670,True,0,No user reviews,0,0,0
582671,True,0,No user reviews,0,0,0
582672,True,0,No user reviews,0,0,0
582673,True,0,No user reviews,0,0,0
582674,True,0,No user reviews,0,0,0
582675,True,0,No user reviews,0,0,0
582676,True,0,No user reviews,0,0,0
582677,True,0,No user reviews,0,0,0
582678,True,0,No user reviews,0,0,0
582679,True,0,No user reviews,0,0,0
582680,True,0,No user reviews,0,0,0
582681,True,0,No user reviews,0,0,0
582700,True,0,No user reviews,0,0,0
582710,True,0,No user reviews,0,0,0
582720,True,0,No user reviews,0,0,0
582740,True,0,1 user reviews,1,0,1
582750,True,0,1 user reviews,0,1,1
582760,True,0,No user reviews,0,0,0
582770,True,0,No user reviews,0,0,0
582780,True,0,No user reviews,0,0,0
582790,True,0,No user reviews,0,0,0
582800,True,0,2 user reviews,2,0,2
582810,True,5,Mixed,44,30,74
582820,True,0,5 user reviews,4,1,5
582830,True,0,No user reviews,0,0,0
582840,True,0,6 user reviews,3,3,6
582860,True,0,No user reviews,0,0,0
582880,True,7,Positive,17,4,21
582890,True,6,Mostly Positive,15,5,20
582900,True,0,No user reviews,0,0,0
582901,True,0,No user reviews,0,0,0
582902,True,0,No user reviews,0,0,0
582903,True,0,No user reviews,0,0,0
582904,True,0,No user reviews,0,0,0
582905,True,0,No user reviews,0,0,0
582906,True,0,No user reviews,0,0,0
582907,True,0,No user reviews,0,0,0
582908,True,0,No user reviews,0,0,0
582909,True,0,No user reviews,0,0,0
582910,True,0,No user reviews,0,0,0
582911,True,0,No user reviews,0,0,0
582912,True,0,No user reviews,0,0,0
582913,True,0,No user reviews,0,0,0
582914,True,0,No user reviews,0,0,0
582915,True,0,No user reviews,0,0,0
582916,True,0,No user reviews,0,0,0
582917,True,0,No user reviews,0,0,0
582920,True,0,5 user reviews,2,3,5
582930,True,0,No user reviews,0,0,0
582960,True,0,6 user reviews,5,1,6
582980,True,7,Positive,12,1,13
582990,True,5,Mixed,12,6,18
583000,True,0,No user reviews,0,0,0
583010,True,8,Very Positive,312,12,324
583020,True,0,No user reviews,0,0,0
583030,True,0,3 user reviews,2,1,3
583040,True,6,Mostly Positive,41,17,58
583050,True,0,No user reviews,0,0,0
583060,True,5,Mixed,5,6,11
583070,True,0,1 user reviews,1,0,1
583090,True,7,Positive,35,4,39
583140,True,7,Positive,21,0,21
583150,True,6,Mostly Positive,14,5,19
583190,True,7,Positive,16,1,17
583200,True,0,6 user reviews,5,1,6
583220,True,0,No user reviews,0,0,0
583230,True,0,No user reviews,0,0,0
583240,True,0,8 user reviews,8,0,8
583260,True,0,No user reviews,0,0,0
583270,True,8,Very Positive,133,9,142
583360,True,0,1 user reviews,1,0,1
583370,True,0,No user reviews,0,0,0
583371,True,0,No user reviews,0,0,0
583372,True,0,No user reviews,0,0,0
583373,True,0,No user reviews,0,0,0
583374,True,0,No user reviews,0,0,0
583375,True,0,No user reviews,0,0,0
583376,True,0,No user reviews,0,0,0
583377,True,0,No user reviews,0,0,0
583378,True,0,No user reviews,0,0,0
583379,True,0,No user reviews,0,0,0
583380,True,0,No user reviews,0,0,0
583381,True,0,No user reviews,0,0,0
583390,True,0,No user reviews,0,0,0
583391,True,0,No user reviews,0,0,0
583392,True,0,No user reviews,0,0,0
583393,True,0,No user reviews,0,0,0
583394,True,0,No user reviews,0,0,0
583395,True,0,No user reviews,0,0,0
583396,True,0,No user reviews,0,0,0
583397,True,0,No user reviews,0,0,0
583398,True,0,No user reviews,0,0,0
583399,True,0,No user reviews,0,0,0
583400,True,0,No user reviews,0,0,0
583401,True,0,No user reviews,0,0,0
583410,True,0,No user reviews,0,0,0
583411,True,0,No user reviews,0,0,0
583412,True,0,No user reviews,0,0,0
583413,True,0,No user reviews,0,0,0
583414,True,0,No user reviews,0,0,0
583415,True,0,No user reviews,0,0,0
583416,True,0,No user reviews,0,0,0
583417,True,0,No user reviews,0,0,0
583418,True,0,No user reviews,0,0,0
583419,True,0,No user reviews,0,0,0
583420,True,0,No user reviews,0,0,0
583421,True,0,No user reviews,0,0,0
583430,True,0,No user reviews,0,0,0
583431,True,0,No user reviews,0,0,0
583434,True,0,No user reviews,0,0,0
583435,True,0,No user reviews,0,0,0
583436,True,0,No user reviews,0,0,0
583437,True,0,No user reviews,0,0,0
583438,True,0,No user reviews,0,0,0
583439,True,0,No user reviews,0,0,0
583440,True,0,No user reviews,0,0,0
583441,True,0,No user reviews,0,0,0
583442,True,0,No user reviews,0,0,0
583443,True,0,No user reviews,0,0,0
583444,True,0,No user reviews,0,0,0
583445,True,0,No user reviews,0,0,0
583446,True,0,No user reviews,0,0,0
583460,True,0,No user reviews,0,0,0
583470,True,8,Very Positive,1034,99,1133
583490,True,5,Mixed,15,8,23
583500,True,0,9 user reviews,7,2,9
583510,True,0,2 user reviews,1,1,2
583520,True,0,No user reviews,0,0,0
583530,True,7,Positive,10,1,11
583570,True,0,1 user reviews,0,1,1
583580,True,0,1 user reviews,0,1,1
583590,True,5,Mixed,22,18,40
583620,True,5,Mixed,17,8,25
583630,True,0,1 user reviews,1,0,1
583631,True,0,No user reviews,0,0,0
583632,True,0,No user reviews,0,0,0
583633,True,0,No user reviews,0,0,0
583634,True,0,No user reviews,0,0,0
583635,True,0,No user reviews,0,0,0
583640,True,7,Positive,38,0,38
583670,True,0,No user reviews,0,0,0
583680,True,0,8 user reviews,7,1,8
583681,True,0,1 user reviews,1,0,1
583690,True,0,3 user reviews,0,3,3
583691,True,0,1 user reviews,1,0,1
583700,True,0,No user reviews,0,0,0
583710,True,0,2 user reviews,2,0,2
583720,True,0,No user reviews,0,0,0
583730,True,6,Mostly Positive,8,3,11
583740,True,0,No user reviews,0,0,0
583760,True,8,Very Positive,230,22,252
583800,True,0,No user reviews,0,0,0
583810,True,7,Positive,15,0,15
583820,True,0,3 user reviews,2,1,3
583821,True,0,1 user reviews,1,0,1
583822,True,0,No user reviews,0,0,0
583823,True,0,No user reviews,0,0,0
583824,True,0,No user reviews,0,0,0
583825,True,0,No user reviews,0,0,0
583826,True,0,No user reviews,0,0,0
583827,True,0,No user reviews,0,0,0
583828,True,0,No user reviews,0,0,0
583829,True,0,No user reviews,0,0,0
583830,True,0,No user reviews,0,0,0
583831,True,0,No user reviews,0,0,0
583832,True,0,No user reviews,0,0,0
583833,True,0,No user reviews,0,0,0
583834,True,0,No user reviews,0,0,0
583835,True,0,No user reviews,0,0,0
583836,True,0,No user reviews,0,0,0
583837,True,0,No user reviews,0,0,0
583838,True,0,No user reviews,0,0,0
583839,True,0,No user reviews,0,0,0
583840,True,0,No user reviews,0,0,0
583841,True,0,No user reviews,0,0,0
583842,True,0,No user reviews,0,0,0
583843,True,0,No user reviews,0,0,0
583844,True,0,No user reviews,0,0,0
583845,True,0,No user reviews,0,0,0
583850,True,5,Mixed,10,5,15
583860,True,0,6 user reviews,5,1,6
583870,True,0,2 user reviews,1,1,2
583890,True,5,Mixed,7,4,11
583930,True,8,Very Positive,131,22,153
583940,True,0,No user reviews,0,0,0
583950,True,5,Mixed,4815,3408,8223
583990,True,0,No user reviews,0,0,0
583991,True,0,No user reviews,0,0,0
583992,True,0,No user reviews,0,0,0
583993,True,0,No user reviews,0,0,0
583994,True,0,No user reviews,0,0,0
584000,True,0,1 user reviews,1,0,1
584001,True,0,No user reviews,0,0,0
584002,True,0,No user reviews,0,0,0
584003,True,0,No user reviews,0,0,0
584004,True,0,No user reviews,0,0,0
584005,True,0,No user reviews,0,0,0
584006,True,0,No user reviews,0,0,0
584007,True,0,No user reviews,0,0,0
584008,True,0,No user reviews,0,0,0
584009,True,0,No user reviews,0,0,0
584010,True,0,No user reviews,0,0,0
584011,True,0,No user reviews,0,0,0
584012,True,0,No user reviews,0,0,0
584013,True,0,No user reviews,0,0,0
584014,True,0,No user reviews,0,0,0
584015,True,0,No user reviews,0,0,0
584016,True,0,No user reviews,0,0,0
584017,True,0,No user reviews,0,0,0
584018,True,0,No user reviews,0,0,0
584019,True,0,No user reviews,0,0,0
584020,True,0,No user reviews,0,0,0
584021,True,0,No user reviews,0,0,0
584022,True,0,No user reviews,0,0,0
584023,True,0,No user reviews,0,0,0
584024,True,0,No user reviews,0,0,0
584025,True,0,No user reviews,0,0,0
584030,True,0,No user reviews,0,0,0
584040,True,0,No user reviews,0,0,0
584050,True,0,1 user reviews,1,0,1
584060,True,0,No user reviews,0,0,0
584070,True,0,No user reviews,0,0,0
584080,True,0,No user reviews,0,0,0
584095,True,5,Mixed,68,40,108
584096,True,6,Mostly Positive,55,21,76
584097,True,8,Very Positive,58,12,70
584100,True,4,Mostly Negative,5,9,14
584120,True,0,No user reviews,0,0,0
584140,True,5,Mixed,289,307,596
584141,True,8,Very Positive,76,5,81
584150,True,5,Mixed,14,8,22
584170,True,0,No user reviews,0,0,0
584180,True,0,1 user reviews,1,0,1
584190,True,0,No user reviews,0,0,0
584191,True,0,1 user reviews,1,0,1
584192,True,0,No user reviews,0,0,0
584200,True,6,Mostly Positive,7,3,10
584210,True,5,Mixed,992,1122,2114
584220,True,0,4 user reviews,4,0,4
584240,True,7,Positive,10,0,10
584250,True,0,No user reviews,0,0,0
584260,True,0,2 user reviews,2,0,2
584270,True,0,No user reviews,0,0,0
584280,True,3,Negative,6,36,42
584310,True,0,No user reviews,0,0,0
584320,True,0,3 user reviews,3,0,3
584330,True,0,No user reviews,0,0,0
584331,True,0,No user reviews,0,0,0
584340,True,0,No user reviews,0,0,0
584341,True,0,No user reviews,0,0,0
584350,True,0,No user reviews,0,0,0
584351,True,0,No user reviews,0,0,0
584352,True,0,No user reviews,0,0,0
584360,True,0,No user reviews,0,0,0
584370,True,5,Mixed,41,20,61
584380,True,0,6 user reviews,6,0,6
584381,True,0,5 user reviews,5,0,5
584382,True,0,2 user reviews,2,0,2
584383,True,0,8 user reviews,8,0,8
584390,True,0,No user reviews,0,0,0
584400,True,8,Very Positive,6548,651,7199
584430,True,0,No user reviews,0,0,0
584431,True,0,No user reviews,0,0,0
584432,True,0,No user reviews,0,0,0
584433,True,0,No user reviews,0,0,0
584434,True,0,No user reviews,0,0,0
584435,True,0,No user reviews,0,0,0
584440,True,0,No user reviews,0,0,0
584441,True,0,No user reviews,0,0,0
584442,True,0,No user reviews,0,0,0
584443,True,0,No user reviews,0,0,0
584444,True,0,No user reviews,0,0,0
584445,True,0,No user reviews,0,0,0
584446,True,0,No user reviews,0,0,0
584447,True,0,No user reviews,0,0,0
584448,True,0,No user reviews,0,0,0
584449,True,0,No user reviews,0,0,0
584450,True,0,No user reviews,0,0,0
584451,True,0,No user reviews,0,0,0
584452,True,0,No user reviews,0,0,0
584460,True,0,No user reviews,0,0,0
584461,True,0,No user reviews,0,0,0
584462,True,0,No user reviews,0,0,0
584463,True,0,No user reviews,0,0,0
584464,True,0,No user reviews,0,0,0
584465,True,0,No user reviews,0,0,0
584466,True,0,No user reviews,0,0,0
584467,True,0,No user reviews,0,0,0
584468,True,0,No user reviews,0,0,0
584469,True,0,No user reviews,0,0,0
584470,True,0,No user reviews,0,0,0
584471,True,0,No user reviews,0,0,0
584472,True,0,No user reviews,0,0,0
584473,True,0,No user reviews,0,0,0
584474,True,0,No user reviews,0,0,0
584475,True,0,No user reviews,0,0,0
584480,True,0,No user reviews,0,0,0
584481,True,0,No user reviews,0,0,0
584482,True,0,No user reviews,0,0,0
584483,True,0,No user reviews,0,0,0
584484,True,0,No user reviews,0,0,0
584485,True,0,No user reviews,0,0,0
584486,True,0,No user reviews,0,0,0
584487,True,0,No user reviews,0,0,0
584488,True,0,No user reviews,0,0,0
584489,True,0,No user reviews,0,0,0
584490,True,0,No user reviews,0,0,0
584491,True,0,No user reviews,0,0,0
584492,True,0,No user reviews,0,0,0
584493,True,0,No user reviews,0,0,0
584494,True,0,No user reviews,0,0,0
584495,True,0,No user reviews,0,0,0
584500,True,0,No user reviews,0,0,0
584501,True,0,No user reviews,0,0,0
584502,True,0,No user reviews,0,0,0
584503,True,0,No user reviews,0,0,0
584504,True,0,No user reviews,0,0,0
584505,True,0,No user reviews,0,0,0
584506,True,0,No user reviews,0,0,0
584507,True,0,1 user reviews,1,0,1
584508,True,0,No user reviews,0,0,0
584509,True,0,No user reviews,0,0,0
584510,True,0,No user reviews,0,0,0
584511,True,0,No user reviews,0,0,0
584512,True,0,No user reviews,0,0,0
584513,True,0,No user reviews,0,0,0
584514,True,0,No user reviews,0,0,0
584515,True,0,No user reviews,0,0,0
584520,True,0,No user reviews,0,0,0
584521,True,0,No user reviews,0,0,0
584522,True,0,No user reviews,0,0,0
584523,True,0,No user reviews,0,0,0
584524,True,0,No user reviews,0,0,0
584525,True,0,No user reviews,0,0,0
584526,True,0,No user reviews,0,0,0
584527,True,0,No user reviews,0,0,0
584528,True,0,No user reviews,0,0,0
584529,True,0,No user reviews,0,0,0
584530,True,0,No user reviews,0,0,0
584531,True,0,No user reviews,0,0,0
584532,True,0,No user reviews,0,0,0
584533,True,0,No user reviews,0,0,0
584534,True,0,No user reviews,0,0,0
584535,True,0,No user reviews,0,0,0
584540,True,0,No user reviews,0,0,0
584541,True,0,No user reviews,0,0,0
584542,True,0,No user reviews,0,0,0
584543,True,0,No user reviews,0,0,0
584544,True,0,No user reviews,0,0,0
584545,True,0,No user reviews,0,0,0
584546,True,0,No user reviews,0,0,0
584547,True,0,No user reviews,0,0,0
584548,True,0,No user reviews,0,0,0
584549,True,0,No user reviews,0,0,0
584550,True,0,No user reviews,0,0,0
584551,True,0,No user reviews,0,0,0
584552,True,0,No user reviews,0,0,0
584553,True,0,No user reviews,0,0,0
584554,True,0,No user reviews,0,0,0
584555,True,0,No user reviews,0,0,0
584570,True,0,1 user reviews,0,1,1
584571,True,0,No user reviews,0,0,0
584572,True,0,No user reviews,0,0,0
584573,True,0,No user reviews,0,0,0
584574,True,0,No user reviews,0,0,0
584575,True,0,No user reviews,0,0,0
584576,True,0,No user reviews,0,0,0
584577,True,0,No user reviews,0,0,0
584578,True,0,No user reviews,0,0,0
584579,True,0,No user reviews,0,0,0
584580,True,0,No user reviews,0,0,0
584581,True,0,No user reviews,0,0,0
584582,True,0,No user reviews,0,0,0
584583,True,0,No user reviews,0,0,0
584584,True,0,No user reviews,0,0,0
584585,True,0,No user reviews,0,0,0
584586,True,0,No user reviews,0,0,0
584587,True,0,No user reviews,0,0,0
584588,True,0,No user reviews,0,0,0
584589,True,0,No user reviews,0,0,0
584590,True,0,1 user reviews,1,0,1
584600,True,0,6 user reviews,4,2,6
584610,True,0,No user reviews,0,0,0
584620,True,0,No user reviews,0,0,0
584630,True,0,1 user reviews,1,0,1
584690,True,0,No user reviews,0,0,0
584700,True,0,No user reviews,0,0,0
584760,True,0,2 user reviews,1,1,2
584770,True,0,4 user reviews,4,0,4
584780,True,3,Negative,1,14,15
584790,True,0,No user reviews,0,0,0
584800,True,6,Mostly Positive,27,9,36
584820,True,0,2 user reviews,0,2,2
584850,True,0,7 user reviews,6,1,7
584860,True,0,2 user reviews,2,0,2
584870,True,0,No user reviews,0,0,0
584880,True,7,Positive,12,0,12
584890,True,5,Mixed,33,20,53
584930,True,8,Very Positive,158,6,164
584940,True,5,Mixed,19,9,28
584950,True,0,No user reviews,0,0,0
584970,True,7,Positive,17,2,19
584980,True,8,Very Positive,934,146,1080
584990,True,8,Very Positive,88,20,108
585000,True,0,No user reviews,0,0,0
585020,True,0,No user reviews,0,0,0
585030,True,0,No user reviews,0,0,0
585040,True,5,Mixed,18,8,26
585060,True,0,No user reviews,0,0,0
585070,True,0,No user reviews,0,0,0
585080,True,5,Mixed,25,30,55
585090,True,4,Mostly Negative,5,8,13
585110,True,0,No user reviews,0,0,0
585120,True,0,No user reviews,0,0,0
585130,True,0,No user reviews,0,0,0
585160,True,0,No user reviews,0,0,0
585170,True,0,No user reviews,0,0,0
585180,True,8,Very Positive,216,2,218
585190,True,8,Very Positive,51,9,60
585210,True,0,No user reviews,0,0,0
585220,True,5,Mixed,6,4,10
585230,True,0,No user reviews,0,0,0
585240,True,7,Positive,21,2,23
585260,True,7,Positive,24,1,25
585270,True,0,No user reviews,0,0,0
585280,True,0,No user reviews,0,0,0
585281,True,0,No user reviews,0,0,0
585282,True,0,No user reviews,0,0,0
585283,True,0,No user reviews,0,0,0
585290,True,5,Mixed,20,14,34
585300,True,0,2 user reviews,2,0,2
585310,True,0,2 user reviews,1,1,2
585320,True,0,No user reviews,0,0,0
585340,True,0,1 user reviews,1,0,1
585360,True,4,Mostly Negative,5,8,13
585380,True,0,No user reviews,0,0,0
585400,True,0,No user reviews,0,0,0
585410,True,8,Very Positive,366,59,425
585420,True,8,Very Positive,2327,234,2561
585430,True,0,9 user reviews,5,4,9
585440,True,0,1 user reviews,1,0,1
585450,True,8,Very Positive,443,96,539
585460,True,0,No user reviews,0,0,0
585472,True,0,No user reviews,0,0,0
585480,True,0,7 user reviews,6,1,7
585481,True,0,4 user reviews,2,2,4
585482,True,0,7 user reviews,6,1,7
585500,True,7,Positive,15,1,16
585530,True,0,No user reviews,0,0,0
585540,True,0,1 user reviews,1,0,1
585550,True,8,Very Positive,549,110,659
585560,True,0,2 user reviews,1,1,2
585590,True,0,No user reviews,0,0,0
585600,True,0,4 user reviews,3,1,4
585610,True,0,2 user reviews,1,1,2
585620,True,5,Mixed,15,7,22
585640,True,0,No user reviews,0,0,0
585650,True,0,No user reviews,0,0,0
585690,True,5,Mixed,153,108,261
585700,True,0,No user reviews,0,0,0
585710,True,8,Very Positive,228,46,274
585730,True,0,No user reviews,0,0,0
585740,True,0,5 user reviews,1,4,5
585750,True,0,2 user reviews,1,1,2
585770,True,0,4 user reviews,3,1,4
585800,True,0,No user reviews,0,0,0
585820,True,0,7 user reviews,2,5,7
585830,True,5,Mixed,32,30,62
585840,True,8,Very Positive,275,66,341
585860,True,3,Negative,0,15,15
585870,True,0,No user reviews,0,0,0
585880,True,7,Positive,15,0,15
585890,True,8,Very Positive,258,16,274
585900,True,6,Mostly Positive,429,137,566
585910,True,8,Very Positive,93,17,110
585920,True,0,7 user reviews,6,1,7
585930,True,0,No user reviews,0,0,0
585940,True,0,2 user reviews,2,0,2
585950,True,8,Very Positive,48,5,53
585970,True,0,1 user reviews,1,0,1
585980,True,0,No user reviews,0,0,0
585990,True,0,7 user reviews,6,1,7
586010,True,0,4 user reviews,3,1,4
586020,True,7,Positive,22,3,25
586030,True,0,2 user reviews,1,1,2
586060,True,5,Mixed,12,6,18
586070,True,0,1 user reviews,1,0,1
586080,True,4,Mostly Negative,6,11,17
586100,True,0,5 user reviews,0,5,5
586110,True,0,No user reviews,0,0,0
586130,True,0,8 user reviews,3,5,8
586140,True,8,Very Positive,1131,77,1208
586150,True,0,8 user reviews,2,6,8
586160,True,0,No user reviews,0,0,0
586170,True,0,4 user reviews,3,1,4
586200,True,5,Mixed,336,166,502
586210,True,5,Mixed,259,113,372
586220,True,0,No user reviews,0,0,0
586230,True,0,9 user reviews,9,0,9
586240,True,8,Very Positive,65,10,75
586300,True,0,No user reviews,0,0,0
586310,True,8,Very Positive,44,11,55
586320,True,7,Positive,14,0,14
586340,True,0,6 user reviews,5,1,6
586350,True,8,Very Positive,84,6,90
586360,True,5,Mixed,13,8,21
586370,True,0,No user reviews,0,0,0
586380,True,0,6 user reviews,3,3,6
586390,True,7,Positive,33,1,34
586410,True,0,2 user reviews,2,0,2
586420,True,0,5 user reviews,5,0,5
586430,True,0,3 user reviews,2,1,3
586450,True,0,9 user reviews,9,0,9
586460,True,0,8 user reviews,4,4,8
586490,True,0,1 user reviews,1,0,1
586500,True,0,No user reviews,0,0,0
586510,True,0,No user reviews,0,0,0
586560,True,0,2 user reviews,2,0,2
586570,True,0,3 user reviews,2,1,3
586600,True,0,8 user reviews,1,7,8
586620,True,0,9 user reviews,3,6,9
586660,True,7,Positive,19,1,20
586670,True,0,8 user reviews,7,1,8
586680,True,0,6 user reviews,1,5,6
586690,True,0,3 user reviews,3,0,3
586700,True,0,2 user reviews,1,1,2
586710,True,0,5 user reviews,3,2,5
586720,True,0,1 user reviews,1,0,1
586730,True,0,No user reviews,0,0,0
586731,True,0,No user reviews,0,0,0
586732,True,0,No user reviews,0,0,0
586740,True,0,2 user reviews,2,0,2
586750,True,5,Mixed,136,82,218
586760,True,0,No user reviews,0,0,0
586770,True,7,Positive,9,2,11
586780,True,0,No user reviews,0,0,0
586790,True,0,9 user reviews,1,8,9
586830,True,6,Mostly Positive,10,4,14
586870,True,0,No user reviews,0,0,0
586880,True,8,Very Positive,123,7,130
586890,True,0,1 user reviews,0,1,1
586900,True,0,No user reviews,0,0,0
586910,True,5,Mixed,9,7,16
586920,True,6,Mostly Positive,7,3,10
586930,True,0,5 user reviews,2,3,5
586940,True,0,1 user reviews,0,1,1
586950,True,6,Mostly Positive,170,51,221
586960,True,8,Very Positive,99,24,123
586970,True,5,Mixed,34,18,52
586980,True,5,Mixed,7,10,17
586990,True,0,5 user reviews,5,0,5
587000,True,8,Very Positive,220,48,268
587010,True,0,2 user reviews,0,2,2
587020,True,0,No user reviews,0,0,0
587030,True,0,No user reviews,0,0,0
587060,True,0,No user reviews,0,0,0
587070,True,0,6 user reviews,4,2,6
587080,True,0,No user reviews,0,0,0
587100,True,8,Very Positive,170,16,186
587110,True,8,Very Positive,178,12,190
587120,True,0,No user reviews,0,0,0
587150,True,0,No user reviews,0,0,0
587160,True,0,No user reviews,0,0,0
587170,True,0,1 user reviews,1,0,1
587180,True,7,Positive,30,7,37
587200,True,0,2 user reviews,2,0,2
587210,True,0,9 user reviews,5,4,9
587220,True,9,Overwhelmingly Positive,896,37,933
587230,True,0,No user reviews,0,0,0
587260,True,8,Very Positive,418,48,466
587270,True,0,No user reviews,0,0,0
587290,True,7,Positive,9,1,10
587310,True,7,Positive,21,0,21
587330,True,0,4 user reviews,1,3,4
587340,True,0,No user reviews,0,0,0
587390,True,0,2 user reviews,1,1,2
587400,True,6,Mostly Positive,12,4,16
587410,True,0,5 user reviews,3,2,5
587411,True,0,No user reviews,0,0,0
587412,True,0,No user reviews,0,0,0
587413,True,0,No user reviews,0,0,0
587414,True,0,1 user reviews,1,0,1
587420,True,5,Mixed,83,40,123
587430,True,8,Very Positive,901,50,951
587440,True,7,Positive,11,2,13
587450,True,5,Mixed,422,282,704
587460,True,0,No user reviews,0,0,0
587470,True,8,Very Positive,195,7,202
587480,True,0,No user reviews,0,0,0
587490,True,5,Mixed,8,6,14
587500,True,0,3 user reviews,2,1,3
587510,True,0,No user reviews,0,0,0
587540,True,0,No user reviews,0,0,0
587550,True,0,No user reviews,0,0,0
587560,True,0,7 user reviews,6,1,7
587570,True,0,No user reviews,0,0,0
587580,True,8,Very Positive,148,21,169
587600,True,0,No user reviews,0,0,0
587610,True,0,No user reviews,0,0,0
587620,True,8,Very Positive,2166,145,2311
587640,True,0,No user reviews,0,0,0
587650,True,0,No user reviews,0,0,0
587660,True,0,1 user reviews,1,0,1
587670,True,0,No user reviews,0,0,0
587690,True,0,4 user reviews,2,2,4
587700,True,0,No user reviews,0,0,0
587710,True,0,1 user reviews,1,0,1
587730,True,0,7 user reviews,6,1,7
587740,True,0,No user reviews,0,0,0
587780,True,0,1 user reviews,1,0,1
587790,True,0,2 user reviews,0,2,2
587800,True,0,No user reviews,0,0,0
587810,True,4,Mostly Negative,9,21,30
587820,True,0,1 user reviews,1,0,1
587840,True,6,Mostly Positive,12,4,16
587860,True,8,Very Positive,43,7,50
587880,True,0,No user reviews,0,0,0
587881,True,0,No user reviews,0,0,0
587882,True,0,No user reviews,0,0,0
587890,True,0,No user reviews,0,0,0
587891,True,0,No user reviews,0,0,0
587910,True,0,No user reviews,0,0,0
587920,True,6,Mostly Positive,20,8,28
587930,True,6,Mostly Positive,19,6,25
587970,True,0,8 user reviews,6,2,8
587980,True,0,No user reviews,0,0,0
587990,True,0,No user reviews,0,0,0
588010,True,0,5 user reviews,5,0,5
588030,True,8,Very Positive,859,63,922
588040,True,8,Very Positive,161,25,186
588050,True,0,2 user reviews,1,1,2
588070,True,0,7 user reviews,2,5,7
588080,True,0,4 user reviews,2,2,4
588110,True,6,Mostly Positive,85,22,107
588120,True,6,Mostly Positive,19,8,27
588130,True,0,No user reviews,0,0,0
588140,True,0,1 user reviews,0,1,1
588150,True,0,1 user reviews,1,0,1
588160,True,5,Mixed,51,58,109
588180,True,7,Positive,17,0,17
588190,True,5,Mixed,258,133,391
588200,True,0,4 user reviews,4,0,4
588220,True,0,No user reviews,0,0,0
588230,True,6,Mostly Positive,31,8,39
588240,True,8,Very Positive,81,16,97
588260,True,0,2 user reviews,2,0,2
588261,True,0,No user reviews,0,0,0
588262,True,0,No user reviews,0,0,0
588263,True,0,1 user reviews,1,0,1
588270,True,0,8 user reviews,3,5,8
588280,True,0,1 user reviews,1,0,1
588290,True,7,Positive,28,1,29
588300,True,0,5 user reviews,4,1,5
588301,True,0,No user reviews,0,0,0
588310,True,7,Positive,25,2,27
588340,True,5,Mixed,16,13,29
588350,True,0,2 user reviews,1,1,2
588390,True,0,No user reviews,0,0,0
588410,True,5,Mixed,19,11,30
588430,True,0,No user reviews,0,0,0
588440,True,5,Mixed,21,10,31
588480,True,0,No user reviews,0,0,0
588490,True,7,Positive,9,1,10
588510,True,0,No user reviews,0,0,0
588530,True,0,1 user reviews,1,0,1
588540,True,7,Positive,9,1,10
588550,True,0,3 user reviews,1,2,3
588560,True,5,Mixed,21,16,37
588570,True,0,3 user reviews,1,2,3
588580,True,0,No user reviews,0,0,0
588600,True,7,Positive,14,0,14
588620,True,7,Positive,13,1,14
588630,True,6,Mostly Positive,11,4,15
588650,True,9,Overwhelmingly Positive,17023,674,17697
588660,True,8,Very Positive,120,2,122
588670,True,0,No user reviews,0,0,0
588690,True,8,Very Positive,192,23,215
588710,True,5,Mixed,8,7,15
588720,True,0,1 user reviews,0,1,1
588730,True,8,Very Positive,189,11,200
588740,True,0,No user reviews,0,0,0
588750,True,5,Mixed,5,6,11
588780,True,0,No user reviews,0,0,0
588790,True,0,1 user reviews,1,0,1
588800,True,0,6 user reviews,3,3,6
588810,True,0,No user reviews,0,0,0
588830,True,0,2 user reviews,2,0,2
588840,True,0,1 user reviews,1,0,1
588870,True,0,No user reviews,0,0,0
588880,True,0,5 user reviews,4,1,5
588890,True,5,Mixed,7,4,11
588920,True,5,Mixed,13,12,25
588930,True,0,No user reviews,0,0,0
588950,True,8,Very Positive,615,72,687
588960,True,0,9 user reviews,9,0,9
588961,True,0,1 user reviews,1,0,1
588962,True,0,5 user reviews,4,1,5
588963,True,7,Positive,21,2,23
588964,True,0,1 user reviews,1,0,1
588970,True,8,Very Positive,192,25,217
588980,True,0,5 user reviews,4,1,5
588990,True,6,Mostly Positive,9,3,12
589010,True,0,No user reviews,0,0,0
589021,True,0,2 user reviews,2,0,2
589040,True,7,Positive,42,4,46
589060,True,7,Positive,13,1,14
589080,True,0,3 user reviews,2,1,3
589090,True,0,No user reviews,0,0,0
589100,True,7,Positive,11,2,13
589110,True,5,Mixed,7,7,14
589120,True,0,No user reviews,0,0,0
589130,True,0,No user reviews,0,0,0
589140,True,0,1 user reviews,1,0,1
589141,True,0,1 user reviews,1,0,1
589142,True,0,1 user reviews,1,0,1
589150,True,0,9 user reviews,5,4,9
589160,True,0,5 user reviews,3,2,5
589170,True,0,4 user reviews,2,2,4
589190,True,7,Positive,9,1,10
589200,True,8,Very Positive,173,8,181
589220,True,0,9 user reviews,8,1,9
589230,True,0,No user reviews,0,0,0
589250,True,5,Mixed,26,12,38
589260,True,0,4 user reviews,1,3,4
589270,True,0,4 user reviews,4,0,4
589280,True,7,Positive,25,0,25
589290,True,8,Very Positive,5885,732,6617
589300,True,0,8 user reviews,3,5,8
589310,True,0,No user reviews,0,0,0
589320,True,6,Mostly Positive,31,13,44
589330,True,0,No user reviews,0,0,0
589360,True,8,Very Positive,2251,446,2697
589380,True,0,6 user reviews,4,2,6
589410,True,0,6 user reviews,4,2,6
589420,True,8,Very Positive,56,8,64
589430,True,0,6 user reviews,1,5,6
589450,True,0,No user reviews,0,0,0
589460,True,0,No user reviews,0,0,0
589470,True,7,Positive,13,3,16
589480,True,7,Positive,28,3,31
589500,True,8,Very Positive,94,6,100
589510,True,8,Very Positive,134,12,146
589530,True,8,Very Positive,263,37,300
589590,True,8,Very Positive,2417,129,2546
589600,True,0,No user reviews,0,0,0
589610,True,0,No user reviews,0,0,0
589620,True,6,Mostly Positive,11,4,15
589640,True,7,Positive,27,6,33
589650,True,0,1 user reviews,1,0,1
589651,True,0,1 user reviews,1,0,1
589670,True,7,Positive,19,4,23
589680,True,0,4 user reviews,4,0,4
589690,True,6,Mostly Positive,13,5,18
589700,True,0,No user reviews,0,0,0
589730,True,5,Mixed,8,6,14
589740,True,5,Mixed,9,12,21
589760,True,8,Very Positive,165,39,204
589770,True,7,Positive,10,1,11
589780,True,8,Very Positive,1609,166,1775
589790,True,0,No user reviews,0,0,0
589840,True,0,No user reviews,0,0,0
589850,True,0,6 user reviews,6,0,6
589860,True,8,Very Positive,70,4,74
589870,True,0,No user reviews,0,0,0
589880,True,6,Mostly Positive,42,13,55
589890,True,0,No user reviews,0,0,0
589900,True,5,Mixed,6,4,10
589910,True,0,2 user reviews,1,1,2
589920,True,0,9 user reviews,3,6,9
589930,True,0,6 user reviews,4,2,6
589940,True,0,No user reviews,0,0,0
589950,True,0,No user reviews,0,0,0
590160,True,0,No user reviews,0,0,0
590161,True,0,No user reviews,0,0,0
590162,True,0,No user reviews,0,0,0
590170,True,0,1 user reviews,1,0,1
590171,True,0,No user reviews,0,0,0
590172,True,0,1 user reviews,1,0,1
590173,True,0,No user reviews,0,0,0
590174,True,0,No user reviews,0,0,0
590175,True,0,1 user reviews,1,0,1
590176,True,0,No user reviews,0,0,0
590177,True,0,No user reviews,0,0,0
590178,True,0,No user reviews,0,0,0
590179,True,0,No user reviews,0,0,0
590180,True,0,No user reviews,0,0,0
590181,True,0,No user reviews,0,0,0
590182,True,0,No user reviews,0,0,0
590183,True,0,No user reviews,0,0,0
590184,True,0,No user reviews,0,0,0
590185,True,0,No user reviews,0,0,0
590186,True,0,No user reviews,0,0,0
590187,True,0,No user reviews,0,0,0
590188,True,0,1 user reviews,0,1,1
590189,True,0,No user reviews,0,0,0
590190,True,0,No user reviews,0,0,0
590191,True,0,No user reviews,0,0,0
590192,True,0,1 user reviews,1,0,1
590193,True,0,No user reviews,0,0,0
590194,True,0,No user reviews,0,0,0
590195,True,0,No user reviews,0,0,0
590196,True,0,No user reviews,0,0,0
590197,True,0,No user reviews,0,0,0
590198,True,0,No user reviews,0,0,0
590199,True,0,No user reviews,0,0,0
590200,True,0,No user reviews,0,0,0
590201,True,0,2 user reviews,0,2,2
590202,True,0,No user reviews,0,0,0
590203,True,0,No user reviews,0,0,0
590204,True,0,No user reviews,0,0,0
590205,True,0,3 user reviews,2,1,3
590206,True,0,No user reviews,0,0,0
590207,True,0,No user reviews,0,0,0
590208,True,0,No user reviews,0,0,0
590209,True,0,1 user reviews,0,1,1
590210,True,0,No user reviews,0,0,0
590211,True,0,No user reviews,0,0,0
590212,True,0,No user reviews,0,0,0
590213,True,0,No user reviews,0,0,0
590214,True,0,No user reviews,0,0,0
590215,True,0,1 user reviews,1,0,1
590216,True,0,1 user reviews,1,0,1
590217,True,0,No user reviews,0,0,0
590218,True,0,1 user reviews,0,1,1
590219,True,0,No user reviews,0,0,0
590220,True,0,No user reviews,0,0,0
590221,True,0,No user reviews,0,0,0
590222,True,0,2 user reviews,2,0,2
590223,True,0,No user reviews,0,0,0
590224,True,0,No user reviews,0,0,0
590225,True,0,No user reviews,0,0,0
590226,True,0,No user reviews,0,0,0
590227,True,0,No user reviews,0,0,0
590228,True,0,No user reviews,0,0,0
590229,True,0,No user reviews,0,0,0
590230,True,0,No user reviews,0,0,0
590231,True,0,No user reviews,0,0,0
590232,True,0,No user reviews,0,0,0
590233,True,0,No user reviews,0,0,0
590234,True,0,No user reviews,0,0,0
590235,True,0,No user reviews,0,0,0
590236,True,0,No user reviews,0,0,0
590237,True,0,No user reviews,0,0,0
590238,True,0,No user reviews,0,0,0
590239,True,0,1 user reviews,0,1,1
590240,True,0,No user reviews,0,0,0
590241,True,0,No user reviews,0,0,0
590242,True,0,1 user reviews,1,0,1
590243,True,0,No user reviews,0,0,0
590244,True,0,No user reviews,0,0,0
590245,True,0,1 user reviews,1,0,1
590246,True,0,No user reviews,0,0,0
590247,True,0,No user reviews,0,0,0
590248,True,0,No user reviews,0,0,0
590249,True,0,No user reviews,0,0,0
590250,True,4,Mostly Negative,4,8,12
590260,True,0,No user reviews,0,0,0
590270,True,0,5 user reviews,2,3,5
590280,True,7,Positive,13,0,13
590290,True,0,1 user reviews,1,0,1
590350,True,0,No user reviews,0,0,0
590360,True,0,1 user reviews,0,1,1
590361,True,0,No user reviews,0,0,0
590370,True,0,7 user reviews,4,3,7
590380,True,8,Very Positive,5893,407,6300
590390,True,7,Positive,17,0,17
590391,True,0,8 user reviews,7,1,8
590400,True,0,No user reviews,0,0,0
590410,True,0,No user reviews,0,0,0
590430,True,0,4 user reviews,2,2,4
590440,True,0,No user reviews,0,0,0
590460,True,0,6 user reviews,6,0,6
590470,True,0,1 user reviews,1,0,1
590480,True,0,No user reviews,0,0,0
590490,True,0,1 user reviews,1,0,1
590500,True,0,No user reviews,0,0,0
590510,True,8,Very Positive,53,13,66
590530,True,6,Mostly Positive,9,3,12
590540,True,0,No user reviews,0,0,0
590560,True,0,No user reviews,0,0,0
590570,True,0,1 user reviews,0,1,1
590580,True,4,Mostly Negative,4,7,11
590590,True,8,Very Positive,149,7,156
590600,True,0,No user reviews,0,0,0
590610,True,7,Positive,17,0,17
590630,True,0,No user reviews,0,0,0
590640,True,0,No user reviews,0,0,0
590650,True,0,No user reviews,0,0,0
590660,True,0,5 user reviews,3,2,5
590670,True,0,No user reviews,0,0,0
590690,True,8,Very Positive,372,58,430
590720,True,7,Positive,29,5,34
590740,True,0,No user reviews,0,0,0
590750,True,0,8 user reviews,6,2,8
590760,True,0,No user reviews,0,0,0
590770,True,0,1 user reviews,0,1,1
590780,True,7,Positive,15,1,16
590790,True,0,No user reviews,0,0,0
590800,True,0,No user reviews,0,0,0
590810,True,0,No user reviews,0,0,0
590820,True,0,4 user reviews,3,1,4
590840,True,0,7 user reviews,6,1,7
590850,True,7,Positive,13,3,16
590860,True,0,8 user reviews,6,2,8
590870,True,4,Mostly Negative,4,9,13
590880,True,0,No user reviews,0,0,0
590881,True,0,No user reviews,0,0,0
590882,True,0,No user reviews,0,0,0
590883,True,0,No user reviews,0,0,0
590884,True,0,No user reviews,0,0,0
590910,True,0,No user reviews,0,0,0
590940,True,6,Mostly Positive,12,4,16
590950,True,7,Positive,33,0,33
590970,True,4,Mostly Negative,23,49,72
591000,True,8,Very Positive,49,8,57
591020,True,0,No user reviews,0,0,0
591030,True,0,No user reviews,0,0,0
591040,True,0,No user reviews,0,0,0
591050,True,0,No user reviews,0,0,0
591060,True,0,No user reviews,0,0,0
591061,True,0,No user reviews,0,0,0
591062,True,0,No user reviews,0,0,0
591063,True,0,No user reviews,0,0,0
591070,True,0,No user reviews,0,0,0
591090,True,0,2 user reviews,2,0,2
591121,True,0,No user reviews,0,0,0
591130,True,0,4 user reviews,2,2,4
591140,True,0,No user reviews,0,0,0
591150,True,0,No user reviews,0,0,0
591160,True,0,No user reviews,0,0,0
591170,True,0,No user reviews,0,0,0
591171,True,0,No user reviews,0,0,0
591172,True,0,No user reviews,0,0,0
591180,True,0,No user reviews,0,0,0
591181,True,0,No user reviews,0,0,0
591190,True,0,No user reviews,0,0,0
591191,True,0,No user reviews,0,0,0
591192,True,0,No user reviews,0,0,0
591193,True,0,No user reviews,0,0,0
591194,True,0,No user reviews,0,0,0
591195,True,0,No user reviews,0,0,0
591196,True,0,No user reviews,0,0,0
591197,True,0,No user reviews,0,0,0
591198,True,0,No user reviews,0,0,0
591199,True,0,No user reviews,0,0,0
591200,True,0,No user reviews,0,0,0
591201,True,0,No user reviews,0,0,0
591202,True,0,No user reviews,0,0,0
591203,True,0,No user reviews,0,0,0
591204,True,0,No user reviews,0,0,0
591205,True,0,No user reviews,0,0,0
591206,True,0,No user reviews,0,0,0
591207,True,0,No user reviews,0,0,0
591208,True,0,No user reviews,0,0,0
591209,True,0,No user reviews,0,0,0
591210,True,0,No user reviews,0,0,0
591211,True,0,No user reviews,0,0,0
591212,True,0,No user reviews,0,0,0
591213,True,0,No user reviews,0,0,0
591214,True,0,No user reviews,0,0,0
591215,True,0,No user reviews,0,0,0
591216,True,0,No user reviews,0,0,0
591217,True,0,No user reviews,0,0,0
591218,True,0,No user reviews,0,0,0
591219,True,0,No user reviews,0,0,0
591220,True,0,No user reviews,0,0,0
591221,True,0,No user reviews,0,0,0
591222,True,0,No user reviews,0,0,0
591223,True,0,No user reviews,0,0,0
591224,True,0,No user reviews,0,0,0
591225,True,0,No user reviews,0,0,0
591226,True,0,No user reviews,0,0,0
591227,True,0,No user reviews,0,0,0
591228,True,0,No user reviews,0,0,0
591229,True,0,No user reviews,0,0,0
591230,True,0,No user reviews,0,0,0
591231,True,0,No user reviews,0,0,0
591240,True,0,No user reviews,0,0,0
591241,True,0,No user reviews,0,0,0
591242,True,0,No user reviews,0,0,0
591243,True,0,No user reviews,0,0,0
591244,True,0,No user reviews,0,0,0
591245,True,0,No user reviews,0,0,0
591246,True,0,No user reviews,0,0,0
591247,True,0,No user reviews,0,0,0
591248,True,0,No user reviews,0,0,0
591249,True,0,No user reviews,0,0,0
591250,True,0,No user reviews,0,0,0
591251,True,0,No user reviews,0,0,0
591252,True,0,No user reviews,0,0,0
591253,True,0,No user reviews,0,0,0
591254,True,0,No user reviews,0,0,0
591255,True,0,No user reviews,0,0,0
591256,True,0,No user reviews,0,0,0
591257,True,0,No user reviews,0,0,0
591258,True,0,No user reviews,0,0,0
591259,True,0,No user reviews,0,0,0
591260,True,0,No user reviews,0,0,0
591280,True,0,No user reviews,0,0,0
591281,True,0,No user reviews,0,0,0
591282,True,0,No user reviews,0,0,0
591283,True,0,No user reviews,0,0,0
591284,True,0,No user reviews,0,0,0
591285,True,0,No user reviews,0,0,0
591286,True,0,No user reviews,0,0,0
591287,True,0,No user reviews,0,0,0
591288,True,0,No user reviews,0,0,0
591289,True,0,No user reviews,0,0,0
591290,True,0,No user reviews,0,0,0
591291,True,0,No user reviews,0,0,0
591292,True,0,No user reviews,0,0,0
591293,True,0,No user reviews,0,0,0
591294,True,0,No user reviews,0,0,0
591295,True,0,No user reviews,0,0,0
591296,True,0,No user reviews,0,0,0
591297,True,0,No user reviews,0,0,0
591298,True,0,No user reviews,0,0,0
591299,True,0,No user reviews,0,0,0
591300,True,0,No user reviews,0,0,0
591301,True,0,No user reviews,0,0,0
591302,True,0,No user reviews,0,0,0
591303,True,0,No user reviews,0,0,0
591304,True,0,No user reviews,0,0,0
591305,True,0,No user reviews,0,0,0
591306,True,0,No user reviews,0,0,0
591307,True,0,No user reviews,0,0,0
591308,True,0,No user reviews,0,0,0
591309,True,0,No user reviews,0,0,0
591310,True,0,No user reviews,0,0,0
591311,True,0,No user reviews,0,0,0
591312,True,0,No user reviews,0,0,0
591313,True,0,No user reviews,0,0,0
591314,True,0,No user reviews,0,0,0
591315,True,0,No user reviews,0,0,0
591316,True,0,No user reviews,0,0,0
591317,True,0,No user reviews,0,0,0
591320,True,0,No user reviews,0,0,0
591330,True,0,No user reviews,0,0,0
591331,True,0,No user reviews,0,0,0
591332,True,0,No user reviews,0,0,0
591333,True,0,No user reviews,0,0,0
591334,True,0,No user reviews,0,0,0
591335,True,0,No user reviews,0,0,0
591336,True,0,No user reviews,0,0,0
591337,True,0,No user reviews,0,0,0
591338,True,0,No user reviews,0,0,0
591339,True,0,No user reviews,0,0,0
591340,True,0,No user reviews,0,0,0
591350,True,7,Positive,17,1,18
591360,True,0,No user reviews,0,0,0
591370,True,8,Very Positive,1356,224,1580
591380,True,8,Very Positive,238,39,277
591390,True,0,No user reviews,0,0,0
591420,True,8,Very Positive,529,56,585
591430,True,0,No user reviews,0,0,0
591460,True,9,Overwhelmingly Positive,945,42,987
591470,True,0,3 user reviews,2,1,3
591480,True,0,2 user reviews,0,2,2
591490,True,0,1 user reviews,0,1,1
591491,True,0,1 user reviews,1,0,1
591492,True,0,1 user reviews,1,0,1
591493,True,0,1 user reviews,0,1,1
591494,True,0,1 user reviews,1,0,1
591495,True,0,1 user reviews,1,0,1
591496,True,0,1 user reviews,1,0,1
591497,True,0,1 user reviews,1,0,1
591498,True,0,1 user reviews,1,0,1
591499,True,0,2 user reviews,0,2,2
591500,True,0,1 user reviews,0,1,1
591501,True,0,2 user reviews,2,0,2
591502,True,0,1 user reviews,1,0,1
591503,True,0,2 user reviews,2,0,2
591504,True,0,No user reviews,0,0,0
591505,True,0,No user reviews,0,0,0
591506,True,0,No user reviews,0,0,0
591507,True,0,No user reviews,0,0,0
591508,True,0,No user reviews,0,0,0
591509,True,0,2 user reviews,2,0,2
591510,True,0,No user reviews,0,0,0
591511,True,0,No user reviews,0,0,0
591512,True,0,No user reviews,0,0,0
591513,True,0,No user reviews,0,0,0
591514,True,0,No user reviews,0,0,0
591520,True,0,No user reviews,0,0,0
591530,True,5,Mixed,159,72,231
591560,True,7,Positive,22,4,26
591580,True,0,5 user reviews,2,3,5
591590,True,0,No user reviews,0,0,0
591600,True,0,No user reviews,0,0,0
591610,True,0,2 user reviews,1,1,2
591620,True,0,3 user reviews,3,0,3
591630,True,8,Very Positive,54,7,61
591640,True,0,1 user reviews,1,0,1
591660,True,0,6 user reviews,3,3,6
591680,True,0,No user reviews,0,0,0
591690,True,0,No user reviews,0,0,0
591710,True,5,Mixed,90,39,129
591720,True,0,No user reviews,0,0,0
591730,True,0,No user reviews,0,0,0
591740,True,0,No user reviews,0,0,0
591750,True,7,Positive,21,2,23
591760,True,7,Positive,19,1,20
591770,True,0,No user reviews,0,0,0
591771,True,0,No user reviews,0,0,0
591772,True,0,No user reviews,0,0,0
591773,True,0,No user reviews,0,0,0
591774,True,0,No user reviews,0,0,0
591775,True,0,No user reviews,0,0,0
591776,True,0,No user reviews,0,0,0
591777,True,0,No user reviews,0,0,0
591778,True,0,No user reviews,0,0,0
591779,True,0,No user reviews,0,0,0
591780,True,0,No user reviews,0,0,0
591781,True,0,No user reviews,0,0,0
591790,True,5,Mixed,68,62,130
591800,True,5,Mixed,74,87,161
591810,True,0,7 user reviews,3,4,7
591811,True,0,No user reviews,0,0,0
591812,True,0,4 user reviews,4,0,4
591813,True,0,4 user reviews,4,0,4
591820,True,0,No user reviews,0,0,0
591870,True,0,No user reviews,0,0,0
591871,True,0,No user reviews,0,0,0
591872,True,0,No user reviews,0,0,0
591880,True,0,No user reviews,0,0,0
591890,True,0,No user reviews,0,0,0
591900,True,0,No user reviews,0,0,0
591910,True,5,Mixed,10,8,18
591920,True,0,5 user reviews,4,1,5
591930,True,5,Mixed,12,7,19
591940,True,0,No user reviews,0,0,0
591960,True,0,No user reviews,0,0,0
591970,True,0,7 user reviews,6,1,7
591971,True,0,1 user reviews,1,0,1
591980,True,0,3 user reviews,3,0,3
591981,True,0,1 user reviews,0,1,1
591982,True,0,1 user reviews,0,1,1
591983,True,0,1 user reviews,1,0,1
591984,True,0,7 user reviews,6,1,7
591985,True,0,4 user reviews,3,1,4
591986,True,0,6 user reviews,4,2,6
591987,True,0,No user reviews,0,0,0
591990,True,0,9 user reviews,5,4,9
592020,True,0,9 user reviews,8,1,9
592030,True,6,Mostly Positive,95,25,120
592040,True,0,3 user reviews,3,0,3
592060,True,0,7 user reviews,1,6,7
592100,True,7,Positive,16,3,19
592110,True,0,No user reviews,0,0,0
592120,True,0,7 user reviews,5,2,7
592130,True,0,1 user reviews,1,0,1
592200,True,0,7 user reviews,6,1,7
592210,True,0,No user reviews,0,0,0
592240,True,7,Positive,9,1,10
592260,True,8,Very Positive,1118,160,1278
592270,True,7,Positive,12,0,12
592290,True,0,4 user reviews,3,1,4
592291,True,0,2 user reviews,2,0,2
592292,True,0,3 user reviews,2,1,3
592300,True,7,Positive,27,2,29
592310,True,6,Mostly Positive,9,3,12
592320,True,5,Mixed,5,7,12
592330,True,0,8 user reviews,5,3,8
592340,True,5,Mixed,15,21,36
592350,True,7,Positive,10,0,10
592360,True,0,1 user reviews,0,1,1
592372,True,4,Mostly Negative,40,81,121
592373,True,8,Very Positive,75,7,82
592374,True,6,Mostly Positive,71,24,95
592380,True,0,No user reviews,0,0,0
592390,True,5,Mixed,21,15,36
592400,True,0,8 user reviews,8,0,8
592410,True,5,Mixed,13,10,23
592420,True,0,No user reviews,0,0,0
592421,True,0,No user reviews,0,0,0
592422,True,0,No user reviews,0,0,0
592423,True,0,No user reviews,0,0,0
592450,True,0,1 user reviews,1,0,1
592460,True,8,Very Positive,62,3,65
592461,True,7,Positive,16,0,16
592480,True,8,Very Positive,108,4,112
592531,True,0,No user reviews,0,0,0
592550,True,5,Mixed,13,11,24
592560,True,0,2 user reviews,1,1,2
592570,True,0,4 user reviews,2,2,4
592580,True,5,Mixed,230,160,390
592600,True,0,No user reviews,0,0,0
592620,True,0,9 user reviews,3,6,9
592640,True,0,No user reviews,0,0,0
592660,True,5,Mixed,10,7,17
592700,True,0,4 user reviews,0,4,4
592720,True,0,4 user reviews,3,1,4
592730,True,5,Mixed,17,8,25
592740,True,0,3 user reviews,1,2,3
592750,True,7,Positive,13,0,13
592780,True,0,No user reviews,0,0,0
592790,True,0,No user reviews,0,0,0
592800,True,5,Mixed,30,17,47
592810,True,0,No user reviews,0,0,0
592811,True,0,No user reviews,0,0,0
592812,True,0,No user reviews,0,0,0
592813,True,0,No user reviews,0,0,0
592814,True,0,No user reviews,0,0,0
592815,True,0,No user reviews,0,0,0
592816,True,0,No user reviews,0,0,0
592820,True,0,2 user reviews,2,0,2
592830,True,0,No user reviews,0,0,0
592840,True,0,No user reviews,0,0,0
592850,True,0,No user reviews,0,0,0
592860,True,0,No user reviews,0,0,0
592870,True,0,No user reviews,0,0,0
592880,True,0,No user reviews,0,0,0
592890,True,0,1 user reviews,0,1,1
592900,True,0,No user reviews,0,0,0
592920,True,0,3 user reviews,2,1,3
592930,True,0,No user reviews,0,0,0
592950,True,0,No user reviews,0,0,0
592990,True,0,3 user reviews,1,2,3
593000,True,0,No user reviews,0,0,0
593020,True,0,No user reviews,0,0,0
593030,True,8,Very Positive,76,13,89
593040,True,0,No user reviews,0,0,0
593050,True,0,No user reviews,0,0,0
593051,True,4,Mostly Negative,5,8,13
593052,True,0,1 user reviews,1,0,1
593053,True,0,No user reviews,0,0,0
593054,True,0,No user reviews,0,0,0
593055,True,0,3 user reviews,1,2,3
593056,True,0,No user reviews,0,0,0
593057,True,0,No user reviews,0,0,0
593060,True,0,2 user reviews,2,0,2
593070,True,7,Positive,18,2,20
593090,True,0,No user reviews,0,0,0
593100,True,0,4 user reviews,3,1,4
593130,True,0,No user reviews,0,0,0
593140,True,0,No user reviews,0,0,0
593150,True,0,No user reviews,0,0,0
593190,True,0,No user reviews,0,0,0
593200,True,7,Positive,26,2,28
593210,True,7,Positive,25,3,28
593240,True,5,Mixed,30,20,50
593250,True,0,2 user reviews,2,0,2
593260,True,0,4 user reviews,2,2,4
593270,True,6,Mostly Positive,8,3,11
593271,True,0,1 user reviews,1,0,1
593272,True,0,2 user reviews,1,1,2
593273,True,0,1 user reviews,1,0,1
593280,True,9,Overwhelmingly Positive,1592,74,1666
593330,True,4,Mostly Negative,9,30,39
593340,True,7,Positive,13,3,16
593350,True,0,No user reviews,0,0,0
593360,True,0,1 user reviews,1,0,1
593370,True,0,No user reviews,0,0,0
593380,True,8,Very Positive,1468,287,1755
593390,True,0,No user reviews,0,0,0
593400,True,0,No user reviews,0,0,0
593410,True,7,Positive,13,2,15
593420,True,0,No user reviews,0,0,0
593430,True,0,1 user reviews,1,0,1
593431,True,0,No user reviews,0,0,0
593450,True,0,No user reviews,0,0,0
593460,True,0,No user reviews,0,0,0
593470,True,0,No user reviews,0,0,0
593490,True,6,Mostly Positive,76,31,107
593500,True,0,No user reviews,0,0,0
593501,True,0,No user reviews,0,0,0
593502,True,0,No user reviews,0,0,0
593503,True,0,No user reviews,0,0,0
593520,True,0,No user reviews,0,0,0
593530,True,4,Mostly Negative,20,36,56
593540,True,5,Mixed,6,4,10
593560,True,4,Mostly Negative,5,8,13
593600,True,5,Mixed,1415,696,2111
593620,True,0,No user reviews,0,0,0
593640,True,0,No user reviews,0,0,0
593670,True,0,3 user reviews,3,0,3
593680,True,0,9 user reviews,9,0,9
593700,True,7,Positive,29,4,33
593720,True,0,No user reviews,0,0,0
593730,True,0,5 user reviews,2,3,5
593740,True,7,Positive,8,2,10
593750,True,0,No user reviews,0,0,0
593751,True,0,No user reviews,0,0,0
593752,True,0,No user reviews,0,0,0
593753,True,0,No user reviews,0,0,0
593754,True,0,No user reviews,0,0,0
593755,True,0,No user reviews,0,0,0
593756,True,0,No user reviews,0,0,0
593757,True,0,No user reviews,0,0,0
593758,True,0,No user reviews,0,0,0
593759,True,0,No user reviews,0,0,0
593760,True,0,No user reviews,0,0,0
593770,True,0,No user reviews,0,0,0
593771,True,0,No user reviews,0,0,0
593772,True,0,No user reviews,0,0,0
593773,True,0,No user reviews,0,0,0
593774,True,0,No user reviews,0,0,0
593775,True,0,No user reviews,0,0,0
593776,True,0,No user reviews,0,0,0
593777,True,0,No user reviews,0,0,0
593778,True,0,No user reviews,0,0,0
593779,True,0,No user reviews,0,0,0
593780,True,0,No user reviews,0,0,0
593790,True,0,No user reviews,0,0,0
593791,True,0,No user reviews,0,0,0
593792,True,0,No user reviews,0,0,0
593793,True,0,No user reviews,0,0,0
593794,True,0,No user reviews,0,0,0
593795,True,0,No user reviews,0,0,0
593796,True,0,No user reviews,0,0,0
593797,True,0,No user reviews,0,0,0
593798,True,0,No user reviews,0,0,0
593799,True,0,No user reviews,0,0,0
593800,True,0,No user reviews,0,0,0
593801,True,0,No user reviews,0,0,0
593810,True,0,No user reviews,0,0,0
593811,True,0,No user reviews,0,0,0
593812,True,0,No user reviews,0,0,0
593813,True,0,No user reviews,0,0,0
593814,True,0,No user reviews,0,0,0
593815,True,0,No user reviews,0,0,0
593816,True,0,No user reviews,0,0,0
593817,True,0,No user reviews,0,0,0
593818,True,0,No user reviews,0,0,0
593819,True,0,No user reviews,0,0,0
593820,True,0,No user reviews,0,0,0
593821,True,0,No user reviews,0,0,0
593822,True,0,No user reviews,0,0,0
593823,True,0,No user reviews,0,0,0
593830,True,0,No user reviews,0,0,0
593831,True,0,No user reviews,0,0,0
593832,True,0,No user reviews,0,0,0
593833,True,0,No user reviews,0,0,0
593834,True,0,No user reviews,0,0,0
593835,True,0,No user reviews,0,0,0
593836,True,0,No user reviews,0,0,0
593837,True,0,No user reviews,0,0,0
593838,True,0,No user reviews,0,0,0
593839,True,0,No user reviews,0,0,0
593840,True,0,No user reviews,0,0,0
593841,True,0,No user reviews,0,0,0
593850,True,5,Mixed,13,10,23
593860,True,0,No user reviews,0,0,0
593861,True,0,No user reviews,0,0,0
593862,True,0,No user reviews,0,0,0
593863,True,0,No user reviews,0,0,0
593864,True,0,No user reviews,0,0,0
593865,True,0,No user reviews,0,0,0
593866,True,0,No user reviews,0,0,0
593867,True,0,No user reviews,0,0,0
593868,True,0,No user reviews,0,0,0
593869,True,0,No user reviews,0,0,0
593870,True,0,No user reviews,0,0,0
593871,True,0,No user reviews,0,0,0
593880,True,0,No user reviews,0,0,0
593900,True,8,Very Positive,56,13,69
593920,True,0,1 user reviews,0,1,1
593930,True,0,No user reviews,0,0,0
593931,True,0,No user reviews,0,0,0
593932,True,0,No user reviews,0,0,0
593950,True,0,2 user reviews,2,0,2
593960,True,8,Very Positive,291,41,332
593970,True,0,3 user reviews,3,0,3
593980,True,0,3 user reviews,1,2,3
593990,True,0,No user reviews,0,0,0
594000,True,0,9 user reviews,7,2,9
594040,True,5,Mixed,48,46,94
594050,True,6,Mostly Positive,69,18,87
594060,True,0,1 user reviews,1,0,1
594080,True,0,No user reviews,0,0,0
594100,True,0,No user reviews,0,0,0
594120,True,0,3 user reviews,0,3,3
594130,True,8,Very Positive,248,8,256
594150,True,0,2 user reviews,2,0,2
594160,True,3,Negative,2,9,11
594184,True,7,Positive,14,0,14
594200,True,7,Positive,10,0,10
594220,True,0,No user reviews,0,0,0
594230,True,0,No user reviews,0,0,0
594270,True,0,No user reviews,0,0,0
594300,True,0,No user reviews,0,0,0
594310,True,0,No user reviews,0,0,0
594320,True,7,Positive,10,0,10
594330,True,8,Very Positive,1344,182,1526
594350,True,8,Very Positive,49,9,58
594360,True,0,9 user reviews,8,1,9
594370,True,5,Mixed,35,24,59
594380,True,0,No user reviews,0,0,0
594390,True,0,No user reviews,0,0,0
594410,True,0,5 user reviews,4,1,5
594420,True,0,No user reviews,0,0,0
594430,True,0,No user reviews,0,0,0
594431,True,0,No user reviews,0,0,0
594432,True,0,No user reviews,0,0,0
594433,True,0,No user reviews,0,0,0
594440,True,0,No user reviews,0,0,0
594450,True,0,No user reviews,0,0,0
594451,True,0,No user reviews,0,0,0
594452,True,0,No user reviews,0,0,0
594453,True,0,No user reviews,0,0,0
594454,True,0,No user reviews,0,0,0
594460,True,0,No user reviews,0,0,0
594461,True,0,No user reviews,0,0,0
594462,True,0,No user reviews,0,0,0
594463,True,0,No user reviews,0,0,0
594464,True,0,No user reviews,0,0,0
594470,True,0,No user reviews,0,0,0
594480,True,0,No user reviews,0,0,0
594490,True,0,1 user reviews,1,0,1
594520,True,0,No user reviews,0,0,0
594540,True,0,No user reviews,0,0,0
594550,True,6,Mostly Positive,42,11,53
594560,True,0,No user reviews,0,0,0
594561,True,0,No user reviews,0,0,0
594570,True,8,Very Positive,29147,2011,31158
594590,True,0,No user reviews,0,0,0
594591,True,5,Mixed,216,300,516
594592,True,0,No user reviews,0,0,0
594593,True,0,No user reviews,0,0,0
594594,True,0,No user reviews,0,0,0
594595,True,0,No user reviews,0,0,0
594596,True,0,No user reviews,0,0,0
594597,True,0,No user reviews,0,0,0
594598,True,0,No user reviews,0,0,0
594599,True,0,No user reviews,0,0,0
594600,True,0,No user reviews,0,0,0
594601,True,0,No user reviews,0,0,0
594602,True,0,No user reviews,0,0,0
594603,True,0,No user reviews,0,0,0
594610,True,0,No user reviews,0,0,0
594620,True,0,No user reviews,0,0,0
594630,True,7,Positive,14,2,16
594640,True,4,Mostly Negative,8,23,31
594650,True,8,Very Positive,22323,4944,27267
594660,True,7,Positive,36,9,45
594670,True,0,No user reviews,0,0,0
594680,True,7,Positive,42,4,46
594700,True,7,Positive,10,0,10
594720,True,5,Mixed,22,16,38
594750,True,5,Mixed,8,5,13
594760,True,0,No user reviews,0,0,0
594770,True,5,Mixed,184,144,328
594800,True,0,4 user reviews,3,1,4
594810,True,0,6 user reviews,6,0,6
594820,True,0,3 user reviews,3,0,3
594860,True,0,No user reviews,0,0,0
594870,True,0,No user reviews,0,0,0
594880,True,0,No user reviews,0,0,0
594890,True,0,No user reviews,0,0,0
594950,True,7,Positive,29,0,29
594970,True,5,Mixed,9,9,18
594980,True,7,Positive,23,2,25
595000,True,4,Mostly Negative,7,11,18
595010,True,5,Mixed,8,4,12
595020,True,0,1 user reviews,1,0,1
595030,True,0,8 user reviews,2,6,8
595050,True,0,No user reviews,0,0,0
595060,True,7,Positive,22,4,26
595070,True,0,5 user reviews,3,2,5
595080,True,7,Positive,14,2,16
595090,True,5,Mixed,23,12,35
595100,True,6,Mostly Positive,32,10,42
595110,True,6,Mostly Positive,142,46,188
595120,True,5,Mixed,52,27,79
595130,True,0,8 user reviews,8,0,8
595140,True,8,Very Positive,780,69,849
595150,True,0,2 user reviews,1,1,2
595160,True,0,7 user reviews,1,6,7
595200,True,7,Positive,23,4,27
595210,True,0,No user reviews,0,0,0
595220,True,0,No user reviews,0,0,0
595230,True,7,Positive,20,0,20
595260,True,5,Mixed,7,4,11
595270,True,7,Positive,10,0,10
595280,True,8,Very Positive,1413,312,1725
595290,True,7,Positive,40,7,47
595300,True,5,Mixed,9,5,14
595320,True,2,Very Negative,9,58,67
595330,True,0,6 user reviews,6,0,6
595331,True,0,4 user reviews,4,0,4
595332,True,0,7 user reviews,7,0,7
595333,True,0,7 user reviews,7,0,7
595350,True,0,No user reviews,0,0,0
595360,True,5,Mixed,13,10,23
595370,True,0,1 user reviews,1,0,1
595371,True,0,No user reviews,0,0,0
595372,True,0,No user reviews,0,0,0
595373,True,0,No user reviews,0,0,0
595374,True,0,No user reviews,0,0,0
595375,True,0,No user reviews,0,0,0
595376,True,0,No user reviews,0,0,0
595377,True,0,No user reviews,0,0,0
595378,True,0,No user reviews,0,0,0
595379,True,0,No user reviews,0,0,0
595380,True,0,No user reviews,0,0,0
595381,True,0,No user reviews,0,0,0
595382,True,0,No user reviews,0,0,0
595383,True,0,No user reviews,0,0,0
595384,True,0,No user reviews,0,0,0
595385,True,0,No user reviews,0,0,0
595386,True,0,No user reviews,0,0,0
595387,True,0,No user reviews,0,0,0
595388,True,0,No user reviews,0,0,0
595389,True,0,No user reviews,0,0,0
595390,True,0,No user reviews,0,0,0
595391,True,0,No user reviews,0,0,0
595392,True,0,No user reviews,0,0,0
595393,True,0,No user reviews,0,0,0
595394,True,0,No user reviews,0,0,0
595395,True,0,No user reviews,0,0,0
595396,True,0,No user reviews,0,0,0
595397,True,0,No user reviews,0,0,0
595398,True,0,No user reviews,0,0,0
595399,True,0,No user reviews,0,0,0
595400,True,0,No user reviews,0,0,0
595401,True,0,No user reviews,0,0,0
595402,True,0,No user reviews,0,0,0
595403,True,0,No user reviews,0,0,0
595404,True,0,No user reviews,0,0,0
595405,True,0,No user reviews,0,0,0
595406,True,0,No user reviews,0,0,0
595407,True,0,No user reviews,0,0,0
595408,True,0,No user reviews,0,0,0
595409,True,0,No user reviews,0,0,0
595410,True,0,No user reviews,0,0,0
595411,True,0,No user reviews,0,0,0
595412,True,0,No user reviews,0,0,0
595413,True,0,No user reviews,0,0,0
595414,True,0,No user reviews,0,0,0
595415,True,0,No user reviews,0,0,0
595416,True,0,No user reviews,0,0,0
595417,True,0,No user reviews,0,0,0
595418,True,0,No user reviews,0,0,0
595420,True,5,Mixed,70,45,115
595430,True,8,Very Positive,227,10,237
595440,True,8,Very Positive,92,15,107
595450,True,0,No user reviews,0,0,0
595460,True,8,Very Positive,111,26,137
595470,True,0,1 user reviews,0,1,1
595490,True,0,No user reviews,0,0,0
595500,True,0,No user reviews,0,0,0
595510,True,0,No user reviews,0,0,0
595520,True,8,Very Positive,1834,233,2067
595540,True,0,No user reviews,0,0,0
595550,True,5,Mixed,23,14,37
595560,True,7,Positive,36,1,37
595570,True,0,No user reviews,0,0,0
595571,True,0,No user reviews,0,0,0
595572,True,0,No user reviews,0,0,0
595573,True,0,No user reviews,0,0,0
595574,True,0,No user reviews,0,0,0
595575,True,0,No user reviews,0,0,0
595576,True,0,No user reviews,0,0,0
595577,True,0,No user reviews,0,0,0
595578,True,0,No user reviews,0,0,0
595579,True,0,No user reviews,0,0,0
595580,True,0,No user reviews,0,0,0
595581,True,0,No user reviews,0,0,0
595582,True,0,No user reviews,0,0,0
595583,True,0,No user reviews,0,0,0
595584,True,0,No user reviews,0,0,0
595585,True,0,No user reviews,0,0,0
595586,True,0,No user reviews,0,0,0
595587,True,0,No user reviews,0,0,0
595588,True,0,No user reviews,0,0,0
595589,True,0,No user reviews,0,0,0
595590,True,0,No user reviews,0,0,0
595591,True,0,No user reviews,0,0,0
595592,True,0,No user reviews,0,0,0
595593,True,0,No user reviews,0,0,0
595594,True,0,No user reviews,0,0,0
595595,True,0,No user reviews,0,0,0
595596,True,0,No user reviews,0,0,0
595597,True,0,No user reviews,0,0,0
595598,True,0,No user reviews,0,0,0
595599,True,0,No user reviews,0,0,0
595600,True,0,No user reviews,0,0,0
595601,True,0,No user reviews,0,0,0
595602,True,0,No user reviews,0,0,0
595603,True,0,No user reviews,0,0,0
595604,True,0,No user reviews,0,0,0
595605,True,0,No user reviews,0,0,0
595606,True,0,No user reviews,0,0,0
595607,True,0,No user reviews,0,0,0
595608,True,0,No user reviews,0,0,0
595609,True,0,No user reviews,0,0,0
595610,True,0,No user reviews,0,0,0
595611,True,0,No user reviews,0,0,0
595612,True,0,No user reviews,0,0,0
595613,True,0,No user reviews,0,0,0
595614,True,0,No user reviews,0,0,0
595615,True,0,No user reviews,0,0,0
595616,True,0,No user reviews,0,0,0
595617,True,0,No user reviews,0,0,0
595620,True,0,No user reviews,0,0,0
595630,True,0,1 user reviews,0,1,1
595640,True,0,7 user reviews,5,2,7
595650,True,0,No user reviews,0,0,0
595660,True,6,Mostly Positive,16,6,22
595680,True,0,1 user reviews,1,0,1
595690,True,6,Mostly Positive,1035,309,1344
595700,True,0,No user reviews,0,0,0
595730,True,8,Very Positive,58,8,66
595740,True,8,Very Positive,76,17,93
595750,True,0,No user reviews,0,0,0
595751,True,0,No user reviews,0,0,0
595752,True,0,No user reviews,0,0,0
595753,True,0,No user reviews,0,0,0
595754,True,0,No user reviews,0,0,0
595755,True,0,No user reviews,0,0,0
595756,True,0,No user reviews,0,0,0
595757,True,0,No user reviews,0,0,0
595760,True,0,No user reviews,0,0,0
595770,True,5,Mixed,58,32,90
595780,True,0,2 user reviews,1,1,2
595790,True,8,Very Positive,97,7,104
595830,True,0,1 user reviews,1,0,1
595900,True,0,No user reviews,0,0,0
595920,True,0,9 user reviews,5,4,9
595930,True,6,Mostly Positive,26,11,37
595940,True,0,5 user reviews,4,1,5
595960,True,8,Very Positive,69,13,82
595970,True,0,1 user reviews,0,1,1
595980,True,0,No user reviews,0,0,0
595990,True,0,3 user reviews,2,1,3
596000,True,7,Positive,37,6,43
596010,True,0,2 user reviews,2,0,2
596020,True,3,Negative,3,15,18
596030,True,0,No user reviews,0,0,0
596040,True,0,No user reviews,0,0,0
596050,True,0,No user reviews,0,0,0
596060,True,0,No user reviews,0,0,0
596070,True,0,5 user reviews,1,4,5
596080,True,7,Positive,10,2,12
596110,True,0,No user reviews,0,0,0
596120,True,0,No user reviews,0,0,0
596130,True,0,No user reviews,0,0,0
596140,True,5,Mixed,9,4,13
596150,True,0,No user reviews,0,0,0
596160,True,0,No user reviews,0,0,0
596190,True,4,Mostly Negative,18,63,81
596200,True,7,Positive,13,3,16
596230,True,0,No user reviews,0,0,0
596231,True,0,1 user reviews,1,0,1
596240,True,5,Mixed,35,40,75
596260,True,0,2 user reviews,2,0,2
596270,True,0,3 user reviews,2,1,3
596280,True,4,Mostly Negative,5,20,25
596290,True,0,1 user reviews,1,0,1
596291,True,0,No user reviews,0,0,0
596292,True,0,No user reviews,0,0,0
596293,True,0,No user reviews,0,0,0
596294,True,0,No user reviews,0,0,0
596295,True,0,No user reviews,0,0,0
596296,True,0,No user reviews,0,0,0
596297,True,0,No user reviews,0,0,0
596298,True,0,No user reviews,0,0,0
596299,True,0,No user reviews,0,0,0
596300,True,0,No user reviews,0,0,0
596301,True,0,No user reviews,0,0,0
596302,True,0,No user reviews,0,0,0
596303,True,0,No user reviews,0,0,0
596304,True,0,No user reviews,0,0,0
596305,True,0,No user reviews,0,0,0
596306,True,0,No user reviews,0,0,0
596307,True,0,No user reviews,0,0,0
596308,True,0,No user reviews,0,0,0
596309,True,0,No user reviews,0,0,0
596310,True,0,No user reviews,0,0,0
596311,True,0,No user reviews,0,0,0
596312,True,0,No user reviews,0,0,0
596313,True,0,No user reviews,0,0,0
596314,True,0,No user reviews,0,0,0
596315,True,0,No user reviews,0,0,0
596316,True,0,No user reviews,0,0,0
596317,True,0,No user reviews,0,0,0
596318,True,0,No user reviews,0,0,0
596319,True,0,No user reviews,0,0,0
596320,True,0,No user reviews,0,0,0
596321,True,0,No user reviews,0,0,0
596322,True,0,No user reviews,0,0,0
596323,True,0,No user reviews,0,0,0
596324,True,0,No user reviews,0,0,0
596325,True,0,No user reviews,0,0,0
596326,True,0,No user reviews,0,0,0
596327,True,0,No user reviews,0,0,0
596328,True,0,No user reviews,0,0,0
596329,True,0,No user reviews,0,0,0
596330,True,0,No user reviews,0,0,0
596331,True,0,No user reviews,0,0,0
596332,True,0,No user reviews,0,0,0
596333,True,0,No user reviews,0,0,0
596334,True,0,No user reviews,0,0,0
596335,True,0,No user reviews,0,0,0
596336,True,0,No user reviews,0,0,0
596337,True,0,No user reviews,0,0,0
596338,True,0,No user reviews,0,0,0
596339,True,0,No user reviews,0,0,0
596340,True,0,No user reviews,0,0,0
596341,True,0,No user reviews,0,0,0
596350,True,0,No user reviews,0,0,0
596370,True,0,8 user reviews,8,0,8
596380,True,5,Mixed,16,13,29
596390,True,0,9 user reviews,9,0,9
596400,True,0,2 user reviews,2,0,2
596420,True,0,No user reviews,0,0,0
596450,True,0,No user reviews,0,0,0
596460,True,0,1 user reviews,0,1,1
596470,True,0,8 user reviews,7,1,8
596510,True,0,No user reviews,0,0,0
596520,True,0,1 user reviews,1,0,1
596530,True,0,3 user reviews,3,0,3
596540,True,5,Mixed,16,12,28
596550,True,0,No user reviews,0,0,0
596560,True,6,Mostly Positive,17,6,23
596570,True,0,No user reviews,0,0,0
596580,True,0,No user reviews,0,0,0
596590,True,0,3 user reviews,3,0,3
596620,True,7,Positive,20,3,23
596630,True,7,Positive,13,1,14
596640,True,5,Mixed,11,9,20
596650,True,0,No user reviews,0,0,0
596700,True,0,No user reviews,0,0,0
596710,True,0,1 user reviews,1,0,1
596730,True,0,1 user reviews,0,1,1
596740,True,5,Mixed,10,7,17
596750,True,0,No user reviews,0,0,0
596760,True,0,3 user reviews,0,3,3
596790,True,0,No user reviews,0,0,0
596810,True,0,9 user reviews,9,0,9
596820,True,0,No user reviews,0,0,0
596821,True,0,No user reviews,0,0,0
596822,True,0,No user reviews,0,0,0
596823,True,0,No user reviews,0,0,0
596860,True,0,No user reviews,0,0,0
596870,True,6,Mostly Positive,16,6,22
596890,True,7,Positive,21,2,23
596900,True,0,No user reviews,0,0,0
596910,True,7,Positive,34,5,39
596920,True,0,No user reviews,0,0,0
596930,True,0,No user reviews,0,0,0
596940,True,0,No user reviews,0,0,0
596950,True,6,Mostly Positive,21,7,28
596960,True,0,8 user reviews,5,3,8
596970,True,8,Very Positive,1118,207,1325
596990,True,0,3 user reviews,2,1,3
597020,True,0,4 user reviews,4,0,4
597030,True,8,Very Positive,84,14,98
597040,True,5,Mixed,5,7,12
597070,True,0,No user reviews,0,0,0
597071,True,0,1 user reviews,1,0,1
597072,True,0,No user reviews,0,0,0
597073,True,0,No user reviews,0,0,0
597074,True,0,4 user reviews,1,3,4
597075,True,0,5 user reviews,4,1,5
597076,True,0,1 user reviews,1,0,1
597080,True,0,No user reviews,0,0,0
597090,True,0,2 user reviews,1,1,2
597120,True,7,Positive,12,0,12
597130,True,0,No user reviews,0,0,0
597150,True,8,Very Positive,183,18,201
597170,True,9,Overwhelmingly Positive,4389,111,4500
597190,True,0,6 user reviews,5,1,6
597200,True,6,Mostly Positive,12,4,16
597210,True,4,Mostly Negative,9,15,24
597220,True,9,Overwhelmingly Positive,4301,92,4393
597230,True,8,Very Positive,174,10,184
597240,True,0,7 user reviews,3,4,7
597260,True,0,No user reviews,0,0,0
597270,True,0,No user reviews,0,0,0
597280,True,0,1 user reviews,1,0,1
597290,True,0,1 user reviews,0,1,1
597300,True,0,No user reviews,0,0,0
597310,True,0,2 user reviews,2,0,2
597320,True,0,No user reviews,0,0,0
597321,True,0,No user reviews,0,0,0
597322,True,0,No user reviews,0,0,0
597323,True,0,No user reviews,0,0,0
597324,True,0,No user reviews,0,0,0
597325,True,0,No user reviews,0,0,0
597326,True,0,No user reviews,0,0,0
597327,True,0,No user reviews,0,0,0
597328,True,0,No user reviews,0,0,0
597329,True,0,No user reviews,0,0,0
597330,True,0,No user reviews,0,0,0
597331,True,0,No user reviews,0,0,0
597340,True,0,No user reviews,0,0,0
597341,True,0,No user reviews,0,0,0
597342,True,0,No user reviews,0,0,0
597343,True,0,No user reviews,0,0,0
597344,True,0,No user reviews,0,0,0
597345,True,0,No user reviews,0,0,0
597346,True,0,No user reviews,0,0,0
597347,True,0,No user reviews,0,0,0
597348,True,0,No user reviews,0,0,0
597349,True,0,No user reviews,0,0,0
597350,True,0,No user reviews,0,0,0
597351,True,0,No user reviews,0,0,0
597352,True,0,No user reviews,0,0,0
597360,True,0,No user reviews,0,0,0
597370,True,0,No user reviews,0,0,0
597380,True,0,No user reviews,0,0,0
597381,True,0,No user reviews,0,0,0
597382,True,0,No user reviews,0,0,0
597383,True,0,No user reviews,0,0,0
597384,True,0,No user reviews,0,0,0
597385,True,0,No user reviews,0,0,0
597386,True,0,No user reviews,0,0,0
597387,True,0,No user reviews,0,0,0
597388,True,0,No user reviews,0,0,0
597389,True,0,No user reviews,0,0,0
597390,True,0,No user reviews,0,0,0
597391,True,0,No user reviews,0,0,0
597392,True,0,No user reviews,0,0,0
597400,True,0,No user reviews,0,0,0
597401,True,0,No user reviews,0,0,0
597402,True,0,No user reviews,0,0,0
597403,True,0,No user reviews,0,0,0
597404,True,0,No user reviews,0,0,0
597405,True,0,No user reviews,0,0,0
597406,True,0,No user reviews,0,0,0
597407,True,0,No user reviews,0,0,0
597408,True,0,No user reviews,0,0,0
597409,True,0,No user reviews,0,0,0
597410,True,0,No user reviews,0,0,0
597411,True,0,No user reviews,0,0,0
597420,True,0,No user reviews,0,0,0
597440,True,0,No user reviews,0,0,0
597450,True,0,No user reviews,0,0,0
597460,True,0,No user reviews,0,0,0
597470,True,0,No user reviews,0,0,0
597480,True,0,No user reviews,0,0,0
597490,True,0,No user reviews,0,0,0
597500,True,0,No user reviews,0,0,0
597510,True,0,No user reviews,0,0,0
597520,True,0,No user reviews,0,0,0
597530,True,0,No user reviews,0,0,0
597540,True,0,No user reviews,0,0,0
597590,True,7,Positive,17,2,19
597600,True,0,No user reviews,0,0,0
597610,True,0,No user reviews,0,0,0
597640,True,0,No user reviews,0,0,0
597660,True,0,No user reviews,0,0,0
597670,True,0,2 user reviews,2,0,2
597690,True,0,No user reviews,0,0,0
597700,True,8,Very Positive,121,11,132
597720,True,5,Mixed,6,4,10
597730,True,0,9 user reviews,8,1,9
597760,True,9,Overwhelmingly Positive,529,25,554
597770,True,5,Mixed,30,20,50
597800,True,0,No user reviews,0,0,0
597810,True,7,Positive,9,1,10
597820,True,0,No user reviews,0,0,0
597830,True,0,No user reviews,0,0,0
597840,True,6,Mostly Positive,83,35,118
597860,True,5,Mixed,9,5,14
597880,True,0,No user reviews,0,0,0
597890,True,0,No user reviews,0,0,0
597900,True,0,7 user reviews,5,2,7
597910,True,0,5 user reviews,4,1,5
597920,True,5,Mixed,6,9,15
597930,True,0,No user reviews,0,0,0
597940,True,0,No user reviews,0,0,0
597950,True,0,No user reviews,0,0,0
597970,True,8,Very Positive,124,21,145
597990,True,0,2 user reviews,1,1,2
598010,True,0,No user reviews,0,0,0
598030,True,0,7 user reviews,1,6,7
598050,True,0,1 user reviews,1,0,1
598060,True,8,Very Positive,86,11,97
598070,True,7,Positive,17,0,17
598090,True,0,5 user reviews,2,3,5
598100,True,0,No user reviews,0,0,0
598110,True,0,No user reviews,0,0,0
598120,True,0,No user reviews,0,0,0
598150,True,0,No user reviews,0,0,0
598160,True,0,No user reviews,0,0,0
598170,True,0,No user reviews,0,0,0
598180,True,5,Mixed,19,16,35
598190,True,8,Very Positive,63,2,65
598210,True,0,No user reviews,0,0,0
598230,True,0,No user reviews,0,0,0
598240,True,5,Mixed,10,11,21
598250,True,0,No user reviews,0,0,0
598290,True,0,No user reviews,0,0,0
598330,True,8,Very Positive,1400,343,1743
598340,True,7,Positive,9,2,11
598350,True,7,Positive,16,2,18
598380,True,0,2 user reviews,2,0,2
598390,True,0,No user reviews,0,0,0
598400,True,5,Mixed,16,9,25
598420,True,0,No user reviews,0,0,0
598430,True,0,No user reviews,0,0,0
598440,True,5,Mixed,37,19,56
598450,True,5,Mixed,90,55,145
598480,True,4,Mostly Negative,5,11,16
598490,True,8,Very Positive,70,9,79
598500,True,0,7 user reviews,3,4,7
598530,True,0,No user reviews,0,0,0
598540,True,0,No user reviews,0,0,0
598550,True,0,No user reviews,0,0,0
598590,True,0,1 user reviews,1,0,1
598600,True,5,Mixed,5,6,11
598610,True,5,Mixed,9,5,14
598620,True,0,6 user reviews,3,3,6
598640,True,7,Positive,24,2,26
598650,True,0,No user reviews,0,0,0
598660,True,5,Mixed,17,10,27
598670,True,7,Positive,19,1,20
598690,True,5,Mixed,44,25,69
598700,True,8,Very Positive,894,96,990
598710,True,0,4 user reviews,4,0,4
598720,True,5,Mixed,7,5,12
598730,True,7,Positive,32,4,36
598740,True,7,Positive,10,2,12
598750,True,0,No user reviews,0,0,0
598770,True,0,No user reviews,0,0,0
598780,True,0,No user reviews,0,0,0
598810,True,6,Mostly Positive,299,99,398
598820,True,0,No user reviews,0,0,0
598830,True,0,No user reviews,0,0,0
598840,True,0,7 user reviews,7,0,7
598850,True,0,No user reviews,0,0,0
598860,True,6,Mostly Positive,9,3,12
598870,True,0,No user reviews,0,0,0
598880,True,0,7 user reviews,7,0,7
598890,True,0,No user reviews,0,0,0
598900,True,0,No user reviews,0,0,0
598910,True,0,No user reviews,0,0,0
598930,True,0,No user reviews,0,0,0
598940,True,5,Mixed,12,6,18
598950,True,0,No user reviews,0,0,0
598960,True,8,Very Positive,519,87,606
598980,True,9,Overwhelmingly Positive,1590,51,1641
598990,True,7,Positive,12,0,12
599000,True,5,Mixed,21,14,35
599020,True,0,No user reviews,0,0,0
599021,True,0,No user reviews,0,0,0
599022,True,0,No user reviews,0,0,0
599023,True,0,No user reviews,0,0,0
599030,True,0,No user reviews,0,0,0
599040,True,5,Mixed,6,6,12
599050,True,7,Positive,10,0,10
599060,True,0,No user reviews,0,0,0
599070,True,0,2 user reviews,2,0,2
599080,True,8,Very Positive,939,162,1101
599110,True,0,No user reviews,0,0,0
599140,True,8,Very Positive,4918,1082,6000
599150,True,0,No user reviews,0,0,0
599160,True,7,Positive,17,3,20
599180,True,0,3 user reviews,2,1,3
599190,True,0,No user reviews,0,0,0
599210,True,0,No user reviews,0,0,0
599230,True,0,No user reviews,0,0,0
599250,True,0,No user reviews,0,0,0
599270,True,0,No user reviews,0,0,0
599290,True,0,No user reviews,0,0,0
599310,True,0,No user reviews,0,0,0
599350,True,0,No user reviews,0,0,0
599390,True,0,No user reviews,0,0,0
599400,True,0,No user reviews,0,0,0
599420,True,0,1 user reviews,1,0,1
599430,True,0,2 user reviews,2,0,2
599440,True,0,6 user reviews,4,2,6
599441,True,0,7 user reviews,6,1,7
599460,True,6,Mostly Positive,169,45,214
599480,True,7,Positive,9,1,10
599490,True,0,No user reviews,0,0,0
599500,True,0,No user reviews,0,0,0
599510,True,0,5 user reviews,2,3,5
599520,True,0,No user reviews,0,0,0
599540,True,0,No user reviews,0,0,0
599560,True,5,Mixed,30,14,44
599580,True,0,No user reviews,0,0,0
599590,True,7,Positive,40,1,41
599600,True,6,Mostly Positive,11,4,15
599630,True,0,6 user reviews,4,2,6
599640,True,0,No user reviews,0,0,0
599660,True,0,No user reviews,0,0,0
599670,True,0,5 user reviews,3,2,5
599680,True,0,No user reviews,0,0,0
599690,True,0,1 user reviews,1,0,1
599740,True,0,No user reviews,0,0,0
599750,True,6,Mostly Positive,254,91,345
599760,True,0,No user reviews,0,0,0
599780,True,0,No user reviews,0,0,0
599800,True,0,1 user reviews,1,0,1
599810,True,0,4 user reviews,3,1,4
599840,True,7,Positive,26,0,26
599860,True,0,No user reviews,0,0,0
599880,True,0,6 user reviews,2,4,6
599890,True,0,1 user reviews,1,0,1
599900,True,5,Mixed,13,8,21
599910,True,0,No user reviews,0,0,0
599920,True,0,No user reviews,0,0,0
599960,True,6,Mostly Positive,107,42,149
599970,True,0,No user reviews,0,0,0
599980,True,0,No user reviews,0,0,0
599990,True,0,8 user reviews,3,5,8
600000,True,0,5 user reviews,4,1,5
600010,True,0,No user reviews,0,0,0
600020,True,0,No user reviews,0,0,0
600021,True,0,No user reviews,0,0,0
600030,True,0,1 user reviews,1,0,1
600050,True,0,No user reviews,0,0,0
600051,True,0,No user reviews,0,0,0
600052,True,0,No user reviews,0,0,0
600053,True,0,No user reviews,0,0,0
600054,True,0,No user reviews,0,0,0
600055,True,0,No user reviews,0,0,0
600060,True,0,No user reviews,0,0,0
600070,True,0,No user reviews,0,0,0
600080,True,0,No user reviews,0,0,0
600090,True,8,Very Positive,63,13,76
600100,True,0,6 user reviews,3,3,6
600120,True,0,No user reviews,0,0,0
600130,True,8,Very Positive,328,24,352
600140,True,0,No user reviews,0,0,0
600150,True,5,Mixed,13,6,19
600160,True,0,No user reviews,0,0,0
600170,True,0,6 user reviews,6,0,6
600180,True,0,No user reviews,0,0,0
600190,True,0,6 user reviews,3,3,6
600200,True,0,No user reviews,0,0,0
600210,True,0,7 user reviews,4,3,7
600220,True,0,No user reviews,0,0,0
600230,True,0,No user reviews,0,0,0
600240,True,0,No user reviews,0,0,0
600250,True,0,8 user reviews,7,1,8
600260,True,0,No user reviews,0,0,0
600280,True,5,Mixed,32,18,50
600290,True,0,No user reviews,0,0,0
600300,True,0,No user reviews,0,0,0
600310,True,0,2 user reviews,2,0,2
600320,True,0,1 user reviews,1,0,1
600330,True,0,7 user reviews,6,1,7
600350,True,0,3 user reviews,1,2,3
600360,True,0,No user reviews,0,0,0
600370,True,9,Overwhelmingly Positive,591,16,607
600400,True,0,No user reviews,0,0,0
600410,True,0,No user reviews,0,0,0
600420,True,7,Positive,24,4,28
600430,True,0,5 user reviews,4,1,5
600440,True,0,No user reviews,0,0,0
600460,True,6,Mostly Positive,129,40,169
600470,True,0,No user reviews,0,0,0
600480,True,8,Very Positive,929,65,994
600500,True,0,1 user reviews,1,0,1
600520,True,0,4 user reviews,4,0,4
600530,True,0,6 user reviews,4,2,6
600540,True,0,No user reviews,0,0,0
600550,True,4,Mostly Negative,5,10,15
600560,True,0,No user reviews,0,0,0
600580,True,0,1 user reviews,1,0,1
600600,True,6,Mostly Positive,10,3,13
600610,True,0,No user reviews,0,0,0
600620,True,0,No user reviews,0,0,0
600630,True,5,Mixed,13,14,27
600640,True,0,3 user reviews,3,0,3
600650,True,7,Positive,16,1,17
600660,True,7,Positive,16,0,16
600670,True,0,4 user reviews,2,2,4
600690,True,0,2 user reviews,2,0,2
600720,True,5,Mixed,68,37,105
600730,True,0,No user reviews,0,0,0
600740,True,5,Mixed,10,9,19
600750,True,0,2 user reviews,1,1,2
600760,True,0,No user reviews,0,0,0
600820,True,0,No user reviews,0,0,0
600830,True,0,No user reviews,0,0,0
600840,True,0,No user reviews,0,0,0
600850,True,0,No user reviews,0,0,0
600860,True,0,No user reviews,0,0,0
600870,True,0,No user reviews,0,0,0
600880,True,0,No user reviews,0,0,0
600890,True,0,No user reviews,0,0,0
600900,True,0,No user reviews,0,0,0
600910,True,0,No user reviews,0,0,0
600920,True,0,No user reviews,0,0,0
600930,True,0,No user reviews,0,0,0
600940,True,0,No user reviews,0,0,0
600950,True,0,No user reviews,0,0,0
600960,True,0,No user reviews,0,0,0
600970,True,0,No user reviews,0,0,0
600980,True,0,4 user reviews,2,2,4
600990,True,8,Very Positive,446,33,479
601010,True,5,Mixed,34,22,56
601020,True,4,Mostly Negative,4,7,11
601050,True,8,Very Positive,595,79,674
601070,True,0,No user reviews,0,0,0
601080,True,0,No user reviews,0,0,0
601090,True,0,No user reviews,0,0,0
601110,True,0,3 user reviews,1,2,3
601120,True,0,4 user reviews,4,0,4
601130,True,0,3 user reviews,3,0,3
601150,True,8,Very Positive,8114,739,8853
601170,True,0,9 user reviews,5,4,9
601180,True,0,8 user reviews,5,3,8
601190,True,0,No user reviews,0,0,0
601200,True,0,2 user reviews,1,1,2
601210,True,0,No user reviews,0,0,0
601220,True,8,Very Positive,217,8,225
601240,True,0,5 user reviews,4,1,5
601250,True,0,4 user reviews,4,0,4
601270,True,7,Positive,21,2,23
601290,True,0,No user reviews,0,0,0
601291,True,0,No user reviews,0,0,0
601292,True,0,No user reviews,0,0,0
601293,True,0,No user reviews,0,0,0
601294,True,0,No user reviews,0,0,0
601295,True,0,No user reviews,0,0,0
601296,True,0,No user reviews,0,0,0
601297,True,0,No user reviews,0,0,0
601298,True,0,No user reviews,0,0,0
601300,True,0,No user reviews,0,0,0
601301,True,0,No user reviews,0,0,0
601302,True,0,No user reviews,0,0,0
601303,True,0,No user reviews,0,0,0
601310,True,0,No user reviews,0,0,0
601320,True,0,3 user reviews,2,1,3
601330,True,0,No user reviews,0,0,0
601340,True,0,5 user reviews,1,4,5
601350,True,0,No user reviews,0,0,0
601360,True,0,No user reviews,0,0,0
601370,True,0,No user reviews,0,0,0
601380,True,3,Negative,6,26,32
601390,True,0,1 user reviews,1,0,1
601400,True,6,Mostly Positive,13,4,17
601420,True,0,6 user reviews,5,1,6
601430,True,8,Very Positive,2560,278,2838
601490,True,5,Mixed,7,6,13
601500,True,0,9 user reviews,6,3,9
601510,True,0,No user reviews,0,0,0
601520,True,0,No user reviews,0,0,0
601530,True,8,Very Positive,186,23,209
601540,True,5,Mixed,178,121,299
601550,True,0,3 user reviews,0,3,3
601570,True,6,Mostly Positive,8,3,11
601590,True,0,6 user reviews,4,2,6
601610,True,0,No user reviews,0,0,0
601620,True,0,6 user reviews,1,5,6
601640,True,0,9 user reviews,4,5,9
601670,True,5,Mixed,209,108,317
601690,True,0,6 user reviews,4,2,6
601700,True,0,No user reviews,0,0,0
601710,True,7,Positive,14,0,14
601720,True,0,No user reviews,0,0,0
601730,True,0,No user reviews,0,0,0
601750,True,5,Mixed,10,10,20
601760,True,0,1 user reviews,0,1,1
601770,True,8,Very Positive,221,42,263
601780,True,6,Mostly Positive,13,5,18
601790,True,5,Mixed,8,5,13
601810,True,8,Very Positive,292,24,316
601840,True,9,Overwhelmingly Positive,1547,55,1602
601850,True,0,1 user reviews,1,0,1
601860,True,0,No user reviews,0,0,0
601870,True,6,Mostly Positive,7,3,10
601880,True,0,No user reviews,0,0,0
601890,True,0,9 user reviews,8,1,9
601920,True,7,Positive,8,2,10
601930,True,0,6 user reviews,6,0,6
601940,True,0,1 user reviews,1,0,1
601990,True,0,No user reviews,0,0,0
602010,True,7,Positive,22,4,26
602040,True,0,No user reviews,0,0,0
602060,True,0,No user reviews,0,0,0
602070,True,0,2 user reviews,2,0,2
602080,True,7,Positive,14,0,14
602090,True,0,No user reviews,0,0,0
602120,True,7,Positive,14,0,14
602130,True,0,8 user reviews,5,3,8
602140,True,0,No user reviews,0,0,0
602150,True,0,1 user reviews,0,1,1
602160,True,0,5 user reviews,4,1,5
602180,True,0,2 user reviews,0,2,2
602200,True,0,5 user reviews,4,1,5
602210,True,0,No user reviews,0,0,0
602250,True,0,No user reviews,0,0,0
602260,True,0,No user reviews,0,0,0
602270,True,0,2 user reviews,1,1,2
602280,True,0,No user reviews,0,0,0
602290,True,0,1 user reviews,0,1,1
602300,True,0,7 user reviews,7,0,7
602310,True,0,No user reviews,0,0,0
602320,True,8,Very Positive,539,51,590
602330,True,0,No user reviews,0,0,0
602340,True,0,No user reviews,0,0,0
602350,True,0,1 user reviews,0,1,1
602370,True,0,No user reviews,0,0,0
602380,True,0,No user reviews,0,0,0
602390,True,0,No user reviews,0,0,0
602400,True,0,No user reviews,0,0,0
602410,True,0,No user reviews,0,0,0
602420,True,0,No user reviews,0,0,0
602430,True,7,Positive,37,5,42
602440,True,0,3 user reviews,3,0,3
602441,True,0,2 user reviews,2,0,2
602450,True,7,Positive,10,2,12
602451,True,0,No user reviews,0,0,0
602460,True,0,4 user reviews,4,0,4
602461,True,0,5 user reviews,3,2,5
602470,True,0,2 user reviews,2,0,2
602471,True,5,Mixed,8,4,12
602472,True,0,6 user reviews,6,0,6
602480,True,7,Positive,34,7,41
602510,True,5,Mixed,27,16,43
602520,True,9,Overwhelmingly Positive,1579,37,1616
602540,True,0,5 user reviews,2,3,5
602550,True,0,3 user reviews,3,0,3
602580,True,0,1 user reviews,1,0,1
602581,True,0,1 user reviews,1,0,1
602582,True,0,1 user reviews,0,1,1
602583,True,0,No user reviews,0,0,0
602584,True,0,5 user reviews,3,2,5
602590,True,7,Positive,8,2,10
602600,True,0,No user reviews,0,0,0
602620,True,0,4 user reviews,3,1,4
602621,True,0,2 user reviews,1,1,2
602622,True,0,6 user reviews,4,2,6
602623,True,7,Positive,12,1,13
602630,True,7,Positive,15,1,16
602660,True,0,No user reviews,0,0,0
602670,True,0,No user reviews,0,0,0
602700,True,8,Very Positive,280,26,306
602720,True,0,3 user reviews,3,0,3
602730,True,0,7 user reviews,6,1,7
602740,True,0,No user reviews,0,0,0
602750,True,0,No user reviews,0,0,0
602770,True,6,Mostly Positive,111,33,144
602780,True,0,No user reviews,0,0,0
602790,True,0,3 user reviews,2,1,3
602800,True,0,3 user reviews,1,2,3
602801,True,0,4 user reviews,3,1,4
602810,True,0,4 user reviews,2,2,4
602811,True,0,2 user reviews,2,0,2
602812,True,0,3 user reviews,1,2,3
602813,True,0,2 user reviews,2,0,2
602814,True,0,No user reviews,0,0,0
602815,True,0,No user reviews,0,0,0
602816,True,0,1 user reviews,1,0,1
602817,True,0,No user reviews,0,0,0
602818,True,0,5 user reviews,3,2,5
602819,True,0,5 user reviews,4,1,5
602820,True,0,No user reviews,0,0,0
602830,True,5,Mixed,7,5,12
602860,True,7,Positive,13,0,13
602870,True,0,No user reviews,0,0,0
602880,True,0,3 user reviews,3,0,3
602890,True,5,Mixed,43,48,91
602900,True,0,No user reviews,0,0,0
602910,True,5,Mixed,9,6,15
602920,True,0,1 user reviews,1,0,1
602930,True,5,Mixed,4,6,10
602950,True,0,No user reviews,0,0,0
602960,True,8,Very Positive,3104,318,3422
602970,True,0,1 user reviews,1,0,1
603000,True,0,1 user reviews,1,0,1
603010,True,7,Positive,18,3,21
603020,True,6,Mostly Positive,111,34,145
603030,True,5,Mixed,13,8,21
603060,True,7,Positive,10,2,12
603090,True,0,9 user reviews,5,4,9
603100,True,6,Mostly Positive,47,18,65
603110,True,0,7 user reviews,6,1,7
603120,True,5,Mixed,21,29,50
603130,True,6,Mostly Positive,37,10,47
603140,True,0,No user reviews,0,0,0
603150,True,4,Mostly Negative,6,12,18
603170,True,0,No user reviews,0,0,0
603190,True,6,Mostly Positive,49,17,66
603210,True,0,5 user reviews,2,3,5
603220,True,0,3 user reviews,3,0,3
603230,True,7,Positive,14,1,15
603240,True,0,No user reviews,0,0,0
603250,True,0,7 user reviews,3,4,7
603260,True,8,Very Positive,252,30,282
603280,True,7,Positive,11,1,12
603300,True,0,No user reviews,0,0,0
603301,True,0,No user reviews,0,0,0
603302,True,0,No user reviews,0,0,0
603303,True,0,No user reviews,0,0,0
603305,True,0,No user reviews,0,0,0
603306,True,0,No user reviews,0,0,0
603307,True,0,No user reviews,0,0,0
603308,True,0,No user reviews,0,0,0
603310,True,0,No user reviews,0,0,0
603320,True,6,Mostly Positive,77,27,104
603330,True,7,Positive,31,4,35
603340,True,0,1 user reviews,1,0,1
603350,True,6,Mostly Positive,51,16,67
603360,True,4,Mostly Negative,5,17,22
603380,True,5,Mixed,12,6,18
603390,True,8,Very Positive,104,6,110
603400,True,5,Mixed,29,17,46
603420,True,5,Mixed,7,5,12
603440,True,0,No user reviews,0,0,0
603450,True,0,1 user reviews,1,0,1
603460,True,0,4 user reviews,3,1,4
603490,True,0,2 user reviews,0,2,2
603510,True,7,Positive,9,1,10
603520,True,0,No user reviews,0,0,0
603530,True,8,Very Positive,374,40,414
603540,True,0,No user reviews,0,0,0
603550,True,0,3 user reviews,1,2,3
603560,True,0,No user reviews,0,0,0
603590,True,0,No user reviews,0,0,0
603600,True,0,No user reviews,0,0,0
603610,True,0,1 user reviews,1,0,1
603630,True,0,No user reviews,0,0,0
603680,True,0,No user reviews,0,0,0
603690,True,0,No user reviews,0,0,0
603700,True,6,Mostly Positive,60,18,78
603720,True,0,No user reviews,0,0,0
603730,True,5,Mixed,29,14,43
603750,True,3,Negative,5,25,30
603760,True,0,7 user reviews,7,0,7
603790,True,5,Mixed,10,6,16
603800,True,8,Very Positive,55,10,65
603810,True,8,Very Positive,48,11,59
603840,True,0,2 user reviews,2,0,2
603850,True,8,Very Positive,2346,566,2912
603870,True,7,Positive,14,1,15
603880,True,0,No user reviews,0,0,0
603910,True,0,2 user reviews,1,1,2
603930,True,5,Mixed,22,10,32
603940,True,8,Very Positive,98,23,121
603960,True,9,Overwhelmingly Positive,820,11,831
603970,True,0,1 user reviews,0,1,1
603980,True,0,No user reviews,0,0,0
603990,True,0,2 user reviews,1,1,2
604000,True,7,Positive,38,3,41
604010,True,7,Positive,17,3,20
604020,True,0,No user reviews,0,0,0
604030,True,0,No user reviews,0,0,0
604040,True,0,5 user reviews,2,3,5
604060,True,0,3 user reviews,2,1,3
604070,True,5,Mixed,6,4,10
604080,True,0,No user reviews,0,0,0
604090,True,0,1 user reviews,0,1,1
604091,True,0,No user reviews,0,0,0
604100,True,0,No user reviews,0,0,0
604110,True,0,6 user reviews,4,2,6
604140,True,5,Mixed,7,4,11
604150,True,0,3 user reviews,2,1,3
604170,True,7,Positive,13,2,15
604180,True,0,No user reviews,0,0,0
604190,True,0,No user reviews,0,0,0
604200,True,0,7 user reviews,3,4,7
604210,True,0,No user reviews,0,0,0
604230,True,0,No user reviews,0,0,0
604240,True,9,Overwhelmingly Positive,4397,182,4579
604280,True,0,1 user reviews,1,0,1
604290,True,0,3 user reviews,3,0,3
604300,True,7,Positive,18,3,21
604310,True,0,No user reviews,0,0,0
604320,True,0,No user reviews,0,0,0
604330,True,8,Very Positive,227,7,234
604340,True,0,2 user reviews,2,0,2
604350,True,0,No user reviews,0,0,0
604360,True,0,No user reviews,0,0,0
604380,True,0,1 user reviews,1,0,1
604390,True,0,No user reviews,0,0,0
604400,True,0,No user reviews,0,0,0
604401,True,0,No user reviews,0,0,0
604410,True,0,No user reviews,0,0,0
604411,True,0,No user reviews,0,0,0
604420,True,0,No user reviews,0,0,0
604421,True,0,No user reviews,0,0,0
604430,True,0,No user reviews,0,0,0
604440,True,0,No user reviews,0,0,0
604450,True,8,Very Positive,198,32,230
604470,True,0,No user reviews,0,0,0
604480,True,0,No user reviews,0,0,0
604490,True,6,Mostly Positive,388,134,522
604500,True,0,No user reviews,0,0,0
604510,True,7,Positive,29,1,30
604520,True,0,No user reviews,0,0,0
604530,True,0,No user reviews,0,0,0
604540,True,0,No user reviews,0,0,0
604550,True,0,1 user reviews,0,1,1
604580,True,0,No user reviews,0,0,0
604600,True,0,1 user reviews,0,1,1
604601,True,0,1 user reviews,0,1,1
604602,True,0,1 user reviews,0,1,1
604610,True,0,1 user reviews,0,1,1
604630,True,0,4 user reviews,3,1,4
604640,True,0,2 user reviews,1,1,2
604650,True,0,No user reviews,0,0,0
604660,True,0,No user reviews,0,0,0
604661,True,0,No user reviews,0,0,0
604662,True,0,No user reviews,0,0,0
604663,True,0,No user reviews,0,0,0
604664,True,0,No user reviews,0,0,0
604665,True,0,No user reviews,0,0,0
604666,True,0,No user reviews,0,0,0
604667,True,0,No user reviews,0,0,0
604668,True,0,No user reviews,0,0,0
604669,True,0,No user reviews,0,0,0
604670,True,0,No user reviews,0,0,0
604671,True,0,No user reviews,0,0,0
604672,True,0,No user reviews,0,0,0
604673,True,0,No user reviews,0,0,0
604674,True,0,No user reviews,0,0,0
604675,True,0,No user reviews,0,0,0
604676,True,0,No user reviews,0,0,0
604677,True,0,No user reviews,0,0,0
604678,True,0,No user reviews,0,0,0
604679,True,0,No user reviews,0,0,0
604680,True,0,No user reviews,0,0,0
604681,True,0,No user reviews,0,0,0
604682,True,0,No user reviews,0,0,0
604683,True,0,No user reviews,0,0,0
604684,True,0,No user reviews,0,0,0
604685,True,0,No user reviews,0,0,0
604686,True,0,No user reviews,0,0,0
604687,True,0,No user reviews,0,0,0
604688,True,0,No user reviews,0,0,0
604689,True,0,No user reviews,0,0,0
604690,True,0,No user reviews,0,0,0
604691,True,0,No user reviews,0,0,0
604692,True,0,No user reviews,0,0,0
604693,True,0,No user reviews,0,0,0
604694,True,0,No user reviews,0,0,0
604695,True,0,No user reviews,0,0,0
604696,True,0,No user reviews,0,0,0
604697,True,0,No user reviews,0,0,0
604698,True,0,No user reviews,0,0,0
604699,True,0,No user reviews,0,0,0
604700,True,0,No user reviews,0,0,0
604701,True,0,No user reviews,0,0,0
604702,True,0,No user reviews,0,0,0
604703,True,0,No user reviews,0,0,0
604704,True,0,No user reviews,0,0,0
604705,True,0,No user reviews,0,0,0
604706,True,0,No user reviews,0,0,0
604707,True,0,No user reviews,0,0,0
604708,True,0,No user reviews,0,0,0
604709,True,0,No user reviews,0,0,0
604710,True,0,No user reviews,0,0,0
604711,True,0,No user reviews,0,0,0
604712,True,0,No user reviews,0,0,0
604713,True,0,No user reviews,0,0,0
604714,True,0,No user reviews,0,0,0
604715,True,0,No user reviews,0,0,0
604716,True,0,No user reviews,0,0,0
604717,True,0,No user reviews,0,0,0
604718,True,0,No user reviews,0,0,0
604719,True,0,No user reviews,0,0,0
604720,True,0,No user reviews,0,0,0
604721,True,0,No user reviews,0,0,0
604722,True,0,No user reviews,0,0,0
604723,True,0,No user reviews,0,0,0
604730,True,0,No user reviews,0,0,0
604740,True,5,Mixed,80,37,117
604770,True,0,7 user reviews,7,0,7
604780,True,6,Mostly Positive,120,35,155
604800,True,0,No user reviews,0,0,0
604830,True,0,8 user reviews,4,4,8
604840,True,0,No user reviews,0,0,0
604860,True,0,No user reviews,0,0,0
604870,True,0,No user reviews,0,0,0
604890,True,0,No user reviews,0,0,0
604900,True,0,6 user reviews,6,0,6
604920,True,0,9 user reviews,9,0,9
604930,True,0,No user reviews,0,0,0
604940,True,0,No user reviews,0,0,0
604950,True,0,No user reviews,0,0,0
604980,True,0,5 user reviews,5,0,5
604990,True,0,1 user reviews,1,0,1
605010,True,0,No user reviews,0,0,0
605020,True,0,No user reviews,0,0,0
605030,True,0,No user reviews,0,0,0
605040,True,0,1 user reviews,0,1,1
605050,True,0,No user reviews,0,0,0
605060,True,0,No user reviews,0,0,0
605070,True,0,No user reviews,0,0,0
605100,True,5,Mixed,8,9,17
605110,True,0,4 user reviews,1,3,4
605140,True,5,Mixed,13,11,24
605160,True,0,5 user reviews,2,3,5
605170,True,0,No user reviews,0,0,0
605180,True,5,Mixed,21,11,32
605190,True,7,Positive,16,2,18
605200,True,0,9 user reviews,6,3,9
605210,True,0,4 user reviews,3,1,4
605230,True,8,Very Positive,265,42,307
605250,True,7,Positive,19,1,20
605270,True,0,3 user reviews,3,0,3
605280,True,0,1 user reviews,1,0,1
605300,True,0,No user reviews,0,0,0
605310,True,5,Mixed,15,9,24
605320,True,0,No user reviews,0,0,0
605321,True,0,No user reviews,0,0,0
605322,True,0,No user reviews,0,0,0
605323,True,0,No user reviews,0,0,0
605324,True,0,No user reviews,0,0,0
605325,True,0,1 user reviews,1,0,1
605326,True,0,No user reviews,0,0,0
605327,True,0,No user reviews,0,0,0
605328,True,0,1 user reviews,1,0,1
605330,True,0,No user reviews,0,0,0
605331,True,0,No user reviews,0,0,0
605332,True,0,No user reviews,0,0,0
605333,True,0,No user reviews,0,0,0
605334,True,0,1 user reviews,0,1,1
605335,True,0,No user reviews,0,0,0
605350,True,0,No user reviews,0,0,0
605351,True,0,No user reviews,0,0,0
605352,True,0,No user reviews,0,0,0
605353,True,0,No user reviews,0,0,0
605354,True,0,No user reviews,0,0,0
605360,True,0,No user reviews,0,0,0
605361,True,0,No user reviews,0,0,0
605410,True,0,3 user reviews,1,2,3
605420,True,0,No user reviews,0,0,0
605430,True,0,1 user reviews,1,0,1
605440,True,0,No user reviews,0,0,0
605450,True,8,Very Positive,529,66,595
605480,True,0,No user reviews,0,0,0
605490,True,0,2 user reviews,1,1,2
605540,True,0,3 user reviews,1,2,3
605550,True,8,Very Positive,50,8,58
605560,True,4,Mostly Negative,3,7,10
605570,True,0,No user reviews,0,0,0
605580,True,0,No user reviews,0,0,0
605581,True,0,No user reviews,0,0,0
605582,True,0,No user reviews,0,0,0
605583,True,0,No user reviews,0,0,0
605584,True,0,No user reviews,0,0,0
605585,True,0,No user reviews,0,0,0
605586,True,0,No user reviews,0,0,0
605587,True,0,No user reviews,0,0,0
605588,True,0,No user reviews,0,0,0
605590,True,0,No user reviews,0,0,0
605600,True,0,No user reviews,0,0,0
605601,True,0,No user reviews,0,0,0
605602,True,0,No user reviews,0,0,0
605603,True,0,No user reviews,0,0,0
605604,True,0,No user reviews,0,0,0
605610,True,0,No user reviews,0,0,0
605660,True,0,No user reviews,0,0,0
605670,True,0,No user reviews,0,0,0
605690,True,0,No user reviews,0,0,0
605700,True,0,No user reviews,0,0,0
605730,True,0,No user reviews,0,0,0
605740,True,8,Very Positive,3569,567,4136
605750,True,0,No user reviews,0,0,0
605751,True,0,No user reviews,0,0,0
605752,True,0,No user reviews,0,0,0
605753,True,0,No user reviews,0,0,0
605760,True,5,Mixed,17,22,39
605770,True,7,Positive,44,4,48
605780,True,0,2 user reviews,0,2,2
605790,True,0,4 user reviews,4,0,4
605800,True,5,Mixed,15,8,23
605810,True,0,No user reviews,0,0,0
605830,True,8,Very Positive,130,16,146
605850,True,0,No user reviews,0,0,0
605860,True,0,3 user reviews,0,3,3
605880,True,0,No user reviews,0,0,0
605890,True,0,No user reviews,0,0,0
605920,True,7,Positive,27,6,33
605930,True,0,2 user reviews,2,0,2
605951,True,0,No user reviews,0,0,0
605953,True,0,No user reviews,0,0,0
605954,True,0,No user reviews,0,0,0
605955,True,0,No user reviews,0,0,0
605956,True,0,No user reviews,0,0,0
605957,True,0,No user reviews,0,0,0
605958,True,0,No user reviews,0,0,0
605959,True,0,No user reviews,0,0,0
605960,True,0,No user reviews,0,0,0
605961,True,0,No user reviews,0,0,0
605980,True,0,No user reviews,0,0,0
605990,True,8,Very Positive,72,1,73
606000,True,6,Mostly Positive,17,5,22
606010,True,0,No user reviews,0,0,0
606030,True,0,4 user reviews,2,2,4
606060,True,0,5 user reviews,1,4,5
606080,True,5,Mixed,9,6,15
606090,True,0,No user reviews,0,0,0
606100,True,0,1 user reviews,1,0,1
606140,True,0,1 user reviews,0,1,1
606150,True,8,Very Positive,2677,555,3232
606170,True,0,No user reviews,0,0,0
606180,True,0,No user reviews,0,0,0
606190,True,0,6 user reviews,5,1,6
606210,True,0,No user reviews,0,0,0
606220,True,0,No user reviews,0,0,0
606230,True,6,Mostly Positive,605,168,773
606270,True,0,3 user reviews,1,2,3
606280,True,6,Mostly Positive,2051,618,2669
606290,True,0,No user reviews,0,0,0
606300,True,0,3 user reviews,2,1,3
606320,True,0,1 user reviews,0,1,1
606321,True,0,2 user reviews,1,1,2
606330,True,8,Very Positive,47,8,55
606350,True,0,No user reviews,0,0,0
606360,True,0,7 user reviews,5,2,7
606370,True,6,Mostly Positive,47,14,61
606390,True,0,No user reviews,0,0,0
606400,True,0,1 user reviews,1,0,1
606401,True,0,No user reviews,0,0,0
606402,True,0,No user reviews,0,0,0
606403,True,0,No user reviews,0,0,0
606404,True,0,No user reviews,0,0,0
606405,True,0,No user reviews,0,0,0
606406,True,0,No user reviews,0,0,0
606407,True,0,No user reviews,0,0,0
606408,True,0,No user reviews,0,0,0
606409,True,0,No user reviews,0,0,0
606410,True,0,No user reviews,0,0,0
606411,True,0,No user reviews,0,0,0
606420,True,0,No user reviews,0,0,0
606440,True,0,5 user reviews,3,2,5
606441,True,0,1 user reviews,1,0,1
606442,True,0,No user reviews,0,0,0
606443,True,0,No user reviews,0,0,0
606444,True,0,No user reviews,0,0,0
606445,True,0,No user reviews,0,0,0
606446,True,0,No user reviews,0,0,0
606447,True,0,No user reviews,0,0,0
606448,True,0,No user reviews,0,0,0
606449,True,0,No user reviews,0,0,0
606450,True,0,No user reviews,0,0,0
606451,True,0,No user reviews,0,0,0
606460,True,0,2 user reviews,2,0,2
606461,True,0,No user reviews,0,0,0
606462,True,0,No user reviews,0,0,0
606463,True,0,No user reviews,0,0,0
606464,True,0,No user reviews,0,0,0
606465,True,0,No user reviews,0,0,0
606466,True,0,No user reviews,0,0,0
606467,True,0,No user reviews,0,0,0
606468,True,0,No user reviews,0,0,0
606469,True,0,No user reviews,0,0,0
606470,True,0,No user reviews,0,0,0
606471,True,0,No user reviews,0,0,0
606480,True,7,Positive,37,5,42
606490,True,7,Positive,29,6,35
606500,True,6,Mostly Positive,463,116,579
606510,True,8,Very Positive,51,10,61
606520,True,7,Positive,11,1,12
606530,True,0,No user reviews,0,0,0
606540,True,0,1 user reviews,1,0,1
606541,True,0,No user reviews,0,0,0
606542,True,0,No user reviews,0,0,0
606543,True,0,No user reviews,0,0,0
606544,True,0,No user reviews,0,0,0
606545,True,0,No user reviews,0,0,0
606546,True,0,No user reviews,0,0,0
606547,True,0,No user reviews,0,0,0
606548,True,0,No user reviews,0,0,0
606549,True,0,No user reviews,0,0,0
606550,True,0,No user reviews,0,0,0
606551,True,0,No user reviews,0,0,0
606560,True,0,No user reviews,0,0,0
606561,True,0,No user reviews,0,0,0
606562,True,0,No user reviews,0,0,0
606563,True,0,No user reviews,0,0,0
606564,True,0,No user reviews,0,0,0
606565,True,0,No user reviews,0,0,0
606566,True,0,No user reviews,0,0,0
606567,True,0,No user reviews,0,0,0
606568,True,0,No user reviews,0,0,0
606569,True,0,No user reviews,0,0,0
606570,True,0,No user reviews,0,0,0
606571,True,0,No user reviews,0,0,0
606572,True,0,No user reviews,0,0,0
606580,True,0,1 user reviews,1,0,1
606581,True,0,No user reviews,0,0,0
606582,True,0,No user reviews,0,0,0
606583,True,0,No user reviews,0,0,0
606584,True,0,No user reviews,0,0,0
606585,True,0,No user reviews,0,0,0
606586,True,0,No user reviews,0,0,0
606587,True,0,No user reviews,0,0,0
606588,True,0,No user reviews,0,0,0
606589,True,0,No user reviews,0,0,0
606590,True,0,No user reviews,0,0,0
606591,True,0,No user reviews,0,0,0
606592,True,0,No user reviews,0,0,0
606600,True,0,1 user reviews,0,1,1
606601,True,0,No user reviews,0,0,0
606602,True,0,No user reviews,0,0,0
606603,True,0,No user reviews,0,0,0
606604,True,0,No user reviews,0,0,0
606605,True,0,No user reviews,0,0,0
606606,True,0,No user reviews,0,0,0
606607,True,0,No user reviews,0,0,0
606608,True,0,No user reviews,0,0,0
606609,True,0,No user reviews,0,0,0
606610,True,0,No user reviews,0,0,0
606611,True,0,No user reviews,0,0,0
606612,True,0,No user reviews,0,0,0
606613,True,0,No user reviews,0,0,0
606614,True,0,No user reviews,0,0,0
606615,True,0,No user reviews,0,0,0
606616,True,0,No user reviews,0,0,0
606617,True,0,No user reviews,0,0,0
606618,True,0,No user reviews,0,0,0
606619,True,0,No user reviews,0,0,0
606620,True,0,No user reviews,0,0,0
606621,True,0,No user reviews,0,0,0
606622,True,0,No user reviews,0,0,0
606623,True,0,No user reviews,0,0,0
606624,True,0,No user reviews,0,0,0
606625,True,0,No user reviews,0,0,0
606626,True,0,No user reviews,0,0,0
606627,True,0,No user reviews,0,0,0
606628,True,0,No user reviews,0,0,0
606629,True,0,No user reviews,0,0,0
606630,True,0,No user reviews,0,0,0
606631,True,0,No user reviews,0,0,0
606632,True,0,No user reviews,0,0,0
606633,True,0,No user reviews,0,0,0
606634,True,0,No user reviews,0,0,0
606635,True,0,No user reviews,0,0,0
606636,True,0,No user reviews,0,0,0
606637,True,0,No user reviews,0,0,0
606638,True,0,No user reviews,0,0,0
606639,True,0,No user reviews,0,0,0
606640,True,0,No user reviews,0,0,0
606641,True,0,No user reviews,0,0,0
606642,True,0,No user reviews,0,0,0
606643,True,0,No user reviews,0,0,0
606644,True,0,No user reviews,0,0,0
606645,True,0,No user reviews,0,0,0
606646,True,0,No user reviews,0,0,0
606647,True,0,No user reviews,0,0,0
606648,True,0,No user reviews,0,0,0
606649,True,0,2 user reviews,1,1,2
606650,True,0,No user reviews,0,0,0
606651,True,0,No user reviews,0,0,0
606652,True,0,No user reviews,0,0,0
606653,True,0,No user reviews,0,0,0
606654,True,0,No user reviews,0,0,0
606655,True,0,No user reviews,0,0,0
606656,True,0,No user reviews,0,0,0
606657,True,0,No user reviews,0,0,0
606658,True,0,No user reviews,0,0,0
606659,True,0,No user reviews,0,0,0
606660,True,0,No user reviews,0,0,0
606661,True,0,No user reviews,0,0,0
606670,True,0,No user reviews,0,0,0
606680,True,8,Very Positive,130,7,137
606690,True,7,Positive,19,3,22
606710,True,8,Very Positive,213,18,231
606720,True,0,1 user reviews,1,0,1
606730,True,5,Mixed,59,38,97
606740,True,0,No user reviews,0,0,0
606790,True,0,4 user reviews,3,1,4
606800,True,6,Mostly Positive,1547,387,1934
606820,True,0,No user reviews,0,0,0
606850,True,0,2 user reviews,2,0,2
606860,True,5,Mixed,77,48,125
606870,True,7,Positive,12,2,14
606880,True,6,Mostly Positive,4468,1120,5588
606890,True,6,Mostly Positive,47,15,62
606920,True,8,Very Positive,65,1,66
606940,True,7,Positive,13,2,15
606950,True,0,9 user reviews,5,4,9
606960,True,5,Mixed,36,42,78
606970,True,0,No user reviews,0,0,0
606971,True,7,Positive,18,2,20
606980,True,0,No user reviews,0,0,0
607020,True,0,6 user reviews,4,2,6
607030,True,0,7 user reviews,3,4,7
607040,True,5,Mixed,6,5,11
607050,True,8,Very Positive,1464,254,1718
607070,True,0,No user reviews,0,0,0
607080,True,0,No user reviews,0,0,0
607090,True,0,3 user reviews,3,0,3
607100,True,0,No user reviews,0,0,0
607120,True,5,Mixed,23,11,34
607143,True,0,No user reviews,0,0,0
607160,True,0,2 user reviews,2,0,2
607190,True,0,2 user reviews,1,1,2
607200,True,0,1 user reviews,1,0,1
607210,True,5,Mixed,6,6,12
607220,True,0,No user reviews,0,0,0
607230,True,0,No user reviews,0,0,0
607250,True,0,2 user reviews,1,1,2
607260,True,0,No user reviews,0,0,0
607270,True,0,6 user reviews,4,2,6
607330,True,7,Positive,13,0,13
607340,True,0,No user reviews,0,0,0
607350,True,0,2 user reviews,0,2,2
607360,True,0,5 user reviews,4,1,5
607380,True,8,Very Positive,48,3,51
607400,True,8,Very Positive,72,6,78
607440,True,0,3 user reviews,1,2,3
607450,True,0,No user reviews,0,0,0
607460,True,0,No user reviews,0,0,0
607480,True,0,No user reviews,0,0,0
607490,True,0,7 user reviews,7,0,7
607500,True,0,No user reviews,0,0,0
607510,True,0,No user reviews,0,0,0
607540,True,0,No user reviews,0,0,0
607550,True,0,No user reviews,0,0,0
607560,True,0,9 user reviews,9,0,9
607570,True,0,No user reviews,0,0,0
607580,True,0,No user reviews,0,0,0
607590,True,0,7 user reviews,6,1,7
607600,True,0,2 user reviews,2,0,2
607601,True,0,No user reviews,0,0,0
607602,True,0,No user reviews,0,0,0
607603,True,0,No user reviews,0,0,0
607604,True,0,No user reviews,0,0,0
607605,True,0,No user reviews,0,0,0
607606,True,0,No user reviews,0,0,0
607607,True,0,No user reviews,0,0,0
607608,True,0,No user reviews,0,0,0
607609,True,0,No user reviews,0,0,0
607610,True,0,No user reviews,0,0,0
607611,True,0,No user reviews,0,0,0
607612,True,0,No user reviews,0,0,0
607613,True,0,No user reviews,0,0,0
607614,True,0,No user reviews,0,0,0
607615,True,0,No user reviews,0,0,0
607616,True,0,No user reviews,0,0,0
607617,True,0,No user reviews,0,0,0
607618,True,0,No user reviews,0,0,0
607619,True,0,No user reviews,0,0,0
607620,True,0,No user reviews,0,0,0
607621,True,0,No user reviews,0,0,0
607622,True,0,No user reviews,0,0,0
607623,True,0,No user reviews,0,0,0
607650,True,0,No user reviews,0,0,0
607660,True,5,Mixed,14,8,22
607670,True,0,5 user reviews,3,2,5
607680,True,0,5 user reviews,3,2,5
607690,True,0,4 user reviews,0,4,4
607710,True,0,No user reviews,0,0,0
607720,True,0,6 user reviews,4,2,6
607730,True,0,No user reviews,0,0,0
607760,True,0,9 user reviews,8,1,9
607770,True,0,2 user reviews,2,0,2
607780,True,0,3 user reviews,3,0,3
607820,True,8,Very Positive,49,5,54
607830,True,0,3 user reviews,2,1,3
607840,True,0,3 user reviews,3,0,3
607860,True,0,No user reviews,0,0,0
607880,True,6,Mostly Positive,168,57,225
607890,True,6,Mostly Positive,759,268,1027
607900,True,0,No user reviews,0,0,0
607901,True,0,No user reviews,0,0,0
607902,True,0,No user reviews,0,0,0
607903,True,0,No user reviews,0,0,0
607904,True,0,No user reviews,0,0,0
607905,True,0,No user reviews,0,0,0
607906,True,0,No user reviews,0,0,0
607907,True,0,No user reviews,0,0,0
607908,True,0,No user reviews,0,0,0
607909,True,0,No user reviews,0,0,0
607910,True,0,No user reviews,0,0,0
607911,True,0,No user reviews,0,0,0
607912,True,0,No user reviews,0,0,0
607913,True,0,No user reviews,0,0,0
607914,True,0,No user reviews,0,0,0
607915,True,0,No user reviews,0,0,0
607916,True,0,No user reviews,0,0,0
607917,True,0,No user reviews,0,0,0
607918,True,0,No user reviews,0,0,0
607919,True,0,No user reviews,0,0,0
607920,True,0,No user reviews,0,0,0
607921,True,0,No user reviews,0,0,0
607922,True,0,No user reviews,0,0,0
607923,True,0,No user reviews,0,0,0
607924,True,0,No user reviews,0,0,0
607925,True,0,No user reviews,0,0,0
607926,True,0,No user reviews,0,0,0
607927,True,0,No user reviews,0,0,0
607928,True,0,No user reviews,0,0,0
607929,True,0,No user reviews,0,0,0
607930,True,0,No user reviews,0,0,0
607931,True,0,No user reviews,0,0,0
607932,True,0,No user reviews,0,0,0
607933,True,0,No user reviews,0,0,0
607934,True,0,No user reviews,0,0,0
607935,True,0,No user reviews,0,0,0
607936,True,0,No user reviews,0,0,0
607937,True,0,No user reviews,0,0,0
607938,True,0,No user reviews,0,0,0
607939,True,0,No user reviews,0,0,0
607940,True,0,No user reviews,0,0,0
607941,True,0,No user reviews,0,0,0
607942,True,0,No user reviews,0,0,0
607943,True,0,No user reviews,0,0,0
607944,True,0,No user reviews,0,0,0
607945,True,0,No user reviews,0,0,0
607946,True,0,No user reviews,0,0,0
607947,True,0,No user reviews,0,0,0
607948,True,0,No user reviews,0,0,0
607949,True,0,No user reviews,0,0,0
607950,True,0,No user reviews,0,0,0
607951,True,0,No user reviews,0,0,0
607952,True,0,No user reviews,0,0,0
607953,True,0,No user reviews,0,0,0
607954,True,0,No user reviews,0,0,0
607955,True,0,No user reviews,0,0,0
607956,True,0,No user reviews,0,0,0
607957,True,0,No user reviews,0,0,0
607958,True,0,No user reviews,0,0,0
607960,True,0,No user reviews,0,0,0
607980,True,0,1 user reviews,1,0,1
607990,True,0,No user reviews,0,0,0
608000,True,0,No user reviews,0,0,0
608020,True,0,No user reviews,0,0,0
608031,True,0,No user reviews,0,0,0
608040,True,0,No user reviews,0,0,0
608050,True,0,No user reviews,0,0,0
608051,True,0,No user reviews,0,0,0
608052,True,0,No user reviews,0,0,0
608053,True,0,No user reviews,0,0,0
608060,True,0,No user reviews,0,0,0
608070,True,0,No user reviews,0,0,0
608071,True,0,No user reviews,0,0,0
608072,True,0,No user reviews,0,0,0
608073,True,0,No user reviews,0,0,0
608074,True,0,No user reviews,0,0,0
608075,True,0,No user reviews,0,0,0
608076,True,0,No user reviews,0,0,0
608077,True,0,No user reviews,0,0,0
608078,True,0,No user reviews,0,0,0
608079,True,0,No user reviews,0,0,0
608080,True,0,No user reviews,0,0,0
608081,True,0,No user reviews,0,0,0
608090,True,0,No user reviews,0,0,0
608100,True,0,No user reviews,0,0,0
608110,True,7,Positive,14,0,14
608120,True,8,Very Positive,102,13,115
608140,True,0,No user reviews,0,0,0
608150,True,0,No user reviews,0,0,0
608160,True,0,6 user reviews,6,0,6
608170,True,0,2 user reviews,2,0,2
608180,True,0,4 user reviews,4,0,4
608190,True,5,Mixed,5,5,10
608200,True,0,No user reviews,0,0,0
608210,True,0,No user reviews,0,0,0
608220,True,0,No user reviews,0,0,0
608230,True,0,1 user reviews,1,0,1
608231,True,0,No user reviews,0,0,0
608232,True,0,No user reviews,0,0,0
608233,True,0,No user reviews,0,0,0
608234,True,0,No user reviews,0,0,0
608235,True,0,No user reviews,0,0,0
608236,True,0,No user reviews,0,0,0
608237,True,0,No user reviews,0,0,0
608238,True,0,No user reviews,0,0,0
608239,True,0,No user reviews,0,0,0
608240,True,0,No user reviews,0,0,0
608241,True,0,1 user reviews,0,1,1
608250,True,0,3 user reviews,3,0,3
608251,True,0,No user reviews,0,0,0
608252,True,0,No user reviews,0,0,0
608253,True,0,No user reviews,0,0,0
608254,True,0,No user reviews,0,0,0
608255,True,0,1 user reviews,1,0,1
608256,True,0,No user reviews,0,0,0
608257,True,0,No user reviews,0,0,0
608258,True,0,No user reviews,0,0,0
608259,True,0,No user reviews,0,0,0
608260,True,0,No user reviews,0,0,0
608261,True,0,2 user reviews,2,0,2
608270,True,0,6 user reviews,5,1,6
608271,True,0,1 user reviews,1,0,1
608272,True,0,No user reviews,0,0,0
608273,True,0,No user reviews,0,0,0
608274,True,0,No user reviews,0,0,0
608275,True,0,No user reviews,0,0,0
608276,True,0,No user reviews,0,0,0
608277,True,0,No user reviews,0,0,0
608278,True,0,No user reviews,0,0,0
608279,True,0,No user reviews,0,0,0
608280,True,0,1 user reviews,1,0,1
608281,True,0,No user reviews,0,0,0
608282,True,0,No user reviews,0,0,0
608283,True,0,No user reviews,0,0,0
608284,True,0,No user reviews,0,0,0
608285,True,0,No user reviews,0,0,0
608286,True,0,No user reviews,0,0,0
608287,True,0,3 user reviews,3,0,3
608288,True,0,No user reviews,0,0,0
608289,True,0,No user reviews,0,0,0
608290,True,0,No user reviews,0,0,0
608291,True,0,No user reviews,0,0,0
608292,True,0,No user reviews,0,0,0
608293,True,0,No user reviews,0,0,0
608294,True,0,3 user reviews,2,1,3
608300,True,0,1 user reviews,1,0,1
608301,True,0,No user reviews,0,0,0
608302,True,0,No user reviews,0,0,0
608303,True,0,No user reviews,0,0,0
608304,True,0,No user reviews,0,0,0
608305,True,0,No user reviews,0,0,0
608306,True,0,No user reviews,0,0,0
608307,True,0,No user reviews,0,0,0
608308,True,0,No user reviews,0,0,0
608309,True,0,No user reviews,0,0,0
608310,True,0,No user reviews,0,0,0
608311,True,0,No user reviews,0,0,0
608312,True,0,No user reviews,0,0,0
608330,True,0,1 user reviews,1,0,1
608331,True,0,No user reviews,0,0,0
608332,True,0,No user reviews,0,0,0
608333,True,0,No user reviews,0,0,0
608334,True,0,No user reviews,0,0,0
608335,True,0,No user reviews,0,0,0
608336,True,0,No user reviews,0,0,0
608337,True,0,No user reviews,0,0,0
608338,True,0,No user reviews,0,0,0
608339,True,0,No user reviews,0,0,0
608340,True,0,No user reviews,0,0,0
608341,True,0,No user reviews,0,0,0
608350,True,0,No user reviews,0,0,0
608351,True,0,No user reviews,0,0,0
608352,True,0,No user reviews,0,0,0
608353,True,0,No user reviews,0,0,0
608354,True,0,No user reviews,0,0,0
608355,True,0,No user reviews,0,0,0
608356,True,0,No user reviews,0,0,0
608357,True,0,No user reviews,0,0,0
608358,True,0,No user reviews,0,0,0
608359,True,0,No user reviews,0,0,0
608370,True,6,Mostly Positive,28,12,40
608420,True,0,3 user reviews,3,0,3
608440,True,0,No user reviews,0,0,0
608450,True,0,2 user reviews,2,0,2
608460,True,7,Positive,11,2,13
608470,True,0,No user reviews,0,0,0
608480,True,0,No user reviews,0,0,0
608510,True,0,No user reviews,0,0,0
608530,True,5,Mixed,41,60,101
608540,True,0,5 user reviews,2,3,5
608580,True,5,Mixed,5,7,12
608590,True,0,No user reviews,0,0,0
608600,True,0,No user reviews,0,0,0
608610,True,0,No user reviews,0,0,0
608620,True,0,No user reviews,0,0,0
608630,True,0,1 user reviews,1,0,1
608650,True,0,No user reviews,0,0,0
608660,True,7,Positive,26,4,30
608670,True,7,Positive,10,0,10
608680,True,5,Mixed,17,22,39
608720,True,0,2 user reviews,2,0,2
608730,True,0,1 user reviews,0,1,1
608740,True,0,No user reviews,0,0,0
608760,True,7,Positive,18,2,20
608800,True,6,Mostly Positive,275,76,351
608810,True,0,No user reviews,0,0,0
608830,True,3,Negative,3,13,16
608840,True,0,No user reviews,0,0,0
608850,True,0,No user reviews,0,0,0
608870,True,7,Positive,24,3,27
608880,True,0,3 user reviews,3,0,3
608890,True,0,4 user reviews,4,0,4
608891,True,0,1 user reviews,1,0,1
608892,True,0,1 user reviews,1,0,1
608893,True,0,1 user reviews,1,0,1
608894,True,0,2 user reviews,2,0,2
608895,True,0,1 user reviews,1,0,1
608896,True,0,No user reviews,0,0,0
608897,True,0,No user reviews,0,0,0
608898,True,0,No user reviews,0,0,0
608899,True,0,No user reviews,0,0,0
608900,True,0,No user reviews,0,0,0
608901,True,0,1 user reviews,1,0,1
608910,True,0,No user reviews,0,0,0
608911,True,0,No user reviews,0,0,0
608912,True,0,No user reviews,0,0,0
608913,True,0,No user reviews,0,0,0
608914,True,0,No user reviews,0,0,0
608915,True,0,No user reviews,0,0,0
608916,True,0,No user reviews,0,0,0
608917,True,0,No user reviews,0,0,0
608918,True,0,No user reviews,0,0,0
608919,True,0,No user reviews,0,0,0
608920,True,0,No user reviews,0,0,0
608921,True,0,No user reviews,0,0,0
608922,True,0,No user reviews,0,0,0
608923,True,0,No user reviews,0,0,0
608924,True,0,No user reviews,0,0,0
608925,True,0,No user reviews,0,0,0
608926,True,0,No user reviews,0,0,0
608927,True,0,No user reviews,0,0,0
608928,True,0,No user reviews,0,0,0
608929,True,0,No user reviews,0,0,0
608930,True,0,No user reviews,0,0,0
608931,True,0,No user reviews,0,0,0
608932,True,0,No user reviews,0,0,0
608933,True,0,No user reviews,0,0,0
608934,True,0,No user reviews,0,0,0
608935,True,0,No user reviews,0,0,0
608936,True,0,No user reviews,0,0,0
608937,True,0,No user reviews,0,0,0
608938,True,0,No user reviews,0,0,0
608939,True,0,No user reviews,0,0,0
608940,True,0,No user reviews,0,0,0
608941,True,0,No user reviews,0,0,0
608942,True,0,No user reviews,0,0,0
608943,True,0,No user reviews,0,0,0
608944,True,0,No user reviews,0,0,0
608945,True,0,No user reviews,0,0,0
608946,True,0,No user reviews,0,0,0
608947,True,0,No user reviews,0,0,0
608948,True,0,No user reviews,0,0,0
608949,True,0,No user reviews,0,0,0
608950,True,0,No user reviews,0,0,0
608951,True,0,No user reviews,0,0,0
608952,True,0,No user reviews,0,0,0
608953,True,0,No user reviews,0,0,0
608954,True,0,No user reviews,0,0,0
608955,True,0,No user reviews,0,0,0
608956,True,0,No user reviews,0,0,0
608957,True,0,No user reviews,0,0,0
608958,True,0,No user reviews,0,0,0
608960,True,0,No user reviews,0,0,0
608961,True,0,No user reviews,0,0,0
608962,True,0,No user reviews,0,0,0
608963,True,0,No user reviews,0,0,0
608964,True,0,No user reviews,0,0,0
608965,True,0,No user reviews,0,0,0
608966,True,0,No user reviews,0,0,0
608967,True,0,No user reviews,0,0,0
608968,True,0,No user reviews,0,0,0
608969,True,0,No user reviews,0,0,0
608970,True,0,No user reviews,0,0,0
608971,True,0,No user reviews,0,0,0
608980,True,0,No user reviews,0,0,0
608990,True,5,Mixed,100,87,187
609010,True,7,Positive,8,2,10
609020,True,0,3 user reviews,2,1,3
609021,True,0,No user reviews,0,0,0
609022,True,0,No user reviews,0,0,0
609023,True,0,No user reviews,0,0,0
609024,True,0,No user reviews,0,0,0
609025,True,0,No user reviews,0,0,0
609026,True,0,No user reviews,0,0,0
609027,True,0,No user reviews,0,0,0
609028,True,0,No user reviews,0,0,0
609029,True,0,No user reviews,0,0,0
609030,True,0,No user reviews,0,0,0
609031,True,0,No user reviews,0,0,0
609032,True,0,No user reviews,0,0,0
609033,True,0,No user reviews,0,0,0
609034,True,0,No user reviews,0,0,0
609035,True,0,No user reviews,0,0,0
609036,True,0,No user reviews,0,0,0
609037,True,0,No user reviews,0,0,0
609038,True,0,No user reviews,0,0,0
609039,True,0,No user reviews,0,0,0
609040,True,0,No user reviews,0,0,0
609041,True,0,No user reviews,0,0,0
609042,True,0,No user reviews,0,0,0
609043,True,0,No user reviews,0,0,0
609044,True,0,No user reviews,0,0,0
609045,True,0,No user reviews,0,0,0
609046,True,0,No user reviews,0,0,0
609047,True,0,No user reviews,0,0,0
609048,True,0,No user reviews,0,0,0
609049,True,0,No user reviews,0,0,0
609050,True,0,No user reviews,0,0,0
609051,True,0,No user reviews,0,0,0
609052,True,0,No user reviews,0,0,0
609053,True,0,No user reviews,0,0,0
609054,True,0,No user reviews,0,0,0
609055,True,0,No user reviews,0,0,0
609056,True,0,No user reviews,0,0,0
609057,True,0,No user reviews,0,0,0
609058,True,0,No user reviews,0,0,0
609059,True,0,No user reviews,0,0,0
609060,True,0,No user reviews,0,0,0
609061,True,0,No user reviews,0,0,0
609062,True,0,No user reviews,0,0,0
609063,True,0,No user reviews,0,0,0
609064,True,0,No user reviews,0,0,0
609065,True,0,No user reviews,0,0,0
609066,True,0,No user reviews,0,0,0
609067,True,0,No user reviews,0,0,0
609068,True,0,No user reviews,0,0,0
609069,True,0,No user reviews,0,0,0
609070,True,0,No user reviews,0,0,0
609100,True,0,6 user reviews,2,4,6
609110,True,8,Very Positive,209,19,228
609120,True,0,3 user reviews,3,0,3
609150,True,6,Mostly Positive,379,162,541
609170,True,5,Mixed,9,9,18
609200,True,0,1 user reviews,1,0,1
609220,True,0,No user reviews,0,0,0
609240,True,0,No user reviews,0,0,0
609250,True,0,No user reviews,0,0,0
609260,True,0,1 user reviews,1,0,1
609270,True,0,No user reviews,0,0,0
609280,True,0,No user reviews,0,0,0
609290,True,0,No user reviews,0,0,0
609300,True,0,No user reviews,0,0,0
609320,True,8,Very Positive,3053,245,3298
609340,True,0,1 user reviews,1,0,1
609360,True,0,No user reviews,0,0,0
609370,True,0,No user reviews,0,0,0
609380,True,0,No user reviews,0,0,0
609400,True,0,No user reviews,0,0,0
609410,True,6,Mostly Positive,22,8,30
609420,True,7,Positive,32,1,33
609430,True,0,No user reviews,0,0,0
609440,True,0,5 user reviews,5,0,5
609460,True,0,No user reviews,0,0,0
609470,True,0,No user reviews,0,0,0
609480,True,0,No user reviews,0,0,0
609490,True,8,Very Positive,537,46,583
609500,True,0,No user reviews,0,0,0
609510,True,0,No user reviews,0,0,0
609511,True,0,No user reviews,0,0,0
609512,True,0,No user reviews,0,0,0
609513,True,0,No user reviews,0,0,0
609514,True,0,No user reviews,0,0,0
609515,True,0,No user reviews,0,0,0
609520,True,0,No user reviews,0,0,0
609521,True,0,No user reviews,0,0,0
609522,True,0,No user reviews,0,0,0
609523,True,0,No user reviews,0,0,0
609524,True,0,No user reviews,0,0,0
609525,True,0,No user reviews,0,0,0
609530,True,0,No user reviews,0,0,0
609531,True,0,No user reviews,0,0,0
609532,True,0,No user reviews,0,0,0
609533,True,0,No user reviews,0,0,0
609534,True,0,No user reviews,0,0,0
609535,True,0,No user reviews,0,0,0
609540,True,0,No user reviews,0,0,0
609541,True,0,No user reviews,0,0,0
609542,True,0,No user reviews,0,0,0
609543,True,0,No user reviews,0,0,0
609544,True,0,No user reviews,0,0,0
609545,True,0,No user reviews,0,0,0
609546,True,0,No user reviews,0,0,0
609547,True,0,No user reviews,0,0,0
609548,True,0,No user reviews,0,0,0
609549,True,0,No user reviews,0,0,0
609550,True,0,No user reviews,0,0,0
609551,True,0,No user reviews,0,0,0
609560,True,0,No user reviews,0,0,0
609561,True,0,No user reviews,0,0,0
609562,True,0,No user reviews,0,0,0
609563,True,0,No user reviews,0,0,0
609564,True,0,No user reviews,0,0,0
609565,True,0,No user reviews,0,0,0
609566,True,0,No user reviews,0,0,0
609567,True,0,No user reviews,0,0,0
609568,True,0,No user reviews,0,0,0
609569,True,0,No user reviews,0,0,0
609570,True,0,No user reviews,0,0,0
609571,True,0,No user reviews,0,0,0
609580,True,0,No user reviews,0,0,0
609581,True,0,No user reviews,0,0,0
609582,True,0,No user reviews,0,0,0
609583,True,0,No user reviews,0,0,0
609584,True,0,No user reviews,0,0,0
609585,True,0,No user reviews,0,0,0
609586,True,0,No user reviews,0,0,0
609587,True,0,No user reviews,0,0,0
609588,True,0,No user reviews,0,0,0
609589,True,0,No user reviews,0,0,0
609590,True,0,No user reviews,0,0,0
609591,True,0,No user reviews,0,0,0
609600,True,0,No user reviews,0,0,0
609601,True,0,No user reviews,0,0,0
609602,True,0,No user reviews,0,0,0
609603,True,0,No user reviews,0,0,0
609604,True,0,No user reviews,0,0,0
609605,True,0,No user reviews,0,0,0
609606,True,0,No user reviews,0,0,0
609607,True,0,No user reviews,0,0,0
609608,True,0,No user reviews,0,0,0
609609,True,0,No user reviews,0,0,0
609610,True,0,No user reviews,0,0,0
609611,True,0,No user reviews,0,0,0
609612,True,0,No user reviews,0,0,0
609620,True,0,No user reviews,0,0,0
609621,True,0,No user reviews,0,0,0
609622,True,0,No user reviews,0,0,0
609623,True,0,No user reviews,0,0,0
609624,True,0,No user reviews,0,0,0
609625,True,0,No user reviews,0,0,0
609626,True,0,No user reviews,0,0,0
609627,True,0,No user reviews,0,0,0
609628,True,0,No user reviews,0,0,0
609629,True,0,No user reviews,0,0,0
609630,True,0,No user reviews,0,0,0
609631,True,0,No user reviews,0,0,0
609632,True,0,No user reviews,0,0,0
609640,True,0,No user reviews,0,0,0
609641,True,0,No user reviews,0,0,0
609642,True,0,No user reviews,0,0,0
609643,True,0,No user reviews,0,0,0
609644,True,0,No user reviews,0,0,0
609645,True,0,No user reviews,0,0,0
609646,True,0,No user reviews,0,0,0
609647,True,0,No user reviews,0,0,0
609648,True,0,No user reviews,0,0,0
609649,True,0,No user reviews,0,0,0
609650,True,0,No user reviews,0,0,0
609651,True,0,No user reviews,0,0,0
609652,True,0,No user reviews,0,0,0
609660,True,0,No user reviews,0,0,0
609661,True,0,No user reviews,0,0,0
609662,True,0,No user reviews,0,0,0
609663,True,0,No user reviews,0,0,0
609664,True,0,No user reviews,0,0,0
609665,True,0,No user reviews,0,0,0
609666,True,0,No user reviews,0,0,0
609667,True,0,No user reviews,0,0,0
609668,True,0,No user reviews,0,0,0
609669,True,0,No user reviews,0,0,0
609670,True,0,No user reviews,0,0,0
609671,True,0,No user reviews,0,0,0
609680,True,0,No user reviews,0,0,0
609681,True,0,No user reviews,0,0,0
609682,True,0,No user reviews,0,0,0
609683,True,0,No user reviews,0,0,0
609684,True,0,No user reviews,0,0,0
609685,True,0,No user reviews,0,0,0
609686,True,0,No user reviews,0,0,0
609687,True,0,No user reviews,0,0,0
609688,True,0,No user reviews,0,0,0
609689,True,0,No user reviews,0,0,0
609690,True,0,No user reviews,0,0,0
609691,True,0,No user reviews,0,0,0
609700,True,0,No user reviews,0,0,0
609720,True,0,3 user reviews,2,1,3
609730,True,0,No user reviews,0,0,0
609750,True,0,No user reviews,0,0,0
609760,True,7,Positive,21,3,24
609770,True,0,No user reviews,0,0,0
609800,True,4,Mostly Negative,11,22,33
609820,True,0,3 user reviews,2,1,3
609821,True,5,Mixed,16,17,33
609822,True,0,4 user reviews,4,0,4
609823,True,0,3 user reviews,0,3,3
609824,True,0,4 user reviews,3,1,4
609825,True,0,No user reviews,0,0,0
609826,True,5,Mixed,12,10,22
609827,True,0,5 user reviews,3,2,5
609828,True,0,4 user reviews,2,2,4
609829,True,0,4 user reviews,3,1,4
609830,True,0,No user reviews,0,0,0
609850,True,7,Positive,12,1,13
609870,True,0,No user reviews,0,0,0
609880,True,0,7 user reviews,6,1,7
609920,True,6,Mostly Positive,147,48,195
609940,True,0,No user reviews,0,0,0
609970,True,7,Positive,21,4,25
609980,True,0,No user reviews,0,0,0
609990,True,0,6 user reviews,6,0,6
610010,True,0,2 user reviews,1,1,2
610040,True,0,No user reviews,0,0,0
610050,True,0,No user reviews,0,0,0
610051,True,0,No user reviews,0,0,0
610060,True,0,No user reviews,0,0,0
610070,True,0,6 user reviews,5,1,6
610080,True,0,No user reviews,0,0,0
610090,True,0,5 user reviews,5,0,5
610100,True,0,No user reviews,0,0,0
610110,True,0,2 user reviews,2,0,2
610120,True,5,Mixed,6,5,11
610130,True,6,Mostly Positive,31,12,43
610150,True,0,No user reviews,0,0,0
610160,True,5,Mixed,40,32,72
610180,True,8,Very Positive,684,59,743
610190,True,8,Very Positive,107,25,132
610210,True,5,Mixed,7,10,17
610220,True,7,Positive,17,0,17
610221,True,0,2 user reviews,2,0,2
610222,True,0,5 user reviews,5,0,5
610250,True,7,Positive,14,0,14
610260,True,0,2 user reviews,0,2,2
610270,True,0,1 user reviews,1,0,1
610280,True,0,5 user reviews,5,0,5
610290,True,0,4 user reviews,2,2,4
610310,True,7,Positive,23,3,26
610330,True,0,No user reviews,0,0,0
610340,True,0,6 user reviews,4,2,6
610350,True,4,Mostly Negative,7,13,20
610360,True,8,Very Positive,401,33,434
610370,True,9,Overwhelmingly Positive,1163,36,1199
610380,True,5,Mixed,33,40,73
610400,True,7,Positive,39,4,43
610410,True,7,Positive,19,1,20
610420,True,0,No user reviews,0,0,0
610460,True,0,1 user reviews,1,0,1
610470,True,0,No user reviews,0,0,0
610480,True,0,No user reviews,0,0,0
610490,True,0,4 user reviews,3,1,4
610500,True,5,Mixed,58,28,86
610510,True,0,No user reviews,0,0,0
610520,True,7,Positive,10,1,11
610530,True,0,1 user reviews,1,0,1
610550,True,0,1 user reviews,1,0,1
610560,True,0,3 user reviews,2,1,3
610570,True,5,Mixed,11,12,23
610610,True,7,Positive,16,2,18
610620,True,0,No user reviews,0,0,0
610630,True,0,No user reviews,0,0,0
610640,True,0,1 user reviews,1,0,1
610650,True,0,No user reviews,0,0,0
610660,True,7,Positive,10,2,12
610670,True,4,Mostly Negative,6,19,25
610680,True,5,Mixed,25,27,52
610690,True,0,2 user reviews,2,0,2
610691,True,0,No user reviews,0,0,0
610692,True,0,4 user reviews,4,0,4
610693,True,7,Positive,12,1,13
610694,True,0,1 user reviews,1,0,1
610695,True,0,5 user reviews,3,2,5
610696,True,0,No user reviews,0,0,0
610697,True,0,1 user reviews,0,1,1
610698,True,0,4 user reviews,4,0,4
610699,True,0,8 user reviews,6,2,8
610700,True,0,9 user reviews,5,4,9
610701,True,0,7 user reviews,4,3,7
610702,True,0,2 user reviews,2,0,2
610703,True,5,Mixed,16,10,26
610704,True,5,Mixed,6,5,11
610705,True,0,7 user reviews,6,1,7
610720,True,0,No user reviews,0,0,0
610730,True,0,7 user reviews,5,2,7
610740,True,5,Mixed,9,4,13
610750,True,6,Mostly Positive,66,21,87
610760,True,0,No user reviews,0,0,0
610780,True,0,7 user reviews,2,5,7
610790,True,0,No user reviews,0,0,0
610810,True,5,Mixed,134,72,206
610820,True,0,No user reviews,0,0,0
610830,True,0,No user reviews,0,0,0
610840,True,6,Mostly Positive,25,8,33
610850,True,0,No user reviews,0,0,0
610860,True,5,Mixed,29,26,55
610870,True,0,No user reviews,0,0,0
610900,True,7,Positive,48,0,48
610910,True,0,2 user reviews,2,0,2
610940,True,0,No user reviews,0,0,0
610960,True,7,Positive,17,1,18
610970,True,0,3 user reviews,3,0,3
610980,True,0,7 user reviews,7,0,7
610990,True,0,No user reviews,0,0,0
611020,True,0,No user reviews,0,0,0
611040,True,6,Mostly Positive,149,62,211
611050,True,0,4 user reviews,2,2,4
611060,True,6,Mostly Positive,9,3,12
611080,True,0,No user reviews,0,0,0
611090,True,0,No user reviews,0,0,0
611110,True,5,Mixed,5,6,11
611120,True,0,No user reviews,0,0,0
611140,True,0,8 user reviews,4,4,8
611160,True,8,Very Positive,380,43,423
611170,True,0,No user reviews,0,0,0
611180,True,5,Mixed,36,37,73
611190,True,0,No user reviews,0,0,0
611200,True,0,No user reviews,0,0,0
611210,True,0,No user reviews,0,0,0
611220,True,0,No user reviews,0,0,0
611230,True,7,Positive,33,8,41
611250,True,0,No user reviews,0,0,0
611260,True,0,1 user reviews,1,0,1
611270,True,0,No user reviews,0,0,0
611300,True,0,No user reviews,0,0,0
611310,True,0,No user reviews,0,0,0
611320,True,7,Positive,14,3,17
611350,True,5,Mixed,30,19,49
611370,True,7,Positive,13,1,14
611390,True,0,6 user reviews,6,0,6
611400,True,7,Positive,12,3,15
611420,True,5,Mixed,9,5,14
611421,True,7,Positive,27,6,33
611430,True,0,1 user reviews,1,0,1
611431,True,0,No user reviews,0,0,0
611432,True,0,No user reviews,0,0,0
611440,True,0,No user reviews,0,0,0
611441,True,0,No user reviews,0,0,0
611442,True,0,No user reviews,0,0,0
611443,True,0,No user reviews,0,0,0
611444,True,0,No user reviews,0,0,0
611445,True,0,No user reviews,0,0,0
611446,True,0,No user reviews,0,0,0
611447,True,0,No user reviews,0,0,0
611448,True,0,No user reviews,0,0,0
611449,True,0,No user reviews,0,0,0
611450,True,0,No user reviews,0,0,0
611451,True,0,No user reviews,0,0,0
611452,True,0,No user reviews,0,0,0
611460,True,0,No user reviews,0,0,0
611470,True,0,No user reviews,0,0,0
611480,True,0,No user reviews,0,0,0
611481,True,0,No user reviews,0,0,0
611482,True,0,No user reviews,0,0,0
611483,True,0,No user reviews,0,0,0
611484,True,0,No user reviews,0,0,0
611485,True,0,No user reviews,0,0,0
611486,True,0,No user reviews,0,0,0
611487,True,0,No user reviews,0,0,0
611488,True,0,No user reviews,0,0,0
611489,True,0,No user reviews,0,0,0
611490,True,0,No user reviews,0,0,0
611491,True,0,No user reviews,0,0,0
611492,True,0,No user reviews,0,0,0
611493,True,0,No user reviews,0,0,0
611494,True,0,No user reviews,0,0,0
611495,True,0,No user reviews,0,0,0
611496,True,0,No user reviews,0,0,0
611497,True,0,No user reviews,0,0,0
611498,True,0,No user reviews,0,0,0
611500,True,6,Mostly Positive,2584,943,3527
611510,True,0,No user reviews,0,0,0
611511,True,0,No user reviews,0,0,0
611512,True,0,No user reviews,0,0,0
611513,True,0,No user reviews,0,0,0
611514,True,0,No user reviews,0,0,0
611520,True,0,No user reviews,0,0,0
611521,True,0,No user reviews,0,0,0
611522,True,0,No user reviews,0,0,0
611523,True,0,No user reviews,0,0,0
611524,True,0,No user reviews,0,0,0
611525,True,0,No user reviews,0,0,0
611526,True,0,No user reviews,0,0,0
611527,True,0,No user reviews,0,0,0
611528,True,0,No user reviews,0,0,0
611540,True,0,No user reviews,0,0,0
611541,True,0,No user reviews,0,0,0
611542,True,0,No user reviews,0,0,0
611543,True,0,No user reviews,0,0,0
611544,True,0,No user reviews,0,0,0
611545,True,0,No user reviews,0,0,0
611546,True,0,No user reviews,0,0,0
611547,True,0,No user reviews,0,0,0
611548,True,0,No user reviews,0,0,0
611549,True,0,No user reviews,0,0,0
611550,True,0,2 user reviews,2,0,2
611590,True,0,No user reviews,0,0,0
611620,True,5,Mixed,7,5,12
611630,True,7,Positive,16,3,19
611640,True,7,Positive,21,3,24
611650,True,0,No user reviews,0,0,0
611660,True,5,Mixed,1742,864,2606
611670,True,6,Mostly Positive,2422,724,3146
611690,True,0,6 user reviews,2,4,6
611710,True,7,Positive,14,0,14
611720,True,7,Positive,20,3,23
611730,True,0,3 user reviews,2,1,3
611740,True,0,5 user reviews,5,0,5
611750,True,5,Mixed,56,50,106
611760,True,9,Overwhelmingly Positive,568,6,574
611770,True,7,Positive,15,3,18
611780,True,5,Mixed,14,9,23
611790,True,8,Very Positive,2684,358,3042
611800,True,5,Mixed,113,76,189
611810,True,0,6 user reviews,2,4,6
611820,True,0,No user reviews,0,0,0
611830,True,7,Positive,36,4,40
611850,True,7,Positive,12,1,13
611860,True,6,Mostly Positive,10,4,14
611890,True,0,No user reviews,0,0,0
611950,True,0,No user reviews,0,0,0
611960,True,0,7 user reviews,5,2,7
611970,True,0,2 user reviews,0,2,2
611980,True,8,Very Positive,124,17,141
611990,True,0,No user reviews,0,0,0
612000,True,0,No user reviews,0,0,0
612010,True,0,3 user reviews,1,2,3
612020,True,0,No user reviews,0,0,0
612030,True,0,8 user reviews,5,3,8
612040,True,0,No user reviews,0,0,0
612050,True,0,No user reviews,0,0,0
612060,True,0,5 user reviews,4,1,5
612070,True,6,Mostly Positive,267,97,364
612100,True,8,Very Positive,67,8,75
612110,True,6,Mostly Positive,84,33,117
612120,True,5,Mixed,7,5,12
612130,True,0,No user reviews,0,0,0
612140,True,7,Positive,12,1,13
612150,True,0,6 user reviews,3,3,6
612160,True,0,5 user reviews,5,0,5
612170,True,0,9 user reviews,5,4,9
612180,True,0,No user reviews,0,0,0
612190,True,0,9 user reviews,5,4,9
612200,True,0,No user reviews,0,0,0
612210,True,0,8 user reviews,8,0,8
612220,True,0,5 user reviews,1,4,5
612240,True,0,No user reviews,0,0,0
612250,True,0,8 user reviews,2,6,8
612260,True,0,1 user reviews,1,0,1
612261,True,5,Mixed,7,4,11
612280,True,0,No user reviews,0,0,0
612300,True,8,Very Positive,49,11,60
612310,True,0,8 user reviews,7,1,8
612320,True,0,2 user reviews,1,1,2
612330,True,0,1 user reviews,1,0,1
612360,True,0,No user reviews,0,0,0
612370,True,8,Very Positive,169,8,177
612380,True,0,2 user reviews,1,1,2
612390,True,8,Very Positive,149,29,178
612400,True,0,No user reviews,0,0,0
612420,True,0,No user reviews,0,0,0
612430,True,0,No user reviews,0,0,0
612440,True,0,No user reviews,0,0,0
612470,True,8,Very Positive,426,72,498
612480,True,7,Positive,31,1,32
612490,True,0,No user reviews,0,0,0
612491,True,0,3 user reviews,3,0,3
612500,True,0,No user reviews,0,0,0
612510,True,0,5 user reviews,1,4,5
612520,True,7,Positive,40,7,47
612540,True,5,Mixed,24,12,36
612550,True,0,No user reviews,0,0,0
612570,True,6,Mostly Positive,189,55,244
612580,True,0,No user reviews,0,0,0
612590,True,0,No user reviews,0,0,0
612600,True,7,Positive,12,0,12
612610,True,0,No user reviews,0,0,0
612620,True,0,No user reviews,0,0,0
612630,True,0,9 user reviews,4,5,9
612631,True,0,6 user reviews,4,2,6
612640,True,7,Positive,18,1,19
612650,True,0,1 user reviews,1,0,1
612660,True,0,No user reviews,0,0,0
612670,True,7,Positive,14,0,14
612720,True,6,Mostly Positive,274,79,353
612730,True,0,No user reviews,0,0,0
612740,True,6,Mostly Positive,35,14,49
612750,True,0,No user reviews,0,0,0
612790,True,0,No user reviews,0,0,0
612810,True,5,Mixed,8,9,17
612820,True,7,Positive,16,4,20
612830,True,0,No user reviews,0,0,0
612840,True,0,9 user reviews,8,1,9
612850,True,0,No user reviews,0,0,0
612870,True,0,1 user reviews,1,0,1
612880,True,6,Mostly Positive,5965,2330,8295
612890,True,0,6 user reviews,6,0,6
612900,True,6,Mostly Positive,115,38,153
612930,True,8,Very Positive,255,48,303
612940,True,0,No user reviews,0,0,0
612950,True,0,No user reviews,0,0,0
612960,True,5,Mixed,10,12,22
612970,True,0,No user reviews,0,0,0
612980,True,0,No user reviews,0,0,0
613000,True,0,No user reviews,0,0,0
613010,True,0,6 user reviews,4,2,6
613020,True,0,3 user reviews,3,0,3
613040,True,0,5 user reviews,3,2,5
613050,True,0,No user reviews,0,0,0
613070,True,0,No user reviews,0,0,0
613080,True,0,No user reviews,0,0,0
613090,True,0,No user reviews,0,0,0
613091,True,0,No user reviews,0,0,0
613092,True,0,No user reviews,0,0,0
613093,True,0,No user reviews,0,0,0
613094,True,0,No user reviews,0,0,0
613095,True,0,No user reviews,0,0,0
613096,True,0,No user reviews,0,0,0
613100,True,8,Very Positive,13469,1541,15010
613120,True,0,6 user reviews,5,1,6
613130,True,7,Positive,12,0,12
613140,True,0,4 user reviews,3,1,4
613150,True,0,No user reviews,0,0,0
613160,True,0,No user reviews,0,0,0
613170,True,0,4 user reviews,3,1,4
613190,True,8,Very Positive,178,38,216
613200,True,7,Positive,9,1,10
613210,True,0,3 user reviews,3,0,3
613220,True,0,No user reviews,0,0,0
613230,True,0,5 user reviews,2,3,5
613240,True,7,Positive,35,0,35
613250,True,0,2 user reviews,1,1,2
613260,True,7,Positive,14,2,16
613270,True,5,Mixed,49,45,94
613290,True,0,No user reviews,0,0,0
613291,True,0,No user reviews,0,0,0
613292,True,0,No user reviews,0,0,0
613293,True,0,No user reviews,0,0,0
613294,True,0,No user reviews,0,0,0
613295,True,0,No user reviews,0,0,0
613296,True,0,No user reviews,0,0,0
613297,True,0,No user reviews,0,0,0
613298,True,0,No user reviews,0,0,0
613299,True,0,No user reviews,0,0,0
613310,True,0,No user reviews,0,0,0
613320,True,0,No user reviews,0,0,0
613321,True,0,No user reviews,0,0,0
613322,True,0,No user reviews,0,0,0
613323,True,0,No user reviews,0,0,0
613324,True,0,No user reviews,0,0,0
613330,True,5,Mixed,4,6,10
613340,True,0,No user reviews,0,0,0
613350,True,0,1 user reviews,1,0,1
613370,True,0,No user reviews,0,0,0
613380,True,0,No user reviews,0,0,0
613390,True,8,Very Positive,123,10,133
613400,True,0,3 user reviews,2,1,3
613410,True,4,Mostly Negative,3,7,10
613420,True,7,Positive,11,1,12
613430,True,0,2 user reviews,1,1,2
613450,True,8,Very Positive,84,6,90
613470,True,8,Very Positive,70,7,77
613520,True,0,2 user reviews,2,0,2
613550,True,0,No user reviews,0,0,0
613580,True,0,4 user reviews,2,2,4
613590,True,0,2 user reviews,2,0,2
613610,True,0,3 user reviews,3,0,3
613620,True,0,2 user reviews,2,0,2
613660,True,0,1 user reviews,1,0,1
613670,True,0,2 user reviews,1,1,2
613680,True,0,No user reviews,0,0,0
613690,True,0,No user reviews,0,0,0
613700,True,0,No user reviews,0,0,0
613710,True,0,No user reviews,0,0,0
613730,True,6,Mostly Positive,116,49,165
613790,True,7,Positive,15,3,18
613830,True,8,Very Positive,1578,323,1901
613850,True,0,5 user reviews,2,3,5
613860,True,5,Mixed,11,11,22
613870,True,0,No user reviews,0,0,0
613880,True,5,Mixed,178,164,342
613900,True,7,Positive,35,1,36
613920,True,0,No user reviews,0,0,0
613950,True,0,No user reviews,0,0,0
613960,True,0,No user reviews,0,0,0
613970,True,0,6 user reviews,0,6,6
613980,True,0,5 user reviews,4,1,5
613990,True,0,No user reviews,0,0,0
614000,True,0,No user reviews,0,0,0
614001,True,0,1 user reviews,1,0,1
614002,True,0,1 user reviews,1,0,1
614003,True,0,1 user reviews,1,0,1
614004,True,5,Mixed,11,15,26
614005,True,4,Mostly Negative,3,11,14
614006,True,0,5 user reviews,3,2,5
614007,True,0,9 user reviews,4,5,9
614008,True,0,No user reviews,0,0,0
614009,True,0,No user reviews,0,0,0
614010,True,0,No user reviews,0,0,0
614020,True,0,1 user reviews,1,0,1
614030,True,5,Mixed,34,17,51
614050,True,0,4 user reviews,0,4,4
614080,True,0,1 user reviews,1,0,1
614090,True,0,4 user reviews,3,1,4
614100,True,0,No user reviews,0,0,0
614130,True,7,Positive,15,2,17
614140,True,0,7 user reviews,4,3,7
614150,True,0,5 user reviews,5,0,5
614160,True,0,2 user reviews,1,1,2
614170,True,0,No user reviews,0,0,0
614180,True,0,3 user reviews,3,0,3
614190,True,0,No user reviews,0,0,0
614200,True,0,1 user reviews,1,0,1
614210,True,0,No user reviews,0,0,0
614211,True,0,No user reviews,0,0,0
614212,True,0,No user reviews,0,0,0
614213,True,0,No user reviews,0,0,0
614214,True,0,No user reviews,0,0,0
614220,True,0,No user reviews,0,0,0
614221,True,0,No user reviews,0,0,0
614230,True,0,No user reviews,0,0,0
614240,True,0,No user reviews,0,0,0
614250,True,0,No user reviews,0,0,0
614260,True,5,Mixed,21,15,36
614270,True,0,No user reviews,0,0,0
614280,True,0,No user reviews,0,0,0
614290,True,0,No user reviews,0,0,0
614300,True,0,No user reviews,0,0,0
614330,True,0,No user reviews,0,0,0
614340,True,0,No user reviews,0,0,0
614350,True,0,No user reviews,0,0,0
614360,True,0,No user reviews,0,0,0
614370,True,0,No user reviews,0,0,0
614380,True,0,1 user reviews,0,1,1
614390,True,0,No user reviews,0,0,0
614410,True,0,No user reviews,0,0,0
614420,True,0,No user reviews,0,0,0
614450,True,0,7 user reviews,2,5,7
614460,True,0,1 user reviews,1,0,1
614500,True,0,No user reviews,0,0,0
614510,True,0,No user reviews,0,0,0
614520,True,0,No user reviews,0,0,0
614530,True,0,5 user reviews,2,3,5
614550,True,0,1 user reviews,1,0,1
614560,True,0,9 user reviews,3,6,9
614570,True,8,Very Positive,1705,320,2025
614580,True,6,Mostly Positive,113,38,151
614581,True,5,Mixed,55,48,103
614582,True,6,Mostly Positive,26,8,34
614590,True,0,No user reviews,0,0,0
614610,True,0,No user reviews,0,0,0
614620,True,0,No user reviews,0,0,0
614630,True,6,Mostly Positive,129,53,182
614650,True,0,1 user reviews,1,0,1
614660,True,0,9 user reviews,5,4,9
614680,True,0,No user reviews,0,0,0
614700,True,0,3 user reviews,3,0,3
614710,True,0,No user reviews,0,0,0
614720,True,0,No user reviews,0,0,0
614730,True,0,No user reviews,0,0,0
614750,True,0,No user reviews,0,0,0
614760,True,0,No user reviews,0,0,0
614770,True,4,Mostly Negative,3,10,13
614780,True,0,No user reviews,0,0,0
614820,True,0,No user reviews,0,0,0
614830,True,7,Positive,20,1,21
614850,True,0,2 user reviews,0,2,2
614860,True,6,Mostly Positive,28,11,39
614870,True,0,No user reviews,0,0,0
614880,True,0,2 user reviews,0,2,2
614890,True,6,Mostly Positive,13,4,17
614900,True,6,Mostly Positive,10,4,14
614910,True,8,Very Positive,118,23,141
614940,True,0,No user reviews,0,0,0
614950,True,8,Very Positive,59,12,71
614960,True,0,9 user reviews,7,2,9
614970,True,5,Mixed,20,16,36
614980,True,0,No user reviews,0,0,0
615010,True,8,Very Positive,62,8,70
615020,True,7,Positive,23,3,26
615030,True,0,No user reviews,0,0,0
615050,True,0,No user reviews,0,0,0
615070,True,0,2 user reviews,1,1,2
615080,True,0,4 user reviews,4,0,4
615090,True,7,Positive,20,3,23
615100,True,0,No user reviews,0,0,0
615120,True,9,Overwhelmingly Positive,501,13,514
615130,True,0,No user reviews,0,0,0
615140,True,0,No user reviews,0,0,0
615150,True,0,9 user reviews,8,1,9
615160,True,0,2 user reviews,1,1,2
615170,True,0,No user reviews,0,0,0
615180,True,5,Mixed,27,13,40
615190,True,0,No user reviews,0,0,0
615200,True,0,1 user reviews,1,0,1
615210,True,0,No user reviews,0,0,0
615250,True,7,Positive,30,2,32
615260,True,0,No user reviews,0,0,0
615270,True,7,Positive,9,1,10
615300,True,0,No user reviews,0,0,0
615320,True,0,No user reviews,0,0,0
615330,True,7,Positive,16,2,18
615340,True,0,No user reviews,0,0,0
615350,True,8,Very Positive,52,7,59
615360,True,0,No user reviews,0,0,0
615380,True,7,Positive,16,3,19
615390,True,0,2 user reviews,0,2,2
615400,True,0,No user reviews,0,0,0
615410,True,0,No user reviews,0,0,0
615420,True,0,2 user reviews,2,0,2
615430,True,0,No user reviews,0,0,0
615440,True,0,No user reviews,0,0,0
615460,True,0,No user reviews,0,0,0
615490,True,0,6 user reviews,4,2,6
615500,True,0,No user reviews,0,0,0
615530,True,0,No user reviews,0,0,0
615540,True,0,9 user reviews,9,0,9
615550,True,0,5 user reviews,4,1,5
615560,True,0,No user reviews,0,0,0
615561,True,0,No user reviews,0,0,0
615570,True,0,No user reviews,0,0,0
615571,True,0,No user reviews,0,0,0
615572,True,0,No user reviews,0,0,0
615573,True,0,No user reviews,0,0,0
615574,True,0,No user reviews,0,0,0
615575,True,0,No user reviews,0,0,0
615576,True,0,No user reviews,0,0,0
615577,True,0,No user reviews,0,0,0
615578,True,0,No user reviews,0,0,0
615579,True,0,No user reviews,0,0,0
615580,True,0,No user reviews,0,0,0
615581,True,0,No user reviews,0,0,0
615582,True,0,No user reviews,0,0,0
615583,True,0,No user reviews,0,0,0
615590,True,0,2 user reviews,2,0,2
615600,True,0,No user reviews,0,0,0
615601,True,0,No user reviews,0,0,0
615602,True,0,No user reviews,0,0,0
615603,True,0,No user reviews,0,0,0
615604,True,0,No user reviews,0,0,0
615610,True,9,Overwhelmingly Positive,1101,21,1122
615620,True,0,No user reviews,0,0,0
615630,True,5,Mixed,14,11,25
615650,True,0,No user reviews,0,0,0
615670,True,6,Mostly Positive,28,8,36
615680,True,0,7 user reviews,3,4,7
615690,True,0,1 user reviews,1,0,1
615700,True,0,3 user reviews,3,0,3
615710,True,0,No user reviews,0,0,0
615720,True,0,1 user reviews,1,0,1
615730,True,7,Positive,31,6,37
615770,True,6,Mostly Positive,36,12,48
615780,True,7,Positive,35,8,43
615910,True,6,Mostly Positive,34,14,48
615920,True,0,No user reviews,0,0,0
615930,True,0,4 user reviews,4,0,4
615960,True,0,No user reviews,0,0,0
615970,True,0,8 user reviews,5,3,8
615981,True,0,No user reviews,0,0,0
616000,True,8,Very Positive,46,5,51
616030,True,0,No user reviews,0,0,0
616040,True,0,3 user reviews,3,0,3
616050,True,0,No user reviews,0,0,0
616070,True,0,No user reviews,0,0,0
616090,True,0,No user reviews,0,0,0
616100,True,0,No user reviews,0,0,0
616110,True,8,Very Positive,1009,117,1126
616120,True,0,No user reviews,0,0,0
616130,True,0,4 user reviews,4,0,4
616150,True,0,2 user reviews,1,1,2
616160,True,0,2 user reviews,1,1,2
616170,True,5,Mixed,15,7,22
616180,True,0,4 user reviews,3,1,4
616190,True,7,Positive,13,2,15
616191,True,6,Mostly Positive,29,9,38
616200,True,6,Mostly Positive,55,16,71
616210,True,0,7 user reviews,3,4,7
616220,True,0,No user reviews,0,0,0
616240,True,5,Mixed,20,21,41
616250,True,9,Overwhelmingly Positive,889,40,929
616260,True,0,No user reviews,0,0,0
616280,True,0,No user reviews,0,0,0
616290,True,7,Positive,11,0,11
616300,True,0,No user reviews,0,0,0
616330,True,0,No user reviews,0,0,0
616340,True,0,No user reviews,0,0,0
616350,True,0,5 user reviews,2,3,5
616370,True,0,5 user reviews,5,0,5
616380,True,0,No user reviews,0,0,0
616410,True,0,No user reviews,0,0,0
616420,True,0,No user reviews,0,0,0
616430,True,0,No user reviews,0,0,0
616440,True,0,No user reviews,0,0,0
616480,True,0,No user reviews,0,0,0
616490,True,0,5 user reviews,2,3,5
616500,True,0,4 user reviews,3,1,4
616510,True,0,No user reviews,0,0,0
616520,True,7,Positive,27,1,28
616530,True,0,1 user reviews,1,0,1
616540,True,0,No user reviews,0,0,0
616550,True,0,1 user reviews,0,1,1
616560,True,6,Mostly Positive,2619,1101,3720
616570,True,0,No user reviews,0,0,0
616580,True,0,No user reviews,0,0,0
616590,True,0,No user reviews,0,0,0
616600,True,0,No user reviews,0,0,0
616610,True,0,No user reviews,0,0,0
616620,True,6,Mostly Positive,49,13,62
616640,True,0,3 user reviews,3,0,3
616650,True,0,1 user reviews,0,1,1
616660,True,0,9 user reviews,6,3,9
616680,True,0,2 user reviews,2,0,2
616690,True,7,Positive,13,3,16
616700,True,0,No user reviews,0,0,0
616720,True,8,Very Positive,106,13,119
616730,True,0,No user reviews,0,0,0
616740,True,0,2 user reviews,2,0,2
616750,True,0,9 user reviews,6,3,9
616780,True,0,No user reviews,0,0,0
616810,True,0,No user reviews,0,0,0
616820,True,0,No user reviews,0,0,0
616830,True,0,No user reviews,0,0,0
616840,True,0,6 user reviews,6,0,6
616850,True,6,Mostly Positive,62,19,81
616860,True,0,1 user reviews,0,1,1
616880,True,0,9 user reviews,8,1,9
616890,True,7,Positive,9,2,11
616901,True,0,No user reviews,0,0,0
616920,True,8,Very Positive,58,11,69
616940,True,0,No user reviews,0,0,0
616950,True,7,Positive,26,2,28
616960,True,0,2 user reviews,1,1,2
616970,True,0,1 user reviews,1,0,1
616980,True,0,2 user reviews,1,1,2
616990,True,0,2 user reviews,0,2,2
617000,True,0,1 user reviews,0,1,1
617001,True,0,1 user reviews,0,1,1
617010,True,0,No user reviews,0,0,0
617020,True,0,2 user reviews,0,2,2
617030,True,5,Mixed,73,64,137
617040,True,0,9 user reviews,9,0,9
617050,True,0,No user reviews,0,0,0
617060,True,0,6 user reviews,5,1,6
617070,True,0,No user reviews,0,0,0
617090,True,0,7 user reviews,4,3,7
617100,True,0,4 user reviews,2,2,4
617110,True,0,3 user reviews,2,1,3
617120,True,0,4 user reviews,3,1,4
617130,True,0,No user reviews,0,0,0
617140,True,0,6 user reviews,6,0,6
617150,True,0,No user reviews,0,0,0
617160,True,8,Very Positive,288,68,356
617190,True,0,3 user reviews,3,0,3
617200,True,0,No user reviews,0,0,0
617210,True,0,2 user reviews,1,1,2
617211,True,0,1 user reviews,1,0,1
617212,True,0,1 user reviews,1,0,1
617213,True,0,1 user reviews,1,0,1
617214,True,0,1 user reviews,1,0,1
617215,True,0,1 user reviews,1,0,1
617216,True,0,1 user reviews,1,0,1
617217,True,0,1 user reviews,1,0,1
617218,True,0,1 user reviews,1,0,1
617219,True,0,1 user reviews,1,0,1
617220,True,0,1 user reviews,1,0,1
617230,True,0,2 user reviews,1,1,2
617270,True,0,6 user reviews,6,0,6
617290,True,8,Very Positive,13567,1995,15562
617340,True,0,No user reviews,0,0,0
617350,True,0,No user reviews,0,0,0
617360,True,0,3 user reviews,3,0,3
617370,True,0,1 user reviews,0,1,1
617380,True,0,No user reviews,0,0,0
617400,True,0,No user reviews,0,0,0
617420,True,0,9 user reviews,5,4,9
617430,True,7,Positive,11,1,12
617440,True,8,Very Positive,47,3,50
617450,True,5,Mixed,18,9,27
617470,True,0,No user reviews,0,0,0
617480,True,8,Very Positive,808,131,939
617540,True,0,No user reviews,0,0,0
617550,True,0,4 user reviews,3,1,4
617560,True,0,1 user reviews,1,0,1
617570,True,0,6 user reviews,6,0,6
617580,True,0,4 user reviews,3,1,4
617590,True,5,Mixed,8,11,19
617600,True,0,No user reviews,0,0,0
617610,True,7,Positive,26,2,28
617620,True,7,Positive,10,0,10
617630,True,0,5 user reviews,3,2,5
617640,True,5,Mixed,51,24,75
617660,True,0,5 user reviews,3,2,5
617670,True,9,Overwhelmingly Positive,623,20,643
617680,True,0,9 user reviews,5,4,9
617690,True,0,1 user reviews,1,0,1
617700,True,8,Very Positive,294,55,349
617710,True,5,Mixed,15,9,24
617720,True,0,No user reviews,0,0,0
617730,True,0,No user reviews,0,0,0
617740,True,0,No user reviews,0,0,0
617750,True,0,2 user reviews,1,1,2
617780,True,0,No user reviews,0,0,0
617810,True,0,No user reviews,0,0,0
617820,True,0,3 user reviews,2,1,3
617830,True,8,Very Positive,2873,365,3238
617850,True,5,Mixed,29,15,44
617860,True,0,No user reviews,0,0,0
617870,True,8,Very Positive,827,95,922
617880,True,0,No user reviews,0,0,0
617890,True,0,No user reviews,0,0,0
617910,True,0,No user reviews,0,0,0
617930,True,0,No user reviews,0,0,0
617940,True,0,No user reviews,0,0,0
617950,True,0,No user reviews,0,0,0
617960,True,4,Mostly Negative,4,7,11
617961,True,0,1 user reviews,1,0,1
617962,True,0,7 user reviews,3,4,7
617970,True,5,Mixed,12,8,20
618010,True,0,8 user reviews,8,0,8
618050,True,5,Mixed,11,13,24
618060,True,0,No user reviews,0,0,0
618070,True,0,9 user reviews,8,1,9
618080,True,0,No user reviews,0,0,0
618090,True,0,No user reviews,0,0,0
618100,True,6,Mostly Positive,60,22,82
618110,True,0,No user reviews,0,0,0
618140,True,6,Mostly Positive,140,40,180
618180,True,0,3 user reviews,3,0,3
618190,True,0,3 user reviews,3,0,3
618200,True,0,7 user reviews,2,5,7
618210,True,0,7 user reviews,6,1,7
618260,True,0,1 user reviews,1,0,1
618270,True,5,Mixed,7,6,13
618280,True,0,2 user reviews,1,1,2
618310,True,0,2 user reviews,1,1,2
618320,True,0,No user reviews,0,0,0
618330,True,0,No user reviews,0,0,0
618350,True,7,Positive,21,1,22
618360,True,7,Positive,17,1,18
618370,True,7,Positive,12,3,15
618430,True,0,5 user reviews,3,2,5
618460,True,0,No user reviews,0,0,0
618470,True,7,Positive,24,2,26
618480,True,0,No user reviews,0,0,0
618490,True,0,5 user reviews,2,3,5
618500,True,6,Mostly Positive,9,3,12
618510,True,8,Very Positive,111,5,116
618520,True,0,1 user reviews,0,1,1
618550,True,8,Very Positive,47,6,53
618560,True,0,No user reviews,0,0,0
618570,True,0,8 user reviews,7,1,8
618580,True,0,No user reviews,0,0,0
618590,True,0,9 user reviews,8,1,9
618600,True,0,No user reviews,0,0,0
618610,True,5,Mixed,54,31,85
618620,True,0,No user reviews,0,0,0
618630,True,0,2 user reviews,2,0,2
618640,True,5,Mixed,10,7,17
618650,True,0,3 user reviews,2,1,3
618660,True,0,No user reviews,0,0,0
618661,True,0,3 user reviews,2,1,3
618662,True,0,4 user reviews,2,2,4
618663,True,0,No user reviews,0,0,0
618664,True,0,1 user reviews,1,0,1
618670,True,0,7 user reviews,3,4,7
618680,True,0,No user reviews,0,0,0
618681,True,0,1 user reviews,0,1,1
618682,True,0,2 user reviews,1,1,2
618690,True,7,Positive,17,1,18
618700,True,0,5 user reviews,4,1,5
618710,True,7,Positive,20,0,20
618720,True,8,Very Positive,294,21,315
618740,True,8,Very Positive,415,28,443
618750,True,6,Mostly Positive,20,7,27
618760,True,5,Mixed,7,4,11
618770,True,0,No user reviews,0,0,0
618771,True,0,No user reviews,0,0,0
618780,True,0,No user reviews,0,0,0
618790,True,0,No user reviews,0,0,0
618800,True,0,No user reviews,0,0,0
618810,True,0,No user reviews,0,0,0
618820,True,0,No user reviews,0,0,0
618830,True,0,No user reviews,0,0,0
618840,True,0,3 user reviews,0,3,3
618850,True,8,Very Positive,137,24,161
618920,True,8,Very Positive,82,15,97
618940,True,0,No user reviews,0,0,0
618950,True,8,Very Positive,65,6,71
618960,True,0,No user reviews,0,0,0
618970,True,8,Very Positive,154,34,188
618980,True,0,No user reviews,0,0,0
618990,True,0,5 user reviews,4,1,5
619000,True,0,1 user reviews,0,1,1
619010,True,5,Mixed,7,6,13
619050,True,0,No user reviews,0,0,0
619070,True,0,No user reviews,0,0,0
619080,True,4,Mostly Negative,293,806,1099
619100,True,0,1 user reviews,1,0,1
619120,True,0,No user reviews,0,0,0
619140,True,0,7 user reviews,1,6,7
619150,True,8,Very Positive,1731,199,1930
619160,True,0,No user reviews,0,0,0
619170,True,0,No user reviews,0,0,0
619190,True,0,No user reviews,0,0,0
619200,True,0,No user reviews,0,0,0
619210,True,8,Very Positive,79,11,90
619220,True,0,3 user reviews,3,0,3
619230,True,5,Mixed,8,4,12
619250,True,0,No user reviews,0,0,0
619270,True,0,2 user reviews,2,0,2
619280,True,8,Very Positive,192,35,227
619290,True,8,Very Positive,472,74,546
619310,True,0,No user reviews,0,0,0
619320,True,0,9 user reviews,7,2,9
619330,True,0,7 user reviews,4,3,7
619340,True,4,Mostly Negative,3,10,13
619350,True,5,Mixed,5,5,10
619380,True,0,No user reviews,0,0,0
619400,True,0,4 user reviews,1,3,4
619420,True,0,No user reviews,0,0,0
619430,True,5,Mixed,33,42,75
619440,True,0,No user reviews,0,0,0
619460,True,0,No user reviews,0,0,0
619470,True,0,5 user reviews,3,2,5
619480,True,0,1 user reviews,1,0,1
619490,True,5,Mixed,28,14,42
619500,True,8,Very Positive,173,16,189
619510,True,7,Positive,24,3,27
619550,True,0,No user reviews,0,0,0
619580,True,7,Positive,14,1,15
619582,True,0,No user reviews,0,0,0
619583,True,0,6 user reviews,6,0,6
619584,True,0,5 user reviews,4,1,5
619585,True,0,4 user reviews,3,1,4
619586,True,0,3 user reviews,2,1,3
619590,True,0,No user reviews,0,0,0
619600,True,0,No user reviews,0,0,0
619610,True,0,No user reviews,0,0,0
619620,True,0,2 user reviews,1,1,2
619630,True,0,2 user reviews,2,0,2
619670,True,0,No user reviews,0,0,0
619680,True,8,Very Positive,71,2,73
619690,True,0,1 user reviews,1,0,1
619700,True,5,Mixed,41,19,60
619710,True,0,2 user reviews,2,0,2
619711,True,0,1 user reviews,1,0,1
619720,True,0,4 user reviews,1,3,4
619740,True,3,Negative,2,9,11
619760,True,0,No user reviews,0,0,0
619780,True,5,Mixed,381,201,582
619790,True,0,No user reviews,0,0,0
619800,True,0,No user reviews,0,0,0
619801,True,0,No user reviews,0,0,0
619810,True,7,Positive,16,1,17
619870,True,8,Very Positive,49,4,53
619880,True,6,Mostly Positive,215,75,290
619890,True,0,6 user reviews,4,2,6
619910,True,0,No user reviews,0,0,0
619930,True,7,Positive,10,1,11
619940,True,7,Positive,12,0,12
619960,True,0,No user reviews,0,0,0
619980,True,0,No user reviews,0,0,0
620000,True,0,No user reviews,0,0,0
620010,True,0,No user reviews,0,0,0
620030,True,0,No user reviews,0,0,0
620040,True,0,9 user reviews,5,4,9
620050,True,5,Mixed,9,6,15
620070,True,0,1 user reviews,1,0,1
620080,True,7,Positive,12,2,14
620090,True,0,No user reviews,0,0,0
620110,True,0,No user reviews,0,0,0
620130,True,0,No user reviews,0,0,0
620140,True,0,3 user reviews,2,1,3
620150,True,5,Mixed,9,7,16
620160,True,0,No user reviews,0,0,0
620170,True,7,Positive,31,5,36
620180,True,0,No user reviews,0,0,0
620190,True,8,Very Positive,384,87,471
620210,True,8,Very Positive,128,1,129
620220,True,8,Very Positive,113,21,134
620250,True,0,No user reviews,0,0,0
620260,True,0,No user reviews,0,0,0
620270,True,0,No user reviews,0,0,0
620280,True,0,9 user reviews,8,1,9
620290,True,0,No user reviews,0,0,0
620300,True,0,No user reviews,0,0,0
620310,True,0,1 user reviews,0,1,1
620320,True,0,1 user reviews,1,0,1
620321,True,0,1 user reviews,1,0,1
620322,True,0,2 user reviews,2,0,2
620323,True,0,1 user reviews,1,0,1
620324,True,0,1 user reviews,1,0,1
620325,True,0,1 user reviews,1,0,1
620326,True,0,2 user reviews,2,0,2
620330,True,0,4 user reviews,4,0,4
620340,True,0,9 user reviews,9,0,9
620350,True,0,6 user reviews,5,1,6
620360,True,7,Positive,22,0,22
620370,True,7,Positive,18,0,18
620381,True,0,1 user reviews,0,1,1
620382,True,0,No user reviews,0,0,0
620400,True,0,No user reviews,0,0,0
620410,True,0,No user reviews,0,0,0
620440,True,0,No user reviews,0,0,0
620450,True,0,No user reviews,0,0,0
620460,True,0,No user reviews,0,0,0
620470,True,0,1 user reviews,1,0,1
620480,True,0,No user reviews,0,0,0
620490,True,0,1 user reviews,1,0,1
620500,True,0,No user reviews,0,0,0
620510,True,0,No user reviews,0,0,0
620520,True,0,No user reviews,0,0,0
620540,True,0,No user reviews,0,0,0
620560,True,0,No user reviews,0,0,0
620570,True,0,9 user reviews,3,6,9
620580,True,0,7 user reviews,5,2,7
620590,True,6,Mostly Positive,931,252,1183
620610,True,8,Very Positive,276,28,304
620630,True,0,2 user reviews,1,1,2
620640,True,0,2 user reviews,1,1,2
620650,True,7,Positive,37,7,44
620660,True,0,5 user reviews,5,0,5
620670,True,7,Positive,10,0,10
620680,True,0,5 user reviews,4,1,5
620700,True,5,Mixed,16,7,23
620710,True,7,Positive,14,2,16
620730,True,0,No user reviews,0,0,0
620740,True,0,No user reviews,0,0,0
620741,True,0,No user reviews,0,0,0
620742,True,0,No user reviews,0,0,0
620743,True,0,No user reviews,0,0,0
620744,True,0,No user reviews,0,0,0
620745,True,0,No user reviews,0,0,0
620746,True,0,7 user reviews,6,1,7
620780,True,0,No user reviews,0,0,0
620790,True,0,1 user reviews,1,0,1
620800,True,0,9 user reviews,9,0,9
620810,True,0,No user reviews,0,0,0
620820,True,0,No user reviews,0,0,0
620830,True,0,No user reviews,0,0,0
620850,True,0,No user reviews,0,0,0
620880,True,0,No user reviews,0,0,0
620900,True,7,Positive,41,2,43
620910,True,0,No user reviews,0,0,0
620920,True,0,No user reviews,0,0,0
620930,True,0,No user reviews,0,0,0
620940,True,7,Positive,15,1,16
620950,True,0,No user reviews,0,0,0
620970,True,0,No user reviews,0,0,0
620980,True,9,Overwhelmingly Positive,28675,1087,29762
620990,True,0,No user reviews,0,0,0
621000,True,6,Mostly Positive,17,6,23
621010,True,7,Positive,17,0,17
621020,True,6,Mostly Positive,39,16,55
621040,True,0,No user reviews,0,0,0
621050,True,4,Mostly Negative,5,14,19
621060,True,8,Very Positive,9371,560,9931
621070,True,6,Mostly Positive,301,124,425
621080,True,7,Positive,41,6,47
621090,True,0,3 user reviews,1,2,3
621100,True,0,No user reviews,0,0,0
621110,True,0,No user reviews,0,0,0
621140,True,0,1 user reviews,1,0,1
621150,True,0,2 user reviews,2,0,2
621160,True,0,No user reviews,0,0,0
621170,True,0,6 user reviews,6,0,6
621180,True,0,No user reviews,0,0,0
621190,True,0,No user reviews,0,0,0
621200,True,0,No user reviews,0,0,0
621210,True,0,1 user reviews,1,0,1
621220,True,6,Mostly Positive,309,103,412
621240,True,0,No user reviews,0,0,0
621290,True,0,3 user reviews,1,2,3
621300,True,0,4 user reviews,4,0,4
621320,True,0,No user reviews,0,0,0
621330,True,0,No user reviews,0,0,0
621331,True,0,No user reviews,0,0,0
621332,True,0,No user reviews,0,0,0
621333,True,0,No user reviews,0,0,0
621334,True,0,No user reviews,0,0,0
621335,True,0,No user reviews,0,0,0
621336,True,0,No user reviews,0,0,0
621337,True,0,No user reviews,0,0,0
621338,True,0,No user reviews,0,0,0
621339,True,0,No user reviews,0,0,0
621340,True,0,No user reviews,0,0,0
621341,True,0,No user reviews,0,0,0
621342,True,0,No user reviews,0,0,0
621350,True,0,No user reviews,0,0,0
621351,True,0,No user reviews,0,0,0
621352,True,0,No user reviews,0,0,0
621353,True,0,No user reviews,0,0,0
621354,True,0,No user reviews,0,0,0
621355,True,0,No user reviews,0,0,0
621356,True,0,No user reviews,0,0,0
621357,True,0,No user reviews,0,0,0
621358,True,0,No user reviews,0,0,0
621359,True,0,No user reviews,0,0,0
621360,True,0,No user reviews,0,0,0
621361,True,0,No user reviews,0,0,0
621362,True,0,No user reviews,0,0,0
621370,True,0,No user reviews,0,0,0
621371,True,0,No user reviews,0,0,0
621372,True,0,No user reviews,0,0,0
621373,True,0,No user reviews,0,0,0
621374,True,0,No user reviews,0,0,0
621375,True,0,No user reviews,0,0,0
621376,True,0,No user reviews,0,0,0
621377,True,0,No user reviews,0,0,0
621378,True,0,No user reviews,0,0,0
621379,True,0,No user reviews,0,0,0
621380,True,0,No user reviews,0,0,0
621381,True,0,No user reviews,0,0,0
621382,True,0,No user reviews,0,0,0
621390,True,0,No user reviews,0,0,0
621400,True,0,No user reviews,0,0,0
621420,True,0,2 user reviews,2,0,2
621430,True,0,No user reviews,0,0,0
621440,True,0,No user reviews,0,0,0
621450,True,0,No user reviews,0,0,0
621451,True,0,No user reviews,0,0,0
621452,True,0,No user reviews,0,0,0
621453,True,0,No user reviews,0,0,0
621480,True,0,No user reviews,0,0,0
621500,True,4,Mostly Negative,8,14,22
621520,True,0,No user reviews,0,0,0
621560,True,0,1 user reviews,1,0,1
621570,True,0,5 user reviews,5,0,5
621580,True,0,No user reviews,0,0,0
621590,True,0,No user reviews,0,0,0
621600,True,0,6 user reviews,6,0,6
621610,True,0,No user reviews,0,0,0
621620,True,0,No user reviews,0,0,0
621630,True,0,No user reviews,0,0,0
621640,True,0,4 user reviews,4,0,4
621650,True,0,No user reviews,0,0,0
621660,True,0,No user reviews,0,0,0
621670,True,0,No user reviews,0,0,0
621680,True,0,No user reviews,0,0,0
621690,True,0,No user reviews,0,0,0
621700,True,0,No user reviews,0,0,0
621710,True,0,No user reviews,0,0,0
621720,True,0,2 user reviews,1,1,2
621730,True,0,1 user reviews,1,0,1
621740,True,0,No user reviews,0,0,0
621750,True,0,No user reviews,0,0,0
621760,True,0,No user reviews,0,0,0
621780,True,5,Mixed,5,5,10
621810,True,8,Very Positive,97,15,112
621830,True,5,Mixed,340,185,525
621840,True,0,4 user reviews,2,2,4
621850,True,0,9 user reviews,6,3,9
621870,True,7,Positive,16,0,16
621880,True,0,No user reviews,0,0,0
621920,True,7,Positive,15,1,16
621921,True,5,Mixed,8,5,13
621922,True,0,9 user reviews,7,2,9
621923,True,6,Mostly Positive,11,3,14
621924,True,0,2 user reviews,2,0,2
621925,True,7,Positive,9,1,10
621926,True,0,6 user reviews,5,1,6
621927,True,0,3 user reviews,2,1,3
621930,True,8,Very Positive,115,20,135
621940,True,6,Mostly Positive,16,6,22
621960,True,0,No user reviews,0,0,0
621970,True,6,Mostly Positive,23,6,29
622010,True,5,Mixed,20,21,41
622020,True,0,7 user reviews,4,3,7
622030,True,0,3 user reviews,2,1,3
622040,True,5,Mixed,86,61,147
622060,True,0,5 user reviews,5,0,5
622070,True,0,No user reviews,0,0,0
622080,True,0,2 user reviews,1,1,2
622090,True,0,No user reviews,0,0,0
622110,True,0,No user reviews,0,0,0
622130,True,0,No user reviews,0,0,0
622150,True,0,2 user reviews,2,0,2
622160,True,0,No user reviews,0,0,0
622170,True,5,Mixed,35,18,53
622200,True,0,9 user reviews,9,0,9
622210,True,0,No user reviews,0,0,0
622220,True,9,Overwhelmingly Positive,736,36,772
622230,True,0,7 user reviews,7,0,7
622240,True,0,No user reviews,0,0,0
622260,True,0,No user reviews,0,0,0
622270,True,0,No user reviews,0,0,0
622280,True,0,No user reviews,0,0,0
622290,True,0,1 user reviews,1,0,1
622300,True,0,No user reviews,0,0,0
622310,True,0,No user reviews,0,0,0
622320,True,0,7 user reviews,2,5,7
622330,True,5,Mixed,11,5,16
622350,True,0,1 user reviews,0,1,1
622351,True,0,No user reviews,0,0,0
622352,True,0,3 user reviews,2,1,3
622353,True,0,5 user reviews,2,3,5
622354,True,0,6 user reviews,3,3,6
622355,True,0,1 user reviews,1,0,1
622356,True,0,No user reviews,0,0,0
622357,True,0,2 user reviews,2,0,2
622358,True,0,No user reviews,0,0,0
622360,True,0,7 user reviews,6,1,7
622370,True,5,Mixed,31,23,54
622380,True,0,No user reviews,0,0,0
622390,True,0,1 user reviews,1,0,1
622400,True,0,No user reviews,0,0,0
622420,True,5,Mixed,43,40,83
622440,True,5,Mixed,119,68,187
622450,True,5,Mixed,66,55,121
622460,True,6,Mostly Positive,97,29,126
622470,True,0,No user reviews,0,0,0
622480,True,0,5 user reviews,4,1,5
622500,True,0,No user reviews,0,0,0
622510,True,0,1 user reviews,1,0,1
622520,True,0,No user reviews,0,0,0
622530,True,5,Mixed,6,5,11
622540,True,0,2 user reviews,1,1,2
622550,True,0,2 user reviews,2,0,2
622570,True,0,No user reviews,0,0,0
622580,True,0,No user reviews,0,0,0
622610,True,0,5 user reviews,4,1,5
622620,True,0,8 user reviews,7,1,8
622650,True,8,Very Positive,2742,432,3174
622660,True,8,Very Positive,243,41,284
622661,True,8,Very Positive,351,51,402
622670,True,0,4 user reviews,4,0,4
622680,True,0,No user reviews,0,0,0
622690,True,0,No user reviews,0,0,0
622700,True,0,9 user reviews,5,4,9
622710,True,0,9 user reviews,9,0,9
622720,True,8,Very Positive,413,101,514
622730,True,0,No user reviews,0,0,0
622740,True,0,No user reviews,0,0,0
622750,True,0,No user reviews,0,0,0
622760,True,0,1 user reviews,1,0,1
622770,True,5,Mixed,64,34,98
622780,True,0,No user reviews,0,0,0
622810,True,0,5 user reviews,5,0,5
622830,True,7,Positive,20,2,22
622850,True,0,No user reviews,0,0,0
622851,True,0,2 user reviews,2,0,2
622860,True,0,No user reviews,0,0,0
622870,True,8,Very Positive,95,20,115
622880,True,0,7 user reviews,4,3,7
622890,True,0,7 user reviews,5,2,7
622900,True,0,No user reviews,0,0,0
622910,True,0,No user reviews,0,0,0
622920,True,5,Mixed,6,4,10
622930,True,0,4 user reviews,4,0,4
622940,True,0,No user reviews,0,0,0
622970,True,0,No user reviews,0,0,0
623040,True,0,4 user reviews,3,1,4
623050,True,0,1 user reviews,1,0,1
623070,True,6,Mostly Positive,15,6,21
623080,True,7,Positive,29,2,31
623090,True,6,Mostly Positive,80,25,105
623100,True,0,6 user reviews,3,3,6
623110,True,0,1 user reviews,1,0,1
623130,True,0,No user reviews,0,0,0
623131,True,0,No user reviews,0,0,0
623132,True,0,No user reviews,0,0,0
623133,True,0,No user reviews,0,0,0
623134,True,0,No user reviews,0,0,0
623140,True,0,6 user reviews,5,1,6
623150,True,5,Mixed,34,17,51
623160,True,6,Mostly Positive,16,5,21
623170,True,7,Positive,16,2,18
623180,True,6,Mostly Positive,11,3,14
623190,True,0,4 user reviews,4,0,4
623191,True,0,No user reviews,0,0,0
623192,True,0,No user reviews,0,0,0
623193,True,0,1 user reviews,1,0,1
623194,True,0,1 user reviews,1,0,1
623195,True,0,No user reviews,0,0,0
623196,True,0,2 user reviews,2,0,2
623197,True,0,No user reviews,0,0,0
623198,True,0,1 user reviews,1,0,1
623200,True,0,2 user reviews,2,0,2
623220,True,0,No user reviews,0,0,0
623230,True,0,No user reviews,0,0,0
623250,True,0,No user reviews,0,0,0
623260,True,0,No user reviews,0,0,0
623261,True,0,No user reviews,0,0,0
623262,True,0,1 user reviews,1,0,1
623263,True,0,1 user reviews,1,0,1
623264,True,0,2 user reviews,2,0,2
623265,True,0,1 user reviews,1,0,1
623266,True,0,4 user reviews,2,2,4
623267,True,0,1 user reviews,1,0,1
623268,True,0,No user reviews,0,0,0
623270,True,0,5 user reviews,5,0,5
623291,True,0,No user reviews,0,0,0
623310,True,5,Mixed,29,13,42
623320,True,0,3 user reviews,3,0,3
623340,True,5,Mixed,225,101,326
623360,True,0,7 user reviews,4,3,7
623370,True,0,2 user reviews,1,1,2
623380,True,7,Positive,36,9,45
623390,True,0,No user reviews,0,0,0
623391,True,0,No user reviews,0,0,0
623392,True,0,No user reviews,0,0,0
623393,True,0,No user reviews,0,0,0
623394,True,0,No user reviews,0,0,0
623395,True,0,No user reviews,0,0,0
623396,True,0,No user reviews,0,0,0
623397,True,0,No user reviews,0,0,0
623398,True,0,No user reviews,0,0,0
623399,True,0,No user reviews,0,0,0
623400,True,0,No user reviews,0,0,0
623401,True,0,No user reviews,0,0,0
623402,True,0,No user reviews,0,0,0
623410,True,0,No user reviews,0,0,0
623411,True,0,No user reviews,0,0,0
623412,True,0,No user reviews,0,0,0
623413,True,0,No user reviews,0,0,0
623414,True,0,No user reviews,0,0,0
623415,True,0,No user reviews,0,0,0
623416,True,0,No user reviews,0,0,0
623417,True,0,No user reviews,0,0,0
623418,True,0,No user reviews,0,0,0
623419,True,0,No user reviews,0,0,0
623420,True,0,No user reviews,0,0,0
623421,True,0,No user reviews,0,0,0
623422,True,0,No user reviews,0,0,0
623430,True,0,No user reviews,0,0,0
623431,True,0,No user reviews,0,0,0
623432,True,0,No user reviews,0,0,0
623433,True,0,No user reviews,0,0,0
623434,True,0,No user reviews,0,0,0
623435,True,0,No user reviews,0,0,0
623436,True,0,No user reviews,0,0,0
623437,True,0,No user reviews,0,0,0
623438,True,0,No user reviews,0,0,0
623439,True,0,No user reviews,0,0,0
623440,True,0,No user reviews,0,0,0
623441,True,0,No user reviews,0,0,0
623442,True,0,No user reviews,0,0,0
623460,True,0,2 user reviews,1,1,2
623470,True,0,2 user reviews,2,0,2
623480,True,0,No user reviews,0,0,0
623481,True,0,No user reviews,0,0,0
623482,True,0,No user reviews,0,0,0
623483,True,0,No user reviews,0,0,0
623484,True,0,No user reviews,0,0,0
623485,True,0,No user reviews,0,0,0
623486,True,0,No user reviews,0,0,0
623487,True,0,No user reviews,0,0,0
623490,True,0,No user reviews,0,0,0
623500,True,0,No user reviews,0,0,0
623501,True,0,No user reviews,0,0,0
623502,True,0,No user reviews,0,0,0
623503,True,0,No user reviews,0,0,0
623504,True,0,No user reviews,0,0,0
623505,True,0,No user reviews,0,0,0
623510,True,0,No user reviews,0,0,0
623511,True,0,No user reviews,0,0,0
623512,True,0,No user reviews,0,0,0
623513,True,0,No user reviews,0,0,0
623514,True,0,No user reviews,0,0,0
623515,True,0,No user reviews,0,0,0
623516,True,0,No user reviews,0,0,0
623517,True,0,No user reviews,0,0,0
623518,True,0,No user reviews,0,0,0
623519,True,0,No user reviews,0,0,0
623520,True,0,No user reviews,0,0,0
623521,True,0,No user reviews,0,0,0
623522,True,0,No user reviews,0,0,0
623523,True,0,No user reviews,0,0,0
623524,True,0,No user reviews,0,0,0
623530,True,4,Mostly Negative,4,7,11
623540,True,8,Very Positive,46,5,51
623550,True,5,Mixed,8,10,18
623560,True,0,No user reviews,0,0,0
623570,True,5,Mixed,8,5,13
623580,True,5,Mixed,6,5,11
623590,True,0,No user reviews,0,0,0
623611,True,0,3 user reviews,3,0,3
623613,True,0,2 user reviews,1,1,2
623616,True,0,3 user reviews,1,2,3
623619,True,0,5 user reviews,2,3,5
623620,True,0,No user reviews,0,0,0
623640,True,7,Positive,35,2,37
623650,True,0,No user reviews,0,0,0
623651,True,0,No user reviews,0,0,0
623652,True,0,No user reviews,0,0,0
623653,True,0,No user reviews,0,0,0
623654,True,0,No user reviews,0,0,0
623655,True,0,No user reviews,0,0,0
623656,True,0,No user reviews,0,0,0
623657,True,0,No user reviews,0,0,0
623660,True,0,No user reviews,0,0,0
623661,True,0,No user reviews,0,0,0
623662,True,0,No user reviews,0,0,0
623663,True,0,No user reviews,0,0,0
623665,True,0,No user reviews,0,0,0
623666,True,0,No user reviews,0,0,0
623667,True,0,No user reviews,0,0,0
623670,True,0,7 user reviews,5,2,7
623690,True,0,No user reviews,0,0,0
623700,True,8,Very Positive,104,11,115
623710,True,0,No user reviews,0,0,0
623720,True,0,No user reviews,0,0,0
623770,True,0,No user reviews,0,0,0
623790,True,0,1 user reviews,1,0,1
623800,True,7,Positive,11,0,11
623810,True,6,Mostly Positive,26,9,35
623820,True,0,4 user reviews,0,4,4
623840,True,0,No user reviews,0,0,0
623850,True,0,No user reviews,0,0,0
623860,True,0,5 user reviews,3,2,5
623870,True,0,No user reviews,0,0,0
623880,True,5,Mixed,118,58,176
623890,True,0,6 user reviews,6,0,6
623900,True,0,8 user reviews,4,4,8
623920,True,5,Mixed,11,12,23
623930,True,5,Mixed,9,12,21
623940,True,8,Very Positive,2267,122,2389
623980,True,0,No user reviews,0,0,0
623990,True,0,No user reviews,0,0,0
624020,True,0,No user reviews,0,0,0
624030,True,0,No user reviews,0,0,0
624040,True,0,No user reviews,0,0,0
624041,True,0,No user reviews,0,0,0
624042,True,0,No user reviews,0,0,0
624043,True,0,No user reviews,0,0,0
624050,True,0,5 user reviews,5,0,5
624060,True,0,2 user reviews,1,1,2
624070,True,0,9 user reviews,7,2,9
624080,True,0,8 user reviews,8,0,8
624090,True,5,Mixed,1094,606,1700
624110,True,0,No user reviews,0,0,0
624120,True,5,Mixed,34,26,60
624140,True,0,No user reviews,0,0,0
624150,True,0,No user reviews,0,0,0
624260,True,0,No user reviews,0,0,0
624270,True,8,Very Positive,780,106,886
624280,True,0,1 user reviews,1,0,1
624281,True,0,No user reviews,0,0,0
624282,True,0,No user reviews,0,0,0
624320,True,7,Positive,27,4,31
624330,True,0,3 user reviews,2,1,3
624360,True,0,No user reviews,0,0,0
624390,True,0,No user reviews,0,0,0
624410,True,0,1 user reviews,0,1,1
624430,True,5,Mixed,8,6,14
624460,True,0,No user reviews,0,0,0
624480,True,0,No user reviews,0,0,0
624510,True,0,No user reviews,0,0,0
624530,True,0,No user reviews,0,0,0
624531,True,0,No user reviews,0,0,0
624540,True,0,No user reviews,0,0,0
624550,True,6,Mostly Positive,7,3,10
624560,True,0,7 user reviews,1,6,7
624590,True,0,No user reviews,0,0,0
624610,True,0,3 user reviews,2,1,3
624620,True,4,Mostly Negative,27,47,74
624621,True,4,Mostly Negative,14,28,42
624622,True,4,Mostly Negative,14,22,36
624630,True,0,6 user reviews,1,5,6
624650,True,0,No user reviews,0,0,0
624660,True,0,No user reviews,0,0,0
624670,True,0,No user reviews,0,0,0
624680,True,7,Positive,10,2,12
624690,True,6,Mostly Positive,30,11,41
624700,True,0,1 user reviews,1,0,1
624710,True,0,9 user reviews,8,1,9
624720,True,0,No user reviews,0,0,0
624730,True,0,No user reviews,0,0,0
624760,True,0,No user reviews,0,0,0
624770,True,0,No user reviews,0,0,0
624771,True,0,No user reviews,0,0,0
624773,True,0,No user reviews,0,0,0
624780,True,0,2 user reviews,1,1,2
624790,True,0,No user reviews,0,0,0
624830,True,7,Positive,21,2,23
624840,True,0,2 user reviews,2,0,2
624850,True,0,No user reviews,0,0,0
624890,True,6,Mostly Positive,20,8,28
624900,True,0,No user reviews,0,0,0
624910,True,0,No user reviews,0,0,0
624920,True,0,No user reviews,0,0,0
624930,True,0,No user reviews,0,0,0
624940,True,0,2 user reviews,1,1,2
624960,True,0,No user reviews,0,0,0
624970,True,8,Very Positive,304,51,355
624990,True,0,6 user reviews,6,0,6
625000,True,7,Positive,12,0,12
625010,True,7,Positive,15,2,17
625020,True,0,No user reviews,0,0,0
625030,True,0,3 user reviews,2,1,3
625040,True,0,6 user reviews,3,3,6
625050,True,5,Mixed,60,81,141
625060,True,0,No user reviews,0,0,0
625080,True,0,No user reviews,0,0,0
625090,True,0,No user reviews,0,0,0
625100,True,0,1 user reviews,1,0,1
625110,True,0,No user reviews,0,0,0
625120,True,7,Positive,16,4,20
625140,True,0,No user reviews,0,0,0
625160,True,0,3 user reviews,2,1,3
625180,True,0,7 user reviews,1,6,7
625190,True,0,7 user reviews,4,3,7
625200,True,0,No user reviews,0,0,0
625210,True,0,No user reviews,0,0,0
625220,True,0,No user reviews,0,0,0
625230,True,0,No user reviews,0,0,0
625260,True,0,No user reviews,0,0,0
625290,True,0,No user reviews,0,0,0
625320,True,0,6 user reviews,4,2,6
625330,True,0,No user reviews,0,0,0
625340,True,5,Mixed,385,207,592
625350,True,0,3 user reviews,1,2,3
625370,True,5,Mixed,13,12,25
625390,True,0,No user reviews,0,0,0
625410,True,0,3 user reviews,3,0,3
625430,True,0,6 user reviews,3,3,6
625440,True,0,No user reviews,0,0,0
625450,True,0,No user reviews,0,0,0
625460,True,0,3 user reviews,3,0,3
625470,True,0,No user reviews,0,0,0
625480,True,0,4 user reviews,4,0,4
625490,True,0,No user reviews,0,0,0
625500,True,0,9 user reviews,8,1,9
625510,True,0,No user reviews,0,0,0
625560,True,0,6 user reviews,5,1,6
625570,True,0,No user reviews,0,0,0
625580,True,0,No user reviews,0,0,0
625610,True,0,No user reviews,0,0,0
625630,True,0,2 user reviews,2,0,2
625640,True,0,No user reviews,0,0,0
625660,True,0,No user reviews,0,0,0
625680,True,8,Very Positive,58,12,70
625690,True,0,3 user reviews,3,0,3
625700,True,5,Mixed,6,4,10
625710,True,0,No user reviews,0,0,0
625730,True,6,Mostly Positive,13,5,18
625740,True,8,Very Positive,71,1,72
625750,True,0,No user reviews,0,0,0
625770,True,7,Positive,14,0,14
625780,True,7,Positive,31,2,33
625790,True,0,No user reviews,0,0,0
625800,True,0,1 user reviews,1,0,1
625810,True,0,No user reviews,0,0,0
625820,True,7,Positive,15,2,17
625830,True,7,Positive,14,3,17
625860,True,0,No user reviews,0,0,0
625900,True,0,3 user reviews,3,0,3
625910,True,6,Mostly Positive,27,8,35
625920,True,0,No user reviews,0,0,0
625940,True,7,Positive,15,0,15
625960,True,6,Mostly Positive,3284,1109,4393
625970,True,0,1 user reviews,1,0,1
625980,True,8,Very Positive,70,4,74
625990,True,6,Mostly Positive,27,8,35
626000,True,0,No user reviews,0,0,0
626010,True,0,No user reviews,0,0,0
626020,True,0,6 user reviews,3,3,6
626130,True,0,2 user reviews,1,1,2
626160,True,0,5 user reviews,2,3,5
626170,True,0,8 user reviews,5,3,8
626180,True,0,6 user reviews,6,0,6
626200,True,4,Mostly Negative,12,28,40
626220,True,0,No user reviews,0,0,0
626230,True,0,No user reviews,0,0,0
626240,True,0,No user reviews,0,0,0
626250,True,5,Mixed,9,4,13
626270,True,0,No user reviews,0,0,0
626280,True,0,No user reviews,0,0,0
626290,True,0,No user reviews,0,0,0
626300,True,0,No user reviews,0,0,0
626310,True,0,No user reviews,0,0,0
626320,True,0,No user reviews,0,0,0
626330,True,0,No user reviews,0,0,0
626340,True,0,No user reviews,0,0,0
626350,True,0,No user reviews,0,0,0
626360,True,0,No user reviews,0,0,0
626370,True,0,No user reviews,0,0,0
626380,True,0,No user reviews,0,0,0
626390,True,0,No user reviews,0,0,0
626400,True,0,No user reviews,0,0,0
626410,True,0,No user reviews,0,0,0
626420,True,0,No user reviews,0,0,0
626430,True,0,No user reviews,0,0,0
626440,True,0,No user reviews,0,0,0
626450,True,7,Positive,28,2,30
626460,True,0,No user reviews,0,0,0
626470,True,5,Mixed,192,133,325
626480,True,0,No user reviews,0,0,0
626481,True,0,No user reviews,0,0,0
626482,True,0,No user reviews,0,0,0
626483,True,0,No user reviews,0,0,0
626484,True,0,No user reviews,0,0,0
626485,True,0,No user reviews,0,0,0
626486,True,0,No user reviews,0,0,0
626487,True,0,No user reviews,0,0,0
626488,True,0,No user reviews,0,0,0
626489,True,0,No user reviews,0,0,0
626491,True,0,2 user reviews,2,0,2
626510,True,8,Very Positive,45,10,55
626520,True,0,No user reviews,0,0,0
626521,True,0,5 user reviews,5,0,5
626522,True,0,No user reviews,0,0,0
626523,True,0,2 user reviews,2,0,2
626530,True,0,1 user reviews,1,0,1
626531,True,0,1 user reviews,1,0,1
626532,True,0,No user reviews,0,0,0
626533,True,0,No user reviews,0,0,0
626534,True,0,No user reviews,0,0,0
626535,True,0,1 user reviews,1,0,1
626536,True,0,3 user reviews,3,0,3
626540,True,0,2 user reviews,2,0,2
626541,True,0,No user reviews,0,0,0
626542,True,0,No user reviews,0,0,0
626543,True,0,1 user reviews,1,0,1
626544,True,0,No user reviews,0,0,0
626545,True,0,No user reviews,0,0,0
626546,True,0,No user reviews,0,0,0
626547,True,0,1 user reviews,1,0,1
626548,True,0,1 user reviews,1,0,1
626550,True,5,Mixed,24,32,56
626560,True,0,1 user reviews,1,0,1
626561,True,0,3 user reviews,3,0,3
626562,True,0,2 user reviews,2,0,2
626570,True,0,1 user reviews,1,0,1
626580,True,7,Positive,37,4,41
626590,True,0,No user reviews,0,0,0
626600,True,6,Mostly Positive,62,20,82
626610,True,6,Mostly Positive,252,101,353
626630,True,4,Mostly Negative,4,8,12
626640,True,7,Positive,29,2,31
626650,True,0,No user reviews,0,0,0
626660,True,8,Very Positive,50,5,55
626670,True,0,No user reviews,0,0,0
626680,True,0,No user reviews,0,0,0
626690,True,8,Very Positive,2908,582,3490
626700,True,0,No user reviews,0,0,0
626730,True,0,4 user reviews,2,2,4
626740,True,0,No user reviews,0,0,0
626760,True,4,Mostly Negative,3,7,10
626780,True,0,No user reviews,0,0,0
626790,True,7,Positive,11,2,13
626800,True,0,No user reviews,0,0,0
626810,True,0,No user reviews,0,0,0
626830,True,0,1 user reviews,0,1,1
626840,True,0,2 user reviews,2,0,2
626850,True,0,No user reviews,0,0,0
626860,True,0,No user reviews,0,0,0
626861,True,0,No user reviews,0,0,0
626862,True,0,No user reviews,0,0,0
626863,True,0,No user reviews,0,0,0
626864,True,0,1 user reviews,1,0,1
626865,True,0,No user reviews,0,0,0
626866,True,0,No user reviews,0,0,0
626867,True,0,No user reviews,0,0,0
626868,True,0,No user reviews,0,0,0
626869,True,0,No user reviews,0,0,0
626870,True,0,No user reviews,0,0,0
626871,True,0,No user reviews,0,0,0
626880,True,0,No user reviews,0,0,0
626881,True,0,No user reviews,0,0,0
626882,True,0,No user reviews,0,0,0
626883,True,0,No user reviews,0,0,0
626884,True,0,No user reviews,0,0,0
626885,True,0,No user reviews,0,0,0
626886,True,0,No user reviews,0,0,0
626887,True,0,No user reviews,0,0,0
626888,True,0,No user reviews,0,0,0
626889,True,0,No user reviews,0,0,0
626890,True,0,No user reviews,0,0,0
626891,True,0,No user reviews,0,0,0
626892,True,0,No user reviews,0,0,0
626900,True,0,No user reviews,0,0,0
626910,True,0,No user reviews,0,0,0
626911,True,0,No user reviews,0,0,0
626912,True,0,No user reviews,0,0,0
626913,True,0,No user reviews,0,0,0
626914,True,0,No user reviews,0,0,0
626915,True,0,No user reviews,0,0,0
626916,True,0,No user reviews,0,0,0
626917,True,0,No user reviews,0,0,0
626918,True,0,No user reviews,0,0,0
626919,True,0,No user reviews,0,0,0
626920,True,0,No user reviews,0,0,0
626921,True,0,No user reviews,0,0,0
626930,True,0,No user reviews,0,0,0
626940,True,0,No user reviews,0,0,0
626950,True,0,No user reviews,0,0,0
626960,True,0,No user reviews,0,0,0
626961,True,0,No user reviews,0,0,0
626962,True,0,No user reviews,0,0,0
626963,True,0,No user reviews,0,0,0
626964,True,0,No user reviews,0,0,0
626965,True,0,No user reviews,0,0,0
626966,True,0,No user reviews,0,0,0
626967,True,0,No user reviews,0,0,0
626968,True,0,No user reviews,0,0,0
626969,True,0,No user reviews,0,0,0
626970,True,0,No user reviews,0,0,0
626971,True,0,No user reviews,0,0,0
626972,True,0,No user reviews,0,0,0
626973,True,0,No user reviews,0,0,0
626990,True,0,No user reviews,0,0,0
626991,True,0,No user reviews,0,0,0
626992,True,0,No user reviews,0,0,0
626993,True,0,No user reviews,0,0,0
626994,True,0,No user reviews,0,0,0
626995,True,0,No user reviews,0,0,0
626996,True,0,No user reviews,0,0,0
626997,True,0,No user reviews,0,0,0
626998,True,0,No user reviews,0,0,0
626999,True,0,No user reviews,0,0,0
627000,True,0,No user reviews,0,0,0
627001,True,0,No user reviews,0,0,0
627010,True,0,1 user reviews,1,0,1
627011,True,0,No user reviews,0,0,0
627012,True,0,No user reviews,0,0,0
627013,True,0,1 user reviews,1,0,1
627030,True,0,No user reviews,0,0,0
627040,True,0,No user reviews,0,0,0
627050,True,0,1 user reviews,1,0,1
627051,True,0,No user reviews,0,0,0
627052,True,0,No user reviews,0,0,0
627053,True,0,No user reviews,0,0,0
627054,True,0,No user reviews,0,0,0
627055,True,0,No user reviews,0,0,0
627056,True,0,No user reviews,0,0,0
627057,True,0,No user reviews,0,0,0
627058,True,0,No user reviews,0,0,0
627059,True,0,No user reviews,0,0,0
627060,True,0,No user reviews,0,0,0
627061,True,0,No user reviews,0,0,0
627062,True,0,No user reviews,0,0,0
627070,True,7,Positive,26,1,27
627080,True,0,No user reviews,0,0,0
627081,True,0,No user reviews,0,0,0
627082,True,0,No user reviews,0,0,0
627083,True,0,No user reviews,0,0,0
627084,True,0,No user reviews,0,0,0
627090,True,0,No user reviews,0,0,0
627091,True,0,No user reviews,0,0,0
627092,True,0,No user reviews,0,0,0
627093,True,0,No user reviews,0,0,0
627094,True,0,No user reviews,0,0,0
627095,True,0,No user reviews,0,0,0
627096,True,0,No user reviews,0,0,0
627097,True,0,No user reviews,0,0,0
627098,True,0,No user reviews,0,0,0
627099,True,0,No user reviews,0,0,0
627100,True,0,No user reviews,0,0,0
627101,True,0,No user reviews,0,0,0
627110,True,0,No user reviews,0,0,0
627111,True,0,No user reviews,0,0,0
627112,True,0,No user reviews,0,0,0
627113,True,0,No user reviews,0,0,0
627114,True,0,No user reviews,0,0,0
627115,True,0,No user reviews,0,0,0
627116,True,0,No user reviews,0,0,0
627117,True,0,No user reviews,0,0,0
627118,True,0,No user reviews,0,0,0
627119,True,0,No user reviews,0,0,0
627120,True,0,No user reviews,0,0,0
627121,True,0,No user reviews,0,0,0
627122,True,0,No user reviews,0,0,0
627140,True,0,No user reviews,0,0,0
627150,True,0,No user reviews,0,0,0
627151,True,0,No user reviews,0,0,0
627152,True,0,No user reviews,0,0,0
627153,True,0,No user reviews,0,0,0
627154,True,0,No user reviews,0,0,0
627155,True,0,No user reviews,0,0,0
627156,True,0,No user reviews,0,0,0
627157,True,0,No user reviews,0,0,0
627158,True,0,No user reviews,0,0,0
627159,True,0,No user reviews,0,0,0
627160,True,0,No user reviews,0,0,0
627161,True,0,No user reviews,0,0,0
627162,True,0,No user reviews,0,0,0
627163,True,0,No user reviews,0,0,0
627164,True,0,No user reviews,0,0,0
627165,True,0,No user reviews,0,0,0
627166,True,0,No user reviews,0,0,0
627167,True,0,No user reviews,0,0,0
627168,True,0,No user reviews,0,0,0
627169,True,0,No user reviews,0,0,0
627170,True,0,No user reviews,0,0,0
627171,True,0,No user reviews,0,0,0
627180,True,0,No user reviews,0,0,0
627200,True,0,No user reviews,0,0,0
627201,True,0,No user reviews,0,0,0
627202,True,0,No user reviews,0,0,0
627203,True,0,No user reviews,0,0,0
627204,True,0,No user reviews,0,0,0
627205,True,0,No user reviews,0,0,0
627206,True,0,No user reviews,0,0,0
627207,True,0,No user reviews,0,0,0
627208,True,0,No user reviews,0,0,0
627209,True,0,No user reviews,0,0,0
627210,True,0,No user reviews,0,0,0
627211,True,0,No user reviews,0,0,0
627212,True,0,No user reviews,0,0,0
627213,True,0,No user reviews,0,0,0
627214,True,0,No user reviews,0,0,0
627215,True,0,No user reviews,0,0,0
627217,True,0,No user reviews,0,0,0
627220,True,5,Mixed,9,4,13
627230,True,0,No user reviews,0,0,0
627231,True,0,No user reviews,0,0,0
627232,True,0,No user reviews,0,0,0
627233,True,0,No user reviews,0,0,0
627234,True,0,No user reviews,0,0,0
627235,True,0,No user reviews,0,0,0
627236,True,0,No user reviews,0,0,0
627237,True,0,No user reviews,0,0,0
627238,True,0,No user reviews,0,0,0
627239,True,0,No user reviews,0,0,0
627240,True,0,No user reviews,0,0,0
627241,True,0,No user reviews,0,0,0
627242,True,0,No user reviews,0,0,0
627250,True,0,No user reviews,0,0,0
627260,True,0,No user reviews,0,0,0
627261,True,0,No user reviews,0,0,0
627270,True,8,Very Positive,1616,363,1979
627290,True,0,No user reviews,0,0,0
627300,True,0,No user reviews,0,0,0
627301,True,0,No user reviews,0,0,0
627302,True,0,No user reviews,0,0,0
627303,True,0,No user reviews,0,0,0
627310,True,0,4 user reviews,4,0,4
627320,True,0,No user reviews,0,0,0
627340,True,0,No user reviews,0,0,0
627350,True,7,Positive,36,6,42
627360,True,0,No user reviews,0,0,0
627370,True,0,1 user reviews,1,0,1
627380,True,0,No user reviews,0,0,0
627390,True,0,5 user reviews,4,1,5
627400,True,0,No user reviews,0,0,0
627410,True,0,5 user reviews,3,2,5
627420,True,0,1 user reviews,1,0,1
627430,True,7,Positive,20,4,24
627440,True,7,Positive,16,3,19
627450,True,5,Mixed,15,22,37
627460,True,0,3 user reviews,0,3,3
627470,True,0,No user reviews,0,0,0
627500,True,0,No user reviews,0,0,0
627510,True,8,Very Positive,197,18,215
627530,True,0,No user reviews,0,0,0
627540,True,0,No user reviews,0,0,0
627570,True,0,3 user reviews,3,0,3
627580,True,7,Positive,18,2,20
627581,True,0,No user reviews,0,0,0
627582,True,0,8 user reviews,7,1,8
627610,True,0,No user reviews,0,0,0
627620,True,5,Mixed,38,41,79
627630,True,0,No user reviews,0,0,0
627631,True,0,No user reviews,0,0,0
627632,True,0,No user reviews,0,0,0
627633,True,0,No user reviews,0,0,0
627634,True,0,No user reviews,0,0,0
627635,True,0,No user reviews,0,0,0
627636,True,0,No user reviews,0,0,0
627637,True,0,No user reviews,0,0,0
627638,True,0,No user reviews,0,0,0
627639,True,0,No user reviews,0,0,0
627640,True,0,No user reviews,0,0,0
627641,True,0,No user reviews,0,0,0
627650,True,0,No user reviews,0,0,0
627651,True,0,No user reviews,0,0,0
627652,True,0,No user reviews,0,0,0
627653,True,0,No user reviews,0,0,0
627654,True,0,No user reviews,0,0,0
627655,True,0,No user reviews,0,0,0
627656,True,0,No user reviews,0,0,0
627657,True,0,No user reviews,0,0,0
627658,True,0,No user reviews,0,0,0
627659,True,0,1 user reviews,1,0,1
627660,True,0,No user reviews,0,0,0
627661,True,0,No user reviews,0,0,0
627662,True,0,No user reviews,0,0,0
627670,True,0,8 user reviews,8,0,8
627680,True,0,No user reviews,0,0,0
627690,True,7,Positive,15,3,18
627710,True,0,No user reviews,0,0,0
627711,True,0,No user reviews,0,0,0
627712,True,0,No user reviews,0,0,0
627713,True,0,No user reviews,0,0,0
627714,True,0,No user reviews,0,0,0
627715,True,0,No user reviews,0,0,0
627716,True,0,No user reviews,0,0,0
627717,True,0,No user reviews,0,0,0
627718,True,0,No user reviews,0,0,0
627719,True,0,No user reviews,0,0,0
627720,True,0,No user reviews,0,0,0
627721,True,0,No user reviews,0,0,0
627730,True,0,No user reviews,0,0,0
627731,True,0,No user reviews,0,0,0
627732,True,0,No user reviews,0,0,0
627733,True,0,No user reviews,0,0,0
627734,True,0,No user reviews,0,0,0
627735,True,0,No user reviews,0,0,0
627736,True,0,No user reviews,0,0,0
627737,True,0,No user reviews,0,0,0
627738,True,0,No user reviews,0,0,0
627739,True,0,No user reviews,0,0,0
627740,True,0,No user reviews,0,0,0
627741,True,0,No user reviews,0,0,0
627742,True,0,No user reviews,0,0,0
627750,True,0,No user reviews,0,0,0
627751,True,0,No user reviews,0,0,0
627752,True,0,No user reviews,0,0,0
627753,True,0,No user reviews,0,0,0
627754,True,0,No user reviews,0,0,0
627755,True,0,No user reviews,0,0,0
627756,True,0,No user reviews,0,0,0
627757,True,0,No user reviews,0,0,0
627758,True,0,No user reviews,0,0,0
627759,True,0,No user reviews,0,0,0
627760,True,0,No user reviews,0,0,0
627761,True,0,No user reviews,0,0,0
627762,True,0,No user reviews,0,0,0
627763,True,0,No user reviews,0,0,0
627764,True,0,No user reviews,0,0,0
627765,True,0,No user reviews,0,0,0
627766,True,0,No user reviews,0,0,0
627767,True,0,No user reviews,0,0,0
627768,True,0,No user reviews,0,0,0
627769,True,0,No user reviews,0,0,0
627770,True,0,No user reviews,0,0,0
627771,True,0,1 user reviews,1,0,1
627780,True,0,No user reviews,0,0,0
627781,True,0,No user reviews,0,0,0
627782,True,0,No user reviews,0,0,0
627783,True,0,No user reviews,0,0,0
627784,True,0,No user reviews,0,0,0
627785,True,0,No user reviews,0,0,0
627786,True,0,No user reviews,0,0,0
627787,True,0,No user reviews,0,0,0
627790,True,0,No user reviews,0,0,0
627791,True,0,No user reviews,0,0,0
627792,True,0,No user reviews,0,0,0
627793,True,0,No user reviews,0,0,0
627794,True,0,No user reviews,0,0,0
627795,True,0,No user reviews,0,0,0
627796,True,0,No user reviews,0,0,0
627797,True,0,No user reviews,0,0,0
627798,True,0,No user reviews,0,0,0
627799,True,0,No user reviews,0,0,0
627800,True,0,No user reviews,0,0,0
627801,True,0,No user reviews,0,0,0
627802,True,0,No user reviews,0,0,0
627803,True,0,No user reviews,0,0,0
627804,True,0,No user reviews,0,0,0
627805,True,0,No user reviews,0,0,0
627806,True,0,No user reviews,0,0,0
627807,True,0,No user reviews,0,0,0
627808,True,0,No user reviews,0,0,0
627809,True,0,No user reviews,0,0,0
627810,True,0,No user reviews,0,0,0
627811,True,0,No user reviews,0,0,0
627820,True,5,Mixed,42,27,69
627830,True,0,No user reviews,0,0,0
627840,True,0,No user reviews,0,0,0
627841,True,0,No user reviews,0,0,0
627842,True,0,No user reviews,0,0,0
627843,True,0,No user reviews,0,0,0
627844,True,0,No user reviews,0,0,0
627845,True,0,No user reviews,0,0,0
627846,True,0,No user reviews,0,0,0
627847,True,0,No user reviews,0,0,0
627848,True,0,No user reviews,0,0,0
627849,True,0,No user reviews,0,0,0
627850,True,0,No user reviews,0,0,0
627851,True,0,No user reviews,0,0,0
627852,True,0,No user reviews,0,0,0
627853,True,0,No user reviews,0,0,0
627854,True,0,No user reviews,0,0,0
627855,True,0,No user reviews,0,0,0
627856,True,0,No user reviews,0,0,0
627857,True,0,No user reviews,0,0,0
627858,True,0,No user reviews,0,0,0
627859,True,0,No user reviews,0,0,0
627860,True,0,No user reviews,0,0,0
627861,True,0,No user reviews,0,0,0
627862,True,0,No user reviews,0,0,0
627863,True,0,No user reviews,0,0,0
627864,True,0,No user reviews,0,0,0
627865,True,0,No user reviews,0,0,0
627866,True,0,No user reviews,0,0,0
627867,True,0,No user reviews,0,0,0
627868,True,0,No user reviews,0,0,0
627869,True,0,No user reviews,0,0,0
627870,True,0,No user reviews,0,0,0
627871,True,0,No user reviews,0,0,0
627872,True,0,No user reviews,0,0,0
627873,True,0,No user reviews,0,0,0
627874,True,0,No user reviews,0,0,0
627875,True,0,No user reviews,0,0,0
627880,True,0,1 user reviews,0,1,1
627881,True,0,No user reviews,0,0,0
627882,True,0,No user reviews,0,0,0
627883,True,0,No user reviews,0,0,0
627884,True,0,No user reviews,0,0,0
627885,True,0,No user reviews,0,0,0
627886,True,0,No user reviews,0,0,0
627887,True,0,No user reviews,0,0,0
627888,True,0,No user reviews,0,0,0
627889,True,0,No user reviews,0,0,0
627890,True,7,Positive,9,1,10
627900,True,0,No user reviews,0,0,0
627901,True,0,No user reviews,0,0,0
627902,True,0,No user reviews,0,0,0
627903,True,0,No user reviews,0,0,0
627904,True,0,No user reviews,0,0,0
627905,True,0,No user reviews,0,0,0
627906,True,0,No user reviews,0,0,0
627907,True,0,No user reviews,0,0,0
627908,True,0,No user reviews,0,0,0
627909,True,0,No user reviews,0,0,0
627910,True,5,Mixed,68,45,113
627930,True,0,No user reviews,0,0,0
627931,True,0,No user reviews,0,0,0
627932,True,0,No user reviews,0,0,0
627933,True,0,No user reviews,0,0,0
627934,True,0,No user reviews,0,0,0
627935,True,0,No user reviews,0,0,0
627936,True,0,No user reviews,0,0,0
627937,True,0,No user reviews,0,0,0
627938,True,0,No user reviews,0,0,0
627939,True,0,No user reviews,0,0,0
627940,True,0,No user reviews,0,0,0
627941,True,0,No user reviews,0,0,0
627942,True,0,No user reviews,0,0,0
627950,True,0,3 user reviews,0,3,3
627960,True,0,No user reviews,0,0,0
627961,True,0,No user reviews,0,0,0
627962,True,0,No user reviews,0,0,0
627963,True,0,No user reviews,0,0,0
627964,True,0,No user reviews,0,0,0
627965,True,0,No user reviews,0,0,0
627966,True,0,No user reviews,0,0,0
627967,True,0,No user reviews,0,0,0
627968,True,0,No user reviews,0,0,0
627969,True,0,No user reviews,0,0,0
627970,True,0,No user reviews,0,0,0
627971,True,0,No user reviews,0,0,0
627980,True,0,1 user reviews,1,0,1
627990,True,0,No user reviews,0,0,0
628000,True,0,6 user reviews,5,1,6
628001,True,0,No user reviews,0,0,0
628002,True,0,No user reviews,0,0,0
628003,True,0,No user reviews,0,0,0
628004,True,0,No user reviews,0,0,0
628005,True,0,No user reviews,0,0,0
628006,True,0,No user reviews,0,0,0
628007,True,0,No user reviews,0,0,0
628008,True,0,No user reviews,0,0,0
628009,True,0,1 user reviews,1,0,1
628010,True,0,No user reviews,0,0,0
628011,True,0,No user reviews,0,0,0
628020,True,0,1 user reviews,1,0,1
628030,True,0,6 user reviews,2,4,6
628040,True,0,6 user reviews,2,4,6
628050,True,6,Mostly Positive,14,5,19
628060,True,5,Mixed,16,11,27
628070,True,6,Mostly Positive,71,22,93
628080,True,0,6 user reviews,2,4,6
628090,True,0,No user reviews,0,0,0
628100,True,0,No user reviews,0,0,0
628110,True,0,1 user reviews,1,0,1
628120,True,0,1 user reviews,0,1,1
628130,True,0,4 user reviews,2,2,4
628140,True,0,4 user reviews,1,3,4
628150,True,0,5 user reviews,4,1,5
628160,True,0,1 user reviews,0,1,1
628170,True,0,6 user reviews,5,1,6
628180,True,0,1 user reviews,1,0,1
628190,True,0,No user reviews,0,0,0
628200,True,0,No user reviews,0,0,0
628220,True,0,No user reviews,0,0,0
628240,True,0,No user reviews,0,0,0
628250,True,0,No user reviews,0,0,0
628260,True,0,No user reviews,0,0,0
628280,True,0,No user reviews,0,0,0
628290,True,6,Mostly Positive,72,30,102
628300,True,0,No user reviews,0,0,0
628310,True,0,No user reviews,0,0,0
628320,True,7,Positive,20,4,24
628330,True,4,Mostly Negative,7,11,18
628350,True,7,Positive,22,5,27
628410,True,0,No user reviews,0,0,0
628440,True,0,No user reviews,0,0,0
628450,True,0,4 user reviews,3,1,4
628460,True,7,Positive,38,2,40
628470,True,0,No user reviews,0,0,0
628471,True,0,No user reviews,0,0,0
628472,True,0,No user reviews,0,0,0
628473,True,0,1 user reviews,1,0,1
628474,True,0,No user reviews,0,0,0
628475,True,0,No user reviews,0,0,0
628476,True,0,No user reviews,0,0,0
628477,True,0,No user reviews,0,0,0
628478,True,0,No user reviews,0,0,0
628479,True,0,No user reviews,0,0,0
628480,True,0,No user reviews,0,0,0
628481,True,0,No user reviews,0,0,0
628530,True,0,No user reviews,0,0,0
628540,True,0,7 user reviews,7,0,7
628550,True,0,No user reviews,0,0,0
628560,True,0,No user reviews,0,0,0
628570,True,0,7 user reviews,5,2,7
628580,True,0,5 user reviews,5,0,5
628600,True,0,No user reviews,0,0,0
628610,True,0,No user reviews,0,0,0
628650,True,0,2 user reviews,0,2,2
628660,True,7,Positive,32,6,38
628670,True,8,Very Positive,631,132,763
628680,True,0,No user reviews,0,0,0
628700,True,0,No user reviews,0,0,0
628710,True,6,Mostly Positive,32,12,44
628720,True,7,Positive,19,4,23
628730,True,0,No user reviews,0,0,0
628750,True,8,Very Positive,118,28,146
628760,True,7,Positive,18,4,22
628770,True,8,Very Positive,374,45,419
628790,True,0,No user reviews,0,0,0
628800,True,8,Very Positive,66,3,69
628820,True,0,6 user reviews,2,4,6
628830,True,0,4 user reviews,4,0,4
628880,True,0,No user reviews,0,0,0
628890,True,5,Mixed,31,21,52
628900,True,5,Mixed,54,44,98
628920,True,8,Very Positive,98,12,110
628930,True,0,No user reviews,0,0,0
628940,True,0,1 user reviews,1,0,1
628950,True,5,Mixed,57,28,85
628960,True,0,5 user reviews,5,0,5
628970,True,0,No user reviews,0,0,0
628980,True,0,No user reviews,0,0,0
629000,True,8,Very Positive,157,14,171
629010,True,0,No user reviews,0,0,0
629020,True,0,5 user reviews,5,0,5
629021,True,0,4 user reviews,4,0,4
629030,True,4,Mostly Negative,14,55,69
629040,True,6,Mostly Positive,14,5,19
629070,True,0,No user reviews,0,0,0
629080,True,0,4 user reviews,4,0,4
629090,True,8,Very Positive,170,21,191
629100,True,0,8 user reviews,8,0,8
629110,True,7,Positive,17,1,18
629160,True,0,No user reviews,0,0,0
629170,True,0,No user reviews,0,0,0
629180,True,0,No user reviews,0,0,0
629190,True,0,No user reviews,0,0,0
629191,True,0,No user reviews,0,0,0
629210,True,0,5 user reviews,1,4,5
629220,True,6,Mostly Positive,162,49,211
629230,True,7,Positive,10,2,12
629240,True,6,Mostly Positive,7,3,10
629260,True,0,No user reviews,0,0,0
629270,True,0,No user reviews,0,0,0
629310,True,0,No user reviews,0,0,0
629330,True,8,Very Positive,238,4,242
629340,True,0,7 user reviews,7,0,7
629360,True,0,3 user reviews,1,2,3
629370,True,0,No user reviews,0,0,0
629380,True,0,1 user reviews,1,0,1
629390,True,0,No user reviews,0,0,0
629400,True,0,1 user reviews,1,0,1
629410,True,0,7 user reviews,6,1,7
629420,True,0,3 user reviews,3,0,3
629430,True,7,Positive,32,1,33
629440,True,8,Very Positive,61,0,61
629450,True,0,No user reviews,0,0,0
629470,True,0,No user reviews,0,0,0
629490,True,0,No user reviews,0,0,0
629500,True,0,No user reviews,0,0,0
629510,True,0,No user reviews,0,0,0
629520,True,9,Overwhelmingly Positive,4780,136,4916
629540,True,6,Mostly Positive,28,8,36
629550,True,0,1 user reviews,1,0,1
629580,True,0,7 user reviews,2,5,7
629610,True,0,No user reviews,0,0,0
629620,True,0,No user reviews,0,0,0
629630,True,0,No user reviews,0,0,0
629640,True,0,7 user reviews,2,5,7
629650,True,7,Positive,41,8,49
629680,True,0,No user reviews,0,0,0
629690,True,8,Very Positive,311,37,348
629700,True,7,Positive,14,0,14
629710,True,0,No user reviews,0,0,0
629720,True,0,No user reviews,0,0,0
629730,True,8,Very Positive,9605,592,10197
629751,True,0,6 user reviews,3,3,6
629760,True,8,Very Positive,36407,6756,43163
629770,True,8,Very Positive,100,7,107
629780,True,0,2 user reviews,1,1,2
629790,True,0,No user reviews,0,0,0
629791,True,0,No user reviews,0,0,0
629792,True,0,No user reviews,0,0,0
629793,True,0,No user reviews,0,0,0
629794,True,0,No user reviews,0,0,0
629795,True,0,No user reviews,0,0,0
629796,True,0,No user reviews,0,0,0
629800,True,0,No user reviews,0,0,0
629810,True,0,3 user reviews,3,0,3
629820,True,0,No user reviews,0,0,0
629830,True,0,3 user reviews,3,0,3
629840,True,5,Mixed,238,130,368
629860,True,7,Positive,20,4,24
629880,True,0,No user reviews,0,0,0
629890,True,0,No user reviews,0,0,0
629900,True,0,No user reviews,0,0,0
629910,True,5,Mixed,501,297,798
629920,True,0,No user reviews,0,0,0
629930,True,0,5 user reviews,4,1,5
629940,True,0,8 user reviews,8,0,8
629960,True,6,Mostly Positive,17,6,23
629970,True,0,8 user reviews,7,1,8
629990,True,5,Mixed,6,6,12
630010,True,6,Mostly Positive,39,12,51
630020,True,6,Mostly Positive,7,3,10
630030,True,6,Mostly Positive,85,30,115
630040,True,0,No user reviews,0,0,0
630050,True,6,Mostly Positive,13,5,18
630060,True,7,Positive,26,2,28
630070,True,0,7 user reviews,6,1,7
630080,True,0,8 user reviews,8,0,8
630100,True,0,No user reviews,0,0,0
630130,True,0,No user reviews,0,0,0
630140,True,0,No user reviews,0,0,0
630160,True,0,9 user reviews,8,1,9
630170,True,0,4 user reviews,3,1,4
630180,True,0,No user reviews,0,0,0
630190,True,0,3 user reviews,1,2,3
630200,True,0,No user reviews,0,0,0
630210,True,0,No user reviews,0,0,0
630230,True,0,No user reviews,0,0,0
630240,True,0,1 user reviews,1,0,1
630250,True,0,No user reviews,0,0,0
630260,True,0,6 user reviews,6,0,6
630270,True,0,No user reviews,0,0,0
630280,True,0,7 user reviews,7,0,7
630290,True,0,1 user reviews,1,0,1
630300,True,0,No user reviews,0,0,0
630310,True,6,Mostly Positive,146,38,184
630330,True,0,No user reviews,0,0,0
630340,True,0,No user reviews,0,0,0
630350,True,0,No user reviews,0,0,0
630360,True,5,Mixed,6,7,13
630380,True,0,No user reviews,0,0,0
630390,True,0,No user reviews,0,0,0
630400,True,0,8 user reviews,7,1,8
630420,True,0,No user reviews,0,0,0
630430,True,0,3 user reviews,2,1,3
630440,True,0,No user reviews,0,0,0
630460,True,7,Positive,26,0,26
630470,True,0,5 user reviews,4,1,5
630480,True,0,No user reviews,0,0,0
630490,True,4,Mostly Negative,14,27,41
630500,True,0,6 user reviews,6,0,6
630510,True,0,No user reviews,0,0,0
630530,True,0,No user reviews,0,0,0
630540,True,0,No user reviews,0,0,0
630541,True,0,No user reviews,0,0,0
630542,True,0,No user reviews,0,0,0
630543,True,0,No user reviews,0,0,0
630550,True,7,Positive,38,5,43
630580,True,0,No user reviews,0,0,0
630590,True,0,No user reviews,0,0,0
630610,True,8,Very Positive,120,17,137
630630,True,7,Positive,24,6,30
630640,True,7,Positive,47,0,47
630663,True,0,2 user reviews,1,1,2
630670,True,0,6 user reviews,3,3,6
630690,True,5,Mixed,5,6,11
630720,True,8,Very Positive,126,27,153
630730,True,0,No user reviews,0,0,0
630760,True,0,No user reviews,0,0,0
630780,True,0,No user reviews,0,0,0
630790,True,0,1 user reviews,1,0,1
630830,True,7,Positive,23,1,24
630840,True,0,No user reviews,0,0,0
630850,True,0,9 user reviews,2,7,9
630870,True,7,Positive,13,0,13
630880,True,0,No user reviews,0,0,0
630890,True,0,7 user reviews,4,3,7
630900,True,8,Very Positive,226,16,242
630910,True,6,Mostly Positive,11,3,14
630911,True,0,7 user reviews,7,0,7
630912,True,0,5 user reviews,3,2,5
630913,True,0,1 user reviews,1,0,1
630914,True,0,1 user reviews,0,1,1
630915,True,0,No user reviews,0,0,0
630916,True,0,8 user reviews,5,3,8
630917,True,0,7 user reviews,7,0,7
630918,True,0,9 user reviews,7,2,9
630919,True,0,1 user reviews,1,0,1
630920,True,0,No user reviews,0,0,0
630940,True,5,Mixed,148,124,272
630970,True,0,1 user reviews,0,1,1
630980,True,0,No user reviews,0,0,0
630990,True,0,No user reviews,0,0,0
631110,True,0,No user reviews,0,0,0
631120,True,0,4 user reviews,4,0,4
631130,True,0,No user reviews,0,0,0
631190,True,0,No user reviews,0,0,0
631220,True,0,No user reviews,0,0,0
631240,True,0,3 user reviews,1,2,3
631250,True,0,3 user reviews,2,1,3
631260,True,0,1 user reviews,1,0,1
631270,True,0,3 user reviews,1,2,3
631280,True,0,No user reviews,0,0,0
631290,True,0,No user reviews,0,0,0
631291,True,0,No user reviews,0,0,0
631292,True,0,No user reviews,0,0,0
631293,True,0,No user reviews,0,0,0
631300,True,0,No user reviews,0,0,0
631310,True,0,No user reviews,0,0,0
631320,True,0,No user reviews,0,0,0
631330,True,0,No user reviews,0,0,0
631331,True,0,No user reviews,0,0,0
631332,True,0,1 user reviews,0,1,1
631430,True,0,No user reviews,0,0,0
631440,True,0,No user reviews,0,0,0
631441,True,0,No user reviews,0,0,0
631442,True,0,No user reviews,0,0,0
631443,True,0,No user reviews,0,0,0
631444,True,0,No user reviews,0,0,0
631445,True,0,No user reviews,0,0,0
631446,True,0,No user reviews,0,0,0
631447,True,0,No user reviews,0,0,0
631450,True,0,No user reviews,0,0,0
631490,True,0,6 user reviews,5,1,6
631500,True,0,4 user reviews,4,0,4
631510,True,8,Very Positive,793,94,887
631540,True,4,Mostly Negative,25,42,67
631550,True,0,3 user reviews,3,0,3
631551,True,0,No user reviews,0,0,0
631552,True,0,No user reviews,0,0,0
631553,True,0,1 user reviews,0,1,1
631554,True,0,No user reviews,0,0,0
631560,True,8,Very Positive,73,2,75
631570,True,8,Very Positive,407,21,428
631580,True,0,No user reviews,0,0,0
631610,True,0,1 user reviews,1,0,1
631640,True,0,No user reviews,0,0,0
631650,True,0,No user reviews,0,0,0
631651,True,0,No user reviews,0,0,0
631652,True,0,No user reviews,0,0,0
631653,True,0,No user reviews,0,0,0
631654,True,0,No user reviews,0,0,0
631655,True,0,No user reviews,0,0,0
631660,True,0,No user reviews,0,0,0
631670,True,0,No user reviews,0,0,0
631690,True,0,4 user reviews,3,1,4
631700,True,0,No user reviews,0,0,0
631701,True,0,No user reviews,0,0,0
631702,True,0,No user reviews,0,0,0
631703,True,0,No user reviews,0,0,0
631710,True,0,No user reviews,0,0,0
631711,True,0,No user reviews,0,0,0
631712,True,0,No user reviews,0,0,0
631713,True,0,No user reviews,0,0,0
631714,True,0,No user reviews,0,0,0
631715,True,0,No user reviews,0,0,0
631716,True,0,No user reviews,0,0,0
631717,True,0,No user reviews,0,0,0
631718,True,0,No user reviews,0,0,0
631719,True,0,No user reviews,0,0,0
631720,True,0,No user reviews,0,0,0
631721,True,0,No user reviews,0,0,0
631740,True,0,No user reviews,0,0,0
631741,True,0,No user reviews,0,0,0
631742,True,0,No user reviews,0,0,0
631743,True,0,No user reviews,0,0,0
631744,True,0,No user reviews,0,0,0
631750,True,0,No user reviews,0,0,0
631751,True,0,No user reviews,0,0,0
631752,True,0,No user reviews,0,0,0
631753,True,0,No user reviews,0,0,0
631754,True,0,No user reviews,0,0,0
631755,True,0,No user reviews,0,0,0
631756,True,0,No user reviews,0,0,0
631757,True,0,No user reviews,0,0,0
631758,True,0,No user reviews,0,0,0
631759,True,0,No user reviews,0,0,0
631760,True,0,No user reviews,0,0,0
631761,True,0,No user reviews,0,0,0
631770,True,0,7 user reviews,7,0,7
631780,True,0,2 user reviews,2,0,2
631790,True,0,No user reviews,0,0,0
631791,True,0,1 user reviews,1,0,1
631792,True,0,No user reviews,0,0,0
631793,True,0,No user reviews,0,0,0
631794,True,0,No user reviews,0,0,0
631795,True,0,No user reviews,0,0,0
631796,True,0,No user reviews,0,0,0
631797,True,0,No user reviews,0,0,0
631798,True,0,No user reviews,0,0,0
631799,True,0,No user reviews,0,0,0
631810,True,7,Positive,11,2,13
631830,True,5,Mixed,24,11,35
631840,True,0,No user reviews,0,0,0
631841,True,0,No user reviews,0,0,0
631842,True,0,No user reviews,0,0,0
631843,True,0,No user reviews,0,0,0
631844,True,0,No user reviews,0,0,0
631845,True,0,No user reviews,0,0,0
631846,True,0,No user reviews,0,0,0
631847,True,0,No user reviews,0,0,0
631848,True,0,No user reviews,0,0,0
631849,True,0,No user reviews,0,0,0
631850,True,0,No user reviews,0,0,0
631851,True,0,No user reviews,0,0,0
631860,True,0,No user reviews,0,0,0
631870,True,0,No user reviews,0,0,0
631880,True,0,No user reviews,0,0,0
631890,True,0,No user reviews,0,0,0
631900,True,7,Positive,44,3,47
631910,True,0,3 user reviews,1,2,3
631920,True,0,6 user reviews,3,3,6
631940,True,0,No user reviews,0,0,0
631950,True,0,No user reviews,0,0,0
631960,True,0,No user reviews,0,0,0
631970,True,0,No user reviews,0,0,0
631980,True,8,Very Positive,91,15,106
631990,True,5,Mixed,16,8,24
632000,True,8,Very Positive,261,40,301
632020,True,7,Positive,18,3,21
632030,True,0,No user reviews,0,0,0
632040,True,0,7 user reviews,7,0,7
632050,True,0,2 user reviews,0,2,2
632060,True,0,No user reviews,0,0,0
632070,True,6,Mostly Positive,350,94,444
632080,True,0,No user reviews,0,0,0
632100,True,7,Positive,8,2,10
632110,True,0,8 user reviews,4,4,8
632120,True,0,1 user reviews,1,0,1
632140,True,0,No user reviews,0,0,0
632150,True,0,No user reviews,0,0,0
632160,True,0,No user reviews,0,0,0
632170,True,5,Mixed,17,9,26
632190,True,0,No user reviews,0,0,0
632200,True,0,5 user reviews,0,5,5
632210,True,0,No user reviews,0,0,0
632240,True,0,No user reviews,0,0,0
632250,True,7,Positive,18,3,21
632280,True,0,No user reviews,0,0,0
632290,True,5,Mixed,6,5,11
632300,True,6,Mostly Positive,291,119,410
632310,True,0,No user reviews,0,0,0
632320,True,0,No user reviews,0,0,0
632340,True,0,No user reviews,0,0,0
632350,True,8,Very Positive,882,165,1047
632360,True,9,Overwhelmingly Positive,52718,1411,54129
632370,True,0,No user reviews,0,0,0
632380,True,0,2 user reviews,1,1,2
632440,True,0,No user reviews,0,0,0
632470,True,8,Very Positive,13014,688,13702
632510,True,6,Mostly Positive,14,6,20
632520,True,5,Mixed,6,4,10
632590,True,7,Positive,14,0,14
632620,True,0,8 user reviews,4,4,8
632630,True,0,No user reviews,0,0,0
632650,True,0,No user reviews,0,0,0
632660,True,0,No user reviews,0,0,0
632670,True,0,No user reviews,0,0,0
632690,True,0,No user reviews,0,0,0
632710,True,7,Positive,31,3,34
632730,True,0,No user reviews,0,0,0
632740,True,0,No user reviews,0,0,0
632750,True,5,Mixed,8,4,12
632790,True,0,No user reviews,0,0,0
632800,True,8,Very Positive,65,9,74
632810,True,0,No user reviews,0,0,0
632820,True,0,3 user reviews,3,0,3
632830,True,0,No user reviews,0,0,0
632840,True,0,3 user reviews,2,1,3
632870,True,7,Positive,13,2,15
632880,True,7,Positive,16,0,16
632890,True,0,No user reviews,0,0,0
632900,True,7,Positive,31,5,36
632910,True,0,1 user reviews,1,0,1
632920,True,0,3 user reviews,3,0,3
632930,True,0,1 user reviews,1,0,1
632940,True,0,No user reviews,0,0,0
632950,True,0,No user reviews,0,0,0
633020,True,0,No user reviews,0,0,0
633030,True,0,No user reviews,0,0,0
633060,True,6,Mostly Positive,487,143,630
633070,True,0,No user reviews,0,0,0
633080,True,0,No user reviews,0,0,0
633090,True,0,No user reviews,0,0,0
633110,True,6,Mostly Positive,145,61,206
633140,True,0,No user reviews,0,0,0
633150,True,0,No user reviews,0,0,0
633160,True,0,No user reviews,0,0,0
633170,True,0,No user reviews,0,0,0
633190,True,0,No user reviews,0,0,0
633200,True,0,No user reviews,0,0,0
633210,True,0,No user reviews,0,0,0
633230,True,6,Mostly Positive,2090,788,2878
633251,True,0,No user reviews,0,0,0
633280,True,0,4 user reviews,2,2,4
633300,True,0,2 user reviews,0,2,2
633310,True,0,No user reviews,0,0,0
633320,True,0,No user reviews,0,0,0
633330,True,0,1 user reviews,1,0,1
633331,True,0,No user reviews,0,0,0
633340,True,0,No user reviews,0,0,0
633350,True,0,8 user reviews,5,3,8
633360,True,6,Mostly Positive,313,132,445
633380,True,0,No user reviews,0,0,0
633410,True,0,No user reviews,0,0,0
633430,True,0,No user reviews,0,0,0
633440,True,0,6 user reviews,3,3,6
633460,True,8,Very Positive,2401,361,2762
633470,True,0,No user reviews,0,0,0
633490,True,0,1 user reviews,1,0,1
633500,True,0,No user reviews,0,0,0
633501,True,0,No user reviews,0,0,0
633502,True,0,No user reviews,0,0,0
633503,True,0,No user reviews,0,0,0
633504,True,0,No user reviews,0,0,0
633505,True,0,No user reviews,0,0,0
633506,True,0,No user reviews,0,0,0
633507,True,0,No user reviews,0,0,0
633520,True,0,No user reviews,0,0,0
633521,True,0,No user reviews,0,0,0
633522,True,0,No user reviews,0,0,0
633523,True,0,No user reviews,0,0,0
633524,True,0,No user reviews,0,0,0
633525,True,0,No user reviews,0,0,0
633528,True,0,No user reviews,0,0,0
633529,True,0,No user reviews,0,0,0
633550,True,0,No user reviews,0,0,0
633551,True,0,No user reviews,0,0,0
633552,True,0,No user reviews,0,0,0
633553,True,0,No user reviews,0,0,0
633554,True,0,No user reviews,0,0,0
633556,True,0,No user reviews,0,0,0
633557,True,0,No user reviews,0,0,0
633558,True,0,No user reviews,0,0,0
633559,True,0,No user reviews,0,0,0
633580,True,5,Mixed,8,4,12
633590,True,0,No user reviews,0,0,0
633600,True,7,Positive,20,2,22
633610,True,0,No user reviews,0,0,0
633630,True,0,No user reviews,0,0,0
633631,True,0,No user reviews,0,0,0
633640,True,0,No user reviews,0,0,0
633660,True,0,3 user reviews,1,2,3
633690,True,0,No user reviews,0,0,0
633691,True,0,No user reviews,0,0,0
633693,True,0,No user reviews,0,0,0
633694,True,0,No user reviews,0,0,0
633695,True,0,No user reviews,0,0,0
633696,True,0,No user reviews,0,0,0
633697,True,0,No user reviews,0,0,0
633698,True,0,No user reviews,0,0,0
633699,True,0,No user reviews,0,0,0
633700,True,0,No user reviews,0,0,0
633701,True,0,No user reviews,0,0,0
633710,True,0,No user reviews,0,0,0
633730,True,0,No user reviews,0,0,0
633731,True,0,No user reviews,0,0,0
633732,True,0,No user reviews,0,0,0
633733,True,0,No user reviews,0,0,0
633734,True,0,No user reviews,0,0,0
633735,True,0,No user reviews,0,0,0
633736,True,0,No user reviews,0,0,0
633737,True,0,No user reviews,0,0,0
633738,True,0,No user reviews,0,0,0
633739,True,0,No user reviews,0,0,0
633770,True,0,No user reviews,0,0,0
633771,True,0,No user reviews,0,0,0
633772,True,0,No user reviews,0,0,0
633773,True,0,No user reviews,0,0,0
633774,True,0,No user reviews,0,0,0
633776,True,0,No user reviews,0,0,0
633777,True,0,No user reviews,0,0,0
633778,True,0,No user reviews,0,0,0
633779,True,0,No user reviews,0,0,0
633781,True,0,No user reviews,0,0,0
633782,True,0,No user reviews,0,0,0
633790,True,0,No user reviews,0,0,0
633791,True,0,No user reviews,0,0,0
633792,True,0,No user reviews,0,0,0
633793,True,0,No user reviews,0,0,0
633794,True,0,No user reviews,0,0,0
633795,True,0,No user reviews,0,0,0
633797,True,0,No user reviews,0,0,0
633798,True,0,No user reviews,0,0,0
633799,True,0,No user reviews,0,0,0
633800,True,0,No user reviews,0,0,0
633801,True,0,No user reviews,0,0,0
633803,True,0,No user reviews,0,0,0
633804,True,0,No user reviews,0,0,0
633805,True,0,No user reviews,0,0,0
633806,True,0,No user reviews,0,0,0
633807,True,0,No user reviews,0,0,0
633808,True,0,No user reviews,0,0,0
633809,True,0,No user reviews,0,0,0
633811,True,0,No user reviews,0,0,0
633830,True,0,No user reviews,0,0,0
633860,True,0,No user reviews,0,0,0
633870,True,0,No user reviews,0,0,0
633871,True,0,No user reviews,0,0,0
633910,True,0,No user reviews,0,0,0
633930,True,7,Positive,17,0,17
633940,True,0,8 user reviews,4,4,8
633950,True,5,Mixed,42,30,72
633960,True,0,2 user reviews,2,0,2
633961,True,0,1 user reviews,1,0,1
633963,True,0,No user reviews,0,0,0
633970,True,0,7 user reviews,1,6,7
633980,True,0,No user reviews,0,0,0
633981,True,0,No user reviews,0,0,0
634010,True,0,1 user reviews,1,0,1
634012,True,0,No user reviews,0,0,0
634014,True,0,1 user reviews,1,0,1
634016,True,0,No user reviews,0,0,0
634030,True,5,Mixed,9,5,14
634040,True,0,No user reviews,0,0,0
634060,True,0,No user reviews,0,0,0
634070,True,0,No user reviews,0,0,0
634090,True,0,1 user reviews,1,0,1
634120,True,5,Mixed,33,29,62
634150,True,0,5 user reviews,1,4,5
634160,True,9,Overwhelmingly Positive,853,34,887
634170,True,0,No user reviews,0,0,0
634180,True,6,Mostly Positive,26,8,34
634190,True,0,No user reviews,0,0,0
634191,True,0,No user reviews,0,0,0
634193,True,0,No user reviews,0,0,0
634194,True,0,No user reviews,0,0,0
634195,True,0,No user reviews,0,0,0
634196,True,0,No user reviews,0,0,0
634200,True,0,4 user reviews,3,1,4
634230,True,5,Mixed,8,12,20
634250,True,0,1 user reviews,1,0,1
634260,True,0,No user reviews,0,0,0
634270,True,0,No user reviews,0,0,0
634280,True,0,No user reviews,0,0,0
634300,True,0,No user reviews,0,0,0
634310,True,0,No user reviews,0,0,0
634320,True,0,No user reviews,0,0,0
634330,True,0,No user reviews,0,0,0
634340,True,6,Mostly Positive,27,8,35
634410,True,8,Very Positive,67,1,68
634420,True,0,1 user reviews,1,0,1
634421,True,0,No user reviews,0,0,0
634580,True,0,No user reviews,0,0,0
634590,True,0,No user reviews,0,0,0
634591,True,0,No user reviews,0,0,0
634592,True,0,No user reviews,0,0,0
634593,True,0,No user reviews,0,0,0
634594,True,0,No user reviews,0,0,0
634595,True,0,No user reviews,0,0,0
634596,True,0,No user reviews,0,0,0
634597,True,0,No user reviews,0,0,0
634598,True,0,No user reviews,0,0,0
634599,True,0,No user reviews,0,0,0
634610,True,0,No user reviews,0,0,0
634611,True,0,No user reviews,0,0,0
634612,True,0,No user reviews,0,0,0
634613,True,0,No user reviews,0,0,0
634614,True,0,No user reviews,0,0,0
634615,True,0,No user reviews,0,0,0
634616,True,0,No user reviews,0,0,0
634617,True,0,No user reviews,0,0,0
634618,True,0,No user reviews,0,0,0
634620,True,0,No user reviews,0,0,0
634621,True,0,No user reviews,0,0,0
634622,True,0,No user reviews,0,0,0
634623,True,0,No user reviews,0,0,0
634624,True,0,No user reviews,0,0,0
634625,True,0,No user reviews,0,0,0
634626,True,0,No user reviews,0,0,0
634627,True,0,No user reviews,0,0,0
634628,True,0,No user reviews,0,0,0
634630,True,0,No user reviews,0,0,0
634631,True,0,No user reviews,0,0,0
634634,True,0,No user reviews,0,0,0
634640,True,0,No user reviews,0,0,0
634641,True,0,No user reviews,0,0,0
634642,True,0,No user reviews,0,0,0
634643,True,0,No user reviews,0,0,0
634644,True,0,No user reviews,0,0,0
634645,True,0,No user reviews,0,0,0
634646,True,0,No user reviews,0,0,0
634647,True,0,No user reviews,0,0,0
634648,True,0,No user reviews,0,0,0
634649,True,0,No user reviews,0,0,0
634650,True,0,No user reviews,0,0,0
634651,True,0,No user reviews,0,0,0
634660,True,0,No user reviews,0,0,0
634661,True,0,No user reviews,0,0,0
634662,True,0,No user reviews,0,0,0
634663,True,0,No user reviews,0,0,0
634664,True,0,No user reviews,0,0,0
634665,True,0,No user reviews,0,0,0
634666,True,0,No user reviews,0,0,0
634667,True,0,No user reviews,0,0,0
634668,True,0,No user reviews,0,0,0
634669,True,0,No user reviews,0,0,0
634670,True,0,No user reviews,0,0,0
634671,True,0,No user reviews,0,0,0
634680,True,0,No user reviews,0,0,0
634681,True,0,No user reviews,0,0,0
634682,True,0,No user reviews,0,0,0
634683,True,0,No user reviews,0,0,0
634684,True,0,No user reviews,0,0,0
634685,True,0,No user reviews,0,0,0
634686,True,0,No user reviews,0,0,0
634687,True,0,No user reviews,0,0,0
634688,True,0,No user reviews,0,0,0
634689,True,0,No user reviews,0,0,0
634690,True,0,No user reviews,0,0,0
634691,True,0,No user reviews,0,0,0
634692,True,0,No user reviews,0,0,0
634693,True,0,No user reviews,0,0,0
634694,True,0,No user reviews,0,0,0
634695,True,0,No user reviews,0,0,0
634696,True,0,No user reviews,0,0,0
634697,True,0,No user reviews,0,0,0
634698,True,0,No user reviews,0,0,0
634699,True,0,No user reviews,0,0,0
634700,True,7,Positive,8,2,10
634710,True,0,No user reviews,0,0,0
634711,True,0,No user reviews,0,0,0
634712,True,0,No user reviews,0,0,0
634713,True,0,No user reviews,0,0,0
634714,True,0,No user reviews,0,0,0
634715,True,0,No user reviews,0,0,0
634716,True,0,No user reviews,0,0,0
634717,True,0,No user reviews,0,0,0
634719,True,0,No user reviews,0,0,0
634720,True,0,No user reviews,0,0,0
634721,True,0,No user reviews,0,0,0
634730,True,0,No user reviews,0,0,0
634731,True,0,No user reviews,0,0,0
634732,True,0,No user reviews,0,0,0
634733,True,0,No user reviews,0,0,0
634734,True,0,No user reviews,0,0,0
634735,True,0,No user reviews,0,0,0
634736,True,0,No user reviews,0,0,0
634737,True,0,No user reviews,0,0,0
634738,True,0,No user reviews,0,0,0
634739,True,0,No user reviews,0,0,0
634740,True,0,No user reviews,0,0,0
634741,True,0,No user reviews,0,0,0
634750,True,0,No user reviews,0,0,0
634751,True,0,No user reviews,0,0,0
634752,True,0,No user reviews,0,0,0
634753,True,0,No user reviews,0,0,0
634754,True,0,No user reviews,0,0,0
634755,True,0,No user reviews,0,0,0
634756,True,0,No user reviews,0,0,0
634757,True,0,No user reviews,0,0,0
634758,True,0,No user reviews,0,0,0
634759,True,0,No user reviews,0,0,0
634760,True,0,No user reviews,0,0,0
634761,True,0,No user reviews,0,0,0
634762,True,0,No user reviews,0,0,0
634770,True,0,No user reviews,0,0,0
634771,True,0,No user reviews,0,0,0
634772,True,0,No user reviews,0,0,0
634773,True,0,No user reviews,0,0,0
634774,True,0,No user reviews,0,0,0
634775,True,0,No user reviews,0,0,0
634776,True,0,No user reviews,0,0,0
634777,True,0,No user reviews,0,0,0
634778,True,0,No user reviews,0,0,0
634779,True,0,No user reviews,0,0,0
634780,True,0,No user reviews,0,0,0
634781,True,0,No user reviews,0,0,0
634782,True,0,No user reviews,0,0,0
634790,True,0,No user reviews,0,0,0
634791,True,0,No user reviews,0,0,0
634792,True,0,No user reviews,0,0,0
634793,True,0,No user reviews,0,0,0
634794,True,0,No user reviews,0,0,0
634795,True,0,No user reviews,0,0,0
634796,True,0,No user reviews,0,0,0
634797,True,0,No user reviews,0,0,0
634798,True,0,No user reviews,0,0,0
634799,True,0,No user reviews,0,0,0
634810,True,0,No user reviews,0,0,0
634820,True,0,No user reviews,0,0,0
634830,True,0,No user reviews,0,0,0
634831,True,0,No user reviews,0,0,0
634832,True,0,No user reviews,0,0,0
634833,True,0,No user reviews,0,0,0
634834,True,0,No user reviews,0,0,0
634835,True,0,No user reviews,0,0,0
634836,True,0,No user reviews,0,0,0
634837,True,0,No user reviews,0,0,0
634838,True,0,No user reviews,0,0,0
634839,True,0,No user reviews,0,0,0
634840,True,0,No user reviews,0,0,0
634860,True,0,No user reviews,0,0,0
634861,True,0,No user reviews,0,0,0
634862,True,0,No user reviews,0,0,0
634863,True,0,No user reviews,0,0,0
634864,True,0,No user reviews,0,0,0
634865,True,0,No user reviews,0,0,0
634866,True,0,No user reviews,0,0,0
634867,True,0,No user reviews,0,0,0
634868,True,0,No user reviews,0,0,0
634869,True,0,No user reviews,0,0,0
634890,True,0,No user reviews,0,0,0
634891,True,0,No user reviews,0,0,0
634892,True,0,No user reviews,0,0,0
634893,True,0,No user reviews,0,0,0
634894,True,0,No user reviews,0,0,0
634895,True,0,No user reviews,0,0,0
634896,True,0,No user reviews,0,0,0
634897,True,0,No user reviews,0,0,0
634898,True,0,No user reviews,0,0,0
634899,True,0,No user reviews,0,0,0
635000,True,0,7 user reviews,4,3,7
635010,True,0,1 user reviews,1,0,1
635020,True,0,1 user reviews,1,0,1
635030,True,7,Positive,29,5,34
635040,True,0,6 user reviews,5,1,6
635050,True,6,Mostly Positive,8,3,11
635060,True,5,Mixed,13,11,24
635110,True,0,No user reviews,0,0,0
635120,True,0,No user reviews,0,0,0
635130,True,0,2 user reviews,0,2,2
635140,True,0,No user reviews,0,0,0
635150,True,0,No user reviews,0,0,0
635160,True,0,No user reviews,0,0,0
635170,True,0,2 user reviews,2,0,2
635180,True,0,No user reviews,0,0,0
635190,True,0,8 user reviews,4,4,8
635200,True,5,Mixed,184,104,288
635220,True,5,Mixed,9,6,15
635240,True,0,No user reviews,0,0,0
635241,True,0,No user reviews,0,0,0
635242,True,0,No user reviews,0,0,0
635243,True,0,No user reviews,0,0,0
635250,True,6,Mostly Positive,32,11,43
635260,True,8,Very Positive,2741,362,3103
635270,True,0,2 user reviews,1,1,2
635290,True,0,9 user reviews,6,3,9
635300,True,0,No user reviews,0,0,0
635310,True,8,Very Positive,60,14,74
635320,True,8,Very Positive,432,92,524
635330,True,5,Mixed,42,28,70
635370,True,0,No user reviews,0,0,0
635380,True,0,No user reviews,0,0,0
635390,True,8,Very Positive,49,12,61
635410,True,0,6 user reviews,3,3,6
635430,True,0,6 user reviews,4,2,6
635510,True,0,No user reviews,0,0,0
635520,True,0,4 user reviews,4,0,4
635530,True,0,No user reviews,0,0,0
635540,True,0,No user reviews,0,0,0
635570,True,0,No user reviews,0,0,0
635580,True,0,2 user reviews,1,1,2
635590,True,0,1 user reviews,1,0,1
635640,True,0,No user reviews,0,0,0
635670,True,6,Mostly Positive,58,21,79
635680,True,0,No user reviews,0,0,0
635681,True,0,No user reviews,0,0,0
635682,True,0,No user reviews,0,0,0
635683,True,0,No user reviews,0,0,0
635684,True,0,No user reviews,0,0,0
635685,True,0,No user reviews,0,0,0
635686,True,0,No user reviews,0,0,0
635687,True,0,No user reviews,0,0,0
635688,True,0,No user reviews,0,0,0
635689,True,0,No user reviews,0,0,0
635690,True,0,No user reviews,0,0,0
635691,True,0,No user reviews,0,0,0
635710,True,0,1 user reviews,0,1,1
635730,True,6,Mostly Positive,529,140,669
635740,True,0,No user reviews,0,0,0
635750,True,0,1 user reviews,1,0,1
635751,True,0,1 user reviews,1,0,1
635760,True,0,No user reviews,0,0,0
635761,True,0,No user reviews,0,0,0
635762,True,0,No user reviews,0,0,0
635770,True,0,No user reviews,0,0,0
635771,True,0,No user reviews,0,0,0
635772,True,0,No user reviews,0,0,0
635780,True,0,1 user reviews,1,0,1
635790,True,7,Positive,11,1,12
635800,True,7,Positive,15,0,15
635810,True,0,No user reviews,0,0,0
635820,True,0,No user reviews,0,0,0
635830,True,0,7 user reviews,3,4,7
635840,True,0,No user reviews,0,0,0
635850,True,7,Positive,41,3,44
635870,True,0,No user reviews,0,0,0
635880,True,7,Positive,21,5,26
635890,True,0,No user reviews,0,0,0
635900,True,6,Mostly Positive,12,5,17
635930,True,0,2 user reviews,2,0,2
635940,True,8,Very Positive,257,6,263
635980,True,0,3 user reviews,3,0,3
636010,True,0,3 user reviews,1,2,3
636020,True,0,1 user reviews,1,0,1
636030,True,0,6 user reviews,6,0,6
636040,True,0,No user reviews,0,0,0
636050,True,0,8 user reviews,8,0,8
636060,True,0,No user reviews,0,0,0
636070,True,7,Positive,14,2,16
636080,True,0,No user reviews,0,0,0
636100,True,8,Very Positive,321,25,346
636130,True,0,7 user reviews,5,2,7
636131,True,0,4 user reviews,4,0,4
636132,True,0,3 user reviews,2,1,3
636133,True,0,5 user reviews,3,2,5
636134,True,0,1 user reviews,1,0,1
636150,True,8,Very Positive,152,30,182
636170,True,6,Mostly Positive,38,14,52
636200,True,0,7 user reviews,5,2,7
636210,True,0,No user reviews,0,0,0
636220,True,0,7 user reviews,7,0,7
636230,True,4,Mostly Negative,2,8,10
636240,True,0,No user reviews,0,0,0
636270,True,0,No user reviews,0,0,0
636280,True,0,No user reviews,0,0,0
636300,True,0,No user reviews,0,0,0
636310,True,0,6 user reviews,4,2,6
636320,True,6,Mostly Positive,74,30,104
636330,True,0,3 user reviews,3,0,3
636360,True,0,1 user reviews,0,1,1
636370,True,0,4 user reviews,3,1,4
636380,True,0,No user reviews,0,0,0
636390,True,7,Positive,35,4,39
636400,True,6,Mostly Positive,23,9,32
636410,True,0,9 user reviews,9,0,9
636430,True,0,4 user reviews,2,2,4
636440,True,0,3 user reviews,3,0,3
636450,True,8,Very Positive,514,48,562
636460,True,6,Mostly Positive,29,9,38
636470,True,4,Mostly Negative,9,14,23
636480,True,9,Overwhelmingly Positive,15973,608,16581
636490,True,3,Negative,1,9,10
636500,True,0,7 user reviews,6,1,7
636501,True,7,Positive,10,0,10
636502,True,0,7 user reviews,6,1,7
636520,True,5,Mixed,20,21,41
636530,True,0,No user reviews,0,0,0
636560,True,0,No user reviews,0,0,0
636570,True,7,Positive,41,6,47
636580,True,0,No user reviews,0,0,0
636590,True,0,5 user reviews,2,3,5
636600,True,0,No user reviews,0,0,0
636610,True,0,No user reviews,0,0,0
636620,True,7,Positive,15,3,18
636630,True,5,Mixed,27,32,59
636650,True,0,No user reviews,0,0,0
636670,True,0,No user reviews,0,0,0
636690,True,5,Mixed,49,32,81
636700,True,0,No user reviews,0,0,0
636710,True,0,5 user reviews,5,0,5
636720,True,5,Mixed,16,7,23
636740,True,0,3 user reviews,2,1,3
636770,True,0,No user reviews,0,0,0
636780,True,0,No user reviews,0,0,0
636790,True,0,No user reviews,0,0,0
636820,True,0,No user reviews,0,0,0
636821,True,0,No user reviews,0,0,0
636822,True,0,No user reviews,0,0,0
636823,True,0,No user reviews,0,0,0
636824,True,0,No user reviews,0,0,0
636825,True,0,No user reviews,0,0,0
636826,True,0,No user reviews,0,0,0
636827,True,0,No user reviews,0,0,0
636828,True,0,No user reviews,0,0,0
636829,True,0,No user reviews,0,0,0
636830,True,0,No user reviews,0,0,0
636860,True,0,No user reviews,0,0,0
636861,True,0,No user reviews,0,0,0
636862,True,0,No user reviews,0,0,0
636863,True,0,No user reviews,0,0,0
636864,True,0,No user reviews,0,0,0
636880,True,0,1 user reviews,1,0,1
636890,True,0,No user reviews,0,0,0
636900,True,0,9 user reviews,9,0,9
636910,True,0,6 user reviews,6,0,6
636920,True,0,No user reviews,0,0,0
636930,True,0,No user reviews,0,0,0
636950,True,0,9 user reviews,8,1,9
636960,True,6,Mostly Positive,14,4,18
636970,True,8,Very Positive,256,60,316
637000,True,0,3 user reviews,2,1,3
637001,True,0,2 user reviews,1,1,2
637030,True,0,2 user reviews,2,0,2
637040,True,4,Mostly Negative,3,9,12
637050,True,0,No user reviews,0,0,0
637060,True,6,Mostly Positive,23,8,31
637070,True,0,4 user reviews,2,2,4
637090,True,8,Very Positive,8830,1919,10749
637100,True,5,Mixed,1257,755,2012
637110,True,0,1 user reviews,1,0,1
637120,True,0,4 user reviews,3,1,4
637130,True,0,2 user reviews,2,0,2
637150,True,0,No user reviews,0,0,0
637160,True,0,No user reviews,0,0,0
637161,True,0,No user reviews,0,0,0
637162,True,0,No user reviews,0,0,0
637163,True,0,No user reviews,0,0,0
637164,True,0,No user reviews,0,0,0
637165,True,0,No user reviews,0,0,0
637180,True,0,No user reviews,0,0,0
637181,True,0,No user reviews,0,0,0
637182,True,0,No user reviews,0,0,0
637183,True,0,No user reviews,0,0,0
637184,True,0,No user reviews,0,0,0
637185,True,0,No user reviews,0,0,0
637186,True,0,No user reviews,0,0,0
637190,True,0,No user reviews,0,0,0
637191,True,0,No user reviews,0,0,0
637192,True,0,No user reviews,0,0,0
637193,True,0,No user reviews,0,0,0
637194,True,0,No user reviews,0,0,0
637195,True,0,No user reviews,0,0,0
637196,True,0,No user reviews,0,0,0
637197,True,0,No user reviews,0,0,0
637198,True,0,No user reviews,0,0,0
637199,True,0,No user reviews,0,0,0
637200,True,0,No user reviews,0,0,0
637201,True,0,No user reviews,0,0,0
637202,True,0,No user reviews,0,0,0
637210,True,0,No user reviews,0,0,0
637211,True,0,No user reviews,0,0,0
637212,True,0,No user reviews,0,0,0
637213,True,0,No user reviews,0,0,0
637214,True,0,No user reviews,0,0,0
637215,True,0,No user reviews,0,0,0
637216,True,0,No user reviews,0,0,0
637217,True,0,No user reviews,0,0,0
637218,True,0,No user reviews,0,0,0
637219,True,0,No user reviews,0,0,0
637220,True,0,No user reviews,0,0,0
637221,True,0,No user reviews,0,0,0
637222,True,0,No user reviews,0,0,0
637230,True,0,No user reviews,0,0,0
637231,True,0,No user reviews,0,0,0
637232,True,0,No user reviews,0,0,0
637233,True,0,No user reviews,0,0,0
637234,True,0,No user reviews,0,0,0
637235,True,0,No user reviews,0,0,0
637236,True,0,No user reviews,0,0,0
637237,True,0,No user reviews,0,0,0
637238,True,0,No user reviews,0,0,0
637239,True,0,No user reviews,0,0,0
637240,True,0,No user reviews,0,0,0
637241,True,0,No user reviews,0,0,0
637242,True,0,No user reviews,0,0,0
637250,True,0,No user reviews,0,0,0
637251,True,0,No user reviews,0,0,0
637252,True,0,No user reviews,0,0,0
637253,True,0,No user reviews,0,0,0
637254,True,0,No user reviews,0,0,0
637255,True,0,No user reviews,0,0,0
637256,True,0,No user reviews,0,0,0
637257,True,0,No user reviews,0,0,0
637258,True,0,No user reviews,0,0,0
637259,True,0,No user reviews,0,0,0
637260,True,0,No user reviews,0,0,0
637261,True,0,No user reviews,0,0,0
637262,True,0,No user reviews,0,0,0
637270,True,0,No user reviews,0,0,0
637271,True,0,No user reviews,0,0,0
637272,True,0,No user reviews,0,0,0
637273,True,0,No user reviews,0,0,0
637274,True,0,No user reviews,0,0,0
637275,True,0,No user reviews,0,0,0
637276,True,0,No user reviews,0,0,0
637277,True,0,No user reviews,0,0,0
637278,True,0,No user reviews,0,0,0
637279,True,0,No user reviews,0,0,0
637280,True,0,No user reviews,0,0,0
637281,True,0,No user reviews,0,0,0
637282,True,0,No user reviews,0,0,0
637290,True,0,No user reviews,0,0,0
637291,True,0,No user reviews,0,0,0
637292,True,0,No user reviews,0,0,0
637293,True,0,No user reviews,0,0,0
637294,True,0,No user reviews,0,0,0
637295,True,0,No user reviews,0,0,0
637296,True,0,No user reviews,0,0,0
637297,True,0,No user reviews,0,0,0
637298,True,0,No user reviews,0,0,0
637299,True,0,No user reviews,0,0,0
637300,True,0,No user reviews,0,0,0
637301,True,0,No user reviews,0,0,0
637302,True,0,No user reviews,0,0,0
637303,True,0,No user reviews,0,0,0
637310,True,0,9 user reviews,6,3,9
637330,True,0,1 user reviews,1,0,1
637340,True,0,No user reviews,0,0,0
637350,True,0,No user reviews,0,0,0
637360,True,0,No user reviews,0,0,0
637361,True,0,No user reviews,0,0,0
637362,True,0,No user reviews,0,0,0
637370,True,0,3 user reviews,2,1,3
637380,True,0,3 user reviews,1,2,3
637390,True,0,No user reviews,0,0,0
637391,True,0,No user reviews,0,0,0
637392,True,0,No user reviews,0,0,0
637393,True,0,No user reviews,0,0,0
637394,True,0,No user reviews,0,0,0
637395,True,0,No user reviews,0,0,0
637396,True,0,No user reviews,0,0,0
637397,True,0,No user reviews,0,0,0
637398,True,0,No user reviews,0,0,0
637399,True,0,No user reviews,0,0,0
637400,True,0,No user reviews,0,0,0
637401,True,0,No user reviews,0,0,0
637402,True,0,No user reviews,0,0,0
637403,True,0,No user reviews,0,0,0
637410,True,5,Mixed,36,22,58
637420,True,0,No user reviews,0,0,0
637430,True,0,No user reviews,0,0,0
637440,True,0,No user reviews,0,0,0
637441,True,0,No user reviews,0,0,0
637442,True,0,No user reviews,0,0,0
637450,True,0,No user reviews,0,0,0
637460,True,0,No user reviews,0,0,0
637461,True,0,No user reviews,0,0,0
637462,True,0,No user reviews,0,0,0
637463,True,0,No user reviews,0,0,0
637464,True,0,No user reviews,0,0,0
637465,True,0,No user reviews,0,0,0
637466,True,0,No user reviews,0,0,0
637467,True,0,No user reviews,0,0,0
637468,True,0,No user reviews,0,0,0
637469,True,0,No user reviews,0,0,0
637470,True,0,No user reviews,0,0,0
637471,True,0,No user reviews,0,0,0
637472,True,0,No user reviews,0,0,0
637473,True,0,No user reviews,0,0,0
637474,True,0,No user reviews,0,0,0
637475,True,0,No user reviews,0,0,0
637476,True,0,No user reviews,0,0,0
637477,True,0,No user reviews,0,0,0
637478,True,0,No user reviews,0,0,0
637480,True,0,No user reviews,0,0,0
637481,True,0,No user reviews,0,0,0
637482,True,0,No user reviews,0,0,0
637483,True,0,No user reviews,0,0,0
637484,True,0,No user reviews,0,0,0
637485,True,0,No user reviews,0,0,0
637486,True,0,No user reviews,0,0,0
637487,True,0,No user reviews,0,0,0
637488,True,0,No user reviews,0,0,0
637489,True,0,No user reviews,0,0,0
637490,True,0,No user reviews,0,0,0
637491,True,0,No user reviews,0,0,0
637492,True,0,No user reviews,0,0,0
637493,True,0,No user reviews,0,0,0
637494,True,0,No user reviews,0,0,0
637495,True,0,No user reviews,0,0,0
637496,True,0,No user reviews,0,0,0
637497,True,0,No user reviews,0,0,0
637498,True,0,No user reviews,0,0,0
637499,True,0,No user reviews,0,0,0
637500,True,0,No user reviews,0,0,0
637501,True,0,No user reviews,0,0,0
637510,True,0,No user reviews,0,0,0
637511,True,0,No user reviews,0,0,0
637512,True,0,No user reviews,0,0,0
637513,True,0,No user reviews,0,0,0
637514,True,0,No user reviews,0,0,0
637515,True,0,No user reviews,0,0,0
637516,True,0,No user reviews,0,0,0
637517,True,0,No user reviews,0,0,0
637518,True,0,No user reviews,0,0,0
637519,True,0,No user reviews,0,0,0
637520,True,0,No user reviews,0,0,0
637521,True,0,No user reviews,0,0,0
637522,True,0,No user reviews,0,0,0
637523,True,0,No user reviews,0,0,0
637524,True,0,No user reviews,0,0,0
637530,True,0,No user reviews,0,0,0
637531,True,0,No user reviews,0,0,0
637532,True,0,No user reviews,0,0,0
637533,True,0,No user reviews,0,0,0
637534,True,0,No user reviews,0,0,0
637535,True,0,No user reviews,0,0,0
637536,True,0,No user reviews,0,0,0
637537,True,0,No user reviews,0,0,0
637538,True,0,No user reviews,0,0,0
637539,True,0,No user reviews,0,0,0
637540,True,0,No user reviews,0,0,0
637541,True,0,No user reviews,0,0,0
637542,True,0,No user reviews,0,0,0
637550,True,0,No user reviews,0,0,0
637551,True,0,No user reviews,0,0,0
637552,True,0,No user reviews,0,0,0
637553,True,0,No user reviews,0,0,0
637554,True,0,No user reviews,0,0,0
637555,True,0,No user reviews,0,0,0
637556,True,0,No user reviews,0,0,0
637557,True,0,No user reviews,0,0,0
637558,True,0,No user reviews,0,0,0
637559,True,0,No user reviews,0,0,0
637560,True,0,No user reviews,0,0,0
637561,True,0,No user reviews,0,0,0
637562,True,0,No user reviews,0,0,0
637570,True,0,No user reviews,0,0,0
637571,True,0,No user reviews,0,0,0
637572,True,0,No user reviews,0,0,0
637573,True,0,No user reviews,0,0,0
637574,True,0,No user reviews,0,0,0
637575,True,0,No user reviews,0,0,0
637576,True,0,No user reviews,0,0,0
637577,True,0,No user reviews,0,0,0
637578,True,0,No user reviews,0,0,0
637579,True,0,No user reviews,0,0,0
637590,True,0,No user reviews,0,0,0
637591,True,0,No user reviews,0,0,0
637592,True,0,No user reviews,0,0,0
637600,True,0,No user reviews,0,0,0
637601,True,0,No user reviews,0,0,0
637602,True,0,No user reviews,0,0,0
637603,True,0,No user reviews,0,0,0
637604,True,0,No user reviews,0,0,0
637605,True,0,No user reviews,0,0,0
637606,True,0,No user reviews,0,0,0
637607,True,0,No user reviews,0,0,0
637608,True,0,No user reviews,0,0,0
637609,True,0,No user reviews,0,0,0
637610,True,0,No user reviews,0,0,0
637611,True,0,No user reviews,0,0,0
637612,True,0,No user reviews,0,0,0
637620,True,0,No user reviews,0,0,0
637621,True,0,No user reviews,0,0,0
637622,True,0,No user reviews,0,0,0
637623,True,0,No user reviews,0,0,0
637624,True,0,No user reviews,0,0,0
637625,True,0,No user reviews,0,0,0
637626,True,0,No user reviews,0,0,0
637627,True,0,No user reviews,0,0,0
637628,True,0,No user reviews,0,0,0
637629,True,0,No user reviews,0,0,0
637630,True,0,No user reviews,0,0,0
637631,True,0,No user reviews,0,0,0
637632,True,0,No user reviews,0,0,0
637640,True,0,3 user reviews,1,2,3
637650,True,6,Mostly Positive,7337,1883,9220
637670,True,5,Mixed,676,290,966
637690,True,0,No user reviews,0,0,0
637691,True,0,No user reviews,0,0,0
637692,True,0,2 user reviews,2,0,2
637693,True,0,No user reviews,0,0,0
637694,True,0,No user reviews,0,0,0
637695,True,0,No user reviews,0,0,0
637696,True,0,No user reviews,0,0,0
637697,True,0,No user reviews,0,0,0
637698,True,0,No user reviews,0,0,0
637699,True,0,No user reviews,0,0,0
637700,True,0,No user reviews,0,0,0
637701,True,0,No user reviews,0,0,0
637702,True,0,No user reviews,0,0,0
637703,True,0,1 user reviews,1,0,1
637704,True,0,No user reviews,0,0,0
637705,True,0,No user reviews,0,0,0
637706,True,0,No user reviews,0,0,0
637707,True,0,No user reviews,0,0,0
637708,True,0,No user reviews,0,0,0
637709,True,0,No user reviews,0,0,0
637710,True,0,No user reviews,0,0,0
637711,True,0,No user reviews,0,0,0
637712,True,0,1 user reviews,1,0,1
637713,True,0,No user reviews,0,0,0
637714,True,0,No user reviews,0,0,0
637715,True,0,2 user reviews,1,1,2
637716,True,0,No user reviews,0,0,0
637717,True,0,No user reviews,0,0,0
637718,True,0,No user reviews,0,0,0
637719,True,0,No user reviews,0,0,0
637720,True,0,3 user reviews,1,2,3
637721,True,0,No user reviews,0,0,0
637722,True,0,No user reviews,0,0,0
637723,True,0,No user reviews,0,0,0
637724,True,0,No user reviews,0,0,0
637725,True,0,No user reviews,0,0,0
637726,True,0,No user reviews,0,0,0
637727,True,0,No user reviews,0,0,0
637728,True,0,No user reviews,0,0,0
637729,True,0,No user reviews,0,0,0
637730,True,0,No user reviews,0,0,0
637731,True,0,No user reviews,0,0,0
637732,True,0,No user reviews,0,0,0
637733,True,0,No user reviews,0,0,0
637734,True,0,No user reviews,0,0,0
637735,True,0,No user reviews,0,0,0
637736,True,0,No user reviews,0,0,0
637737,True,0,No user reviews,0,0,0
637738,True,0,No user reviews,0,0,0
637739,True,0,No user reviews,0,0,0
637740,True,0,No user reviews,0,0,0
637741,True,0,No user reviews,0,0,0
637742,True,0,No user reviews,0,0,0
637743,True,0,No user reviews,0,0,0
637744,True,0,No user reviews,0,0,0
637745,True,0,No user reviews,0,0,0
637746,True,0,No user reviews,0,0,0
637747,True,0,No user reviews,0,0,0
637748,True,0,No user reviews,0,0,0
637749,True,0,No user reviews,0,0,0
637750,True,0,No user reviews,0,0,0
637751,True,0,No user reviews,0,0,0
637752,True,0,No user reviews,0,0,0
637753,True,0,No user reviews,0,0,0
637754,True,0,No user reviews,0,0,0
637755,True,0,No user reviews,0,0,0
637756,True,0,No user reviews,0,0,0
637757,True,0,No user reviews,0,0,0
637758,True,0,No user reviews,0,0,0
637759,True,0,No user reviews,0,0,0
637760,True,0,No user reviews,0,0,0
637761,True,0,No user reviews,0,0,0
637762,True,0,3 user reviews,3,0,3
637763,True,0,No user reviews,0,0,0
637764,True,0,No user reviews,0,0,0
637765,True,0,No user reviews,0,0,0
637766,True,0,4 user reviews,3,1,4
637767,True,0,1 user reviews,1,0,1
637768,True,0,No user reviews,0,0,0
637769,True,0,No user reviews,0,0,0
637770,True,0,1 user reviews,1,0,1
637771,True,0,No user reviews,0,0,0
637772,True,0,2 user reviews,2,0,2
637773,True,0,No user reviews,0,0,0
637774,True,0,No user reviews,0,0,0
637775,True,0,1 user reviews,1,0,1
637776,True,0,No user reviews,0,0,0
637777,True,0,No user reviews,0,0,0
637778,True,0,No user reviews,0,0,0
637779,True,0,No user reviews,0,0,0
637780,True,0,No user reviews,0,0,0
637781,True,0,No user reviews,0,0,0
637782,True,0,No user reviews,0,0,0
637783,True,0,No user reviews,0,0,0
637784,True,0,No user reviews,0,0,0
637785,True,0,No user reviews,0,0,0
637786,True,0,No user reviews,0,0,0
637787,True,0,2 user reviews,2,0,2
637788,True,0,1 user reviews,1,0,1
637789,True,0,No user reviews,0,0,0
637790,True,0,No user reviews,0,0,0
637791,True,0,No user reviews,0,0,0
637792,True,0,No user reviews,0,0,0
637793,True,0,No user reviews,0,0,0
637794,True,0,No user reviews,0,0,0
637795,True,0,No user reviews,0,0,0
637796,True,0,No user reviews,0,0,0
637797,True,0,No user reviews,0,0,0
637798,True,0,No user reviews,0,0,0
637799,True,0,No user reviews,0,0,0
637800,True,0,No user reviews,0,0,0
637801,True,0,No user reviews,0,0,0
637802,True,0,No user reviews,0,0,0
637803,True,0,No user reviews,0,0,0
637804,True,0,No user reviews,0,0,0
637805,True,0,1 user reviews,1,0,1
637806,True,0,No user reviews,0,0,0
637807,True,0,No user reviews,0,0,0
637808,True,0,No user reviews,0,0,0
637809,True,0,No user reviews,0,0,0
637810,True,0,No user reviews,0,0,0
637811,True,0,No user reviews,0,0,0
637812,True,0,No user reviews,0,0,0
637813,True,0,No user reviews,0,0,0
637814,True,0,No user reviews,0,0,0
637815,True,0,No user reviews,0,0,0
637816,True,0,No user reviews,0,0,0
637817,True,0,No user reviews,0,0,0
637818,True,0,No user reviews,0,0,0
637819,True,0,No user reviews,0,0,0
637820,True,0,No user reviews,0,0,0
637821,True,0,No user reviews,0,0,0
637822,True,0,No user reviews,0,0,0
637823,True,0,No user reviews,0,0,0
637824,True,0,No user reviews,0,0,0
637825,True,0,1 user reviews,1,0,1
637826,True,0,1 user reviews,1,0,1
637827,True,0,1 user reviews,1,0,1
637828,True,0,No user reviews,0,0,0
637829,True,0,No user reviews,0,0,0
637830,True,0,1 user reviews,1,0,1
637831,True,0,No user reviews,0,0,0
637832,True,0,No user reviews,0,0,0
637833,True,0,No user reviews,0,0,0
637834,True,0,No user reviews,0,0,0
637835,True,0,No user reviews,0,0,0
637836,True,0,No user reviews,0,0,0
637837,True,0,No user reviews,0,0,0
637838,True,0,No user reviews,0,0,0
637839,True,0,1 user reviews,1,0,1
637840,True,0,No user reviews,0,0,0
637841,True,0,No user reviews,0,0,0
637842,True,0,No user reviews,0,0,0
637843,True,0,No user reviews,0,0,0
637844,True,0,3 user reviews,3,0,3
637845,True,0,No user reviews,0,0,0
637846,True,0,No user reviews,0,0,0
637847,True,0,No user reviews,0,0,0
637848,True,0,No user reviews,0,0,0
637849,True,0,No user reviews,0,0,0
637850,True,0,No user reviews,0,0,0
637860,True,0,4 user reviews,2,2,4
637870,True,0,3 user reviews,2,1,3
637880,True,8,Very Positive,56,4,60
637910,True,0,1 user reviews,1,0,1
637920,True,0,4 user reviews,1,3,4
637930,True,0,2 user reviews,2,0,2
637940,True,0,3 user reviews,2,1,3
637960,True,0,No user reviews,0,0,0
637980,True,0,No user reviews,0,0,0
638000,True,8,Very Positive,164,19,183
638010,True,0,3 user reviews,1,2,3
638011,True,0,3 user reviews,3,0,3
638020,True,0,6 user reviews,1,5,6
638040,True,0,No user reviews,0,0,0
638060,True,0,2 user reviews,1,1,2
638070,True,5,Mixed,86,45,131
638090,True,0,No user reviews,0,0,0
638100,True,0,No user reviews,0,0,0
638110,True,0,No user reviews,0,0,0
638120,True,0,2 user reviews,0,2,2
638160,True,5,Mixed,90,46,136
638180,True,6,Mostly Positive,27,11,38
638190,True,0,No user reviews,0,0,0
638200,True,8,Very Positive,108,11,119
638230,True,8,Very Positive,2297,194,2491
638240,True,0,3 user reviews,0,3,3
638250,True,0,No user reviews,0,0,0
638260,True,0,3 user reviews,2,1,3
638270,True,0,2 user reviews,2,0,2
638280,True,7,Positive,19,1,20
638290,True,0,No user reviews,0,0,0
638310,True,0,3 user reviews,2,1,3
638330,True,0,No user reviews,0,0,0
638360,True,0,1 user reviews,1,0,1
638370,True,0,No user reviews,0,0,0
638460,True,0,7 user reviews,7,0,7
638470,True,0,5 user reviews,4,1,5
638490,True,0,No user reviews,0,0,0
638500,True,0,No user reviews,0,0,0
638510,True,0,No user reviews,0,0,0
638530,True,0,No user reviews,0,0,0
638531,True,0,No user reviews,0,0,0
638532,True,0,No user reviews,0,0,0
638533,True,0,No user reviews,0,0,0
638534,True,0,No user reviews,0,0,0
638550,True,0,1 user reviews,1,0,1
638570,True,0,No user reviews,0,0,0
638571,True,0,No user reviews,0,0,0
638572,True,0,No user reviews,0,0,0
638573,True,0,No user reviews,0,0,0
638610,True,0,2 user reviews,2,0,2
638620,True,0,No user reviews,0,0,0
638630,True,0,4 user reviews,4,0,4
638650,True,8,Very Positive,323,66,389
638720,True,7,Positive,16,2,18
638740,True,0,2 user reviews,1,1,2
638760,True,0,No user reviews,0,0,0
638780,True,0,4 user reviews,4,0,4
638790,True,0,No user reviews,0,0,0
638800,True,0,No user reviews,0,0,0
638810,True,0,No user reviews,0,0,0
638830,True,0,5 user reviews,4,1,5
638850,True,6,Mostly Positive,294,81,375
638860,True,0,No user reviews,0,0,0
638890,True,0,1 user reviews,0,1,1
638891,True,0,No user reviews,0,0,0
638900,True,0,No user reviews,0,0,0
638920,True,0,No user reviews,0,0,0
638930,True,7,Positive,38,6,44
638950,True,0,No user reviews,0,0,0
638970,True,9,Overwhelmingly Positive,11442,546,11988
638980,True,0,3 user reviews,3,0,3
638981,True,0,3 user reviews,3,0,3
638990,True,0,No user reviews,0,0,0
639000,True,0,No user reviews,0,0,0
639001,True,0,2 user reviews,2,0,2
639030,True,0,No user reviews,0,0,0
639050,True,0,No user reviews,0,0,0
639070,True,0,No user reviews,0,0,0
639080,True,0,1 user reviews,1,0,1
639090,True,0,No user reviews,0,0,0
639091,True,0,No user reviews,0,0,0
639092,True,0,No user reviews,0,0,0
639093,True,0,No user reviews,0,0,0
639094,True,0,No user reviews,0,0,0
639095,True,0,No user reviews,0,0,0
639096,True,0,No user reviews,0,0,0
639097,True,0,No user reviews,0,0,0
639098,True,0,No user reviews,0,0,0
639099,True,0,No user reviews,0,0,0
639100,True,0,No user reviews,0,0,0
639101,True,0,No user reviews,0,0,0
639102,True,0,No user reviews,0,0,0
639110,True,0,No user reviews,0,0,0
639111,True,0,No user reviews,0,0,0
639112,True,0,No user reviews,0,0,0
639113,True,0,No user reviews,0,0,0
639114,True,0,No user reviews,0,0,0
639115,True,0,No user reviews,0,0,0
639116,True,0,No user reviews,0,0,0
639117,True,0,No user reviews,0,0,0
639118,True,0,No user reviews,0,0,0
639119,True,0,No user reviews,0,0,0
639120,True,0,No user reviews,0,0,0
639121,True,0,No user reviews,0,0,0
639122,True,0,No user reviews,0,0,0
639123,True,0,No user reviews,0,0,0
639124,True,0,No user reviews,0,0,0
639125,True,0,No user reviews,0,0,0
639126,True,0,No user reviews,0,0,0
639127,True,0,No user reviews,0,0,0
639128,True,0,No user reviews,0,0,0
639129,True,0,No user reviews,0,0,0
639130,True,8,Very Positive,236,26,262
639150,True,0,4 user reviews,3,1,4
639170,True,8,Very Positive,472,50,522
639180,True,0,No user reviews,0,0,0
639190,True,0,No user reviews,0,0,0
639200,True,0,No user reviews,0,0,0
639210,True,0,No user reviews,0,0,0
639220,True,6,Mostly Positive,15,6,21
639230,True,0,No user reviews,0,0,0
639240,True,0,1 user reviews,0,1,1
639250,True,0,No user reviews,0,0,0
639260,True,0,No user reviews,0,0,0
639261,True,0,No user reviews,0,0,0
639262,True,0,No user reviews,0,0,0
639263,True,0,No user reviews,0,0,0
639264,True,0,No user reviews,0,0,0
639265,True,0,No user reviews,0,0,0
639266,True,0,No user reviews,0,0,0
639270,True,8,Very Positive,156,6,162
639280,True,0,8 user reviews,6,2,8
639300,True,6,Mostly Positive,41,16,57
639310,True,5,Mixed,34,21,55
639320,True,0,1 user reviews,1,0,1
639330,True,0,No user reviews,0,0,0
639331,True,0,No user reviews,0,0,0
639332,True,0,No user reviews,0,0,0
639333,True,0,No user reviews,0,0,0
639334,True,0,No user reviews,0,0,0
639335,True,0,No user reviews,0,0,0
639336,True,0,No user reviews,0,0,0
639337,True,0,No user reviews,0,0,0
639338,True,0,No user reviews,0,0,0
639339,True,0,No user reviews,0,0,0
639340,True,0,No user reviews,0,0,0
639341,True,0,No user reviews,0,0,0
639342,True,0,No user reviews,0,0,0
639350,True,0,No user reviews,0,0,0
639351,True,0,No user reviews,0,0,0
639352,True,0,No user reviews,0,0,0
639353,True,0,No user reviews,0,0,0
639354,True,0,No user reviews,0,0,0
639355,True,0,No user reviews,0,0,0
639356,True,0,No user reviews,0,0,0
639357,True,0,No user reviews,0,0,0
639358,True,0,No user reviews,0,0,0
639359,True,0,No user reviews,0,0,0
639360,True,0,No user reviews,0,0,0
639361,True,0,No user reviews,0,0,0
639362,True,0,No user reviews,0,0,0
639370,True,0,3 user reviews,3,0,3
639390,True,0,No user reviews,0,0,0
639391,True,0,No user reviews,0,0,0
639392,True,0,No user reviews,0,0,0
639393,True,0,No user reviews,0,0,0
639394,True,0,No user reviews,0,0,0
639395,True,0,No user reviews,0,0,0
639396,True,0,No user reviews,0,0,0
639397,True,0,No user reviews,0,0,0
639398,True,0,No user reviews,0,0,0
639399,True,0,No user reviews,0,0,0
639400,True,0,No user reviews,0,0,0
639401,True,0,No user reviews,0,0,0
639402,True,0,No user reviews,0,0,0
639410,True,0,No user reviews,0,0,0
639411,True,0,No user reviews,0,0,0
639412,True,0,No user reviews,0,0,0
639413,True,0,No user reviews,0,0,0
639414,True,0,No user reviews,0,0,0
639415,True,0,No user reviews,0,0,0
639416,True,0,No user reviews,0,0,0
639417,True,0,No user reviews,0,0,0
639418,True,0,No user reviews,0,0,0
639419,True,0,No user reviews,0,0,0
639420,True,0,No user reviews,0,0,0
639421,True,0,No user reviews,0,0,0
639430,True,7,Positive,11,0,11
639431,True,7,Positive,13,3,16
639432,True,0,4 user reviews,4,0,4
639433,True,0,1 user reviews,0,1,1
639434,True,7,Positive,11,0,11
639435,True,0,8 user reviews,8,0,8
639436,True,0,No user reviews,0,0,0
639437,True,0,1 user reviews,1,0,1
639438,True,7,Positive,10,1,11
639440,True,0,No user reviews,0,0,0
639460,True,6,Mostly Positive,47,16,63
639470,True,0,7 user reviews,6,1,7
639490,True,8,Very Positive,164,1,165
639510,True,0,No user reviews,0,0,0
639520,True,0,No user reviews,0,0,0
639521,True,0,No user reviews,0,0,0
639522,True,0,No user reviews,0,0,0
639523,True,0,1 user reviews,1,0,1
639524,True,0,No user reviews,0,0,0
639525,True,0,No user reviews,0,0,0
639530,True,0,No user reviews,0,0,0
639531,True,0,2 user reviews,1,1,2
639532,True,0,3 user reviews,2,1,3
639540,True,0,9 user reviews,7,2,9
639550,True,0,No user reviews,0,0,0
639560,True,6,Mostly Positive,28,8,36
639570,True,0,4 user reviews,4,0,4
639580,True,0,No user reviews,0,0,0
639600,True,8,Very Positive,276,26,302
639620,True,0,No user reviews,0,0,0
639650,True,0,No user reviews,0,0,0
639660,True,0,No user reviews,0,0,0
639680,True,7,Positive,10,0,10
639690,True,0,2 user reviews,2,0,2
639700,True,0,1 user reviews,1,0,1
639701,True,0,1 user reviews,1,0,1
639720,True,7,Positive,22,4,26
639730,True,0,6 user reviews,4,2,6
639760,True,0,No user reviews,0,0,0
639770,True,7,Positive,29,0,29
639780,True,9,Overwhelmingly Positive,930,48,978
639790,True,9,Overwhelmingly Positive,3542,142,3684
639810,True,0,No user reviews,0,0,0
639830,True,0,No user reviews,0,0,0
639840,True,0,6 user reviews,2,4,6
639850,True,0,No user reviews,0,0,0
639860,True,0,No user reviews,0,0,0
639870,True,0,No user reviews,0,0,0
639880,True,0,No user reviews,0,0,0
639890,True,0,1 user reviews,1,0,1
639891,True,0,No user reviews,0,0,0
639900,True,0,No user reviews,0,0,0
639920,True,0,2 user reviews,1,1,2
639940,True,0,No user reviews,0,0,0
639950,True,0,No user reviews,0,0,0
639960,True,0,No user reviews,0,0,0
640010,True,0,No user reviews,0,0,0
640020,True,0,No user reviews,0,0,0
640040,True,0,2 user reviews,2,0,2
640050,True,3,Negative,1,11,12
640070,True,0,7 user reviews,5,2,7
640080,True,0,No user reviews,0,0,0
640090,True,7,Positive,8,2,10
640120,True,8,Very Positive,68,1,69
640140,True,5,Mixed,84,40,124
640150,True,0,No user reviews,0,0,0
640190,True,0,No user reviews,0,0,0
640200,True,0,2 user reviews,1,1,2
640210,True,5,Mixed,23,18,41
640220,True,0,No user reviews,0,0,0
640221,True,0,No user reviews,0,0,0
640222,True,0,No user reviews,0,0,0
640230,True,0,No user reviews,0,0,0
640250,True,0,2 user reviews,2,0,2
640290,True,0,3 user reviews,3,0,3
640300,True,6,Mostly Positive,23,6,29
640310,True,4,Mostly Negative,22,36,58
640340,True,7,Positive,30,5,35
640380,True,8,Very Positive,118,5,123
640390,True,0,No user reviews,0,0,0
640400,True,0,No user reviews,0,0,0
640401,True,0,No user reviews,0,0,0
640410,True,0,No user reviews,0,0,0
640440,True,0,No user reviews,0,0,0
640450,True,0,No user reviews,0,0,0
640460,True,0,No user reviews,0,0,0
640490,True,0,No user reviews,0,0,0
640500,True,0,No user reviews,0,0,0
640510,True,0,No user reviews,0,0,0
640520,True,0,No user reviews,0,0,0
640530,True,0,No user reviews,0,0,0
640540,True,0,No user reviews,0,0,0
640550,True,0,No user reviews,0,0,0
640560,True,0,No user reviews,0,0,0
640570,True,0,No user reviews,0,0,0
640580,True,0,No user reviews,0,0,0
640590,True,8,Very Positive,131,23,154
640600,True,0,2 user reviews,0,2,2
640640,True,0,No user reviews,0,0,0
640641,True,0,No user reviews,0,0,0
640642,True,0,No user reviews,0,0,0
640643,True,0,No user reviews,0,0,0
640644,True,0,No user reviews,0,0,0
640645,True,0,No user reviews,0,0,0
640646,True,0,No user reviews,0,0,0
640647,True,0,No user reviews,0,0,0
640648,True,0,No user reviews,0,0,0
640649,True,0,No user reviews,0,0,0
640650,True,0,No user reviews,0,0,0
640651,True,0,No user reviews,0,0,0
640652,True,0,No user reviews,0,0,0
640653,True,0,No user reviews,0,0,0
640654,True,0,No user reviews,0,0,0
640655,True,0,No user reviews,0,0,0
640656,True,0,No user reviews,0,0,0
640657,True,0,No user reviews,0,0,0
640658,True,0,No user reviews,0,0,0
640659,True,0,No user reviews,0,0,0
640660,True,0,No user reviews,0,0,0
640661,True,0,No user reviews,0,0,0
640662,True,0,No user reviews,0,0,0
640663,True,0,No user reviews,0,0,0
640664,True,0,No user reviews,0,0,0
640670,True,0,2 user reviews,2,0,2
640680,True,0,No user reviews,0,0,0
640690,True,0,9 user reviews,6,3,9
640700,True,0,3 user reviews,3,0,3
640720,True,0,3 user reviews,1,2,3
640730,True,0,No user reviews,0,0,0
640740,True,0,4 user reviews,4,0,4
640741,True,0,No user reviews,0,0,0
640742,True,0,No user reviews,0,0,0
640743,True,0,No user reviews,0,0,0
640744,True,0,No user reviews,0,0,0
640745,True,0,No user reviews,0,0,0
640746,True,0,1 user reviews,1,0,1
640747,True,0,No user reviews,0,0,0
640748,True,0,No user reviews,0,0,0
640749,True,0,No user reviews,0,0,0
640750,True,0,No user reviews,0,0,0
640751,True,0,No user reviews,0,0,0
640752,True,0,No user reviews,0,0,0
640760,True,5,Mixed,9,6,15
640770,True,0,No user reviews,0,0,0
640780,True,0,No user reviews,0,0,0
640800,True,6,Mostly Positive,58,24,82
640820,True,6,Mostly Positive,7475,2226,9701
640840,True,0,No user reviews,0,0,0
640850,True,5,Mixed,40,28,68
640860,True,5,Mixed,27,13,40
640880,True,0,9 user reviews,8,1,9
640890,True,7,Positive,13,2,15
640900,True,7,Positive,16,1,17
640910,True,0,2 user reviews,2,0,2
640920,True,8,Very Positive,74,10,84
640940,True,0,No user reviews,0,0,0
640970,True,6,Mostly Positive,33,10,43
640990,True,8,Very Positive,128,21,149
641000,True,7,Positive,41,3,44
641010,True,0,No user reviews,0,0,0
641020,True,0,2 user reviews,2,0,2
641030,True,0,No user reviews,0,0,0
641050,True,0,1 user reviews,1,0,1
641080,True,5,Mixed,502,250,752
641280,True,0,No user reviews,0,0,0
641310,True,0,No user reviews,0,0,0
641320,True,8,Very Positive,2417,515,2932
641340,True,0,No user reviews,0,0,0
641350,True,0,No user reviews,0,0,0
641360,True,0,1 user reviews,1,0,1
641370,True,0,No user reviews,0,0,0
641380,True,0,7 user reviews,4,3,7
641382,True,0,2 user reviews,2,0,2
641383,True,0,No user reviews,0,0,0
641384,True,0,4 user reviews,3,1,4
641385,True,0,No user reviews,0,0,0
641390,True,7,Positive,18,0,18
641391,True,0,No user reviews,0,0,0
641392,True,0,No user reviews,0,0,0
641393,True,0,1 user reviews,1,0,1
641394,True,0,No user reviews,0,0,0
641395,True,0,No user reviews,0,0,0
641396,True,0,2 user reviews,1,1,2
641397,True,0,1 user reviews,1,0,1
641398,True,0,No user reviews,0,0,0
641399,True,0,1 user reviews,1,0,1
641400,True,0,No user reviews,0,0,0
641401,True,0,No user reviews,0,0,0
641402,True,0,No user reviews,0,0,0
641430,True,0,No user reviews,0,0,0
641440,True,0,No user reviews,0,0,0
641450,True,0,1 user reviews,1,0,1
641460,True,0,No user reviews,0,0,0
641470,True,0,No user reviews,0,0,0
641480,True,0,1 user reviews,1,0,1
641490,True,0,No user reviews,0,0,0
641491,True,0,No user reviews,0,0,0
641492,True,0,No user reviews,0,0,0
641493,True,0,No user reviews,0,0,0
641500,True,0,No user reviews,0,0,0
641501,True,0,No user reviews,0,0,0
641502,True,0,No user reviews,0,0,0
641503,True,0,No user reviews,0,0,0
641504,True,0,No user reviews,0,0,0
641505,True,0,No user reviews,0,0,0
641506,True,0,No user reviews,0,0,0
641507,True,0,No user reviews,0,0,0
641508,True,0,No user reviews,0,0,0
641509,True,0,No user reviews,0,0,0
641510,True,0,No user reviews,0,0,0
641520,True,0,1 user reviews,1,0,1
641540,True,0,No user reviews,0,0,0
641550,True,0,No user reviews,0,0,0
641560,True,0,No user reviews,0,0,0
641580,True,0,No user reviews,0,0,0
641590,True,0,3 user reviews,2,1,3
641670,True,0,No user reviews,0,0,0
641680,True,0,No user reviews,0,0,0
641690,True,0,No user reviews,0,0,0
641700,True,0,No user reviews,0,0,0
641710,True,0,No user reviews,0,0,0
641740,True,0,No user reviews,0,0,0
641750,True,0,No user reviews,0,0,0
641751,True,0,No user reviews,0,0,0
641752,True,0,1 user reviews,1,0,1
641753,True,0,No user reviews,0,0,0
641754,True,0,No user reviews,0,0,0
641755,True,0,No user reviews,0,0,0
641756,True,0,No user reviews,0,0,0
641757,True,0,No user reviews,0,0,0
641758,True,0,No user reviews,0,0,0
641759,True,0,No user reviews,0,0,0
641760,True,0,No user reviews,0,0,0
641761,True,0,No user reviews,0,0,0
641780,True,8,Very Positive,618,64,682
641790,True,0,No user reviews,0,0,0
641791,True,0,No user reviews,0,0,0
641792,True,0,No user reviews,0,0,0
641793,True,0,No user reviews,0,0,0
641794,True,0,No user reviews,0,0,0
641795,True,0,No user reviews,0,0,0
641800,True,0,No user reviews,0,0,0
641801,True,0,No user reviews,0,0,0
641810,True,0,No user reviews,0,0,0
641811,True,0,No user reviews,0,0,0
641812,True,0,No user reviews,0,0,0
641813,True,0,No user reviews,0,0,0
641814,True,0,No user reviews,0,0,0
641815,True,0,No user reviews,0,0,0
641816,True,0,No user reviews,0,0,0
641817,True,0,No user reviews,0,0,0
641820,True,0,No user reviews,0,0,0
641821,True,0,No user reviews,0,0,0
641822,True,0,No user reviews,0,0,0
641823,True,0,No user reviews,0,0,0
641824,True,0,No user reviews,0,0,0
641825,True,0,No user reviews,0,0,0
641826,True,0,No user reviews,0,0,0
641827,True,0,No user reviews,0,0,0
641828,True,0,No user reviews,0,0,0
641829,True,0,No user reviews,0,0,0
641830,True,0,No user reviews,0,0,0
641831,True,0,No user reviews,0,0,0
641832,True,0,No user reviews,0,0,0
641833,True,0,No user reviews,0,0,0
641834,True,0,No user reviews,0,0,0
641835,True,0,No user reviews,0,0,0
641836,True,0,No user reviews,0,0,0
641837,True,0,No user reviews,0,0,0
641838,True,0,No user reviews,0,0,0
641839,True,0,No user reviews,0,0,0
641860,True,0,No user reviews,0,0,0
641870,True,0,No user reviews,0,0,0
641880,True,0,No user reviews,0,0,0
641910,True,4,Mostly Negative,7,11,18
641940,True,0,No user reviews,0,0,0
641950,True,5,Mixed,9,5,14
641960,True,8,Very Positive,568,141,709
641970,True,0,3 user reviews,2,1,3
641980,True,7,Positive,22,5,27
641990,True,8,Very Positive,4162,540,4702
642000,True,0,No user reviews,0,0,0
642050,True,0,No user reviews,0,0,0
642051,True,0,No user reviews,0,0,0
642052,True,0,No user reviews,0,0,0
642053,True,0,No user reviews,0,0,0
642054,True,0,No user reviews,0,0,0
642055,True,0,No user reviews,0,0,0
642056,True,0,No user reviews,0,0,0
642057,True,0,No user reviews,0,0,0
642060,True,0,No user reviews,0,0,0
642061,True,0,No user reviews,0,0,0
642062,True,0,No user reviews,0,0,0
642063,True,0,No user reviews,0,0,0
642064,True,0,No user reviews,0,0,0
642065,True,0,No user reviews,0,0,0
642066,True,0,No user reviews,0,0,0
642067,True,0,No user reviews,0,0,0
642070,True,5,Mixed,7,6,13
642080,True,8,Very Positive,164,8,172
642090,True,8,Very Positive,428,20,448
642100,True,0,No user reviews,0,0,0
642101,True,0,No user reviews,0,0,0
642102,True,0,No user reviews,0,0,0
642103,True,0,No user reviews,0,0,0
642104,True,0,No user reviews,0,0,0
642105,True,0,No user reviews,0,0,0
642106,True,0,No user reviews,0,0,0
642107,True,0,No user reviews,0,0,0
642108,True,0,No user reviews,0,0,0
642109,True,0,No user reviews,0,0,0
642110,True,0,No user reviews,0,0,0
642111,True,0,No user reviews,0,0,0
642120,True,0,1 user reviews,1,0,1
642121,True,0,No user reviews,0,0,0
642122,True,0,No user reviews,0,0,0
642123,True,0,No user reviews,0,0,0
642124,True,0,No user reviews,0,0,0
642125,True,0,No user reviews,0,0,0
642126,True,0,No user reviews,0,0,0
642127,True,0,No user reviews,0,0,0
642128,True,0,No user reviews,0,0,0
642129,True,0,No user reviews,0,0,0
642130,True,0,No user reviews,0,0,0
642131,True,0,No user reviews,0,0,0
642140,True,0,No user reviews,0,0,0
642141,True,0,No user reviews,0,0,0
642142,True,0,No user reviews,0,0,0
642143,True,0,No user reviews,0,0,0
642144,True,0,No user reviews,0,0,0
642145,True,0,No user reviews,0,0,0
642146,True,0,No user reviews,0,0,0
642147,True,0,No user reviews,0,0,0
642148,True,0,No user reviews,0,0,0
642149,True,0,No user reviews,0,0,0
642150,True,0,No user reviews,0,0,0
642151,True,0,No user reviews,0,0,0
642160,True,0,No user reviews,0,0,0
642170,True,5,Mixed,14,8,22
642180,True,0,No user reviews,0,0,0
642190,True,5,Mixed,6,9,15
642200,True,7,Positive,10,0,10
642201,True,0,No user reviews,0,0,0
642210,True,0,No user reviews,0,0,0
642220,True,0,No user reviews,0,0,0
642221,True,0,No user reviews,0,0,0
642222,True,0,No user reviews,0,0,0
642223,True,0,No user reviews,0,0,0
642224,True,0,No user reviews,0,0,0
642225,True,0,No user reviews,0,0,0
642226,True,0,No user reviews,0,0,0
642227,True,0,No user reviews,0,0,0
642228,True,0,No user reviews,0,0,0
642229,True,0,No user reviews,0,0,0
642230,True,0,No user reviews,0,0,0
642231,True,0,No user reviews,0,0,0
642232,True,0,No user reviews,0,0,0
642233,True,0,No user reviews,0,0,0
642234,True,0,No user reviews,0,0,0
642240,True,7,Positive,12,0,12
642250,True,0,No user reviews,0,0,0
642260,True,0,No user reviews,0,0,0
642270,True,0,No user reviews,0,0,0
642280,True,8,Very Positive,595,56,651
642290,True,0,No user reviews,0,0,0
642291,True,0,No user reviews,0,0,0
642292,True,0,No user reviews,0,0,0
642293,True,0,No user reviews,0,0,0
642294,True,0,No user reviews,0,0,0
642295,True,0,No user reviews,0,0,0
642296,True,0,No user reviews,0,0,0
642297,True,0,No user reviews,0,0,0
642300,True,0,No user reviews,0,0,0
642301,True,0,No user reviews,0,0,0
642302,True,0,No user reviews,0,0,0
642303,True,0,No user reviews,0,0,0
642304,True,0,No user reviews,0,0,0
642305,True,0,No user reviews,0,0,0
642306,True,0,No user reviews,0,0,0
642307,True,0,No user reviews,0,0,0
642308,True,0,No user reviews,0,0,0
642309,True,0,No user reviews,0,0,0
642310,True,0,No user reviews,0,0,0
642311,True,0,No user reviews,0,0,0
642312,True,0,No user reviews,0,0,0
642313,True,0,No user reviews,0,0,0
642314,True,0,No user reviews,0,0,0
642315,True,0,No user reviews,0,0,0
642316,True,0,No user reviews,0,0,0
642317,True,0,No user reviews,0,0,0
642318,True,0,No user reviews,0,0,0
642319,True,0,No user reviews,0,0,0
642320,True,0,No user reviews,0,0,0
642321,True,0,No user reviews,0,0,0
642330,True,0,No user reviews,0,0,0
642331,True,0,No user reviews,0,0,0
642332,True,0,No user reviews,0,0,0
642333,True,0,No user reviews,0,0,0
642334,True,0,No user reviews,0,0,0
642335,True,0,No user reviews,0,0,0
642336,True,0,No user reviews,0,0,0
642337,True,0,No user reviews,0,0,0
642338,True,0,No user reviews,0,0,0
642339,True,0,No user reviews,0,0,0
642340,True,0,No user reviews,0,0,0
642341,True,0,No user reviews,0,0,0
642342,True,0,No user reviews,0,0,0
642343,True,0,No user reviews,0,0,0
642344,True,0,No user reviews,0,0,0
642345,True,0,No user reviews,0,0,0
642346,True,0,No user reviews,0,0,0
642347,True,0,No user reviews,0,0,0
642348,True,0,No user reviews,0,0,0
642349,True,0,No user reviews,0,0,0
642350,True,0,No user reviews,0,0,0
642351,True,0,No user reviews,0,0,0
642360,True,0,No user reviews,0,0,0
642361,True,0,No user reviews,0,0,0
642362,True,0,No user reviews,0,0,0
642363,True,0,No user reviews,0,0,0
642364,True,0,No user reviews,0,0,0
642365,True,0,No user reviews,0,0,0
642366,True,0,No user reviews,0,0,0
642367,True,0,No user reviews,0,0,0
642368,True,0,No user reviews,0,0,0
642369,True,0,No user reviews,0,0,0
642370,True,0,No user reviews,0,0,0
642371,True,0,No user reviews,0,0,0
642372,True,0,No user reviews,0,0,0
642373,True,0,No user reviews,0,0,0
642374,True,0,No user reviews,0,0,0
642375,True,0,No user reviews,0,0,0
642376,True,0,No user reviews,0,0,0
642377,True,0,No user reviews,0,0,0
642378,True,0,No user reviews,0,0,0
642379,True,0,No user reviews,0,0,0
642380,True,0,No user reviews,0,0,0
642381,True,0,No user reviews,0,0,0
642400,True,0,No user reviews,0,0,0
642401,True,0,No user reviews,0,0,0
642402,True,0,No user reviews,0,0,0
642403,True,0,No user reviews,0,0,0
642404,True,0,No user reviews,0,0,0
642405,True,0,No user reviews,0,0,0
642406,True,0,No user reviews,0,0,0
642407,True,0,No user reviews,0,0,0
642408,True,0,No user reviews,0,0,0
642409,True,0,No user reviews,0,0,0
642410,True,0,No user reviews,0,0,0
642411,True,0,No user reviews,0,0,0
642412,True,0,No user reviews,0,0,0
642413,True,0,No user reviews,0,0,0
642414,True,0,No user reviews,0,0,0
642415,True,0,No user reviews,0,0,0
642416,True,0,No user reviews,0,0,0
642417,True,0,No user reviews,0,0,0
642418,True,0,No user reviews,0,0,0
642419,True,0,No user reviews,0,0,0
642420,True,0,No user reviews,0,0,0
642421,True,0,No user reviews,0,0,0
642430,True,0,No user reviews,0,0,0
642431,True,0,No user reviews,0,0,0
642432,True,0,No user reviews,0,0,0
642433,True,0,No user reviews,0,0,0
642434,True,0,No user reviews,0,0,0
642435,True,0,No user reviews,0,0,0
642436,True,0,No user reviews,0,0,0
642437,True,0,No user reviews,0,0,0
642438,True,0,No user reviews,0,0,0
642439,True,0,No user reviews,0,0,0
642440,True,0,No user reviews,0,0,0
642441,True,0,No user reviews,0,0,0
642442,True,0,No user reviews,0,0,0
642443,True,0,No user reviews,0,0,0
642444,True,0,No user reviews,0,0,0
642445,True,0,No user reviews,0,0,0
642446,True,0,No user reviews,0,0,0
642447,True,0,No user reviews,0,0,0
642448,True,0,No user reviews,0,0,0
642449,True,0,No user reviews,0,0,0
642450,True,0,No user reviews,0,0,0
642451,True,0,No user reviews,0,0,0
642460,True,0,No user reviews,0,0,0
642461,True,0,1 user reviews,0,1,1
642462,True,0,No user reviews,0,0,0
642463,True,0,No user reviews,0,0,0
642464,True,0,No user reviews,0,0,0
642465,True,0,No user reviews,0,0,0
642466,True,0,No user reviews,0,0,0
642467,True,0,No user reviews,0,0,0
642468,True,0,No user reviews,0,0,0
642469,True,0,No user reviews,0,0,0
642470,True,0,No user reviews,0,0,0
642471,True,0,No user reviews,0,0,0
642472,True,0,No user reviews,0,0,0
642473,True,0,No user reviews,0,0,0
642474,True,0,No user reviews,0,0,0
642475,True,0,No user reviews,0,0,0
642476,True,0,No user reviews,0,0,0
642477,True,0,No user reviews,0,0,0
642478,True,0,No user reviews,0,0,0
642479,True,0,No user reviews,0,0,0
642480,True,0,No user reviews,0,0,0
642481,True,0,No user reviews,0,0,0
642500,True,0,No user reviews,0,0,0
642510,True,0,4 user reviews,2,2,4
642520,True,0,7 user reviews,2,5,7
642540,True,0,No user reviews,0,0,0
642550,True,0,No user reviews,0,0,0
642551,True,0,No user reviews,0,0,0
642552,True,0,No user reviews,0,0,0
642553,True,0,No user reviews,0,0,0
642554,True,0,No user reviews,0,0,0
642555,True,0,No user reviews,0,0,0
642560,True,8,Very Positive,173,9,182
642570,True,0,1 user reviews,0,1,1
642580,True,7,Positive,22,4,26
642590,True,0,No user reviews,0,0,0
642600,True,7,Positive,10,0,10
642610,True,8,Very Positive,49,7,56
642630,True,0,3 user reviews,3,0,3
642640,True,0,No user reviews,0,0,0
642650,True,8,Very Positive,52,2,54
642660,True,0,1 user reviews,0,1,1
642670,True,0,No user reviews,0,0,0
642690,True,0,No user reviews,0,0,0
642700,True,0,9 user reviews,3,6,9
642710,True,0,No user reviews,0,0,0
642720,True,0,1 user reviews,1,0,1
642730,True,7,Positive,21,3,24
642750,True,6,Mostly Positive,278,96,374
642770,True,8,Very Positive,71,4,75
642780,True,0,4 user reviews,3,1,4
642790,True,0,No user reviews,0,0,0
642800,True,0,2 user reviews,1,1,2
642802,True,0,5 user reviews,2,3,5
642803,True,0,8 user reviews,6,2,8
642804,True,7,Positive,25,2,27
642805,True,0,2 user reviews,2,0,2
642806,True,5,Mixed,9,4,13
642807,True,5,Mixed,9,11,20
642810,True,0,No user reviews,0,0,0
642830,True,5,Mixed,7,7,14
642840,True,0,No user reviews,0,0,0
642860,True,0,No user reviews,0,0,0
642890,True,0,No user reviews,0,0,0
642920,True,0,No user reviews,0,0,0
642930,True,0,No user reviews,0,0,0
642940,True,0,No user reviews,0,0,0
642941,True,0,No user reviews,0,0,0
642942,True,0,No user reviews,0,0,0
642943,True,0,No user reviews,0,0,0
642944,True,0,No user reviews,0,0,0
642945,True,0,No user reviews,0,0,0
642946,True,0,No user reviews,0,0,0
642947,True,0,No user reviews,0,0,0
642948,True,0,No user reviews,0,0,0
642949,True,0,No user reviews,0,0,0
642950,True,0,No user reviews,0,0,0
642951,True,0,No user reviews,0,0,0
642952,True,0,No user reviews,0,0,0
642953,True,0,No user reviews,0,0,0
642954,True,0,No user reviews,0,0,0
642955,True,0,No user reviews,0,0,0
642956,True,0,No user reviews,0,0,0
642957,True,0,No user reviews,0,0,0
642958,True,0,No user reviews,0,0,0
642959,True,0,No user reviews,0,0,0
642960,True,0,No user reviews,0,0,0
642961,True,0,No user reviews,0,0,0
642970,True,0,No user reviews,0,0,0
642971,True,0,No user reviews,0,0,0
642972,True,0,No user reviews,0,0,0
642973,True,0,No user reviews,0,0,0
642974,True,0,No user reviews,0,0,0
642975,True,0,No user reviews,0,0,0
642976,True,0,No user reviews,0,0,0
642977,True,0,No user reviews,0,0,0
642978,True,0,No user reviews,0,0,0
642979,True,0,No user reviews,0,0,0
642980,True,0,No user reviews,0,0,0
642981,True,0,No user reviews,0,0,0
642982,True,0,No user reviews,0,0,0
642983,True,0,No user reviews,0,0,0
642984,True,0,No user reviews,0,0,0
642985,True,0,No user reviews,0,0,0
642986,True,0,No user reviews,0,0,0
642987,True,0,No user reviews,0,0,0
642988,True,0,No user reviews,0,0,0
642989,True,0,No user reviews,0,0,0
642990,True,0,No user reviews,0,0,0
642991,True,0,No user reviews,0,0,0
643000,True,0,No user reviews,0,0,0
643010,True,0,No user reviews,0,0,0
643020,True,0,No user reviews,0,0,0
643021,True,0,No user reviews,0,0,0
643022,True,0,No user reviews,0,0,0
643023,True,0,No user reviews,0,0,0
643024,True,0,No user reviews,0,0,0
643025,True,0,No user reviews,0,0,0
643026,True,0,No user reviews,0,0,0
643027,True,0,No user reviews,0,0,0
643028,True,0,No user reviews,0,0,0
643029,True,0,No user reviews,0,0,0
643030,True,0,No user reviews,0,0,0
643031,True,0,No user reviews,0,0,0
643032,True,0,No user reviews,0,0,0
643033,True,0,No user reviews,0,0,0
643034,True,0,No user reviews,0,0,0
643035,True,0,No user reviews,0,0,0
643036,True,0,No user reviews,0,0,0
643037,True,0,No user reviews,0,0,0
643038,True,0,No user reviews,0,0,0
643039,True,0,No user reviews,0,0,0
643040,True,0,No user reviews,0,0,0
643041,True,0,No user reviews,0,0,0
643060,True,0,No user reviews,0,0,0
643061,True,0,No user reviews,0,0,0
643062,True,0,No user reviews,0,0,0
643063,True,0,No user reviews,0,0,0
643064,True,0,No user reviews,0,0,0
643065,True,0,No user reviews,0,0,0
643066,True,0,No user reviews,0,0,0
643067,True,0,No user reviews,0,0,0
643068,True,0,No user reviews,0,0,0
643069,True,0,No user reviews,0,0,0
643070,True,0,No user reviews,0,0,0
643071,True,0,No user reviews,0,0,0
643072,True,0,No user reviews,0,0,0
643073,True,0,No user reviews,0,0,0
643074,True,0,No user reviews,0,0,0
643075,True,0,No user reviews,0,0,0
643076,True,0,No user reviews,0,0,0
643077,True,0,No user reviews,0,0,0
643078,True,0,No user reviews,0,0,0
643079,True,0,No user reviews,0,0,0
643080,True,0,No user reviews,0,0,0
643081,True,0,No user reviews,0,0,0
643090,True,0,No user reviews,0,0,0
643100,True,0,No user reviews,0,0,0
643110,True,0,No user reviews,0,0,0
643120,True,0,No user reviews,0,0,0
643130,True,0,No user reviews,0,0,0
643140,True,0,No user reviews,0,0,0
643150,True,0,No user reviews,0,0,0
643160,True,0,No user reviews,0,0,0
643170,True,0,No user reviews,0,0,0
643180,True,0,1 user reviews,1,0,1
643190,True,0,No user reviews,0,0,0
643200,True,6,Mostly Positive,35,13,48
643220,True,0,No user reviews,0,0,0
643221,True,0,No user reviews,0,0,0
643222,True,0,No user reviews,0,0,0
643223,True,0,No user reviews,0,0,0
643224,True,0,No user reviews,0,0,0
643225,True,0,No user reviews,0,0,0
643226,True,0,No user reviews,0,0,0
643227,True,0,No user reviews,0,0,0
643228,True,0,No user reviews,0,0,0
643229,True,0,No user reviews,0,0,0
643230,True,0,No user reviews,0,0,0
643231,True,0,No user reviews,0,0,0
643260,True,0,4 user reviews,4,0,4
643270,True,0,1 user reviews,1,0,1
643280,True,0,No user reviews,0,0,0
643281,True,0,No user reviews,0,0,0
643282,True,0,No user reviews,0,0,0
643283,True,0,No user reviews,0,0,0
643284,True,0,No user reviews,0,0,0
643285,True,0,No user reviews,0,0,0
643286,True,0,No user reviews,0,0,0
643287,True,0,No user reviews,0,0,0
643288,True,0,No user reviews,0,0,0
643289,True,0,No user reviews,0,0,0
643290,True,0,No user reviews,0,0,0
643291,True,0,No user reviews,0,0,0
643292,True,0,No user reviews,0,0,0
643293,True,0,No user reviews,0,0,0
643294,True,0,No user reviews,0,0,0
643295,True,0,No user reviews,0,0,0
643296,True,0,No user reviews,0,0,0
643297,True,0,No user reviews,0,0,0
643298,True,0,No user reviews,0,0,0
643299,True,0,No user reviews,0,0,0
643300,True,0,No user reviews,0,0,0
643301,True,0,No user reviews,0,0,0
643310,True,0,No user reviews,0,0,0
643311,True,0,No user reviews,0,0,0
643312,True,0,No user reviews,0,0,0
643313,True,0,No user reviews,0,0,0
643314,True,0,No user reviews,0,0,0
643315,True,0,No user reviews,0,0,0
643316,True,0,No user reviews,0,0,0
643317,True,0,No user reviews,0,0,0
643318,True,0,No user reviews,0,0,0
643319,True,0,No user reviews,0,0,0
643320,True,0,No user reviews,0,0,0
643321,True,0,No user reviews,0,0,0
643322,True,0,No user reviews,0,0,0
643323,True,0,No user reviews,0,0,0
643324,True,0,No user reviews,0,0,0
643325,True,0,No user reviews,0,0,0
643326,True,0,No user reviews,0,0,0
643327,True,0,No user reviews,0,0,0
643328,True,0,No user reviews,0,0,0
643329,True,0,No user reviews,0,0,0
643330,True,0,No user reviews,0,0,0
643331,True,0,No user reviews,0,0,0
643340,True,0,No user reviews,0,0,0
643341,True,0,No user reviews,0,0,0
643342,True,0,No user reviews,0,0,0
643343,True,0,No user reviews,0,0,0
643344,True,0,No user reviews,0,0,0
643345,True,0,No user reviews,0,0,0
643346,True,0,No user reviews,0,0,0
643347,True,0,No user reviews,0,0,0
643348,True,0,No user reviews,0,0,0
643349,True,0,No user reviews,0,0,0
643350,True,0,No user reviews,0,0,0
643351,True,0,No user reviews,0,0,0
643352,True,0,No user reviews,0,0,0
643353,True,0,No user reviews,0,0,0
643354,True,0,No user reviews,0,0,0
643355,True,0,No user reviews,0,0,0
643356,True,0,No user reviews,0,0,0
643357,True,0,No user reviews,0,0,0
643358,True,0,No user reviews,0,0,0
643359,True,0,No user reviews,0,0,0
643360,True,0,No user reviews,0,0,0
643361,True,0,No user reviews,0,0,0
643390,True,7,Positive,31,0,31
643400,True,0,1 user reviews,1,0,1
643401,True,0,No user reviews,0,0,0
643402,True,0,No user reviews,0,0,0
643403,True,0,No user reviews,0,0,0
643404,True,0,No user reviews,0,0,0
643405,True,0,No user reviews,0,0,0
643406,True,0,No user reviews,0,0,0
643407,True,0,No user reviews,0,0,0
643408,True,0,No user reviews,0,0,0
643409,True,0,No user reviews,0,0,0
643410,True,0,No user reviews,0,0,0
643411,True,0,No user reviews,0,0,0
643420,True,0,8 user reviews,8,0,8
643440,True,0,1 user reviews,1,0,1
643441,True,0,No user reviews,0,0,0
643442,True,0,No user reviews,0,0,0
643443,True,0,No user reviews,0,0,0
643444,True,0,No user reviews,0,0,0
643445,True,0,No user reviews,0,0,0
643446,True,0,No user reviews,0,0,0
643447,True,0,No user reviews,0,0,0
643448,True,0,No user reviews,0,0,0
643449,True,0,No user reviews,0,0,0
643450,True,0,No user reviews,0,0,0
643451,True,0,No user reviews,0,0,0
643460,True,0,1 user reviews,0,1,1
643470,True,0,No user reviews,0,0,0
643471,True,0,No user reviews,0,0,0
643472,True,0,No user reviews,0,0,0
643473,True,0,No user reviews,0,0,0
643474,True,0,No user reviews,0,0,0
643475,True,0,No user reviews,0,0,0
643476,True,0,No user reviews,0,0,0
643477,True,0,No user reviews,0,0,0
643478,True,0,No user reviews,0,0,0
643479,True,0,No user reviews,0,0,0
643480,True,0,No user reviews,0,0,0
643481,True,0,No user reviews,0,0,0
643482,True,0,No user reviews,0,0,0
643483,True,0,No user reviews,0,0,0
643484,True,0,No user reviews,0,0,0
643485,True,0,No user reviews,0,0,0
643486,True,0,No user reviews,0,0,0
643487,True,0,No user reviews,0,0,0
643488,True,0,No user reviews,0,0,0
643489,True,0,No user reviews,0,0,0
643490,True,0,No user reviews,0,0,0
643491,True,0,No user reviews,0,0,0
643500,True,0,No user reviews,0,0,0
643501,True,0,No user reviews,0,0,0
643502,True,0,No user reviews,0,0,0
643503,True,0,No user reviews,0,0,0
643504,True,0,No user reviews,0,0,0
643505,True,0,No user reviews,0,0,0
643506,True,0,No user reviews,0,0,0
643507,True,0,No user reviews,0,0,0
643508,True,0,No user reviews,0,0,0
643509,True,0,No user reviews,0,0,0
643510,True,0,No user reviews,0,0,0
643511,True,0,No user reviews,0,0,0
643512,True,0,No user reviews,0,0,0
643513,True,0,No user reviews,0,0,0
643514,True,0,No user reviews,0,0,0
643515,True,0,No user reviews,0,0,0
643516,True,0,No user reviews,0,0,0
643517,True,0,No user reviews,0,0,0
643518,True,0,No user reviews,0,0,0
643519,True,0,No user reviews,0,0,0
643520,True,0,No user reviews,0,0,0
643521,True,0,No user reviews,0,0,0
643530,True,0,No user reviews,0,0,0
643540,True,0,No user reviews,0,0,0
643541,True,0,No user reviews,0,0,0
643542,True,0,No user reviews,0,0,0
643543,True,0,No user reviews,0,0,0
643544,True,0,No user reviews,0,0,0
643545,True,0,No user reviews,0,0,0
643546,True,0,No user reviews,0,0,0
643547,True,0,No user reviews,0,0,0
643548,True,0,No user reviews,0,0,0
643549,True,0,No user reviews,0,0,0
643550,True,0,No user reviews,0,0,0
643551,True,0,No user reviews,0,0,0
643552,True,0,No user reviews,0,0,0
643553,True,0,No user reviews,0,0,0
643554,True,0,No user reviews,0,0,0
643555,True,0,No user reviews,0,0,0
643556,True,0,No user reviews,0,0,0
643557,True,0,No user reviews,0,0,0
643558,True,0,No user reviews,0,0,0
643559,True,0,No user reviews,0,0,0
643560,True,0,No user reviews,0,0,0
643561,True,0,No user reviews,0,0,0
643570,True,7,Positive,18,0,18
643580,True,0,No user reviews,0,0,0
643590,True,5,Mixed,14,20,34
643610,True,6,Mostly Positive,21,8,29
643620,True,6,Mostly Positive,62,16,78
643650,True,0,2 user reviews,2,0,2
643670,True,0,1 user reviews,1,0,1
643671,True,0,1 user reviews,1,0,1
643680,True,0,No user reviews,0,0,0
643681,True,5,Mixed,14,14,28
643682,True,5,Mixed,5,7,12
643683,True,0,2 user reviews,0,2,2
643684,True,0,1 user reviews,1,0,1
643686,True,0,3 user reviews,2,1,3
643687,True,0,2 user reviews,1,1,2
643688,True,0,4 user reviews,3,1,4
643689,True,0,9 user reviews,6,3,9
643690,True,0,No user reviews,0,0,0
643692,True,0,1 user reviews,1,0,1
643693,True,0,1 user reviews,1,0,1
643694,True,0,No user reviews,0,0,0
643695,True,0,No user reviews,0,0,0
643696,True,0,No user reviews,0,0,0
643697,True,0,No user reviews,0,0,0
643698,True,0,2 user reviews,2,0,2
643699,True,0,No user reviews,0,0,0
643700,True,7,Positive,13,3,16
643710,True,0,No user reviews,0,0,0
643730,True,0,8 user reviews,7,1,8
643731,True,0,3 user reviews,3,0,3
643740,True,0,5 user reviews,2,3,5
643750,True,0,No user reviews,0,0,0
643760,True,0,No user reviews,0,0,0
643810,True,8,Very Positive,226,47,273
643820,True,5,Mixed,48,29,77
643830,True,6,Mostly Positive,14,4,18
643850,True,0,No user reviews,0,0,0
643851,True,0,No user reviews,0,0,0
643852,True,0,No user reviews,0,0,0
643853,True,0,No user reviews,0,0,0
643854,True,0,No user reviews,0,0,0
643855,True,0,No user reviews,0,0,0
643870,True,0,2 user reviews,2,0,2
643880,True,8,Very Positive,235,19,254
643900,True,8,Very Positive,59,5,64
643910,True,0,3 user reviews,3,0,3
643930,True,0,No user reviews,0,0,0
643940,True,0,3 user reviews,2,1,3
643950,True,0,7 user reviews,1,6,7
643960,True,8,Very Positive,132,30,162
643970,True,5,Mixed,8,4,12
643980,True,0,No user reviews,0,0,0
644000,True,5,Mixed,9,7,16
644010,True,5,Mixed,9,6,15
644020,True,0,No user reviews,0,0,0
644021,True,0,No user reviews,0,0,0
644022,True,0,No user reviews,0,0,0
644023,True,0,No user reviews,0,0,0
644024,True,0,No user reviews,0,0,0
644025,True,0,No user reviews,0,0,0
644026,True,0,No user reviews,0,0,0
644027,True,0,No user reviews,0,0,0
644028,True,0,No user reviews,0,0,0
644029,True,0,No user reviews,0,0,0
644030,True,0,No user reviews,0,0,0
644031,True,0,No user reviews,0,0,0
644032,True,0,No user reviews,0,0,0
644033,True,0,No user reviews,0,0,0
644034,True,0,No user reviews,0,0,0
644035,True,0,No user reviews,0,0,0
644036,True,0,No user reviews,0,0,0
644037,True,0,No user reviews,0,0,0
644038,True,0,No user reviews,0,0,0
644039,True,0,No user reviews,0,0,0
644040,True,0,No user reviews,0,0,0
644041,True,0,No user reviews,0,0,0
644050,True,0,No user reviews,0,0,0
644051,True,0,No user reviews,0,0,0
644052,True,0,No user reviews,0,0,0
644053,True,0,No user reviews,0,0,0
644054,True,0,No user reviews,0,0,0
644055,True,0,No user reviews,0,0,0
644056,True,0,No user reviews,0,0,0
644057,True,0,No user reviews,0,0,0
644058,True,0,No user reviews,0,0,0
644059,True,0,No user reviews,0,0,0
644060,True,0,No user reviews,0,0,0
644061,True,0,No user reviews,0,0,0
644062,True,0,No user reviews,0,0,0
644063,True,0,No user reviews,0,0,0
644064,True,0,No user reviews,0,0,0
644065,True,0,No user reviews,0,0,0
644066,True,0,No user reviews,0,0,0
644067,True,0,No user reviews,0,0,0
644068,True,0,No user reviews,0,0,0
644069,True,0,No user reviews,0,0,0
644070,True,0,No user reviews,0,0,0
644071,True,0,No user reviews,0,0,0
644080,True,8,Very Positive,47,8,55
644110,True,5,Mixed,8,6,14
644130,True,4,Mostly Negative,4,16,20
644150,True,0,3 user reviews,3,0,3
644160,True,0,6 user reviews,4,2,6
644170,True,0,No user reviews,0,0,0
644171,True,0,No user reviews,0,0,0
644172,True,0,No user reviews,0,0,0
644173,True,0,No user reviews,0,0,0
644174,True,0,No user reviews,0,0,0
644175,True,0,No user reviews,0,0,0
644176,True,0,No user reviews,0,0,0
644177,True,0,No user reviews,0,0,0
644178,True,0,No user reviews,0,0,0
644179,True,0,No user reviews,0,0,0
644180,True,0,No user reviews,0,0,0
644181,True,0,No user reviews,0,0,0
644200,True,7,Positive,19,3,22
644210,True,0,No user reviews,0,0,0
644220,True,0,No user reviews,0,0,0
644221,True,0,No user reviews,0,0,0
644222,True,0,No user reviews,0,0,0
644223,True,0,No user reviews,0,0,0
644224,True,0,No user reviews,0,0,0
644225,True,0,No user reviews,0,0,0
644226,True,0,No user reviews,0,0,0
644227,True,0,No user reviews,0,0,0
644228,True,0,No user reviews,0,0,0
644229,True,0,No user reviews,0,0,0
644230,True,0,No user reviews,0,0,0
644231,True,0,No user reviews,0,0,0
644232,True,0,No user reviews,0,0,0
644233,True,0,No user reviews,0,0,0
644234,True,0,No user reviews,0,0,0
644235,True,0,No user reviews,0,0,0
644236,True,0,No user reviews,0,0,0
644237,True,0,No user reviews,0,0,0
644238,True,0,No user reviews,0,0,0
644239,True,0,No user reviews,0,0,0
644240,True,0,No user reviews,0,0,0
644241,True,0,No user reviews,0,0,0
644242,True,0,No user reviews,0,0,0
644243,True,0,No user reviews,0,0,0
644280,True,0,No user reviews,0,0,0
644290,True,5,Mixed,256,129,385
644300,True,0,No user reviews,0,0,0
644320,True,0,No user reviews,0,0,0
644330,True,0,No user reviews,0,0,0
644340,True,0,No user reviews,0,0,0
644360,True,0,No user reviews,0,0,0
644370,True,7,Positive,19,1,20
644380,True,0,7 user reviews,3,4,7
644390,True,8,Very Positive,605,51,656
644400,True,0,3 user reviews,3,0,3
644420,True,5,Mixed,26,12,38
644440,True,0,No user reviews,0,0,0
644441,True,0,No user reviews,0,0,0
644442,True,0,No user reviews,0,0,0
644443,True,0,No user reviews,0,0,0
644444,True,0,No user reviews,0,0,0
644445,True,0,No user reviews,0,0,0
644446,True,0,No user reviews,0,0,0
644447,True,0,No user reviews,0,0,0
644448,True,0,No user reviews,0,0,0
644449,True,0,No user reviews,0,0,0
644450,True,0,No user reviews,0,0,0
644451,True,0,No user reviews,0,0,0
644460,True,0,No user reviews,0,0,0
644461,True,0,No user reviews,0,0,0
644462,True,0,No user reviews,0,0,0
644463,True,0,No user reviews,0,0,0
644464,True,0,No user reviews,0,0,0
644465,True,0,No user reviews,0,0,0
644466,True,0,No user reviews,0,0,0
644467,True,0,No user reviews,0,0,0
644468,True,0,No user reviews,0,0,0
644469,True,0,No user reviews,0,0,0
644470,True,0,No user reviews,0,0,0
644471,True,0,No user reviews,0,0,0
644480,True,5,Mixed,101,46,147
644520,True,0,No user reviews,0,0,0
644530,True,0,8 user reviews,4,4,8
644540,True,7,Positive,18,0,18
644550,True,0,9 user reviews,8,1,9
644560,True,8,Very Positive,4678,357,5035
644570,True,8,Very Positive,768,140,908
644580,True,0,5 user reviews,5,0,5
644610,True,0,8 user reviews,4,4,8
644640,True,5,Mixed,46,68,114
644660,True,0,No user reviews,0,0,0
644670,True,5,Mixed,65,39,104
644680,True,0,4 user reviews,4,0,4
644690,True,0,No user reviews,0,0,0
644700,True,0,No user reviews,0,0,0
644710,True,7,Positive,39,6,45
644730,True,0,No user reviews,0,0,0
644740,True,0,1 user reviews,1,0,1
644760,True,0,7 user reviews,4,3,7
644780,True,0,No user reviews,0,0,0
644800,True,0,No user reviews,0,0,0
644820,True,0,No user reviews,0,0,0
644830,True,8,Very Positive,1335,232,1567
644840,True,0,No user reviews,0,0,0
644860,True,0,No user reviews,0,0,0
644870,True,0,3 user reviews,2,1,3
644890,True,0,5 user reviews,2,3,5
644910,True,0,No user reviews,0,0,0
644920,True,0,No user reviews,0,0,0
644921,True,0,No user reviews,0,0,0
644922,True,0,No user reviews,0,0,0
644930,True,8,Very Positive,9908,2237,12145
644940,True,0,No user reviews,0,0,0
644960,True,0,1 user reviews,1,0,1
644961,True,0,1 user reviews,1,0,1
644962,True,0,2 user reviews,2,0,2
645040,True,0,No user reviews,0,0,0
645050,True,0,No user reviews,0,0,0
645090,True,8,Very Positive,444,47,491
645100,True,0,No user reviews,0,0,0
645130,True,0,No user reviews,0,0,0
645140,True,0,No user reviews,0,0,0
645150,True,0,4 user reviews,1,3,4
645170,True,0,2 user reviews,2,0,2
645171,True,0,No user reviews,0,0,0
645180,True,0,3 user reviews,3,0,3
645190,True,0,No user reviews,0,0,0
645200,True,0,No user reviews,0,0,0
645210,True,0,No user reviews,0,0,0
645220,True,0,1 user reviews,1,0,1
645230,True,0,No user reviews,0,0,0
645240,True,0,2 user reviews,2,0,2
645250,True,0,2 user reviews,2,0,2
645260,True,0,No user reviews,0,0,0
645270,True,6,Mostly Positive,11,3,14
645280,True,0,6 user reviews,5,1,6
645290,True,5,Mixed,14,10,24
645300,True,0,No user reviews,0,0,0
645310,True,0,4 user reviews,4,0,4
645320,True,0,No user reviews,0,0,0
645330,True,0,3 user reviews,0,3,3
645340,True,5,Mixed,7,6,13
645360,True,0,2 user reviews,1,1,2
645380,True,7,Positive,13,2,15
645400,True,5,Mixed,82,91,173
645401,True,5,Mixed,68,66,134
645402,True,5,Mixed,527,386,913
645410,True,5,Mixed,6,4,10
645420,True,0,7 user reviews,6,1,7
645430,True,0,6 user reviews,5,1,6
645440,True,0,6 user reviews,2,4,6
645450,True,5,Mixed,9,4,13
645460,True,6,Mostly Positive,19,8,27
645470,True,0,No user reviews,0,0,0
645480,True,0,No user reviews,0,0,0
645500,True,7,Positive,14,3,17
645510,True,0,2 user reviews,2,0,2
645511,True,0,No user reviews,0,0,0
645512,True,0,No user reviews,0,0,0
645513,True,0,No user reviews,0,0,0
645514,True,0,No user reviews,0,0,0
645515,True,0,No user reviews,0,0,0
645516,True,0,No user reviews,0,0,0
645517,True,0,No user reviews,0,0,0
645518,True,0,No user reviews,0,0,0
645519,True,0,No user reviews,0,0,0
645520,True,0,No user reviews,0,0,0
645521,True,0,No user reviews,0,0,0
645560,True,0,No user reviews,0,0,0
645610,True,0,3 user reviews,3,0,3
645620,True,0,No user reviews,0,0,0
645630,True,8,Very Positive,11470,1784,13254
645650,True,0,9 user reviews,6,3,9
645660,True,0,No user reviews,0,0,0
645670,True,0,6 user reviews,4,2,6
645671,True,0,6 user reviews,4,2,6
645690,True,7,Positive,10,0,10
645700,True,0,3 user reviews,2,1,3
645720,True,0,No user reviews,0,0,0
645730,True,8,Very Positive,244,39,283
645750,True,7,Positive,15,0,15
645770,True,0,No user reviews,0,0,0
645771,True,0,No user reviews,0,0,0
645780,True,0,1 user reviews,1,0,1
645790,True,5,Mixed,333,147,480
645820,True,6,Mostly Positive,20,6,26
645830,True,0,No user reviews,0,0,0
645840,True,0,No user reviews,0,0,0
645850,True,0,No user reviews,0,0,0
645860,True,0,6 user reviews,4,2,6
645880,True,0,No user reviews,0,0,0
645890,True,0,2 user reviews,2,0,2
645910,True,0,1 user reviews,1,0,1
645911,True,0,2 user reviews,2,0,2
645920,True,7,Positive,30,4,34
645930,True,5,Mixed,13,7,20
645940,True,0,1 user reviews,1,0,1
645950,True,0,No user reviews,0,0,0
645960,True,0,No user reviews,0,0,0
645970,True,0,6 user reviews,5,1,6
645980,True,0,No user reviews,0,0,0
645981,True,0,No user reviews,0,0,0
645982,True,0,No user reviews,0,0,0
645983,True,0,No user reviews,0,0,0
645984,True,0,No user reviews,0,0,0
645985,True,0,No user reviews,0,0,0
645986,True,0,No user reviews,0,0,0
645987,True,0,No user reviews,0,0,0
645988,True,0,No user reviews,0,0,0
645989,True,0,No user reviews,0,0,0
645990,True,0,No user reviews,0,0,0
646010,True,5,Mixed,7,5,12
646030,True,0,No user reviews,0,0,0
646050,True,5,Mixed,4,6,10
646060,True,0,No user reviews,0,0,0
646080,True,0,No user reviews,0,0,0
646100,True,0,9 user reviews,2,7,9
646110,True,0,No user reviews,0,0,0
646130,True,0,No user reviews,0,0,0
646140,True,0,No user reviews,0,0,0
646150,True,0,3 user reviews,2,1,3
646160,True,0,No user reviews,0,0,0
646161,True,0,No user reviews,0,0,0
646170,True,0,No user reviews,0,0,0
646171,True,0,No user reviews,0,0,0
646180,True,0,2 user reviews,1,1,2
646190,True,0,No user reviews,0,0,0
646200,True,8,Very Positive,574,122,696
646210,True,7,Positive,24,1,25
646240,True,0,No user reviews,0,0,0
646260,True,0,No user reviews,0,0,0
646270,True,8,Very Positive,314,56,370
646280,True,6,Mostly Positive,12,5,17
646290,True,0,No user reviews,0,0,0
646300,True,0,4 user reviews,2,2,4
646310,True,6,Mostly Positive,20,7,27
646320,True,0,No user reviews,0,0,0
646330,True,7,Positive,21,2,23
646340,True,0,No user reviews,0,0,0
646350,True,0,7 user reviews,3,4,7
646360,True,0,No user reviews,0,0,0
646370,True,0,3 user reviews,3,0,3
646380,True,0,8 user reviews,7,1,8
646400,True,0,No user reviews,0,0,0
646410,True,0,No user reviews,0,0,0
646420,True,0,3 user reviews,3,0,3
646430,True,0,2 user reviews,0,2,2
646440,True,0,1 user reviews,0,1,1
646460,True,0,5 user reviews,5,0,5
646470,True,6,Mostly Positive,23,6,29
646480,True,0,No user reviews,0,0,0
646490,True,0,1 user reviews,1,0,1
646500,True,8,Very Positive,201,37,238
646520,True,0,No user reviews,0,0,0
646530,True,7,Positive,16,3,19
646550,True,0,3 user reviews,3,0,3
646560,True,0,No user reviews,0,0,0
646570,True,9,Overwhelmingly Positive,31440,620,32060
646580,True,0,No user reviews,0,0,0
646590,True,0,No user reviews,0,0,0
646600,True,5,Mixed,40,19,59
646610,True,0,1 user reviews,1,0,1
646620,True,0,No user reviews,0,0,0
646630,True,0,No user reviews,0,0,0
646640,True,0,No user reviews,0,0,0
646660,True,0,2 user reviews,1,1,2
646661,True,0,1 user reviews,1,0,1
646662,True,0,5 user reviews,5,0,5
646663,True,0,2 user reviews,2,0,2
646664,True,0,1 user reviews,1,0,1
646665,True,0,2 user reviews,2,0,2
646666,True,0,3 user reviews,3,0,3
646667,True,0,2 user reviews,2,0,2
646668,True,6,Mostly Positive,18,5,23
646669,True,7,Positive,13,2,15
646670,True,7,Positive,13,0,13
646671,True,0,4 user reviews,4,0,4
646672,True,0,6 user reviews,4,2,6
646673,True,0,4 user reviews,4,0,4
646680,True,0,9 user reviews,8,1,9
646690,True,0,No user reviews,0,0,0
646700,True,0,No user reviews,0,0,0
646710,True,0,No user reviews,0,0,0
646730,True,7,Positive,23,4,27
646740,True,0,No user reviews,0,0,0
646750,True,0,No user reviews,0,0,0
646760,True,0,No user reviews,0,0,0
646770,True,0,No user reviews,0,0,0
646780,True,7,Positive,12,1,13
646790,True,0,No user reviews,0,0,0
646800,True,0,1 user reviews,1,0,1
646810,True,0,No user reviews,0,0,0
646820,True,0,No user reviews,0,0,0
646860,True,0,No user reviews,0,0,0
646870,True,0,No user reviews,0,0,0
646880,True,0,No user reviews,0,0,0
646890,True,0,2 user reviews,1,1,2
646900,True,0,No user reviews,0,0,0
646910,True,6,Mostly Positive,5459,1394,6853
646920,True,0,No user reviews,0,0,0
646921,True,0,No user reviews,0,0,0
646922,True,0,No user reviews,0,0,0
646930,True,0,2 user reviews,2,0,2
646950,True,0,No user reviews,0,0,0
646951,True,0,No user reviews,0,0,0
646952,True,0,No user reviews,0,0,0
646953,True,0,No user reviews,0,0,0
646960,True,0,No user reviews,0,0,0
646990,True,0,No user reviews,0,0,0
647000,True,0,No user reviews,0,0,0
647010,True,0,No user reviews,0,0,0
647020,True,0,7 user reviews,7,0,7
647030,True,0,No user reviews,0,0,0
647040,True,5,Mixed,19,9,28
647050,True,0,2 user reviews,0,2,2
647070,True,0,3 user reviews,3,0,3
647071,True,0,2 user reviews,2,0,2
647080,True,0,8 user reviews,8,0,8
647090,True,0,4 user reviews,4,0,4
647120,True,0,No user reviews,0,0,0
647130,True,0,No user reviews,0,0,0
647140,True,0,No user reviews,0,0,0
647150,True,0,1 user reviews,1,0,1
647160,True,0,No user reviews,0,0,0
647170,True,0,No user reviews,0,0,0
647171,True,0,No user reviews,0,0,0
647190,True,0,No user reviews,0,0,0
647200,True,0,1 user reviews,1,0,1
647210,True,0,No user reviews,0,0,0
647220,True,0,No user reviews,0,0,0
647230,True,0,No user reviews,0,0,0
647240,True,0,1 user reviews,1,0,1
647250,True,0,No user reviews,0,0,0
647260,True,0,1 user reviews,1,0,1
647280,True,0,6 user reviews,3,3,6
647290,True,0,1 user reviews,1,0,1
647300,True,0,No user reviews,0,0,0
647310,True,0,1 user reviews,1,0,1
647320,True,0,1 user reviews,1,0,1
647330,True,0,No user reviews,0,0,0
647340,True,0,No user reviews,0,0,0
647350,True,0,No user reviews,0,0,0
647370,True,0,No user reviews,0,0,0
647371,True,0,3 user reviews,2,1,3
647400,True,0,1 user reviews,1,0,1
647430,True,0,No user reviews,0,0,0
647450,True,0,No user reviews,0,0,0
647460,True,0,No user reviews,0,0,0
647470,True,0,No user reviews,0,0,0
647480,True,0,No user reviews,0,0,0
647490,True,0,No user reviews,0,0,0
647500,True,5,Mixed,11,8,19
647510,True,0,No user reviews,0,0,0
647520,True,0,No user reviews,0,0,0
647530,True,0,6 user reviews,2,4,6
647550,True,0,No user reviews,0,0,0
647560,True,5,Mixed,18,17,35
647570,True,6,Mostly Positive,95,28,123
647580,True,0,No user reviews,0,0,0
647620,True,0,No user reviews,0,0,0
647630,True,0,3 user reviews,0,3,3
647631,True,0,No user reviews,0,0,0
647632,True,0,1 user reviews,1,0,1
647633,True,0,No user reviews,0,0,0
647640,True,5,Mixed,6,4,10
647650,True,0,4 user reviews,2,2,4
647660,True,0,No user reviews,0,0,0
647670,True,0,No user reviews,0,0,0
647680,True,0,No user reviews,0,0,0
647690,True,0,No user reviews,0,0,0
647700,True,0,No user reviews,0,0,0
647710,True,0,No user reviews,0,0,0
647720,True,0,No user reviews,0,0,0
647730,True,0,No user reviews,0,0,0
647740,True,8,Very Positive,141,24,165
647770,True,0,No user reviews,0,0,0
647790,True,0,1 user reviews,1,0,1
647810,True,7,Positive,9,2,11
647820,True,4,Mostly Negative,4,13,17
647830,True,6,Mostly Positive,738,192,930
647840,True,0,8 user reviews,8,0,8
647850,True,0,3 user reviews,3,0,3
647860,True,5,Mixed,7,5,12
647890,True,0,4 user reviews,2,2,4
647900,True,0,2 user reviews,2,0,2
647910,True,0,3 user reviews,3,0,3
647920,True,0,No user reviews,0,0,0
647930,True,0,4 user reviews,3,1,4
647940,True,0,No user reviews,0,0,0
647950,True,0,No user reviews,0,0,0
647960,True,9,Overwhelmingly Positive,666,23,689
647980,True,4,Mostly Negative,7,11,18
647990,True,7,Positive,14,2,16
648020,True,5,Mixed,7,4,11
648030,True,0,No user reviews,0,0,0
648050,True,8,Very Positive,53,5,58
648060,True,0,5 user reviews,2,3,5
648070,True,0,6 user reviews,1,5,6
648080,True,0,No user reviews,0,0,0
648090,True,0,No user reviews,0,0,0
648100,True,8,Very Positive,96,8,104
648110,True,0,No user reviews,0,0,0
648111,True,0,No user reviews,0,0,0
648112,True,0,No user reviews,0,0,0
648113,True,0,1 user reviews,0,1,1
648120,True,7,Positive,22,5,27
648150,True,0,No user reviews,0,0,0
648190,True,0,3 user reviews,3,0,3
648200,True,0,1 user reviews,0,1,1
648220,True,0,No user reviews,0,0,0
648270,True,0,No user reviews,0,0,0
648290,True,7,Positive,20,4,24
648292,True,7,Positive,29,1,30
648293,True,6,Mostly Positive,16,6,22
648300,True,0,No user reviews,0,0,0
648301,True,5,Mixed,11,11,22
648310,True,0,No user reviews,0,0,0
648330,True,0,No user reviews,0,0,0
648350,True,8,Very Positive,11819,2644,14463
648380,True,0,No user reviews,0,0,0
648390,True,0,No user reviews,0,0,0
648400,True,7,Positive,9,2,11
648410,True,0,No user reviews,0,0,0
648420,True,7,Positive,10,1,11
648430,True,0,No user reviews,0,0,0
648440,True,0,5 user reviews,4,1,5
648450,True,0,No user reviews,0,0,0
648460,True,0,No user reviews,0,0,0
648470,True,0,No user reviews,0,0,0
648480,True,0,No user reviews,0,0,0
648491,True,0,No user reviews,0,0,0
648500,True,0,No user reviews,0,0,0
648510,True,0,8 user reviews,7,1,8
648520,True,0,No user reviews,0,0,0
648530,True,0,3 user reviews,1,2,3
648540,True,0,No user reviews,0,0,0
648550,True,0,6 user reviews,3,3,6
648570,True,0,5 user reviews,2,3,5
648580,True,8,Very Positive,243,9,252
648590,True,0,No user reviews,0,0,0
648600,True,0,No user reviews,0,0,0
648630,True,5,Mixed,8,9,17
648640,True,0,7 user reviews,5,2,7
648650,True,0,No user reviews,0,0,0
648660,True,0,6 user reviews,4,2,6
648670,True,0,No user reviews,0,0,0
648690,True,0,No user reviews,0,0,0
648710,True,0,5 user reviews,5,0,5
648730,True,0,3 user reviews,3,0,3
648750,True,5,Mixed,25,15,40
648780,True,6,Mostly Positive,48,14,62
648800,True,8,Very Positive,23131,2288,25419
648810,True,0,4 user reviews,2,2,4
648820,True,0,5 user reviews,5,0,5
648860,True,0,No user reviews,0,0,0
648870,True,0,No user reviews,0,0,0
648880,True,0,7 user reviews,7,0,7
648890,True,8,Very Positive,87,10,97
648930,True,7,Positive,23,0,23
648940,True,0,No user reviews,0,0,0
648960,True,0,No user reviews,0,0,0
648970,True,0,No user reviews,0,0,0
648980,True,7,Positive,28,0,28
649000,True,0,No user reviews,0,0,0
649020,True,0,No user reviews,0,0,0
649040,True,0,No user reviews,0,0,0
649070,True,0,No user reviews,0,0,0
649090,True,0,No user reviews,0,0,0
649120,True,0,6 user reviews,6,0,6
649150,True,0,6 user reviews,2,4,6
649160,True,0,2 user reviews,1,1,2
649170,True,0,4 user reviews,1,3,4
649190,True,5,Mixed,6,5,11
649240,True,6,Mostly Positive,11,4,15
649250,True,0,1 user reviews,1,0,1
649270,True,5,Mixed,23,11,34
649271,True,0,6 user reviews,4,2,6
649272,True,7,Positive,13,1,14
649280,True,7,Positive,9,2,11
649290,True,0,No user reviews,0,0,0
649300,True,0,3 user reviews,0,3,3
649310,True,0,6 user reviews,6,0,6
649320,True,0,No user reviews,0,0,0
649330,True,0,6 user reviews,5,1,6
649340,True,0,No user reviews,0,0,0
649360,True,0,1 user reviews,0,1,1
649370,True,0,No user reviews,0,0,0
649390,True,0,1 user reviews,1,0,1
649400,True,0,No user reviews,0,0,0
649401,True,0,No user reviews,0,0,0
649402,True,0,No user reviews,0,0,0
649403,True,0,No user reviews,0,0,0
649410,True,5,Mixed,71,49,120
649420,True,0,No user reviews,0,0,0
649430,True,0,No user reviews,0,0,0
649431,True,0,No user reviews,0,0,0
649450,True,7,Positive,19,4,23
649460,True,5,Mixed,6,5,11
649480,True,0,4 user reviews,4,0,4
649481,True,0,3 user reviews,3,0,3
649482,True,0,7 user reviews,7,0,7
649483,True,0,4 user reviews,3,1,4
649484,True,0,4 user reviews,1,3,4
649485,True,7,Positive,9,1,10
649486,True,6,Mostly Positive,13,4,17
649487,True,0,1 user reviews,1,0,1
649488,True,0,7 user reviews,5,2,7
649489,True,0,3 user reviews,3,0,3
649490,True,0,4 user reviews,4,0,4
649491,True,0,3 user reviews,3,0,3
649500,True,0,No user reviews,0,0,0
649510,True,0,4 user reviews,2,2,4
649540,True,0,No user reviews,0,0,0
649550,True,0,No user reviews,0,0,0
649570,True,0,2 user reviews,1,1,2
649580,True,6,Mostly Positive,36,12,48
649600,True,5,Mixed,94,44,138
649610,True,0,No user reviews,0,0,0
649611,True,0,No user reviews,0,0,0
649612,True,0,No user reviews,0,0,0
649613,True,0,No user reviews,0,0,0
649614,True,0,No user reviews,0,0,0
649615,True,0,No user reviews,0,0,0
649616,True,0,No user reviews,0,0,0
649617,True,0,No user reviews,0,0,0
649618,True,0,No user reviews,0,0,0
649619,True,0,No user reviews,0,0,0
649620,True,7,Positive,15,0,15
649630,True,0,2 user reviews,1,1,2
649640,True,8,Very Positive,251,59,310
649660,True,0,3 user reviews,1,2,3
649670,True,5,Mixed,7,7,14
649690,True,0,3 user reviews,2,1,3
649700,True,0,No user reviews,0,0,0
649720,True,0,No user reviews,0,0,0
649730,True,0,3 user reviews,1,2,3
649740,True,0,7 user reviews,2,5,7
649770,True,0,No user reviews,0,0,0
649790,True,5,Mixed,40,52,92
649810,True,5,Mixed,16,8,24
649820,True,0,No user reviews,0,0,0
649830,True,0,No user reviews,0,0,0
649870,True,5,Mixed,6,7,13
649880,True,5,Mixed,11,6,17
649890,True,0,No user reviews,0,0,0
649900,True,0,No user reviews,0,0,0
649920,True,0,No user reviews,0,0,0
649930,True,0,No user reviews,0,0,0
649940,True,0,6 user reviews,6,0,6
649950,True,6,Mostly Positive,291,124,415
649970,True,0,1 user reviews,1,0,1
649990,True,7,Positive,11,1,12
650000,True,5,Mixed,629,481,1110
650010,True,0,4 user reviews,2,2,4
650030,True,0,No user reviews,0,0,0
650031,True,0,No user reviews,0,0,0
650040,True,0,No user reviews,0,0,0
650041,True,0,No user reviews,0,0,0
650042,True,0,No user reviews,0,0,0
650043,True,0,No user reviews,0,0,0
650044,True,0,No user reviews,0,0,0
650045,True,0,No user reviews,0,0,0
650046,True,0,No user reviews,0,0,0
650047,True,0,No user reviews,0,0,0
650048,True,0,No user reviews,0,0,0
650049,True,0,No user reviews,0,0,0
650050,True,0,No user reviews,0,0,0
650060,True,0,No user reviews,0,0,0
650061,True,0,No user reviews,0,0,0
650062,True,0,No user reviews,0,0,0
650063,True,0,No user reviews,0,0,0
650064,True,0,No user reviews,0,0,0
650065,True,0,No user reviews,0,0,0
650070,True,5,Mixed,17,8,25
650090,True,0,No user reviews,0,0,0
650110,True,5,Mixed,46,30,76
650120,True,0,No user reviews,0,0,0
650140,True,0,No user reviews,0,0,0
650170,True,0,No user reviews,0,0,0
650190,True,0,No user reviews,0,0,0
650220,True,8,Very Positive,193,33,226
650230,True,0,3 user reviews,3,0,3
650231,True,0,2 user reviews,2,0,2
650232,True,0,1 user reviews,1,0,1
650233,True,0,1 user reviews,1,0,1
650234,True,0,1 user reviews,1,0,1
650235,True,0,1 user reviews,0,1,1
650236,True,0,1 user reviews,1,0,1
650237,True,0,1 user reviews,1,0,1
650238,True,0,1 user reviews,1,0,1
650239,True,0,1 user reviews,0,1,1
650240,True,0,1 user reviews,0,1,1
650241,True,0,2 user reviews,2,0,2
650242,True,0,1 user reviews,1,0,1
650243,True,0,2 user reviews,1,1,2
650250,True,0,No user reviews,0,0,0
650260,True,0,No user reviews,0,0,0
650261,True,0,No user reviews,0,0,0
650270,True,0,No user reviews,0,0,0
650280,True,0,No user reviews,0,0,0
650290,True,0,4 user reviews,2,2,4
650291,True,0,2 user reviews,0,2,2
650300,True,0,2 user reviews,2,0,2
650310,True,0,3 user reviews,0,3,3
650330,True,7,Positive,16,3,19
650340,True,0,1 user reviews,0,1,1
650350,True,5,Mixed,71,54,125
650360,True,0,3 user reviews,0,3,3
650370,True,0,No user reviews,0,0,0
650390,True,0,No user reviews,0,0,0
650410,True,4,Mostly Negative,26,49,75
650420,True,0,No user reviews,0,0,0
650421,True,0,No user reviews,0,0,0
650422,True,0,No user reviews,0,0,0
650423,True,0,No user reviews,0,0,0
650424,True,0,No user reviews,0,0,0
650425,True,0,No user reviews,0,0,0
650440,True,6,Mostly Positive,151,60,211
650460,True,0,No user reviews,0,0,0
650490,True,5,Mixed,17,25,42
650500,True,6,Mostly Positive,5967,2330,8297
650510,True,6,Mostly Positive,170,62,232
650520,True,0,No user reviews,0,0,0
650521,True,0,No user reviews,0,0,0
650522,True,0,No user reviews,0,0,0
650523,True,0,No user reviews,0,0,0
650524,True,4,Mostly Negative,26,49,75
650540,True,0,No user reviews,0,0,0
650560,True,0,No user reviews,0,0,0
650570,True,7,Positive,43,3,46
650580,True,0,3 user reviews,1,2,3
650600,True,0,3 user reviews,2,1,3
650610,True,7,Positive,9,1,10
650611,True,8,Very Positive,50,3,53
650620,True,0,No user reviews,0,0,0
650630,True,0,No user reviews,0,0,0
650640,True,0,No user reviews,0,0,0
650670,True,6,Mostly Positive,290,121,411
650680,True,7,Positive,13,1,14
650690,True,0,No user reviews,0,0,0
650700,True,0,No user reviews,0,0,0
650710,True,0,No user reviews,0,0,0
650720,True,0,1 user reviews,0,1,1
650730,True,0,9 user reviews,4,5,9
650740,True,0,No user reviews,0,0,0
650750,True,6,Mostly Positive,24,7,31
650760,True,6,Mostly Positive,75,22,97
650770,True,0,No user reviews,0,0,0
650780,True,6,Mostly Positive,15,5,20
650790,True,0,No user reviews,0,0,0
650810,True,0,8 user reviews,2,6,8
650820,True,0,3 user reviews,1,2,3
650840,True,0,4 user reviews,3,1,4
650860,True,5,Mixed,22,13,35
650880,True,0,2 user reviews,1,1,2
650900,True,0,No user reviews,0,0,0
650910,True,0,No user reviews,0,0,0
650920,True,0,No user reviews,0,0,0
650930,True,0,No user reviews,0,0,0
650940,True,8,Very Positive,154,31,185
650980,True,0,2 user reviews,1,1,2
650990,True,0,1 user reviews,0,1,1
651010,True,0,4 user reviews,3,1,4
651020,True,5,Mixed,5,6,11
651080,True,0,No user reviews,0,0,0
651090,True,0,No user reviews,0,0,0
651120,True,0,8 user reviews,4,4,8
651130,True,0,8 user reviews,8,0,8
651131,True,0,2 user reviews,2,0,2
651132,True,0,1 user reviews,1,0,1
651140,True,0,No user reviews,0,0,0
651150,True,8,Very Positive,380,79,459
651170,True,0,1 user reviews,0,1,1
651280,True,0,3 user reviews,3,0,3
651310,True,0,No user reviews,0,0,0
651320,True,0,No user reviews,0,0,0
651340,True,6,Mostly Positive,14,4,18
651360,True,0,5 user reviews,5,0,5
651370,True,0,No user reviews,0,0,0
651380,True,7,Positive,31,0,31
651400,True,0,No user reviews,0,0,0
651410,True,0,No user reviews,0,0,0
651430,True,0,No user reviews,0,0,0
651440,True,4,Mostly Negative,33,65,98
651450,True,0,No user reviews,0,0,0
651460,True,0,No user reviews,0,0,0
651470,True,0,1 user reviews,1,0,1
651480,True,0,1 user reviews,1,0,1
651481,True,0,2 user reviews,2,0,2
651490,True,0,No user reviews,0,0,0
651500,True,8,Very Positive,45,5,50
651510,True,0,1 user reviews,1,0,1
651520,True,0,3 user reviews,1,2,3
651530,True,0,No user reviews,0,0,0
651550,True,7,Positive,9,2,11
651560,True,0,No user reviews,0,0,0
651610,True,0,No user reviews,0,0,0
651630,True,0,No user reviews,0,0,0
651640,True,0,8 user reviews,8,0,8
651650,True,0,4 user reviews,2,2,4
651660,True,8,Very Positive,283,56,339
651670,True,8,Very Positive,393,75,468
651680,True,5,Mixed,11,6,17
651690,True,0,3 user reviews,2,1,3
651820,True,0,1 user reviews,1,0,1
651930,True,0,No user reviews,0,0,0
651940,True,0,No user reviews,0,0,0
651970,True,0,3 user reviews,2,1,3
651990,True,0,No user reviews,0,0,0
652000,True,0,4 user reviews,3,1,4
652030,True,0,No user reviews,0,0,0
652040,True,0,3 user reviews,3,0,3
652050,True,7,Positive,11,2,13
652060,True,0,1 user reviews,0,1,1
652070,True,0,1 user reviews,0,1,1
652090,True,0,3 user reviews,3,0,3
652120,True,0,4 user reviews,3,1,4
652130,True,0,3 user reviews,3,0,3
652140,True,0,No user reviews,0,0,0
652150,True,8,Very Positive,61,2,63
652160,True,0,No user reviews,0,0,0
652180,True,0,2 user reviews,0,2,2
652190,True,8,Very Positive,75,11,86
652200,True,0,3 user reviews,3,0,3
652220,True,0,No user reviews,0,0,0
652230,True,0,5 user reviews,1,4,5
652250,True,0,No user reviews,0,0,0
652270,True,0,No user reviews,0,0,0
652280,True,0,2 user reviews,0,2,2
652310,True,0,1 user reviews,1,0,1
652330,True,0,No user reviews,0,0,0
652340,True,7,Positive,28,0,28
652350,True,0,No user reviews,0,0,0
652360,True,7,Positive,12,2,14
652390,True,0,1 user reviews,0,1,1
652410,True,8,Very Positive,83,6,89
652440,True,0,No user reviews,0,0,0
652460,True,0,3 user reviews,2,1,3
652470,True,0,2 user reviews,1,1,2
652480,True,0,No user reviews,0,0,0
652490,True,0,1 user reviews,1,0,1
652491,True,0,1 user reviews,0,1,1
652510,True,0,7 user reviews,7,0,7
652520,True,0,No user reviews,0,0,0
652530,True,0,4 user reviews,4,0,4
652540,True,0,6 user reviews,3,3,6
652550,True,0,2 user reviews,0,2,2
652560,True,0,5 user reviews,3,2,5
652570,True,7,Positive,23,2,25
652600,True,5,Mixed,11,6,17
652610,True,0,3 user reviews,3,0,3
652620,True,0,No user reviews,0,0,0
652660,True,4,Mostly Negative,12,27,39
652700,True,7,Positive,10,0,10
652730,True,0,No user reviews,0,0,0
652750,True,0,7 user reviews,4,3,7
652760,True,0,5 user reviews,5,0,5
652770,True,0,No user reviews,0,0,0
652780,True,0,No user reviews,0,0,0
652800,True,7,Positive,18,1,19
652810,True,7,Positive,21,0,21
652830,True,0,9 user reviews,5,4,9
652840,True,0,No user reviews,0,0,0
652880,True,0,9 user reviews,8,1,9
652890,True,7,Positive,13,2,15
652900,True,0,No user reviews,0,0,0
652910,True,0,2 user reviews,2,0,2
652930,True,0,No user reviews,0,0,0
652931,True,0,No user reviews,0,0,0
652932,True,0,No user reviews,0,0,0
652940,True,0,No user reviews,0,0,0
652950,True,8,Very Positive,82,3,85
652960,True,8,Very Positive,143,19,162
652980,True,0,No user reviews,0,0,0
652990,True,0,No user reviews,0,0,0
653000,True,0,No user reviews,0,0,0
653050,True,0,6 user reviews,3,3,6
653080,True,0,5 user reviews,4,1,5
653090,True,0,No user reviews,0,0,0
653100,True,0,1 user reviews,1,0,1
653120,True,0,No user reviews,0,0,0
653130,True,0,No user reviews,0,0,0
653150,True,0,No user reviews,0,0,0
653170,True,0,No user reviews,0,0,0
653171,True,0,No user reviews,0,0,0
653172,True,0,No user reviews,0,0,0
653173,True,0,No user reviews,0,0,0
653190,True,7,Positive,10,2,12
653200,True,0,1 user reviews,1,0,1
653210,True,0,6 user reviews,3,3,6
653220,True,0,No user reviews,0,0,0
653230,True,0,4 user reviews,4,0,4
653240,True,0,No user reviews,0,0,0
653250,True,0,No user reviews,0,0,0
653260,True,0,No user reviews,0,0,0
653270,True,0,No user reviews,0,0,0
653280,True,0,No user reviews,0,0,0
653290,True,0,No user reviews,0,0,0
653300,True,0,No user reviews,0,0,0
653320,True,0,No user reviews,0,0,0
653330,True,0,No user reviews,0,0,0
653340,True,0,No user reviews,0,0,0
653350,True,0,No user reviews,0,0,0
653360,True,0,No user reviews,0,0,0
653380,True,0,No user reviews,0,0,0
653390,True,0,No user reviews,0,0,0
653400,True,0,No user reviews,0,0,0
653410,True,0,No user reviews,0,0,0
653420,True,0,No user reviews,0,0,0
653430,True,0,No user reviews,0,0,0
653440,True,0,No user reviews,0,0,0
653450,True,0,No user reviews,0,0,0
653460,True,0,No user reviews,0,0,0
653470,True,0,No user reviews,0,0,0
653480,True,0,No user reviews,0,0,0
653490,True,0,No user reviews,0,0,0
653500,True,0,No user reviews,0,0,0
653530,True,9,Overwhelmingly Positive,6195,215,6410
653550,True,0,No user reviews,0,0,0
653560,True,0,No user reviews,0,0,0
653570,True,0,No user reviews,0,0,0
653580,True,7,Positive,11,0,11
653720,True,0,3 user reviews,1,2,3
653721,True,0,1 user reviews,1,0,1
653722,True,0,2 user reviews,2,0,2
653723,True,0,1 user reviews,1,0,1
653724,True,0,5 user reviews,3,2,5
653725,True,0,2 user reviews,2,0,2
653726,True,0,2 user reviews,2,0,2
653727,True,0,1 user reviews,1,0,1
653728,True,0,8 user reviews,2,6,8
653730,True,0,No user reviews,0,0,0
653740,True,0,No user reviews,0,0,0
653750,True,0,No user reviews,0,0,0
653760,True,0,9 user reviews,4,5,9
653770,True,0,2 user reviews,2,0,2
653780,True,0,4 user reviews,2,2,4
653790,True,0,No user reviews,0,0,0
653840,True,0,No user reviews,0,0,0
653850,True,0,No user reviews,0,0,0
653860,True,0,No user reviews,0,0,0
653861,True,0,No user reviews,0,0,0
653870,True,0,1 user reviews,0,1,1
653890,True,0,2 user reviews,1,1,2
653891,True,0,No user reviews,0,0,0
653892,True,0,1 user reviews,1,0,1
653920,True,0,1 user reviews,1,0,1
653930,True,8,Very Positive,174,11,185
653940,True,6,Mostly Positive,56,19,75
653950,True,8,Very Positive,59,2,61
653960,True,0,1 user reviews,1,0,1
653970,True,0,5 user reviews,4,1,5
654000,True,0,4 user reviews,4,0,4
654010,True,0,3 user reviews,3,0,3
654020,True,0,8 user reviews,6,2,8
654050,True,8,Very Positive,187,25,212
654060,True,0,No user reviews,0,0,0
654070,True,0,9 user reviews,5,4,9
654080,True,0,1 user reviews,1,0,1
654090,True,6,Mostly Positive,24,8,32
654100,True,7,Positive,20,1,21
654110,True,0,No user reviews,0,0,0
654120,True,0,8 user reviews,5,3,8
654140,True,0,1 user reviews,1,0,1
654170,True,0,No user reviews,0,0,0
654171,True,0,No user reviews,0,0,0
654172,True,8,Very Positive,55,4,59
654174,True,0,No user reviews,0,0,0
654180,True,0,No user reviews,0,0,0
654181,True,7,Positive,14,2,16
654183,True,0,3 user reviews,3,0,3
654185,True,0,2 user reviews,2,0,2
654186,True,0,2 user reviews,2,0,2
654187,True,0,No user reviews,0,0,0
654188,True,0,1 user reviews,1,0,1
654189,True,0,No user reviews,0,0,0
654190,True,0,1 user reviews,1,0,1
654200,True,0,No user reviews,0,0,0
654220,True,8,Very Positive,55,9,64
654230,True,0,No user reviews,0,0,0
654240,True,0,2 user reviews,1,1,2
654250,True,5,Mixed,9,6,15
654260,True,0,5 user reviews,5,0,5
654270,True,0,No user reviews,0,0,0
654280,True,0,No user reviews,0,0,0
654300,True,4,Mostly Negative,12,20,32
654310,True,0,No user reviews,0,0,0
654330,True,0,No user reviews,0,0,0
654340,True,0,No user reviews,0,0,0
654350,True,4,Mostly Negative,10,16,26
654360,True,0,No user reviews,0,0,0
654390,True,0,1 user reviews,0,1,1
654400,True,7,Positive,18,1,19
654430,True,7,Positive,19,2,21
654440,True,6,Mostly Positive,45,14,59
654450,True,0,2 user reviews,0,2,2
654460,True,0,No user reviews,0,0,0
654470,True,5,Mixed,23,14,37
654500,True,7,Positive,21,0,21
654520,True,0,5 user reviews,5,0,5
654540,True,0,1 user reviews,1,0,1
654550,True,8,Very Positive,82,10,92
654570,True,0,7 user reviews,5,2,7
654580,True,7,Positive,14,0,14
654590,True,0,No user reviews,0,0,0
654600,True,0,9 user reviews,8,1,9
654610,True,5,Mixed,14,8,22
654630,True,0,No user reviews,0,0,0
654640,True,0,2 user reviews,2,0,2
654660,True,5,Mixed,6,7,13
654670,True,0,7 user reviews,7,0,7
654680,True,0,No user reviews,0,0,0
654690,True,5,Mixed,144,75,219
654700,True,0,4 user reviews,2,2,4
654710,True,5,Mixed,5,6,11
654740,True,0,8 user reviews,5,3,8
654750,True,0,4 user reviews,2,2,4
654770,True,7,Positive,17,0,17
654800,True,0,4 user reviews,2,2,4
654810,True,7,Positive,20,0,20
654820,True,0,1 user reviews,1,0,1
654840,True,0,1 user reviews,1,0,1
654850,True,6,Mostly Positive,107,43,150
654880,True,8,Very Positive,2965,312,3277
654890,True,6,Mostly Positive,269,84,353
654900,True,8,Very Positive,149,17,166
654910,True,7,Positive,25,0,25
654940,True,0,3 user reviews,0,3,3
654950,True,0,4 user reviews,0,4,4
654960,True,0,No user reviews,0,0,0
654970,True,0,3 user reviews,1,2,3
654980,True,0,1 user reviews,0,1,1
654990,True,5,Mixed,203,212,415
655000,True,5,Mixed,14,7,21
655020,True,5,Mixed,18,9,27
655030,True,0,5 user reviews,5,0,5
655040,True,0,5 user reviews,3,2,5
655060,True,0,No user reviews,0,0,0
655061,True,0,No user reviews,0,0,0
655062,True,0,No user reviews,0,0,0
655063,True,0,No user reviews,0,0,0
655064,True,0,No user reviews,0,0,0
655065,True,0,No user reviews,0,0,0
655066,True,0,No user reviews,0,0,0
655067,True,0,No user reviews,0,0,0
655068,True,0,No user reviews,0,0,0
655069,True,0,No user reviews,0,0,0
655070,True,0,No user reviews,0,0,0
655071,True,0,No user reviews,0,0,0
655080,True,8,Very Positive,56,12,68
655100,True,6,Mostly Positive,77,24,101
655110,True,0,No user reviews,0,0,0
655120,True,3,Negative,2,9,11
655160,True,0,No user reviews,0,0,0
655170,True,0,No user reviews,0,0,0
655180,True,0,3 user reviews,3,0,3
655200,True,0,3 user reviews,3,0,3
655220,True,0,1 user reviews,1,0,1
655250,True,0,1 user reviews,0,1,1
655270,True,6,Mostly Positive,22,9,31
655280,True,0,3 user reviews,3,0,3
655290,True,5,Mixed,117,74,191
655330,True,0,No user reviews,0,0,0
655340,True,0,No user reviews,0,0,0
655360,True,0,2 user reviews,2,0,2
655370,True,7,Positive,13,1,14
655380,True,7,Positive,30,4,34
655420,True,7,Positive,9,1,10
655430,True,0,7 user reviews,4,3,7
655440,True,0,2 user reviews,1,1,2
655460,True,5,Mixed,6,7,13
655480,True,8,Very Positive,168,6,174
655490,True,0,2 user reviews,2,0,2
655500,True,8,Very Positive,358,35,393
655520,True,0,No user reviews,0,0,0
655550,True,0,No user reviews,0,0,0
655560,True,0,1 user reviews,1,0,1
655561,True,0,No user reviews,0,0,0
655562,True,0,No user reviews,0,0,0
655563,True,0,No user reviews,0,0,0
655564,True,0,No user reviews,0,0,0
655565,True,0,No user reviews,0,0,0
655566,True,0,No user reviews,0,0,0
655567,True,0,No user reviews,0,0,0
655568,True,0,No user reviews,0,0,0
655569,True,0,No user reviews,0,0,0
655570,True,0,No user reviews,0,0,0
655571,True,0,1 user reviews,1,0,1
655580,True,0,3 user reviews,3,0,3
655600,True,0,No user reviews,0,0,0
655610,True,3,Negative,1,9,10
655620,True,0,1 user reviews,1,0,1
655630,True,0,1 user reviews,1,0,1
655640,True,0,No user reviews,0,0,0
655650,True,0,1 user reviews,1,0,1
655660,True,0,8 user reviews,6,2,8
655670,True,0,No user reviews,0,0,0
655680,True,0,No user reviews,0,0,0
655681,True,0,No user reviews,0,0,0
655682,True,0,No user reviews,0,0,0
655683,True,0,No user reviews,0,0,0
655684,True,0,No user reviews,0,0,0
655685,True,0,No user reviews,0,0,0
655686,True,0,No user reviews,0,0,0
655687,True,0,No user reviews,0,0,0
655688,True,0,No user reviews,0,0,0
655689,True,0,No user reviews,0,0,0
655690,True,0,No user reviews,0,0,0
655691,True,0,No user reviews,0,0,0
655700,True,0,No user reviews,0,0,0
655710,True,0,9 user reviews,2,7,9
655730,True,8,Very Positive,132,32,164
655740,True,0,No user reviews,0,0,0
655760,True,0,6 user reviews,5,1,6
655770,True,8,Very Positive,172,6,178
655780,True,5,Mixed,142,71,213
655790,True,5,Mixed,85,45,130
655800,True,0,3 user reviews,3,0,3
655801,True,0,1 user reviews,1,0,1
655802,True,0,No user reviews,0,0,0
655803,True,0,No user reviews,0,0,0
655804,True,0,No user reviews,0,0,0
655805,True,0,No user reviews,0,0,0
655806,True,0,No user reviews,0,0,0
655807,True,0,No user reviews,0,0,0
655808,True,0,No user reviews,0,0,0
655809,True,0,No user reviews,0,0,0
655810,True,0,No user reviews,0,0,0
655811,True,0,No user reviews,0,0,0
655840,True,0,No user reviews,0,0,0
655890,True,0,No user reviews,0,0,0
655891,True,0,No user reviews,0,0,0
655892,True,0,No user reviews,0,0,0
655893,True,0,No user reviews,0,0,0
655894,True,0,No user reviews,0,0,0
655895,True,0,No user reviews,0,0,0
655896,True,0,No user reviews,0,0,0
655897,True,0,No user reviews,0,0,0
655898,True,0,No user reviews,0,0,0
655899,True,0,No user reviews,0,0,0
655900,True,0,No user reviews,0,0,0
655901,True,0,No user reviews,0,0,0
655910,True,7,Positive,21,1,22
655920,True,0,No user reviews,0,0,0
655930,True,0,2 user reviews,1,1,2
655940,True,0,5 user reviews,3,2,5
655950,True,0,1 user reviews,1,0,1
655960,True,0,No user reviews,0,0,0
655961,True,0,No user reviews,0,0,0
655962,True,0,No user reviews,0,0,0
655963,True,0,No user reviews,0,0,0
655964,True,0,No user reviews,0,0,0
655965,True,0,No user reviews,0,0,0
655966,True,0,No user reviews,0,0,0
655967,True,0,No user reviews,0,0,0
655968,True,0,No user reviews,0,0,0
655969,True,0,No user reviews,0,0,0
655970,True,0,No user reviews,0,0,0
655971,True,0,No user reviews,0,0,0
655980,True,0,5 user reviews,2,3,5
656000,True,0,No user reviews,0,0,0
656001,True,0,No user reviews,0,0,0
656002,True,0,No user reviews,0,0,0
656003,True,0,No user reviews,0,0,0
656004,True,0,No user reviews,0,0,0
656005,True,0,No user reviews,0,0,0
656006,True,0,No user reviews,0,0,0
656007,True,0,No user reviews,0,0,0
656008,True,0,No user reviews,0,0,0
656009,True,0,No user reviews,0,0,0
656010,True,0,No user reviews,0,0,0
656011,True,0,No user reviews,0,0,0
656020,True,0,1 user reviews,1,0,1
656030,True,5,Mixed,42,22,64
656040,True,7,Positive,21,5,26
656060,True,0,4 user reviews,2,2,4
656070,True,0,No user reviews,0,0,0
656120,True,0,No user reviews,0,0,0
656130,True,0,No user reviews,0,0,0
656140,True,5,Mixed,14,7,21
656150,True,0,No user reviews,0,0,0
656151,True,0,No user reviews,0,0,0
656152,True,0,No user reviews,0,0,0
656153,True,0,No user reviews,0,0,0
656154,True,0,No user reviews,0,0,0
656155,True,0,No user reviews,0,0,0
656156,True,0,No user reviews,0,0,0
656157,True,0,No user reviews,0,0,0
656158,True,0,No user reviews,0,0,0
656159,True,0,No user reviews,0,0,0
656160,True,0,No user reviews,0,0,0
656161,True,0,No user reviews,0,0,0
656170,True,0,No user reviews,0,0,0
656190,True,0,6 user reviews,5,1,6
656200,True,5,Mixed,72,48,120
656210,True,5,Mixed,25,15,40
656220,True,0,3 user reviews,0,3,3
656240,True,5,Mixed,617,635,1252
656260,True,0,5 user reviews,4,1,5
656280,True,0,No user reviews,0,0,0
656300,True,0,2 user reviews,0,2,2
656320,True,0,1 user reviews,1,0,1
656330,True,0,No user reviews,0,0,0
656340,True,0,3 user reviews,1,2,3
656350,True,8,Very Positive,2229,165,2394
656360,True,0,4 user reviews,2,2,4
656380,True,0,No user reviews,0,0,0
656400,True,6,Mostly Positive,10,4,14
656420,True,0,No user reviews,0,0,0
656440,True,5,Mixed,5,5,10
656450,True,5,Mixed,9,6,15
656460,True,5,Mixed,30,20,50
656480,True,0,6 user reviews,4,2,6
656490,True,5,Mixed,14,9,23
656510,True,5,Mixed,26,22,48
656530,True,2,Very Negative,11,82,93
656540,True,0,No user reviews,0,0,0
656550,True,7,Positive,24,2,26
656560,True,5,Mixed,8,6,14
656570,True,6,Mostly Positive,9,3,12
656580,True,0,2 user reviews,1,1,2
656590,True,5,Mixed,27,13,40
656600,True,5,Mixed,78,37,115
656610,True,4,Mostly Negative,11,31,42
656620,True,0,No user reviews,0,0,0
656630,True,0,5 user reviews,4,1,5
656640,True,0,No user reviews,0,0,0
656660,True,0,4 user reviews,4,0,4
656670,True,0,No user reviews,0,0,0
656680,True,0,3 user reviews,2,1,3
656690,True,0,4 user reviews,3,1,4
656700,True,5,Mixed,122,56,178
656730,True,0,2 user reviews,0,2,2
656740,True,7,Positive,34,4,38
656760,True,0,No user reviews,0,0,0
656770,True,0,No user reviews,0,0,0
656780,True,0,2 user reviews,0,2,2
656810,True,0,5 user reviews,4,1,5
656820,True,0,No user reviews,0,0,0
656830,True,0,No user reviews,0,0,0
656840,True,0,No user reviews,0,0,0
656870,True,0,1 user reviews,0,1,1
656880,True,7,Positive,22,5,27
656890,True,0,1 user reviews,1,0,1
656900,True,7,Positive,20,3,23
656910,True,0,2 user reviews,1,1,2
656940,True,0,1 user reviews,0,1,1
656970,True,8,Very Positive,70,7,77
656990,True,0,No user reviews,0,0,0
657000,True,7,Positive,41,2,43
657010,True,0,No user reviews,0,0,0
657020,True,0,2 user reviews,2,0,2
657040,True,7,Positive,32,4,36
657050,True,0,No user reviews,0,0,0
657070,True,5,Mixed,13,8,21
657080,True,0,No user reviews,0,0,0
657090,True,5,Mixed,54,31,85
657110,True,0,2 user reviews,1,1,2
657120,True,7,Positive,22,5,27
657130,True,0,No user reviews,0,0,0
657140,True,0,No user reviews,0,0,0
657150,True,0,No user reviews,0,0,0
657160,True,0,No user reviews,0,0,0
657170,True,0,1 user reviews,1,0,1
657180,True,0,2 user reviews,2,0,2
657190,True,0,No user reviews,0,0,0
657200,True,8,Very Positive,5366,1118,6484
657210,True,0,No user reviews,0,0,0
657230,True,0,2 user reviews,1,1,2
657240,True,8,Very Positive,422,31,453
657250,True,0,No user reviews,0,0,0
657260,True,7,Positive,12,0,12
657270,True,0,No user reviews,0,0,0
657280,True,8,Very Positive,71,13,84
657290,True,7,Positive,25,6,31
657300,True,7,Positive,10,0,10
657320,True,0,1 user reviews,1,0,1
657350,True,7,Positive,12,0,12
657360,True,0,No user reviews,0,0,0
657361,True,0,No user reviews,0,0,0
657400,True,0,1 user reviews,1,0,1
657410,True,0,No user reviews,0,0,0
657420,True,0,No user reviews,0,0,0
657421,True,0,No user reviews,0,0,0
657422,True,0,6 user reviews,4,2,6
657423,True,0,4 user reviews,4,0,4
657424,True,0,8 user reviews,7,1,8
657430,True,7,Positive,12,1,13
657431,True,0,5 user reviews,5,0,5
657440,True,6,Mostly Positive,15,4,19
657450,True,0,No user reviews,0,0,0
657470,True,4,Mostly Negative,10,19,29
657480,True,0,No user reviews,0,0,0
657500,True,0,7 user reviews,4,3,7
657510,True,7,Positive,23,1,24
657530,True,5,Mixed,7,10,17
657550,True,0,5 user reviews,4,1,5
657560,True,0,2 user reviews,1,1,2
657580,True,0,No user reviews,0,0,0
657590,True,5,Mixed,8,10,18
657610,True,0,8 user reviews,8,0,8
657611,True,0,No user reviews,0,0,0
657612,True,0,2 user reviews,2,0,2
657613,True,0,No user reviews,0,0,0
657614,True,0,No user reviews,0,0,0
657615,True,0,No user reviews,0,0,0
657616,True,0,No user reviews,0,0,0
657617,True,0,No user reviews,0,0,0
657618,True,0,No user reviews,0,0,0
657619,True,0,1 user reviews,1,0,1
657620,True,0,No user reviews,0,0,0
657621,True,0,1 user reviews,1,0,1
657630,True,8,Very Positive,205,30,235
657660,True,0,No user reviews,0,0,0
657690,True,8,Very Positive,180,8,188
657700,True,5,Mixed,9,4,13
657730,True,7,Positive,42,6,48
657750,True,0,No user reviews,0,0,0
657751,True,0,No user reviews,0,0,0
657752,True,0,No user reviews,0,0,0
657753,True,0,No user reviews,0,0,0
657754,True,0,No user reviews,0,0,0
657755,True,0,No user reviews,0,0,0
657756,True,0,No user reviews,0,0,0
657757,True,0,No user reviews,0,0,0
657758,True,0,No user reviews,0,0,0
657759,True,0,No user reviews,0,0,0
657760,True,0,No user reviews,0,0,0
657761,True,0,No user reviews,0,0,0
657780,True,0,4 user reviews,2,2,4
657790,True,0,8 user reviews,3,5,8
657810,True,5,Mixed,15,7,22
657840,True,0,No user reviews,0,0,0
657841,True,0,No user reviews,0,0,0
657842,True,0,No user reviews,0,0,0
657843,True,0,No user reviews,0,0,0
657844,True,0,No user reviews,0,0,0
657845,True,0,No user reviews,0,0,0
657846,True,0,No user reviews,0,0,0
657847,True,0,No user reviews,0,0,0
657848,True,0,No user reviews,0,0,0
657849,True,0,No user reviews,0,0,0
657850,True,0,No user reviews,0,0,0
657851,True,0,No user reviews,0,0,0
657852,True,0,No user reviews,0,0,0
657860,True,0,No user reviews,0,0,0
657900,True,7,Positive,30,7,37
657910,True,0,No user reviews,0,0,0
657911,True,0,No user reviews,0,0,0
657912,True,0,No user reviews,0,0,0
657913,True,0,No user reviews,0,0,0
657914,True,0,No user reviews,0,0,0
657915,True,0,No user reviews,0,0,0
657916,True,0,No user reviews,0,0,0
657917,True,0,No user reviews,0,0,0
657918,True,0,No user reviews,0,0,0
657919,True,0,No user reviews,0,0,0
657920,True,0,No user reviews,0,0,0
657921,True,0,No user reviews,0,0,0
657930,True,7,Positive,25,1,26
657960,True,0,No user reviews,0,0,0
657970,True,0,No user reviews,0,0,0
657971,True,0,No user reviews,0,0,0
657972,True,0,No user reviews,0,0,0
657973,True,0,No user reviews,0,0,0
657974,True,0,No user reviews,0,0,0
657975,True,0,No user reviews,0,0,0
657976,True,0,No user reviews,0,0,0
657977,True,0,No user reviews,0,0,0
657978,True,0,No user reviews,0,0,0
657979,True,0,No user reviews,0,0,0
657980,True,0,No user reviews,0,0,0
657981,True,0,No user reviews,0,0,0
657982,True,0,No user reviews,0,0,0
657990,True,5,Mixed,36,37,73
658000,True,6,Mostly Positive,9,3,12
658001,True,0,8 user reviews,3,5,8
658010,True,0,No user reviews,0,0,0
658011,True,0,No user reviews,0,0,0
658012,True,0,No user reviews,0,0,0
658013,True,0,No user reviews,0,0,0
658014,True,0,No user reviews,0,0,0
658015,True,0,No user reviews,0,0,0
658016,True,0,No user reviews,0,0,0
658017,True,0,No user reviews,0,0,0
658018,True,0,No user reviews,0,0,0
658019,True,0,No user reviews,0,0,0
658020,True,0,No user reviews,0,0,0
658021,True,0,No user reviews,0,0,0
658022,True,0,No user reviews,0,0,0
658030,True,0,No user reviews,0,0,0
658031,True,0,No user reviews,0,0,0
658032,True,0,No user reviews,0,0,0
658033,True,0,No user reviews,0,0,0
658034,True,0,No user reviews,0,0,0
658035,True,0,No user reviews,0,0,0
658036,True,0,No user reviews,0,0,0
658037,True,0,No user reviews,0,0,0
658038,True,0,No user reviews,0,0,0
658039,True,0,No user reviews,0,0,0
658040,True,0,No user reviews,0,0,0
658041,True,0,No user reviews,0,0,0
658050,True,7,Positive,25,1,26
658060,True,5,Mixed,12,6,18
658090,True,0,3 user reviews,1,2,3
658110,True,0,No user reviews,0,0,0
658111,True,0,No user reviews,0,0,0
658112,True,0,No user reviews,0,0,0
658113,True,0,No user reviews,0,0,0
658114,True,0,No user reviews,0,0,0
658115,True,0,No user reviews,0,0,0
658116,True,0,No user reviews,0,0,0
658120,True,5,Mixed,7,8,15
658130,True,0,No user reviews,0,0,0
658131,True,0,No user reviews,0,0,0
658132,True,0,No user reviews,0,0,0
658133,True,0,No user reviews,0,0,0
658134,True,0,No user reviews,0,0,0
658135,True,0,No user reviews,0,0,0
658136,True,0,No user reviews,0,0,0
658137,True,0,No user reviews,0,0,0
658140,True,7,Positive,11,2,13
658150,True,7,Positive,42,1,43
658160,True,8,Very Positive,140,28,168
658210,True,0,3 user reviews,3,0,3
658230,True,7,Positive,9,1,10
658250,True,0,No user reviews,0,0,0
658260,True,8,Very Positive,169,35,204
658270,True,0,No user reviews,0,0,0
658271,True,0,No user reviews,0,0,0
658272,True,0,No user reviews,0,0,0
658273,True,0,No user reviews,0,0,0
658274,True,0,No user reviews,0,0,0
658275,True,0,No user reviews,0,0,0
658276,True,0,No user reviews,0,0,0
658277,True,0,1 user reviews,1,0,1
658278,True,0,No user reviews,0,0,0
658279,True,0,No user reviews,0,0,0
658280,True,0,No user reviews,0,0,0
658290,True,0,No user reviews,0,0,0
658291,True,0,No user reviews,0,0,0
658292,True,0,No user reviews,0,0,0
658293,True,0,No user reviews,0,0,0
658294,True,0,No user reviews,0,0,0
658295,True,0,No user reviews,0,0,0
658296,True,0,No user reviews,0,0,0
658297,True,0,No user reviews,0,0,0
658298,True,0,No user reviews,0,0,0
658299,True,0,No user reviews,0,0,0
658300,True,0,No user reviews,0,0,0
658301,True,0,No user reviews,0,0,0
658302,True,0,No user reviews,0,0,0
658303,True,0,No user reviews,0,0,0
658304,True,0,No user reviews,0,0,0
658305,True,0,No user reviews,0,0,0
658306,True,0,No user reviews,0,0,0
658320,True,0,No user reviews,0,0,0
658330,True,7,Positive,10,1,11
658340,True,0,No user reviews,0,0,0
658360,True,0,No user reviews,0,0,0
658390,True,0,1 user reviews,0,1,1
658400,True,0,6 user reviews,6,0,6
658410,True,0,No user reviews,0,0,0
658420,True,0,3 user reviews,2,1,3
658430,True,5,Mixed,6,7,13
658440,True,0,No user reviews,0,0,0
658450,True,0,4 user reviews,2,2,4
658460,True,0,No user reviews,0,0,0
658470,True,6,Mostly Positive,38,16,54
658480,True,0,No user reviews,0,0,0
658490,True,5,Mixed,28,13,41
658500,True,7,Positive,24,1,25
658510,True,0,No user reviews,0,0,0
658530,True,7,Positive,18,0,18
658550,True,8,Very Positive,116,11,127
658560,True,8,Very Positive,299,18,317
658570,True,6,Mostly Positive,354,109,463
658590,True,8,Very Positive,46,9,55
658600,True,8,Very Positive,112,14,126
658610,True,0,1 user reviews,0,1,1
658620,True,8,Very Positive,237,11,248
658630,True,0,5 user reviews,4,1,5
658640,True,0,No user reviews,0,0,0
658650,True,0,No user reviews,0,0,0
658660,True,6,Mostly Positive,8,3,11
658670,True,0,1 user reviews,0,1,1
658690,True,7,Positive,29,1,30
658700,True,5,Mixed,39,17,56
658710,True,0,No user reviews,0,0,0
658720,True,0,1 user reviews,1,0,1
658760,True,0,2 user reviews,2,0,2
658770,True,0,4 user reviews,3,1,4
658780,True,8,Very Positive,54,10,64
658790,True,0,9 user reviews,6,3,9
658800,True,0,9 user reviews,8,1,9
658810,True,0,5 user reviews,5,0,5
658820,True,0,No user reviews,0,0,0
658830,True,5,Mixed,18,11,29
658850,True,8,Very Positive,718,82,800
658860,True,0,No user reviews,0,0,0
658870,True,0,1 user reviews,1,0,1
658880,True,0,No user reviews,0,0,0
658900,True,0,2 user reviews,2,0,2
658910,True,0,5 user reviews,4,1,5
658960,True,0,No user reviews,0,0,0
658961,True,0,No user reviews,0,0,0
658962,True,0,No user reviews,0,0,0
658963,True,0,No user reviews,0,0,0
658964,True,0,No user reviews,0,0,0
658965,True,0,No user reviews,0,0,0
658966,True,0,No user reviews,0,0,0
658967,True,0,No user reviews,0,0,0
658968,True,0,No user reviews,0,0,0
658969,True,0,No user reviews,0,0,0
658970,True,0,No user reviews,0,0,0
658980,True,5,Mixed,166,148,314
658990,True,0,8 user reviews,8,0,8
659000,True,0,No user reviews,0,0,0
659040,True,0,9 user reviews,8,1,9
659060,True,0,2 user reviews,2,0,2
659110,True,6,Mostly Positive,24,7,31
659120,True,4,Mostly Negative,9,19,28
659130,True,5,Mixed,10,8,18
659140,True,0,No user reviews,0,0,0
659150,True,0,No user reviews,0,0,0
659160,True,0,2 user reviews,0,2,2
659170,True,0,1 user reviews,1,0,1
659180,True,0,4 user reviews,4,0,4
659190,True,5,Mixed,77,34,111
659220,True,0,4 user reviews,4,0,4
659230,True,0,No user reviews,0,0,0
659260,True,0,7 user reviews,7,0,7
659290,True,5,Mixed,7,6,13
659310,True,0,No user reviews,0,0,0
659320,True,0,No user reviews,0,0,0
659330,True,0,No user reviews,0,0,0
659360,True,0,No user reviews,0,0,0
659390,True,0,1 user reviews,1,0,1
659391,True,0,No user reviews,0,0,0
659392,True,0,No user reviews,0,0,0
659393,True,0,No user reviews,0,0,0
659394,True,0,No user reviews,0,0,0
659395,True,0,No user reviews,0,0,0
659396,True,0,No user reviews,0,0,0
659397,True,0,No user reviews,0,0,0
659398,True,0,No user reviews,0,0,0
659399,True,0,No user reviews,0,0,0
659400,True,0,No user reviews,0,0,0
659401,True,0,No user reviews,0,0,0
659420,True,0,No user reviews,0,0,0
659421,True,0,No user reviews,0,0,0
659422,True,0,No user reviews,0,0,0
659423,True,0,No user reviews,0,0,0
659424,True,0,No user reviews,0,0,0
659425,True,0,No user reviews,0,0,0
659426,True,0,No user reviews,0,0,0
659427,True,0,No user reviews,0,0,0
659428,True,0,No user reviews,0,0,0
659429,True,0,No user reviews,0,0,0
659430,True,0,No user reviews,0,0,0
659431,True,0,No user reviews,0,0,0
659432,True,0,No user reviews,0,0,0
659460,True,0,1 user reviews,1,0,1
659480,True,6,Mostly Positive,74,26,100
659490,True,0,7 user reviews,5,2,7
659500,True,0,No user reviews,0,0,0
659510,True,0,1 user reviews,1,0,1
659540,True,8,Very Positive,362,12,374
659560,True,0,1 user reviews,1,0,1
659570,True,0,1 user reviews,1,0,1
659580,True,0,No user reviews,0,0,0
659590,True,0,No user reviews,0,0,0
659600,True,0,No user reviews,0,0,0
659610,True,0,2 user reviews,0,2,2
659620,True,0,No user reviews,0,0,0
659630,True,0,No user reviews,0,0,0
659640,True,0,No user reviews,0,0,0
659650,True,0,1 user reviews,1,0,1
659660,True,0,No user reviews,0,0,0
659670,True,0,No user reviews,0,0,0
659680,True,0,1 user reviews,1,0,1
659690,True,0,No user reviews,0,0,0
659710,True,0,5 user reviews,5,0,5
659720,True,0,3 user reviews,3,0,3
659760,True,0,No user reviews,0,0,0
659780,True,0,No user reviews,0,0,0
659790,True,0,No user reviews,0,0,0
659800,True,0,No user reviews,0,0,0
659810,True,0,3 user reviews,1,2,3
659830,True,0,3 user reviews,3,0,3
659860,True,0,1 user reviews,1,0,1
659870,True,0,3 user reviews,2,1,3
659890,True,0,6 user reviews,6,0,6
659900,True,0,No user reviews,0,0,0
659910,True,0,1 user reviews,1,0,1
659920,True,5,Mixed,27,14,41
659930,True,7,Positive,9,2,11
659940,True,0,5 user reviews,4,1,5
659950,True,0,6 user reviews,4,2,6
659970,True,0,4 user reviews,4,0,4
659971,True,0,No user reviews,0,0,0
659990,True,0,1 user reviews,0,1,1
660000,True,0,No user reviews,0,0,0
660010,True,0,No user reviews,0,0,0
660030,True,0,4 user reviews,4,0,4
660040,True,0,4 user reviews,4,0,4
660050,True,0,No user reviews,0,0,0
660060,True,0,1 user reviews,1,0,1
660070,True,0,1 user reviews,1,0,1
660080,True,6,Mostly Positive,42,16,58
660090,True,0,No user reviews,0,0,0
660110,True,0,No user reviews,0,0,0
660120,True,0,6 user reviews,0,6,6
660130,True,0,No user reviews,0,0,0
660160,True,8,Very Positive,272,34,306
660170,True,0,2 user reviews,0,2,2
660180,True,4,Mostly Negative,8,25,33
660190,True,0,No user reviews,0,0,0
660220,True,0,No user reviews,0,0,0
660240,True,0,No user reviews,0,0,0
660250,True,0,1 user reviews,0,1,1
660270,True,0,3 user reviews,2,1,3
660280,True,0,1 user reviews,0,1,1
660290,True,0,9 user reviews,5,4,9
660320,True,0,8 user reviews,4,4,8
660330,True,0,No user reviews,0,0,0
660340,True,0,No user reviews,0,0,0
660360,True,0,No user reviews,0,0,0
660361,True,0,No user reviews,0,0,0
660362,True,0,No user reviews,0,0,0
660363,True,0,No user reviews,0,0,0
660364,True,0,No user reviews,0,0,0
660365,True,0,No user reviews,0,0,0
660366,True,0,No user reviews,0,0,0
660367,True,0,No user reviews,0,0,0
660368,True,0,No user reviews,0,0,0
660369,True,0,No user reviews,0,0,0
660370,True,0,No user reviews,0,0,0
660371,True,0,No user reviews,0,0,0
660390,True,0,No user reviews,0,0,0
660400,True,0,No user reviews,0,0,0
660420,True,0,No user reviews,0,0,0
660430,True,0,No user reviews,0,0,0
660431,True,0,No user reviews,0,0,0
660432,True,0,No user reviews,0,0,0
660433,True,0,No user reviews,0,0,0
660434,True,0,No user reviews,0,0,0
660435,True,0,No user reviews,0,0,0
660436,True,0,No user reviews,0,0,0
660437,True,0,No user reviews,0,0,0
660438,True,0,No user reviews,0,0,0
660439,True,0,No user reviews,0,0,0
660440,True,0,No user reviews,0,0,0
660441,True,0,No user reviews,0,0,0
660442,True,0,No user reviews,0,0,0
660450,True,0,No user reviews,0,0,0
660470,True,0,No user reviews,0,0,0
660490,True,0,No user reviews,0,0,0
660491,True,0,No user reviews,0,0,0
660492,True,0,No user reviews,0,0,0
660493,True,0,No user reviews,0,0,0
660494,True,0,No user reviews,0,0,0
660495,True,0,No user reviews,0,0,0
660496,True,0,No user reviews,0,0,0
660497,True,0,No user reviews,0,0,0
660498,True,0,No user reviews,0,0,0
660499,True,0,No user reviews,0,0,0
660500,True,0,No user reviews,0,0,0
660501,True,0,No user reviews,0,0,0
660502,True,0,No user reviews,0,0,0
660520,True,0,No user reviews,0,0,0
660540,True,0,No user reviews,0,0,0
660541,True,0,No user reviews,0,0,0
660542,True,0,No user reviews,0,0,0
660543,True,0,No user reviews,0,0,0
660544,True,0,No user reviews,0,0,0
660545,True,0,No user reviews,0,0,0
660546,True,0,No user reviews,0,0,0
660547,True,0,No user reviews,0,0,0
660548,True,0,No user reviews,0,0,0
660549,True,0,No user reviews,0,0,0
660550,True,0,No user reviews,0,0,0
660551,True,0,No user reviews,0,0,0
660552,True,0,No user reviews,0,0,0
660560,True,0,5 user reviews,3,2,5
660570,True,5,Mixed,8,4,12
660580,True,0,No user reviews,0,0,0
660581,True,0,No user reviews,0,0,0
660582,True,0,No user reviews,0,0,0
660583,True,0,No user reviews,0,0,0
660584,True,0,No user reviews,0,0,0
660585,True,0,No user reviews,0,0,0
660586,True,0,No user reviews,0,0,0
660587,True,0,No user reviews,0,0,0
660588,True,0,No user reviews,0,0,0
660589,True,0,No user reviews,0,0,0
660590,True,0,No user reviews,0,0,0
660591,True,0,No user reviews,0,0,0
660670,True,0,No user reviews,0,0,0
660671,True,0,No user reviews,0,0,0
660672,True,0,No user reviews,0,0,0
660673,True,0,No user reviews,0,0,0
660674,True,0,No user reviews,0,0,0
660675,True,0,No user reviews,0,0,0
660676,True,0,No user reviews,0,0,0
660677,True,0,No user reviews,0,0,0
660678,True,0,No user reviews,0,0,0
660679,True,0,No user reviews,0,0,0
660680,True,0,No user reviews,0,0,0
660681,True,0,No user reviews,0,0,0
660682,True,0,No user reviews,0,0,0
660683,True,0,No user reviews,0,0,0
660684,True,0,No user reviews,0,0,0
660685,True,0,No user reviews,0,0,0
660686,True,0,No user reviews,0,0,0
660687,True,0,No user reviews,0,0,0
660688,True,0,No user reviews,0,0,0
660689,True,0,No user reviews,0,0,0
660690,True,0,No user reviews,0,0,0
660691,True,0,No user reviews,0,0,0
660692,True,0,No user reviews,0,0,0
660693,True,0,No user reviews,0,0,0
660694,True,0,No user reviews,0,0,0
660695,True,0,No user reviews,0,0,0
660696,True,0,No user reviews,0,0,0
660697,True,0,No user reviews,0,0,0
660698,True,0,No user reviews,0,0,0
660699,True,0,No user reviews,0,0,0
660700,True,0,No user reviews,0,0,0
660701,True,0,No user reviews,0,0,0
660730,True,0,8 user reviews,5,3,8
660740,True,0,No user reviews,0,0,0
660760,True,0,1 user reviews,1,0,1
660770,True,0,No user reviews,0,0,0
660800,True,0,No user reviews,0,0,0
660820,True,0,1 user reviews,0,1,1
660830,True,0,No user reviews,0,0,0
660850,True,7,Positive,15,2,17
660860,True,0,No user reviews,0,0,0
660870,True,0,No user reviews,0,0,0
660880,True,0,No user reviews,0,0,0
660900,True,0,2 user reviews,0,2,2
660910,True,0,No user reviews,0,0,0
660920,True,5,Mixed,68,49,117
660930,True,0,2 user reviews,2,0,2
660940,True,0,1 user reviews,0,1,1
660970,True,0,No user reviews,0,0,0
660980,True,0,No user reviews,0,0,0
660990,True,4,Mostly Negative,5,15,20
661000,True,5,Mixed,15,12,27
661030,True,7,Positive,11,0,11
661040,True,5,Mixed,27,17,44
661050,True,0,2 user reviews,2,0,2
661070,True,0,1 user reviews,1,0,1
661100,True,0,1 user reviews,1,0,1
661110,True,0,2 user reviews,1,1,2
661120,True,7,Positive,26,0,26
661130,True,0,No user reviews,0,0,0
661140,True,0,3 user reviews,2,1,3
661141,True,0,No user reviews,0,0,0
661142,True,0,No user reviews,0,0,0
661180,True,0,1 user reviews,0,1,1
661190,True,0,1 user reviews,0,1,1
661200,True,0,6 user reviews,6,0,6
661220,True,0,9 user reviews,9,0,9
661230,True,7,Positive,23,2,25
661240,True,0,4 user reviews,4,0,4
661250,True,0,No user reviews,0,0,0
661260,True,0,No user reviews,0,0,0
661270,True,0,2 user reviews,2,0,2
661280,True,6,Mostly Positive,51,14,65
661290,True,6,Mostly Positive,83,30,113
661300,True,0,7 user reviews,6,1,7
661310,True,0,No user reviews,0,0,0
661311,True,0,No user reviews,0,0,0
661312,True,0,No user reviews,0,0,0
661313,True,0,1 user reviews,1,0,1
661330,True,0,3 user reviews,3,0,3
661340,True,0,3 user reviews,3,0,3
661360,True,0,5 user reviews,5,0,5
661380,True,0,2 user reviews,2,0,2
661410,True,0,1 user reviews,0,1,1
661420,True,0,No user reviews,0,0,0
661430,True,8,Very Positive,108,10,118
661440,True,0,2 user reviews,1,1,2
661450,True,7,Positive,10,0,10
661460,True,0,4 user reviews,3,1,4
661470,True,5,Mixed,10,5,15
661480,True,0,6 user reviews,5,1,6
661490,True,3,Negative,1,9,10
661500,True,7,Positive,14,2,16
661520,True,0,6 user reviews,1,5,6
661530,True,0,No user reviews,0,0,0
661550,True,0,1 user reviews,1,0,1
661560,True,0,2 user reviews,0,2,2
661610,True,0,1 user reviews,0,1,1
661650,True,0,2 user reviews,1,1,2
661660,True,7,Positive,8,2,10
661670,True,0,6 user reviews,3,3,6
661680,True,0,No user reviews,0,0,0
661690,True,0,No user reviews,0,0,0
661700,True,0,No user reviews,0,0,0
661710,True,0,No user reviews,0,0,0
661730,True,0,1 user reviews,1,0,1
661740,True,6,Mostly Positive,33,13,46
661750,True,0,No user reviews,0,0,0
661770,True,0,No user reviews,0,0,0
661790,True,8,Very Positive,615,75,690
661820,True,0,2 user reviews,2,0,2
661830,True,0,No user reviews,0,0,0
661850,True,0,No user reviews,0,0,0
661870,True,0,No user reviews,0,0,0
661890,True,0,No user reviews,0,0,0
661900,True,0,3 user reviews,2,1,3
661920,True,5,Mixed,67,38,105
661940,True,8,Very Positive,107,9,116
661950,True,0,No user reviews,0,0,0
661960,True,0,No user reviews,0,0,0
661970,True,0,7 user reviews,3,4,7
661980,True,0,No user reviews,0,0,0
661990,True,7,Positive,32,4,36
662140,True,0,No user reviews,0,0,0
662150,True,0,No user reviews,0,0,0
662160,True,0,No user reviews,0,0,0
662190,True,7,Positive,37,2,39
662200,True,0,9 user reviews,6,3,9
662210,True,8,Very Positive,199,6,205
662230,True,5,Mixed,24,11,35
662240,True,6,Mostly Positive,43,12,55
662250,True,0,4 user reviews,0,4,4
662260,True,0,1 user reviews,1,0,1
662290,True,0,8 user reviews,8,0,8
662320,True,5,Mixed,14,7,21
662340,True,0,No user reviews,0,0,0
662350,True,6,Mostly Positive,150,41,191
662352,True,5,Mixed,21,13,34
662353,True,4,Mostly Negative,37,69,106
662355,True,0,No user reviews,0,0,0
662356,True,0,No user reviews,0,0,0
662380,True,0,5 user reviews,1,4,5
662390,True,0,No user reviews,0,0,0
662400,True,0,2 user reviews,2,0,2
662410,True,7,Positive,12,0,12
662420,True,0,No user reviews,0,0,0
662440,True,0,No user reviews,0,0,0
662450,True,0,No user reviews,0,0,0
662470,True,0,No user reviews,0,0,0
662490,True,0,No user reviews,0,0,0
662500,True,0,4 user reviews,1,3,4
662540,True,8,Very Positive,67,11,78
662550,True,0,3 user reviews,3,0,3
662570,True,0,No user reviews,0,0,0
662600,True,0,2 user reviews,1,1,2
662610,True,0,No user reviews,0,0,0
662620,True,0,4 user reviews,3,1,4
662660,True,0,2 user reviews,2,0,2
662680,True,7,Positive,17,3,20
662690,True,0,5 user reviews,4,1,5
662700,True,0,No user reviews,0,0,0
662710,True,0,No user reviews,0,0,0
662740,True,0,1 user reviews,1,0,1
662741,True,0,No user reviews,0,0,0
662742,True,0,No user reviews,0,0,0
662743,True,0,No user reviews,0,0,0
662744,True,0,No user reviews,0,0,0
662745,True,0,No user reviews,0,0,0
662746,True,0,No user reviews,0,0,0
662747,True,0,No user reviews,0,0,0
662748,True,0,No user reviews,0,0,0
662749,True,0,No user reviews,0,0,0
662750,True,0,No user reviews,0,0,0
662751,True,0,No user reviews,0,0,0
662760,True,0,2 user reviews,2,0,2
662761,True,0,No user reviews,0,0,0
662762,True,0,No user reviews,0,0,0
662763,True,0,No user reviews,0,0,0
662764,True,0,No user reviews,0,0,0
662765,True,0,No user reviews,0,0,0
662766,True,0,No user reviews,0,0,0
662767,True,0,No user reviews,0,0,0
662768,True,0,No user reviews,0,0,0
662769,True,0,No user reviews,0,0,0
662770,True,0,No user reviews,0,0,0
662771,True,0,No user reviews,0,0,0
662772,True,0,1 user reviews,1,0,1
662780,True,0,1 user reviews,1,0,1
662810,True,0,No user reviews,0,0,0
662811,True,0,No user reviews,0,0,0
662812,True,0,No user reviews,0,0,0
662813,True,0,No user reviews,0,0,0
662814,True,0,No user reviews,0,0,0
662815,True,0,No user reviews,0,0,0
662816,True,0,No user reviews,0,0,0
662817,True,0,No user reviews,0,0,0
662818,True,0,No user reviews,0,0,0
662819,True,0,No user reviews,0,0,0
662820,True,0,No user reviews,0,0,0
662821,True,0,No user reviews,0,0,0
662822,True,0,No user reviews,0,0,0
662830,True,0,No user reviews,0,0,0
662840,True,6,Mostly Positive,17,6,23
662850,True,0,No user reviews,0,0,0
662860,True,0,2 user reviews,2,0,2
662861,True,0,No user reviews,0,0,0
662862,True,0,No user reviews,0,0,0
662863,True,0,No user reviews,0,0,0
662864,True,0,1 user reviews,0,1,1
662865,True,0,1 user reviews,0,1,1
662866,True,0,No user reviews,0,0,0
662870,True,0,No user reviews,0,0,0
662910,True,6,Mostly Positive,20,8,28
662920,True,7,Positive,20,3,23
662930,True,0,9 user reviews,9,0,9
662940,True,0,No user reviews,0,0,0
662950,True,3,Negative,0,13,13
662960,True,6,Mostly Positive,95,33,128
662970,True,5,Mixed,15,7,22
662990,True,0,1 user reviews,1,0,1
663000,True,0,No user reviews,0,0,0
663020,True,0,2 user reviews,0,2,2
663060,True,0,1 user reviews,0,1,1
663070,True,0,No user reviews,0,0,0
663080,True,0,No user reviews,0,0,0
663090,True,5,Mixed,14,16,30
663100,True,0,9 user reviews,8,1,9
663110,True,4,Mostly Negative,13,20,33
663120,True,0,1 user reviews,1,0,1
663130,True,7,Positive,12,2,14
663140,True,0,1 user reviews,1,0,1
663160,True,0,4 user reviews,1,3,4
663170,True,0,1 user reviews,1,0,1
663180,True,0,No user reviews,0,0,0
663190,True,5,Mixed,17,10,27
663200,True,5,Mixed,17,17,34
663210,True,7,Positive,32,3,35
663220,True,0,No user reviews,0,0,0
663230,True,0,1 user reviews,1,0,1
663240,True,8,Very Positive,61,11,72
663250,True,0,1 user reviews,0,1,1
663270,True,0,No user reviews,0,0,0
663280,True,0,3 user reviews,2,1,3
663290,True,0,7 user reviews,1,6,7
663300,True,5,Mixed,25,20,45
663310,True,0,No user reviews,0,0,0
663360,True,0,No user reviews,0,0,0
663370,True,7,Positive,22,2,24
663380,True,6,Mostly Positive,765,279,1044
663390,True,5,Mixed,110,52,162
663410,True,0,No user reviews,0,0,0
663420,True,0,No user reviews,0,0,0
663430,True,0,2 user reviews,1,1,2
663480,True,0,1 user reviews,1,0,1
663530,True,0,1 user reviews,0,1,1
663540,True,0,5 user reviews,5,0,5
663580,True,0,8 user reviews,5,3,8
663590,True,7,Positive,16,1,17
663600,True,0,No user reviews,0,0,0
663660,True,0,No user reviews,0,0,0
663670,True,8,Very Positive,288,25,313
663690,True,0,No user reviews,0,0,0
663700,True,0,No user reviews,0,0,0
663730,True,0,9 user reviews,6,3,9
663760,True,0,No user reviews,0,0,0
663790,True,0,No user reviews,0,0,0
663810,True,0,No user reviews,0,0,0
663820,True,0,3 user reviews,3,0,3
663830,True,6,Mostly Positive,23,8,31
663840,True,0,No user reviews,0,0,0
663850,True,0,No user reviews,0,0,0
663870,True,0,No user reviews,0,0,0
663890,True,0,No user reviews,0,0,0
663900,True,0,No user reviews,0,0,0
663910,True,0,No user reviews,0,0,0
663920,True,0,2 user reviews,2,0,2
663940,True,0,No user reviews,0,0,0
663970,True,0,No user reviews,0,0,0
664000,True,8,Very Positive,86,18,104
664030,True,0,No user reviews,0,0,0
664040,True,0,4 user reviews,4,0,4
664050,True,0,No user reviews,0,0,0
664060,True,0,6 user reviews,5,1,6
664070,True,0,No user reviews,0,0,0
664080,True,0,1 user reviews,0,1,1
664090,True,8,Very Positive,112,28,140
664110,True,0,1 user reviews,1,0,1
664120,True,0,7 user reviews,1,6,7
664140,True,0,4 user reviews,4,0,4
664160,True,0,3 user reviews,3,0,3
664180,True,8,Very Positive,52,2,54
664190,True,0,3 user reviews,3,0,3
664210,True,0,1 user reviews,1,0,1
664240,True,0,8 user reviews,8,0,8
664250,True,0,7 user reviews,4,3,7
664260,True,0,No user reviews,0,0,0
664270,True,0,No user reviews,0,0,0
664280,True,0,No user reviews,0,0,0
664290,True,5,Mixed,14,13,27
664320,True,5,Mixed,22,20,42
664330,True,0,1 user reviews,1,0,1
664340,True,0,2 user reviews,0,2,2
664350,True,5,Mixed,6,9,15
664360,True,0,1 user reviews,1,0,1
664390,True,0,No user reviews,0,0,0
664400,True,0,No user reviews,0,0,0
664420,True,0,1 user reviews,1,0,1
664430,True,5,Mixed,376,417,793
664440,True,0,No user reviews,0,0,0
664450,True,7,Positive,32,5,37
664460,True,0,No user reviews,0,0,0
664490,True,0,No user reviews,0,0,0
664510,True,0,8 user reviews,6,2,8
664530,True,6,Mostly Positive,13,4,17
664540,True,0,No user reviews,0,0,0
664560,True,0,3 user reviews,2,1,3
664570,True,0,No user reviews,0,0,0
664580,True,0,No user reviews,0,0,0
664590,True,0,1 user reviews,1,0,1
664600,True,0,1 user reviews,0,1,1
664610,True,7,Positive,8,2,10
664620,True,5,Mixed,9,7,16
664630,True,0,2 user reviews,1,1,2
664640,True,0,No user reviews,0,0,0
664650,True,5,Mixed,12,9,21
664660,True,0,1 user reviews,1,0,1
664670,True,0,No user reviews,0,0,0
664680,True,0,No user reviews,0,0,0
664690,True,0,No user reviews,0,0,0
664710,True,0,1 user reviews,1,0,1
664720,True,0,2 user reviews,0,2,2
664730,True,0,No user reviews,0,0,0
664750,True,8,Very Positive,215,13,228
664760,True,0,No user reviews,0,0,0
664780,True,5,Mixed,20,10,30
664800,True,0,No user reviews,0,0,0
664820,True,0,6 user reviews,6,0,6
664830,True,8,Very Positive,298,39,337
664840,True,0,No user reviews,0,0,0
664850,True,7,Positive,20,0,20
664870,True,0,2 user reviews,1,1,2
664880,True,0,No user reviews,0,0,0
664890,True,0,4 user reviews,2,2,4
664910,True,0,No user reviews,0,0,0
664920,True,0,No user reviews,0,0,0
664930,True,0,No user reviews,0,0,0
664950,True,7,Positive,17,3,20
664970,True,0,No user reviews,0,0,0
664980,True,0,No user reviews,0,0,0
664990,True,0,No user reviews,0,0,0
665000,True,0,No user reviews,0,0,0
665010,True,0,No user reviews,0,0,0
665030,True,6,Mostly Positive,28,10,38
665040,True,0,1 user reviews,1,0,1
665050,True,0,No user reviews,0,0,0
665060,True,0,1 user reviews,0,1,1
665070,True,0,1 user reviews,1,0,1
665080,True,0,9 user reviews,6,3,9
665090,True,5,Mixed,111,53,164
665100,True,7,Positive,15,1,16
665110,True,0,No user reviews,0,0,0
665120,True,6,Mostly Positive,28,8,36
665140,True,5,Mixed,5,7,12
665160,True,0,No user reviews,0,0,0
665170,True,0,No user reviews,0,0,0
665180,True,6,Mostly Positive,331,117,448
665200,True,0,No user reviews,0,0,0
665210,True,0,3 user reviews,3,0,3
665220,True,0,No user reviews,0,0,0
665240,True,0,4 user reviews,2,2,4
665270,True,7,Positive,20,1,21
665300,True,8,Very Positive,225,11,236
665310,True,0,6 user reviews,6,0,6
665330,True,8,Very Positive,178,29,207
665340,True,0,6 user reviews,4,2,6
665350,True,0,5 user reviews,5,0,5
665360,True,6,Mostly Positive,2943,902,3845
665370,True,8,Very Positive,307,13,320
665380,True,7,Positive,20,1,21
665410,True,0,No user reviews,0,0,0
665440,True,0,7 user reviews,5,2,7
665450,True,0,4 user reviews,2,2,4
665460,True,0,3 user reviews,3,0,3
665490,True,0,No user reviews,0,0,0
665500,True,0,4 user reviews,4,0,4
665510,True,0,5 user reviews,3,2,5
665520,True,0,No user reviews,0,0,0
665530,True,0,No user reviews,0,0,0
665550,True,0,No user reviews,0,0,0
665590,True,5,Mixed,9,4,13
665620,True,0,6 user reviews,4,2,6
665630,True,0,1 user reviews,1,0,1
665640,True,0,4 user reviews,3,1,4
665650,True,0,5 user reviews,5,0,5
665670,True,0,5 user reviews,3,2,5
665680,True,0,6 user reviews,1,5,6
665710,True,0,No user reviews,0,0,0
665730,True,0,6 user reviews,3,3,6
665740,True,0,No user reviews,0,0,0
665760,True,0,No user reviews,0,0,0
665770,True,0,No user reviews,0,0,0
665780,True,0,1 user reviews,1,0,1
665790,True,0,1 user reviews,1,0,1
665800,True,0,No user reviews,0,0,0
665810,True,0,No user reviews,0,0,0
665820,True,0,No user reviews,0,0,0
665830,True,0,8 user reviews,6,2,8
665840,True,0,No user reviews,0,0,0
665880,True,0,4 user reviews,2,2,4
665890,True,0,No user reviews,0,0,0
665900,True,0,No user reviews,0,0,0
665920,True,0,6 user reviews,5,1,6
665930,True,0,6 user reviews,4,2,6
665950,True,0,2 user reviews,1,1,2
665960,True,5,Mixed,9,13,22
665970,True,0,No user reviews,0,0,0
665980,True,0,No user reviews,0,0,0
665990,True,0,No user reviews,0,0,0
666010,True,0,7 user reviews,5,2,7
666020,True,8,Very Positive,491,49,540
666030,True,0,1 user reviews,0,1,1
666040,True,0,4 user reviews,1,3,4
666050,True,0,3 user reviews,3,0,3
666060,True,0,1 user reviews,0,1,1
666080,True,0,1 user reviews,0,1,1
666090,True,0,3 user reviews,2,1,3
666100,True,8,Very Positive,70,6,76
666110,True,0,1 user reviews,0,1,1
666120,True,0,4 user reviews,0,4,4
666140,True,8,Very Positive,6893,447,7340
666150,True,0,No user reviews,0,0,0
666180,True,0,No user reviews,0,0,0
666200,True,0,No user reviews,0,0,0
666220,True,0,No user reviews,0,0,0
666230,True,7,Positive,24,1,25
666231,True,0,5 user reviews,4,1,5
666232,True,0,5 user reviews,5,0,5
666233,True,0,7 user reviews,6,1,7
666234,True,0,No user reviews,0,0,0
666235,True,0,No user reviews,0,0,0
666236,True,0,No user reviews,0,0,0
666237,True,0,No user reviews,0,0,0
666240,True,0,No user reviews,0,0,0
666250,True,0,7 user reviews,1,6,7
666260,True,0,7 user reviews,3,4,7
666270,True,0,No user reviews,0,0,0
666290,True,0,2 user reviews,0,2,2
666300,True,0,No user reviews,0,0,0
666310,True,0,2 user reviews,0,2,2
666320,True,0,2 user reviews,2,0,2
666330,True,8,Very Positive,150,33,183
666340,True,7,Positive,15,2,17
666350,True,7,Positive,31,3,34
666370,True,0,1 user reviews,1,0,1
666390,True,0,No user reviews,0,0,0
666400,True,0,No user reviews,0,0,0
666410,True,0,No user reviews,0,0,0
666420,True,0,No user reviews,0,0,0
666430,True,0,No user reviews,0,0,0
666440,True,0,No user reviews,0,0,0
666450,True,0,No user reviews,0,0,0
666460,True,0,No user reviews,0,0,0
666470,True,0,No user reviews,0,0,0
666480,True,0,No user reviews,0,0,0
666490,True,0,No user reviews,0,0,0
666500,True,0,No user reviews,0,0,0
666510,True,0,No user reviews,0,0,0
666520,True,0,No user reviews,0,0,0
666530,True,0,No user reviews,0,0,0
666540,True,0,No user reviews,0,0,0
666560,True,0,8 user reviews,4,4,8
666570,True,6,Mostly Positive,203,67,270
666590,True,0,3 user reviews,3,0,3
666600,True,0,7 user reviews,4,3,7
666610,True,8,Very Positive,84,1,85
666620,True,3,Negative,2,10,12
666630,True,7,Positive,11,0,11
666640,True,0,3 user reviews,1,2,3
666650,True,0,No user reviews,0,0,0
666651,True,0,No user reviews,0,0,0
666652,True,0,No user reviews,0,0,0
666653,True,0,No user reviews,0,0,0
666654,True,0,No user reviews,0,0,0
666655,True,0,No user reviews,0,0,0
666656,True,0,No user reviews,0,0,0
666657,True,0,No user reviews,0,0,0
666658,True,0,No user reviews,0,0,0
666659,True,0,No user reviews,0,0,0
666660,True,0,7 user reviews,3,4,7
666670,True,0,7 user reviews,7,0,7
666730,True,6,Mostly Positive,68,19,87
666780,True,0,No user reviews,0,0,0
666790,True,0,1 user reviews,1,0,1
666800,True,5,Mixed,6,7,13
666810,True,0,1 user reviews,1,0,1
666820,True,8,Very Positive,124,14,138
666830,True,0,No user reviews,0,0,0
666840,True,0,No user reviews,0,0,0
666850,True,0,3 user reviews,2,1,3
666860,True,0,No user reviews,0,0,0
666870,True,0,5 user reviews,0,5,5
666910,True,0,3 user reviews,3,0,3
666930,True,0,3 user reviews,1,2,3
666940,True,5,Mixed,11,7,18
666960,True,5,Mixed,7,5,12
666970,True,0,No user reviews,0,0,0
667000,True,0,1 user reviews,0,1,1
667010,True,7,Positive,14,2,16
667030,True,0,6 user reviews,3,3,6
667040,True,7,Positive,9,2,11
667050,True,0,7 user reviews,3,4,7
667060,True,0,1 user reviews,1,0,1
667090,True,0,2 user reviews,2,0,2
667110,True,0,No user reviews,0,0,0
667120,True,0,No user reviews,0,0,0
667130,True,6,Mostly Positive,14,4,18
667160,True,0,No user reviews,0,0,0
667170,True,0,7 user reviews,1,6,7
667200,True,0,No user reviews,0,0,0
667220,True,0,7 user reviews,4,3,7
667230,True,0,No user reviews,0,0,0
667240,True,0,3 user reviews,3,0,3
667250,True,0,1 user reviews,1,0,1
667270,True,0,No user reviews,0,0,0
667280,True,0,No user reviews,0,0,0
667290,True,0,6 user reviews,2,4,6
667291,True,0,5 user reviews,2,3,5
667300,True,5,Mixed,8,11,19
667310,True,0,1 user reviews,1,0,1
667340,True,0,6 user reviews,2,4,6
667360,True,4,Mostly Negative,4,7,11
667370,True,0,No user reviews,0,0,0
667400,True,0,No user reviews,0,0,0
667410,True,0,1 user reviews,0,1,1
667420,True,0,4 user reviews,1,3,4
667430,True,0,No user reviews,0,0,0
667450,True,0,1 user reviews,0,1,1
667460,True,0,No user reviews,0,0,0
667470,True,0,No user reviews,0,0,0
667480,True,0,No user reviews,0,0,0
667490,True,0,No user reviews,0,0,0
667510,True,0,1 user reviews,1,0,1
667520,True,4,Mostly Negative,4,8,12
667530,True,0,No user reviews,0,0,0
667550,True,0,5 user reviews,5,0,5
667580,True,0,No user reviews,0,0,0
667590,True,0,No user reviews,0,0,0
667600,True,8,Very Positive,448,29,477
667620,True,5,Mixed,16,7,23
667630,True,0,1 user reviews,0,1,1
667650,True,0,No user reviews,0,0,0
667660,True,0,No user reviews,0,0,0
667670,True,0,4 user reviews,3,1,4
667690,True,0,4 user reviews,4,0,4
667710,True,0,No user reviews,0,0,0
667720,True,6,Mostly Positive,862,218,1080
667750,True,0,6 user reviews,6,0,6
667760,True,7,Positive,10,0,10
667770,True,0,9 user reviews,5,4,9
667780,True,7,Positive,12,1,13
667790,True,7,Positive,12,0,12
667800,True,7,Positive,26,1,27
667810,True,5,Mixed,25,14,39
667820,True,7,Positive,27,1,28
667840,True,0,3 user reviews,0,3,3
667860,True,0,No user reviews,0,0,0
667870,True,7,Positive,11,0,11
667880,True,0,2 user reviews,2,0,2
667890,True,0,No user reviews,0,0,0
667900,True,0,1 user reviews,0,1,1
667920,True,0,9 user reviews,5,4,9
667930,True,0,1 user reviews,1,0,1
667970,True,9,Overwhelmingly Positive,1759,60,1819
667980,True,0,1 user reviews,1,0,1
668000,True,0,No user reviews,0,0,0
668010,True,0,2 user reviews,2,0,2
668030,True,0,3 user reviews,2,1,3
668040,True,0,5 user reviews,4,1,5
668050,True,0,2 user reviews,0,2,2
668060,True,0,3 user reviews,0,3,3
668090,True,0,No user reviews,0,0,0
668110,True,0,No user reviews,0,0,0
668120,True,0,No user reviews,0,0,0
668121,True,0,No user reviews,0,0,0
668130,True,0,No user reviews,0,0,0
668140,True,0,No user reviews,0,0,0
668160,True,0,No user reviews,0,0,0
668170,True,0,No user reviews,0,0,0
668180,True,0,No user reviews,0,0,0
668190,True,0,1 user reviews,0,1,1
668200,True,0,2 user reviews,2,0,2
668210,True,8,Very Positive,418,49,467
668220,True,0,2 user reviews,2,0,2
668230,True,0,2 user reviews,2,0,2
668280,True,0,2 user reviews,2,0,2
668290,True,0,4 user reviews,2,2,4
668300,True,0,3 user reviews,1,2,3
668320,True,7,Positive,24,3,27
668350,True,8,Very Positive,132,1,133
668360,True,7,Positive,25,5,30
668370,True,0,No user reviews,0,0,0
668390,True,0,No user reviews,0,0,0
668410,True,0,No user reviews,0,0,0
668430,True,8,Very Positive,109,12,121
668440,True,0,No user reviews,0,0,0
668460,True,0,No user reviews,0,0,0
668480,True,0,No user reviews,0,0,0
668490,True,0,No user reviews,0,0,0
668510,True,0,3 user reviews,3,0,3
668520,True,0,3 user reviews,3,0,3
668530,True,0,No user reviews,0,0,0
668550,True,0,No user reviews,0,0,0
668560,True,0,2 user reviews,1,1,2
668570,True,0,No user reviews,0,0,0
668580,True,0,No user reviews,0,0,0
668590,True,8,Very Positive,98,18,116
668600,True,0,No user reviews,0,0,0
668610,True,0,4 user reviews,3,1,4
668620,True,0,No user reviews,0,0,0
668630,True,8,Very Positive,490,117,607
668650,True,0,3 user reviews,3,0,3
668660,True,7,Positive,16,2,18
668670,True,0,6 user reviews,2,4,6
668680,True,0,2 user reviews,2,0,2
668710,True,7,Positive,12,1,13
668714,True,0,2 user reviews,1,1,2
668720,True,0,No user reviews,0,0,0
668721,True,0,No user reviews,0,0,0
668730,True,0,6 user reviews,4,2,6
668770,True,0,No user reviews,0,0,0
668780,True,0,6 user reviews,6,0,6
668790,True,0,3 user reviews,2,1,3
668800,True,0,2 user reviews,2,0,2
668830,True,0,1 user reviews,0,1,1
668840,True,0,6 user reviews,4,2,6
668850,True,0,1 user reviews,0,1,1
668870,True,0,No user reviews,0,0,0
668871,True,0,No user reviews,0,0,0
668880,True,0,No user reviews,0,0,0
668890,True,4,Mostly Negative,7,12,19
668910,True,0,5 user reviews,2,3,5
668950,True,0,No user reviews,0,0,0
668960,True,0,2 user reviews,2,0,2
668970,True,0,3 user reviews,3,0,3
668980,True,8,Very Positive,60,13,73
669000,True,0,3 user reviews,0,3,3
669040,True,0,No user reviews,0,0,0
669050,True,8,Very Positive,113,14,127
669100,True,0,No user reviews,0,0,0
669110,True,0,No user reviews,0,0,0
669120,True,0,No user reviews,0,0,0
669130,True,0,No user reviews,0,0,0
669140,True,0,No user reviews,0,0,0
669150,True,0,1 user reviews,1,0,1
669160,True,0,No user reviews,0,0,0
669170,True,0,No user reviews,0,0,0
669180,True,0,No user reviews,0,0,0
669190,True,0,4 user reviews,1,3,4
669200,True,0,No user reviews,0,0,0
669210,True,0,No user reviews,0,0,0
669220,True,0,No user reviews,0,0,0
669230,True,0,No user reviews,0,0,0
669270,True,0,No user reviews,0,0,0
669290,True,5,Mixed,111,102,213
669300,True,0,No user reviews,0,0,0
669310,True,0,2 user reviews,2,0,2
669320,True,0,6 user reviews,4,2,6
669330,True,0,No user reviews,0,0,0
669340,True,0,9 user reviews,8,1,9
669350,True,0,6 user reviews,4,2,6
669360,True,0,2 user reviews,1,1,2
669380,True,7,Positive,33,6,39
669390,True,0,5 user reviews,4,1,5
669410,True,0,1 user reviews,0,1,1
669440,True,0,No user reviews,0,0,0
669480,True,0,5 user reviews,5,0,5
669490,True,0,2 user reviews,2,0,2
669500,True,8,Very Positive,48,4,52
669520,True,0,1 user reviews,0,1,1
669570,True,0,5 user reviews,1,4,5
669580,True,0,No user reviews,0,0,0
669590,True,0,1 user reviews,1,0,1
669600,True,0,1 user reviews,1,0,1
669620,True,0,No user reviews,0,0,0
669630,True,0,No user reviews,0,0,0
669650,True,0,3 user reviews,0,3,3
669660,True,5,Mixed,36,19,55
669690,True,0,No user reviews,0,0,0
669700,True,0,1 user reviews,0,1,1
669710,True,0,2 user reviews,2,0,2
669730,True,0,7 user reviews,2,5,7
669740,True,0,3 user reviews,3,0,3
669750,True,0,5 user reviews,4,1,5
669760,True,0,No user reviews,0,0,0
669770,True,5,Mixed,25,20,45
669800,True,0,No user reviews,0,0,0
669801,True,0,No user reviews,0,0,0
669820,True,0,No user reviews,0,0,0
669830,True,7,Positive,10,1,11
669840,True,0,No user reviews,0,0,0
669860,True,0,No user reviews,0,0,0
669870,True,0,No user reviews,0,0,0
669880,True,0,No user reviews,0,0,0
669890,True,0,No user reviews,0,0,0
669900,True,0,No user reviews,0,0,0
669910,True,7,Positive,22,1,23
669940,True,0,No user reviews,0,0,0
669950,True,8,Very Positive,263,30,293
669960,True,0,3 user reviews,2,1,3
669970,True,7,Positive,27,3,30
669990,True,0,1 user reviews,1,0,1
670020,True,0,1 user reviews,1,0,1
670030,True,0,No user reviews,0,0,0
670040,True,0,No user reviews,0,0,0
670050,True,0,No user reviews,0,0,0
670060,True,7,Positive,13,0,13
670080,True,0,No user reviews,0,0,0
670090,True,0,1 user reviews,1,0,1
670100,True,0,4 user reviews,1,3,4
670120,True,0,No user reviews,0,0,0
670130,True,0,6 user reviews,5,1,6
670140,True,0,4 user reviews,4,0,4
670160,True,8,Very Positive,217,18,235
670180,True,5,Mixed,7,4,11
670190,True,0,No user reviews,0,0,0
670210,True,0,1 user reviews,1,0,1
670230,True,0,2 user reviews,2,0,2
670240,True,0,3 user reviews,2,1,3
670250,True,0,No user reviews,0,0,0
670260,True,8,Very Positive,166,25,191
670270,True,0,5 user reviews,3,2,5
670280,True,0,4 user reviews,3,1,4
670290,True,0,No user reviews,0,0,0
670300,True,0,No user reviews,0,0,0
670320,True,0,2 user reviews,2,0,2
670330,True,0,5 user reviews,2,3,5
670340,True,0,3 user reviews,3,0,3
670350,True,6,Mostly Positive,152,45,197
670360,True,0,No user reviews,0,0,0
670370,True,0,4 user reviews,1,3,4
670400,True,0,No user reviews,0,0,0
670410,True,0,4 user reviews,2,2,4
670430,True,0,5 user reviews,0,5,5
670440,True,0,No user reviews,0,0,0
670450,True,0,5 user reviews,4,1,5
670460,True,5,Mixed,7,4,11
670470,True,0,9 user reviews,4,5,9
670490,True,4,Mostly Negative,14,51,65
670500,True,0,No user reviews,0,0,0
670510,True,0,No user reviews,0,0,0
670530,True,0,No user reviews,0,0,0
670550,True,0,No user reviews,0,0,0
670560,True,0,No user reviews,0,0,0
670570,True,0,3 user reviews,2,1,3
670600,True,0,No user reviews,0,0,0
670601,True,0,No user reviews,0,0,0
670602,True,0,No user reviews,0,0,0
670603,True,0,No user reviews,0,0,0
670604,True,0,No user reviews,0,0,0
670605,True,0,No user reviews,0,0,0
670610,True,7,Positive,27,0,27
670620,True,0,3 user reviews,2,1,3
670630,True,0,5 user reviews,5,0,5
670640,True,0,No user reviews,0,0,0
670690,True,0,No user reviews,0,0,0
670700,True,0,No user reviews,0,0,0
670720,True,0,5 user reviews,5,0,5
670730,True,0,3 user reviews,3,0,3
670750,True,8,Very Positive,98,14,112
670760,True,0,No user reviews,0,0,0
670780,True,0,2 user reviews,0,2,2
670790,True,0,No user reviews,0,0,0
670820,True,5,Mixed,31,14,45
670830,True,0,No user reviews,0,0,0
670840,True,0,5 user reviews,5,0,5
670850,True,0,4 user reviews,3,1,4
670860,True,0,No user reviews,0,0,0
670870,True,0,2 user reviews,2,0,2
670900,True,5,Mixed,147,106,253
670910,True,0,6 user reviews,0,6,6
670930,True,6,Mostly Positive,10,3,13
670940,True,0,1 user reviews,1,0,1
670950,True,0,4 user reviews,4,0,4
670960,True,0,1 user reviews,1,0,1
670961,True,0,1 user reviews,1,0,1
670970,True,0,No user reviews,0,0,0
670980,True,0,No user reviews,0,0,0
671050,True,0,1 user reviews,1,0,1
671070,True,0,No user reviews,0,0,0
671090,True,7,Positive,37,6,43
671100,True,7,Positive,17,1,18
671110,True,0,No user reviews,0,0,0
671120,True,0,4 user reviews,4,0,4
671130,True,0,No user reviews,0,0,0
671150,True,0,3 user reviews,3,0,3
671160,True,7,Positive,24,2,26
671170,True,8,Very Positive,51,9,60
671180,True,0,4 user reviews,3,1,4
671190,True,7,Positive,41,3,44
671200,True,0,2 user reviews,1,1,2
671210,True,0,No user reviews,0,0,0
671230,True,0,1 user reviews,1,0,1
671240,True,5,Mixed,17,10,27
671260,True,6,Mostly Positive,22,9,31
671270,True,7,Positive,8,2,10
671290,True,0,No user reviews,0,0,0
671310,True,0,No user reviews,0,0,0
671330,True,0,2 user reviews,2,0,2
671340,True,0,No user reviews,0,0,0
671341,True,0,No user reviews,0,0,0
671342,True,0,No user reviews,0,0,0
671360,True,0,No user reviews,0,0,0
671370,True,0,No user reviews,0,0,0
671380,True,0,No user reviews,0,0,0
671381,True,0,No user reviews,0,0,0
671382,True,0,No user reviews,0,0,0
671390,True,6,Mostly Positive,67,21,88
671410,True,0,No user reviews,0,0,0
671430,True,0,No user reviews,0,0,0
671440,True,6,Mostly Positive,1082,298,1380
671460,True,0,No user reviews,0,0,0
671470,True,0,2 user reviews,2,0,2
671480,True,0,2 user reviews,2,0,2
671490,True,0,1 user reviews,0,1,1
671510,True,5,Mixed,1082,472,1554
671540,True,0,1 user reviews,1,0,1
671550,True,7,Positive,37,1,38
671560,True,0,9 user reviews,9,0,9
671580,True,0,3 user reviews,1,2,3
671600,True,5,Mixed,8,10,18
671610,True,0,No user reviews,0,0,0
671620,True,8,Very Positive,344,66,410
671630,True,6,Mostly Positive,8,3,11
671650,True,7,Positive,25,4,29
671670,True,5,Mixed,6,4,10
671690,True,0,No user reviews,0,0,0
671700,True,0,No user reviews,0,0,0
671720,True,0,No user reviews,0,0,0
671740,True,7,Positive,25,3,28
671750,True,0,1 user reviews,1,0,1
671770,True,0,No user reviews,0,0,0
671800,True,5,Mixed,9,7,16
671810,True,0,1 user reviews,0,1,1
671820,True,0,1 user reviews,1,0,1
671840,True,6,Mostly Positive,8,3,11
671850,True,0,1 user reviews,0,1,1
671860,True,0,No user reviews,0,0,0
671880,True,0,2 user reviews,2,0,2
671900,True,5,Mixed,23,22,45
671910,True,0,No user reviews,0,0,0
671920,True,6,Mostly Positive,27,9,36
671950,True,0,No user reviews,0,0,0
671970,True,0,No user reviews,0,0,0
671980,True,7,Positive,29,4,33
672000,True,0,No user reviews,0,0,0
672010,True,0,1 user reviews,1,0,1
672020,True,7,Positive,31,3,34
672030,True,0,4 user reviews,2,2,4
672040,True,0,8 user reviews,6,2,8
672050,True,0,3 user reviews,0,3,3
672080,True,0,No user reviews,0,0,0
672100,True,0,4 user reviews,4,0,4
672130,True,0,2 user reviews,0,2,2
672140,True,0,8 user reviews,2,6,8
672150,True,7,Positive,35,3,38
672160,True,5,Mixed,16,8,24
672170,True,0,No user reviews,0,0,0
672180,True,0,6 user reviews,5,1,6
672200,True,0,No user reviews,0,0,0
672230,True,6,Mostly Positive,28,8,36
672240,True,0,No user reviews,0,0,0
672250,True,0,9 user reviews,4,5,9
672270,True,6,Mostly Positive,34,11,45
672271,True,5,Mixed,28,22,50
672280,True,0,No user reviews,0,0,0
672290,True,0,8 user reviews,5,3,8
672300,True,0,No user reviews,0,0,0
672310,True,0,5 user reviews,4,1,5
672320,True,0,1 user reviews,1,0,1
672380,True,0,3 user reviews,0,3,3
672410,True,0,1 user reviews,1,0,1
672420,True,0,No user reviews,0,0,0
672430,True,0,No user reviews,0,0,0
672440,True,0,No user reviews,0,0,0
672460,True,5,Mixed,9,6,15
672480,True,0,1 user reviews,0,1,1
672490,True,0,No user reviews,0,0,0
672510,True,0,No user reviews,0,0,0
672530,True,0,No user reviews,0,0,0
672560,True,0,No user reviews,0,0,0
672570,True,0,2 user reviews,1,1,2
672590,True,7,Positive,34,8,42
672630,True,8,Very Positive,635,114,749
672640,True,0,No user reviews,0,0,0
672650,True,0,No user reviews,0,0,0
672670,True,0,2 user reviews,1,1,2
672680,True,0,4 user reviews,2,2,4
672690,True,0,9 user reviews,9,0,9
672710,True,5,Mixed,12,9,21
672720,True,0,5 user reviews,4,1,5
672730,True,0,No user reviews,0,0,0
672760,True,0,2 user reviews,1,1,2
672770,True,0,1 user reviews,0,1,1
672780,True,0,No user reviews,0,0,0
672790,True,6,Mostly Positive,10,4,14
672800,True,0,No user reviews,0,0,0
672810,True,0,No user reviews,0,0,0
672830,True,6,Mostly Positive,24,8,32
672840,True,8,Very Positive,108,8,116
672860,True,5,Mixed,25,29,54
672870,True,0,No user reviews,0,0,0
672880,True,0,No user reviews,0,0,0
672910,True,0,3 user reviews,2,1,3
672920,True,0,5 user reviews,5,0,5
672940,True,0,5 user reviews,0,5,5
672960,True,0,No user reviews,0,0,0
672970,True,0,8 user reviews,6,2,8
672990,True,0,No user reviews,0,0,0
673000,True,8,Very Positive,412,65,477
673010,True,0,2 user reviews,0,2,2
673020,True,0,No user reviews,0,0,0
673030,True,0,No user reviews,0,0,0
673040,True,0,2 user reviews,2,0,2
673050,True,0,1 user reviews,1,0,1
673060,True,7,Positive,39,4,43
673070,True,0,No user reviews,0,0,0
673080,True,0,No user reviews,0,0,0
673090,True,0,No user reviews,0,0,0
673120,True,0,1 user reviews,0,1,1
673130,True,9,Overwhelmingly Positive,2267,76,2343
673140,True,0,3 user reviews,3,0,3
673170,True,0,No user reviews,0,0,0
673190,True,6,Mostly Positive,33,12,45
673210,True,5,Mixed,192,86,278
673220,True,0,6 user reviews,3,3,6
673230,True,0,4 user reviews,4,0,4
673240,True,0,No user reviews,0,0,0
673250,True,0,No user reviews,0,0,0
673260,True,6,Mostly Positive,119,41,160
673280,True,0,4 user reviews,4,0,4
673300,True,8,Very Positive,49,3,52
673310,True,0,3 user reviews,0,3,3
673320,True,0,No user reviews,0,0,0
673340,True,0,No user reviews,0,0,0
673360,True,0,1 user reviews,1,0,1
673380,True,0,3 user reviews,3,0,3
673400,True,0,5 user reviews,0,5,5
673410,True,0,No user reviews,0,0,0
673430,True,0,No user reviews,0,0,0
673440,True,0,No user reviews,0,0,0
673450,True,5,Mixed,54,32,86
673480,True,0,2 user reviews,2,0,2
673500,True,5,Mixed,7,6,13
673530,True,0,1 user reviews,1,0,1
673540,True,0,1 user reviews,1,0,1
673550,True,0,3 user reviews,3,0,3
673560,True,0,No user reviews,0,0,0
673570,True,0,5 user reviews,2,3,5
673580,True,0,1 user reviews,0,1,1
673590,True,0,No user reviews,0,0,0
673600,True,8,Very Positive,90,14,104
673610,True,8,Very Positive,2003,408,2411
673620,True,0,No user reviews,0,0,0
673630,True,0,1 user reviews,0,1,1
673660,True,5,Mixed,8,10,18
673690,True,0,No user reviews,0,0,0
673710,True,0,No user reviews,0,0,0
673720,True,0,2 user reviews,0,2,2
673730,True,0,1 user reviews,1,0,1
673740,True,7,Positive,33,5,38
673750,True,8,Very Positive,205,22,227
673790,True,0,No user reviews,0,0,0
673800,True,8,Very Positive,122,27,149
673810,True,0,No user reviews,0,0,0
673820,True,0,3 user reviews,0,3,3
673830,True,5,Mixed,6,4,10
673840,True,6,Mostly Positive,10,3,13
673850,True,8,Very Positive,91,14,105
673870,True,0,No user reviews,0,0,0
673880,True,8,Very Positive,3082,213,3295
673890,True,0,No user reviews,0,0,0
673900,True,0,No user reviews,0,0,0
673910,True,0,No user reviews,0,0,0
673920,True,0,1 user reviews,1,0,1
673930,True,0,No user reviews,0,0,0
673940,True,0,No user reviews,0,0,0
673950,True,8,Very Positive,2314,186,2500
673970,True,0,9 user reviews,8,1,9
673980,True,7,Positive,25,1,26
673990,True,0,No user reviews,0,0,0
674000,True,0,1 user reviews,1,0,1
674010,True,0,2 user reviews,0,2,2
674020,True,5,Mixed,4752,2558,7310
674070,True,0,No user reviews,0,0,0
674080,True,0,No user reviews,0,0,0
674090,True,0,No user reviews,0,0,0
674100,True,0,1 user reviews,1,0,1
674120,True,0,1 user reviews,0,1,1
674130,True,0,No user reviews,0,0,0
674150,True,5,Mixed,10,8,18
674160,True,0,6 user reviews,3,3,6
674170,True,5,Mixed,22,10,32
674180,True,0,3 user reviews,2,1,3
674190,True,7,Positive,20,1,21
674200,True,0,No user reviews,0,0,0
674210,True,7,Positive,12,2,14
674220,True,4,Mostly Negative,7,11,18
674230,True,0,4 user reviews,4,0,4
674240,True,0,No user reviews,0,0,0
674250,True,7,Positive,15,1,16
674290,True,0,No user reviews,0,0,0
674300,True,0,No user reviews,0,0,0
674310,True,7,Positive,27,4,31
674320,True,0,No user reviews,0,0,0
674330,True,7,Positive,21,0,21
674360,True,0,1 user reviews,0,1,1
674370,True,5,Mixed,15,12,27
674380,True,0,9 user reviews,6,3,9
674390,True,0,No user reviews,0,0,0
674400,True,0,No user reviews,0,0,0
674420,True,0,4 user reviews,1,3,4
674430,True,0,No user reviews,0,0,0
674440,True,0,9 user reviews,8,1,9
674450,True,0,1 user reviews,1,0,1
674460,True,0,No user reviews,0,0,0
674480,True,0,2 user reviews,1,1,2
674500,True,8,Very Positive,802,191,993
674520,True,8,Very Positive,605,44,649
674530,True,0,2 user reviews,0,2,2
674550,True,0,2 user reviews,0,2,2
674560,True,0,No user reviews,0,0,0
674570,True,7,Positive,14,3,17
674580,True,0,No user reviews,0,0,0
674590,True,0,No user reviews,0,0,0
674630,True,0,No user reviews,0,0,0
674670,True,0,1 user reviews,1,0,1
674690,True,0,No user reviews,0,0,0
674700,True,0,No user reviews,0,0,0
674720,True,0,No user reviews,0,0,0
674730,True,0,No user reviews,0,0,0
674750,True,8,Very Positive,252,62,314
674760,True,0,No user reviews,0,0,0
674780,True,0,No user reviews,0,0,0
674800,True,0,6 user reviews,3,3,6
674840,True,0,4 user reviews,2,2,4
674850,True,8,Very Positive,117,9,126
674860,True,0,8 user reviews,2,6,8
674880,True,0,No user reviews,0,0,0
674890,True,7,Positive,8,2,10
674900,True,0,No user reviews,0,0,0
674910,True,0,1 user reviews,1,0,1
674920,True,0,1 user reviews,0,1,1
674930,True,0,No user reviews,0,0,0
674940,True,8,Very Positive,23661,1725,25386
674950,True,0,No user reviews,0,0,0
674960,True,8,Very Positive,56,12,68
674970,True,0,No user reviews,0,0,0
674980,True,0,3 user reviews,1,2,3
675010,True,8,Very Positive,5236,622,5858
675030,True,7,Positive,20,2,22
675040,True,0,No user reviews,0,0,0
675060,True,0,No user reviews,0,0,0
675080,True,0,2 user reviews,2,0,2
675090,True,0,No user reviews,0,0,0
675091,True,0,No user reviews,0,0,0
675092,True,0,No user reviews,0,0,0
675093,True,0,No user reviews,0,0,0
675094,True,0,No user reviews,0,0,0
675095,True,0,No user reviews,0,0,0
675096,True,0,No user reviews,0,0,0
675097,True,0,No user reviews,0,0,0
675098,True,0,No user reviews,0,0,0
675099,True,0,No user reviews,0,0,0
675100,True,0,No user reviews,0,0,0
675101,True,0,No user reviews,0,0,0
675120,True,0,4 user reviews,4,0,4
675130,True,0,5 user reviews,2,3,5
675140,True,0,3 user reviews,2,1,3
675150,True,0,No user reviews,0,0,0
675151,True,0,No user reviews,0,0,0
675152,True,0,No user reviews,0,0,0
675160,True,0,No user reviews,0,0,0
675170,True,5,Mixed,67,56,123
675180,True,0,4 user reviews,0,4,4
675190,True,0,No user reviews,0,0,0
675200,True,0,No user reviews,0,0,0
675210,True,5,Mixed,16,23,39
675220,True,0,5 user reviews,2,3,5
675230,True,0,No user reviews,0,0,0
675240,True,8,Very Positive,121,8,129
675250,True,0,No user reviews,0,0,0
675260,True,8,Very Positive,1669,117,1786
675270,True,0,3 user reviews,3,0,3
675280,True,8,Very Positive,46,8,54
675290,True,8,Very Positive,324,31,355
675330,True,0,No user reviews,0,0,0
675340,True,0,7 user reviews,7,0,7
675350,True,0,No user reviews,0,0,0
675351,True,0,1 user reviews,1,0,1
675354,True,0,4 user reviews,4,0,4
675355,True,0,5 user reviews,4,1,5
675356,True,0,1 user reviews,1,0,1
675357,True,0,2 user reviews,1,1,2
675358,True,0,1 user reviews,0,1,1
675359,True,0,No user reviews,0,0,0
675360,True,0,8 user reviews,3,5,8
675370,True,0,1 user reviews,0,1,1
675390,True,0,No user reviews,0,0,0
675400,True,0,No user reviews,0,0,0
675410,True,0,No user reviews,0,0,0
675420,True,0,No user reviews,0,0,0
675430,True,0,No user reviews,0,0,0
675480,True,0,6 user reviews,4,2,6
675490,True,7,Positive,17,3,20
675500,True,0,8 user reviews,4,4,8
675510,True,4,Mostly Negative,4,7,11
675520,True,0,No user reviews,0,0,0
675530,True,0,1 user reviews,1,0,1
675560,True,0,No user reviews,0,0,0
675570,True,0,No user reviews,0,0,0
675590,True,8,Very Positive,79,1,80
675600,True,0,No user reviews,0,0,0
675620,True,0,7 user reviews,5,2,7
675630,True,7,Positive,15,0,15
675640,True,0,6 user reviews,2,4,6
675650,True,0,No user reviews,0,0,0
675660,True,0,4 user reviews,0,4,4
675690,True,0,No user reviews,0,0,0
675720,True,4,Mostly Negative,5,8,13
675730,True,6,Mostly Positive,10,3,13
675750,True,0,1 user reviews,1,0,1
675770,True,0,2 user reviews,1,1,2
675780,True,0,No user reviews,0,0,0
675790,True,0,No user reviews,0,0,0
675800,True,0,No user reviews,0,0,0
675801,True,0,No user reviews,0,0,0
675802,True,0,No user reviews,0,0,0
675803,True,0,No user reviews,0,0,0
675804,True,0,No user reviews,0,0,0
675805,True,0,No user reviews,0,0,0
675806,True,0,No user reviews,0,0,0
675807,True,0,No user reviews,0,0,0
675808,True,0,No user reviews,0,0,0
675809,True,0,No user reviews,0,0,0
675810,True,0,No user reviews,0,0,0
675820,True,0,No user reviews,0,0,0
675821,True,0,No user reviews,0,0,0
675830,True,0,2 user reviews,1,1,2
675860,True,0,No user reviews,0,0,0
675870,True,0,3 user reviews,2,1,3
675880,True,0,No user reviews,0,0,0
675890,True,7,Positive,15,1,16
675900,True,0,No user reviews,0,0,0
675901,True,0,No user reviews,0,0,0
675902,True,0,No user reviews,0,0,0
675903,True,0,No user reviews,0,0,0
675904,True,0,No user reviews,0,0,0
675905,True,0,No user reviews,0,0,0
675906,True,0,No user reviews,0,0,0
675907,True,0,No user reviews,0,0,0
675910,True,7,Positive,10,1,11
675930,True,0,No user reviews,0,0,0
675940,True,5,Mixed,13,8,21
675950,True,5,Mixed,8,5,13
675960,True,0,5 user reviews,1,4,5
675970,True,0,6 user reviews,6,0,6
675980,True,0,2 user reviews,2,0,2
675990,True,7,Positive,10,2,12
676000,True,5,Mixed,16,7,23
676030,True,0,No user reviews,0,0,0
676040,True,0,No user reviews,0,0,0
676050,True,0,No user reviews,0,0,0
676060,True,0,No user reviews,0,0,0
676070,True,0,No user reviews,0,0,0
676080,True,7,Positive,18,2,20
676090,True,6,Mostly Positive,10,4,14
676110,True,0,No user reviews,0,0,0
676120,True,5,Mixed,9,4,13
676130,True,7,Positive,17,1,18
676140,True,0,No user reviews,0,0,0
676150,True,0,No user reviews,0,0,0
676151,True,0,No user reviews,0,0,0
676160,True,0,No user reviews,0,0,0
676170,True,0,2 user reviews,2,0,2
676180,True,0,7 user reviews,7,0,7
676210,True,0,2 user reviews,1,1,2
676240,True,7,Positive,25,3,28
676250,True,0,No user reviews,0,0,0
676251,True,0,No user reviews,0,0,0
676252,True,0,No user reviews,0,0,0
676253,True,0,No user reviews,0,0,0
676254,True,0,No user reviews,0,0,0
676255,True,0,No user reviews,0,0,0
676256,True,0,No user reviews,0,0,0
676257,True,0,No user reviews,0,0,0
676258,True,0,No user reviews,0,0,0
676310,True,0,5 user reviews,1,4,5
676320,True,0,2 user reviews,1,1,2
676340,True,0,6 user reviews,4,2,6
676380,True,0,No user reviews,0,0,0
676410,True,0,3 user reviews,1,2,3
676420,True,8,Very Positive,171,12,183
676430,True,8,Very Positive,186,36,222
676440,True,7,Positive,26,3,29
676450,True,7,Positive,11,0,11
676460,True,0,5 user reviews,1,4,5
676470,True,0,No user reviews,0,0,0
676490,True,0,No user reviews,0,0,0
676500,True,8,Very Positive,215,23,238
676510,True,7,Positive,26,1,27
676520,True,0,2 user reviews,2,0,2
676530,True,0,No user reviews,0,0,0
676540,True,0,No user reviews,0,0,0
676550,True,4,Mostly Negative,2,8,10
676570,True,0,1 user reviews,0,1,1
676580,True,0,5 user reviews,5,0,5
676600,True,0,1 user reviews,1,0,1
676620,True,0,6 user reviews,6,0,6
676630,True,7,Positive,45,2,47
676660,True,0,2 user reviews,2,0,2
676670,True,0,No user reviews,0,0,0
676680,True,0,1 user reviews,1,0,1
676690,True,0,5 user reviews,3,2,5
676700,True,6,Mostly Positive,11,4,15
676720,True,0,8 user reviews,2,6,8
676730,True,5,Mixed,11,12,23
676740,True,6,Mostly Positive,296,96,392
676750,True,0,No user reviews,0,0,0
676760,True,4,Mostly Negative,8,14,22
676770,True,0,No user reviews,0,0,0
676800,True,0,No user reviews,0,0,0
676810,True,0,No user reviews,0,0,0
676820,True,9,Overwhelmingly Positive,955,46,1001
676830,True,7,Positive,23,4,27
676840,True,5,Mixed,242,104,346
676850,True,0,4 user reviews,2,2,4
676860,True,0,No user reviews,0,0,0
676880,True,0,2 user reviews,0,2,2
676890,True,0,No user reviews,0,0,0
676910,True,0,9 user reviews,7,2,9
676930,True,7,Positive,22,2,24
676950,True,0,No user reviews,0,0,0
676960,True,0,8 user reviews,7,1,8
676990,True,0,3 user reviews,0,3,3
677010,True,0,2 user reviews,0,2,2
677020,True,6,Mostly Positive,35,11,46
677030,True,0,2 user reviews,2,0,2
677040,True,5,Mixed,14,8,22
677060,True,6,Mostly Positive,15,6,21
677080,True,0,1 user reviews,1,0,1
677090,True,0,2 user reviews,2,0,2
677100,True,0,No user reviews,0,0,0
677120,True,8,Very Positive,2098,271,2369
677130,True,0,No user reviews,0,0,0
677150,True,0,5 user reviews,4,1,5
677160,True,6,Mostly Positive,904,228,1132
677180,True,5,Mixed,50,68,118
677190,True,7,Positive,9,1,10
677210,True,0,4 user reviews,4,0,4
677220,True,0,3 user reviews,2,1,3
677230,True,0,4 user reviews,1,3,4
677240,True,0,7 user reviews,3,4,7
677250,True,0,1 user reviews,1,0,1
677260,True,0,No user reviews,0,0,0
677280,True,6,Mostly Positive,15,5,20
677290,True,0,No user reviews,0,0,0
677300,True,7,Positive,19,2,21
677310,True,0,No user reviews,0,0,0
677320,True,0,No user reviews,0,0,0
677330,True,7,Positive,17,4,21
677340,True,8,Very Positive,307,68,375
677360,True,0,No user reviews,0,0,0
677370,True,0,No user reviews,0,0,0
677380,True,0,4 user reviews,4,0,4
677390,True,0,No user reviews,0,0,0
677391,True,0,No user reviews,0,0,0
677400,True,0,No user reviews,0,0,0
677401,True,0,No user reviews,0,0,0
677402,True,0,No user reviews,0,0,0
677410,True,0,No user reviews,0,0,0
677420,True,0,No user reviews,0,0,0
677421,True,0,No user reviews,0,0,0
677422,True,0,No user reviews,0,0,0
677430,True,0,No user reviews,0,0,0
677431,True,0,No user reviews,0,0,0
677432,True,0,No user reviews,0,0,0
677440,True,0,No user reviews,0,0,0
677441,True,0,No user reviews,0,0,0
677442,True,0,No user reviews,0,0,0
677450,True,5,Mixed,55,29,84
677480,True,5,Mixed,187,133,320
677490,True,0,No user reviews,0,0,0
677491,True,0,No user reviews,0,0,0
677492,True,0,No user reviews,0,0,0
677493,True,0,No user reviews,0,0,0
677494,True,0,No user reviews,0,0,0
677495,True,0,No user reviews,0,0,0
677496,True,0,No user reviews,0,0,0
677497,True,0,No user reviews,0,0,0
677498,True,0,No user reviews,0,0,0
677499,True,0,No user reviews,0,0,0
677500,True,0,No user reviews,0,0,0
677501,True,0,No user reviews,0,0,0
677502,True,0,No user reviews,0,0,0
677503,True,0,No user reviews,0,0,0
677504,True,0,No user reviews,0,0,0
677505,True,0,No user reviews,0,0,0
677506,True,0,No user reviews,0,0,0
677507,True,0,No user reviews,0,0,0
677508,True,0,No user reviews,0,0,0
677509,True,0,No user reviews,0,0,0
677510,True,0,No user reviews,0,0,0
677511,True,0,No user reviews,0,0,0
677512,True,0,No user reviews,0,0,0
677513,True,0,No user reviews,0,0,0
677514,True,0,No user reviews,0,0,0
677520,True,0,9 user reviews,7,2,9
677530,True,0,No user reviews,0,0,0
677540,True,0,No user reviews,0,0,0
677550,True,0,No user reviews,0,0,0
677570,True,0,No user reviews,0,0,0
677580,True,0,No user reviews,0,0,0
677590,True,0,1 user reviews,1,0,1
677610,True,0,4 user reviews,3,1,4
677620,True,8,Very Positive,54,9,63
677640,True,0,3 user reviews,1,2,3
677650,True,5,Mixed,7,6,13
677670,True,0,No user reviews,0,0,0
677680,True,0,2 user reviews,1,1,2
677690,True,0,1 user reviews,1,0,1
677691,True,0,1 user reviews,1,0,1
677692,True,0,1 user reviews,1,0,1
677700,True,0,3 user reviews,3,0,3
677710,True,0,5 user reviews,4,1,5
677720,True,0,8 user reviews,6,2,8
677730,True,5,Mixed,6,4,10
677780,True,0,No user reviews,0,0,0
677790,True,6,Mostly Positive,10,3,13
677810,True,0,No user reviews,0,0,0
677820,True,4,Mostly Negative,3,9,12
677850,True,5,Mixed,12,6,18
677870,True,0,5 user reviews,1,4,5
677880,True,0,5 user reviews,3,2,5
677900,True,6,Mostly Positive,8,3,11
677910,True,7,Positive,15,2,17
677920,True,0,5 user reviews,1,4,5
677930,True,0,No user reviews,0,0,0
677940,True,0,8 user reviews,6,2,8
677950,True,7,Positive,26,5,31
677951,True,0,4 user reviews,1,3,4
677960,True,7,Positive,10,0,10
677990,True,0,4 user reviews,3,1,4
677991,True,7,Positive,8,2,10
677992,True,0,1 user reviews,1,0,1
677993,True,0,3 user reviews,1,2,3
677994,True,0,No user reviews,0,0,0
677995,True,0,2 user reviews,0,2,2
677996,True,0,1 user reviews,0,1,1
677997,True,0,1 user reviews,1,0,1
677998,True,0,1 user reviews,0,1,1
677999,True,0,3 user reviews,3,0,3
678000,True,0,4 user reviews,2,2,4
678001,True,5,Mixed,14,18,32
678002,True,7,Positive,12,1,13
678003,True,0,8 user reviews,4,4,8
678004,True,4,Mostly Negative,9,17,26
678005,True,7,Positive,16,1,17
678008,True,0,4 user reviews,2,2,4
678009,True,0,1 user reviews,0,1,1
678010,True,0,5 user reviews,4,1,5
678030,True,4,Mostly Negative,8,21,29
678060,True,5,Mixed,4,6,10
678080,True,0,No user reviews,0,0,0
678090,True,0,No user reviews,0,0,0
678100,True,0,3 user reviews,3,0,3
678150,True,0,No user reviews,0,0,0
678160,True,0,No user reviews,0,0,0
678170,True,0,No user reviews,0,0,0
678180,True,0,No user reviews,0,0,0
678181,True,0,No user reviews,0,0,0
678182,True,0,1 user reviews,1,0,1
678183,True,0,1 user reviews,0,1,1
678185,True,0,1 user reviews,1,0,1
678186,True,0,3 user reviews,2,1,3
678187,True,0,No user reviews,0,0,0
678188,True,0,1 user reviews,1,0,1
678190,True,5,Mixed,30,32,62
678200,True,0,6 user reviews,5,1,6
678220,True,6,Mostly Positive,12,4,16
678230,True,0,No user reviews,0,0,0
678240,True,0,2 user reviews,2,0,2
678250,True,0,No user reviews,0,0,0
678270,True,0,No user reviews,0,0,0
678280,True,0,No user reviews,0,0,0
678290,True,0,5 user reviews,4,1,5
678310,True,7,Positive,48,1,49
678320,True,0,No user reviews,0,0,0
678321,True,0,No user reviews,0,0,0
678322,True,0,No user reviews,0,0,0
678323,True,0,No user reviews,0,0,0
678324,True,0,No user reviews,0,0,0
678350,True,0,No user reviews,0,0,0
678390,True,0,No user reviews,0,0,0
678400,True,0,3 user reviews,3,0,3
678410,True,0,2 user reviews,1,1,2
678420,True,0,No user reviews,0,0,0
678430,True,0,2 user reviews,2,0,2
678440,True,0,8 user reviews,8,0,8
678450,True,0,5 user reviews,1,4,5
678460,True,0,No user reviews,0,0,0
678470,True,0,1 user reviews,1,0,1
678480,True,0,1 user reviews,0,1,1
678490,True,0,No user reviews,0,0,0
678500,True,0,1 user reviews,0,1,1
678520,True,8,Very Positive,164,18,182
678530,True,7,Positive,11,0,11
678540,True,0,3 user reviews,3,0,3
678550,True,0,No user reviews,0,0,0
678560,True,7,Positive,20,1,21
678570,True,0,1 user reviews,0,1,1
678590,True,0,No user reviews,0,0,0
678600,True,0,No user reviews,0,0,0
678620,True,0,4 user reviews,3,1,4
678700,True,0,No user reviews,0,0,0
678710,True,0,No user reviews,0,0,0
678720,True,0,No user reviews,0,0,0
678730,True,0,No user reviews,0,0,0
678731,True,0,No user reviews,0,0,0
678732,True,0,No user reviews,0,0,0
678733,True,0,No user reviews,0,0,0
678734,True,0,No user reviews,0,0,0
678740,True,0,No user reviews,0,0,0
678750,True,0,No user reviews,0,0,0
678760,True,0,6 user reviews,2,4,6
678800,True,0,No user reviews,0,0,0
678820,True,6,Mostly Positive,22,6,28
678830,True,0,3 user reviews,3,0,3
678850,True,5,Mixed,12,6,18
678870,True,0,3 user reviews,3,0,3
678880,True,0,2 user reviews,2,0,2
678890,True,4,Mostly Negative,8,26,34
678900,True,6,Mostly Positive,466,180,646
678910,True,0,No user reviews,0,0,0
678920,True,0,No user reviews,0,0,0
678930,True,0,1 user reviews,1,0,1
678940,True,0,No user reviews,0,0,0
678950,True,8,Very Positive,8915,1038,9953
678960,True,8,Very Positive,7303,682,7985
678970,True,8,Very Positive,64,4,68
679030,True,0,2 user reviews,2,0,2
679050,True,0,No user reviews,0,0,0
679070,True,0,8 user reviews,4,4,8
679080,True,0,3 user reviews,1,2,3
679090,True,0,5 user reviews,5,0,5
679100,True,0,1 user reviews,1,0,1
679120,True,6,Mostly Positive,25,8,33
679150,True,0,No user reviews,0,0,0
679160,True,0,2 user reviews,1,1,2
679190,True,5,Mixed,23,11,34
679200,True,0,No user reviews,0,0,0
679230,True,7,Positive,10,0,10
679250,True,0,No user reviews,0,0,0
679260,True,5,Mixed,70,88,158
679270,True,6,Mostly Positive,113,45,158
679280,True,0,No user reviews,0,0,0
679290,True,0,1 user reviews,1,0,1
679300,True,7,Positive,13,0,13
679310,True,7,Positive,15,3,18
679340,True,0,No user reviews,0,0,0
679350,True,0,No user reviews,0,0,0
679390,True,0,2 user reviews,1,1,2
679400,True,0,No user reviews,0,0,0
679410,True,0,5 user reviews,5,0,5
679430,True,0,1 user reviews,1,0,1
679470,True,0,7 user reviews,3,4,7
679480,True,0,3 user reviews,1,2,3
679490,True,0,2 user reviews,1,1,2
679500,True,7,Positive,19,0,19
679510,True,0,2 user reviews,1,1,2
679530,True,5,Mixed,5,7,12
679550,True,0,3 user reviews,2,1,3
679560,True,0,8 user reviews,8,0,8
679570,True,0,2 user reviews,2,0,2
679580,True,0,No user reviews,0,0,0
679590,True,0,No user reviews,0,0,0
679600,True,0,No user reviews,0,0,0
679610,True,0,No user reviews,0,0,0
679620,True,5,Mixed,5,5,10
679640,True,0,2 user reviews,1,1,2
679660,True,8,Very Positive,53,7,60
679670,True,0,5 user reviews,2,3,5
679690,True,0,4 user reviews,2,2,4
679700,True,0,No user reviews,0,0,0
679710,True,0,No user reviews,0,0,0
679720,True,0,2 user reviews,2,0,2
679740,True,0,9 user reviews,5,4,9
679750,True,8,Very Positive,195,20,215
679770,True,7,Positive,19,2,21
679780,True,0,1 user reviews,0,1,1
679790,True,0,No user reviews,0,0,0
679820,True,4,Mostly Negative,5,8,13
679830,True,0,9 user reviews,9,0,9
679840,True,0,No user reviews,0,0,0
679850,True,0,No user reviews,0,0,0
679860,True,0,4 user reviews,0,4,4
679870,True,0,No user reviews,0,0,0
679880,True,0,No user reviews,0,0,0
679900,True,8,Very Positive,833,85,918
679910,True,0,No user reviews,0,0,0
679930,True,0,4 user reviews,3,1,4
679940,True,0,No user reviews,0,0,0
679950,True,0,No user reviews,0,0,0
679960,True,0,No user reviews,0,0,0
679990,True,0,3 user reviews,2,1,3
680010,True,0,No user reviews,0,0,0
680020,True,0,No user reviews,0,0,0
680030,True,7,Positive,11,1,12
680040,True,0,No user reviews,0,0,0
680070,True,0,5 user reviews,3,2,5
680100,True,0,1 user reviews,1,0,1
680130,True,0,No user reviews,0,0,0
680140,True,0,2 user reviews,0,2,2
680160,True,0,No user reviews,0,0,0
680170,True,0,No user reviews,0,0,0
680190,True,0,4 user reviews,4,0,4
680210,True,0,1 user reviews,1,0,1
680240,True,0,No user reviews,0,0,0
680250,True,0,1 user reviews,1,0,1
680300,True,0,No user reviews,0,0,0
680310,True,0,No user reviews,0,0,0
680320,True,6,Mostly Positive,113,37,150
680330,True,5,Mixed,19,10,29
680340,True,6,Mostly Positive,45,12,57
680350,True,0,6 user reviews,5,1,6
680360,True,8,Very Positive,855,137,992
680370,True,0,No user reviews,0,0,0
680380,True,5,Mixed,46,21,67
680390,True,7,Positive,13,2,15
680400,True,0,5 user reviews,4,1,5
680430,True,0,No user reviews,0,0,0
680440,True,0,3 user reviews,1,2,3
680450,True,0,1 user reviews,1,0,1
680470,True,0,No user reviews,0,0,0
680480,True,8,Very Positive,115,21,136
680500,True,0,1 user reviews,1,0,1
680550,True,0,6 user reviews,2,4,6
680560,True,0,1 user reviews,0,1,1
680590,True,8,Very Positive,73,4,77
680600,True,0,No user reviews,0,0,0
680610,True,0,No user reviews,0,0,0
680620,True,7,Positive,14,1,15
680640,True,4,Mostly Negative,9,25,34
680680,True,0,5 user reviews,4,1,5
680690,True,5,Mixed,6,6,12
680700,True,7,Positive,45,2,47
680710,True,0,No user reviews,0,0,0
680730,True,0,No user reviews,0,0,0
680750,True,7,Positive,15,3,18
680760,True,0,No user reviews,0,0,0
680780,True,5,Mixed,8,5,13
680790,True,0,No user reviews,0,0,0
680800,True,0,No user reviews,0,0,0
680830,True,0,6 user reviews,6,0,6
680840,True,0,No user reviews,0,0,0
680860,True,5,Mixed,16,11,27
680870,True,0,No user reviews,0,0,0
680880,True,0,No user reviews,0,0,0
680890,True,0,6 user reviews,6,0,6
680910,True,7,Positive,17,0,17
680930,True,0,6 user reviews,5,1,6
680940,True,0,6 user reviews,1,5,6
680950,True,6,Mostly Positive,19,8,27
680970,True,0,2 user reviews,2,0,2
680980,True,6,Mostly Positive,273,76,349
680990,True,5,Mixed,6,5,11
681000,True,0,6 user reviews,5,1,6
681020,True,0,2 user reviews,1,1,2
681030,True,0,1 user reviews,0,1,1
681040,True,0,6 user reviews,6,0,6
681060,True,7,Positive,25,4,29
681090,True,0,3 user reviews,2,1,3
681100,True,0,3 user reviews,2,1,3
681110,True,5,Mixed,34,15,49
681120,True,0,No user reviews,0,0,0
681140,True,5,Mixed,9,9,18
681150,True,5,Mixed,4,6,10
681160,True,0,2 user reviews,0,2,2
681190,True,0,8 user reviews,8,0,8
681240,True,8,Very Positive,96,8,104
681260,True,0,1 user reviews,0,1,1
681280,True,8,Very Positive,1940,126,2066
681290,True,0,3 user reviews,3,0,3
681330,True,6,Mostly Positive,110,29,139
681340,True,0,1 user reviews,1,0,1
681350,True,0,2 user reviews,1,1,2
681360,True,0,2 user reviews,1,1,2
681380,True,0,3 user reviews,3,0,3
681390,True,8,Very Positive,313,52,365
681410,True,0,4 user reviews,4,0,4
681460,True,6,Mostly Positive,13,4,17
681480,True,0,7 user reviews,2,5,7
681490,True,0,2 user reviews,0,2,2
681500,True,0,No user reviews,0,0,0
681510,True,0,No user reviews,0,0,0
681511,True,0,No user reviews,0,0,0
681512,True,0,No user reviews,0,0,0
681513,True,0,No user reviews,0,0,0
681514,True,0,No user reviews,0,0,0
681515,True,0,No user reviews,0,0,0
681516,True,0,No user reviews,0,0,0
681520,True,5,Mixed,18,10,28
681530,True,7,Positive,21,0,21
681540,True,0,No user reviews,0,0,0
681550,True,5,Mixed,7,5,12
681560,True,0,3 user reviews,2,1,3
681570,True,0,3 user reviews,2,1,3
681580,True,0,No user reviews,0,0,0
681590,True,0,No user reviews,0,0,0
681610,True,0,No user reviews,0,0,0
681620,True,7,Positive,11,1,12
681630,True,0,5 user reviews,3,2,5
681640,True,7,Positive,35,1,36
681660,True,4,Mostly Negative,1801,2967,4768
681670,True,0,No user reviews,0,0,0
681680,True,0,No user reviews,0,0,0
681690,True,0,1 user reviews,1,0,1
681710,True,0,No user reviews,0,0,0
681720,True,5,Mixed,27,39,66
681730,True,8,Very Positive,275,65,340
681740,True,0,No user reviews,0,0,0
681750,True,0,8 user reviews,2,6,8
681760,True,0,2 user reviews,0,2,2
681780,True,0,8 user reviews,0,8,8
681790,True,7,Positive,9,1,10
681800,True,0,1 user reviews,1,0,1
681810,True,0,2 user reviews,0,2,2
681820,True,7,Positive,18,2,20
681830,True,0,4 user reviews,1,3,4
681840,True,7,Positive,8,2,10
681870,True,0,No user reviews,0,0,0
681900,True,0,1 user reviews,1,0,1
681920,True,0,No user reviews,0,0,0
681950,True,0,2 user reviews,2,0,2
681980,True,5,Mixed,6,5,11
681990,True,0,3 user reviews,3,0,3
682000,True,0,No user reviews,0,0,0
682010,True,0,1 user reviews,0,1,1
682020,True,0,7 user reviews,7,0,7
682070,True,0,7 user reviews,5,2,7
682080,True,7,Positive,21,4,25
682100,True,0,5 user reviews,0,5,5
682110,True,0,No user reviews,0,0,0
682130,True,8,Very Positive,593,103,696
682140,True,6,Mostly Positive,157,40,197
682150,True,6,Mostly Positive,20,8,28
682160,True,0,2 user reviews,2,0,2
682170,True,7,Positive,10,1,11
682180,True,0,5 user reviews,4,1,5
682230,True,7,Positive,25,1,26
682250,True,0,No user reviews,0,0,0
682270,True,0,4 user reviews,2,2,4
682280,True,0,2 user reviews,2,0,2
682290,True,0,No user reviews,0,0,0
682300,True,0,No user reviews,0,0,0
682310,True,0,No user reviews,0,0,0
682320,True,0,No user reviews,0,0,0
682340,True,0,No user reviews,0,0,0
682350,True,0,4 user reviews,2,2,4
682360,True,0,4 user reviews,2,2,4
682370,True,0,2 user reviews,1,1,2
682380,True,0,9 user reviews,5,4,9
682390,True,0,2 user reviews,1,1,2
682400,True,0,6 user reviews,4,2,6
682410,True,0,2 user reviews,2,0,2
682420,True,0,No user reviews,0,0,0
682450,True,8,Very Positive,121,17,138
682460,True,0,No user reviews,0,0,0
682470,True,0,6 user reviews,5,1,6
682480,True,0,5 user reviews,5,0,5
682490,True,0,1 user reviews,0,1,1
682500,True,0,8 user reviews,3,5,8
682510,True,0,7 user reviews,3,4,7
682520,True,0,1 user reviews,0,1,1
682530,True,6,Mostly Positive,206,69,275
682540,True,0,No user reviews,0,0,0
682560,True,0,No user reviews,0,0,0
682570,True,5,Mixed,87,39,126
682590,True,6,Mostly Positive,9,3,12
682600,True,0,1 user reviews,1,0,1
682610,True,6,Mostly Positive,9,3,12
682630,True,0,6 user reviews,4,2,6
682650,True,0,No user reviews,0,0,0
682670,True,0,No user reviews,0,0,0
682730,True,4,Mostly Negative,5,8,13
682740,True,0,No user reviews,0,0,0
682760,True,0,No user reviews,0,0,0
682770,True,0,No user reviews,0,0,0
682780,True,7,Positive,9,2,11
682790,True,0,9 user reviews,4,5,9
682810,True,0,3 user reviews,3,0,3
682820,True,0,No user reviews,0,0,0
682830,True,0,No user reviews,0,0,0
682840,True,0,No user reviews,0,0,0
682850,True,0,No user reviews,0,0,0
682870,True,0,6 user reviews,6,0,6
682880,True,0,1 user reviews,1,0,1
682890,True,0,No user reviews,0,0,0
682900,True,0,No user reviews,0,0,0
682910,True,5,Mixed,8,7,15
682920,True,0,No user reviews,0,0,0
682940,True,0,No user reviews,0,0,0
682950,True,0,No user reviews,0,0,0
682960,True,0,No user reviews,0,0,0
682970,True,0,No user reviews,0,0,0
682980,True,0,No user reviews,0,0,0
682990,True,8,Very Positive,2703,431,3134
683000,True,6,Mostly Positive,14,6,20
683010,True,0,No user reviews,0,0,0
683020,True,0,No user reviews,0,0,0
683030,True,0,No user reviews,0,0,0
683031,True,0,No user reviews,0,0,0
683032,True,0,No user reviews,0,0,0
683036,True,0,No user reviews,0,0,0
683037,True,0,No user reviews,0,0,0
683050,True,0,No user reviews,0,0,0
683060,True,0,No user reviews,0,0,0
683070,True,0,1 user reviews,1,0,1
683080,True,0,6 user reviews,1,5,6
683090,True,0,2 user reviews,2,0,2
683100,True,5,Mixed,59,48,107
683130,True,0,3 user reviews,3,0,3
683140,True,0,No user reviews,0,0,0
683150,True,0,6 user reviews,2,4,6
683180,True,5,Mixed,7,4,11
683190,True,0,No user reviews,0,0,0
683210,True,0,2 user reviews,0,2,2
683220,True,5,Mixed,9,6,15
683230,True,5,Mixed,5,7,12
683240,True,0,4 user reviews,4,0,4
683260,True,0,No user reviews,0,0,0
683270,True,0,2 user reviews,1,1,2
683280,True,6,Mostly Positive,55,18,73
683300,True,0,No user reviews,0,0,0
683310,True,0,4 user reviews,3,1,4
683320,True,9,Overwhelmingly Positive,9770,428,10198
683340,True,0,2 user reviews,2,0,2
683360,True,0,No user reviews,0,0,0
683370,True,0,No user reviews,0,0,0
683400,True,0,No user reviews,0,0,0
683420,True,7,Positive,13,0,13
683430,True,0,1 user reviews,1,0,1
683440,True,0,7 user reviews,4,3,7
683490,True,0,1 user reviews,1,0,1
683500,True,0,No user reviews,0,0,0
683510,True,0,No user reviews,0,0,0
683520,True,0,No user reviews,0,0,0
683530,True,0,9 user reviews,4,5,9
683540,True,0,No user reviews,0,0,0
683541,True,0,No user reviews,0,0,0
683542,True,0,No user reviews,0,0,0
683543,True,0,No user reviews,0,0,0
683544,True,0,No user reviews,0,0,0
683545,True,0,No user reviews,0,0,0
683546,True,0,No user reviews,0,0,0
683547,True,0,No user reviews,0,0,0
683548,True,0,No user reviews,0,0,0
683549,True,0,No user reviews,0,0,0
683550,True,0,No user reviews,0,0,0
683551,True,0,No user reviews,0,0,0
683580,True,0,No user reviews,0,0,0
683581,True,0,No user reviews,0,0,0
683582,True,0,No user reviews,0,0,0
683583,True,0,No user reviews,0,0,0
683584,True,0,No user reviews,0,0,0
683585,True,0,No user reviews,0,0,0
683586,True,0,No user reviews,0,0,0
683587,True,0,No user reviews,0,0,0
683588,True,0,No user reviews,0,0,0
683589,True,0,No user reviews,0,0,0
683590,True,0,No user reviews,0,0,0
683591,True,0,No user reviews,0,0,0
683600,True,4,Mostly Negative,3,12,15
683610,True,0,3 user reviews,3,0,3
683620,True,0,1 user reviews,1,0,1
683630,True,0,1 user reviews,1,0,1
683640,True,0,No user reviews,0,0,0
683641,True,0,No user reviews,0,0,0
683642,True,0,No user reviews,0,0,0
683643,True,0,No user reviews,0,0,0
683644,True,0,No user reviews,0,0,0
683645,True,0,No user reviews,0,0,0
683646,True,0,No user reviews,0,0,0
683647,True,0,No user reviews,0,0,0
683648,True,0,No user reviews,0,0,0
683649,True,0,No user reviews,0,0,0
683650,True,0,No user reviews,0,0,0
683651,True,0,No user reviews,0,0,0
683660,True,0,No user reviews,0,0,0
683670,True,0,No user reviews,0,0,0
683680,True,0,No user reviews,0,0,0
683690,True,5,Mixed,10,11,21
683730,True,0,4 user reviews,3,1,4
683740,True,0,1 user reviews,0,1,1
683760,True,6,Mostly Positive,9,3,12
683770,True,6,Mostly Positive,23,8,31
683790,True,0,9 user reviews,6,3,9
683810,True,0,3 user reviews,0,3,3
683830,True,5,Mixed,18,11,29
683840,True,0,1 user reviews,1,0,1
683850,True,6,Mostly Positive,29,9,38
683870,True,7,Positive,10,0,10
683880,True,7,Positive,10,0,10
683890,True,7,Positive,10,0,10
683900,True,8,Very Positive,464,84,548
683910,True,0,5 user reviews,4,1,5
683930,True,0,No user reviews,0,0,0
683940,True,6,Mostly Positive,99,28,127
683960,True,0,No user reviews,0,0,0
683970,True,0,8 user reviews,7,1,8
683990,True,0,1 user reviews,1,0,1
683991,True,0,1 user reviews,1,0,1
683992,True,0,1 user reviews,1,0,1
683993,True,0,1 user reviews,1,0,1
683994,True,0,2 user reviews,2,0,2
684000,True,7,Positive,10,1,11
684040,True,5,Mixed,11,8,19
684050,True,6,Mostly Positive,52,21,73
684060,True,7,Positive,10,2,12
684070,True,0,No user reviews,0,0,0
684080,True,0,No user reviews,0,0,0
684081,True,0,No user reviews,0,0,0
684082,True,0,No user reviews,0,0,0
684083,True,0,No user reviews,0,0,0
684084,True,0,No user reviews,0,0,0
684085,True,0,No user reviews,0,0,0
684086,True,0,No user reviews,0,0,0
684087,True,0,No user reviews,0,0,0
684088,True,0,No user reviews,0,0,0
684089,True,0,No user reviews,0,0,0
684090,True,0,No user reviews,0,0,0
684091,True,0,No user reviews,0,0,0
684100,True,0,No user reviews,0,0,0
684110,True,0,No user reviews,0,0,0
684130,True,0,9 user reviews,4,5,9
684140,True,0,No user reviews,0,0,0
684170,True,0,1 user reviews,0,1,1
684200,True,5,Mixed,8,4,12
684210,True,0,No user reviews,0,0,0
684230,True,0,7 user reviews,6,1,7
684240,True,0,No user reviews,0,0,0
684241,True,0,No user reviews,0,0,0
684250,True,0,No user reviews,0,0,0
684260,True,0,1 user reviews,1,0,1
684270,True,8,Very Positive,142,11,153
684280,True,0,No user reviews,0,0,0
684290,True,0,No user reviews,0,0,0
684300,True,5,Mixed,15,15,30
684320,True,7,Positive,11,1,12
684330,True,0,3 user reviews,3,0,3
684340,True,0,2 user reviews,1,1,2
684360,True,0,No user reviews,0,0,0
684380,True,0,No user reviews,0,0,0
684400,True,0,No user reviews,0,0,0
684410,True,8,Very Positive,1019,116,1135
684420,True,0,8 user reviews,3,5,8
684430,True,0,9 user reviews,9,0,9
684450,True,5,Mixed,78,50,128
684460,True,0,No user reviews,0,0,0
684470,True,0,1 user reviews,1,0,1
684490,True,0,No user reviews,0,0,0
684510,True,0,4 user reviews,2,2,4
684530,True,7,Positive,28,0,28
684560,True,0,4 user reviews,1,3,4
684570,True,0,4 user reviews,3,1,4
684580,True,5,Mixed,390,212,602
684590,True,7,Positive,11,1,12
684610,True,0,No user reviews,0,0,0
684620,True,6,Mostly Positive,8,3,11
684630,True,8,Very Positive,300,15,315
684650,True,0,3 user reviews,2,1,3
684680,True,7,Positive,40,2,42
684690,True,7,Positive,12,0,12
684700,True,5,Mixed,8,7,15
684710,True,0,No user reviews,0,0,0
684720,True,5,Mixed,29,13,42
684730,True,0,No user reviews,0,0,0
684740,True,0,No user reviews,0,0,0
684760,True,0,No user reviews,0,0,0
684770,True,0,3 user reviews,2,1,3
684780,True,0,No user reviews,0,0,0
684800,True,0,No user reviews,0,0,0
684820,True,0,2 user reviews,1,1,2
684830,True,0,No user reviews,0,0,0
684840,True,0,No user reviews,0,0,0
684850,True,5,Mixed,10,12,22
684851,True,0,9 user reviews,5,4,9
684870,True,0,3 user reviews,3,0,3
684930,True,0,4 user reviews,1,3,4
684940,True,6,Mostly Positive,8,3,11
684970,True,0,3 user reviews,1,2,3
684980,True,0,5 user reviews,4,1,5
685040,True,0,No user reviews,0,0,0
685050,True,0,8 user reviews,6,2,8
685060,True,0,7 user reviews,7,0,7
685070,True,0,No user reviews,0,0,0
685080,True,0,2 user reviews,0,2,2
685100,True,0,No user reviews,0,0,0
685110,True,0,No user reviews,0,0,0
685120,True,0,1 user reviews,1,0,1
685130,True,0,3 user reviews,2,1,3
685140,True,0,No user reviews,0,0,0
685180,True,0,No user reviews,0,0,0
685200,True,0,No user reviews,0,0,0
685220,True,0,No user reviews,0,0,0
685230,True,0,2 user reviews,1,1,2
685240,True,8,Very Positive,79,6,85
685250,True,0,No user reviews,0,0,0
685300,True,7,Positive,36,2,38
685310,True,0,No user reviews,0,0,0
685320,True,0,No user reviews,0,0,0
685330,True,0,No user reviews,0,0,0
685340,True,8,Very Positive,61,12,73
685360,True,0,No user reviews,0,0,0
685370,True,0,8 user reviews,3,5,8
685380,True,0,No user reviews,0,0,0
685400,True,8,Very Positive,150,7,157
685420,True,0,No user reviews,0,0,0
685430,True,0,4 user reviews,1,3,4
685450,True,0,No user reviews,0,0,0
685480,True,0,No user reviews,0,0,0
685500,True,0,2 user reviews,1,1,2
685501,True,0,No user reviews,0,0,0
685502,True,0,No user reviews,0,0,0
685503,True,0,No user reviews,0,0,0
685504,True,0,No user reviews,0,0,0
685505,True,0,No user reviews,0,0,0
685506,True,0,No user reviews,0,0,0
685507,True,0,No user reviews,0,0,0
685508,True,0,No user reviews,0,0,0
685509,True,0,No user reviews,0,0,0
685510,True,0,No user reviews,0,0,0
685511,True,0,No user reviews,0,0,0
685512,True,0,No user reviews,0,0,0
685513,True,0,No user reviews,0,0,0
685514,True,0,No user reviews,0,0,0
685515,True,0,No user reviews,0,0,0
685516,True,0,No user reviews,0,0,0
685517,True,0,No user reviews,0,0,0
685518,True,0,No user reviews,0,0,0
685519,True,0,No user reviews,0,0,0
685520,True,0,No user reviews,0,0,0
685521,True,0,No user reviews,0,0,0
685522,True,0,No user reviews,0,0,0
685523,True,0,No user reviews,0,0,0
685524,True,0,No user reviews,0,0,0
685525,True,0,No user reviews,0,0,0
685526,True,0,No user reviews,0,0,0
685527,True,0,No user reviews,0,0,0
685528,True,0,No user reviews,0,0,0
685529,True,0,No user reviews,0,0,0
685530,True,0,No user reviews,0,0,0
685531,True,0,No user reviews,0,0,0
685532,True,0,No user reviews,0,0,0
685533,True,0,No user reviews,0,0,0
685560,True,0,No user reviews,0,0,0
685570,True,0,No user reviews,0,0,0
685580,True,0,No user reviews,0,0,0
685581,True,0,No user reviews,0,0,0
685582,True,0,No user reviews,0,0,0
685583,True,0,No user reviews,0,0,0
685584,True,0,No user reviews,0,0,0
685585,True,0,No user reviews,0,0,0
685586,True,0,No user reviews,0,0,0
685587,True,0,No user reviews,0,0,0
685588,True,0,No user reviews,0,0,0
685589,True,0,No user reviews,0,0,0
685680,True,8,Very Positive,90,17,107
685690,True,8,Very Positive,118,20,138
685700,True,0,No user reviews,0,0,0
685720,True,0,No user reviews,0,0,0
685730,True,0,1 user reviews,0,1,1
685740,True,0,No user reviews,0,0,0
685750,True,5,Mixed,9,13,22
685760,True,0,2 user reviews,1,1,2
685770,True,0,4 user reviews,2,2,4
685790,True,4,Mostly Negative,3,11,14
685800,True,0,6 user reviews,5,1,6
685820,True,0,2 user reviews,2,0,2
685830,True,0,No user reviews,0,0,0
685840,True,0,3 user reviews,3,0,3
685850,True,0,2 user reviews,2,0,2
685870,True,0,No user reviews,0,0,0
685910,True,0,5 user reviews,5,0,5
685920,True,0,3 user reviews,3,0,3
685970,True,0,1 user reviews,0,1,1
685990,True,3,Negative,5,22,27
686000,True,0,1 user reviews,1,0,1
686010,True,0,3 user reviews,3,0,3
686030,True,7,Positive,12,0,12
686040,True,0,3 user reviews,2,1,3
686070,True,0,No user reviews,0,0,0
686080,True,0,No user reviews,0,0,0
686090,True,5,Mixed,11,6,17
686100,True,0,1 user reviews,0,1,1
686110,True,0,2 user reviews,1,1,2
686130,True,0,1 user reviews,1,0,1
686140,True,0,No user reviews,0,0,0
686170,True,0,No user reviews,0,0,0
686180,True,5,Mixed,38,37,75
686190,True,5,Mixed,70,40,110
686200,True,8,Very Positive,931,63,994
686240,True,0,1 user reviews,0,1,1
686260,True,5,Mixed,247,162,409
686270,True,0,No user reviews,0,0,0
686280,True,0,8 user reviews,6,2,8
686300,True,0,1 user reviews,1,0,1
686340,True,0,No user reviews,0,0,0
686350,True,0,No user reviews,0,0,0
686351,True,0,No user reviews,0,0,0
686360,True,6,Mostly Positive,24,8,32
686370,True,0,No user reviews,0,0,0
686380,True,0,5 user reviews,1,4,5
686390,True,0,2 user reviews,1,1,2
686400,True,0,1 user reviews,1,0,1
686401,True,0,4 user reviews,3,1,4
686402,True,0,2 user reviews,2,0,2
686403,True,0,2 user reviews,2,0,2
686404,True,0,1 user reviews,1,0,1
686405,True,0,3 user reviews,3,0,3
686410,True,0,3 user reviews,2,1,3
686430,True,0,4 user reviews,4,0,4
686440,True,6,Mostly Positive,59,16,75
686450,True,7,Positive,18,0,18
686460,True,0,No user reviews,0,0,0
686490,True,0,6 user reviews,0,6,6
686500,True,5,Mixed,16,10,26
686510,True,0,6 user reviews,6,0,6
686520,True,7,Positive,10,0,10
686550,True,5,Mixed,6,7,13
686560,True,0,No user reviews,0,0,0
686570,True,5,Mixed,17,10,27
686580,True,0,4 user reviews,4,0,4
686600,True,4,Mostly Negative,51,87,138
686610,True,0,1 user reviews,0,1,1
686620,True,0,4 user reviews,2,2,4
686630,True,0,1 user reviews,1,0,1
686640,True,0,8 user reviews,3,5,8
686660,True,0,No user reviews,0,0,0
686670,True,0,No user reviews,0,0,0
686680,True,6,Mostly Positive,237,64,301
686700,True,0,No user reviews,0,0,0
686710,True,5,Mixed,13,17,30
686711,True,5,Mixed,10,7,17
686720,True,7,Positive,25,6,31
686740,True,0,5 user reviews,4,1,5
686760,True,8,Very Positive,53,7,60
686770,True,7,Positive,38,0,38
686790,True,4,Mostly Negative,6,10,16
686800,True,5,Mixed,12,6,18
686810,True,8,Very Positive,9867,1558,11425
686840,True,0,No user reviews,0,0,0
686870,True,0,No user reviews,0,0,0
686880,True,0,1 user reviews,1,0,1
686900,True,6,Mostly Positive,40,11,51
686910,True,0,3 user reviews,2,1,3
686940,True,0,No user reviews,0,0,0
686950,True,0,No user reviews,0,0,0
686970,True,0,1 user reviews,1,0,1
686980,True,0,1 user reviews,1,0,1
686990,True,0,1 user reviews,1,0,1
687000,True,0,1 user reviews,1,0,1
687010,True,0,1 user reviews,1,0,1
687020,True,0,1 user reviews,1,0,1
687030,True,0,1 user reviews,1,0,1
687040,True,0,1 user reviews,1,0,1
687050,True,0,1 user reviews,1,0,1
687060,True,0,1 user reviews,1,0,1
687070,True,0,1 user reviews,1,0,1
687080,True,0,1 user reviews,1,0,1
687100,True,0,1 user reviews,1,0,1
687110,True,0,1 user reviews,1,0,1
687120,True,0,1 user reviews,1,0,1
687130,True,0,1 user reviews,1,0,1
687140,True,0,No user reviews,0,0,0
687150,True,0,1 user reviews,1,0,1
687160,True,0,1 user reviews,1,0,1
687170,True,0,1 user reviews,1,0,1
687180,True,0,1 user reviews,1,0,1
687190,True,0,1 user reviews,1,0,1
687200,True,0,1 user reviews,1,0,1
687210,True,0,1 user reviews,1,0,1
687220,True,0,1 user reviews,1,0,1
687230,True,0,1 user reviews,1,0,1
687251,True,4,Mostly Negative,3,7,10
687260,True,8,Very Positive,335,38,373
687270,True,0,2 user reviews,1,1,2
687280,True,0,No user reviews,0,0,0
687310,True,6,Mostly Positive,7,3,10
687320,True,0,No user reviews,0,0,0
687340,True,0,No user reviews,0,0,0
687360,True,7,Positive,11,0,11
687390,True,0,2 user reviews,0,2,2
687420,True,0,No user reviews,0,0,0
687440,True,0,No user reviews,0,0,0
687460,True,0,No user reviews,0,0,0
687470,True,0,No user reviews,0,0,0
687480,True,5,Mixed,10,9,19
687490,True,5,Mixed,11,9,20
687500,True,5,Mixed,22,18,40
687510,True,0,5 user reviews,4,1,5
687520,True,0,No user reviews,0,0,0
687540,True,6,Mostly Positive,39,14,53
687550,True,0,No user reviews,0,0,0
687560,True,0,9 user reviews,8,1,9
687570,True,0,4 user reviews,4,0,4
687580,True,0,No user reviews,0,0,0
687590,True,0,1 user reviews,1,0,1
687600,True,0,4 user reviews,2,2,4
687610,True,0,3 user reviews,3,0,3
687630,True,0,No user reviews,0,0,0
687640,True,0,3 user reviews,0,3,3
687650,True,0,No user reviews,0,0,0
687660,True,0,No user reviews,0,0,0
687661,True,0,No user reviews,0,0,0
687720,True,0,5 user reviews,4,1,5
687730,True,0,No user reviews,0,0,0
687750,True,5,Mixed,49,36,85
687760,True,0,7 user reviews,3,4,7
687780,True,0,No user reviews,0,0,0
687820,True,0,No user reviews,0,0,0
687830,True,8,Very Positive,57,7,64
687850,True,0,8 user reviews,5,3,8
687870,True,0,No user reviews,0,0,0
687890,True,0,7 user reviews,5,2,7
687900,True,5,Mixed,5,5,10
687910,True,0,2 user reviews,2,0,2
687920,True,6,Mostly Positive,124,46,170
687930,True,0,No user reviews,0,0,0
687950,True,0,No user reviews,0,0,0
687980,True,0,No user reviews,0,0,0
688000,True,0,9 user reviews,5,4,9
688010,True,0,No user reviews,0,0,0
688020,True,0,8 user reviews,4,4,8
688030,True,0,No user reviews,0,0,0
688050,True,0,1 user reviews,1,0,1
688060,True,8,Very Positive,296,29,325
688070,True,7,Positive,12,2,14
688090,True,0,6 user reviews,2,4,6
688100,True,0,No user reviews,0,0,0
688110,True,0,2 user reviews,2,0,2
688120,True,0,1 user reviews,1,0,1
688130,True,8,Very Positive,1008,174,1182
688140,True,5,Mixed,54,27,81
688150,True,0,2 user reviews,0,2,2
688170,True,0,1 user reviews,1,0,1
688180,True,0,1 user reviews,0,1,1
688200,True,0,1 user reviews,0,1,1
688210,True,0,No user reviews,0,0,0
688240,True,0,No user reviews,0,0,0
688241,True,0,No user reviews,0,0,0
688242,True,0,No user reviews,0,0,0
688243,True,0,No user reviews,0,0,0
688244,True,0,No user reviews,0,0,0
688245,True,0,No user reviews,0,0,0
688246,True,0,No user reviews,0,0,0
688247,True,0,No user reviews,0,0,0
688248,True,0,No user reviews,0,0,0
688249,True,0,No user reviews,0,0,0
688250,True,0,No user reviews,0,0,0
688251,True,0,No user reviews,0,0,0
688252,True,0,No user reviews,0,0,0
688253,True,0,No user reviews,0,0,0
688254,True,0,No user reviews,0,0,0
688255,True,0,No user reviews,0,0,0
688256,True,0,No user reviews,0,0,0
688257,True,0,No user reviews,0,0,0
688258,True,0,No user reviews,0,0,0
688259,True,0,No user reviews,0,0,0
688260,True,5,Mixed,25,12,37
688270,True,0,No user reviews,0,0,0
688271,True,0,No user reviews,0,0,0
688272,True,0,No user reviews,0,0,0
688273,True,0,1 user reviews,1,0,1
688274,True,0,No user reviews,0,0,0
688280,True,0,1 user reviews,1,0,1
688290,True,0,1 user reviews,1,0,1
688310,True,0,1 user reviews,1,0,1
688330,True,0,No user reviews,0,0,0
688340,True,0,No user reviews,0,0,0
688350,True,0,7 user reviews,0,7,7
688370,True,0,1 user reviews,1,0,1
688380,True,7,Positive,12,2,14
688400,True,7,Positive,11,1,12
688410,True,7,Positive,30,2,32
688420,True,8,Very Positive,1268,143,1411
688430,True,0,No user reviews,0,0,0
688450,True,0,3 user reviews,1,2,3
688460,True,0,No user reviews,0,0,0
688470,True,6,Mostly Positive,29,12,41
688480,True,5,Mixed,118,79,197
688500,True,0,No user reviews,0,0,0
688510,True,0,No user reviews,0,0,0
688520,True,0,No user reviews,0,0,0
688530,True,0,No user reviews,0,0,0
688570,True,5,Mixed,9,10,19
688620,True,0,2 user reviews,1,1,2
688630,True,0,1 user reviews,0,1,1
688650,True,0,No user reviews,0,0,0
688660,True,5,Mixed,29,32,61
688680,True,6,Mostly Positive,12,4,16
688690,True,0,5 user reviews,4,1,5
688700,True,7,Positive,13,0,13
688720,True,0,5 user reviews,5,0,5
688730,True,0,No user reviews,0,0,0
688740,True,8,Very Positive,61,2,63
688750,True,0,1 user reviews,0,1,1
688770,True,8,Very Positive,47,3,50
688780,True,0,1 user reviews,1,0,1
688790,True,0,3 user reviews,3,0,3
688800,True,0,9 user reviews,7,2,9
688810,True,0,No user reviews,0,0,0
688820,True,0,No user reviews,0,0,0
688830,True,0,No user reviews,0,0,0
688860,True,0,3 user reviews,3,0,3
688870,True,0,No user reviews,0,0,0
688880,True,5,Mixed,6,8,14
688890,True,0,No user reviews,0,0,0
688900,True,0,1 user reviews,1,0,1
688910,True,0,No user reviews,0,0,0
688920,True,0,No user reviews,0,0,0
688930,True,0,7 user reviews,6,1,7
688940,True,0,No user reviews,0,0,0
688960,True,0,No user reviews,0,0,0
688970,True,0,No user reviews,0,0,0
688980,True,0,No user reviews,0,0,0
689000,True,0,7 user reviews,5,2,7
689020,True,0,5 user reviews,4,1,5
689030,True,0,1 user reviews,0,1,1
689040,True,0,9 user reviews,8,1,9
689050,True,0,2 user reviews,1,1,2
689070,True,0,No user reviews,0,0,0
689090,True,0,No user reviews,0,0,0
689100,True,0,3 user reviews,2,1,3
689120,True,0,1 user reviews,1,0,1
689130,True,0,No user reviews,0,0,0
689170,True,0,9 user reviews,7,2,9
689180,True,5,Mixed,11,5,16
689210,True,0,1 user reviews,1,0,1
689220,True,0,No user reviews,0,0,0
689270,True,0,1 user reviews,0,1,1
689290,True,7,Positive,13,1,14
689300,True,0,No user reviews,0,0,0
689340,True,0,6 user reviews,4,2,6
689350,True,4,Mostly Negative,7,19,26
689360,True,4,Mostly Negative,5,10,15
689390,True,0,No user reviews,0,0,0
689400,True,0,No user reviews,0,0,0
689420,True,0,No user reviews,0,0,0
689430,True,0,No user reviews,0,0,0
689460,True,0,No user reviews,0,0,0
689470,True,7,Positive,12,0,12
689480,True,0,2 user reviews,0,2,2
689490,True,0,No user reviews,0,0,0
689510,True,0,No user reviews,0,0,0
689520,True,4,Mostly Negative,6,15,21
689550,True,0,1 user reviews,1,0,1
689570,True,7,Positive,9,1,10
689580,True,0,No user reviews,0,0,0
689590,True,0,No user reviews,0,0,0
689600,True,0,No user reviews,0,0,0
689610,True,0,2 user reviews,0,2,2
689620,True,5,Mixed,32,28,60
689630,True,0,No user reviews,0,0,0
689650,True,5,Mixed,31,41,72
689660,True,0,1 user reviews,0,1,1
689680,True,0,No user reviews,0,0,0
689690,True,0,No user reviews,0,0,0
689700,True,5,Mixed,8,5,13
689710,True,7,Positive,20,1,21
689720,True,0,No user reviews,0,0,0
689740,True,0,4 user reviews,4,0,4
689780,True,0,No user reviews,0,0,0
689790,True,5,Mixed,69,43,112
689800,True,5,Mixed,9,13,22
689810,True,5,Mixed,9,5,14
689820,True,0,No user reviews,0,0,0
689830,True,0,No user reviews,0,0,0
689850,True,0,No user reviews,0,0,0
689860,True,6,Mostly Positive,13,5,18
689870,True,7,Positive,8,2,10
689880,True,0,No user reviews,0,0,0
689890,True,0,No user reviews,0,0,0
689900,True,8,Very Positive,86,14,100
689910,True,8,Very Positive,152,12,164
689920,True,6,Mostly Positive,7,3,10
689950,True,7,Positive,10,0,10
689980,True,0,No user reviews,0,0,0
690000,True,0,2 user reviews,1,1,2
690030,True,0,No user reviews,0,0,0
690040,True,8,Very Positive,1952,419,2371
690060,True,0,No user reviews,0,0,0
690080,True,0,3 user reviews,2,1,3
690110,True,0,No user reviews,0,0,0
690120,True,7,Positive,23,3,26
690130,True,0,3 user reviews,3,0,3
690140,True,6,Mostly Positive,78,30,108
690150,True,6,Mostly Positive,19,5,24
690180,True,7,Positive,29,1,30
690200,True,0,6 user reviews,6,0,6
690210,True,0,No user reviews,0,0,0
690220,True,0,1 user reviews,1,0,1
690240,True,5,Mixed,10,6,16
690250,True,0,5 user reviews,2,3,5
690260,True,0,1 user reviews,1,0,1
690280,True,0,7 user reviews,4,3,7
690300,True,0,No user reviews,0,0,0
690310,True,0,7 user reviews,6,1,7
690330,True,0,2 user reviews,2,0,2
690350,True,0,5 user reviews,3,2,5
690370,True,0,No user reviews,0,0,0
690380,True,0,No user reviews,0,0,0
690400,True,7,Positive,13,1,14
690410,True,0,1 user reviews,1,0,1
690420,True,7,Positive,49,0,49
690430,True,0,2 user reviews,1,1,2
690440,True,0,2 user reviews,2,0,2
690450,True,0,No user reviews,0,0,0
690460,True,0,6 user reviews,2,4,6
690500,True,0,No user reviews,0,0,0
690510,True,0,No user reviews,0,0,0
690530,True,5,Mixed,115,74,189
690540,True,0,No user reviews,0,0,0
690550,True,7,Positive,12,1,13
690560,True,8,Very Positive,65,12,77
690570,True,0,1 user reviews,1,0,1
690580,True,0,4 user reviews,0,4,4
690610,True,0,1 user reviews,0,1,1
690620,True,8,Very Positive,47,10,57
690630,True,7,Positive,11,0,11
690640,True,8,Very Positive,1234,108,1342
690660,True,0,1 user reviews,1,0,1
690670,True,0,4 user reviews,1,3,4
690690,True,0,No user reviews,0,0,0
690700,True,0,No user reviews,0,0,0
690710,True,0,9 user reviews,9,0,9
690720,True,0,No user reviews,0,0,0
690730,True,0,2 user reviews,1,1,2
690740,True,5,Mixed,24,17,41
690780,True,0,No user reviews,0,0,0
690790,True,8,Very Positive,3556,846,4402
690800,True,0,No user reviews,0,0,0
690810,True,5,Mixed,175,137,312
690820,True,0,2 user reviews,0,2,2
690830,True,8,Very Positive,2621,436,3057
690840,True,0,1 user reviews,0,1,1
690850,True,0,2 user reviews,2,0,2
690860,True,0,No user reviews,0,0,0
690880,True,0,No user reviews,0,0,0
690930,True,0,No user reviews,0,0,0
690950,True,0,3 user reviews,3,0,3
690980,True,0,No user reviews,0,0,0
690990,True,0,No user reviews,0,0,0
691020,True,0,1 user reviews,0,1,1
691080,True,4,Mostly Negative,7,22,29
691110,True,7,Positive,9,1,10
691120,True,0,2 user reviews,2,0,2
691140,True,0,4 user reviews,3,1,4
691150,True,8,Very Positive,46,4,50
691160,True,8,Very Positive,212,18,230
691190,True,5,Mixed,14,8,22
691210,True,0,No user reviews,0,0,0
691220,True,0,2 user reviews,1,1,2
691240,True,7,Positive,8,2,10
691250,True,0,9 user reviews,8,1,9
691260,True,8,Very Positive,378,38,416
691280,True,5,Mixed,85,41,126
691290,True,0,No user reviews,0,0,0
691300,True,0,3 user reviews,3,0,3
691310,True,0,3 user reviews,2,1,3
691320,True,6,Mostly Positive,182,57,239
691390,True,6,Mostly Positive,16,6,22
691400,True,0,No user reviews,0,0,0
691420,True,0,2 user reviews,0,2,2
691430,True,7,Positive,20,0,20
691440,True,0,2 user reviews,2,0,2
691441,True,0,5 user reviews,5,0,5
691450,True,8,Very Positive,459,10,469
691460,True,0,No user reviews,0,0,0
691480,True,0,2 user reviews,2,0,2
691490,True,0,6 user reviews,6,0,6
691500,True,0,1 user reviews,1,0,1
691510,True,0,3 user reviews,1,2,3
691520,True,0,No user reviews,0,0,0
691530,True,0,No user reviews,0,0,0
691540,True,0,No user reviews,0,0,0
691560,True,0,No user reviews,0,0,0
691570,True,0,2 user reviews,2,0,2
691580,True,0,4 user reviews,4,0,4
691590,True,5,Mixed,6,6,12
691600,True,0,4 user reviews,4,0,4
691620,True,0,5 user reviews,4,1,5
691630,True,5,Mixed,34,22,56
691640,True,0,No user reviews,0,0,0
691650,True,0,2 user reviews,2,0,2
691680,True,0,2 user reviews,2,0,2
691690,True,5,Mixed,328,161,489
691700,True,0,2 user reviews,1,1,2
691720,True,0,6 user reviews,4,2,6
691730,True,0,No user reviews,0,0,0
691750,True,0,6 user reviews,4,2,6
691770,True,8,Very Positive,108,6,114
691790,True,0,No user reviews,0,0,0
691820,True,0,4 user reviews,3,1,4
691830,True,8,Very Positive,96,18,114
691850,True,0,No user reviews,0,0,0
691860,True,0,5 user reviews,3,2,5
691890,True,0,5 user reviews,4,1,5
691910,True,0,1 user reviews,1,0,1
691930,True,0,No user reviews,0,0,0
691950,True,0,No user reviews,0,0,0
691960,True,0,No user reviews,0,0,0
691961,True,0,No user reviews,0,0,0
691970,True,0,No user reviews,0,0,0
691980,True,0,7 user reviews,0,7,7
691990,True,0,No user reviews,0,0,0
692010,True,0,4 user reviews,2,2,4
692030,True,5,Mixed,27,35,62
692050,True,0,No user reviews,0,0,0
692060,True,0,No user reviews,0,0,0
692080,True,7,Positive,18,1,19
692090,True,0,No user reviews,0,0,0
692100,True,8,Very Positive,130,32,162
692110,True,0,1 user reviews,1,0,1
692120,True,0,6 user reviews,5,1,6
692130,True,0,No user reviews,0,0,0
692140,True,0,1 user reviews,1,0,1
692150,True,0,2 user reviews,2,0,2
692151,True,7,Positive,11,0,11
692152,True,0,1 user reviews,1,0,1
692153,True,0,4 user reviews,4,0,4
692170,True,0,4 user reviews,0,4,4
692190,True,0,6 user reviews,5,1,6
692200,True,5,Mixed,19,9,28
692240,True,0,1 user reviews,0,1,1
692270,True,0,No user reviews,0,0,0
692300,True,0,No user reviews,0,0,0
692310,True,0,1 user reviews,0,1,1
692330,True,0,No user reviews,0,0,0
692360,True,6,Mostly Positive,18,6,24
692500,True,0,1 user reviews,1,0,1
692510,True,7,Positive,12,0,12
692520,True,0,No user reviews,0,0,0
692530,True,0,2 user reviews,1,1,2
692590,True,0,7 user reviews,3,4,7
692610,True,0,No user reviews,0,0,0
692630,True,0,2 user reviews,0,2,2
692660,True,0,2 user reviews,2,0,2
692680,True,0,3 user reviews,3,0,3
692690,True,7,Positive,41,7,48
692710,True,0,No user reviews,0,0,0
692770,True,0,3 user reviews,3,0,3
692780,True,4,Mostly Negative,3,9,12
692790,True,0,7 user reviews,3,4,7
692830,True,5,Mixed,9,8,17
692840,True,5,Mixed,153,204,357
692850,True,9,Overwhelmingly Positive,6665,294,6959
692890,True,8,Very Positive,338,15,353
692920,True,0,No user reviews,0,0,0
692930,True,6,Mostly Positive,31,8,39
692950,True,0,6 user reviews,6,0,6
692960,True,0,No user reviews,0,0,0
693000,True,0,2 user reviews,1,1,2
693020,True,0,No user reviews,0,0,0
693030,True,0,5 user reviews,5,0,5
693050,True,0,6 user reviews,1,5,6
693060,True,0,No user reviews,0,0,0
693070,True,0,No user reviews,0,0,0
693080,True,0,No user reviews,0,0,0
693090,True,0,6 user reviews,3,3,6
693150,True,0,No user reviews,0,0,0
693160,True,0,9 user reviews,2,7,9
693170,True,8,Very Positive,95,1,96
693180,True,5,Mixed,7,6,13
693190,True,0,4 user reviews,1,3,4
693200,True,0,No user reviews,0,0,0
693210,True,6,Mostly Positive,15,5,20
693220,True,0,No user reviews,0,0,0
693240,True,0,8 user reviews,4,4,8
693250,True,5,Mixed,16,10,26
693280,True,0,2 user reviews,0,2,2
693290,True,0,No user reviews,0,0,0
693300,True,0,2 user reviews,1,1,2
693310,True,0,2 user reviews,1,1,2
693320,True,0,3 user reviews,2,1,3
693330,True,0,2 user reviews,2,0,2
693380,True,0,5 user reviews,5,0,5
693400,True,0,3 user reviews,0,3,3
693430,True,0,1 user reviews,0,1,1
693450,True,7,Positive,11,0,11
693470,True,0,8 user reviews,7,1,8
693500,True,0,1 user reviews,0,1,1
693510,True,0,2 user reviews,2,0,2
693520,True,0,No user reviews,0,0,0
693560,True,0,4 user reviews,4,0,4
693580,True,5,Mixed,47,33,80
693590,True,0,No user reviews,0,0,0
693600,True,0,No user reviews,0,0,0
693601,True,0,No user reviews,0,0,0
693602,True,0,No user reviews,0,0,0
693603,True,0,No user reviews,0,0,0
693604,True,0,No user reviews,0,0,0
693605,True,0,No user reviews,0,0,0
693606,True,0,No user reviews,0,0,0
693607,True,0,No user reviews,0,0,0
693608,True,0,No user reviews,0,0,0
693609,True,0,No user reviews,0,0,0
693610,True,0,No user reviews,0,0,0
693611,True,0,No user reviews,0,0,0
693612,True,0,No user reviews,0,0,0
693613,True,0,No user reviews,0,0,0
693614,True,0,No user reviews,0,0,0
693615,True,0,No user reviews,0,0,0
693616,True,0,No user reviews,0,0,0
693617,True,0,No user reviews,0,0,0
693618,True,0,No user reviews,0,0,0
693619,True,0,No user reviews,0,0,0
693620,True,0,No user reviews,0,0,0
693621,True,0,No user reviews,0,0,0
693622,True,0,No user reviews,0,0,0
693623,True,0,No user reviews,0,0,0
693624,True,0,No user reviews,0,0,0
693625,True,0,No user reviews,0,0,0
693626,True,0,No user reviews,0,0,0
693627,True,0,No user reviews,0,0,0
693628,True,0,No user reviews,0,0,0
693629,True,0,No user reviews,0,0,0
693630,True,0,No user reviews,0,0,0
693631,True,0,No user reviews,0,0,0
693632,True,0,No user reviews,0,0,0
693633,True,0,No user reviews,0,0,0
693634,True,0,No user reviews,0,0,0
693635,True,0,No user reviews,0,0,0
693636,True,0,No user reviews,0,0,0
693637,True,0,No user reviews,0,0,0
693638,True,0,No user reviews,0,0,0
693639,True,0,No user reviews,0,0,0
693641,True,0,No user reviews,0,0,0
693642,True,0,No user reviews,0,0,0
693643,True,0,No user reviews,0,0,0
693644,True,0,No user reviews,0,0,0
693650,True,0,5 user reviews,5,0,5
693660,True,0,No user reviews,0,0,0
693670,True,6,Mostly Positive,19,8,27
693700,True,8,Very Positive,89,15,104
693710,True,0,1 user reviews,1,0,1
693750,True,5,Mixed,39,26,65
693760,True,0,No user reviews,0,0,0
693790,True,0,8 user reviews,4,4,8
693800,True,5,Mixed,15,13,28
693810,True,0,No user reviews,0,0,0
693820,True,0,1 user reviews,0,1,1
693830,True,0,3 user reviews,2,1,3
693880,True,4,Mostly Negative,5,10,15
693890,True,5,Mixed,7,5,12
693900,True,0,No user reviews,0,0,0
693910,True,0,2 user reviews,1,1,2
693950,True,0,5 user reviews,5,0,5
693960,True,6,Mostly Positive,17,7,24
693990,True,0,No user reviews,0,0,0
694050,True,0,2 user reviews,1,1,2
694070,True,0,5 user reviews,3,2,5
694080,True,0,No user reviews,0,0,0
694090,True,5,Mixed,59,34,93
694100,True,0,No user reviews,0,0,0
694110,True,0,No user reviews,0,0,0
694130,True,0,No user reviews,0,0,0
694140,True,0,4 user reviews,2,2,4
694150,True,0,2 user reviews,2,0,2
694160,True,0,No user reviews,0,0,0
694180,True,0,No user reviews,0,0,0
694190,True,0,8 user reviews,4,4,8
694200,True,0,No user reviews,0,0,0
694210,True,0,1 user reviews,1,0,1
694230,True,0,No user reviews,0,0,0
694240,True,0,No user reviews,0,0,0
694300,True,0,No user reviews,0,0,0
694350,True,0,No user reviews,0,0,0
694360,True,0,No user reviews,0,0,0
694370,True,8,Very Positive,64,4,68
694380,True,0,1 user reviews,1,0,1
694390,True,0,6 user reviews,6,0,6
694400,True,0,No user reviews,0,0,0
694420,True,0,1 user reviews,1,0,1
694430,True,0,3 user reviews,0,3,3
694440,True,0,6 user reviews,0,6,6
694450,True,0,No user reviews,0,0,0
694460,True,0,No user reviews,0,0,0
694470,True,0,5 user reviews,1,4,5
694480,True,6,Mostly Positive,10,4,14
694490,True,3,Negative,3,13,16
694500,True,8,Very Positive,239,49,288
694510,True,0,1 user reviews,1,0,1
694520,True,0,7 user reviews,6,1,7
694550,True,0,No user reviews,0,0,0
694610,True,0,No user reviews,0,0,0
694620,True,0,No user reviews,0,0,0
694630,True,0,1 user reviews,1,0,1
694631,True,0,No user reviews,0,0,0
694632,True,0,No user reviews,0,0,0
694633,True,0,No user reviews,0,0,0
694634,True,0,No user reviews,0,0,0
694635,True,0,No user reviews,0,0,0
694636,True,0,No user reviews,0,0,0
694637,True,0,No user reviews,0,0,0
694638,True,0,No user reviews,0,0,0
694639,True,0,No user reviews,0,0,0
694640,True,0,No user reviews,0,0,0
694641,True,0,No user reviews,0,0,0
694642,True,0,No user reviews,0,0,0
694643,True,0,No user reviews,0,0,0
694644,True,0,No user reviews,0,0,0
694645,True,0,No user reviews,0,0,0
694646,True,0,No user reviews,0,0,0
694647,True,0,No user reviews,0,0,0
694648,True,0,No user reviews,0,0,0
694649,True,0,No user reviews,0,0,0
694650,True,0,No user reviews,0,0,0
694651,True,0,No user reviews,0,0,0
694652,True,0,No user reviews,0,0,0
694653,True,0,1 user reviews,1,0,1
694654,True,0,No user reviews,0,0,0
694660,True,0,2 user reviews,2,0,2
694670,True,0,1 user reviews,1,0,1
694680,True,6,Mostly Positive,19,7,26
694700,True,0,No user reviews,0,0,0
694720,True,0,No user reviews,0,0,0
694730,True,5,Mixed,6,6,12
694760,True,0,7 user reviews,7,0,7
694770,True,8,Very Positive,200,18,218
694780,True,0,No user reviews,0,0,0
694790,True,7,Positive,16,2,18
694800,True,0,No user reviews,0,0,0
694820,True,0,No user reviews,0,0,0
694830,True,0,3 user reviews,3,0,3
694870,True,7,Positive,19,2,21
694880,True,5,Mixed,221,139,360
694930,True,0,7 user reviews,4,3,7
694940,True,0,No user reviews,0,0,0
694950,True,7,Positive,11,0,11
694960,True,0,No user reviews,0,0,0
694980,True,0,6 user reviews,5,1,6
694990,True,0,No user reviews,0,0,0
695000,True,0,No user reviews,0,0,0
695010,True,0,No user reviews,0,0,0
695030,True,0,No user reviews,0,0,0
695050,True,8,Very Positive,85,17,102
695080,True,0,No user reviews,0,0,0
695100,True,8,Very Positive,61,13,74
695110,True,0,7 user reviews,7,0,7
695130,True,0,No user reviews,0,0,0
695140,True,0,No user reviews,0,0,0
695160,True,0,No user reviews,0,0,0
695170,True,0,No user reviews,0,0,0
695180,True,0,No user reviews,0,0,0
695190,True,0,No user reviews,0,0,0
695200,True,0,No user reviews,0,0,0
695210,True,0,No user reviews,0,0,0
695220,True,0,No user reviews,0,0,0
695230,True,0,No user reviews,0,0,0
695240,True,0,No user reviews,0,0,0
695250,True,0,No user reviews,0,0,0
695260,True,0,No user reviews,0,0,0
695270,True,0,No user reviews,0,0,0
695280,True,0,No user reviews,0,0,0
695290,True,6,Mostly Positive,846,316,1162
695320,True,0,2 user reviews,2,0,2
695360,True,0,4 user reviews,0,4,4
695370,True,0,2 user reviews,2,0,2
695371,True,0,2 user reviews,1,1,2
695380,True,0,No user reviews,0,0,0
695420,True,0,2 user reviews,2,0,2
695440,True,0,2 user reviews,1,1,2
695450,True,6,Mostly Positive,11,4,15
695460,True,0,No user reviews,0,0,0
695470,True,0,No user reviews,0,0,0
695490,True,0,6 user reviews,4,2,6
695500,True,0,No user reviews,0,0,0
695510,True,7,Positive,8,2,10
695520,True,0,3 user reviews,1,2,3
695560,True,0,No user reviews,0,0,0
695570,True,7,Positive,10,0,10
695580,True,0,No user reviews,0,0,0
695600,True,6,Mostly Positive,112,39,151
695630,True,5,Mixed,6,7,13
695650,True,0,No user reviews,0,0,0
695660,True,7,Positive,18,3,21
695680,True,6,Mostly Positive,92,25,117
695690,True,5,Mixed,26,34,60
695700,True,0,No user reviews,0,0,0
695720,True,0,No user reviews,0,0,0
695730,True,0,No user reviews,0,0,0
695740,True,0,9 user reviews,1,8,9
695741,True,0,No user reviews,0,0,0
695742,True,0,No user reviews,0,0,0
695743,True,0,2 user reviews,1,1,2
695760,True,5,Mixed,13,10,23
695810,True,0,5 user reviews,2,3,5
695820,True,0,1 user reviews,1,0,1
695830,True,0,No user reviews,0,0,0
695840,True,0,No user reviews,0,0,0
695860,True,0,8 user reviews,4,4,8
695870,True,0,No user reviews,0,0,0
695880,True,0,No user reviews,0,0,0
695910,True,0,5 user reviews,3,2,5
695920,True,8,Very Positive,290,49,339
695940,True,0,3 user reviews,2,1,3
695950,True,0,3 user reviews,3,0,3
695960,True,0,5 user reviews,5,0,5
695970,True,8,Very Positive,51,4,55
695980,True,0,4 user reviews,3,1,4
695990,True,0,1 user reviews,1,0,1
696000,True,0,6 user reviews,5,1,6
696010,True,0,2 user reviews,2,0,2
696020,True,0,2 user reviews,2,0,2
696030,True,0,1 user reviews,1,0,1
696040,True,0,3 user reviews,2,1,3
696050,True,0,No user reviews,0,0,0
696060,True,7,Positive,11,0,11
696070,True,0,No user reviews,0,0,0
696110,True,0,8 user reviews,4,4,8
696120,True,0,No user reviews,0,0,0
696140,True,8,Very Positive,72,12,84
696150,True,7,Positive,10,0,10
696160,True,0,No user reviews,0,0,0
696170,True,8,Very Positive,628,134,762
696180,True,5,Mixed,104,48,152
696190,True,0,5 user reviews,3,2,5
696200,True,7,Positive,18,0,18
696210,True,0,No user reviews,0,0,0
696211,True,0,No user reviews,0,0,0
696220,True,8,Very Positive,268,33,301
696230,True,0,6 user reviews,6,0,6
696250,True,0,9 user reviews,3,6,9
696260,True,0,No user reviews,0,0,0
696280,True,6,Mostly Positive,9,3,12
696290,True,0,No user reviews,0,0,0
696300,True,0,No user reviews,0,0,0
696310,True,0,1 user reviews,1,0,1
696331,True,0,No user reviews,0,0,0
696340,True,0,No user reviews,0,0,0
696350,True,0,No user reviews,0,0,0
696360,True,5,Mixed,21,10,31
696370,True,6,Mostly Positive,329,118,447
696400,True,0,8 user reviews,3,5,8
696410,True,0,3 user reviews,2,1,3
696420,True,0,No user reviews,0,0,0
696430,True,0,No user reviews,0,0,0
696440,True,0,3 user reviews,2,1,3
696460,True,7,Positive,20,4,24
696470,True,0,3 user reviews,1,2,3
696480,True,8,Very Positive,217,5,222
696490,True,7,Positive,10,1,11
696500,True,3,Negative,1,10,11
696510,True,0,6 user reviews,5,1,6
696530,True,6,Mostly Positive,83,23,106
696540,True,0,2 user reviews,1,1,2
696560,True,7,Positive,26,6,32
696570,True,0,No user reviews,0,0,0
696580,True,0,4 user reviews,3,1,4
696590,True,8,Very Positive,59,11,70
696600,True,0,No user reviews,0,0,0
696610,True,0,No user reviews,0,0,0
696620,True,0,No user reviews,0,0,0
696640,True,0,No user reviews,0,0,0
696650,True,5,Mixed,105,55,160
696670,True,0,No user reviews,0,0,0
696680,True,5,Mixed,257,168,425
696710,True,0,5 user reviews,5,0,5
696740,True,0,1 user reviews,1,0,1
696760,True,0,6 user reviews,5,1,6
696770,True,0,No user reviews,0,0,0
696790,True,5,Mixed,253,139,392
696810,True,5,Mixed,6,4,10
696830,True,0,No user reviews,0,0,0
696840,True,0,9 user reviews,5,4,9
696850,True,0,No user reviews,0,0,0
696860,True,0,3 user reviews,3,0,3
696880,True,0,4 user reviews,3,1,4
696890,True,0,No user reviews,0,0,0
696891,True,0,No user reviews,0,0,0
696892,True,0,No user reviews,0,0,0
696910,True,0,4 user reviews,4,0,4
696920,True,0,No user reviews,0,0,0
696940,True,6,Mostly Positive,34,13,47
696990,True,0,No user reviews,0,0,0
697000,True,0,2 user reviews,0,2,2
697010,True,5,Mixed,8,9,17
697020,True,5,Mixed,6,8,14
697040,True,0,1 user reviews,1,0,1
697130,True,0,3 user reviews,0,3,3
697160,True,0,1 user reviews,0,1,1
697170,True,0,No user reviews,0,0,0
697180,True,0,No user reviews,0,0,0
697210,True,0,No user reviews,0,0,0
697250,True,5,Mixed,5,7,12
697270,True,0,No user reviews,0,0,0
697320,True,0,4 user reviews,1,3,4
697330,True,0,No user reviews,0,0,0
697340,True,0,3 user reviews,1,2,3
697350,True,0,3 user reviews,3,0,3
697370,True,0,5 user reviews,4,1,5
697380,True,0,1 user reviews,0,1,1
697400,True,0,No user reviews,0,0,0
697410,True,0,No user reviews,0,0,0
697420,True,0,No user reviews,0,0,0
697430,True,0,2 user reviews,2,0,2
697440,True,8,Very Positive,194,5,199
697450,True,0,No user reviews,0,0,0
697480,True,0,No user reviews,0,0,0
697490,True,0,3 user reviews,0,3,3
697510,True,0,No user reviews,0,0,0
697530,True,0,No user reviews,0,0,0
697550,True,8,Very Positive,694,100,794
697560,True,0,No user reviews,0,0,0
697570,True,0,No user reviews,0,0,0
697580,True,5,Mixed,8,5,13
697600,True,0,6 user reviews,6,0,6
697610,True,0,No user reviews,0,0,0
697620,True,0,No user reviews,0,0,0
697630,True,5,Mixed,9,11,20
697650,True,8,Very Positive,54,4,58
697660,True,5,Mixed,6,4,10
697670,True,0,7 user reviews,6,1,7
697680,True,0,No user reviews,0,0,0
697710,True,0,9 user reviews,9,0,9
697720,True,0,No user reviews,0,0,0
697730,True,0,2 user reviews,1,1,2
697760,True,7,Positive,13,1,14
697800,True,7,Positive,14,0,14
697810,True,0,No user reviews,0,0,0
697850,True,5,Mixed,6,4,10
697860,True,7,Positive,34,6,40
697870,True,0,2 user reviews,1,1,2
697880,True,0,6 user reviews,2,4,6
697890,True,0,No user reviews,0,0,0
697910,True,0,3 user reviews,3,0,3
697920,True,0,No user reviews,0,0,0
697930,True,5,Mixed,9,5,14
697950,True,0,3 user reviews,2,1,3
697960,True,0,9 user reviews,7,2,9
697970,True,0,No user reviews,0,0,0
697990,True,0,No user reviews,0,0,0
698030,True,0,1 user reviews,0,1,1
698040,True,0,9 user reviews,6,3,9
698050,True,0,2 user reviews,1,1,2
698060,True,0,1 user reviews,1,0,1
698080,True,0,3 user reviews,1,2,3
698090,True,0,No user reviews,0,0,0
698100,True,0,No user reviews,0,0,0
698110,True,6,Mostly Positive,10,4,14
698120,True,0,No user reviews,0,0,0
698130,True,0,No user reviews,0,0,0
698160,True,0,4 user reviews,0,4,4
698180,True,0,No user reviews,0,0,0
698190,True,0,No user reviews,0,0,0
698200,True,0,No user reviews,0,0,0
698201,True,0,No user reviews,0,0,0
698202,True,0,No user reviews,0,0,0
698203,True,0,No user reviews,0,0,0
698204,True,0,No user reviews,0,0,0
698205,True,0,No user reviews,0,0,0
698206,True,0,No user reviews,0,0,0
698207,True,0,No user reviews,0,0,0
698208,True,0,No user reviews,0,0,0
698209,True,0,No user reviews,0,0,0
698210,True,0,No user reviews,0,0,0
698211,True,0,No user reviews,0,0,0
698212,True,0,No user reviews,0,0,0
698213,True,0,No user reviews,0,0,0
698214,True,0,No user reviews,0,0,0
698215,True,0,No user reviews,0,0,0
698216,True,0,No user reviews,0,0,0
698217,True,0,No user reviews,0,0,0
698218,True,0,No user reviews,0,0,0
698219,True,0,No user reviews,0,0,0
698220,True,0,No user reviews,0,0,0
698221,True,0,No user reviews,0,0,0
698222,True,0,No user reviews,0,0,0
698223,True,0,No user reviews,0,0,0
698224,True,0,No user reviews,0,0,0
698225,True,0,No user reviews,0,0,0
698226,True,0,No user reviews,0,0,0
698230,True,0,No user reviews,0,0,0
698240,True,7,Positive,14,0,14
698250,True,0,7 user reviews,7,0,7
698260,True,8,Very Positive,212,47,259
698280,True,6,Mostly Positive,19,6,25
698290,True,0,No user reviews,0,0,0
698300,True,7,Positive,22,2,24
698320,True,0,No user reviews,0,0,0
698330,True,6,Mostly Positive,19,6,25
698340,True,0,No user reviews,0,0,0
698360,True,0,5 user reviews,4,1,5
698370,True,0,No user reviews,0,0,0
698390,True,0,No user reviews,0,0,0
698410,True,0,4 user reviews,1,3,4
698440,True,0,2 user reviews,2,0,2
698450,True,7,Positive,13,0,13
698460,True,0,No user reviews,0,0,0
698470,True,0,No user reviews,0,0,0
698480,True,0,1 user reviews,1,0,1
698500,True,0,8 user reviews,6,2,8
698520,True,7,Positive,11,2,13
698540,True,8,Very Positive,259,23,282
698560,True,0,No user reviews,0,0,0
698570,True,0,4 user reviews,4,0,4
698590,True,0,9 user reviews,8,1,9
698600,True,0,2 user reviews,0,2,2
698610,True,0,2 user reviews,1,1,2
698620,True,7,Positive,8,2,10
698640,True,6,Mostly Positive,484,158,642
698650,True,7,Positive,10,0,10
698670,True,0,No user reviews,0,0,0
698690,True,0,No user reviews,0,0,0
698700,True,0,No user reviews,0,0,0
698710,True,5,Mixed,8,11,19
698740,True,0,5 user reviews,5,0,5
698760,True,0,8 user reviews,7,1,8
698770,True,7,Positive,19,1,20
698780,True,8,Very Positive,147,4,151
698790,True,7,Positive,16,3,19
698810,True,0,No user reviews,0,0,0
698830,True,5,Mixed,15,11,26
698840,True,0,No user reviews,0,0,0
698850,True,0,No user reviews,0,0,0
698870,True,7,Positive,34,7,41
698880,True,0,No user reviews,0,0,0
698890,True,0,6 user reviews,6,0,6
698910,True,7,Positive,9,1,10
698920,True,0,No user reviews,0,0,0
698950,True,0,1 user reviews,1,0,1
698960,True,0,No user reviews,0,0,0
698980,True,0,3 user reviews,2,1,3
698990,True,0,No user reviews,0,0,0
699000,True,0,No user reviews,0,0,0
699010,True,0,8 user reviews,2,6,8
699030,True,0,No user reviews,0,0,0
699040,True,0,No user reviews,0,0,0
699060,True,0,2 user reviews,1,1,2
699080,True,7,Positive,33,7,40
699090,True,0,2 user reviews,2,0,2
699100,True,5,Mixed,9,6,15
699150,True,7,Positive,35,3,38
699160,True,0,4 user reviews,2,2,4
699170,True,8,Very Positive,1892,162,2054
699180,True,8,Very Positive,199,18,217
699200,True,0,2 user reviews,2,0,2
699230,True,0,3 user reviews,3,0,3
699240,True,5,Mixed,9,4,13
699250,True,0,No user reviews,0,0,0
699290,True,0,7 user reviews,7,0,7
699330,True,0,No user reviews,0,0,0
699340,True,0,No user reviews,0,0,0
699350,True,7,Positive,22,0,22
699370,True,0,1 user reviews,0,1,1
699390,True,7,Positive,18,3,21
699410,True,0,8 user reviews,6,2,8
699440,True,0,No user reviews,0,0,0
699470,True,0,1 user reviews,0,1,1
699480,True,5,Mixed,4,6,10
699510,True,0,1 user reviews,0,1,1
699520,True,0,No user reviews,0,0,0
699540,True,7,Positive,30,1,31
699550,True,0,7 user reviews,1,6,7
699560,True,0,No user reviews,0,0,0
699570,True,0,2 user reviews,0,2,2
699590,True,5,Mixed,10,6,16
699600,True,8,Very Positive,71,3,74
699670,True,5,Mixed,75,37,112
699680,True,5,Mixed,8,5,13
699700,True,5,Mixed,8,11,19
699720,True,0,No user reviews,0,0,0
699740,True,5,Mixed,48,35,83
699750,True,0,6 user reviews,4,2,6
699760,True,4,Mostly Negative,3,9,12
699770,True,5,Mixed,33,27,60
699780,True,7,Positive,26,3,29
699790,True,0,1 user reviews,1,0,1
699820,True,0,6 user reviews,2,4,6
699830,True,0,4 user reviews,3,1,4
699850,True,0,4 user reviews,3,1,4
699860,True,0,3 user reviews,1,2,3
699870,True,5,Mixed,20,23,43
699920,True,6,Mostly Positive,147,49,196
699930,True,0,1 user reviews,1,0,1
699940,True,5,Mixed,24,12,36
699970,True,0,2 user reviews,1,1,2
699990,True,0,5 user reviews,3,2,5
700010,True,0,9 user reviews,5,4,9
700030,True,5,Mixed,553,771,1324
700050,True,0,No user reviews,0,0,0
700060,True,5,Mixed,6,7,13
700100,True,0,9 user reviews,7,2,9
700140,True,0,5 user reviews,5,0,5
700150,True,0,No user reviews,0,0,0
700160,True,8,Very Positive,60,8,68
700170,True,0,No user reviews,0,0,0
700180,True,0,2 user reviews,2,0,2
700200,True,7,Positive,16,4,20
700210,True,0,No user reviews,0,0,0
700230,True,0,5 user reviews,5,0,5
700240,True,0,8 user reviews,4,4,8
700270,True,0,No user reviews,0,0,0
700280,True,8,Very Positive,377,89,466
700282,True,5,Mixed,418,327,745
700290,True,0,1 user reviews,1,0,1
700300,True,0,No user reviews,0,0,0
700310,True,0,No user reviews,0,0,0
700320,True,0,8 user reviews,7,1,8
700330,True,0,No user reviews,0,0,0
700340,True,0,No user reviews,0,0,0
700360,True,0,6 user reviews,4,2,6
700370,True,0,No user reviews,0,0,0
700380,True,0,No user reviews,0,0,0
700400,True,0,3 user reviews,3,0,3
700420,True,0,No user reviews,0,0,0
700430,True,0,No user reviews,0,0,0
700440,True,5,Mixed,6,5,11
700450,True,0,No user reviews,0,0,0
700460,True,0,1 user reviews,1,0,1
700470,True,4,Mostly Negative,3,8,11
700480,True,0,No user reviews,0,0,0
700490,True,0,No user reviews,0,0,0
700500,True,0,No user reviews,0,0,0
700510,True,0,No user reviews,0,0,0
700520,True,7,Positive,13,0,13
700540,True,0,2 user reviews,1,1,2
700550,True,0,No user reviews,0,0,0
700560,True,0,3 user reviews,1,2,3
700570,True,0,No user reviews,0,0,0
700580,True,0,No user reviews,0,0,0
700590,True,0,6 user reviews,4,2,6
700600,True,0,No user reviews,0,0,0
700610,True,0,No user reviews,0,0,0
700620,True,6,Mostly Positive,14,4,18
700650,True,0,6 user reviews,4,2,6
700660,True,5,Mixed,27,14,41
700670,True,0,No user reviews,0,0,0
700680,True,0,No user reviews,0,0,0
700690,True,0,No user reviews,0,0,0
700700,True,0,No user reviews,0,0,0
700710,True,0,No user reviews,0,0,0
700720,True,0,No user reviews,0,0,0
700730,True,0,1 user reviews,1,0,1
700740,True,5,Mixed,14,14,28
700750,True,0,9 user reviews,7,2,9
700770,True,0,9 user reviews,3,6,9
700800,True,0,3 user reviews,0,3,3
700820,True,0,No user reviews,0,0,0
700830,True,0,9 user reviews,8,1,9
700850,True,0,7 user reviews,6,1,7
700851,True,0,1 user reviews,0,1,1
700860,True,0,No user reviews,0,0,0
700870,True,0,4 user reviews,4,0,4
700880,True,0,1 user reviews,1,0,1
700900,True,0,No user reviews,0,0,0
700910,True,0,2 user reviews,2,0,2
700920,True,0,5 user reviews,3,2,5
700930,True,0,No user reviews,0,0,0
700940,True,0,1 user reviews,0,1,1
700950,True,0,No user reviews,0,0,0
700960,True,0,1 user reviews,1,0,1
700970,True,0,No user reviews,0,0,0
700971,True,0,No user reviews,0,0,0
700972,True,0,No user reviews,0,0,0
700973,True,0,No user reviews,0,0,0
700980,True,0,No user reviews,0,0,0
700990,True,0,9 user reviews,4,5,9
701000,True,0,No user reviews,0,0,0
701010,True,0,No user reviews,0,0,0
701020,True,0,No user reviews,0,0,0
701040,True,7,Positive,30,0,30
701060,True,0,No user reviews,0,0,0
701080,True,7,Positive,13,0,13
701100,True,0,No user reviews,0,0,0
701160,True,8,Very Positive,1725,292,2017
701180,True,7,Positive,18,0,18
701260,True,0,No user reviews,0,0,0
701270,True,0,6 user reviews,6,0,6
701280,True,0,5 user reviews,3,2,5
701290,True,0,9 user reviews,6,3,9
701360,True,0,No user reviews,0,0,0
701370,True,0,1 user reviews,0,1,1
701380,True,7,Positive,35,1,36
701410,True,0,No user reviews,0,0,0
701420,True,7,Positive,12,0,12
701440,True,7,Positive,12,0,12
701460,True,0,7 user reviews,3,4,7
701470,True,7,Positive,35,2,37
701480,True,0,No user reviews,0,0,0
701490,True,0,No user reviews,0,0,0
701500,True,0,No user reviews,0,0,0
701520,True,0,No user reviews,0,0,0
701531,True,8,Very Positive,126,2,128
701540,True,5,Mixed,7,5,12
701560,True,0,No user reviews,0,0,0
701580,True,0,No user reviews,0,0,0
701610,True,7,Positive,9,2,11
701620,True,0,No user reviews,0,0,0
701630,True,0,No user reviews,0,0,0
701640,True,0,No user reviews,0,0,0
701650,True,0,No user reviews,0,0,0
701670,True,0,No user reviews,0,0,0
701680,True,0,No user reviews,0,0,0
701690,True,0,No user reviews,0,0,0
701710,True,0,No user reviews,0,0,0
701720,True,5,Mixed,17,9,26
701730,True,8,Very Positive,48,8,56
701740,True,0,6 user reviews,3,3,6
701750,True,0,No user reviews,0,0,0
701760,True,7,Positive,11,2,13
701800,True,0,2 user reviews,2,0,2
701810,True,7,Positive,13,0,13
701820,True,0,2 user reviews,2,0,2
701840,True,0,No user reviews,0,0,0
701860,True,7,Positive,16,3,19
701870,True,7,Positive,30,3,33
701880,True,0,1 user reviews,1,0,1
701890,True,0,No user reviews,0,0,0
701900,True,0,No user reviews,0,0,0
701910,True,0,3 user reviews,3,0,3
701930,True,0,2 user reviews,2,0,2
701940,True,0,4 user reviews,4,0,4
701950,True,7,Positive,8,2,10
701960,True,0,4 user reviews,2,2,4
701970,True,0,4 user reviews,3,1,4
701980,True,0,3 user reviews,2,1,3
701990,True,0,1 user reviews,1,0,1
702000,True,0,No user reviews,0,0,0
702010,True,0,No user reviews,0,0,0
702030,True,7,Positive,10,1,11
702040,True,0,2 user reviews,2,0,2
702050,True,8,Very Positive,312,31,343
702070,True,0,No user reviews,0,0,0
702080,True,0,1 user reviews,0,1,1
702100,True,0,No user reviews,0,0,0
702110,True,8,Very Positive,58,5,63
702120,True,6,Mostly Positive,47,13,60
702140,True,0,No user reviews,0,0,0
702150,True,0,4 user reviews,3,1,4
702160,True,0,No user reviews,0,0,0
702180,True,0,1 user reviews,0,1,1
702190,True,4,Mostly Negative,4,10,14
702200,True,0,6 user reviews,0,6,6
702210,True,5,Mixed,10,6,16
702220,True,0,7 user reviews,5,2,7
702250,True,0,No user reviews,0,0,0
702270,True,0,1 user reviews,1,0,1
702300,True,0,3 user reviews,3,0,3
702310,True,0,2 user reviews,1,1,2
702320,True,0,No user reviews,0,0,0
702330,True,0,1 user reviews,1,0,1
702340,True,0,No user reviews,0,0,0
702350,True,6,Mostly Positive,486,193,679
702360,True,0,3 user reviews,3,0,3
702410,True,0,No user reviews,0,0,0
702411,True,0,No user reviews,0,0,0
702412,True,0,No user reviews,0,0,0
702413,True,0,No user reviews,0,0,0
702414,True,0,No user reviews,0,0,0
702415,True,0,No user reviews,0,0,0
702430,True,5,Mixed,8,8,16
702490,True,0,No user reviews,0,0,0
702510,True,4,Mostly Negative,7,13,20
702540,True,6,Mostly Positive,126,42,168
702550,True,0,2 user reviews,2,0,2
702590,True,0,No user reviews,0,0,0
702600,True,7,Positive,8,2,10
702620,True,0,No user reviews,0,0,0
702660,True,8,Very Positive,124,10,134
702670,True,8,Very Positive,2007,341,2348
702680,True,0,No user reviews,0,0,0
702690,True,0,No user reviews,0,0,0
702691,True,0,No user reviews,0,0,0
702692,True,0,No user reviews,0,0,0
702693,True,0,No user reviews,0,0,0
702694,True,0,No user reviews,0,0,0
702695,True,0,No user reviews,0,0,0
702696,True,0,No user reviews,0,0,0
702700,True,5,Mixed,35,41,76
702720,True,0,No user reviews,0,0,0
702721,True,0,No user reviews,0,0,0
702722,True,0,No user reviews,0,0,0
702723,True,0,No user reviews,0,0,0
702724,True,0,No user reviews,0,0,0
702725,True,0,No user reviews,0,0,0
702740,True,0,No user reviews,0,0,0
702741,True,0,No user reviews,0,0,0
702742,True,0,No user reviews,0,0,0
702750,True,0,No user reviews,0,0,0
702760,True,0,No user reviews,0,0,0
702770,True,0,No user reviews,0,0,0
702780,True,0,No user reviews,0,0,0
702790,True,0,4 user reviews,3,1,4
702800,True,0,No user reviews,0,0,0
702810,True,0,No user reviews,0,0,0
702820,True,0,1 user reviews,1,0,1
702850,True,0,No user reviews,0,0,0
702890,True,8,Very Positive,1045,221,1266
702900,True,0,No user reviews,0,0,0
702920,True,0,No user reviews,0,0,0
702930,True,0,No user reviews,0,0,0
702940,True,0,3 user reviews,3,0,3
702950,True,5,Mixed,7,9,16
702960,True,5,Mixed,11,6,17
702961,True,0,4 user reviews,3,1,4
702962,True,0,1 user reviews,0,1,1
702963,True,0,No user reviews,0,0,0
702964,True,0,4 user reviews,3,1,4
702965,True,0,7 user reviews,5,2,7
702967,True,0,6 user reviews,3,3,6
702968,True,0,1 user reviews,0,1,1
702980,True,7,Positive,24,1,25
702990,True,7,Positive,38,7,45
703000,True,0,1 user reviews,1,0,1
703030,True,0,No user reviews,0,0,0
703050,True,0,2 user reviews,2,0,2
703060,True,0,No user reviews,0,0,0
703080,True,8,Very Positive,13039,1599,14638
703090,True,0,No user reviews,0,0,0
703100,True,0,No user reviews,0,0,0
703120,True,0,5 user reviews,3,2,5
703140,True,0,2 user reviews,2,0,2
703160,True,0,No user reviews,0,0,0
703170,True,0,No user reviews,0,0,0
703180,True,6,Mostly Positive,28,11,39
703200,True,0,3 user reviews,2,1,3
703210,True,0,5 user reviews,2,3,5
703250,True,0,1 user reviews,1,0,1
703260,True,0,No user reviews,0,0,0
703270,True,0,No user reviews,0,0,0
703280,True,0,No user reviews,0,0,0
703300,True,5,Mixed,6,6,12
703310,True,5,Mixed,14,7,21
703320,True,8,Very Positive,149,11,160
703340,True,0,No user reviews,0,0,0
703360,True,0,2 user reviews,0,2,2
703390,True,0,No user reviews,0,0,0
703400,True,0,7 user reviews,5,2,7
703420,True,0,No user reviews,0,0,0
703430,True,0,No user reviews,0,0,0
703440,True,0,1 user reviews,1,0,1
703441,True,0,No user reviews,0,0,0
703460,True,0,1 user reviews,1,0,1
703461,True,0,1 user reviews,1,0,1
703470,True,0,No user reviews,0,0,0
703471,True,0,No user reviews,0,0,0
703480,True,0,No user reviews,0,0,0
703490,True,0,5 user reviews,3,2,5
703500,True,7,Positive,28,3,31
703510,True,6,Mostly Positive,130,46,176
703530,True,0,8 user reviews,2,6,8
703540,True,0,6 user reviews,4,2,6
703560,True,0,6 user reviews,6,0,6
703590,True,0,No user reviews,0,0,0
703600,True,4,Mostly Negative,8,14,22
703620,True,8,Very Positive,44,7,51
703630,True,7,Positive,20,0,20
703671,True,0,No user reviews,0,0,0
703690,True,0,No user reviews,0,0,0
703700,True,6,Mostly Positive,41,11,52
703720,True,0,9 user reviews,9,0,9
703730,True,7,Positive,17,3,20
703770,True,0,No user reviews,0,0,0
703800,True,0,1 user reviews,1,0,1
703820,True,0,No user reviews,0,0,0
703830,True,0,No user reviews,0,0,0
703840,True,8,Very Positive,215,27,242
703860,True,5,Mixed,514,289,803
703870,True,5,Mixed,7,4,11
703880,True,7,Positive,35,5,40
703900,True,0,No user reviews,0,0,0
703920,True,4,Mostly Negative,4,9,13
703940,True,0,3 user reviews,1,2,3
703950,True,0,No user reviews,0,0,0
703960,True,0,2 user reviews,2,0,2
703970,True,0,No user reviews,0,0,0
703980,True,0,No user reviews,0,0,0
704000,True,0,No user reviews,0,0,0
704010,True,6,Mostly Positive,35,11,46
704020,True,0,2 user reviews,2,0,2
704030,True,6,Mostly Positive,120,50,170
704040,True,0,No user reviews,0,0,0
704060,True,0,4 user reviews,3,1,4
704070,True,0,4 user reviews,2,2,4
704090,True,0,No user reviews,0,0,0
704091,True,0,No user reviews,0,0,0
704092,True,0,No user reviews,0,0,0
704093,True,0,No user reviews,0,0,0
704094,True,0,No user reviews,0,0,0
704095,True,0,No user reviews,0,0,0
704096,True,0,No user reviews,0,0,0
704097,True,0,No user reviews,0,0,0
704098,True,0,No user reviews,0,0,0
704099,True,0,No user reviews,0,0,0
704110,True,5,Mixed,5,7,12
704120,True,0,No user reviews,0,0,0
704130,True,0,No user reviews,0,0,0
704140,True,0,2 user reviews,0,2,2
704150,True,0,4 user reviews,3,1,4
704160,True,0,No user reviews,0,0,0
704180,True,7,Positive,22,1,23
704190,True,5,Mixed,8,5,13
704200,True,7,Positive,16,1,17
704210,True,5,Mixed,50,70,120
704230,True,5,Mixed,40,33,73
704240,True,0,No user reviews,0,0,0
704250,True,5,Mixed,9,6,15
704260,True,0,3 user reviews,3,0,3
704270,True,5,Mixed,3842,1662,5504
704282,True,0,4 user reviews,3,1,4
704283,True,5,Mixed,16,10,26
704285,True,0,5 user reviews,4,1,5
704286,True,0,9 user reviews,4,5,9
704287,True,0,No user reviews,0,0,0
704288,True,0,No user reviews,0,0,0
704289,True,0,No user reviews,0,0,0
704300,True,6,Mostly Positive,39,14,53
704310,True,0,8 user reviews,5,3,8
704320,True,0,No user reviews,0,0,0
704321,True,0,No user reviews,0,0,0
704322,True,0,No user reviews,0,0,0
704325,True,0,No user reviews,0,0,0
704326,True,0,No user reviews,0,0,0
704327,True,0,No user reviews,0,0,0
704328,True,0,No user reviews,0,0,0
704330,True,0,No user reviews,0,0,0
704340,True,0,No user reviews,0,0,0
704350,True,0,No user reviews,0,0,0
704360,True,8,Very Positive,106,17,123
704370,True,0,5 user reviews,2,3,5
704390,True,0,No user reviews,0,0,0
704430,True,0,2 user reviews,1,1,2
704440,True,0,5 user reviews,5,0,5
704450,True,8,Very Positive,1911,318,2229
704470,True,8,Very Positive,64,0,64
704480,True,7,Positive,13,1,14
704510,True,8,Very Positive,73,10,83
704520,True,0,No user reviews,0,0,0
704540,True,0,4 user reviews,2,2,4
704570,True,0,No user reviews,0,0,0
704580,True,0,No user reviews,0,0,0
704600,True,0,No user reviews,0,0,0
704610,True,0,No user reviews,0,0,0
704620,True,0,No user reviews,0,0,0
704630,True,0,1 user reviews,1,0,1
704640,True,8,Very Positive,171,23,194
704660,True,0,No user reviews,0,0,0
704670,True,0,1 user reviews,1,0,1
704680,True,6,Mostly Positive,19,5,24
704690,True,6,Mostly Positive,27,7,34
704700,True,0,1 user reviews,1,0,1
704710,True,8,Very Positive,77,4,81
704720,True,0,1 user reviews,1,0,1
704730,True,0,1 user reviews,1,0,1
704740,True,8,Very Positive,75,18,93
704760,True,0,7 user reviews,6,1,7
704770,True,0,No user reviews,0,0,0
704810,True,0,8 user reviews,7,1,8
704830,True,5,Mixed,30,39,69
704840,True,7,Positive,48,1,49
704850,True,8,Very Positive,2644,430,3074
704860,True,8,Very Positive,58,14,72
704870,True,0,No user reviews,0,0,0
704880,True,5,Mixed,19,11,30
704900,True,0,No user reviews,0,0,0
704910,True,7,Positive,21,2,23
704920,True,0,4 user reviews,4,0,4
704930,True,0,No user reviews,0,0,0
704940,True,0,1 user reviews,0,1,1
704950,True,5,Mixed,9,5,14
704960,True,0,No user reviews,0,0,0
704970,True,0,No user reviews,0,0,0
704990,True,0,1 user reviews,1,0,1
705000,True,0,No user reviews,0,0,0
705020,True,6,Mostly Positive,16,5,21
705050,True,0,6 user reviews,2,4,6
705060,True,6,Mostly Positive,10,4,14
705070,True,4,Mostly Negative,12,20,32
705090,True,5,Mixed,9,6,15
705100,True,8,Very Positive,49,10,59
705120,True,8,Very Positive,283,50,333
705130,True,0,No user reviews,0,0,0
705140,True,0,No user reviews,0,0,0
705150,True,0,3 user reviews,1,2,3
705160,True,5,Mixed,5,5,10
705170,True,0,No user reviews,0,0,0
705200,True,0,No user reviews,0,0,0
705210,True,0,2 user reviews,1,1,2
705220,True,0,No user reviews,0,0,0
705230,True,0,3 user reviews,1,2,3
705240,True,0,2 user reviews,1,1,2
705250,True,6,Mostly Positive,10,3,13
705260,True,0,1 user reviews,1,0,1
705280,True,8,Very Positive,127,25,152
705290,True,8,Very Positive,90,18,108
705300,True,5,Mixed,11,12,23
705340,True,7,Positive,12,2,14
705360,True,0,No user reviews,0,0,0
705370,True,0,No user reviews,0,0,0
705380,True,6,Mostly Positive,9,3,12
705390,True,5,Mixed,6,6,12
705410,True,0,No user reviews,0,0,0
705440,True,0,3 user reviews,2,1,3
705450,True,7,Positive,28,5,33
705500,True,7,Positive,19,1,20
705520,True,0,1 user reviews,0,1,1
705530,True,0,4 user reviews,4,0,4
705540,True,0,2 user reviews,1,1,2
705550,True,7,Positive,12,2,14
705560,True,0,1 user reviews,1,0,1
705570,True,0,No user reviews,0,0,0
705580,True,0,No user reviews,0,0,0
705590,True,0,No user reviews,0,0,0
705610,True,6,Mostly Positive,20,6,26
705620,True,7,Positive,12,3,15
705640,True,5,Mixed,6,4,10
705670,True,7,Positive,12,1,13
705700,True,0,8 user reviews,4,4,8
705710,True,4,Mostly Negative,11,34,45
705720,True,0,No user reviews,0,0,0
705740,True,5,Mixed,20,11,31
705750,True,7,Positive,33,4,37
705770,True,0,3 user reviews,3,0,3
705780,True,0,4 user reviews,4,0,4
705800,True,0,3 user reviews,2,1,3
705810,True,0,No user reviews,0,0,0
705830,True,0,No user reviews,0,0,0
705850,True,0,No user reviews,0,0,0
705860,True,0,No user reviews,0,0,0
705870,True,7,Positive,42,5,47
705880,True,0,No user reviews,0,0,0
705900,True,0,No user reviews,0,0,0
705920,True,0,1 user reviews,1,0,1
705930,True,0,1 user reviews,0,1,1
705950,True,0,2 user reviews,1,1,2
705980,True,0,No user reviews,0,0,0
705990,True,0,No user reviews,0,0,0
706000,True,0,No user reviews,0,0,0
706010,True,0,2 user reviews,0,2,2
706020,True,5,Mixed,266,139,405
706030,True,0,8 user reviews,6,2,8
706060,True,0,4 user reviews,1,3,4
706070,True,0,1 user reviews,0,1,1
706080,True,0,4 user reviews,0,4,4
706090,True,0,4 user reviews,4,0,4
706100,True,0,1 user reviews,1,0,1
706110,True,0,1 user reviews,1,0,1
706120,True,0,No user reviews,0,0,0
706121,True,0,No user reviews,0,0,0
706122,True,0,No user reviews,0,0,0
706130,True,7,Positive,44,5,49
706140,True,0,No user reviews,0,0,0
706150,True,0,No user reviews,0,0,0
706180,True,0,8 user reviews,1,7,8
706200,True,0,2 user reviews,1,1,2
706210,True,0,No user reviews,0,0,0
706220,True,6,Mostly Positive,13342,5202,18544
706230,True,0,6 user reviews,4,2,6
706240,True,0,4 user reviews,3,1,4
706260,True,5,Mixed,9,6,15
706261,True,0,2 user reviews,2,0,2
706262,True,0,No user reviews,0,0,0
706270,True,0,No user reviews,0,0,0
706280,True,7,Positive,15,2,17
706290,True,0,1 user reviews,0,1,1
706310,True,0,No user reviews,0,0,0
706320,True,5,Mixed,7,9,16
706330,True,0,9 user reviews,5,4,9
706350,True,0,2 user reviews,1,1,2
706360,True,0,No user reviews,0,0,0
706370,True,0,6 user reviews,5,1,6
706380,True,0,1 user reviews,1,0,1
706390,True,0,8 user reviews,7,1,8
706400,True,0,3 user reviews,3,0,3
706440,True,5,Mixed,9,5,14
706450,True,0,8 user reviews,6,2,8
706480,True,0,No user reviews,0,0,0
706490,True,5,Mixed,43,29,72
706510,True,0,8 user reviews,8,0,8
706520,True,5,Mixed,15,8,23
706550,True,0,No user reviews,0,0,0
706560,True,8,Very Positive,218,13,231
706570,True,0,5 user reviews,3,2,5
706580,True,0,3 user reviews,3,0,3
706590,True,0,No user reviews,0,0,0
706600,True,0,No user reviews,0,0,0
706620,True,0,No user reviews,0,0,0
706650,True,0,No user reviews,0,0,0
706660,True,0,No user reviews,0,0,0
706680,True,0,No user reviews,0,0,0
706690,True,0,1 user reviews,0,1,1
706700,True,0,No user reviews,0,0,0
706710,True,7,Positive,15,2,17
706770,True,7,Positive,19,1,20
706780,True,0,No user reviews,0,0,0
706800,True,0,No user reviews,0,0,0
706830,True,0,No user reviews,0,0,0
706850,True,7,Positive,16,0,16
706860,True,0,No user reviews,0,0,0
706870,True,0,3 user reviews,3,0,3
706880,True,6,Mostly Positive,11,4,15
706910,True,0,1 user reviews,1,0,1
706920,True,0,No user reviews,0,0,0
706950,True,0,6 user reviews,2,4,6
706960,True,6,Mostly Positive,18,6,24
706970,True,0,No user reviews,0,0,0
706980,True,0,No user reviews,0,0,0
706990,True,0,No user reviews,0,0,0
707000,True,0,4 user reviews,1,3,4
707010,True,6,Mostly Positive,457,195,652
707030,True,8,Very Positive,2406,273,2679
707040,True,0,1 user reviews,0,1,1
707060,True,0,9 user reviews,3,6,9
707070,True,0,No user reviews,0,0,0
707080,True,5,Mixed,7,6,13
707090,True,0,No user reviews,0,0,0
707100,True,0,No user reviews,0,0,0
707110,True,7,Positive,15,2,17
707140,True,0,9 user reviews,1,8,9
707160,True,0,No user reviews,0,0,0
707170,True,0,No user reviews,0,0,0
707172,True,0,1 user reviews,0,1,1
707173,True,0,1 user reviews,0,1,1
707174,True,0,1 user reviews,0,1,1
707175,True,0,1 user reviews,0,1,1
707176,True,0,1 user reviews,0,1,1
707177,True,0,1 user reviews,0,1,1
707178,True,0,1 user reviews,0,1,1
707179,True,0,1 user reviews,0,1,1
707180,True,0,1 user reviews,0,1,1
707181,True,0,2 user reviews,1,1,2
707182,True,0,2 user reviews,1,1,2
707183,True,0,2 user reviews,1,1,2
707184,True,0,No user reviews,0,0,0
707185,True,0,2 user reviews,2,0,2
707186,True,0,1 user reviews,0,1,1
707187,True,0,1 user reviews,0,1,1
707188,True,0,1 user reviews,0,1,1
707189,True,0,No user reviews,0,0,0
707190,True,0,1 user reviews,0,1,1
707191,True,0,1 user reviews,0,1,1
707192,True,0,1 user reviews,0,1,1
707193,True,0,1 user reviews,0,1,1
707194,True,0,1 user reviews,0,1,1
707195,True,0,1 user reviews,0,1,1
707220,True,0,4 user reviews,2,2,4
707230,True,0,2 user reviews,2,0,2
707240,True,0,7 user reviews,6,1,7
707250,True,0,No user reviews,0,0,0
707280,True,0,4 user reviews,1,3,4
707300,True,5,Mixed,94,54,148
707310,True,0,No user reviews,0,0,0
707320,True,0,3 user reviews,1,2,3
707330,True,0,No user reviews,0,0,0
707340,True,0,No user reviews,0,0,0
707350,True,0,7 user reviews,4,3,7
707360,True,0,No user reviews,0,0,0
707390,True,0,6 user reviews,5,1,6
707400,True,7,Positive,10,0,10
707410,True,0,3 user reviews,2,1,3
707450,True,4,Mostly Negative,6,10,16
707470,True,0,No user reviews,0,0,0
707480,True,0,2 user reviews,2,0,2
707490,True,0,2 user reviews,2,0,2
707560,True,0,1 user reviews,1,0,1
707580,True,6,Mostly Positive,66,17,83
707590,True,6,Mostly Positive,37,13,50
707610,True,0,7 user reviews,4,3,7
707620,True,0,No user reviews,0,0,0
707670,True,0,8 user reviews,1,7,8
707680,True,0,7 user reviews,7,0,7
707720,True,0,5 user reviews,1,4,5
707730,True,0,No user reviews,0,0,0
707740,True,0,1 user reviews,1,0,1
707750,True,0,7 user reviews,1,6,7
707770,True,0,6 user reviews,2,4,6
707830,True,0,No user reviews,0,0,0
707840,True,0,No user reviews,0,0,0
707850,True,0,6 user reviews,3,3,6
707860,True,0,5 user reviews,2,3,5
707870,True,7,Positive,20,5,25
707900,True,0,No user reviews,0,0,0
707910,True,0,No user reviews,0,0,0
707920,True,0,3 user reviews,1,2,3
707950,True,0,No user reviews,0,0,0
707960,True,0,6 user reviews,2,4,6
708020,True,0,No user reviews,0,0,0
708030,True,0,No user reviews,0,0,0
708040,True,0,No user reviews,0,0,0
708070,True,0,No user reviews,0,0,0
708100,True,0,No user reviews,0,0,0
708110,True,0,No user reviews,0,0,0
708120,True,0,7 user reviews,3,4,7
708140,True,0,1 user reviews,1,0,1
708150,True,7,Positive,19,3,22
708160,True,0,No user reviews,0,0,0
708170,True,0,No user reviews,0,0,0
708171,True,0,No user reviews,0,0,0
708172,True,0,5 user reviews,4,1,5
708173,True,5,Mixed,13,10,23
708190,True,5,Mixed,12,6,18
708200,True,0,No user reviews,0,0,0
708250,True,0,No user reviews,0,0,0
708260,True,0,5 user reviews,5,0,5
708280,True,0,1 user reviews,1,0,1
708300,True,0,7 user reviews,5,2,7
708310,True,0,6 user reviews,3,3,6
708320,True,0,No user reviews,0,0,0
708340,True,7,Positive,12,1,13
708350,True,0,No user reviews,0,0,0
708360,True,0,No user reviews,0,0,0
708370,True,5,Mixed,24,12,36
708410,True,0,No user reviews,0,0,0
708420,True,0,No user reviews,0,0,0
708430,True,0,6 user reviews,3,3,6
708450,True,5,Mixed,16,11,27
708460,True,0,No user reviews,0,0,0
708490,True,0,1 user reviews,1,0,1
708500,True,0,No user reviews,0,0,0
708510,True,0,9 user reviews,3,6,9
708520,True,0,No user reviews,0,0,0
708521,True,0,1 user reviews,0,1,1
708522,True,0,No user reviews,0,0,0
708523,True,0,No user reviews,0,0,0
708530,True,0,No user reviews,0,0,0
708550,True,0,No user reviews,0,0,0
708580,True,6,Mostly Positive,130,39,169
708590,True,0,1 user reviews,1,0,1
708620,True,0,No user reviews,0,0,0
708621,True,0,No user reviews,0,0,0
708622,True,0,No user reviews,0,0,0
708630,True,0,4 user reviews,0,4,4
708640,True,0,5 user reviews,3,2,5
708650,True,0,No user reviews,0,0,0
708680,True,0,No user reviews,0,0,0
708690,True,0,No user reviews,0,0,0
708710,True,5,Mixed,12,8,20
708720,True,0,No user reviews,0,0,0
708760,True,6,Mostly Positive,32,9,41
708770,True,6,Mostly Positive,713,298,1011
708780,True,7,Positive,12,0,12
708820,True,7,Positive,18,3,21
708830,True,0,4 user reviews,2,2,4
708850,True,7,Positive,15,2,17
708870,True,0,5 user reviews,5,0,5
708880,True,7,Positive,32,1,33
708890,True,7,Positive,17,1,18
708900,True,0,No user reviews,0,0,0
708910,True,0,No user reviews,0,0,0
708920,True,0,4 user reviews,4,0,4
708930,True,0,1 user reviews,1,0,1
708950,True,7,Positive,25,1,26
708970,True,0,4 user reviews,2,2,4
708980,True,0,No user reviews,0,0,0
709010,True,0,No user reviews,0,0,0
709020,True,0,1 user reviews,0,1,1
709040,True,0,No user reviews,0,0,0
709050,True,0,1 user reviews,0,1,1
709060,True,0,No user reviews,0,0,0
709080,True,0,No user reviews,0,0,0
709090,True,0,No user reviews,0,0,0
709100,True,0,No user reviews,0,0,0
709130,True,0,No user reviews,0,0,0
709140,True,0,5 user reviews,4,1,5
709150,True,8,Very Positive,99,10,109
709160,True,0,No user reviews,0,0,0
709170,True,7,Positive,22,0,22
709171,True,0,No user reviews,0,0,0
709172,True,0,No user reviews,0,0,0
709173,True,0,No user reviews,0,0,0
709174,True,0,1 user reviews,1,0,1
709175,True,0,No user reviews,0,0,0
709190,True,0,9 user reviews,3,6,9
709210,True,0,No user reviews,0,0,0
709240,True,0,No user reviews,0,0,0
709280,True,0,3 user reviews,1,2,3
709290,True,0,1 user reviews,1,0,1
709300,True,0,1 user reviews,1,0,1
709340,True,0,1 user reviews,1,0,1
709350,True,0,1 user reviews,1,0,1
709370,True,0,1 user reviews,1,0,1
709380,True,5,Mixed,11,6,17
709390,True,0,No user reviews,0,0,0
709400,True,0,3 user reviews,3,0,3
709410,True,5,Mixed,30,23,53
709440,True,8,Very Positive,214,27,241
709450,True,0,1 user reviews,1,0,1
709470,True,0,5 user reviews,5,0,5
709490,True,0,4 user reviews,2,2,4
709500,True,0,No user reviews,0,0,0
709510,True,7,Positive,20,1,21
709520,True,0,1 user reviews,1,0,1
709550,True,0,4 user reviews,4,0,4
709560,True,0,5 user reviews,0,5,5
709590,True,0,No user reviews,0,0,0
709600,True,0,1 user reviews,1,0,1
709610,True,0,2 user reviews,0,2,2
709620,True,0,5 user reviews,4,1,5
709650,True,0,No user reviews,0,0,0
709670,True,7,Positive,18,2,20
709680,True,0,No user reviews,0,0,0
709690,True,0,No user reviews,0,0,0
709700,True,5,Mixed,6,7,13
709710,True,7,Positive,16,3,19
709720,True,0,2 user reviews,0,2,2
709730,True,0,No user reviews,0,0,0
709750,True,0,No user reviews,0,0,0
709780,True,4,Mostly Negative,9,17,26
709790,True,0,2 user reviews,2,0,2
709800,True,3,Negative,2,9,11
709820,True,5,Mixed,11,7,18
709830,True,0,3 user reviews,3,0,3
709831,True,0,No user reviews,0,0,0
709840,True,4,Mostly Negative,17,39,56
709850,True,0,No user reviews,0,0,0
709870,True,5,Mixed,12,9,21
709880,True,6,Mostly Positive,16,6,22
709890,True,0,1 user reviews,0,1,1
709900,True,5,Mixed,21,14,35
709920,True,8,Very Positive,179,5,184
709940,True,0,5 user reviews,5,0,5
709960,True,0,No user reviews,0,0,0
709970,True,0,No user reviews,0,0,0
709980,True,0,No user reviews,0,0,0
710000,True,0,No user reviews,0,0,0
710010,True,0,No user reviews,0,0,0
710020,True,0,No user reviews,0,0,0
710030,True,8,Very Positive,45,5,50
710040,True,0,No user reviews,0,0,0
710050,True,0,No user reviews,0,0,0
710060,True,0,No user reviews,0,0,0
710070,True,7,Positive,9,2,11
710090,True,0,No user reviews,0,0,0
710110,True,5,Mixed,7,5,12
710120,True,5,Mixed,8,4,12
710130,True,0,2 user reviews,1,1,2
710140,True,0,No user reviews,0,0,0
710160,True,0,No user reviews,0,0,0
710170,True,8,Very Positive,49,5,54
710190,True,0,2 user reviews,1,1,2
710220,True,0,9 user reviews,9,0,9
710230,True,0,No user reviews,0,0,0
710240,True,0,2 user reviews,1,1,2
710250,True,0,7 user reviews,4,3,7
710280,True,0,No user reviews,0,0,0
710300,True,0,8 user reviews,7,1,8
710310,True,0,No user reviews,0,0,0
710350,True,0,4 user reviews,4,0,4
710360,True,0,5 user reviews,4,1,5
710400,True,0,No user reviews,0,0,0
710410,True,0,No user reviews,0,0,0
710430,True,0,No user reviews,0,0,0
710460,True,0,3 user reviews,2,1,3
710470,True,6,Mostly Positive,160,43,203
710480,True,0,3 user reviews,3,0,3
710490,True,8,Very Positive,69,15,84
710500,True,0,No user reviews,0,0,0
710510,True,0,No user reviews,0,0,0
710520,True,0,2 user reviews,1,1,2
710530,True,0,No user reviews,0,0,0
710550,True,0,No user reviews,0,0,0
710560,True,0,No user reviews,0,0,0
710580,True,0,2 user reviews,2,0,2
710600,True,7,Positive,19,1,20
710610,True,8,Very Positive,84,19,103
710620,True,0,No user reviews,0,0,0
710630,True,0,4 user reviews,4,0,4
710640,True,0,2 user reviews,0,2,2
710650,True,0,1 user reviews,0,1,1
710670,True,0,No user reviews,0,0,0
710680,True,0,No user reviews,0,0,0
710690,True,0,4 user reviews,3,1,4
710700,True,6,Mostly Positive,15,6,21
710710,True,8,Very Positive,183,4,187
710730,True,0,No user reviews,0,0,0
710740,True,0,6 user reviews,5,1,6
710750,True,0,No user reviews,0,0,0
710760,True,6,Mostly Positive,27,10,37
710780,True,7,Positive,28,7,35
710790,True,0,No user reviews,0,0,0
710800,True,7,Positive,14,3,17
710820,True,0,3 user reviews,3,0,3
710830,True,0,6 user reviews,5,1,6
710840,True,0,No user reviews,0,0,0
710880,True,0,1 user reviews,0,1,1
710890,True,0,4 user reviews,3,1,4
710920,True,8,Very Positive,1484,198,1682
710940,True,0,1 user reviews,1,0,1
710950,True,7,Positive,20,3,23
710960,True,0,No user reviews,0,0,0
710970,True,0,7 user reviews,1,6,7
710990,True,0,No user reviews,0,0,0
711000,True,0,1 user reviews,0,1,1
711010,True,5,Mixed,7,8,15
711020,True,0,3 user reviews,3,0,3
711021,True,0,4 user reviews,3,1,4
711022,True,0,4 user reviews,4,0,4
711023,True,0,1 user reviews,1,0,1
711030,True,0,No user reviews,0,0,0
711040,True,0,No user reviews,0,0,0
711050,True,0,6 user reviews,4,2,6
711064,True,0,1 user reviews,1,0,1
711070,True,0,7 user reviews,2,5,7
711130,True,0,8 user reviews,8,0,8
711140,True,0,2 user reviews,1,1,2
711150,True,0,2 user reviews,1,1,2
711172,True,5,Mixed,21,13,34
711190,True,0,No user reviews,0,0,0
711210,True,7,Positive,16,3,19
711220,True,0,No user reviews,0,0,0
711230,True,0,1 user reviews,0,1,1
711240,True,6,Mostly Positive,11,4,15
711250,True,0,No user reviews,0,0,0
711260,True,0,1 user reviews,1,0,1
711270,True,0,No user reviews,0,0,0
711280,True,0,No user reviews,0,0,0
711300,True,0,5 user reviews,5,0,5
711310,True,0,1 user reviews,0,1,1
711320,True,5,Mixed,9,4,13
711330,True,0,5 user reviews,2,3,5
711340,True,0,No user reviews,0,0,0
711350,True,0,3 user reviews,0,3,3
711360,True,0,No user reviews,0,0,0
711380,True,0,9 user reviews,4,5,9
711390,True,0,No user reviews,0,0,0
711400,True,0,No user reviews,0,0,0
711430,True,7,Positive,20,3,23
711440,True,5,Mixed,79,40,119
711450,True,0,1 user reviews,1,0,1
711460,True,0,1 user reviews,0,1,1
711480,True,0,8 user reviews,6,2,8
711490,True,0,No user reviews,0,0,0
711500,True,0,1 user reviews,1,0,1
711510,True,0,No user reviews,0,0,0
711530,True,0,6 user reviews,4,2,6
711540,True,8,Very Positive,383,37,420
711550,True,0,2 user reviews,2,0,2
711560,True,0,7 user reviews,3,4,7
711570,True,5,Mixed,9,6,15
711580,True,0,No user reviews,0,0,0
711590,True,0,No user reviews,0,0,0
711600,True,0,No user reviews,0,0,0
711610,True,0,No user reviews,0,0,0
711630,True,0,No user reviews,0,0,0
711660,True,6,Mostly Positive,532,154,686
711680,True,5,Mixed,12,13,25
711681,True,6,Mostly Positive,12,5,17
711690,True,0,No user reviews,0,0,0
711700,True,0,No user reviews,0,0,0
711710,True,0,No user reviews,0,0,0
711720,True,0,6 user reviews,5,1,6
711730,True,4,Mostly Negative,11,17,28
711731,True,0,No user reviews,0,0,0
711732,True,0,No user reviews,0,0,0
711733,True,0,No user reviews,0,0,0
711734,True,0,1 user reviews,0,1,1
711735,True,0,No user reviews,0,0,0
711736,True,0,No user reviews,0,0,0
711737,True,0,No user reviews,0,0,0
711738,True,0,No user reviews,0,0,0
711739,True,0,No user reviews,0,0,0
711740,True,0,No user reviews,0,0,0
711741,True,0,1 user reviews,0,1,1
711742,True,0,1 user reviews,0,1,1
711743,True,0,No user reviews,0,0,0
711744,True,0,No user reviews,0,0,0
711745,True,0,No user reviews,0,0,0
711746,True,0,No user reviews,0,0,0
711750,True,6,Mostly Positive,167,66,233
711760,True,0,No user reviews,0,0,0
711770,True,0,6 user reviews,3,3,6
711810,True,0,1 user reviews,1,0,1
711860,True,0,1 user reviews,1,0,1
711870,True,0,No user reviews,0,0,0
711890,True,7,Positive,10,0,10
711920,True,0,5 user reviews,4,1,5
711930,True,4,Mostly Negative,2,8,10
711940,True,0,No user reviews,0,0,0
711950,True,0,No user reviews,0,0,0
711960,True,0,No user reviews,0,0,0
711970,True,0,No user reviews,0,0,0
711980,True,8,Very Positive,166,24,190
711990,True,8,Very Positive,116,19,135
712000,True,5,Mixed,6,7,13
712010,True,5,Mixed,16,13,29
712050,True,6,Mostly Positive,199,60,259
712060,True,0,No user reviews,0,0,0
712070,True,0,4 user reviews,3,1,4
712080,True,0,No user reviews,0,0,0
712090,True,0,No user reviews,0,0,0
712100,True,5,Mixed,2971,1693,4664
712120,True,0,No user reviews,0,0,0
712130,True,0,4 user reviews,3,1,4
712150,True,5,Mixed,7,5,12
712160,True,0,7 user reviews,6,1,7
712180,True,6,Mostly Positive,20,6,26
712190,True,5,Mixed,233,107,340
712201,True,0,No user reviews,0,0,0
712210,True,0,1 user reviews,1,0,1
712230,True,0,No user reviews,0,0,0
712240,True,7,Positive,12,1,13
712260,True,7,Positive,12,0,12
712270,True,0,No user reviews,0,0,0
712330,True,0,1 user reviews,1,0,1
712340,True,7,Positive,10,1,11
712350,True,0,No user reviews,0,0,0
712360,True,0,No user reviews,0,0,0
712380,True,0,5 user reviews,5,0,5
712390,True,0,No user reviews,0,0,0
712400,True,0,No user reviews,0,0,0
712410,True,0,2 user reviews,1,1,2
712420,True,0,No user reviews,0,0,0
712430,True,0,1 user reviews,1,0,1
712440,True,0,No user reviews,0,0,0
712450,True,0,No user reviews,0,0,0
712470,True,0,No user reviews,0,0,0
712471,True,0,No user reviews,0,0,0
712480,True,0,No user reviews,0,0,0
712490,True,0,No user reviews,0,0,0
712500,True,0,No user reviews,0,0,0
712501,True,0,No user reviews,0,0,0
712502,True,0,No user reviews,0,0,0
712503,True,0,No user reviews,0,0,0
712510,True,0,No user reviews,0,0,0
712511,True,0,No user reviews,0,0,0
712512,True,0,No user reviews,0,0,0
712513,True,0,No user reviews,0,0,0
712520,True,0,No user reviews,0,0,0
712521,True,0,No user reviews,0,0,0
712530,True,5,Mixed,12,9,21
712540,True,0,1 user reviews,1,0,1
712550,True,0,No user reviews,0,0,0
712560,True,0,No user reviews,0,0,0
712561,True,0,No user reviews,0,0,0
712562,True,0,No user reviews,0,0,0
712563,True,0,No user reviews,0,0,0
712564,True,0,No user reviews,0,0,0
712565,True,0,No user reviews,0,0,0
712566,True,0,No user reviews,0,0,0
712567,True,0,No user reviews,0,0,0
712568,True,0,No user reviews,0,0,0
712569,True,0,No user reviews,0,0,0
712570,True,0,No user reviews,0,0,0
712571,True,0,No user reviews,0,0,0
712590,True,0,No user reviews,0,0,0
712610,True,0,1 user reviews,1,0,1
712620,True,0,3 user reviews,3,0,3
712630,True,0,6 user reviews,5,1,6
712640,True,8,Very Positive,236,47,283
712650,True,0,7 user reviews,4,3,7
712660,True,0,1 user reviews,1,0,1
712670,True,0,4 user reviews,4,0,4
712680,True,0,No user reviews,0,0,0
712681,True,0,No user reviews,0,0,0
712682,True,0,No user reviews,0,0,0
712683,True,0,No user reviews,0,0,0
712684,True,0,No user reviews,0,0,0
712685,True,0,No user reviews,0,0,0
712686,True,0,No user reviews,0,0,0
712687,True,0,No user reviews,0,0,0
712688,True,0,No user reviews,0,0,0
712689,True,0,No user reviews,0,0,0
712690,True,0,No user reviews,0,0,0
712691,True,0,No user reviews,0,0,0
712692,True,0,No user reviews,0,0,0
712693,True,0,No user reviews,0,0,0
712694,True,0,No user reviews,0,0,0
712695,True,0,No user reviews,0,0,0
712696,True,0,No user reviews,0,0,0
712700,True,0,1 user reviews,1,0,1
712710,True,0,No user reviews,0,0,0
712711,True,0,No user reviews,0,0,0
712720,True,0,5 user reviews,5,0,5
712730,True,8,Very Positive,988,53,1041
712760,True,0,1 user reviews,1,0,1
712770,True,0,No user reviews,0,0,0
712790,True,5,Mixed,14,17,31
712800,True,0,No user reviews,0,0,0
712810,True,5,Mixed,21,12,33
712840,True,6,Mostly Positive,115,37,152
712870,True,0,1 user reviews,0,1,1
712880,True,0,No user reviews,0,0,0
712890,True,0,5 user reviews,4,1,5
712900,True,0,No user reviews,0,0,0
712910,True,0,No user reviews,0,0,0
712920,True,0,1 user reviews,1,0,1
712970,True,7,Positive,14,0,14
712980,True,5,Mixed,9,4,13
713000,True,0,No user reviews,0,0,0
713010,True,0,9 user reviews,7,2,9
713030,True,0,9 user reviews,8,1,9
713050,True,6,Mostly Positive,8,3,11
713060,True,0,No user reviews,0,0,0
713070,True,0,1 user reviews,0,1,1
713080,True,0,3 user reviews,0,3,3
713090,True,7,Positive,12,0,12
713100,True,0,7 user reviews,1,6,7
713110,True,0,1 user reviews,0,1,1
713130,True,0,No user reviews,0,0,0
713150,True,0,1 user reviews,1,0,1
713160,True,7,Positive,31,1,32
713170,True,0,1 user reviews,1,0,1
713180,True,7,Positive,24,3,27
713220,True,7,Positive,9,2,11
713230,True,0,8 user reviews,2,6,8
713240,True,0,No user reviews,0,0,0
713260,True,0,4 user reviews,4,0,4
713270,True,0,2 user reviews,1,1,2
713280,True,0,No user reviews,0,0,0
713290,True,0,No user reviews,0,0,0
713300,True,0,No user reviews,0,0,0
713310,True,0,8 user reviews,8,0,8
713320,True,0,No user reviews,0,0,0
713340,True,0,1 user reviews,1,0,1
713350,True,0,No user reviews,0,0,0
713360,True,0,No user reviews,0,0,0
713370,True,0,1 user reviews,1,0,1
713380,True,0,1 user reviews,1,0,1
713390,True,0,1 user reviews,0,1,1
713400,True,0,4 user reviews,3,1,4
713410,True,0,No user reviews,0,0,0
713420,True,5,Mixed,15,9,24
713430,True,0,8 user reviews,8,0,8
713450,True,0,4 user reviews,2,2,4
713460,True,8,Very Positive,84,16,100
713500,True,0,6 user reviews,3,3,6
713530,True,8,Very Positive,72,14,86
713540,True,0,2 user reviews,2,0,2
713550,True,0,1 user reviews,1,0,1
713560,True,7,Positive,9,2,11
713570,True,0,2 user reviews,1,1,2
713580,True,4,Mostly Negative,4,10,14
713590,True,0,8 user reviews,1,7,8
713600,True,0,8 user reviews,3,5,8
713610,True,0,9 user reviews,4,5,9
713630,True,0,No user reviews,0,0,0
713650,True,0,No user reviews,0,0,0
713680,True,4,Mostly Negative,11,18,29
713690,True,0,5 user reviews,5,0,5
713700,True,0,1 user reviews,1,0,1
713710,True,0,No user reviews,0,0,0
713760,True,0,2 user reviews,1,1,2
713800,True,0,6 user reviews,4,2,6
713830,True,0,No user reviews,0,0,0
713840,True,0,5 user reviews,3,2,5
713860,True,6,Mostly Positive,26,8,34
713880,True,0,No user reviews,0,0,0
713900,True,0,No user reviews,0,0,0
713930,True,0,No user reviews,0,0,0
713960,True,0,No user reviews,0,0,0
713970,True,0,No user reviews,0,0,0
713980,True,0,No user reviews,0,0,0
713990,True,0,No user reviews,0,0,0
714010,True,5,Mixed,24,14,38
714020,True,0,No user reviews,0,0,0
714030,True,0,No user reviews,0,0,0
714050,True,0,5 user reviews,2,3,5
714060,True,0,1 user reviews,1,0,1
714070,True,0,No user reviews,0,0,0
714080,True,8,Very Positive,104,26,130
714100,True,0,No user reviews,0,0,0
714120,True,8,Very Positive,983,160,1143
714130,True,0,No user reviews,0,0,0
714150,True,0,No user reviews,0,0,0
714160,True,0,No user reviews,0,0,0
714170,True,0,1 user reviews,0,1,1
714210,True,0,No user reviews,0,0,0
714230,True,0,1 user reviews,1,0,1
714240,True,7,Positive,32,4,36
714250,True,5,Mixed,11,10,21
714270,True,0,No user reviews,0,0,0
714280,True,0,6 user reviews,4,2,6
714290,True,0,4 user reviews,3,1,4
714300,True,5,Mixed,13,8,21
714320,True,0,No user reviews,0,0,0
714331,True,0,1 user reviews,1,0,1
714332,True,0,No user reviews,0,0,0
714333,True,0,No user reviews,0,0,0
714334,True,0,No user reviews,0,0,0
714335,True,0,No user reviews,0,0,0
714336,True,0,No user reviews,0,0,0
714337,True,0,No user reviews,0,0,0
714340,True,0,No user reviews,0,0,0
714360,True,0,5 user reviews,2,3,5
714370,True,4,Mostly Negative,52,179,231
714380,True,0,No user reviews,0,0,0
714390,True,0,No user reviews,0,0,0
714410,True,0,No user reviews,0,0,0
714420,True,0,No user reviews,0,0,0
714430,True,0,No user reviews,0,0,0
714440,True,0,No user reviews,0,0,0
714450,True,0,No user reviews,0,0,0
714460,True,0,No user reviews,0,0,0
714470,True,0,No user reviews,0,0,0
714480,True,0,No user reviews,0,0,0
714500,True,0,No user reviews,0,0,0
714510,True,0,3 user reviews,2,1,3
714530,True,0,1 user reviews,0,1,1
714570,True,0,5 user reviews,3,2,5
714580,True,0,No user reviews,0,0,0
714600,True,0,No user reviews,0,0,0
714610,True,0,No user reviews,0,0,0
714620,True,5,Mixed,5,5,10
714640,True,5,Mixed,9,6,15
714660,True,0,No user reviews,0,0,0
714710,True,0,No user reviews,0,0,0
714720,True,0,No user reviews,0,0,0
714730,True,0,1 user reviews,1,0,1
714740,True,0,No user reviews,0,0,0
714760,True,0,1 user reviews,1,0,1
714770,True,0,5 user reviews,3,2,5
714780,True,0,No user reviews,0,0,0
714800,True,8,Very Positive,104,5,109
714810,True,0,No user reviews,0,0,0
714830,True,0,1 user reviews,1,0,1
714831,True,0,No user reviews,0,0,0
714840,True,0,2 user reviews,1,1,2
714850,True,0,1 user reviews,1,0,1
714860,True,0,No user reviews,0,0,0
714861,True,0,1 user reviews,1,0,1
714880,True,0,No user reviews,0,0,0
714900,True,0,No user reviews,0,0,0
714910,True,0,No user reviews,0,0,0
714920,True,0,No user reviews,0,0,0
714940,True,0,No user reviews,0,0,0
714941,True,0,No user reviews,0,0,0
714942,True,0,No user reviews,0,0,0
714943,True,0,No user reviews,0,0,0
714944,True,0,No user reviews,0,0,0
714960,True,0,8 user reviews,6,2,8
714970,True,0,No user reviews,0,0,0
714980,True,0,7 user reviews,4,3,7
715010,True,8,Very Positive,197,8,205
715020,True,5,Mixed,7,4,11
715050,True,6,Mostly Positive,97,36,133
715060,True,0,3 user reviews,1,2,3
715070,True,7,Positive,24,1,25
715080,True,0,2 user reviews,2,0,2
715090,True,0,3 user reviews,3,0,3
715100,True,0,No user reviews,0,0,0
715110,True,5,Mixed,17,10,27
715130,True,0,No user reviews,0,0,0
715150,True,0,No user reviews,0,0,0
715190,True,8,Very Positive,53,9,62
715191,True,8,Very Positive,103,24,127
715192,True,0,No user reviews,0,0,0
715193,True,7,Positive,32,5,37
715194,True,5,Mixed,141,77,218
715210,True,0,No user reviews,0,0,0
715260,True,0,No user reviews,0,0,0
715270,True,0,4 user reviews,4,0,4
715280,True,0,6 user reviews,3,3,6
715290,True,0,1 user reviews,0,1,1
715310,True,0,No user reviews,0,0,0
715320,True,0,No user reviews,0,0,0
715350,True,0,No user reviews,0,0,0
715370,True,7,Positive,26,1,27
715380,True,5,Mixed,62,30,92
715390,True,0,No user reviews,0,0,0
715400,True,0,No user reviews,0,0,0
715410,True,0,4 user reviews,1,3,4
715420,True,0,1 user reviews,1,0,1
715430,True,0,2 user reviews,2,0,2
715440,True,7,Positive,12,1,13
715450,True,0,No user reviews,0,0,0
715460,True,7,Positive,14,0,14
715470,True,0,3 user reviews,1,2,3
715480,True,0,1 user reviews,0,1,1
715490,True,0,3 user reviews,2,1,3
715510,True,0,4 user reviews,3,1,4
715520,True,4,Mostly Negative,10,19,29
715540,True,0,No user reviews,0,0,0
715550,True,0,No user reviews,0,0,0
715560,True,8,Very Positive,1661,167,1828
715580,True,7,Positive,34,0,34
715590,True,0,No user reviews,0,0,0
715650,True,7,Positive,11,2,13
715660,True,0,5 user reviews,3,2,5
715670,True,0,5 user reviews,5,0,5
715680,True,0,No user reviews,0,0,0
715690,True,6,Mostly Positive,28,8,36
715740,True,0,No user reviews,0,0,0
715750,True,0,No user reviews,0,0,0
715760,True,0,9 user reviews,8,1,9
715770,True,0,No user reviews,0,0,0
715810,True,0,No user reviews,0,0,0
715840,True,5,Mixed,9,6,15
715850,True,6,Mostly Positive,19,6,25
715870,True,0,8 user reviews,6,2,8
715900,True,0,3 user reviews,3,0,3
715910,True,0,No user reviews,0,0,0
715920,True,0,5 user reviews,5,0,5
715940,True,0,5 user reviews,1,4,5
715950,True,8,Very Positive,75,7,82
715970,True,0,No user reviews,0,0,0
715980,True,4,Mostly Negative,5,15,20
715990,True,0,2 user reviews,2,0,2
716000,True,0,6 user reviews,5,1,6
716010,True,7,Positive,12,1,13
716030,True,7,Positive,21,0,21
716040,True,0,7 user reviews,5,2,7
716050,True,6,Mostly Positive,10,3,13
716060,True,0,No user reviews,0,0,0
716070,True,7,Positive,24,1,25
716080,True,0,No user reviews,0,0,0
716081,True,0,No user reviews,0,0,0
716082,True,0,No user reviews,0,0,0
716090,True,0,9 user reviews,6,3,9
716100,True,0,8 user reviews,3,5,8
716120,True,0,No user reviews,0,0,0
716130,True,0,No user reviews,0,0,0
716140,True,0,2 user reviews,2,0,2
716150,True,7,Positive,13,1,14
716160,True,0,No user reviews,0,0,0
716161,True,0,No user reviews,0,0,0
716162,True,0,No user reviews,0,0,0
716163,True,0,No user reviews,0,0,0
716164,True,0,No user reviews,0,0,0
716165,True,0,No user reviews,0,0,0
716166,True,0,No user reviews,0,0,0
716167,True,0,No user reviews,0,0,0
716170,True,0,No user reviews,0,0,0
716190,True,0,4 user reviews,3,1,4
716200,True,0,No user reviews,0,0,0
716220,True,0,1 user reviews,0,1,1
716230,True,0,7 user reviews,6,1,7
716240,True,0,6 user reviews,4,2,6
716250,True,7,Positive,10,1,11
716260,True,0,No user reviews,0,0,0
716270,True,5,Mixed,31,17,48
716310,True,0,1 user reviews,0,1,1
716320,True,0,No user reviews,0,0,0
716330,True,6,Mostly Positive,11,4,15
716340,True,8,Very Positive,89,2,91
716350,True,0,No user reviews,0,0,0
716360,True,0,6 user reviews,6,0,6
716370,True,0,No user reviews,0,0,0
716380,True,5,Mixed,37,24,61
716390,True,0,1 user reviews,0,1,1
716400,True,0,8 user reviews,4,4,8
716410,True,0,5 user reviews,1,4,5
716420,True,0,No user reviews,0,0,0
716430,True,0,No user reviews,0,0,0
716450,True,0,No user reviews,0,0,0
716480,True,0,1 user reviews,0,1,1
716490,True,9,Overwhelmingly Positive,648,24,672
716500,True,8,Very Positive,371,25,396
716510,True,0,No user reviews,0,0,0
716550,True,0,No user reviews,0,0,0
716560,True,0,6 user reviews,5,1,6
716580,True,7,Positive,11,0,11
716600,True,0,9 user reviews,4,5,9
716610,True,0,No user reviews,0,0,0
716620,True,0,No user reviews,0,0,0
716630,True,5,Mixed,46,30,76
716640,True,6,Mostly Positive,193,68,261
716650,True,8,Very Positive,132,4,136
716660,True,6,Mostly Positive,16,6,22
716670,True,5,Mixed,409,202,611
716680,True,8,Very Positive,53,10,63
716690,True,0,No user reviews,0,0,0
716691,True,0,No user reviews,0,0,0
716710,True,8,Very Positive,254,10,264
716750,True,5,Mixed,9,4,13
716760,True,0,9 user reviews,5,4,9
716770,True,0,6 user reviews,5,1,6
716780,True,0,No user reviews,0,0,0
716790,True,0,1 user reviews,1,0,1
716800,True,0,No user reviews,0,0,0
716820,True,0,No user reviews,0,0,0
716830,True,0,No user reviews,0,0,0
716840,True,0,3 user reviews,1,2,3
716850,True,0,1 user reviews,0,1,1
716870,True,0,1 user reviews,1,0,1
716880,True,0,No user reviews,0,0,0
716890,True,5,Mixed,6,6,12
716900,True,0,No user reviews,0,0,0
716910,True,0,No user reviews,0,0,0
716920,True,0,4 user reviews,2,2,4
716930,True,0,6 user reviews,6,0,6
716940,True,5,Mixed,7,4,11
716950,True,0,No user reviews,0,0,0
716960,True,0,1 user reviews,1,0,1
716970,True,0,1 user reviews,1,0,1
716980,True,0,2 user reviews,2,0,2
716990,True,0,No user reviews,0,0,0
717000,True,0,1 user reviews,1,0,1
717010,True,0,No user reviews,0,0,0
717011,True,0,No user reviews,0,0,0
717012,True,0,No user reviews,0,0,0
717013,True,0,No user reviews,0,0,0
717014,True,0,No user reviews,0,0,0
717015,True,0,No user reviews,0,0,0
717016,True,0,No user reviews,0,0,0
717017,True,0,No user reviews,0,0,0
717018,True,0,No user reviews,0,0,0
717019,True,0,No user reviews,0,0,0
717020,True,0,5 user reviews,4,1,5
717030,True,0,No user reviews,0,0,0
717031,True,0,3 user reviews,2,1,3
717032,True,0,1 user reviews,1,0,1
717040,True,0,3 user reviews,1,2,3
717050,True,0,No user reviews,0,0,0
717060,True,0,3 user reviews,3,0,3
717070,True,7,Positive,16,1,17
717080,True,0,No user reviews,0,0,0
717090,True,0,No user reviews,0,0,0
717100,True,0,No user reviews,0,0,0
717110,True,0,No user reviews,0,0,0
717120,True,5,Mixed,8,6,14
717130,True,0,No user reviews,0,0,0
717160,True,0,No user reviews,0,0,0
717170,True,0,No user reviews,0,0,0
717180,True,0,No user reviews,0,0,0
717190,True,0,No user reviews,0,0,0
717200,True,0,3 user reviews,2,1,3
717210,True,0,No user reviews,0,0,0
717230,True,0,No user reviews,0,0,0
717240,True,0,2 user reviews,1,1,2
717250,True,9,Overwhelmingly Positive,899,4,903
717260,True,0,No user reviews,0,0,0
717280,True,0,1 user reviews,1,0,1
717300,True,0,No user reviews,0,0,0
717310,True,6,Mostly Positive,69,18,87
717320,True,0,No user reviews,0,0,0
717330,True,0,2 user reviews,1,1,2
717340,True,7,Positive,35,1,36
717380,True,0,No user reviews,0,0,0
717400,True,0,1 user reviews,1,0,1
717430,True,0,No user reviews,0,0,0
717440,True,0,No user reviews,0,0,0
717490,True,6,Mostly Positive,26,9,35
717500,True,0,No user reviews,0,0,0
717530,True,0,No user reviews,0,0,0
717540,True,0,3 user reviews,3,0,3
717560,True,6,Mostly Positive,73,30,103
717570,True,0,No user reviews,0,0,0
717580,True,0,No user reviews,0,0,0
717590,True,0,No user reviews,0,0,0
717610,True,8,Very Positive,113,17,130
717620,True,0,No user reviews,0,0,0
717630,True,0,No user reviews,0,0,0
717640,True,8,Very Positive,181,38,219
717650,True,0,No user reviews,0,0,0
717670,True,0,2 user reviews,1,1,2
717680,True,0,No user reviews,0,0,0
717690,True,5,Mixed,700,721,1421
717710,True,0,No user reviews,0,0,0
717720,True,0,3 user reviews,2,1,3
717740,True,0,No user reviews,0,0,0
717741,True,0,No user reviews,0,0,0
717742,True,0,No user reviews,0,0,0
717743,True,0,No user reviews,0,0,0
717744,True,0,No user reviews,0,0,0
717745,True,0,No user reviews,0,0,0
717746,True,0,No user reviews,0,0,0
717747,True,0,No user reviews,0,0,0
717748,True,0,No user reviews,0,0,0
717749,True,0,No user reviews,0,0,0
717751,True,0,No user reviews,0,0,0
717752,True,0,No user reviews,0,0,0
717753,True,0,No user reviews,0,0,0
717760,True,0,2 user reviews,2,0,2
717780,True,7,Positive,18,2,20
717790,True,6,Mostly Positive,161,68,229
717800,True,0,No user reviews,0,0,0
717820,True,5,Mixed,8,5,13
717830,True,0,6 user reviews,6,0,6
717840,True,0,4 user reviews,4,0,4
717850,True,8,Very Positive,68,2,70
717910,True,0,No user reviews,0,0,0
717930,True,0,No user reviews,0,0,0
717940,True,0,No user reviews,0,0,0
717950,True,8,Very Positive,46,11,57
717960,True,0,1 user reviews,1,0,1
717980,True,0,No user reviews,0,0,0
717990,True,0,No user reviews,0,0,0
718010,True,7,Positive,21,1,22
718020,True,0,4 user reviews,4,0,4
718030,True,0,6 user reviews,6,0,6
718040,True,0,No user reviews,0,0,0
718050,True,0,No user reviews,0,0,0
718070,True,0,3 user reviews,1,2,3
718080,True,0,9 user reviews,7,2,9
718100,True,0,1 user reviews,1,0,1
718120,True,0,4 user reviews,4,0,4
718130,True,0,1 user reviews,1,0,1
718140,True,0,3 user reviews,1,2,3
718150,True,0,No user reviews,0,0,0
718180,True,5,Mixed,32,14,46
718200,True,8,Very Positive,90,7,97
718210,True,0,7 user reviews,6,1,7
718220,True,0,4 user reviews,2,2,4
718230,True,0,No user reviews,0,0,0
718240,True,0,5 user reviews,4,1,5
718250,True,7,Positive,13,1,14
718270,True,0,No user reviews,0,0,0
718290,True,0,No user reviews,0,0,0
718310,True,0,No user reviews,0,0,0
718320,True,5,Mixed,10,12,22
718330,True,8,Very Positive,60,6,66
718350,True,0,3 user reviews,0,3,3
718370,True,5,Mixed,39,42,81
718380,True,5,Mixed,7,7,14
718390,True,0,No user reviews,0,0,0
718410,True,0,1 user reviews,1,0,1
718420,True,0,No user reviews,0,0,0
718460,True,0,No user reviews,0,0,0
718470,True,0,1 user reviews,1,0,1
718480,True,0,No user reviews,0,0,0
718490,True,0,2 user reviews,2,0,2
718500,True,0,No user reviews,0,0,0
718520,True,0,No user reviews,0,0,0
718530,True,0,3 user reviews,3,0,3
718540,True,5,Mixed,5,5,10
718550,True,0,No user reviews,0,0,0
718560,True,8,Very Positive,1095,115,1210
718570,True,7,Positive,12,0,12
718590,True,6,Mostly Positive,306,87,393
718600,True,0,6 user reviews,5,1,6
718630,True,0,No user reviews,0,0,0
718650,True,6,Mostly Positive,360,124,484
718660,True,5,Mixed,5,5,10
718670,True,8,Very Positive,2054,506,2560
718680,True,0,4 user reviews,3,1,4
718690,True,0,1 user reviews,1,0,1
718700,True,0,No user reviews,0,0,0
718710,True,0,1 user reviews,1,0,1
718720,True,7,Positive,15,3,18
718730,True,7,Positive,24,1,25
718740,True,0,No user reviews,0,0,0
718750,True,0,No user reviews,0,0,0
718790,True,0,No user reviews,0,0,0
718800,True,0,1 user reviews,1,0,1
718830,True,0,4 user reviews,2,2,4
718840,True,0,No user reviews,0,0,0
718850,True,6,Mostly Positive,1225,313,1538
718900,True,0,No user reviews,0,0,0
718910,True,0,3 user reviews,1,2,3
718920,True,0,2 user reviews,0,2,2
718940,True,0,No user reviews,0,0,0
718950,True,0,No user reviews,0,0,0
718960,True,0,4 user reviews,2,2,4
718970,True,0,6 user reviews,4,2,6
718980,True,0,1 user reviews,0,1,1
718990,True,0,2 user reviews,0,2,2
719000,True,0,No user reviews,0,0,0
719010,True,0,No user reviews,0,0,0
719020,True,0,No user reviews,0,0,0
719030,True,0,No user reviews,0,0,0
719040,True,8,Very Positive,2725,621,3346
719070,True,0,2 user reviews,2,0,2
719080,True,7,Positive,18,2,20
719090,True,0,5 user reviews,4,1,5
719100,True,0,1 user reviews,0,1,1
719110,True,0,5 user reviews,4,1,5
719120,True,3,Negative,1,9,10
719130,True,0,5 user reviews,4,1,5
719140,True,0,9 user reviews,8,1,9
719160,True,0,No user reviews,0,0,0
719180,True,6,Mostly Positive,35,9,44
719200,True,6,Mostly Positive,104,37,141
719210,True,7,Positive,11,0,11
719220,True,0,1 user reviews,1,0,1
719240,True,0,No user reviews,0,0,0
719250,True,0,8 user reviews,6,2,8
719260,True,0,2 user reviews,1,1,2
719270,True,0,No user reviews,0,0,0
719280,True,0,No user reviews,0,0,0
719290,True,0,1 user reviews,1,0,1
719300,True,0,1 user reviews,1,0,1
719310,True,0,1 user reviews,1,0,1
719320,True,0,4 user reviews,2,2,4
719330,True,7,Positive,45,4,49
719340,True,0,No user reviews,0,0,0
719350,True,0,1 user reviews,1,0,1
719370,True,0,No user reviews,0,0,0
719410,True,5,Mixed,8,5,13
719430,True,7,Positive,35,8,43
719470,True,0,1 user reviews,1,0,1
719480,True,0,1 user reviews,1,0,1
719490,True,0,No user reviews,0,0,0
719520,True,7,Positive,28,5,33
719530,True,0,No user reviews,0,0,0
719540,True,0,4 user reviews,1,3,4
719550,True,0,8 user reviews,7,1,8
719570,True,0,No user reviews,0,0,0
719590,True,4,Mostly Negative,63,241,304
719600,True,0,4 user reviews,1,3,4
719610,True,5,Mixed,25,21,46
719630,True,0,No user reviews,0,0,0
719640,True,0,No user reviews,0,0,0
719660,True,8,Very Positive,56,1,57
719670,True,0,2 user reviews,1,1,2
719690,True,6,Mostly Positive,17,5,22
719710,True,0,3 user reviews,3,0,3
719720,True,0,No user reviews,0,0,0
719730,True,0,No user reviews,0,0,0
719740,True,0,1 user reviews,1,0,1
719750,True,8,Very Positive,160,14,174
719800,True,7,Positive,13,2,15
719820,True,0,1 user reviews,0,1,1
719830,True,0,1 user reviews,0,1,1
719840,True,0,2 user reviews,2,0,2
719890,True,6,Mostly Positive,779,294,1073
719920,True,0,No user reviews,0,0,0
719930,True,0,5 user reviews,5,0,5
719970,True,0,3 user reviews,0,3,3
719990,True,0,No user reviews,0,0,0
720000,True,0,6 user reviews,3,3,6
720020,True,0,1 user reviews,1,0,1
720030,True,8,Very Positive,115,21,136
720040,True,3,Negative,2,16,18
720060,True,0,3 user reviews,1,2,3
720100,True,0,No user reviews,0,0,0
720110,True,0,No user reviews,0,0,0
720130,True,0,1 user reviews,1,0,1
720140,True,0,No user reviews,0,0,0
720150,True,7,Positive,37,3,40
720160,True,0,No user reviews,0,0,0
720170,True,0,No user reviews,0,0,0
720180,True,0,1 user reviews,1,0,1
720200,True,6,Mostly Positive,10,4,14
720230,True,0,No user reviews,0,0,0
720240,True,5,Mixed,8,9,17
720250,True,8,Very Positive,734,162,896
720260,True,0,No user reviews,0,0,0
720270,True,5,Mixed,11,9,20
720280,True,8,Very Positive,365,82,447
720290,True,5,Mixed,8,5,13
720300,True,0,No user reviews,0,0,0
720310,True,0,2 user reviews,0,2,2
720330,True,0,1 user reviews,0,1,1
720340,True,0,No user reviews,0,0,0
720350,True,0,No user reviews,0,0,0
720380,True,0,No user reviews,0,0,0
720400,True,0,1 user reviews,1,0,1
720440,True,0,No user reviews,0,0,0
720450,True,0,1 user reviews,0,1,1
720470,True,0,9 user reviews,1,8,9
720480,True,0,3 user reviews,3,0,3
720490,True,0,No user reviews,0,0,0
720510,True,0,7 user reviews,6,1,7
720530,True,7,Positive,16,2,18
720540,True,0,No user reviews,0,0,0
720560,True,8,Very Positive,193,29,222
720590,True,0,2 user reviews,2,0,2
720600,True,0,6 user reviews,5,1,6
720610,True,0,No user reviews,0,0,0
720611,True,0,No user reviews,0,0,0
720612,True,0,No user reviews,0,0,0
720613,True,0,No user reviews,0,0,0
720614,True,0,No user reviews,0,0,0
720615,True,0,No user reviews,0,0,0
720616,True,0,No user reviews,0,0,0
720618,True,0,No user reviews,0,0,0
720620,True,0,No user reviews,0,0,0
720640,True,0,1 user reviews,1,0,1
720660,True,0,No user reviews,0,0,0
720670,True,0,No user reviews,0,0,0
720680,True,7,Positive,20,5,25
720690,True,0,2 user reviews,2,0,2
720700,True,0,2 user reviews,2,0,2
720710,True,0,6 user reviews,5,1,6
720720,True,0,No user reviews,0,0,0
720730,True,4,Mostly Negative,5,8,13
720740,True,0,6 user reviews,6,0,6
720750,True,0,5 user reviews,1,4,5
720760,True,0,5 user reviews,3,2,5
720770,True,0,5 user reviews,5,0,5
720780,True,6,Mostly Positive,7,3,10
720790,True,0,3 user reviews,2,1,3
720800,True,0,5 user reviews,1,4,5
720810,True,0,No user reviews,0,0,0
720820,True,0,No user reviews,0,0,0
720850,True,0,2 user reviews,2,0,2
720860,True,0,9 user reviews,9,0,9
720900,True,0,No user reviews,0,0,0
720930,True,0,No user reviews,0,0,0
720940,True,7,Positive,27,3,30
720950,True,0,1 user reviews,1,0,1
720960,True,6,Mostly Positive,8,3,11
720980,True,0,No user reviews,0,0,0
720990,True,0,No user reviews,0,0,0
721000,True,0,No user reviews,0,0,0
721010,True,8,Very Positive,48,5,53
721030,True,0,No user reviews,0,0,0
721050,True,0,1 user reviews,1,0,1
721051,True,0,1 user reviews,1,0,1
721052,True,0,2 user reviews,1,1,2
721053,True,0,No user reviews,0,0,0
721054,True,0,No user reviews,0,0,0
721060,True,4,Mostly Negative,4,7,11
721080,True,0,4 user reviews,1,3,4
721090,True,5,Mixed,9,5,14
721100,True,0,2 user reviews,2,0,2
721101,True,0,1 user reviews,1,0,1
721102,True,0,No user reviews,0,0,0
721103,True,0,No user reviews,0,0,0
721104,True,0,3 user reviews,2,1,3
721105,True,0,2 user reviews,2,0,2
721106,True,0,1 user reviews,1,0,1
721107,True,0,1 user reviews,1,0,1
721108,True,0,1 user reviews,1,0,1
721109,True,0,No user reviews,0,0,0
721110,True,0,No user reviews,0,0,0
721111,True,0,No user reviews,0,0,0
721112,True,0,No user reviews,0,0,0
721113,True,0,No user reviews,0,0,0
721114,True,0,1 user reviews,1,0,1
721115,True,0,No user reviews,0,0,0
721116,True,0,No user reviews,0,0,0
721117,True,0,No user reviews,0,0,0
721118,True,0,1 user reviews,1,0,1
721119,True,0,No user reviews,0,0,0
721130,True,0,No user reviews,0,0,0
721131,True,0,No user reviews,0,0,0
721132,True,0,5 user reviews,5,0,5
721133,True,0,2 user reviews,2,0,2
721140,True,0,No user reviews,0,0,0
721141,True,0,No user reviews,0,0,0
721142,True,0,No user reviews,0,0,0
721143,True,0,No user reviews,0,0,0
721144,True,0,No user reviews,0,0,0
721145,True,0,1 user reviews,1,0,1
721146,True,0,No user reviews,0,0,0
721147,True,0,No user reviews,0,0,0
721148,True,0,No user reviews,0,0,0
721149,True,0,1 user reviews,0,1,1
721150,True,0,1 user reviews,1,0,1
721151,True,0,No user reviews,0,0,0
721180,True,0,No user reviews,0,0,0
721260,True,0,3 user reviews,3,0,3
721270,True,0,5 user reviews,4,1,5
721280,True,0,4 user reviews,4,0,4
721290,True,0,No user reviews,0,0,0
721300,True,0,2 user reviews,1,1,2
721310,True,0,No user reviews,0,0,0
721320,True,0,No user reviews,0,0,0
721330,True,0,No user reviews,0,0,0
721340,True,5,Mixed,65,28,93
721341,True,5,Mixed,6,6,12
721350,True,0,1 user reviews,1,0,1
721380,True,0,5 user reviews,5,0,5
721390,True,7,Positive,38,1,39
721400,True,0,5 user reviews,4,1,5
721410,True,0,5 user reviews,4,1,5
721420,True,0,3 user reviews,1,2,3
721430,True,6,Mostly Positive,17,5,22
721460,True,0,No user reviews,0,0,0
721470,True,0,2 user reviews,1,1,2
721480,True,0,4 user reviews,4,0,4
721490,True,0,No user reviews,0,0,0
721510,True,0,No user reviews,0,0,0
721540,True,0,1 user reviews,0,1,1
721550,True,0,No user reviews,0,0,0
721560,True,0,No user reviews,0,0,0
721570,True,0,No user reviews,0,0,0
721580,True,0,No user reviews,0,0,0
721590,True,0,No user reviews,0,0,0
721600,True,0,No user reviews,0,0,0
721610,True,0,No user reviews,0,0,0
721620,True,8,Very Positive,40,10,50
721630,True,0,No user reviews,0,0,0
721640,True,0,No user reviews,0,0,0
721650,True,0,No user reviews,0,0,0
721670,True,0,2 user reviews,1,1,2
721700,True,0,No user reviews,0,0,0
721710,True,0,No user reviews,0,0,0
721711,True,0,No user reviews,0,0,0
721720,True,0,No user reviews,0,0,0
721740,True,0,6 user reviews,5,1,6
721750,True,0,No user reviews,0,0,0
721760,True,6,Mostly Positive,14,4,18
721770,True,0,No user reviews,0,0,0
721800,True,0,No user reviews,0,0,0
721801,True,0,No user reviews,0,0,0
721802,True,0,No user reviews,0,0,0
721803,True,0,No user reviews,0,0,0
721804,True,0,No user reviews,0,0,0
721805,True,0,No user reviews,0,0,0
721806,True,0,No user reviews,0,0,0
721807,True,0,No user reviews,0,0,0
721808,True,0,No user reviews,0,0,0
721809,True,0,No user reviews,0,0,0
721810,True,0,No user reviews,0,0,0
721811,True,0,No user reviews,0,0,0
721812,True,0,No user reviews,0,0,0
721813,True,0,No user reviews,0,0,0
721814,True,0,No user reviews,0,0,0
721815,True,0,No user reviews,0,0,0
721816,True,0,No user reviews,0,0,0
721817,True,0,No user reviews,0,0,0
721818,True,0,No user reviews,0,0,0
721819,True,0,No user reviews,0,0,0
721820,True,0,No user reviews,0,0,0
721821,True,0,No user reviews,0,0,0
721822,True,0,No user reviews,0,0,0
721823,True,0,No user reviews,0,0,0
721850,True,0,No user reviews,0,0,0
721870,True,0,No user reviews,0,0,0
721880,True,0,No user reviews,0,0,0
721890,True,0,6 user reviews,4,2,6
721910,True,0,No user reviews,0,0,0
721930,True,0,No user reviews,0,0,0
721940,True,5,Mixed,13,6,19
721950,True,5,Mixed,7,7,14
721960,True,0,3 user reviews,2,1,3
721980,True,0,No user reviews,0,0,0
721990,True,0,No user reviews,0,0,0
722010,True,0,3 user reviews,0,3,3
722020,True,0,6 user reviews,0,6,6
722040,True,0,9 user reviews,7,2,9
722050,True,0,3 user reviews,3,0,3
722060,True,8,Very Positive,889,52,941
722070,True,0,No user reviews,0,0,0
722080,True,0,No user reviews,0,0,0
722090,True,0,1 user reviews,1,0,1
722120,True,0,No user reviews,0,0,0
722130,True,0,No user reviews,0,0,0
722180,True,8,Very Positive,244,49,293
722190,True,0,5 user reviews,3,2,5
722200,True,0,No user reviews,0,0,0
722230,True,5,Mixed,244,201,445
722250,True,5,Mixed,18,8,26
722270,True,0,No user reviews,0,0,0
722290,True,0,5 user reviews,2,3,5
722310,True,0,No user reviews,0,0,0
722330,True,7,Positive,15,1,16
722340,True,0,1 user reviews,0,1,1
722350,True,0,5 user reviews,3,2,5
722360,True,0,No user reviews,0,0,0
722361,True,0,No user reviews,0,0,0
722362,True,0,No user reviews,0,0,0
722370,True,0,1 user reviews,1,0,1
722380,True,0,No user reviews,0,0,0
722390,True,0,No user reviews,0,0,0
722400,True,0,1 user reviews,1,0,1
722410,True,0,2 user reviews,0,2,2
722420,True,0,No user reviews,0,0,0
722421,True,0,No user reviews,0,0,0
722422,True,0,No user reviews,0,0,0
722423,True,0,No user reviews,0,0,0
722424,True,0,No user reviews,0,0,0
722425,True,0,No user reviews,0,0,0
722426,True,0,No user reviews,0,0,0
722427,True,0,No user reviews,0,0,0
722428,True,0,No user reviews,0,0,0
722429,True,0,No user reviews,0,0,0
722430,True,0,No user reviews,0,0,0
722431,True,0,No user reviews,0,0,0
722460,True,0,No user reviews,0,0,0
722461,True,0,No user reviews,0,0,0
722462,True,0,No user reviews,0,0,0
722463,True,0,No user reviews,0,0,0
722464,True,0,No user reviews,0,0,0
722465,True,0,No user reviews,0,0,0
722466,True,0,No user reviews,0,0,0
722467,True,0,No user reviews,0,0,0
722468,True,0,No user reviews,0,0,0
722469,True,0,No user reviews,0,0,0
722470,True,0,No user reviews,0,0,0
722471,True,0,No user reviews,0,0,0
722490,True,0,1 user reviews,0,1,1
722491,True,0,No user reviews,0,0,0
722492,True,0,No user reviews,0,0,0
722493,True,0,No user reviews,0,0,0
722494,True,0,No user reviews,0,0,0
722495,True,0,No user reviews,0,0,0
722496,True,0,No user reviews,0,0,0
722497,True,0,No user reviews,0,0,0
722498,True,0,No user reviews,0,0,0
722499,True,0,No user reviews,0,0,0
722500,True,0,No user reviews,0,0,0
722501,True,0,No user reviews,0,0,0
722502,True,0,No user reviews,0,0,0
722520,True,0,No user reviews,0,0,0
722530,True,0,No user reviews,0,0,0
722540,True,5,Mixed,4,6,10
722550,True,0,No user reviews,0,0,0
722560,True,6,Mostly Positive,220,58,278
722570,True,0,7 user reviews,3,4,7
722580,True,0,No user reviews,0,0,0
722590,True,0,No user reviews,0,0,0
722600,True,0,5 user reviews,5,0,5
722610,True,0,No user reviews,0,0,0
722620,True,0,3 user reviews,3,0,3
722650,True,0,No user reviews,0,0,0
722660,True,5,Mixed,16,11,27
722670,True,7,Positive,9,2,11
722680,True,0,2 user reviews,1,1,2
722690,True,0,No user reviews,0,0,0
722710,True,0,No user reviews,0,0,0
722720,True,0,No user reviews,0,0,0
722730,True,9,Overwhelmingly Positive,556,20,576
722740,True,0,No user reviews,0,0,0
722750,True,0,No user reviews,0,0,0
722760,True,0,2 user reviews,2,0,2
722770,True,0,No user reviews,0,0,0
722800,True,0,2 user reviews,2,0,2
722810,True,0,4 user reviews,1,3,4
722820,True,0,No user reviews,0,0,0
722840,True,0,No user reviews,0,0,0
722841,True,0,No user reviews,0,0,0
722842,True,0,No user reviews,0,0,0
722843,True,0,No user reviews,0,0,0
722844,True,0,No user reviews,0,0,0
722850,True,0,1 user reviews,1,0,1
722851,True,0,4 user reviews,3,1,4
722870,True,7,Positive,35,2,37
722880,True,0,No user reviews,0,0,0
722881,True,0,No user reviews,0,0,0
722890,True,0,6 user reviews,6,0,6
722900,True,0,No user reviews,0,0,0
722910,True,0,1 user reviews,1,0,1
722920,True,7,Positive,24,6,30
722960,True,6,Mostly Positive,140,48,188
722990,True,7,Positive,9,1,10
723000,True,0,No user reviews,0,0,0
723020,True,0,3 user reviews,0,3,3
723030,True,0,No user reviews,0,0,0
723040,True,0,No user reviews,0,0,0
723050,True,0,No user reviews,0,0,0
723070,True,0,3 user reviews,2,1,3
723080,True,0,1 user reviews,1,0,1
723090,True,9,Overwhelmingly Positive,598,14,612
723100,True,6,Mostly Positive,10,3,13
723110,True,0,8 user reviews,6,2,8
723120,True,0,No user reviews,0,0,0
723130,True,0,No user reviews,0,0,0
723170,True,0,No user reviews,0,0,0
723180,True,0,1 user reviews,0,1,1
723190,True,0,5 user reviews,2,3,5
723210,True,0,No user reviews,0,0,0
723260,True,0,No user reviews,0,0,0
723270,True,8,Very Positive,322,34,356
723280,True,0,2 user reviews,1,1,2
723320,True,0,No user reviews,0,0,0
723330,True,0,No user reviews,0,0,0
723340,True,0,No user reviews,0,0,0
723350,True,7,Positive,29,6,35
723370,True,0,2 user reviews,1,1,2
723380,True,0,2 user reviews,1,1,2
723390,True,4,Mostly Negative,378,634,1012
723410,True,0,No user reviews,0,0,0
723420,True,0,No user reviews,0,0,0
723430,True,0,No user reviews,0,0,0
723440,True,0,No user reviews,0,0,0
723450,True,5,Mixed,12,7,19
723460,True,0,1 user reviews,1,0,1
723470,True,0,No user reviews,0,0,0
723510,True,0,2 user reviews,1,1,2
723520,True,0,No user reviews,0,0,0
723530,True,0,2 user reviews,2,0,2
723540,True,0,2 user reviews,0,2,2
723550,True,0,No user reviews,0,0,0
723560,True,0,No user reviews,0,0,0
723600,True,0,No user reviews,0,0,0
723610,True,0,No user reviews,0,0,0
723620,True,0,No user reviews,0,0,0
723650,True,0,1 user reviews,1,0,1
723750,True,0,No user reviews,0,0,0
723760,True,0,4 user reviews,4,0,4
723770,True,0,No user reviews,0,0,0
723780,True,0,No user reviews,0,0,0
723790,True,0,No user reviews,0,0,0
723800,True,0,2 user reviews,0,2,2
723810,True,0,6 user reviews,1,5,6
723820,True,0,2 user reviews,2,0,2
723830,True,0,8 user reviews,4,4,8
723880,True,0,2 user reviews,1,1,2
723890,True,8,Very Positive,68,11,79
723910,True,0,1 user reviews,1,0,1
723920,True,0,No user reviews,0,0,0
723930,True,7,Positive,9,1,10
723940,True,0,3 user reviews,3,0,3
723950,True,0,No user reviews,0,0,0
723960,True,0,No user reviews,0,0,0
723990,True,0,No user reviews,0,0,0
724000,True,0,No user reviews,0,0,0
724010,True,7,Positive,12,2,14
724020,True,0,No user reviews,0,0,0
724030,True,0,2 user reviews,2,0,2
724060,True,0,No user reviews,0,0,0
724070,True,5,Mixed,8,4,12
724080,True,0,7 user reviews,4,3,7
724090,True,0,2 user reviews,0,2,2
724100,True,0,No user reviews,0,0,0
724110,True,0,3 user reviews,0,3,3
724120,True,0,3 user reviews,3,0,3
724130,True,0,5 user reviews,4,1,5
724170,True,0,No user reviews,0,0,0
724180,True,0,No user reviews,0,0,0
724190,True,0,No user reviews,0,0,0
724191,True,0,No user reviews,0,0,0
724192,True,0,No user reviews,0,0,0
724193,True,0,No user reviews,0,0,0
724194,True,0,No user reviews,0,0,0
724195,True,0,No user reviews,0,0,0
724196,True,0,No user reviews,0,0,0
724197,True,0,No user reviews,0,0,0
724198,True,0,No user reviews,0,0,0
724199,True,0,No user reviews,0,0,0
724200,True,0,No user reviews,0,0,0
724201,True,0,No user reviews,0,0,0
724230,True,0,No user reviews,0,0,0
724240,True,0,No user reviews,0,0,0
724250,True,6,Mostly Positive,47,19,66
724260,True,0,9 user reviews,8,1,9
724290,True,0,No user reviews,0,0,0
724300,True,8,Very Positive,163,12,175
724310,True,0,No user reviews,0,0,0
724330,True,0,6 user reviews,5,1,6
724340,True,0,1 user reviews,1,0,1
724350,True,5,Mixed,11,9,20
724360,True,0,No user reviews,0,0,0
724370,True,0,7 user reviews,7,0,7
724380,True,0,No user reviews,0,0,0
724390,True,6,Mostly Positive,21,7,28
724420,True,5,Mixed,6,4,10
724430,True,4,Mostly Negative,6,16,22
724440,True,0,6 user reviews,6,0,6
724460,True,0,3 user reviews,1,2,3
724470,True,8,Very Positive,66,15,81
724480,True,0,4 user reviews,1,3,4
724490,True,5,Mixed,13,9,22
724510,True,5,Mixed,16,8,24
724520,True,0,No user reviews,0,0,0
724580,True,0,7 user reviews,2,5,7
724590,True,0,2 user reviews,1,1,2
724600,True,0,No user reviews,0,0,0
724610,True,0,No user reviews,0,0,0
724620,True,0,No user reviews,0,0,0
724630,True,0,8 user reviews,4,4,8
724640,True,0,5 user reviews,5,0,5
724650,True,0,No user reviews,0,0,0
724680,True,0,No user reviews,0,0,0
724690,True,0,9 user reviews,5,4,9
724710,True,5,Mixed,13,9,22
724720,True,0,6 user reviews,6,0,6
724740,True,5,Mixed,123,60,183
724750,True,0,No user reviews,0,0,0
724760,True,0,3 user reviews,2,1,3
724780,True,0,1 user reviews,1,0,1
724781,True,0,No user reviews,0,0,0
724782,True,0,No user reviews,0,0,0
724783,True,0,No user reviews,0,0,0
724784,True,0,No user reviews,0,0,0
724785,True,0,No user reviews,0,0,0
724786,True,0,No user reviews,0,0,0
724787,True,0,No user reviews,0,0,0
724788,True,0,No user reviews,0,0,0
724789,True,0,No user reviews,0,0,0
724790,True,0,No user reviews,0,0,0
724791,True,0,No user reviews,0,0,0
724800,True,0,No user reviews,0,0,0
724801,True,0,No user reviews,0,0,0
724802,True,0,No user reviews,0,0,0
724803,True,0,No user reviews,0,0,0
724804,True,0,No user reviews,0,0,0
724805,True,0,No user reviews,0,0,0
724806,True,0,No user reviews,0,0,0
724807,True,0,No user reviews,0,0,0
724808,True,0,No user reviews,0,0,0
724809,True,0,No user reviews,0,0,0
724810,True,0,No user reviews,0,0,0
724811,True,0,No user reviews,0,0,0
724812,True,0,No user reviews,0,0,0
724813,True,0,No user reviews,0,0,0
724814,True,0,No user reviews,0,0,0
724815,True,0,No user reviews,0,0,0
724816,True,0,No user reviews,0,0,0
724817,True,0,No user reviews,0,0,0
724818,True,0,No user reviews,0,0,0
724819,True,0,No user reviews,0,0,0
724820,True,0,No user reviews,0,0,0
724821,True,0,No user reviews,0,0,0
724822,True,0,No user reviews,0,0,0
724823,True,0,No user reviews,0,0,0
724824,True,0,No user reviews,0,0,0
724825,True,0,No user reviews,0,0,0
724826,True,0,No user reviews,0,0,0
724827,True,0,No user reviews,0,0,0
724828,True,0,No user reviews,0,0,0
724829,True,0,No user reviews,0,0,0
724830,True,0,No user reviews,0,0,0
724831,True,0,No user reviews,0,0,0
724840,True,0,2 user reviews,2,0,2
724850,True,0,1 user reviews,1,0,1
724851,True,0,No user reviews,0,0,0
724852,True,0,No user reviews,0,0,0
724853,True,0,No user reviews,0,0,0
724854,True,0,No user reviews,0,0,0
724855,True,0,No user reviews,0,0,0
724856,True,0,No user reviews,0,0,0
724857,True,0,No user reviews,0,0,0
724858,True,0,No user reviews,0,0,0
724859,True,0,No user reviews,0,0,0
724860,True,0,No user reviews,0,0,0
724861,True,0,No user reviews,0,0,0
724870,True,0,No user reviews,0,0,0
724890,True,0,No user reviews,0,0,0
724900,True,0,4 user reviews,2,2,4
724910,True,0,No user reviews,0,0,0
724920,True,0,2 user reviews,1,1,2
724930,True,0,No user reviews,0,0,0
724940,True,0,6 user reviews,2,4,6
724950,True,0,No user reviews,0,0,0
724960,True,0,No user reviews,0,0,0
724970,True,6,Mostly Positive,57,16,73
724980,True,7,Positive,17,1,18
725010,True,0,No user reviews,0,0,0
725020,True,0,No user reviews,0,0,0
725030,True,0,1 user reviews,1,0,1
725040,True,7,Positive,19,2,21
725050,True,0,1 user reviews,1,0,1
725080,True,6,Mostly Positive,7,3,10
725090,True,0,No user reviews,0,0,0
725100,True,0,No user reviews,0,0,0
725110,True,0,6 user reviews,4,2,6
725120,True,7,Positive,36,3,39
725130,True,0,No user reviews,0,0,0
725140,True,0,No user reviews,0,0,0
725150,True,0,No user reviews,0,0,0
725170,True,7,Positive,10,1,11
725260,True,0,No user reviews,0,0,0
725270,True,8,Very Positive,270,22,292
725280,True,0,9 user reviews,5,4,9
725310,True,0,No user reviews,0,0,0
725320,True,0,1 user reviews,0,1,1
725330,True,8,Very Positive,54,2,56
725340,True,0,No user reviews,0,0,0
725353,True,5,Mixed,74,34,108
725370,True,5,Mixed,12,15,27
725380,True,0,7 user reviews,7,0,7
725400,True,5,Mixed,9,10,19
725410,True,7,Positive,28,2,30
725420,True,0,No user reviews,0,0,0
725430,True,0,1 user reviews,1,0,1
725460,True,0,No user reviews,0,0,0
725461,True,0,No user reviews,0,0,0
725462,True,0,No user reviews,0,0,0
725463,True,0,No user reviews,0,0,0
725464,True,0,No user reviews,0,0,0
725465,True,0,No user reviews,0,0,0
725466,True,0,No user reviews,0,0,0
725467,True,0,No user reviews,0,0,0
725468,True,0,No user reviews,0,0,0
725469,True,0,No user reviews,0,0,0
725470,True,0,No user reviews,0,0,0
725471,True,0,No user reviews,0,0,0
725480,True,9,Overwhelmingly Positive,1790,89,1879
725510,True,0,No user reviews,0,0,0
725520,True,0,No user reviews,0,0,0
725521,True,0,No user reviews,0,0,0
725522,True,0,No user reviews,0,0,0
725523,True,0,No user reviews,0,0,0
725524,True,0,No user reviews,0,0,0
725525,True,0,No user reviews,0,0,0
725526,True,0,No user reviews,0,0,0
725527,True,0,No user reviews,0,0,0
725528,True,0,No user reviews,0,0,0
725529,True,0,No user reviews,0,0,0
725530,True,0,No user reviews,0,0,0
725531,True,0,No user reviews,0,0,0
725540,True,0,No user reviews,0,0,0
725550,True,0,2 user reviews,1,1,2
725580,True,0,No user reviews,0,0,0
725581,True,0,No user reviews,0,0,0
725582,True,0,No user reviews,0,0,0
725583,True,0,No user reviews,0,0,0
725584,True,0,No user reviews,0,0,0
725585,True,0,No user reviews,0,0,0
725586,True,0,No user reviews,0,0,0
725587,True,0,No user reviews,0,0,0
725588,True,0,No user reviews,0,0,0
725589,True,0,No user reviews,0,0,0
725590,True,0,No user reviews,0,0,0
725591,True,0,No user reviews,0,0,0
725610,True,7,Positive,11,2,13
725620,True,0,1 user reviews,1,0,1
725640,True,0,4 user reviews,3,1,4
725660,True,0,No user reviews,0,0,0
725680,True,0,8 user reviews,5,3,8
725720,True,0,No user reviews,0,0,0
725721,True,0,No user reviews,0,0,0
725722,True,0,No user reviews,0,0,0
725723,True,0,No user reviews,0,0,0
725724,True,0,No user reviews,0,0,0
725725,True,0,No user reviews,0,0,0
725726,True,0,No user reviews,0,0,0
725727,True,0,No user reviews,0,0,0
725728,True,0,No user reviews,0,0,0
725729,True,0,No user reviews,0,0,0
725730,True,0,No user reviews,0,0,0
725731,True,0,No user reviews,0,0,0
725740,True,0,No user reviews,0,0,0
725741,True,0,No user reviews,0,0,0
725742,True,0,No user reviews,0,0,0
725743,True,0,No user reviews,0,0,0
725744,True,0,No user reviews,0,0,0
725745,True,0,No user reviews,0,0,0
725746,True,0,No user reviews,0,0,0
725747,True,0,No user reviews,0,0,0
725748,True,0,No user reviews,0,0,0
725749,True,0,No user reviews,0,0,0
725750,True,0,No user reviews,0,0,0
725751,True,0,No user reviews,0,0,0
725780,True,6,Mostly Positive,34,13,47
725790,True,0,No user reviews,0,0,0
725850,True,7,Positive,11,0,11
725860,True,0,No user reviews,0,0,0
725870,True,0,No user reviews,0,0,0
725880,True,0,No user reviews,0,0,0
725890,True,0,No user reviews,0,0,0
725910,True,0,1 user reviews,1,0,1
725920,True,0,No user reviews,0,0,0
725950,True,0,2 user reviews,0,2,2
725960,True,4,Mostly Negative,12,23,35
725970,True,0,6 user reviews,5,1,6
725980,True,0,No user reviews,0,0,0
726000,True,7,Positive,36,4,40
726020,True,7,Positive,20,4,24
726030,True,0,3 user reviews,0,3,3
726050,True,7,Positive,21,4,25
726060,True,0,4 user reviews,0,4,4
726070,True,3,Negative,2,13,15
726100,True,0,No user reviews,0,0,0
726110,True,8,Very Positive,512,50,562
726120,True,6,Mostly Positive,9,3,12
726140,True,0,No user reviews,0,0,0
726160,True,0,No user reviews,0,0,0
726190,True,0,1 user reviews,1,0,1
726200,True,8,Very Positive,76,18,94
726230,True,7,Positive,19,1,20
726240,True,0,No user reviews,0,0,0
726250,True,8,Very Positive,120,17,137
726260,True,0,No user reviews,0,0,0
726300,True,0,3 user reviews,3,0,3
726310,True,0,No user reviews,0,0,0
726320,True,6,Mostly Positive,9,3,12
726330,True,0,1 user reviews,1,0,1
726340,True,6,Mostly Positive,24,7,31
726360,True,5,Mixed,242,133,375
726370,True,0,No user reviews,0,0,0
726380,True,0,9 user reviews,8,1,9
726390,True,0,No user reviews,0,0,0
726400,True,0,No user reviews,0,0,0
726410,True,0,No user reviews,0,0,0
726430,True,5,Mixed,9,7,16
726440,True,0,No user reviews,0,0,0
726450,True,0,1 user reviews,1,0,1
726460,True,0,8 user reviews,5,3,8
726470,True,0,No user reviews,0,0,0
726480,True,7,Positive,33,3,36
726490,True,0,3 user reviews,2,1,3
726500,True,0,1 user reviews,1,0,1
726510,True,7,Positive,13,3,16
726520,True,0,1 user reviews,1,0,1
726530,True,0,No user reviews,0,0,0
726550,True,0,No user reviews,0,0,0
726560,True,7,Positive,23,0,23
726570,True,0,1 user reviews,0,1,1
726580,True,5,Mixed,10,7,17
726590,True,6,Mostly Positive,140,44,184
726600,True,0,9 user reviews,5,4,9
726610,True,0,No user reviews,0,0,0
726620,True,5,Mixed,6,6,12
726630,True,7,Positive,12,1,13
726660,True,0,No user reviews,0,0,0
726670,True,0,No user reviews,0,0,0
726690,True,7,Positive,22,1,23
726700,True,0,1 user reviews,1,0,1
726710,True,0,7 user reviews,4,3,7
726720,True,6,Mostly Positive,11,4,15
726740,True,0,No user reviews,0,0,0
726760,True,5,Mixed,9,9,18
726770,True,0,No user reviews,0,0,0
726780,True,0,No user reviews,0,0,0
726790,True,0,No user reviews,0,0,0
726791,True,0,No user reviews,0,0,0
726792,True,0,No user reviews,0,0,0
726793,True,0,No user reviews,0,0,0
726794,True,0,No user reviews,0,0,0
726795,True,0,No user reviews,0,0,0
726796,True,0,No user reviews,0,0,0
726797,True,0,No user reviews,0,0,0
726798,True,0,No user reviews,0,0,0
726799,True,0,No user reviews,0,0,0
726800,True,0,6 user reviews,1,5,6
726810,True,0,1 user reviews,1,0,1
726820,True,0,2 user reviews,2,0,2
726830,True,8,Very Positive,337,27,364
726840,True,8,Very Positive,133,23,156
726870,True,7,Positive,19,1,20
726880,True,7,Positive,12,0,12
726910,True,0,No user reviews,0,0,0
726920,True,0,No user reviews,0,0,0
726950,True,5,Mixed,20,23,43
726970,True,0,No user reviews,0,0,0
726980,True,0,No user reviews,0,0,0
726990,True,8,Very Positive,86,13,99
727010,True,0,1 user reviews,0,1,1
727020,True,7,Positive,18,0,18
727030,True,0,No user reviews,0,0,0
727040,True,7,Positive,12,1,13
727050,True,0,1 user reviews,0,1,1
727060,True,0,4 user reviews,2,2,4
727070,True,0,9 user reviews,7,2,9
727080,True,0,1 user reviews,1,0,1
727090,True,4,Mostly Negative,11,17,28
727100,True,7,Positive,8,2,10
727110,True,0,2 user reviews,1,1,2
727130,True,8,Very Positive,522,102,624
727140,True,0,3 user reviews,3,0,3
727150,True,0,2 user reviews,2,0,2
727160,True,0,No user reviews,0,0,0
727170,True,5,Mixed,7,10,17
727180,True,4,Mostly Negative,5,9,14
727190,True,5,Mixed,9,5,14
727200,True,0,5 user reviews,5,0,5
727210,True,0,No user reviews,0,0,0
727220,True,6,Mostly Positive,7,3,10
727230,True,0,No user reviews,0,0,0
727260,True,0,No user reviews,0,0,0
727270,True,0,No user reviews,0,0,0
727280,True,0,No user reviews,0,0,0
727290,True,7,Positive,10,1,11
727310,True,0,No user reviews,0,0,0
727320,True,0,3 user reviews,2,1,3
727330,True,0,1 user reviews,1,0,1
727340,True,6,Mostly Positive,37,10,47
727370,True,0,No user reviews,0,0,0
727400,True,0,No user reviews,0,0,0
727420,True,0,6 user reviews,6,0,6
727430,True,0,1 user reviews,1,0,1
727440,True,0,1 user reviews,1,0,1
727450,True,0,1 user reviews,1,0,1
727460,True,0,9 user reviews,5,4,9
727470,True,0,No user reviews,0,0,0
727480,True,0,5 user reviews,3,2,5
727490,True,0,1 user reviews,0,1,1
727510,True,5,Mixed,20,22,42
727520,True,0,No user reviews,0,0,0
727530,True,0,3 user reviews,1,2,3
727540,True,0,No user reviews,0,0,0
727550,True,0,6 user reviews,4,2,6
727570,True,8,Very Positive,41,10,51
727600,True,0,No user reviews,0,0,0
727610,True,0,1 user reviews,1,0,1
727630,True,0,No user reviews,0,0,0
727640,True,7,Positive,19,2,21
727660,True,0,No user reviews,0,0,0
727670,True,0,3 user reviews,3,0,3
727690,True,0,No user reviews,0,0,0
727710,True,0,No user reviews,0,0,0
727720,True,5,Mixed,14,7,21
727730,True,6,Mostly Positive,27,10,37
727740,True,0,No user reviews,0,0,0
727760,True,6,Mostly Positive,20,6,26
727770,True,0,No user reviews,0,0,0
727790,True,0,5 user reviews,5,0,5
727800,True,0,6 user reviews,4,2,6
727810,True,0,No user reviews,0,0,0
727820,True,0,No user reviews,0,0,0
727830,True,0,No user reviews,0,0,0
727840,True,0,1 user reviews,0,1,1
727850,True,8,Very Positive,447,52,499
727860,True,0,1 user reviews,0,1,1
727870,True,0,No user reviews,0,0,0
727880,True,0,No user reviews,0,0,0
727890,True,0,No user reviews,0,0,0
727900,True,0,3 user reviews,2,1,3
727910,True,5,Mixed,78,50,128
727930,True,7,Positive,45,4,49
727940,True,0,No user reviews,0,0,0
727960,True,0,No user reviews,0,0,0
727970,True,0,2 user reviews,1,1,2
727980,True,0,2 user reviews,2,0,2
727990,True,0,1 user reviews,0,1,1
728000,True,0,No user reviews,0,0,0
728020,True,0,2 user reviews,2,0,2
728032,True,0,3 user reviews,3,0,3
728050,True,0,6 user reviews,1,5,6
728060,True,0,No user reviews,0,0,0
728070,True,6,Mostly Positive,14,5,19
728080,True,0,No user reviews,0,0,0
728090,True,0,No user reviews,0,0,0
728100,True,0,No user reviews,0,0,0
728110,True,0,No user reviews,0,0,0
728150,True,0,7 user reviews,3,4,7
728170,True,0,No user reviews,0,0,0
728190,True,7,Positive,19,0,19
728200,True,0,No user reviews,0,0,0
728210,True,0,No user reviews,0,0,0
728220,True,0,3 user reviews,3,0,3
728240,True,8,Very Positive,90,22,112
728260,True,0,No user reviews,0,0,0
728270,True,0,No user reviews,0,0,0
728290,True,0,No user reviews,0,0,0
728300,True,7,Positive,15,1,16
728301,True,0,5 user reviews,4,1,5
728302,True,6,Mostly Positive,12,4,16
728310,True,0,No user reviews,0,0,0
728320,True,0,No user reviews,0,0,0
728330,True,0,No user reviews,0,0,0
728340,True,0,No user reviews,0,0,0
728350,True,0,1 user reviews,1,0,1
728360,True,0,No user reviews,0,0,0
728370,True,0,No user reviews,0,0,0
728380,True,0,No user reviews,0,0,0
728420,True,6,Mostly Positive,16,6,22
728430,True,0,No user reviews,0,0,0
728440,True,8,Very Positive,52,12,64
728450,True,0,No user reviews,0,0,0
728460,True,0,No user reviews,0,0,0
728461,True,0,No user reviews,0,0,0
728462,True,0,No user reviews,0,0,0
728463,True,0,No user reviews,0,0,0
728470,True,0,No user reviews,0,0,0
728500,True,0,No user reviews,0,0,0
728520,True,0,No user reviews,0,0,0
728530,True,8,Very Positive,923,72,995
728540,True,5,Mixed,1817,1707,3524
728550,True,0,No user reviews,0,0,0
728590,True,0,No user reviews,0,0,0
728600,True,0,8 user reviews,7,1,8
728610,True,0,1 user reviews,1,0,1
728620,True,0,No user reviews,0,0,0
728630,True,4,Mostly Negative,4,7,11
728640,True,0,No user reviews,0,0,0
728670,True,0,2 user reviews,1,1,2
728700,True,0,1 user reviews,1,0,1
728710,True,0,1 user reviews,1,0,1
728720,True,0,No user reviews,0,0,0
728730,True,0,No user reviews,0,0,0
728740,True,5,Mixed,259,153,412
728770,True,0,No user reviews,0,0,0
728780,True,0,2 user reviews,2,0,2
728781,True,0,4 user reviews,3,1,4
728810,True,0,No user reviews,0,0,0
728830,True,0,4 user reviews,4,0,4
728850,True,7,Positive,35,7,42
728870,True,7,Positive,22,3,25
728880,True,8,Very Positive,4117,285,4402
728910,True,7,Positive,16,0,16
728920,True,0,7 user reviews,5,2,7
728950,True,0,4 user reviews,2,2,4
728980,True,0,No user reviews,0,0,0
728990,True,0,5 user reviews,2,3,5
729000,True,0,No user reviews,0,0,0
729020,True,0,2 user reviews,2,0,2
729030,True,4,Mostly Negative,3,9,12
729040,True,8,Very Positive,3600,675,4275
729050,True,0,2 user reviews,2,0,2
729060,True,6,Mostly Positive,34,14,48
729090,True,4,Mostly Negative,4,9,13
729130,True,0,1 user reviews,1,0,1
729160,True,8,Very Positive,48,2,50
729180,True,0,No user reviews,0,0,0
729190,True,0,7 user reviews,4,3,7
729200,True,0,No user reviews,0,0,0
729210,True,0,No user reviews,0,0,0
729220,True,5,Mixed,8,6,14
729230,True,0,1 user reviews,0,1,1
729240,True,0,3 user reviews,2,1,3
729250,True,0,No user reviews,0,0,0
729260,True,0,No user reviews,0,0,0
729270,True,0,No user reviews,0,0,0
729290,True,0,No user reviews,0,0,0
729300,True,7,Positive,18,0,18
729310,True,0,9 user reviews,4,5,9
729320,True,0,No user reviews,0,0,0
729330,True,5,Mixed,15,13,28
729340,True,0,1 user reviews,0,1,1
729360,True,0,No user reviews,0,0,0
729370,True,7,Positive,35,2,37
729390,True,0,4 user reviews,4,0,4
729410,True,0,1 user reviews,1,0,1
729420,True,0,No user reviews,0,0,0
729440,True,0,No user reviews,0,0,0
729450,True,7,Positive,38,6,44
729460,True,5,Mixed,14,8,22
729470,True,5,Mixed,7,4,11
729490,True,0,7 user reviews,6,1,7
729500,True,0,No user reviews,0,0,0
729520,True,0,No user reviews,0,0,0
729530,True,6,Mostly Positive,38,15,53
729540,True,0,No user reviews,0,0,0
729560,True,0,No user reviews,0,0,0
729570,True,7,Positive,14,3,17
729580,True,0,4 user reviews,4,0,4
729590,True,0,No user reviews,0,0,0
729600,True,0,1 user reviews,1,0,1
729610,True,0,No user reviews,0,0,0
729620,True,0,1 user reviews,0,1,1
729630,True,0,1 user reviews,1,0,1
729640,True,0,6 user reviews,6,0,6
729650,True,0,No user reviews,0,0,0
729660,True,7,Positive,31,4,35
729670,True,5,Mixed,7,9,16
729680,True,0,No user reviews,0,0,0
729690,True,0,No user reviews,0,0,0
729720,True,5,Mixed,15,11,26
729760,True,0,4 user reviews,3,1,4
729780,True,0,1 user reviews,1,0,1
729800,True,0,1 user reviews,1,0,1
729820,True,0,No user reviews,0,0,0
729830,True,0,No user reviews,0,0,0
729840,True,0,2 user reviews,2,0,2
729850,True,0,9 user reviews,8,1,9
729910,True,0,1 user reviews,0,1,1
729920,True,0,2 user reviews,2,0,2
729930,True,0,2 user reviews,1,1,2
729940,True,0,2 user reviews,2,0,2
729950,True,0,2 user reviews,2,0,2
729960,True,0,1 user reviews,1,0,1
729970,True,0,4 user reviews,4,0,4
729980,True,0,8 user reviews,8,0,8
729990,True,0,1 user reviews,1,0,1
730000,True,8,Very Positive,184,35,219
730010,True,0,1 user reviews,0,1,1
730020,True,0,No user reviews,0,0,0
730030,True,5,Mixed,11,5,16
730040,True,0,1 user reviews,1,0,1
730050,True,8,Very Positive,187,41,228
730070,True,0,No user reviews,0,0,0
730080,True,0,No user reviews,0,0,0
730090,True,0,No user reviews,0,0,0
730100,True,0,No user reviews,0,0,0
730101,True,0,No user reviews,0,0,0
730102,True,0,No user reviews,0,0,0
730103,True,0,No user reviews,0,0,0
730104,True,0,No user reviews,0,0,0
730105,True,0,No user reviews,0,0,0
730106,True,0,No user reviews,0,0,0
730107,True,0,No user reviews,0,0,0
730108,True,0,No user reviews,0,0,0
730109,True,0,No user reviews,0,0,0
730110,True,0,No user reviews,0,0,0
730111,True,0,No user reviews,0,0,0
730112,True,0,No user reviews,0,0,0
730113,True,0,No user reviews,0,0,0
730120,True,0,7 user reviews,5,2,7
730160,True,0,No user reviews,0,0,0
730170,True,0,2 user reviews,1,1,2
730180,True,0,1 user reviews,1,0,1
730190,True,0,4 user reviews,2,2,4
730210,True,0,No user reviews,0,0,0
730220,True,5,Mixed,6,6,12
730230,True,0,No user reviews,0,0,0
730240,True,0,No user reviews,0,0,0
730260,True,6,Mostly Positive,15,5,20
730261,True,0,9 user reviews,2,7,9
730262,True,0,7 user reviews,4,3,7
730270,True,0,9 user reviews,9,0,9
730280,True,0,1 user reviews,0,1,1
730290,True,6,Mostly Positive,9,3,12
730300,True,7,Positive,12,0,12
730310,True,5,Mixed,421,395,816
730340,True,0,No user reviews,0,0,0
730350,True,0,2 user reviews,2,0,2
730390,True,8,Very Positive,405,13,418
730410,True,4,Mostly Negative,49,85,134
730420,True,0,No user reviews,0,0,0
730450,True,0,9 user reviews,6,3,9
730460,True,0,1 user reviews,0,1,1
730480,True,0,3 user reviews,2,1,3
730490,True,0,1 user reviews,1,0,1
730500,True,0,No user reviews,0,0,0
730510,True,0,8 user reviews,8,0,8
730520,True,0,1 user reviews,1,0,1
730530,True,0,2 user reviews,2,0,2
730540,True,0,No user reviews,0,0,0
730550,True,0,No user reviews,0,0,0
730570,True,0,No user reviews,0,0,0
730580,True,0,6 user reviews,4,2,6
730590,True,0,No user reviews,0,0,0
730611,True,0,2 user reviews,2,0,2
730612,True,0,1 user reviews,1,0,1
730613,True,0,2 user reviews,1,1,2
730614,True,0,7 user reviews,7,0,7
730615,True,0,1 user reviews,0,1,1
730616,True,0,4 user reviews,3,1,4
730617,True,0,No user reviews,0,0,0
730618,True,0,2 user reviews,2,0,2
730619,True,0,3 user reviews,2,1,3
730620,True,5,Mixed,27,12,39
730640,True,0,No user reviews,0,0,0
730670,True,0,1 user reviews,1,0,1
730690,True,0,No user reviews,0,0,0
730700,True,0,3 user reviews,3,0,3
730710,True,0,2 user reviews,0,2,2
730720,True,7,Positive,20,1,21
730730,True,0,No user reviews,0,0,0
730750,True,0,6 user reviews,5,1,6
730760,True,0,2 user reviews,0,2,2
730780,True,0,1 user reviews,1,0,1
730790,True,0,2 user reviews,2,0,2
730800,True,0,No user reviews,0,0,0
730810,True,0,No user reviews,0,0,0
730820,True,9,Overwhelmingly Positive,567,11,578
730830,True,5,Mixed,58,38,96
730840,True,7,Positive,41,0,41
730850,True,0,No user reviews,0,0,0
730860,True,7,Positive,10,2,12
730870,True,8,Very Positive,59,3,62
730890,True,0,No user reviews,0,0,0
730900,True,0,No user reviews,0,0,0
730901,True,0,No user reviews,0,0,0
730902,True,0,No user reviews,0,0,0
730903,True,0,No user reviews,0,0,0
730904,True,0,No user reviews,0,0,0
730905,True,0,No user reviews,0,0,0
730920,True,7,Positive,46,3,49
730930,True,0,No user reviews,0,0,0
730940,True,0,No user reviews,0,0,0
730960,True,0,No user reviews,0,0,0
731000,True,5,Mixed,5,6,11
731010,True,0,No user reviews,0,0,0
731020,True,0,No user reviews,0,0,0
731030,True,0,No user reviews,0,0,0
731040,True,0,No user reviews,0,0,0
731080,True,0,No user reviews,0,0,0
731090,True,0,No user reviews,0,0,0
731100,True,0,1 user reviews,1,0,1
731101,True,0,2 user reviews,2,0,2
731110,True,0,No user reviews,0,0,0
731120,True,0,3 user reviews,1,2,3
731130,True,0,1 user reviews,1,0,1
731140,True,0,No user reviews,0,0,0
731150,True,0,3 user reviews,1,2,3
731160,True,0,1 user reviews,0,1,1
731170,True,0,1 user reviews,1,0,1
731171,True,0,2 user reviews,1,1,2
731172,True,0,3 user reviews,2,1,3
731180,True,0,No user reviews,0,0,0
731190,True,0,2 user reviews,1,1,2
731200,True,0,No user reviews,0,0,0
731210,True,0,No user reviews,0,0,0
731220,True,0,No user reviews,0,0,0
731230,True,5,Mixed,9,5,14
731240,True,0,No user reviews,0,0,0
731250,True,5,Mixed,16,8,24
731270,True,0,No user reviews,0,0,0
731300,True,0,No user reviews,0,0,0
731310,True,5,Mixed,8,5,13
731320,True,7,Positive,12,1,13
731350,True,0,No user reviews,0,0,0
731360,True,0,No user reviews,0,0,0
731370,True,0,No user reviews,0,0,0
731390,True,0,1 user reviews,1,0,1
731410,True,0,No user reviews,0,0,0
731420,True,7,Positive,14,3,17
731430,True,0,No user reviews,0,0,0
731440,True,0,No user reviews,0,0,0
731450,True,0,4 user reviews,1,3,4
731460,True,0,2 user reviews,1,1,2
731490,True,8,Very Positive,3068,216,3284
731500,True,0,No user reviews,0,0,0
731510,True,0,5 user reviews,5,0,5
731520,True,0,4 user reviews,4,0,4
731540,True,0,No user reviews,0,0,0
731550,True,0,No user reviews,0,0,0
731551,True,0,No user reviews,0,0,0
731552,True,0,No user reviews,0,0,0
731560,True,7,Positive,27,1,28
731590,True,5,Mixed,46,23,69
731600,True,7,Positive,12,0,12
731610,True,0,No user reviews,0,0,0
731620,True,5,Mixed,454,292,746
731630,True,0,No user reviews,0,0,0
731650,True,5,Mixed,11,7,18
731670,True,0,2 user reviews,2,0,2
731680,True,0,No user reviews,0,0,0
731690,True,0,2 user reviews,1,1,2
731700,True,0,4 user reviews,2,2,4
731720,True,5,Mixed,22,20,42
731730,True,0,No user reviews,0,0,0
731750,True,0,No user reviews,0,0,0
731760,True,0,6 user reviews,1,5,6
731770,True,0,No user reviews,0,0,0
731780,True,0,No user reviews,0,0,0
731790,True,0,1 user reviews,0,1,1
731810,True,0,No user reviews,0,0,0
731820,True,0,3 user reviews,3,0,3
731850,True,0,No user reviews,0,0,0
731860,True,0,No user reviews,0,0,0
731880,True,5,Mixed,23,24,47
731890,True,0,8 user reviews,6,2,8
731900,True,0,No user reviews,0,0,0
731901,True,0,No user reviews,0,0,0
731902,True,0,No user reviews,0,0,0
731903,True,0,No user reviews,0,0,0
731904,True,0,No user reviews,0,0,0
731910,True,0,No user reviews,0,0,0
731920,True,5,Mixed,54,62,116
731930,True,0,5 user reviews,4,1,5
731940,True,7,Positive,24,6,30
731950,True,0,6 user reviews,5,1,6
731960,True,0,No user reviews,0,0,0
731970,True,0,No user reviews,0,0,0
731980,True,0,No user reviews,0,0,0
731990,True,0,No user reviews,0,0,0
732010,True,0,No user reviews,0,0,0
732030,True,0,9 user reviews,8,1,9
732040,True,0,2 user reviews,2,0,2
732050,True,0,No user reviews,0,0,0
732060,True,0,4 user reviews,1,3,4
732070,True,0,5 user reviews,4,1,5
732080,True,0,No user reviews,0,0,0
732090,True,0,5 user reviews,2,3,5
732110,True,0,3 user reviews,2,1,3
732120,True,0,No user reviews,0,0,0
732160,True,5,Mixed,36,26,62
732170,True,0,No user reviews,0,0,0
732180,True,0,No user reviews,0,0,0
732190,True,0,2 user reviews,2,0,2
732200,True,0,No user reviews,0,0,0
732220,True,0,No user reviews,0,0,0
732240,True,6,Mostly Positive,236,60,296
732270,True,0,No user reviews,0,0,0
732280,True,0,No user reviews,0,0,0
732290,True,0,3 user reviews,3,0,3
732340,True,0,No user reviews,0,0,0
732360,True,0,No user reviews,0,0,0
732370,True,8,Very Positive,134,22,156
732390,True,0,1 user reviews,1,0,1
732400,True,8,Very Positive,44,9,53
732410,True,0,1 user reviews,0,1,1
732430,True,9,Overwhelmingly Positive,5310,152,5462
732440,True,0,No user reviews,0,0,0
732460,True,8,Very Positive,54,5,59
732470,True,7,Positive,8,2,10
732480,True,0,6 user reviews,3,3,6
732500,True,0,No user reviews,0,0,0
732510,True,0,5 user reviews,3,2,5
732520,True,5,Mixed,12,9,21
732570,True,0,No user reviews,0,0,0
732590,True,0,No user reviews,0,0,0
732610,True,0,No user reviews,0,0,0
732620,True,0,No user reviews,0,0,0
732630,True,0,No user reviews,0,0,0
732640,True,0,No user reviews,0,0,0
732650,True,0,No user reviews,0,0,0
732670,True,0,No user reviews,0,0,0
732680,True,0,1 user reviews,0,1,1
732690,True,9,Overwhelmingly Positive,2439,71,2510
732700,True,0,3 user reviews,3,0,3
732710,True,0,No user reviews,0,0,0
732730,True,0,No user reviews,0,0,0
732760,True,0,No user reviews,0,0,0
732770,True,7,Positive,15,1,16
732790,True,0,No user reviews,0,0,0
732791,True,0,No user reviews,0,0,0
732800,True,0,2 user reviews,1,1,2
732810,True,8,Very Positive,405,31,436
732820,True,0,1 user reviews,1,0,1
732840,True,0,5 user reviews,3,2,5
732850,True,0,1 user reviews,1,0,1
732860,True,0,4 user reviews,3,1,4
732890,True,0,6 user reviews,6,0,6
732900,True,0,No user reviews,0,0,0
732930,True,7,Positive,19,0,19
732950,True,0,No user reviews,0,0,0
732960,True,0,No user reviews,0,0,0
732970,True,0,No user reviews,0,0,0
732980,True,0,No user reviews,0,0,0
733000,True,0,No user reviews,0,0,0
733010,True,0,No user reviews,0,0,0
733020,True,0,6 user reviews,5,1,6
733030,True,0,4 user reviews,2,2,4
733040,True,0,1 user reviews,0,1,1
733050,True,8,Very Positive,83,6,89
733060,True,0,5 user reviews,0,5,5
733070,True,8,Very Positive,184,21,205
733080,True,0,1 user reviews,1,0,1
733090,True,5,Mixed,13,6,19
733100,True,0,No user reviews,0,0,0
733110,True,0,No user reviews,0,0,0
733130,True,0,No user reviews,0,0,0
733140,True,8,Very Positive,60,6,66
733170,True,0,No user reviews,0,0,0
733180,True,0,7 user reviews,5,2,7
733200,True,0,2 user reviews,2,0,2
733210,True,8,Very Positive,284,26,310
733220,True,0,No user reviews,0,0,0
733230,True,0,3 user reviews,0,3,3
733250,True,0,5 user reviews,4,1,5
733300,True,8,Very Positive,127,9,136
733330,True,0,No user reviews,0,0,0
733340,True,8,Very Positive,103,10,113
733360,True,0,No user reviews,0,0,0
733390,True,0,No user reviews,0,0,0
733391,True,0,No user reviews,0,0,0
733400,True,0,No user reviews,0,0,0
733420,True,0,No user reviews,0,0,0
733430,True,0,7 user reviews,1,6,7
733440,True,0,6 user reviews,0,6,6
733460,True,6,Mostly Positive,81,33,114
733480,True,0,No user reviews,0,0,0
733490,True,0,No user reviews,0,0,0
733500,True,0,2 user reviews,2,0,2
733510,True,0,4 user reviews,4,0,4
733520,True,0,4 user reviews,3,1,4
733530,True,0,3 user reviews,3,0,3
733540,True,0,7 user reviews,6,1,7
733550,True,0,4 user reviews,1,3,4
733560,True,0,No user reviews,0,0,0
733570,True,0,1 user reviews,1,0,1
733600,True,0,No user reviews,0,0,0
733610,True,5,Mixed,6,4,10
733620,True,0,No user reviews,0,0,0
733670,True,0,4 user reviews,2,2,4
733690,True,5,Mixed,6,4,10
733700,True,0,No user reviews,0,0,0
733710,True,0,No user reviews,0,0,0
733740,True,8,Very Positive,56,5,61
733750,True,0,No user reviews,0,0,0
733760,True,0,9 user reviews,8,1,9
733770,True,0,9 user reviews,2,7,9
733790,True,8,Very Positive,604,87,691
733800,True,6,Mostly Positive,33,11,44
733810,True,0,2 user reviews,2,0,2
733820,True,0,No user reviews,0,0,0
733830,True,0,No user reviews,0,0,0
733840,True,0,No user reviews,0,0,0
733870,True,0,2 user reviews,2,0,2
733880,True,0,1 user reviews,1,0,1
733910,True,0,2 user reviews,2,0,2
733940,True,0,6 user reviews,0,6,6
733950,True,0,No user reviews,0,0,0
733990,True,8,Very Positive,907,69,976
734020,True,5,Mixed,14,19,33
734030,True,0,No user reviews,0,0,0
734060,True,0,No user reviews,0,0,0
734070,True,0,5 user reviews,5,0,5
734080,True,0,5 user reviews,2,3,5
734090,True,0,1 user reviews,1,0,1
734120,True,6,Mostly Positive,38,12,50
734130,True,0,No user reviews,0,0,0
734150,True,0,No user reviews,0,0,0
734151,True,0,No user reviews,0,0,0
734160,True,0,No user reviews,0,0,0
734170,True,0,No user reviews,0,0,0
734190,True,0,No user reviews,0,0,0
734200,True,0,No user reviews,0,0,0
734201,True,0,No user reviews,0,0,0
734202,True,0,No user reviews,0,0,0
734203,True,0,No user reviews,0,0,0
734204,True,0,No user reviews,0,0,0
734205,True,0,No user reviews,0,0,0
734206,True,0,No user reviews,0,0,0
734207,True,0,No user reviews,0,0,0
734208,True,0,No user reviews,0,0,0
734209,True,0,No user reviews,0,0,0
734210,True,0,No user reviews,0,0,0
734211,True,0,No user reviews,0,0,0
734220,True,0,No user reviews,0,0,0
734270,True,0,No user reviews,0,0,0
734280,True,0,5 user reviews,4,1,5
734281,True,0,No user reviews,0,0,0
734282,True,5,Mixed,9,6,15
734283,True,6,Mostly Positive,8,3,11
734290,True,0,No user reviews,0,0,0
734330,True,0,No user reviews,0,0,0
734350,True,0,No user reviews,0,0,0
734380,True,4,Mostly Negative,3,7,10
734400,True,0,8 user reviews,8,0,8
734430,True,0,No user reviews,0,0,0
734440,True,0,No user reviews,0,0,0
734450,True,0,5 user reviews,4,1,5
734460,True,0,No user reviews,0,0,0
734461,True,0,No user reviews,0,0,0
734462,True,0,No user reviews,0,0,0
734470,True,0,No user reviews,0,0,0
734490,True,0,5 user reviews,5,0,5
734500,True,0,No user reviews,0,0,0
734510,True,6,Mostly Positive,41,16,57
734520,True,0,No user reviews,0,0,0
734530,True,0,No user reviews,0,0,0
734540,True,5,Mixed,5,6,11
734550,True,0,No user reviews,0,0,0
734570,True,5,Mixed,11,10,21
734580,True,0,2 user reviews,1,1,2
734590,True,4,Mostly Negative,6,18,24
734700,True,7,Positive,16,1,17
734730,True,5,Mixed,14,8,22
734740,True,7,Positive,36,3,39
734750,True,0,No user reviews,0,0,0
734810,True,0,No user reviews,0,0,0
734820,True,0,4 user reviews,3,1,4
734830,True,5,Mixed,25,19,44
734840,True,0,6 user reviews,4,2,6
734860,True,0,No user reviews,0,0,0
734861,True,0,No user reviews,0,0,0
734862,True,0,No user reviews,0,0,0
734863,True,0,No user reviews,0,0,0
734864,True,0,No user reviews,0,0,0
734865,True,0,No user reviews,0,0,0
734866,True,0,No user reviews,0,0,0
734867,True,0,No user reviews,0,0,0
734868,True,0,No user reviews,0,0,0
734869,True,0,No user reviews,0,0,0
734870,True,0,1 user reviews,1,0,1
734880,True,8,Very Positive,57,3,60
734890,True,0,2 user reviews,2,0,2
734900,True,7,Positive,26,1,27
734910,True,0,No user reviews,0,0,0
734920,True,8,Very Positive,132,7,139
734930,True,0,No user reviews,0,0,0
734940,True,0,No user reviews,0,0,0
734941,True,0,No user reviews,0,0,0
734942,True,0,No user reviews,0,0,0
734943,True,0,No user reviews,0,0,0
734944,True,0,No user reviews,0,0,0
734945,True,0,No user reviews,0,0,0
734946,True,0,No user reviews,0,0,0
734947,True,0,No user reviews,0,0,0
734948,True,0,No user reviews,0,0,0
734949,True,0,1 user reviews,1,0,1
734950,True,0,No user reviews,0,0,0
734951,True,0,No user reviews,0,0,0
734960,True,0,No user reviews,0,0,0
734970,True,0,No user reviews,0,0,0
734980,True,7,Positive,38,8,46
734990,True,0,No user reviews,0,0,0
735000,True,8,Very Positive,53,4,57
735010,True,0,5 user reviews,4,1,5
735030,True,0,3 user reviews,3,0,3
735060,True,6,Mostly Positive,10,3,13
735070,True,0,1 user reviews,1,0,1
735110,True,0,3 user reviews,0,3,3
735150,True,0,1 user reviews,1,0,1
735170,True,0,No user reviews,0,0,0
735190,True,0,No user reviews,0,0,0
735200,True,0,No user reviews,0,0,0
735210,True,0,1 user reviews,1,0,1
735220,True,0,No user reviews,0,0,0
735230,True,0,1 user reviews,1,0,1
735250,True,0,No user reviews,0,0,0
735260,True,5,Mixed,6,4,10
735270,True,0,No user reviews,0,0,0
735280,True,6,Mostly Positive,129,54,183
735290,True,0,No user reviews,0,0,0
735300,True,0,No user reviews,0,0,0
735320,True,0,4 user reviews,4,0,4
735330,True,0,No user reviews,0,0,0
735350,True,5,Mixed,50,29,79
735360,True,0,7 user reviews,5,2,7
735370,True,5,Mixed,11,10,21
735390,True,0,No user reviews,0,0,0
735400,True,0,No user reviews,0,0,0
735410,True,5,Mixed,6,6,12
735420,True,0,No user reviews,0,0,0
735433,True,0,2 user reviews,2,0,2
735450,True,5,Mixed,21,10,31
735460,True,0,No user reviews,0,0,0
735470,True,0,No user reviews,0,0,0
735480,True,0,No user reviews,0,0,0
735490,True,0,1 user reviews,1,0,1
735500,True,5,Mixed,7,9,16
735510,True,0,7 user reviews,7,0,7
735520,True,0,No user reviews,0,0,0
735530,True,0,3 user reviews,2,1,3
735540,True,0,1 user reviews,0,1,1
735550,True,0,2 user reviews,1,1,2
735570,True,0,8 user reviews,6,2,8
735580,True,8,Very Positive,111,3,114
735590,True,0,5 user reviews,4,1,5
735600,True,7,Positive,22,3,25
735620,True,0,No user reviews,0,0,0
735630,True,0,No user reviews,0,0,0
735640,True,0,No user reviews,0,0,0
735650,True,0,1 user reviews,1,0,1
735680,True,0,No user reviews,0,0,0
735690,True,0,No user reviews,0,0,0
735700,True,0,3 user reviews,3,0,3
735710,True,0,No user reviews,0,0,0
735711,True,0,No user reviews,0,0,0
735712,True,0,No user reviews,0,0,0
735713,True,0,No user reviews,0,0,0
735714,True,0,No user reviews,0,0,0
735715,True,0,No user reviews,0,0,0
735716,True,0,No user reviews,0,0,0
735717,True,0,No user reviews,0,0,0
735718,True,0,No user reviews,0,0,0
735719,True,0,No user reviews,0,0,0
735720,True,0,No user reviews,0,0,0
735721,True,0,No user reviews,0,0,0
735722,True,0,No user reviews,0,0,0
735730,True,6,Mostly Positive,245,70,315
735740,True,0,No user reviews,0,0,0
735741,True,0,No user reviews,0,0,0
735760,True,0,No user reviews,0,0,0
735770,True,0,No user reviews,0,0,0
735780,True,0,No user reviews,0,0,0
735790,True,0,No user reviews,0,0,0
735791,True,0,No user reviews,0,0,0
735792,True,0,No user reviews,0,0,0
735793,True,0,No user reviews,0,0,0
735794,True,0,No user reviews,0,0,0
735795,True,0,No user reviews,0,0,0
735796,True,0,No user reviews,0,0,0
735797,True,0,No user reviews,0,0,0
735810,True,0,No user reviews,0,0,0
735830,True,0,1 user reviews,0,1,1
735850,True,0,No user reviews,0,0,0
735860,True,0,No user reviews,0,0,0
735880,True,0,No user reviews,0,0,0
735890,True,0,No user reviews,0,0,0
735900,True,0,No user reviews,0,0,0
735910,True,0,No user reviews,0,0,0
735920,True,0,No user reviews,0,0,0
735930,True,0,No user reviews,0,0,0
735940,True,0,No user reviews,0,0,0
735950,True,0,No user reviews,0,0,0
735960,True,0,No user reviews,0,0,0
735970,True,0,No user reviews,0,0,0
735980,True,0,No user reviews,0,0,0
735990,True,0,No user reviews,0,0,0
736000,True,0,No user reviews,0,0,0
736030,True,0,No user reviews,0,0,0
736050,True,0,1 user reviews,1,0,1
736080,True,0,No user reviews,0,0,0
736090,True,0,1 user reviews,1,0,1
736100,True,7,Positive,32,0,32
736110,True,5,Mixed,9,7,16
736140,True,0,No user reviews,0,0,0
736170,True,0,4 user reviews,3,1,4
736180,True,0,2 user reviews,2,0,2
736190,True,8,Very Positive,898,57,955
736200,True,0,8 user reviews,8,0,8
736210,True,0,4 user reviews,2,2,4
736220,True,8,Very Positive,4932,1146,6078
736230,True,0,1 user reviews,1,0,1
736240,True,0,No user reviews,0,0,0
736250,True,7,Positive,29,5,34
736260,True,9,Overwhelmingly Positive,5530,100,5630
736270,True,0,No user reviews,0,0,0
736280,True,0,9 user reviews,5,4,9
736290,True,0,No user reviews,0,0,0
736300,True,0,No user reviews,0,0,0
736310,True,0,No user reviews,0,0,0
736320,True,0,1 user reviews,1,0,1
736330,True,0,No user reviews,0,0,0
736340,True,7,Positive,19,2,21
736370,True,0,3 user reviews,2,1,3
736390,True,0,8 user reviews,7,1,8
736400,True,0,9 user reviews,5,4,9
736420,True,0,5 user reviews,5,0,5
736430,True,0,4 user reviews,1,3,4
736450,True,0,2 user reviews,1,1,2
736460,True,0,No user reviews,0,0,0
736470,True,0,6 user reviews,5,1,6
736480,True,0,No user reviews,0,0,0
736530,True,0,No user reviews,0,0,0
736540,True,0,No user reviews,0,0,0
736550,True,0,No user reviews,0,0,0
736570,True,8,Very Positive,214,12,226
736580,True,0,1 user reviews,1,0,1
736590,True,0,No user reviews,0,0,0
736610,True,0,1 user reviews,0,1,1
736630,True,0,No user reviews,0,0,0
736640,True,0,No user reviews,0,0,0
736650,True,0,No user reviews,0,0,0
736660,True,0,No user reviews,0,0,0
736670,True,0,No user reviews,0,0,0
736680,True,0,3 user reviews,2,1,3
736690,True,0,4 user reviews,3,1,4
736700,True,0,No user reviews,0,0,0
736710,True,7,Positive,9,2,11
736720,True,7,Positive,14,2,16
736730,True,0,No user reviews,0,0,0
736750,True,0,No user reviews,0,0,0
736770,True,5,Mixed,5,5,10
736780,True,0,No user reviews,0,0,0
736800,True,0,No user reviews,0,0,0
736810,True,6,Mostly Positive,46,12,58
736820,True,0,No user reviews,0,0,0
736830,True,0,No user reviews,0,0,0
736840,True,7,Positive,14,1,15
736850,True,6,Mostly Positive,372,115,487
736860,True,5,Mixed,33,23,56
736910,True,0,No user reviews,0,0,0
736920,True,0,No user reviews,0,0,0
736930,True,5,Mixed,9,5,14
736990,True,0,No user reviews,0,0,0
737000,True,7,Positive,15,3,18
737001,True,4,Mostly Negative,5,8,13
737002,True,7,Positive,11,2,13
737010,True,0,No user reviews,0,0,0
737020,True,0,No user reviews,0,0,0
737040,True,5,Mixed,124,69,193
737050,True,0,No user reviews,0,0,0
737070,True,0,3 user reviews,1,2,3
737080,True,0,No user reviews,0,0,0
737090,True,0,No user reviews,0,0,0
737100,True,0,No user reviews,0,0,0
737120,True,0,No user reviews,0,0,0
737130,True,0,1 user reviews,1,0,1
737230,True,0,No user reviews,0,0,0
737250,True,0,2 user reviews,2,0,2
737260,True,4,Mostly Negative,7,13,20
737270,True,8,Very Positive,68,6,74
737272,True,7,Positive,26,4,30
737280,True,0,3 user reviews,3,0,3
737320,True,0,No user reviews,0,0,0
737330,True,0,5 user reviews,4,1,5
737340,True,0,No user reviews,0,0,0
737350,True,0,No user reviews,0,0,0
737360,True,0,No user reviews,0,0,0
737361,True,0,No user reviews,0,0,0
737362,True,0,No user reviews,0,0,0
737363,True,0,No user reviews,0,0,0
737364,True,0,No user reviews,0,0,0
737365,True,0,No user reviews,0,0,0
737366,True,0,No user reviews,0,0,0
737367,True,0,No user reviews,0,0,0
737368,True,0,No user reviews,0,0,0
737369,True,0,No user reviews,0,0,0
737370,True,0,No user reviews,0,0,0
737371,True,0,No user reviews,0,0,0
737380,True,0,2 user reviews,2,0,2
737390,True,0,3 user reviews,2,1,3
737400,True,0,No user reviews,0,0,0
737410,True,0,No user reviews,0,0,0
737411,True,0,No user reviews,0,0,0
737412,True,0,No user reviews,0,0,0
737413,True,0,No user reviews,0,0,0
737414,True,0,No user reviews,0,0,0
737415,True,0,No user reviews,0,0,0
737416,True,0,No user reviews,0,0,0
737417,True,0,No user reviews,0,0,0
737418,True,0,No user reviews,0,0,0
737419,True,0,No user reviews,0,0,0
737420,True,0,No user reviews,0,0,0
737421,True,0,No user reviews,0,0,0
737430,True,0,No user reviews,0,0,0
737460,True,0,No user reviews,0,0,0
737461,True,0,No user reviews,0,0,0
737462,True,0,No user reviews,0,0,0
737463,True,0,No user reviews,0,0,0
737464,True,0,No user reviews,0,0,0
737465,True,0,No user reviews,0,0,0
737466,True,0,No user reviews,0,0,0
737467,True,0,No user reviews,0,0,0
737468,True,0,No user reviews,0,0,0
737469,True,0,No user reviews,0,0,0
737470,True,0,No user reviews,0,0,0
737480,True,0,3 user reviews,2,1,3
737490,True,0,No user reviews,0,0,0
737500,True,0,No user reviews,0,0,0
737510,True,0,6 user reviews,2,4,6
737520,True,0,No user reviews,0,0,0
737530,True,4,Mostly Negative,3,7,10
737600,True,0,2 user reviews,1,1,2
737640,True,0,No user reviews,0,0,0
737660,True,0,1 user reviews,1,0,1
737670,True,0,3 user reviews,2,1,3
737690,True,0,5 user reviews,5,0,5
737710,True,0,1 user reviews,1,0,1
737730,True,0,2 user reviews,2,0,2
737740,True,7,Positive,11,0,11
737760,True,0,No user reviews,0,0,0
737780,True,8,Very Positive,42,9,51
737790,True,0,No user reviews,0,0,0
737800,True,8,Very Positive,1201,199,1400
737810,True,0,3 user reviews,0,3,3
737820,True,0,5 user reviews,2,3,5
737830,True,0,3 user reviews,3,0,3
737840,True,0,4 user reviews,3,1,4
737860,True,0,No user reviews,0,0,0
737870,True,7,Positive,30,5,35
737880,True,5,Mixed,18,8,26
737890,True,6,Mostly Positive,48,14,62
737920,True,0,1 user reviews,1,0,1
737930,True,0,5 user reviews,5,0,5
737980,True,0,2 user reviews,2,0,2
737990,True,7,Positive,29,5,34
738000,True,5,Mixed,18,11,29
738020,True,5,Mixed,10,6,16
738030,True,0,1 user reviews,1,0,1
738050,True,0,1 user reviews,1,0,1
738060,True,0,No user reviews,0,0,0
738070,True,0,No user reviews,0,0,0
738080,True,0,3 user reviews,2,1,3
738100,True,0,No user reviews,0,0,0
738110,True,0,No user reviews,0,0,0
738120,True,0,No user reviews,0,0,0
738130,True,0,1 user reviews,1,0,1
738140,True,0,No user reviews,0,0,0
738150,True,0,No user reviews,0,0,0
738170,True,0,No user reviews,0,0,0
738171,True,0,No user reviews,0,0,0
738172,True,0,No user reviews,0,0,0
738173,True,0,No user reviews,0,0,0
738174,True,0,No user reviews,0,0,0
738175,True,0,No user reviews,0,0,0
738176,True,0,No user reviews,0,0,0
738177,True,0,No user reviews,0,0,0
738178,True,0,No user reviews,0,0,0
738179,True,0,No user reviews,0,0,0
738180,True,0,No user reviews,0,0,0
738181,True,0,No user reviews,0,0,0
738190,True,0,No user reviews,0,0,0
738200,True,0,No user reviews,0,0,0
738210,True,0,1 user reviews,1,0,1
738230,True,0,No user reviews,0,0,0
738240,True,0,No user reviews,0,0,0
738250,True,0,No user reviews,0,0,0
738260,True,0,3 user reviews,1,2,3
738270,True,6,Mostly Positive,17,5,22
738290,True,0,1 user reviews,1,0,1
738310,True,0,No user reviews,0,0,0
738320,True,0,2 user reviews,1,1,2
738350,True,0,7 user reviews,1,6,7
738360,True,0,1 user reviews,0,1,1
738361,True,0,No user reviews,0,0,0
738362,True,0,No user reviews,0,0,0
738363,True,0,No user reviews,0,0,0
738364,True,0,No user reviews,0,0,0
738365,True,0,No user reviews,0,0,0
738366,True,0,No user reviews,0,0,0
738367,True,0,No user reviews,0,0,0
738368,True,0,No user reviews,0,0,0
738369,True,0,No user reviews,0,0,0
738370,True,0,No user reviews,0,0,0
738371,True,0,No user reviews,0,0,0
738372,True,0,No user reviews,0,0,0
738380,True,0,No user reviews,0,0,0
738390,True,0,No user reviews,0,0,0
738440,True,0,6 user reviews,6,0,6
738450,True,0,8 user reviews,3,5,8
738470,True,0,No user reviews,0,0,0
738480,True,0,No user reviews,0,0,0
738500,True,0,No user reviews,0,0,0
738510,True,0,8 user reviews,8,0,8
738520,True,8,Very Positive,1450,217,1667
738530,True,5,Mixed,246,158,404
738540,True,8,Very Positive,663,88,751
738550,True,5,Mixed,16,13,29
738560,True,6,Mostly Positive,10,3,13
738580,True,0,6 user reviews,5,1,6
738590,True,0,4 user reviews,3,1,4
738600,True,0,5 user reviews,2,3,5
738610,True,5,Mixed,66,37,103
738620,True,0,2 user reviews,2,0,2
738640,True,0,No user reviews,0,0,0
738650,True,8,Very Positive,48,4,52
738680,True,0,No user reviews,0,0,0
738690,True,0,No user reviews,0,0,0
738700,True,0,3 user reviews,3,0,3
738710,True,0,2 user reviews,2,0,2
738711,True,0,2 user reviews,2,0,2
738720,True,0,2 user reviews,2,0,2
738730,True,0,1 user reviews,0,1,1
738740,True,0,No user reviews,0,0,0
738741,True,0,No user reviews,0,0,0
738742,True,0,No user reviews,0,0,0
738743,True,0,No user reviews,0,0,0
738744,True,0,No user reviews,0,0,0
738745,True,0,No user reviews,0,0,0
738746,True,0,No user reviews,0,0,0
738747,True,0,No user reviews,0,0,0
738748,True,0,No user reviews,0,0,0
738749,True,0,No user reviews,0,0,0
738750,True,0,No user reviews,0,0,0
738751,True,0,No user reviews,0,0,0
738760,True,5,Mixed,8,4,12
738770,True,0,No user reviews,0,0,0
738780,True,0,No user reviews,0,0,0
738790,True,0,4 user reviews,1,3,4
738800,True,0,No user reviews,0,0,0
738810,True,0,1 user reviews,1,0,1
738820,True,0,No user reviews,0,0,0
738830,True,0,2 user reviews,1,1,2
738840,True,0,No user reviews,0,0,0
738850,True,0,No user reviews,0,0,0
738860,True,7,Positive,13,1,14
738870,True,0,No user reviews,0,0,0
738880,True,0,No user reviews,0,0,0
738890,True,0,No user reviews,0,0,0
738900,True,0,No user reviews,0,0,0
738920,True,5,Mixed,31,28,59
738940,True,0,1 user reviews,1,0,1
738950,True,0,No user reviews,0,0,0
738960,True,0,No user reviews,0,0,0
738980,True,0,No user reviews,0,0,0
739000,True,6,Mostly Positive,26,8,34
739010,True,0,4 user reviews,4,0,4
739030,True,0,5 user reviews,0,5,5
739050,True,0,5 user reviews,0,5,5
739060,True,0,No user reviews,0,0,0
739080,True,7,Positive,27,0,27
739090,True,0,No user reviews,0,0,0
739100,True,7,Positive,10,1,11
739120,True,0,No user reviews,0,0,0
739130,True,5,Mixed,54,50,104
739160,True,0,No user reviews,0,0,0
739170,True,0,7 user reviews,5,2,7
739180,True,7,Positive,15,1,16
739190,True,6,Mostly Positive,63,19,82
739210,True,7,Positive,15,2,17
739220,True,6,Mostly Positive,12,5,17
739230,True,0,No user reviews,0,0,0
739240,True,5,Mixed,7,5,12
739250,True,0,1 user reviews,0,1,1
739251,True,0,8 user reviews,6,2,8
739253,True,0,2 user reviews,2,0,2
739255,True,0,2 user reviews,1,1,2
739256,True,0,4 user reviews,2,2,4
739260,True,0,2 user reviews,2,0,2
739270,True,0,1 user reviews,1,0,1
739280,True,8,Very Positive,46,7,53
739281,True,6,Mostly Positive,24,9,33
739282,True,6,Mostly Positive,48,17,65
739290,True,0,2 user reviews,2,0,2
739300,True,0,No user reviews,0,0,0
739360,True,0,9 user reviews,7,2,9
739390,True,0,No user reviews,0,0,0
739400,True,0,No user reviews,0,0,0
739410,True,0,7 user reviews,4,3,7
739430,True,0,No user reviews,0,0,0
739440,True,0,7 user reviews,6,1,7
739450,True,0,No user reviews,0,0,0
739460,True,0,No user reviews,0,0,0
739470,True,0,No user reviews,0,0,0
739480,True,0,No user reviews,0,0,0
739490,True,0,No user reviews,0,0,0
739500,True,0,No user reviews,0,0,0
739510,True,0,No user reviews,0,0,0
739520,True,0,No user reviews,0,0,0
739530,True,0,No user reviews,0,0,0
739540,True,6,Mostly Positive,207,68,275
739560,True,0,No user reviews,0,0,0
739561,True,0,No user reviews,0,0,0
739562,True,0,No user reviews,0,0,0
739563,True,0,No user reviews,0,0,0
739564,True,0,No user reviews,0,0,0
739565,True,0,No user reviews,0,0,0
739566,True,0,No user reviews,0,0,0
739567,True,0,No user reviews,0,0,0
739568,True,0,No user reviews,0,0,0
739569,True,0,No user reviews,0,0,0
739570,True,0,No user reviews,0,0,0
739571,True,0,No user reviews,0,0,0
739572,True,0,No user reviews,0,0,0
739573,True,0,No user reviews,0,0,0
739581,True,7,Positive,32,5,37
739590,True,0,No user reviews,0,0,0
739600,True,0,1 user reviews,1,0,1
739601,True,0,No user reviews,0,0,0
739602,True,0,No user reviews,0,0,0
739603,True,0,No user reviews,0,0,0
739604,True,0,No user reviews,0,0,0
739605,True,0,No user reviews,0,0,0
739606,True,0,No user reviews,0,0,0
739607,True,0,No user reviews,0,0,0
739608,True,0,No user reviews,0,0,0
739609,True,0,No user reviews,0,0,0
739610,True,0,No user reviews,0,0,0
739611,True,0,No user reviews,0,0,0
739620,True,0,1 user reviews,0,1,1
739630,True,9,Overwhelmingly Positive,38545,1000,39545
739640,True,0,No user reviews,0,0,0
739650,True,6,Mostly Positive,122,50,172
739660,True,0,1 user reviews,1,0,1
739690,True,0,8 user reviews,5,3,8
739700,True,0,No user reviews,0,0,0
739710,True,0,1 user reviews,1,0,1
739720,True,7,Positive,16,1,17
739730,True,0,2 user reviews,1,1,2
739760,True,0,1 user reviews,1,0,1
739761,True,0,No user reviews,0,0,0
739762,True,0,No user reviews,0,0,0
739763,True,0,No user reviews,0,0,0
739764,True,0,No user reviews,0,0,0
739765,True,0,No user reviews,0,0,0
739766,True,0,No user reviews,0,0,0
739767,True,0,No user reviews,0,0,0
739768,True,0,No user reviews,0,0,0
739769,True,0,No user reviews,0,0,0
739770,True,0,No user reviews,0,0,0
739771,True,0,No user reviews,0,0,0
739780,True,0,1 user reviews,0,1,1
739800,True,0,3 user reviews,2,1,3
739820,True,0,1 user reviews,1,0,1
739830,True,0,No user reviews,0,0,0
739831,True,0,No user reviews,0,0,0
739850,True,7,Positive,15,1,16
739860,True,0,No user reviews,0,0,0
739880,True,0,No user reviews,0,0,0
739890,True,0,No user reviews,0,0,0
739910,True,0,No user reviews,0,0,0
739930,True,0,No user reviews,0,0,0
739940,True,0,No user reviews,0,0,0
739950,True,0,3 user reviews,3,0,3
739960,True,0,No user reviews,0,0,0
739970,True,0,No user reviews,0,0,0
739980,True,8,Very Positive,61,15,76
739990,True,0,7 user reviews,4,3,7
740000,True,0,2 user reviews,1,1,2
740020,True,0,6 user reviews,6,0,6
740040,True,7,Positive,39,8,47
740050,True,0,7 user reviews,6,1,7
740060,True,0,3 user reviews,0,3,3
740070,True,0,8 user reviews,3,5,8
740080,True,8,Very Positive,64,9,73
740090,True,6,Mostly Positive,19,5,24
740140,True,4,Mostly Negative,3,10,13
740141,True,0,5 user reviews,3,2,5
740143,True,5,Mixed,28,17,45
740150,True,0,1 user reviews,1,0,1
740160,True,6,Mostly Positive,14,6,20
740170,True,0,2 user reviews,1,1,2
740190,True,0,5 user reviews,0,5,5
740200,True,5,Mixed,23,18,41
740210,True,0,No user reviews,0,0,0
740220,True,0,2 user reviews,1,1,2
740230,True,8,Very Positive,76,11,87
740240,True,6,Mostly Positive,10,3,13
740250,True,0,No user reviews,0,0,0
740260,True,7,Positive,18,3,21
740270,True,0,No user reviews,0,0,0
740280,True,5,Mixed,5,5,10
740290,True,8,Very Positive,85,13,98
740300,True,0,3 user reviews,2,1,3
740310,True,0,No user reviews,0,0,0
740320,True,6,Mostly Positive,7,3,10
740340,True,0,5 user reviews,3,2,5
740350,True,0,3 user reviews,2,1,3
740370,True,0,4 user reviews,4,0,4
740390,True,0,4 user reviews,1,3,4
740400,True,7,Positive,15,3,18
740410,True,7,Positive,25,4,29
740440,True,0,No user reviews,0,0,0
740450,True,0,No user reviews,0,0,0
740470,True,0,No user reviews,0,0,0
740480,True,0,1 user reviews,1,0,1
740481,True,0,1 user reviews,1,0,1
740482,True,0,1 user reviews,1,0,1
740483,True,0,1 user reviews,1,0,1
740484,True,0,1 user reviews,1,0,1
740485,True,0,1 user reviews,1,0,1
740486,True,0,1 user reviews,1,0,1
740487,True,0,1 user reviews,1,0,1
740488,True,0,1 user reviews,1,0,1
740489,True,0,1 user reviews,1,0,1
740490,True,0,1 user reviews,1,0,1
740491,True,0,1 user reviews,1,0,1
740500,True,0,No user reviews,0,0,0
740510,True,0,No user reviews,0,0,0
740520,True,0,2 user reviews,2,0,2
740550,True,5,Mixed,26,16,42
740560,True,0,No user reviews,0,0,0
740570,True,7,Positive,17,4,21
740580,True,0,No user reviews,0,0,0
740590,True,0,8 user reviews,6,2,8
740591,True,0,9 user reviews,8,1,9
740592,True,0,7 user reviews,7,0,7
740600,True,5,Mixed,34,23,57
740630,True,0,No user reviews,0,0,0
740640,True,0,No user reviews,0,0,0
740650,True,0,4 user reviews,4,0,4
740660,True,0,8 user reviews,7,1,8
740680,True,0,No user reviews,0,0,0
740700,True,0,No user reviews,0,0,0
740710,True,0,No user reviews,0,0,0
740720,True,0,1 user reviews,0,1,1
740730,True,0,2 user reviews,0,2,2
740740,True,0,No user reviews,0,0,0
740780,True,0,7 user reviews,6,1,7
740790,True,5,Mixed,27,16,43
740800,True,0,No user reviews,0,0,0
740810,True,5,Mixed,8,5,13
740850,True,0,No user reviews,0,0,0
740950,True,0,2 user reviews,2,0,2
740960,True,0,1 user reviews,1,0,1
740990,True,0,No user reviews,0,0,0
741010,True,0,1 user reviews,1,0,1
741020,True,0,No user reviews,0,0,0
741030,True,0,2 user reviews,1,1,2
741060,True,0,No user reviews,0,0,0
741080,True,0,1 user reviews,0,1,1
741090,True,0,No user reviews,0,0,0
741100,True,0,7 user reviews,3,4,7
741110,True,0,2 user reviews,2,0,2
741120,True,4,Mostly Negative,3,7,10
741140,True,8,Very Positive,115,8,123
741150,True,8,Very Positive,42,8,50
741160,True,0,No user reviews,0,0,0
741170,True,0,No user reviews,0,0,0
741180,True,0,No user reviews,0,0,0
741200,True,0,No user reviews,0,0,0
741250,True,8,Very Positive,56,3,59
741260,True,5,Mixed,8,8,16
741320,True,0,No user reviews,0,0,0
741340,True,0,No user reviews,0,0,0
741350,True,6,Mostly Positive,220,69,289
741360,True,0,No user reviews,0,0,0
741370,True,6,Mostly Positive,9,3,12
741380,True,0,No user reviews,0,0,0
741390,True,0,No user reviews,0,0,0
741400,True,7,Positive,20,5,25
741420,True,0,8 user reviews,6,2,8
741430,True,8,Very Positive,89,22,111
741440,True,0,No user reviews,0,0,0
741450,True,0,5 user reviews,0,5,5
741470,True,0,1 user reviews,1,0,1
741490,True,5,Mixed,8,7,15
741500,True,5,Mixed,21,20,41
741510,True,6,Mostly Positive,206,74,280
741520,True,0,8 user reviews,7,1,8
741530,True,0,No user reviews,0,0,0
741540,True,0,2 user reviews,2,0,2
741550,True,0,No user reviews,0,0,0
741590,True,0,No user reviews,0,0,0
741620,True,0,2 user reviews,1,1,2
741650,True,0,3 user reviews,1,2,3
741660,True,0,No user reviews,0,0,0
741670,True,8,Very Positive,364,75,439
741710,True,0,2 user reviews,2,0,2
741711,True,0,1 user reviews,1,0,1
741730,True,0,No user reviews,0,0,0
741760,True,0,6 user reviews,3,3,6
741770,True,0,5 user reviews,3,2,5
741780,True,0,1 user reviews,1,0,1
741790,True,0,No user reviews,0,0,0
741791,True,0,No user reviews,0,0,0
741792,True,0,No user reviews,0,0,0
741793,True,0,No user reviews,0,0,0
741794,True,0,No user reviews,0,0,0
741795,True,0,No user reviews,0,0,0
741796,True,0,No user reviews,0,0,0
741797,True,0,No user reviews,0,0,0
741798,True,0,No user reviews,0,0,0
741799,True,0,No user reviews,0,0,0
741800,True,0,No user reviews,0,0,0
741801,True,0,No user reviews,0,0,0
741820,True,4,Mostly Negative,86,213,299
741930,True,0,2 user reviews,0,2,2
741980,True,0,No user reviews,0,0,0
741990,True,8,Very Positive,47,5,52
742000,True,0,No user reviews,0,0,0
742010,True,0,4 user reviews,1,3,4
742020,True,0,No user reviews,0,0,0
742021,True,0,No user reviews,0,0,0
742030,True,0,9 user reviews,5,4,9
742060,True,0,No user reviews,0,0,0
742120,True,8,Very Positive,3580,380,3960
742150,True,7,Positive,30,0,30
742160,True,0,No user reviews,0,0,0
742170,True,0,No user reviews,0,0,0
742220,True,0,3 user reviews,3,0,3
742230,True,0,3 user reviews,1,2,3
742240,True,0,No user reviews,0,0,0
742250,True,8,Very Positive,60,9,69
742280,True,0,1 user reviews,1,0,1
742300,True,8,Very Positive,828,87,915
742310,True,0,No user reviews,0,0,0
742320,True,0,No user reviews,0,0,0
742330,True,0,No user reviews,0,0,0
742340,True,6,Mostly Positive,7,3,10
742350,True,0,2 user reviews,2,0,2
742360,True,0,No user reviews,0,0,0
742370,True,0,No user reviews,0,0,0
742380,True,7,Positive,9,1,10
742410,True,0,No user reviews,0,0,0
742430,True,0,No user reviews,0,0,0
742460,True,8,Very Positive,122,19,141
742470,True,0,5 user reviews,5,0,5
742480,True,7,Positive,37,5,42
742490,True,8,Very Positive,57,13,70
742500,True,0,No user reviews,0,0,0
742510,True,0,5 user reviews,4,1,5
742520,True,8,Very Positive,172,4,176
742530,True,6,Mostly Positive,20,7,27
742540,True,0,7 user reviews,6,1,7
742630,True,0,No user reviews,0,0,0
742660,True,0,1 user reviews,1,0,1
742670,True,0,1 user reviews,1,0,1
742680,True,0,1 user reviews,1,0,1
742690,True,0,1 user reviews,1,0,1
742700,True,7,Positive,40,4,44
742710,True,0,No user reviews,0,0,0
742730,True,0,No user reviews,0,0,0
742751,True,0,No user reviews,0,0,0
742752,True,0,No user reviews,0,0,0
742753,True,0,No user reviews,0,0,0
742754,True,0,No user reviews,0,0,0
742755,True,0,No user reviews,0,0,0
742756,True,0,No user reviews,0,0,0
742757,True,0,No user reviews,0,0,0
742758,True,0,No user reviews,0,0,0
742759,True,0,No user reviews,0,0,0
742760,True,0,No user reviews,0,0,0
742761,True,0,No user reviews,0,0,0
742762,True,0,No user reviews,0,0,0
742780,True,0,No user reviews,0,0,0
742790,True,0,2 user reviews,2,0,2
742800,True,0,2 user reviews,2,0,2
742810,True,0,No user reviews,0,0,0
742820,True,0,No user reviews,0,0,0
742830,True,7,Positive,13,3,16
742890,True,0,5 user reviews,5,0,5
742891,True,0,8 user reviews,8,0,8
742892,True,0,6 user reviews,6,0,6
742900,True,5,Mixed,18,8,26
742910,True,0,No user reviews,0,0,0
742950,True,0,No user reviews,0,0,0
742951,True,0,No user reviews,0,0,0
742952,True,0,No user reviews,0,0,0
742953,True,0,No user reviews,0,0,0
742954,True,0,No user reviews,0,0,0
742955,True,0,No user reviews,0,0,0
742956,True,0,No user reviews,0,0,0
742957,True,0,No user reviews,0,0,0
742958,True,0,No user reviews,0,0,0
742959,True,0,No user reviews,0,0,0
742960,True,0,No user reviews,0,0,0
742961,True,0,No user reviews,0,0,0
742980,True,0,1 user reviews,1,0,1
742990,True,0,No user reviews,0,0,0
743000,True,0,No user reviews,0,0,0
743030,True,0,6 user reviews,3,3,6
743040,True,0,1 user reviews,1,0,1
743050,True,0,No user reviews,0,0,0
743060,True,0,3 user reviews,0,3,3
743070,True,0,1 user reviews,1,0,1
743090,True,5,Mixed,28,37,65
743100,True,0,1 user reviews,1,0,1
743110,True,7,Positive,11,0,11
743130,True,8,Very Positive,317,17,334
743140,True,0,No user reviews,0,0,0
743160,True,0,No user reviews,0,0,0
743170,True,0,No user reviews,0,0,0
743190,True,0,No user reviews,0,0,0
743200,True,0,No user reviews,0,0,0
743201,True,0,No user reviews,0,0,0
743230,True,0,6 user reviews,5,1,6
743240,True,0,No user reviews,0,0,0
743270,True,0,No user reviews,0,0,0
743280,True,0,No user reviews,0,0,0
743290,True,0,No user reviews,0,0,0
743330,True,0,2 user reviews,1,1,2
743340,True,0,No user reviews,0,0,0
743350,True,5,Mixed,8,4,12
743360,True,0,3 user reviews,3,0,3
743370,True,0,No user reviews,0,0,0
743380,True,0,No user reviews,0,0,0
743390,True,8,Very Positive,235,10,245
743420,True,0,No user reviews,0,0,0
743450,True,9,Overwhelmingly Positive,4259,185,4444
743460,True,0,No user reviews,0,0,0
743480,True,0,No user reviews,0,0,0
743500,True,0,No user reviews,0,0,0
743520,True,0,No user reviews,0,0,0
743550,True,0,4 user reviews,4,0,4
743570,True,0,No user reviews,0,0,0
743580,True,0,No user reviews,0,0,0
743590,True,0,No user reviews,0,0,0
743620,True,0,1 user reviews,0,1,1
743640,True,8,Very Positive,377,85,462
743650,True,0,No user reviews,0,0,0
743660,True,0,5 user reviews,5,0,5
743680,True,0,No user reviews,0,0,0
743790,True,0,No user reviews,0,0,0
743810,True,0,No user reviews,0,0,0
743830,True,5,Mixed,12,6,18
743840,True,0,No user reviews,0,0,0
743841,True,0,No user reviews,0,0,0
743842,True,0,No user reviews,0,0,0
743843,True,0,No user reviews,0,0,0
743844,True,0,No user reviews,0,0,0
743845,True,0,No user reviews,0,0,0
743850,True,7,Positive,18,1,19
743860,True,4,Mostly Negative,46,93,139
743870,True,0,No user reviews,0,0,0
743880,True,0,2 user reviews,1,1,2
743890,True,6,Mostly Positive,432,180,612
743900,True,6,Mostly Positive,178,64,242
743920,True,0,No user reviews,0,0,0
743930,True,0,No user reviews,0,0,0
743940,True,0,5 user reviews,5,0,5
743960,True,5,Mixed,9,4,13
743990,True,0,2 user reviews,1,1,2
744010,True,0,4 user reviews,2,2,4
744020,True,0,No user reviews,0,0,0
744040,True,6,Mostly Positive,7,3,10
744050,True,8,Very Positive,50,8,58
744060,True,6,Mostly Positive,311,105,416
744070,True,0,No user reviews,0,0,0
744080,True,0,No user reviews,0,0,0
744090,True,0,No user reviews,0,0,0
744150,True,0,3 user reviews,3,0,3
744160,True,0,No user reviews,0,0,0
744170,True,0,1 user reviews,1,0,1
744190,True,8,Very Positive,382,34,416
744200,True,0,No user reviews,0,0,0
744220,True,3,Negative,2,9,11
744240,True,0,No user reviews,0,0,0
744260,True,0,1 user reviews,0,1,1
744270,True,5,Mixed,26,34,60
744280,True,0,1 user reviews,0,1,1
744290,True,0,No user reviews,0,0,0
744310,True,0,No user reviews,0,0,0
744330,True,0,No user reviews,0,0,0
744340,True,0,No user reviews,0,0,0
744380,True,0,No user reviews,0,0,0
744390,True,0,1 user reviews,0,1,1
744400,True,0,1 user reviews,1,0,1
744420,True,6,Mostly Positive,32,11,43
744430,True,7,Positive,25,4,29
744440,True,0,1 user reviews,1,0,1
744450,True,0,1 user reviews,0,1,1
744460,True,5,Mixed,7,7,14
744490,True,0,No user reviews,0,0,0
744520,True,7,Positive,35,3,38
744550,True,0,1 user reviews,1,0,1
744570,True,8,Very Positive,58,10,68
744580,True,0,1 user reviews,1,0,1
744590,True,5,Mixed,6,5,11
744600,True,7,Positive,12,0,12
744610,True,0,5 user reviews,1,4,5
744630,True,0,1 user reviews,0,1,1
744640,True,0,No user reviews,0,0,0
744650,True,7,Positive,16,0,16
744660,True,0,No user reviews,0,0,0
744670,True,5,Mixed,68,35,103
744680,True,0,6 user reviews,4,2,6
744700,True,0,No user reviews,0,0,0
744710,True,0,1 user reviews,0,1,1
744720,True,0,4 user reviews,0,4,4
744740,True,0,3 user reviews,3,0,3
744750,True,5,Mixed,7,5,12
744760,True,0,4 user reviews,2,2,4
744800,True,0,3 user reviews,3,0,3
744810,True,0,3 user reviews,3,0,3
744840,True,8,Very Positive,530,74,604
744870,True,0,No user reviews,0,0,0
744871,True,0,2 user reviews,0,2,2
744880,True,0,1 user reviews,1,0,1
744890,True,0,1 user reviews,0,1,1
744900,True,0,No user reviews,0,0,0
744910,True,0,No user reviews,0,0,0
744920,True,0,2 user reviews,2,0,2
744930,True,0,No user reviews,0,0,0
744940,True,5,Mixed,7,8,15
744950,True,5,Mixed,104,112,216
744980,True,0,No user reviews,0,0,0
744990,True,0,1 user reviews,1,0,1
745000,True,6,Mostly Positive,58,19,77
745010,True,5,Mixed,60,36,96
745030,True,7,Positive,14,0,14
745060,True,0,2 user reviews,1,1,2
745090,True,7,Positive,20,3,23
745120,True,0,3 user reviews,1,2,3
745130,True,5,Mixed,8,7,15
745160,True,0,4 user reviews,4,0,4
745170,True,0,No user reviews,0,0,0
745180,True,6,Mostly Positive,8,3,11
745220,True,6,Mostly Positive,158,45,203
745230,True,0,No user reviews,0,0,0
745250,True,0,5 user reviews,4,1,5
745270,True,0,No user reviews,0,0,0
745280,True,0,No user reviews,0,0,0
745310,True,0,No user reviews,0,0,0
745330,True,6,Mostly Positive,20,8,28
745340,True,4,Mostly Negative,4,7,11
745360,True,0,No user reviews,0,0,0
745370,True,5,Mixed,6,6,12
745380,True,5,Mixed,5,6,11
745400,True,7,Positive,9,1,10
745420,True,0,4 user reviews,3,1,4
745430,True,0,3 user reviews,3,0,3
745440,True,0,No user reviews,0,0,0
745450,True,0,No user reviews,0,0,0
745500,True,0,4 user reviews,2,2,4
745510,True,7,Positive,27,5,32
745520,True,0,5 user reviews,5,0,5
745530,True,5,Mixed,6,5,11
745550,True,0,No user reviews,0,0,0
745560,True,0,No user reviews,0,0,0
745580,True,0,5 user reviews,4,1,5
745620,True,0,2 user reviews,1,1,2
745630,True,0,1 user reviews,1,0,1
745640,True,0,7 user reviews,0,7,7
745650,True,0,3 user reviews,3,0,3
745660,True,0,6 user reviews,6,0,6
745670,True,5,Mixed,5,6,11
745680,True,0,No user reviews,0,0,0
745710,True,0,2 user reviews,2,0,2
745720,True,0,No user reviews,0,0,0
745730,True,0,No user reviews,0,0,0
745740,True,8,Very Positive,103,17,120
745750,True,0,1 user reviews,1,0,1
745760,True,0,No user reviews,0,0,0
745770,True,0,No user reviews,0,0,0
745780,True,0,No user reviews,0,0,0
745790,True,7,Positive,13,1,14
745800,True,0,No user reviews,0,0,0
745802,True,0,No user reviews,0,0,0
745810,True,6,Mostly Positive,45,18,63
745820,True,0,No user reviews,0,0,0
745830,True,0,6 user reviews,5,1,6
745840,True,0,5 user reviews,5,0,5
745850,True,8,Very Positive,60,5,65
745870,True,0,2 user reviews,2,0,2
745880,True,9,Overwhelmingly Positive,893,10,903
745890,True,0,3 user reviews,3,0,3
745900,True,0,3 user reviews,2,1,3
745910,True,0,No user reviews,0,0,0
745911,True,0,1 user reviews,1,0,1
745912,True,0,1 user reviews,1,0,1
745920,True,8,Very Positive,11055,1192,12247
745930,True,0,2 user reviews,0,2,2
745940,True,5,Mixed,6,6,12
745950,True,7,Positive,20,5,25
745960,True,8,Very Positive,186,11,197
745970,True,6,Mostly Positive,18,5,23
745980,True,0,No user reviews,0,0,0
746000,True,0,6 user reviews,5,1,6
746010,True,0,No user reviews,0,0,0
746020,True,0,8 user reviews,2,6,8
746030,True,0,3 user reviews,2,1,3
746040,True,0,No user reviews,0,0,0
746070,True,0,No user reviews,0,0,0
746080,True,0,No user reviews,0,0,0
746110,True,0,3 user reviews,3,0,3
746140,True,6,Mostly Positive,82,22,104
746150,True,0,No user reviews,0,0,0
746160,True,0,No user reviews,0,0,0
746170,True,0,No user reviews,0,0,0
746180,True,0,No user reviews,0,0,0
746200,True,0,No user reviews,0,0,0
746220,True,0,2 user reviews,2,0,2
746230,True,0,No user reviews,0,0,0
746240,True,0,6 user reviews,2,4,6
746250,True,0,No user reviews,0,0,0
746260,True,0,No user reviews,0,0,0
746270,True,0,No user reviews,0,0,0
746280,True,0,No user reviews,0,0,0
746300,True,0,No user reviews,0,0,0
746340,True,0,1 user reviews,0,1,1
746350,True,5,Mixed,9,5,14
746360,True,0,1 user reviews,1,0,1
746390,True,5,Mixed,13,6,19
746400,True,8,Very Positive,126,5,131
746410,True,6,Mostly Positive,16,6,22
746420,True,0,4 user reviews,4,0,4
746430,True,0,9 user reviews,4,5,9
746450,True,0,No user reviews,0,0,0
746460,True,0,No user reviews,0,0,0
746470,True,7,Positive,17,2,19
746500,True,0,5 user reviews,5,0,5
746510,True,8,Very Positive,242,24,266
746530,True,0,No user reviews,0,0,0
746540,True,5,Mixed,10,6,16
746560,True,8,Very Positive,57,1,58
746570,True,7,Positive,17,2,19
746580,True,8,Very Positive,319,31,350
746590,True,0,No user reviews,0,0,0
746610,True,0,4 user reviews,3,1,4
746620,True,0,4 user reviews,2,2,4
746650,True,8,Very Positive,92,3,95
746660,True,0,8 user reviews,6,2,8
746680,True,0,1 user reviews,1,0,1
746700,True,0,No user reviews,0,0,0
746710,True,8,Very Positive,183,16,199
746730,True,8,Very Positive,98,7,105
746731,True,0,4 user reviews,4,0,4
746750,True,0,8 user reviews,6,2,8
746760,True,4,Mostly Negative,5,8,13
746770,True,0,1 user reviews,1,0,1
746820,True,0,4 user reviews,4,0,4
746840,True,6,Mostly Positive,13,5,18
746850,True,8,Very Positive,1888,264,2152
746860,True,0,No user reviews,0,0,0
746870,True,0,No user reviews,0,0,0
746880,True,5,Mixed,12,7,19
746890,True,0,1 user reviews,1,0,1
746900,True,0,1 user reviews,0,1,1
746910,True,0,No user reviews,0,0,0
746920,True,0,No user reviews,0,0,0
746930,True,6,Mostly Positive,592,168,760
746940,True,8,Very Positive,85,5,90
746960,True,7,Positive,22,0,22
746970,True,0,No user reviews,0,0,0
746980,True,0,No user reviews,0,0,0
746990,True,0,6 user reviews,1,5,6
747020,True,0,1 user reviews,1,0,1
747030,True,0,9 user reviews,4,5,9
747040,True,0,5 user reviews,2,3,5
747050,True,6,Mostly Positive,8,3,11
747060,True,5,Mixed,23,12,35
747090,True,0,3 user reviews,2,1,3
747110,True,0,No user reviews,0,0,0
747120,True,0,No user reviews,0,0,0
747130,True,0,No user reviews,0,0,0
747140,True,0,1 user reviews,1,0,1
747160,True,0,6 user reviews,6,0,6
747180,True,0,3 user reviews,3,0,3
747190,True,5,Mixed,26,12,38
747200,True,8,Very Positive,178,29,207
747210,True,0,No user reviews,0,0,0
747220,True,0,No user reviews,0,0,0
747230,True,0,No user reviews,0,0,0
747240,True,0,No user reviews,0,0,0
747250,True,0,No user reviews,0,0,0
747260,True,5,Mixed,7,9,16
747280,True,0,No user reviews,0,0,0
747290,True,0,3 user reviews,3,0,3
747300,True,0,No user reviews,0,0,0
747310,True,5,Mixed,12,17,29
747320,True,6,Mostly Positive,13,4,17
747330,True,0,No user reviews,0,0,0
747340,True,8,Very Positive,284,63,347
747350,True,8,Very Positive,418,56,474
747360,True,8,Very Positive,150,32,182
747410,True,0,1 user reviews,1,0,1
747420,True,0,No user reviews,0,0,0
747430,True,0,No user reviews,0,0,0
747470,True,7,Positive,15,2,17
747480,True,0,No user reviews,0,0,0
747520,True,0,5 user reviews,5,0,5
747530,True,0,No user reviews,0,0,0
747540,True,0,No user reviews,0,0,0
747560,True,0,No user reviews,0,0,0
747590,True,6,Mostly Positive,21,7,28
747600,True,0,1 user reviews,0,1,1
747610,True,0,No user reviews,0,0,0
747620,True,7,Positive,17,1,18
747630,True,0,No user reviews,0,0,0
747640,True,0,6 user reviews,5,1,6
747650,True,7,Positive,10,0,10
747670,True,0,No user reviews,0,0,0
747680,True,0,No user reviews,0,0,0
747690,True,7,Positive,17,3,20
747700,True,0,3 user reviews,0,3,3
747720,True,0,No user reviews,0,0,0
747721,True,0,No user reviews,0,0,0
747730,True,0,3 user reviews,2,1,3
747740,True,0,No user reviews,0,0,0
747741,True,0,No user reviews,0,0,0
747742,True,0,No user reviews,0,0,0
747750,True,0,2 user reviews,2,0,2
747770,True,0,No user reviews,0,0,0
747790,True,0,1 user reviews,1,0,1
747800,True,0,1 user reviews,0,1,1
747810,True,0,1 user reviews,1,0,1
747820,True,0,No user reviews,0,0,0
747850,True,0,4 user reviews,3,1,4
747890,True,0,No user reviews,0,0,0
747900,True,0,1 user reviews,1,0,1
747910,True,6,Mostly Positive,85,27,112
747920,True,0,No user reviews,0,0,0
747930,True,0,No user reviews,0,0,0
747970,True,0,No user reviews,0,0,0
747980,True,0,3 user reviews,3,0,3
747990,True,0,9 user reviews,5,4,9
748000,True,0,No user reviews,0,0,0
748010,True,0,1 user reviews,1,0,1
748030,True,0,No user reviews,0,0,0
748040,True,8,Very Positive,50,3,53
748050,True,0,No user reviews,0,0,0
748060,True,0,4 user reviews,1,3,4
748070,True,0,3 user reviews,3,0,3
748080,True,0,No user reviews,0,0,0
748090,True,0,No user reviews,0,0,0
748110,True,0,5 user reviews,4,1,5
748120,True,0,No user reviews,0,0,0
748130,True,0,4 user reviews,1,3,4
748140,True,0,No user reviews,0,0,0
748150,True,6,Mostly Positive,9,3,12
748170,True,0,No user reviews,0,0,0
748190,True,0,No user reviews,0,0,0
748210,True,0,No user reviews,0,0,0
748260,True,0,1 user reviews,1,0,1
748270,True,0,8 user reviews,6,2,8
748280,True,0,No user reviews,0,0,0
748290,True,0,1 user reviews,1,0,1
748291,True,0,No user reviews,0,0,0
748300,True,5,Mixed,129,59,188
748310,True,0,4 user reviews,4,0,4
748320,True,0,No user reviews,0,0,0
748330,True,7,Positive,11,0,11
748340,True,5,Mixed,11,11,22
748341,True,7,Positive,38,6,44
748350,True,0,No user reviews,0,0,0
748360,True,8,Very Positive,508,123,631
748370,True,6,Mostly Positive,562,204,766
748420,True,0,No user reviews,0,0,0
748430,True,0,2 user reviews,1,1,2
748460,True,8,Very Positive,42,8,50
748470,True,0,No user reviews,0,0,0
748471,True,0,No user reviews,0,0,0
748472,True,0,No user reviews,0,0,0
748473,True,0,No user reviews,0,0,0
748480,True,5,Mixed,17,8,25
748490,True,9,Overwhelmingly Positive,964,33,997
748500,True,0,1 user reviews,1,0,1
748520,True,0,2 user reviews,0,2,2
748540,True,0,9 user reviews,6,3,9
748580,True,0,2 user reviews,2,0,2
748600,True,7,Positive,14,3,17
748610,True,6,Mostly Positive,48,14,62
748650,True,0,3 user reviews,2,1,3
748660,True,0,No user reviews,0,0,0
748670,True,0,4 user reviews,0,4,4
748680,True,0,2 user reviews,2,0,2
748700,True,0,No user reviews,0,0,0
748710,True,0,No user reviews,0,0,0
748720,True,0,2 user reviews,1,1,2
748730,True,0,No user reviews,0,0,0
748740,True,0,No user reviews,0,0,0
748780,True,0,No user reviews,0,0,0
748790,True,0,1 user reviews,1,0,1
748800,True,0,2 user reviews,2,0,2
748820,True,0,4 user reviews,2,2,4
748830,True,0,No user reviews,0,0,0
748850,True,0,1 user reviews,1,0,1
748870,True,0,No user reviews,0,0,0
748880,True,0,7 user reviews,5,2,7
748890,True,8,Very Positive,84,7,91
748900,True,0,No user reviews,0,0,0
748910,True,0,No user reviews,0,0,0
748930,True,0,6 user reviews,3,3,6
748940,True,0,No user reviews,0,0,0
748950,True,0,No user reviews,0,0,0
748970,True,8,Very Positive,56,10,66
748980,True,0,3 user reviews,3,0,3
748990,True,0,No user reviews,0,0,0
749000,True,0,No user reviews,0,0,0
749010,True,0,9 user reviews,7,2,9
749020,True,0,No user reviews,0,0,0
749040,True,0,2 user reviews,1,1,2
749050,True,5,Mixed,58,26,84
749060,True,0,No user reviews,0,0,0
749070,True,0,No user reviews,0,0,0
749080,True,0,7 user reviews,4,3,7
749090,True,0,No user reviews,0,0,0
749110,True,0,4 user reviews,2,2,4
749130,True,0,2 user reviews,2,0,2
749140,True,7,Positive,12,0,12
749150,True,0,1 user reviews,0,1,1
749160,True,0,No user reviews,0,0,0
749170,True,0,No user reviews,0,0,0
749180,True,0,No user reviews,0,0,0
749190,True,0,No user reviews,0,0,0
749200,True,0,No user reviews,0,0,0
749230,True,0,No user reviews,0,0,0
749240,True,0,2 user reviews,1,1,2
749241,True,0,1 user reviews,1,0,1
749242,True,0,1 user reviews,1,0,1
749250,True,6,Mostly Positive,85,35,120
749270,True,4,Mostly Negative,7,16,23
749280,True,0,No user reviews,0,0,0
749290,True,0,1 user reviews,1,0,1
749320,True,0,3 user reviews,3,0,3
749340,True,6,Mostly Positive,24,9,33
749370,True,5,Mixed,6,7,13
749410,True,7,Positive,12,1,13
749420,True,0,No user reviews,0,0,0
749430,True,0,No user reviews,0,0,0
749450,True,0,No user reviews,0,0,0
749470,True,0,1 user reviews,1,0,1
749480,True,0,8 user reviews,3,5,8
749490,True,0,No user reviews,0,0,0
749520,True,0,4 user reviews,4,0,4
749530,True,0,No user reviews,0,0,0
749540,True,4,Mostly Negative,17,30,47
749550,True,6,Mostly Positive,9,3,12
749560,True,7,Positive,20,4,24
749580,True,0,3 user reviews,0,3,3
749590,True,0,1 user reviews,1,0,1
749610,True,0,No user reviews,0,0,0
749620,True,0,No user reviews,0,0,0
749630,True,0,No user reviews,0,0,0
749640,True,0,No user reviews,0,0,0
749650,True,0,1 user reviews,0,1,1
749660,True,0,No user reviews,0,0,0
749670,True,0,8 user reviews,5,3,8
749700,True,0,7 user reviews,7,0,7
749710,True,0,6 user reviews,4,2,6
749720,True,0,No user reviews,0,0,0
749730,True,7,Positive,11,1,12
749750,True,0,No user reviews,0,0,0
749780,True,5,Mixed,57,73,130
749790,True,0,No user reviews,0,0,0
749800,True,5,Mixed,70,43,113
749810,True,0,No user reviews,0,0,0
749820,True,0,No user reviews,0,0,0
749830,True,0,5 user reviews,3,2,5
749840,True,6,Mostly Positive,35,9,44
749850,True,0,9 user reviews,9,0,9
749860,True,0,5 user reviews,3,2,5
749870,True,0,No user reviews,0,0,0
749880,True,0,4 user reviews,1,3,4
749890,True,7,Positive,40,4,44
749900,True,0,1 user reviews,0,1,1
749920,True,7,Positive,15,2,17
749950,True,0,No user reviews,0,0,0
749960,True,5,Mixed,72,39,111
749980,True,0,7 user reviews,4,3,7
749990,True,0,7 user reviews,6,1,7
750000,True,0,No user reviews,0,0,0
750010,True,5,Mixed,30,16,46
750020,True,0,2 user reviews,2,0,2
750030,True,8,Very Positive,94,18,112
750031,True,5,Mixed,134,78,212
750050,True,5,Mixed,280,177,457
750060,True,0,9 user reviews,9,0,9
750070,True,4,Mostly Negative,6,14,20
750080,True,0,3 user reviews,2,1,3
750120,True,0,No user reviews,0,0,0
750150,True,0,No user reviews,0,0,0
750151,True,0,No user reviews,0,0,0
750170,True,8,Very Positive,129,5,134
750200,True,0,No user reviews,0,0,0
750210,True,6,Mostly Positive,41,17,58
750230,True,5,Mixed,6,6,12
750240,True,0,No user reviews,0,0,0
750250,True,0,No user reviews,0,0,0
750270,True,0,No user reviews,0,0,0
750280,True,0,No user reviews,0,0,0
750300,True,0,No user reviews,0,0,0
750310,True,6,Mostly Positive,39,11,50
750320,True,0,9 user reviews,8,1,9
750330,True,5,Mixed,8,7,15
750340,True,0,7 user reviews,7,0,7
750341,True,0,8 user reviews,8,0,8
750342,True,0,7 user reviews,7,0,7
750350,True,0,No user reviews,0,0,0
750360,True,0,No user reviews,0,0,0
750380,True,0,No user reviews,0,0,0
750381,True,8,Very Positive,364,83,447
750400,True,0,No user reviews,0,0,0
750420,True,0,No user reviews,0,0,0
750430,True,0,4 user reviews,3,1,4
750440,True,0,5 user reviews,2,3,5
750450,True,7,Positive,25,0,25
750460,True,7,Positive,16,4,20
750470,True,8,Very Positive,102,8,110
750480,True,0,No user reviews,0,0,0
750490,True,0,2 user reviews,2,0,2
750491,True,0,2 user reviews,1,1,2
750492,True,0,5 user reviews,4,1,5
750500,True,7,Positive,9,2,11
750510,True,0,No user reviews,0,0,0
750520,True,6,Mostly Positive,65,18,83
750530,True,0,No user reviews,0,0,0
750540,True,0,No user reviews,0,0,0
750541,True,0,No user reviews,0,0,0
750542,True,0,No user reviews,0,0,0
750543,True,0,No user reviews,0,0,0
750544,True,0,No user reviews,0,0,0
750545,True,0,No user reviews,0,0,0
750546,True,0,No user reviews,0,0,0
750547,True,0,No user reviews,0,0,0
750610,True,0,No user reviews,0,0,0
750620,True,0,2 user reviews,1,1,2
750630,True,0,No user reviews,0,0,0
750640,True,0,1 user reviews,1,0,1
750660,True,5,Mixed,6,5,11
750670,True,0,No user reviews,0,0,0
750710,True,0,2 user reviews,1,1,2
750740,True,0,No user reviews,0,0,0
750750,True,0,No user reviews,0,0,0
750770,True,5,Mixed,9,4,13
750780,True,0,2 user reviews,2,0,2
750790,True,0,3 user reviews,2,1,3
750800,True,5,Mixed,28,14,42
750820,True,0,1 user reviews,1,0,1
750840,True,0,2 user reviews,0,2,2
750850,True,7,Positive,21,5,26
750870,True,0,3 user reviews,2,1,3
750900,True,0,No user reviews,0,0,0
750910,True,0,3 user reviews,3,0,3
750911,True,0,No user reviews,0,0,0
750912,True,0,No user reviews,0,0,0
750920,True,8,Very Positive,8280,1586,9866
750960,True,0,7 user reviews,7,0,7
750970,True,0,7 user reviews,4,3,7
750980,True,0,No user reviews,0,0,0
750990,True,7,Positive,25,2,27
751030,True,0,No user reviews,0,0,0
751040,True,0,No user reviews,0,0,0
751060,True,6,Mostly Positive,12,5,17
751070,True,0,No user reviews,0,0,0
751090,True,0,No user reviews,0,0,0
751100,True,0,No user reviews,0,0,0
751110,True,6,Mostly Positive,37,13,50
751140,True,0,No user reviews,0,0,0
751160,True,0,2 user reviews,0,2,2
751170,True,0,4 user reviews,3,1,4
751180,True,0,1 user reviews,0,1,1
751190,True,0,No user reviews,0,0,0
751191,True,0,No user reviews,0,0,0
751200,True,7,Positive,8,2,10
751220,True,7,Positive,27,1,28
751230,True,0,No user reviews,0,0,0
751240,True,5,Mixed,65,48,113
751250,True,7,Positive,26,5,31
751260,True,0,5 user reviews,5,0,5
751270,True,0,1 user reviews,1,0,1
751280,True,8,Very Positive,68,1,69
751300,True,8,Very Positive,56,6,62
751310,True,0,No user reviews,0,0,0
751320,True,0,No user reviews,0,0,0
751330,True,0,5 user reviews,3,2,5
751340,True,6,Mostly Positive,19,7,26
751350,True,0,No user reviews,0,0,0
751380,True,0,6 user reviews,5,1,6
751390,True,0,8 user reviews,5,3,8
751400,True,0,3 user reviews,3,0,3
751430,True,0,2 user reviews,1,1,2
751440,True,6,Mostly Positive,303,91,394
751450,True,8,Very Positive,69,1,70
751470,True,0,7 user reviews,7,0,7
751480,True,0,4 user reviews,3,1,4
751490,True,0,No user reviews,0,0,0
751500,True,5,Mixed,80,39,119
751520,True,0,No user reviews,0,0,0
751530,True,0,1 user reviews,0,1,1
751540,True,0,5 user reviews,2,3,5
751550,True,0,No user reviews,0,0,0
751580,True,0,1 user reviews,1,0,1
751590,True,0,No user reviews,0,0,0
751600,True,0,No user reviews,0,0,0
751610,True,0,No user reviews,0,0,0
751630,True,0,No user reviews,0,0,0
751640,True,7,Positive,25,1,26
751660,True,0,2 user reviews,1,1,2
751670,True,0,2 user reviews,2,0,2
751680,True,0,2 user reviews,2,0,2
751690,True,0,No user reviews,0,0,0
751700,True,0,1 user reviews,1,0,1
751701,True,0,No user reviews,0,0,0
751702,True,0,No user reviews,0,0,0
751720,True,0,5 user reviews,5,0,5
751730,True,7,Positive,14,2,16
751740,True,0,3 user reviews,0,3,3
751770,True,0,No user reviews,0,0,0
751780,True,8,Very Positive,6367,420,6787
751820,True,8,Very Positive,86,19,105
751830,True,0,No user reviews,0,0,0
751831,True,0,No user reviews,0,0,0
751832,True,0,No user reviews,0,0,0
751840,True,0,No user reviews,0,0,0
751850,True,0,No user reviews,0,0,0
751860,True,0,No user reviews,0,0,0
751870,True,0,2 user reviews,0,2,2
751880,True,0,5 user reviews,5,0,5
751890,True,0,No user reviews,0,0,0
751910,True,0,No user reviews,0,0,0
751920,True,0,No user reviews,0,0,0
751930,True,0,No user reviews,0,0,0
751940,True,0,No user reviews,0,0,0
751950,True,0,8 user reviews,7,1,8
751970,True,0,6 user reviews,6,0,6
752000,True,0,1 user reviews,0,1,1
752020,True,5,Mixed,5,7,12
752030,True,0,7 user reviews,4,3,7
752040,True,0,No user reviews,0,0,0
752050,True,5,Mixed,11,11,22
752060,True,0,No user reviews,0,0,0
752070,True,0,No user reviews,0,0,0
752080,True,0,2 user reviews,2,0,2
752110,True,0,No user reviews,0,0,0
752170,True,0,7 user reviews,7,0,7
752180,True,0,No user reviews,0,0,0
752200,True,0,1 user reviews,0,1,1
752220,True,0,No user reviews,0,0,0
752230,True,0,No user reviews,0,0,0
752240,True,0,No user reviews,0,0,0
752260,True,0,No user reviews,0,0,0
752300,True,4,Mostly Negative,5,10,15
752310,True,0,4 user reviews,2,2,4
752330,True,7,Positive,24,5,29
752350,True,0,No user reviews,0,0,0
752360,True,0,No user reviews,0,0,0
752380,True,6,Mostly Positive,19,5,24
752400,True,0,1 user reviews,0,1,1
752430,True,0,3 user reviews,3,0,3
752440,True,0,7 user reviews,7,0,7
752450,True,5,Mixed,12,6,18
752470,True,7,Positive,35,7,42
752490,True,0,No user reviews,0,0,0
752500,True,7,Positive,26,6,32
752510,True,0,No user reviews,0,0,0
752520,True,5,Mixed,10,6,16
752530,True,0,No user reviews,0,0,0
752540,True,0,No user reviews,0,0,0
752550,True,7,Positive,13,0,13
752560,True,0,1 user reviews,1,0,1
752570,True,5,Mixed,5,5,10
752590,True,8,Very Positive,8483,588,9071
752600,True,0,7 user reviews,7,0,7
752630,True,0,No user reviews,0,0,0
752640,True,6,Mostly Positive,15,5,20
752650,True,0,No user reviews,0,0,0
752690,True,0,3 user reviews,2,1,3
752700,True,0,3 user reviews,0,3,3
752710,True,0,1 user reviews,1,0,1
752720,True,2,Very Negative,14,97,111
752730,True,4,Mostly Negative,4,13,17
752750,True,4,Mostly Negative,6,11,17
752760,True,0,No user reviews,0,0,0
752770,True,0,No user reviews,0,0,0
752780,True,0,4 user reviews,0,4,4
752790,True,0,2 user reviews,1,1,2
752800,True,7,Positive,17,0,17
752810,True,0,6 user reviews,2,4,6
752820,True,0,No user reviews,0,0,0
752830,True,0,5 user reviews,3,2,5
752840,True,0,No user reviews,0,0,0
752850,True,6,Mostly Positive,8,3,11
752860,True,0,No user reviews,0,0,0
752870,True,0,No user reviews,0,0,0
752880,True,0,No user reviews,0,0,0
752900,True,0,No user reviews,0,0,0
752910,True,8,Very Positive,84,13,97
752920,True,0,2 user reviews,2,0,2
752921,True,0,No user reviews,0,0,0
752922,True,0,No user reviews,0,0,0
752923,True,0,No user reviews,0,0,0
752924,True,0,No user reviews,0,0,0
752925,True,0,No user reviews,0,0,0
752926,True,0,No user reviews,0,0,0
752927,True,0,No user reviews,0,0,0
752928,True,0,No user reviews,0,0,0
752929,True,0,No user reviews,0,0,0
752930,True,0,No user reviews,0,0,0
752931,True,0,No user reviews,0,0,0
752932,True,0,No user reviews,0,0,0
752940,True,0,No user reviews,0,0,0
752941,True,0,No user reviews,0,0,0
752942,True,0,No user reviews,0,0,0
752943,True,0,No user reviews,0,0,0
752944,True,0,No user reviews,0,0,0
752945,True,0,No user reviews,0,0,0
752946,True,0,No user reviews,0,0,0
752947,True,0,No user reviews,0,0,0
752948,True,0,No user reviews,0,0,0
752949,True,0,No user reviews,0,0,0
752950,True,0,No user reviews,0,0,0
752951,True,0,No user reviews,0,0,0
752952,True,0,No user reviews,0,0,0
752960,True,0,No user reviews,0,0,0
752990,True,0,No user reviews,0,0,0
753000,True,0,2 user reviews,1,1,2
753001,True,0,No user reviews,0,0,0
753003,True,0,No user reviews,0,0,0
753004,True,0,No user reviews,0,0,0
753020,True,0,No user reviews,0,0,0
753030,True,0,No user reviews,0,0,0
753060,True,0,No user reviews,0,0,0
753080,True,0,No user reviews,0,0,0
753090,True,0,No user reviews,0,0,0
753100,True,0,2 user reviews,0,2,2
753110,True,4,Mostly Negative,12,25,37
753120,True,0,1 user reviews,1,0,1
753170,True,0,1 user reviews,0,1,1
753200,True,0,6 user reviews,6,0,6
753210,True,4,Mostly Negative,3,7,10
753220,True,8,Very Positive,91,0,91
753230,True,6,Mostly Positive,54,21,75
753240,True,0,3 user reviews,1,2,3
753250,True,0,No user reviews,0,0,0
753270,True,0,9 user reviews,6,3,9
753281,True,0,No user reviews,0,0,0
753282,True,0,No user reviews,0,0,0
753283,True,0,No user reviews,0,0,0
753285,True,0,No user reviews,0,0,0
753286,True,0,No user reviews,0,0,0
753290,True,0,No user reviews,0,0,0
753291,True,0,1 user reviews,1,0,1
753292,True,0,No user reviews,0,0,0
753293,True,0,No user reviews,0,0,0
753360,True,5,Mixed,17,8,25
753370,True,0,7 user reviews,2,5,7
753380,True,0,5 user reviews,4,1,5
753390,True,0,2 user reviews,1,1,2
753400,True,0,3 user reviews,3,0,3
753410,True,0,No user reviews,0,0,0
753420,True,8,Very Positive,958,95,1053
753430,True,0,No user reviews,0,0,0
753440,True,7,Positive,12,2,14
753450,True,0,2 user reviews,2,0,2
753460,True,0,2 user reviews,1,1,2
753470,True,0,1 user reviews,1,0,1
753480,True,0,No user reviews,0,0,0
753490,True,0,5 user reviews,2,3,5
753500,True,0,2 user reviews,1,1,2
753510,True,0,No user reviews,0,0,0
753520,True,0,No user reviews,0,0,0
753530,True,0,No user reviews,0,0,0
753560,True,0,3 user reviews,3,0,3
753570,True,0,1 user reviews,0,1,1
753580,True,0,No user reviews,0,0,0
753590,True,5,Mixed,125,55,180
753610,True,0,No user reviews,0,0,0
753630,True,0,No user reviews,0,0,0
753640,True,8,Very Positive,5745,339,6084
753650,True,8,Very Positive,568,54,622
753660,True,8,Very Positive,44,10,54
753670,True,0,4 user reviews,2,2,4
753680,True,0,No user reviews,0,0,0
753700,True,0,No user reviews,0,0,0
753710,True,0,No user reviews,0,0,0
753730,True,0,No user reviews,0,0,0
753740,True,0,No user reviews,0,0,0
753741,True,0,No user reviews,0,0,0
753742,True,0,1 user reviews,0,1,1
753743,True,0,No user reviews,0,0,0
753744,True,0,No user reviews,0,0,0
753745,True,0,No user reviews,0,0,0
753746,True,0,No user reviews,0,0,0
753747,True,0,No user reviews,0,0,0
753748,True,0,No user reviews,0,0,0
753749,True,0,No user reviews,0,0,0
753750,True,0,No user reviews,0,0,0
753751,True,0,No user reviews,0,0,0
753752,True,0,No user reviews,0,0,0
753753,True,0,No user reviews,0,0,0
753754,True,0,No user reviews,0,0,0
753756,True,0,No user reviews,0,0,0
753757,True,0,No user reviews,0,0,0
753758,True,0,No user reviews,0,0,0
753759,True,0,No user reviews,0,0,0
753760,True,0,No user reviews,0,0,0
753761,True,0,No user reviews,0,0,0
753762,True,0,No user reviews,0,0,0
753763,True,0,No user reviews,0,0,0
753764,True,0,No user reviews,0,0,0
753765,True,0,No user reviews,0,0,0
753766,True,0,No user reviews,0,0,0
753767,True,0,No user reviews,0,0,0
753768,True,0,No user reviews,0,0,0
753769,True,0,No user reviews,0,0,0
753770,True,0,No user reviews,0,0,0
753771,True,0,1 user reviews,1,0,1
753772,True,0,No user reviews,0,0,0
753773,True,0,No user reviews,0,0,0
753774,True,0,No user reviews,0,0,0
753775,True,0,No user reviews,0,0,0
753776,True,0,No user reviews,0,0,0
753777,True,0,No user reviews,0,0,0
753778,True,0,No user reviews,0,0,0
753779,True,0,No user reviews,0,0,0
753780,True,0,1 user reviews,1,0,1
753781,True,0,No user reviews,0,0,0
753782,True,0,No user reviews,0,0,0
753783,True,0,No user reviews,0,0,0
753784,True,0,No user reviews,0,0,0
753785,True,0,No user reviews,0,0,0
753786,True,0,2 user reviews,1,1,2
753787,True,0,No user reviews,0,0,0
753788,True,0,No user reviews,0,0,0
753789,True,0,2 user reviews,2,0,2
753790,True,0,No user reviews,0,0,0
753791,True,0,No user reviews,0,0,0
753792,True,0,No user reviews,0,0,0
753793,True,0,No user reviews,0,0,0
753794,True,0,1 user reviews,1,0,1
753795,True,0,No user reviews,0,0,0
753796,True,0,1 user reviews,1,0,1
753797,True,0,3 user reviews,3,0,3
753798,True,0,No user reviews,0,0,0
753799,True,0,No user reviews,0,0,0
753800,True,0,No user reviews,0,0,0
753801,True,0,No user reviews,0,0,0
753802,True,0,No user reviews,0,0,0
753803,True,0,No user reviews,0,0,0
753804,True,0,No user reviews,0,0,0
753805,True,0,No user reviews,0,0,0
753806,True,0,No user reviews,0,0,0
753807,True,0,No user reviews,0,0,0
753808,True,0,No user reviews,0,0,0
753809,True,0,No user reviews,0,0,0
753810,True,0,No user reviews,0,0,0
753811,True,0,No user reviews,0,0,0
753812,True,0,No user reviews,0,0,0
753813,True,0,No user reviews,0,0,0
753814,True,0,4 user reviews,0,4,4
753815,True,0,No user reviews,0,0,0
753816,True,0,No user reviews,0,0,0
753817,True,0,No user reviews,0,0,0
753818,True,0,No user reviews,0,0,0
753819,True,0,No user reviews,0,0,0
753820,True,0,No user reviews,0,0,0
753821,True,0,No user reviews,0,0,0
753822,True,0,No user reviews,0,0,0
753823,True,0,No user reviews,0,0,0
753824,True,0,No user reviews,0,0,0
753825,True,0,No user reviews,0,0,0
753826,True,0,No user reviews,0,0,0
753827,True,0,No user reviews,0,0,0
753828,True,0,No user reviews,0,0,0
753829,True,0,1 user reviews,1,0,1
753830,True,0,No user reviews,0,0,0
753831,True,0,No user reviews,0,0,0
753832,True,0,No user reviews,0,0,0
753833,True,0,No user reviews,0,0,0
753834,True,0,No user reviews,0,0,0
753835,True,0,No user reviews,0,0,0
753836,True,0,2 user reviews,0,2,2
753842,True,0,1 user reviews,1,0,1
753843,True,0,No user reviews,0,0,0
753844,True,0,No user reviews,0,0,0
753845,True,0,1 user reviews,1,0,1
753846,True,0,No user reviews,0,0,0
753847,True,0,No user reviews,0,0,0
753848,True,0,No user reviews,0,0,0
753849,True,0,No user reviews,0,0,0
753850,True,0,No user reviews,0,0,0
753851,True,0,No user reviews,0,0,0
753852,True,0,No user reviews,0,0,0
753853,True,0,No user reviews,0,0,0
753854,True,0,No user reviews,0,0,0
753855,True,0,No user reviews,0,0,0
753856,True,0,No user reviews,0,0,0
753857,True,0,No user reviews,0,0,0
753858,True,0,No user reviews,0,0,0
753859,True,0,1 user reviews,1,0,1
753860,True,0,No user reviews,0,0,0
753861,True,0,No user reviews,0,0,0
753862,True,0,No user reviews,0,0,0
753863,True,0,1 user reviews,1,0,1
753864,True,0,No user reviews,0,0,0
753865,True,0,No user reviews,0,0,0
753866,True,0,No user reviews,0,0,0
753867,True,0,No user reviews,0,0,0
753868,True,0,No user reviews,0,0,0
753869,True,0,No user reviews,0,0,0
753870,True,0,No user reviews,0,0,0
753871,True,0,No user reviews,0,0,0
753872,True,0,No user reviews,0,0,0
753873,True,0,1 user reviews,1,0,1
753874,True,0,1 user reviews,1,0,1
753875,True,0,1 user reviews,1,0,1
753876,True,0,1 user reviews,0,1,1
753877,True,0,1 user reviews,1,0,1
753878,True,0,No user reviews,0,0,0
753879,True,0,No user reviews,0,0,0
753880,True,0,No user reviews,0,0,0
753881,True,0,No user reviews,0,0,0
753882,True,0,No user reviews,0,0,0
753883,True,0,No user reviews,0,0,0
753884,True,0,No user reviews,0,0,0
753885,True,0,No user reviews,0,0,0
753886,True,0,No user reviews,0,0,0
753887,True,0,No user reviews,0,0,0
753888,True,0,No user reviews,0,0,0
753889,True,0,No user reviews,0,0,0
753890,True,0,No user reviews,0,0,0
753891,True,0,No user reviews,0,0,0
753892,True,0,7 user reviews,7,0,7
753893,True,0,No user reviews,0,0,0
753894,True,0,1 user reviews,1,0,1
753895,True,0,No user reviews,0,0,0
753896,True,0,No user reviews,0,0,0
753900,True,5,Mixed,24,15,39
753920,True,0,8 user reviews,3,5,8
753930,True,5,Mixed,176,85,261
753950,True,0,No user reviews,0,0,0
753960,True,0,5 user reviews,2,3,5
753980,True,0,No user reviews,0,0,0
753990,True,0,9 user reviews,4,5,9
754000,True,0,No user reviews,0,0,0
754010,True,0,No user reviews,0,0,0
754020,True,0,4 user reviews,3,1,4
754030,True,0,No user reviews,0,0,0
754040,True,8,Very Positive,48,3,51
754050,True,0,No user reviews,0,0,0
754070,True,0,No user reviews,0,0,0
754100,True,0,No user reviews,0,0,0
754110,True,0,9 user reviews,6,3,9
754120,True,5,Mixed,16,9,25
754150,True,8,Very Positive,548,30,578
754160,True,0,No user reviews,0,0,0
754190,True,0,5 user reviews,5,0,5
754200,True,0,1 user reviews,0,1,1
754230,True,0,5 user reviews,4,1,5
754260,True,0,No user reviews,0,0,0
754270,True,0,4 user reviews,4,0,4
754280,True,0,No user reviews,0,0,0
754290,True,0,1 user reviews,0,1,1
754300,True,0,6 user reviews,6,0,6
754310,True,0,5 user reviews,5,0,5
754320,True,0,5 user reviews,4,1,5
754330,True,0,4 user reviews,2,2,4
754340,True,6,Mostly Positive,18,6,24
754350,True,0,No user reviews,0,0,0
754360,True,0,No user reviews,0,0,0
754370,True,0,No user reviews,0,0,0
754380,True,0,2 user reviews,0,2,2
754400,True,0,2 user reviews,2,0,2
754410,True,0,No user reviews,0,0,0
754420,True,0,No user reviews,0,0,0
754460,True,0,6 user reviews,5,1,6
754470,True,0,1 user reviews,0,1,1
754480,True,0,No user reviews,0,0,0
754500,True,6,Mostly Positive,217,73,290
754510,True,0,4 user reviews,3,1,4
754520,True,7,Positive,12,2,14
754530,True,5,Mixed,231,126,357
754540,True,7,Positive,14,2,16
754550,True,0,No user reviews,0,0,0
754570,True,0,No user reviews,0,0,0
754571,True,0,No user reviews,0,0,0
754572,True,0,No user reviews,0,0,0
754573,True,0,No user reviews,0,0,0
754574,True,0,No user reviews,0,0,0
754575,True,0,No user reviews,0,0,0
754576,True,0,No user reviews,0,0,0
754577,True,0,No user reviews,0,0,0
754590,True,0,No user reviews,0,0,0
754610,True,4,Mostly Negative,3,7,10
754620,True,0,No user reviews,0,0,0
754630,True,0,2 user reviews,1,1,2
754640,True,0,No user reviews,0,0,0
754650,True,0,No user reviews,0,0,0
754660,True,0,No user reviews,0,0,0
754670,True,0,No user reviews,0,0,0
754680,True,6,Mostly Positive,19,5,24
754700,True,0,No user reviews,0,0,0
754730,True,0,No user reviews,0,0,0
754740,True,0,No user reviews,0,0,0
754760,True,0,No user reviews,0,0,0
754770,True,7,Positive,33,3,36
754790,True,0,6 user reviews,6,0,6
754800,True,0,1 user reviews,0,1,1
754810,True,0,1 user reviews,1,0,1
754820,True,0,No user reviews,0,0,0
754830,True,0,3 user reviews,3,0,3
754840,True,8,Very Positive,47,4,51
754850,True,5,Mixed,31,20,51
754860,True,0,No user reviews,0,0,0
754870,True,0,No user reviews,0,0,0
754880,True,0,No user reviews,0,0,0
754900,True,0,No user reviews,0,0,0
754920,True,6,Mostly Positive,17,5,22
754921,True,5,Mixed,16,14,30
754922,True,5,Mixed,9,5,14
754923,True,0,9 user reviews,4,5,9
754930,True,0,7 user reviews,5,2,7
754940,True,0,No user reviews,0,0,0
754941,True,0,No user reviews,0,0,0
754950,True,0,No user reviews,0,0,0
754951,True,0,No user reviews,0,0,0
754952,True,0,No user reviews,0,0,0
754953,True,0,No user reviews,0,0,0
754954,True,0,No user reviews,0,0,0
754955,True,0,No user reviews,0,0,0
754960,True,0,No user reviews,0,0,0
754970,True,0,No user reviews,0,0,0
754980,True,0,No user reviews,0,0,0
754981,True,0,No user reviews,0,0,0
754982,True,0,No user reviews,0,0,0
754990,True,0,No user reviews,0,0,0
755000,True,0,No user reviews,0,0,0
755010,True,0,No user reviews,0,0,0
755030,True,0,No user reviews,0,0,0
755031,True,0,No user reviews,0,0,0
755032,True,0,No user reviews,0,0,0
755033,True,0,No user reviews,0,0,0
755035,True,0,No user reviews,0,0,0
755036,True,0,No user reviews,0,0,0
755040,True,0,No user reviews,0,0,0
755070,True,0,1 user reviews,1,0,1
755071,True,0,No user reviews,0,0,0
755072,True,0,No user reviews,0,0,0
755073,True,0,No user reviews,0,0,0
755080,True,0,No user reviews,0,0,0
755100,True,0,No user reviews,0,0,0
755120,True,0,No user reviews,0,0,0
755130,True,0,3 user reviews,2,1,3
755140,True,0,2 user reviews,0,2,2
755150,True,0,No user reviews,0,0,0
755160,True,0,No user reviews,0,0,0
755180,True,0,No user reviews,0,0,0
755190,True,0,No user reviews,0,0,0
755200,True,0,No user reviews,0,0,0
755220,True,0,No user reviews,0,0,0
755230,True,0,1 user reviews,1,0,1
755240,True,0,1 user reviews,0,1,1
755250,True,0,4 user reviews,4,0,4
755260,True,0,No user reviews,0,0,0
755270,True,0,No user reviews,0,0,0
755290,True,0,2 user reviews,0,2,2
755340,True,0,2 user reviews,2,0,2
755350,True,5,Mixed,10,15,25
755360,True,0,No user reviews,0,0,0
755370,True,0,1 user reviews,1,0,1
755390,True,0,No user reviews,0,0,0
755400,True,0,No user reviews,0,0,0
755410,True,8,Very Positive,95,4,99
755420,True,0,No user reviews,0,0,0
755430,True,0,No user reviews,0,0,0
755440,True,0,No user reviews,0,0,0
755450,True,0,No user reviews,0,0,0
755470,True,8,Very Positive,86,19,105
755480,True,0,No user reviews,0,0,0
755490,True,0,7 user reviews,7,0,7
755500,True,6,Mostly Positive,241,78,319
755520,True,0,9 user reviews,8,1,9
755530,True,0,1 user reviews,1,0,1
755540,True,0,No user reviews,0,0,0
755550,True,0,No user reviews,0,0,0
755560,True,0,5 user reviews,4,1,5
755570,True,5,Mixed,20,17,37
755580,True,0,1 user reviews,0,1,1
755590,True,7,Positive,9,1,10
755600,True,6,Mostly Positive,9,3,12
755610,True,0,2 user reviews,2,0,2
755630,True,5,Mixed,23,15,38
755640,True,0,No user reviews,0,0,0
755650,True,0,No user reviews,0,0,0
755670,True,7,Positive,13,3,16
755700,True,0,No user reviews,0,0,0
755710,True,0,No user reviews,0,0,0
755720,True,0,No user reviews,0,0,0
755730,True,0,No user reviews,0,0,0
755740,True,0,No user reviews,0,0,0
755741,True,0,No user reviews,0,0,0
755742,True,0,No user reviews,0,0,0
755743,True,0,1 user reviews,0,1,1
755744,True,0,1 user reviews,0,1,1
755750,True,0,No user reviews,0,0,0
755751,True,0,No user reviews,0,0,0
755752,True,0,1 user reviews,0,1,1
755753,True,0,No user reviews,0,0,0
755754,True,0,No user reviews,0,0,0
755755,True,0,No user reviews,0,0,0
755756,True,0,3 user reviews,3,0,3
755757,True,0,4 user reviews,2,2,4
755760,True,0,1 user reviews,1,0,1
755770,True,0,No user reviews,0,0,0
755790,True,6,Mostly Positive,161,64,225
755800,True,0,No user reviews,0,0,0
755820,True,0,No user reviews,0,0,0
755830,True,0,8 user reviews,7,1,8
755840,True,0,No user reviews,0,0,0
755850,True,0,4 user reviews,2,2,4
755860,True,0,1 user reviews,1,0,1
755890,True,6,Mostly Positive,29,12,41
755920,True,0,7 user reviews,7,0,7
755950,True,7,Positive,24,3,27
755980,True,8,Very Positive,64,12,76
755990,True,0,No user reviews,0,0,0
756010,True,5,Mixed,116,103,219
756020,True,7,Positive,9,1,10
756040,True,6,Mostly Positive,12,5,17
756060,True,0,8 user reviews,7,1,8
756070,True,0,6 user reviews,5,1,6
756071,True,6,Mostly Positive,102,39,141
756080,True,0,4 user reviews,3,1,4
756090,True,4,Mostly Negative,5,10,15
756100,True,0,1 user reviews,1,0,1
756120,True,0,No user reviews,0,0,0
756121,True,0,No user reviews,0,0,0
756130,True,0,No user reviews,0,0,0
756140,True,0,No user reviews,0,0,0
756150,True,0,1 user reviews,1,0,1
756170,True,0,No user reviews,0,0,0
756180,True,0,No user reviews,0,0,0
756181,True,0,No user reviews,0,0,0
756190,True,0,1 user reviews,0,1,1
756200,True,0,No user reviews,0,0,0
756210,True,0,3 user reviews,3,0,3
756220,True,0,No user reviews,0,0,0
756230,True,0,7 user reviews,3,4,7
756240,True,6,Mostly Positive,22,7,29
756260,True,4,Mostly Negative,4,8,12
756280,True,0,7 user reviews,6,1,7
756290,True,0,2 user reviews,0,2,2
756300,True,0,No user reviews,0,0,0
756320,True,7,Positive,23,0,23
756330,True,0,No user reviews,0,0,0
756340,True,0,2 user reviews,1,1,2
756350,True,0,4 user reviews,1,3,4
756360,True,5,Mixed,25,18,43
756380,True,0,No user reviews,0,0,0
756410,True,0,No user reviews,0,0,0
756420,True,0,4 user reviews,0,4,4
756440,True,0,6 user reviews,6,0,6
756490,True,0,6 user reviews,3,3,6
756500,True,4,Mostly Negative,7,12,19
756520,True,0,3 user reviews,0,3,3
756530,True,6,Mostly Positive,96,38,134
756540,True,0,No user reviews,0,0,0
756550,True,0,No user reviews,0,0,0
756560,True,0,3 user reviews,3,0,3
756590,True,8,Very Positive,79,9,88
756600,True,7,Positive,13,2,15
756610,True,0,No user reviews,0,0,0
756611,True,0,No user reviews,0,0,0
756620,True,0,No user reviews,0,0,0
756630,True,0,4 user reviews,4,0,4
756640,True,0,No user reviews,0,0,0
756650,True,0,No user reviews,0,0,0
756660,True,8,Very Positive,420,25,445
756680,True,0,2 user reviews,2,0,2
756690,True,0,No user reviews,0,0,0
756700,True,7,Positive,13,3,16
756720,True,0,1 user reviews,0,1,1
756721,True,0,1 user reviews,1,0,1
756722,True,0,No user reviews,0,0,0
756723,True,0,No user reviews,0,0,0
756724,True,0,No user reviews,0,0,0
756725,True,0,No user reviews,0,0,0
756726,True,0,No user reviews,0,0,0
756727,True,0,No user reviews,0,0,0
756728,True,0,1 user reviews,0,1,1
756729,True,0,No user reviews,0,0,0
756730,True,0,No user reviews,0,0,0
756731,True,0,No user reviews,0,0,0
756740,True,0,1 user reviews,1,0,1
756760,True,0,No user reviews,0,0,0
756790,True,0,5 user reviews,5,0,5
756800,True,0,No user reviews,0,0,0
756810,True,0,3 user reviews,1,2,3
756840,True,0,4 user reviews,4,0,4
756860,True,0,3 user reviews,2,1,3
756880,True,5,Mixed,17,22,39
756890,True,0,1 user reviews,1,0,1
756900,True,0,No user reviews,0,0,0
756910,True,0,No user reviews,0,0,0
756920,True,0,No user reviews,0,0,0
756950,True,0,No user reviews,0,0,0
756951,True,0,2 user reviews,0,2,2
756952,True,0,No user reviews,0,0,0
756953,True,0,No user reviews,0,0,0
756954,True,0,No user reviews,0,0,0
756955,True,0,4 user reviews,3,1,4
756980,True,0,1 user reviews,1,0,1
757020,True,0,No user reviews,0,0,0
757030,True,7,Positive,12,0,12
757040,True,7,Positive,47,2,49
757050,True,0,No user reviews,0,0,0
757060,True,6,Mostly Positive,7,3,10
757070,True,0,1 user reviews,0,1,1
757080,True,7,Positive,9,2,11
757090,True,0,No user reviews,0,0,0
757100,True,0,8 user reviews,7,1,8
757120,True,0,No user reviews,0,0,0
757130,True,0,No user reviews,0,0,0
757150,True,0,No user reviews,0,0,0
757160,True,4,Mostly Negative,5,9,14
757170,True,0,2 user reviews,2,0,2
757180,True,7,Positive,42,6,48
757190,True,0,1 user reviews,1,0,1
757200,True,6,Mostly Positive,22,9,31
757210,True,8,Very Positive,154,15,169
757220,True,0,No user reviews,0,0,0
757230,True,0,2 user reviews,0,2,2
757240,True,0,1 user reviews,1,0,1
757280,True,0,2 user reviews,2,0,2
757290,True,0,No user reviews,0,0,0
757300,True,8,Very Positive,88,18,106
757310,True,0,No user reviews,0,0,0
757320,True,8,Very Positive,180,19,199
757330,True,8,Very Positive,67,7,74
757350,True,5,Mixed,6,8,14
757380,True,0,No user reviews,0,0,0
757400,True,0,1 user reviews,1,0,1
757410,True,0,No user reviews,0,0,0
757420,True,0,7 user reviews,2,5,7
757430,True,0,4 user reviews,4,0,4
757440,True,0,No user reviews,0,0,0
757450,True,6,Mostly Positive,17,5,22
757460,True,0,No user reviews,0,0,0
757480,True,8,Very Positive,442,15,457
757490,True,0,No user reviews,0,0,0
757500,True,0,2 user reviews,0,2,2
757510,True,0,8 user reviews,7,1,8
757530,True,0,No user reviews,0,0,0
757540,True,0,4 user reviews,2,2,4
757550,True,0,No user reviews,0,0,0
757560,True,0,No user reviews,0,0,0
757570,True,0,No user reviews,0,0,0
757580,True,6,Mostly Positive,12,5,17
757590,True,5,Mixed,9,8,17
757600,True,0,3 user reviews,1,2,3
757630,True,4,Mostly Negative,4,8,12
757670,True,0,No user reviews,0,0,0
757690,True,0,No user reviews,0,0,0
757700,True,0,3 user reviews,3,0,3
757730,True,7,Positive,12,1,13
757750,True,0,No user reviews,0,0,0
757760,True,0,1 user reviews,1,0,1
757770,True,0,5 user reviews,4,1,5
757780,True,0,No user reviews,0,0,0
757790,True,0,No user reviews,0,0,0
757800,True,0,No user reviews,0,0,0
757820,True,0,No user reviews,0,0,0
757860,True,5,Mixed,5,7,12
757870,True,0,4 user reviews,3,1,4
757890,True,0,No user reviews,0,0,0
757900,True,0,No user reviews,0,0,0
757910,True,0,No user reviews,0,0,0
757920,True,0,No user reviews,0,0,0
757930,True,0,No user reviews,0,0,0
757940,True,0,No user reviews,0,0,0
757960,True,0,No user reviews,0,0,0
757970,True,0,No user reviews,0,0,0
757980,True,0,No user reviews,0,0,0
757990,True,0,2 user reviews,1,1,2
758020,True,0,1 user reviews,1,0,1
758030,True,0,No user reviews,0,0,0
758040,True,0,No user reviews,0,0,0
758050,True,4,Mostly Negative,4,7,11
758070,True,7,Positive,9,1,10
758080,True,6,Mostly Positive,43,14,57
758090,True,7,Positive,17,0,17
758100,True,5,Mixed,29,22,51
758110,True,0,No user reviews,0,0,0
758120,True,5,Mixed,8,6,14
758130,True,0,No user reviews,0,0,0
758140,True,0,1 user reviews,0,1,1
758150,True,0,5 user reviews,4,1,5
758160,True,8,Very Positive,60,0,60
758170,True,0,6 user reviews,5,1,6
758180,True,0,No user reviews,0,0,0
758190,True,8,Very Positive,589,92,681
758210,True,0,No user reviews,0,0,0
758220,True,0,5 user reviews,4,1,5
758230,True,8,Very Positive,170,6,176
758250,True,5,Mixed,12,6,18
758270,True,0,No user reviews,0,0,0
758280,True,0,No user reviews,0,0,0
758290,True,0,5 user reviews,5,0,5
758320,True,6,Mostly Positive,48,14,62
758330,True,8,Very Positive,627,76,703
758350,True,0,No user reviews,0,0,0
758360,True,0,No user reviews,0,0,0
758370,True,8,Very Positive,455,51,506
758380,True,0,No user reviews,0,0,0
758390,True,0,4 user reviews,1,3,4
758400,True,0,3 user reviews,2,1,3
758410,True,6,Mostly Positive,89,25,114
758420,True,5,Mixed,268,128,396
758440,True,0,7 user reviews,5,2,7
758450,True,0,No user reviews,0,0,0
758470,True,0,7 user reviews,4,3,7
758480,True,8,Very Positive,211,9,220
758500,True,8,Very Positive,277,15,292
758520,True,0,No user reviews,0,0,0
758530,True,0,No user reviews,0,0,0
758540,True,0,No user reviews,0,0,0
758560,True,7,Positive,15,0,15
758570,True,8,Very Positive,58,12,70
758580,True,0,3 user reviews,3,0,3
758590,True,0,3 user reviews,3,0,3
758600,True,0,3 user reviews,2,1,3
758610,True,0,1 user reviews,0,1,1
758620,True,0,No user reviews,0,0,0
758630,True,0,5 user reviews,5,0,5
758640,True,0,1 user reviews,1,0,1
758650,True,0,No user reviews,0,0,0
758660,True,7,Positive,24,1,25
758680,True,0,No user reviews,0,0,0
758690,True,0,No user reviews,0,0,0
758720,True,0,No user reviews,0,0,0
758730,True,8,Very Positive,43,10,53
758770,True,4,Mostly Negative,13,20,33
758771,True,4,Mostly Negative,6,12,18
758790,True,0,1 user reviews,0,1,1
758840,True,0,No user reviews,0,0,0
758870,True,8,Very Positive,455,51,506
758880,True,0,8 user reviews,5,3,8
758910,True,0,1 user reviews,1,0,1
758920,True,0,No user reviews,0,0,0
758930,True,7,Positive,33,6,39
758980,True,0,No user reviews,0,0,0
758990,True,8,Very Positive,612,57,669
759000,True,7,Positive,41,5,46
759010,True,0,6 user reviews,3,3,6
759020,True,0,No user reviews,0,0,0
759030,True,0,No user reviews,0,0,0
759040,True,0,No user reviews,0,0,0
759060,True,6,Mostly Positive,17,6,23
759070,True,0,No user reviews,0,0,0
759071,True,0,No user reviews,0,0,0
759072,True,0,No user reviews,0,0,0
759080,True,0,No user reviews,0,0,0
759130,True,6,Mostly Positive,54,14,68
759140,True,0,No user reviews,0,0,0
759150,True,0,No user reviews,0,0,0
759151,True,0,No user reviews,0,0,0
759152,True,0,No user reviews,0,0,0
759153,True,0,No user reviews,0,0,0
759154,True,0,No user reviews,0,0,0
759155,True,0,No user reviews,0,0,0
759156,True,0,No user reviews,0,0,0
759157,True,0,No user reviews,0,0,0
759160,True,5,Mixed,6,6,12
759170,True,0,1 user reviews,1,0,1
759180,True,0,No user reviews,0,0,0
759220,True,7,Positive,15,1,16
759230,True,0,No user reviews,0,0,0
759240,True,0,4 user reviews,4,0,4
759250,True,0,3 user reviews,3,0,3
759260,True,0,8 user reviews,6,2,8
759280,True,0,1 user reviews,0,1,1
759300,True,0,No user reviews,0,0,0
759320,True,0,No user reviews,0,0,0
759330,True,0,1 user reviews,1,0,1
759350,True,0,No user reviews,0,0,0
759380,True,0,No user reviews,0,0,0
759390,True,0,No user reviews,0,0,0
759410,True,0,No user reviews,0,0,0
759411,True,0,No user reviews,0,0,0
759412,True,0,No user reviews,0,0,0
759413,True,0,No user reviews,0,0,0
759414,True,0,No user reviews,0,0,0
759415,True,0,No user reviews,0,0,0
759416,True,0,No user reviews,0,0,0
759417,True,0,No user reviews,0,0,0
759418,True,0,No user reviews,0,0,0
759420,True,0,No user reviews,0,0,0
759440,True,8,Very Positive,105,11,116
759454,True,0,2 user reviews,2,0,2
759455,True,0,2 user reviews,2,0,2
759490,True,0,No user reviews,0,0,0
759500,True,0,6 user reviews,5,1,6
759510,True,0,No user reviews,0,0,0
759530,True,0,No user reviews,0,0,0
759540,True,6,Mostly Positive,55,14,69
759560,True,0,No user reviews,0,0,0
759570,True,5,Mixed,22,26,48
759580,True,0,5 user reviews,4,1,5
759581,True,0,2 user reviews,2,0,2
759590,True,0,3 user reviews,3,0,3
759610,True,0,3 user reviews,2,1,3
759640,True,7,Positive,17,1,18
759650,True,0,1 user reviews,1,0,1
759670,True,0,No user reviews,0,0,0
759680,True,0,1 user reviews,1,0,1
759681,True,0,2 user reviews,2,0,2
759740,True,6,Mostly Positive,540,141,681
759750,True,5,Mixed,9,10,19
759760,True,0,2 user reviews,2,0,2
759770,True,0,4 user reviews,3,1,4
759810,True,0,No user reviews,0,0,0
759820,True,0,No user reviews,0,0,0
759830,True,0,7 user reviews,4,3,7
759840,True,0,No user reviews,0,0,0
759850,True,0,1 user reviews,1,0,1
759870,True,3,Negative,3,16,19
759900,True,0,No user reviews,0,0,0
759910,True,0,No user reviews,0,0,0
759920,True,0,No user reviews,0,0,0
759940,True,0,8 user reviews,8,0,8
759950,True,0,8 user reviews,4,4,8
759970,True,0,No user reviews,0,0,0
759980,True,0,No user reviews,0,0,0
760000,True,0,2 user reviews,2,0,2
760010,True,0,No user reviews,0,0,0
760020,True,0,4 user reviews,3,1,4
760030,True,0,2 user reviews,2,0,2
760050,True,7,Positive,29,6,35
760060,True,8,Very Positive,4265,496,4761
760070,True,6,Mostly Positive,86,32,118
760080,True,6,Mostly Positive,25,10,35
760120,True,0,1 user reviews,0,1,1
760130,True,0,No user reviews,0,0,0
760180,True,0,3 user reviews,2,1,3
760190,True,0,No user reviews,0,0,0
760200,True,7,Positive,36,3,39
760220,True,0,2 user reviews,2,0,2
760240,True,0,No user reviews,0,0,0
760250,True,0,No user reviews,0,0,0
760260,True,0,No user reviews,0,0,0
760300,True,0,7 user reviews,7,0,7
760320,True,6,Mostly Positive,7,3,10
760330,True,8,Very Positive,175,8,183
760340,True,0,No user reviews,0,0,0
760350,True,5,Mixed,8,5,13
760360,True,0,2 user reviews,0,2,2
760390,True,0,1 user reviews,1,0,1
760400,True,5,Mixed,12,6,18
760410,True,0,No user reviews,0,0,0
760420,True,0,1 user reviews,0,1,1
760460,True,5,Mixed,30,22,52
760490,True,0,No user reviews,0,0,0
760510,True,0,7 user reviews,7,0,7
760520,True,0,2 user reviews,1,1,2
760530,True,0,1 user reviews,0,1,1
760550,True,0,No user reviews,0,0,0
760560,True,5,Mixed,6,6,12
760570,True,0,No user reviews,0,0,0
760571,True,0,No user reviews,0,0,0
760572,True,0,No user reviews,0,0,0
760573,True,0,No user reviews,0,0,0
760580,True,0,2 user reviews,1,1,2
760590,True,0,No user reviews,0,0,0
760610,True,0,7 user reviews,7,0,7
760620,True,6,Mostly Positive,165,58,223
760630,True,7,Positive,40,4,44
760650,True,8,Very Positive,63,12,75
760660,True,0,6 user reviews,1,5,6
760680,True,0,4 user reviews,2,2,4
760710,True,0,2 user reviews,1,1,2
760720,True,0,5 user reviews,5,0,5
760730,True,6,Mostly Positive,47,18,65
760760,True,0,No user reviews,0,0,0
760800,True,6,Mostly Positive,35,15,50
760810,True,7,Positive,40,1,41
760830,True,0,No user reviews,0,0,0
760840,True,4,Mostly Negative,4,8,12
760841,True,4,Mostly Negative,4,7,11
760842,True,3,Negative,2,13,15
760843,True,4,Mostly Negative,17,38,55
760844,True,0,7 user reviews,1,6,7
760860,True,5,Mixed,7,7,14
760890,True,8,Very Positive,154,3,157
760900,True,0,No user reviews,0,0,0
760910,True,0,No user reviews,0,0,0
760920,True,7,Positive,19,1,20
760930,True,5,Mixed,16,14,30
760940,True,0,No user reviews,0,0,0
760950,True,0,No user reviews,0,0,0
760960,True,0,4 user reviews,3,1,4
760970,True,0,2 user reviews,2,0,2
760980,True,0,No user reviews,0,0,0
761000,True,0,No user reviews,0,0,0
761010,True,0,No user reviews,0,0,0
761020,True,0,No user reviews,0,0,0
761030,True,8,Very Positive,120,27,147
761040,True,0,5 user reviews,5,0,5
761070,True,0,No user reviews,0,0,0
761080,True,0,No user reviews,0,0,0
761090,True,0,No user reviews,0,0,0
761100,True,0,1 user reviews,1,0,1
761110,True,0,4 user reviews,1,3,4
761130,True,0,No user reviews,0,0,0
761140,True,0,No user reviews,0,0,0
761150,True,0,No user reviews,0,0,0
761160,True,0,4 user reviews,4,0,4
761170,True,7,Positive,33,2,35
761190,True,0,5 user reviews,4,1,5
761210,True,0,No user reviews,0,0,0
761220,True,0,4 user reviews,2,2,4
761230,True,0,No user reviews,0,0,0
761231,True,0,No user reviews,0,0,0
761240,True,0,No user reviews,0,0,0
761250,True,0,7 user reviews,1,6,7
761270,True,0,No user reviews,0,0,0
761280,True,0,No user reviews,0,0,0
761290,True,0,3 user reviews,3,0,3
761300,True,0,1 user reviews,1,0,1
761320,True,7,Positive,25,5,30
761350,True,8,Very Positive,53,5,58
761400,True,0,No user reviews,0,0,0
761440,True,0,2 user reviews,2,0,2
761450,True,0,No user reviews,0,0,0
761460,True,8,Very Positive,214,22,236
761480,True,7,Positive,21,0,21
761530,True,0,No user reviews,0,0,0
761560,True,0,No user reviews,0,0,0
761570,True,0,No user reviews,0,0,0
761590,True,0,6 user reviews,6,0,6
761591,True,0,4 user reviews,4,0,4
761592,True,0,3 user reviews,3,0,3
761593,True,0,3 user reviews,3,0,3
761594,True,0,4 user reviews,4,0,4
761595,True,0,2 user reviews,2,0,2
761596,True,7,Positive,10,0,10
761597,True,0,1 user reviews,1,0,1
761600,True,8,Very Positive,407,23,430
761620,True,8,Very Positive,367,77,444
761630,True,3,Negative,1,9,10
761640,True,0,9 user reviews,1,8,9
761660,True,0,3 user reviews,0,3,3
761670,True,7,Positive,16,0,16
761680,True,0,No user reviews,0,0,0
761700,True,5,Mixed,6,4,10
761720,True,0,No user reviews,0,0,0
761760,True,5,Mixed,10,6,16
761770,True,0,No user reviews,0,0,0
761790,True,5,Mixed,8,7,15
761830,True,0,No user reviews,0,0,0
761880,True,0,1 user reviews,1,0,1
761890,True,5,Mixed,539,235,774
761900,True,0,No user reviews,0,0,0
761910,True,8,Very Positive,134,18,152
761920,True,0,2 user reviews,2,0,2
761930,True,0,1 user reviews,0,1,1
761970,True,0,No user reviews,0,0,0
761980,True,0,No user reviews,0,0,0
761990,True,0,No user reviews,0,0,0
762000,True,0,No user reviews,0,0,0
762030,True,7,Positive,16,1,17
762060,True,0,No user reviews,0,0,0
762070,True,0,1 user reviews,1,0,1
762080,True,6,Mostly Positive,28,11,39
762090,True,0,No user reviews,0,0,0
762100,True,0,No user reviews,0,0,0
762110,True,0,3 user reviews,3,0,3
762120,True,0,2 user reviews,0,2,2
762130,True,0,2 user reviews,1,1,2
762140,True,0,1 user reviews,0,1,1
762150,True,0,No user reviews,0,0,0
762174,True,7,Positive,30,0,30
762176,True,0,1 user reviews,1,0,1
762177,True,0,4 user reviews,4,0,4
762178,True,0,3 user reviews,3,0,3
762179,True,0,5 user reviews,4,1,5
762180,True,7,Positive,17,0,17
762190,True,0,6 user reviews,6,0,6
762220,True,6,Mostly Positive,34,10,44
762240,True,0,5 user reviews,5,0,5
762250,True,0,No user reviews,0,0,0
762270,True,0,8 user reviews,8,0,8
762290,True,0,1 user reviews,1,0,1
762300,True,0,1 user reviews,1,0,1
762310,True,0,1 user reviews,1,0,1
762320,True,0,1 user reviews,1,0,1
762330,True,0,1 user reviews,1,0,1
762340,True,0,1 user reviews,1,0,1
762350,True,0,1 user reviews,1,0,1
762360,True,0,1 user reviews,1,0,1
762380,True,5,Mixed,5,5,10
762390,True,0,2 user reviews,2,0,2
762420,True,0,No user reviews,0,0,0
762440,True,0,No user reviews,0,0,0
762450,True,0,No user reviews,0,0,0
762480,True,0,No user reviews,0,0,0
762490,True,6,Mostly Positive,22,9,31
762500,True,7,Positive,11,2,13
762520,True,5,Mixed,12,10,22
762530,True,0,No user reviews,0,0,0
762540,True,0,No user reviews,0,0,0
762550,True,0,No user reviews,0,0,0
762560,True,0,No user reviews,0,0,0
762590,True,7,Positive,12,3,15
762600,True,0,7 user reviews,6,1,7
762610,True,8,Very Positive,89,2,91
762630,True,0,4 user reviews,2,2,4
762640,True,0,1 user reviews,1,0,1
762650,True,5,Mixed,283,125,408
762660,True,0,No user reviews,0,0,0
762670,True,0,2 user reviews,1,1,2
762680,True,0,3 user reviews,1,2,3
762770,True,7,Positive,12,1,13
762780,True,0,No user reviews,0,0,0
762800,True,0,No user reviews,0,0,0
762830,True,5,Mixed,227,112,339
762840,True,0,No user reviews,0,0,0
762850,True,0,No user reviews,0,0,0
762860,True,0,1 user reviews,1,0,1
762870,True,0,No user reviews,0,0,0
762880,True,0,No user reviews,0,0,0
762900,True,0,6 user reviews,2,4,6
762912,True,7,Positive,12,0,12
762913,True,7,Positive,21,1,22
762914,True,0,3 user reviews,3,0,3
762915,True,0,9 user reviews,9,0,9
762916,True,0,4 user reviews,4,0,4
762918,True,0,3 user reviews,3,0,3
762919,True,0,4 user reviews,4,0,4
762920,True,4,Mostly Negative,10,18,28
762930,True,7,Positive,18,0,18
762940,True,0,No user reviews,0,0,0
762950,True,0,4 user reviews,3,1,4
762970,True,0,1 user reviews,0,1,1
762980,True,0,1 user reviews,1,0,1
763000,True,0,No user reviews,0,0,0
763010,True,0,5 user reviews,4,1,5
763030,True,8,Very Positive,49,4,53
763050,True,0,9 user reviews,5,4,9
763070,True,5,Mixed,8,4,12
763090,True,5,Mixed,4,6,10
763100,True,5,Mixed,24,13,37
763170,True,0,No user reviews,0,0,0
763180,True,0,No user reviews,0,0,0
763200,True,0,No user reviews,0,0,0
763210,True,0,7 user reviews,3,4,7
763220,True,0,No user reviews,0,0,0
763230,True,0,No user reviews,0,0,0
763250,True,6,Mostly Positive,69,22,91
763260,True,0,No user reviews,0,0,0
763270,True,6,Mostly Positive,8,3,11
763280,True,0,2 user reviews,2,0,2
763290,True,5,Mixed,15,10,25
763300,True,0,5 user reviews,1,4,5
763320,True,0,3 user reviews,3,0,3
763340,True,0,No user reviews,0,0,0
763350,True,0,3 user reviews,3,0,3
763360,True,0,5 user reviews,3,2,5
763370,True,0,6 user reviews,4,2,6
763380,True,0,2 user reviews,2,0,2
763390,True,0,No user reviews,0,0,0
763400,True,0,2 user reviews,0,2,2
763410,True,0,No user reviews,0,0,0
763420,True,0,No user reviews,0,0,0
763430,True,6,Mostly Positive,47,15,62
763470,True,0,No user reviews,0,0,0
763490,True,0,1 user reviews,1,0,1
763520,True,0,4 user reviews,2,2,4
763560,True,0,No user reviews,0,0,0
763570,True,0,No user reviews,0,0,0
763580,True,0,No user reviews,0,0,0
763590,True,0,1 user reviews,1,0,1
763600,True,0,No user reviews,0,0,0
763610,True,0,No user reviews,0,0,0
763630,True,0,5 user reviews,3,2,5
763650,True,0,No user reviews,0,0,0
763680,True,0,1 user reviews,0,1,1
763691,True,0,4 user reviews,4,0,4
763692,True,0,4 user reviews,4,0,4
763693,True,7,Positive,12,0,12
763695,True,0,No user reviews,0,0,0
763696,True,0,No user reviews,0,0,0
763697,True,0,No user reviews,0,0,0
763698,True,0,No user reviews,0,0,0
763699,True,8,Very Positive,51,3,54
763710,True,0,7 user reviews,5,2,7
763720,True,0,No user reviews,0,0,0
763730,True,0,8 user reviews,5,3,8
763740,True,0,3 user reviews,1,2,3
763750,True,0,5 user reviews,3,2,5
763760,True,7,Positive,16,1,17
763770,True,5,Mixed,13,6,19
763780,True,8,Very Positive,288,27,315
763790,True,7,Positive,29,2,31
763810,True,0,6 user reviews,4,2,6
763820,True,5,Mixed,123,120,243
763860,True,0,No user reviews,0,0,0
763870,True,0,No user reviews,0,0,0
763880,True,0,No user reviews,0,0,0
763890,True,9,Overwhelmingly Positive,1418,44,1462
763910,True,7,Positive,18,4,22
763920,True,0,No user reviews,0,0,0
763930,True,8,Very Positive,49,1,50
763940,True,0,No user reviews,0,0,0
763950,True,0,6 user reviews,2,4,6
763960,True,0,No user reviews,0,0,0
763970,True,7,Positive,26,6,32
763990,True,5,Mixed,12,7,19
764010,True,5,Mixed,16,15,31
764030,True,0,No user reviews,0,0,0
764040,True,0,No user reviews,0,0,0
764050,True,8,Very Positive,443,103,546
764080,True,0,No user reviews,0,0,0
764090,True,0,3 user reviews,3,0,3
764110,True,7,Positive,8,2,10
764180,True,0,6 user reviews,5,1,6
764230,True,8,Very Positive,52,5,57
764240,True,7,Positive,8,2,10
764250,True,0,No user reviews,0,0,0
764270,True,0,No user reviews,0,0,0
764280,True,0,7 user reviews,7,0,7
764300,True,8,Very Positive,142,10,152
764320,True,0,2 user reviews,1,1,2
764330,True,0,1 user reviews,1,0,1
764331,True,0,No user reviews,0,0,0
764340,True,0,1 user reviews,1,0,1
764350,True,0,No user reviews,0,0,0
764370,True,0,7 user reviews,7,0,7
764390,True,0,1 user reviews,1,0,1
764410,True,0,1 user reviews,0,1,1
764430,True,5,Mixed,8,5,13
764460,True,0,No user reviews,0,0,0
764470,True,0,6 user reviews,4,2,6
764490,True,0,4 user reviews,1,3,4
764500,True,7,Positive,27,6,33
764510,True,8,Very Positive,63,11,74
764530,True,0,No user reviews,0,0,0
764550,True,0,1 user reviews,0,1,1
764560,True,5,Mixed,10,5,15
764570,True,0,No user reviews,0,0,0
764590,True,6,Mostly Positive,15,4,19
764600,True,0,No user reviews,0,0,0
764620,True,0,No user reviews,0,0,0
764630,True,0,No user reviews,0,0,0
764660,True,0,1 user reviews,1,0,1
764661,True,0,2 user reviews,2,0,2
764670,True,5,Mixed,10,9,19
764690,True,0,No user reviews,0,0,0
764720,True,0,2 user reviews,2,0,2
764740,True,0,No user reviews,0,0,0
764750,True,0,No user reviews,0,0,0
764780,True,0,1 user reviews,0,1,1
764790,True,8,Very Positive,1996,132,2128
764830,True,0,4 user reviews,2,2,4
764860,True,0,No user reviews,0,0,0
764870,True,0,No user reviews,0,0,0
764880,True,0,1 user reviews,1,0,1
764890,True,0,4 user reviews,4,0,4
764900,True,0,No user reviews,0,0,0
764920,True,5,Mixed,151,113,264
764940,True,0,No user reviews,0,0,0
764950,True,0,No user reviews,0,0,0
764970,True,0,8 user reviews,7,1,8
764990,True,7,Positive,21,1,22
765010,True,0,1 user reviews,1,0,1
765020,True,0,No user reviews,0,0,0
765030,True,0,1 user reviews,1,0,1
765040,True,0,1 user reviews,1,0,1
765050,True,0,1 user reviews,0,1,1
765060,True,7,Positive,11,1,12
765080,True,0,No user reviews,0,0,0
765090,True,0,No user reviews,0,0,0
765100,True,7,Positive,10,0,10
765140,True,0,2 user reviews,1,1,2
765160,True,0,8 user reviews,4,4,8
765170,True,0,No user reviews,0,0,0
765180,True,4,Mostly Negative,6,14,20
765190,True,0,No user reviews,0,0,0
765210,True,6,Mostly Positive,48,16,64
765230,True,0,9 user reviews,8,1,9
765240,True,0,No user reviews,0,0,0
765250,True,5,Mixed,25,20,45
765260,True,0,3 user reviews,1,2,3
765290,True,0,No user reviews,0,0,0
765320,True,0,3 user reviews,1,2,3
765340,True,0,1 user reviews,0,1,1
765350,True,0,3 user reviews,3,0,3
765360,True,0,3 user reviews,3,0,3
765370,True,0,3 user reviews,0,3,3
765380,True,5,Mixed,8,4,12
765390,True,0,8 user reviews,1,7,8
765400,True,0,5 user reviews,1,4,5
765410,True,9,Overwhelmingly Positive,2103,92,2195
765420,True,0,No user reviews,0,0,0
765430,True,0,5 user reviews,5,0,5
765440,True,0,No user reviews,0,0,0
765450,True,0,No user reviews,0,0,0
765460,True,0,6 user reviews,4,2,6
765470,True,0,4 user reviews,2,2,4
765490,True,0,7 user reviews,6,1,7
765510,True,0,No user reviews,0,0,0
765520,True,0,2 user reviews,2,0,2
765530,True,0,3 user reviews,0,3,3
765560,True,0,7 user reviews,4,3,7
765570,True,0,3 user reviews,1,2,3
765590,True,7,Positive,16,2,18
765600,True,0,No user reviews,0,0,0
765610,True,7,Positive,16,2,18
765620,True,0,1 user reviews,0,1,1
765630,True,0,No user reviews,0,0,0
765640,True,0,4 user reviews,4,0,4
765650,True,0,No user reviews,0,0,0
765660,True,0,No user reviews,0,0,0
765670,True,0,No user reviews,0,0,0
765690,True,7,Positive,14,0,14
765700,True,0,No user reviews,0,0,0
765710,True,0,1 user reviews,1,0,1
765730,True,0,3 user reviews,0,3,3
765750,True,0,4 user reviews,4,0,4
765760,True,0,No user reviews,0,0,0
765770,True,0,8 user reviews,7,1,8
765780,True,0,No user reviews,0,0,0
765790,True,0,3 user reviews,1,2,3
765800,True,0,No user reviews,0,0,0
765810,True,0,No user reviews,0,0,0
765820,True,0,No user reviews,0,0,0
765830,True,0,4 user reviews,4,0,4
765840,True,0,9 user reviews,8,1,9
765850,True,0,6 user reviews,6,0,6
765860,True,0,5 user reviews,4,1,5
765870,True,8,Very Positive,238,50,288
765880,True,6,Mostly Positive,46,14,60
765890,True,7,Positive,25,1,26
765900,True,6,Mostly Positive,59,19,78
765910,True,0,7 user reviews,7,0,7
765930,True,0,3 user reviews,0,3,3
765940,True,7,Positive,18,1,19
765950,True,0,5 user reviews,2,3,5
765960,True,7,Positive,32,3,35
765970,True,0,No user reviews,0,0,0
766000,True,7,Positive,10,2,12
766010,True,0,1 user reviews,1,0,1
766030,True,7,Positive,10,0,10
766040,True,5,Mixed,31,30,61
766060,True,0,No user reviews,0,0,0
766070,True,0,1 user reviews,0,1,1
766090,True,0,No user reviews,0,0,0
766100,True,0,No user reviews,0,0,0
766101,True,0,No user reviews,0,0,0
766102,True,0,No user reviews,0,0,0
766110,True,0,No user reviews,0,0,0
766130,True,0,No user reviews,0,0,0
766150,True,0,1 user reviews,1,0,1
766170,True,0,No user reviews,0,0,0
766171,True,0,No user reviews,0,0,0
766172,True,0,No user reviews,0,0,0
766173,True,0,No user reviews,0,0,0
766180,True,0,No user reviews,0,0,0
766200,True,0,No user reviews,0,0,0
766210,True,0,No user reviews,0,0,0
766250,True,0,No user reviews,0,0,0
766280,True,8,Very Positive,124,10,134
766300,True,0,3 user reviews,3,0,3
766310,True,0,No user reviews,0,0,0
766320,True,6,Mostly Positive,58,17,75
766350,True,0,No user reviews,0,0,0
766360,True,0,No user reviews,0,0,0
766370,True,5,Mixed,262,165,427
766400,True,0,No user reviews,0,0,0
766401,True,0,No user reviews,0,0,0
766402,True,0,No user reviews,0,0,0
766403,True,0,No user reviews,0,0,0
766404,True,0,No user reviews,0,0,0
766405,True,0,No user reviews,0,0,0
766406,True,0,No user reviews,0,0,0
766407,True,0,No user reviews,0,0,0
766408,True,0,No user reviews,0,0,0
766409,True,0,No user reviews,0,0,0
766410,True,0,No user reviews,0,0,0
766411,True,0,No user reviews,0,0,0
766412,True,0,No user reviews,0,0,0
766420,True,0,2 user reviews,1,1,2
766430,True,0,No user reviews,0,0,0
766440,True,0,No user reviews,0,0,0
766441,True,0,No user reviews,0,0,0
766442,True,0,No user reviews,0,0,0
766443,True,0,No user reviews,0,0,0
766444,True,0,No user reviews,0,0,0
766445,True,0,No user reviews,0,0,0
766446,True,0,No user reviews,0,0,0
766447,True,0,No user reviews,0,0,0
766448,True,0,No user reviews,0,0,0
766449,True,0,1 user reviews,1,0,1
766450,True,0,3 user reviews,3,0,3
766460,True,0,2 user reviews,0,2,2
766470,True,0,No user reviews,0,0,0
766471,True,0,1 user reviews,1,0,1
766472,True,0,1 user reviews,1,0,1
766490,True,0,No user reviews,0,0,0
766491,True,0,No user reviews,0,0,0
766500,True,0,1 user reviews,1,0,1
766520,True,0,No user reviews,0,0,0
766521,True,0,2 user reviews,2,0,2
766550,True,6,Mostly Positive,7,3,10
766560,True,7,Positive,9,1,10
766570,True,0,No user reviews,0,0,0
766580,True,0,2 user reviews,0,2,2
766600,True,4,Mostly Negative,3,7,10
766610,True,0,No user reviews,0,0,0
766611,True,0,No user reviews,0,0,0
766620,True,0,1 user reviews,0,1,1
766630,True,7,Positive,39,8,47
766650,True,0,No user reviews,0,0,0
766680,True,5,Mixed,12,9,21
766700,True,0,7 user reviews,3,4,7
766710,True,0,1 user reviews,1,0,1
766711,True,0,No user reviews,0,0,0
766712,True,0,3 user reviews,2,1,3
766730,True,8,Very Positive,83,6,89
766740,True,0,9 user reviews,8,1,9
766770,True,0,No user reviews,0,0,0
766780,True,0,6 user reviews,6,0,6
766850,True,5,Mixed,28,27,55
766870,True,8,Very Positive,50,10,60
766880,True,0,No user reviews,0,0,0
766900,True,0,No user reviews,0,0,0
766910,True,0,1 user reviews,1,0,1
766930,True,0,No user reviews,0,0,0
766940,True,7,Positive,25,1,26
766990,True,0,No user reviews,0,0,0
767000,True,0,No user reviews,0,0,0
767010,True,0,1 user reviews,1,0,1
767020,True,0,2 user reviews,2,0,2
767030,True,5,Mixed,5,6,11
767050,True,4,Mostly Negative,4,7,11
767080,True,0,No user reviews,0,0,0
767100,True,0,5 user reviews,2,3,5
767110,True,5,Mixed,4,6,10
767120,True,0,No user reviews,0,0,0
767130,True,0,4 user reviews,1,3,4
767140,True,0,No user reviews,0,0,0
767150,True,0,No user reviews,0,0,0
767170,True,0,1 user reviews,0,1,1
767180,True,0,No user reviews,0,0,0
767190,True,0,4 user reviews,4,0,4
767200,True,0,2 user reviews,2,0,2
767220,True,0,No user reviews,0,0,0
767230,True,0,No user reviews,0,0,0
767240,True,7,Positive,12,3,15
767260,True,0,1 user reviews,1,0,1
767300,True,0,No user reviews,0,0,0
767310,True,0,7 user reviews,1,6,7
767330,True,0,4 user reviews,0,4,4
767340,True,0,7 user reviews,3,4,7
767360,True,7,Positive,17,1,18
767380,True,0,No user reviews,0,0,0
767390,True,5,Mixed,97,46,143
767400,True,0,1 user reviews,1,0,1
767410,True,0,No user reviews,0,0,0
767420,True,0,No user reviews,0,0,0
767460,True,7,Positive,19,4,23
767470,True,0,No user reviews,0,0,0
767490,True,6,Mostly Positive,33,9,42
767500,True,0,5 user reviews,5,0,5
767510,True,0,No user reviews,0,0,0
767530,True,0,No user reviews,0,0,0
767550,True,0,No user reviews,0,0,0
767560,True,0,No user reviews,0,0,0
767570,True,7,Positive,13,0,13
767580,True,0,2 user reviews,1,1,2
767590,True,0,No user reviews,0,0,0
767650,True,7,Positive,11,0,11
767660,True,0,No user reviews,0,0,0
767680,True,0,No user reviews,0,0,0
767690,True,0,No user reviews,0,0,0
767810,True,0,1 user reviews,1,0,1
767840,True,0,2 user reviews,1,1,2
767860,True,0,No user reviews,0,0,0
767870,True,0,No user reviews,0,0,0
767880,True,0,No user reviews,0,0,0
767890,True,5,Mixed,8,5,13
767910,True,0,3 user reviews,0,3,3
767930,True,8,Very Positive,138,15,153
767960,True,0,3 user reviews,1,2,3
767970,True,6,Mostly Positive,11,3,14
767980,True,0,4 user reviews,3,1,4
767990,True,0,No user reviews,0,0,0
768010,True,0,No user reviews,0,0,0
768020,True,0,2 user reviews,1,1,2
768050,True,0,7 user reviews,4,3,7
768060,True,7,Positive,15,2,17
768090,True,0,7 user reviews,5,2,7
768100,True,0,No user reviews,0,0,0
768110,True,0,1 user reviews,1,0,1
768120,True,0,No user reviews,0,0,0
768130,True,0,2 user reviews,1,1,2
768160,True,0,No user reviews,0,0,0
768170,True,0,4 user reviews,1,3,4
768180,True,0,No user reviews,0,0,0
768200,True,0,No user reviews,0,0,0
768210,True,0,No user reviews,0,0,0
768220,True,0,No user reviews,0,0,0
768240,True,0,3 user reviews,3,0,3
768270,True,0,9 user reviews,9,0,9
768290,True,7,Positive,13,1,14
768300,True,0,2 user reviews,1,1,2
768310,True,0,1 user reviews,1,0,1
768340,True,0,3 user reviews,3,0,3
768370,True,5,Mixed,30,32,62
768450,True,0,No user reviews,0,0,0
768460,True,6,Mostly Positive,12,4,16
768480,True,0,2 user reviews,2,0,2
768500,True,0,No user reviews,0,0,0
768520,True,0,No user reviews,0,0,0
768530,True,5,Mixed,42,19,61
768540,True,5,Mixed,17,11,28
768550,True,0,9 user reviews,6,3,9
768560,True,0,No user reviews,0,0,0
768561,True,0,2 user reviews,0,2,2
768562,True,0,2 user reviews,2,0,2
768570,True,0,3 user reviews,0,3,3
768580,True,0,7 user reviews,6,1,7
768590,True,7,Positive,10,1,11
768600,True,0,No user reviews,0,0,0
768620,True,0,No user reviews,0,0,0
768630,True,0,No user reviews,0,0,0
768640,True,0,2 user reviews,2,0,2
768680,True,0,No user reviews,0,0,0
768690,True,0,No user reviews,0,0,0
768700,True,0,No user reviews,0,0,0
768701,True,0,No user reviews,0,0,0
768702,True,0,1 user reviews,1,0,1
768703,True,0,1 user reviews,0,1,1
768710,True,0,No user reviews,0,0,0
768730,True,0,2 user reviews,1,1,2
768750,True,5,Mixed,54,68,122
768770,True,0,2 user reviews,2,0,2
768790,True,0,No user reviews,0,0,0
768800,True,6,Mostly Positive,26,9,35
768820,True,0,No user reviews,0,0,0
768830,True,8,Very Positive,55,8,63
768840,True,0,No user reviews,0,0,0
768850,True,0,No user reviews,0,0,0
768851,True,0,No user reviews,0,0,0
768852,True,0,No user reviews,0,0,0
768853,True,0,No user reviews,0,0,0
768854,True,0,No user reviews,0,0,0
768855,True,0,No user reviews,0,0,0
768856,True,0,No user reviews,0,0,0
768880,True,0,4 user reviews,3,1,4
768910,True,0,No user reviews,0,0,0
768920,True,0,No user reviews,0,0,0
768930,True,0,No user reviews,0,0,0
768950,True,0,No user reviews,0,0,0
768970,True,0,No user reviews,0,0,0
768990,True,0,8 user reviews,4,4,8
769000,True,0,No user reviews,0,0,0
769010,True,0,No user reviews,0,0,0
769020,True,0,2 user reviews,2,0,2
769030,True,0,No user reviews,0,0,0
769060,True,0,8 user reviews,6,2,8
769080,True,0,5 user reviews,2,3,5
769090,True,0,No user reviews,0,0,0
769100,True,0,No user reviews,0,0,0
769110,True,4,Mostly Negative,5,9,14
769120,True,0,No user reviews,0,0,0
769130,True,0,6 user reviews,6,0,6
769140,True,0,1 user reviews,1,0,1
769150,True,0,6 user reviews,2,4,6
769160,True,0,1 user reviews,1,0,1
769170,True,0,No user reviews,0,0,0
769180,True,7,Positive,22,0,22
769190,True,0,No user reviews,0,0,0
769200,True,0,6 user reviews,4,2,6
769220,True,7,Positive,10,2,12
769230,True,0,No user reviews,0,0,0
769320,True,7,Positive,10,0,10
769340,True,0,8 user reviews,6,2,8
769360,True,4,Mostly Negative,5,11,16
769370,True,0,1 user reviews,0,1,1
769390,True,0,3 user reviews,0,3,3
769410,True,7,Positive,18,3,21
769420,True,0,5 user reviews,4,1,5
769440,True,7,Positive,9,2,11
769480,True,0,No user reviews,0,0,0
769500,True,0,No user reviews,0,0,0
769501,True,0,No user reviews,0,0,0
769502,True,0,No user reviews,0,0,0
769503,True,0,No user reviews,0,0,0
769504,True,0,No user reviews,0,0,0
769505,True,0,No user reviews,0,0,0
769520,True,0,1 user reviews,1,0,1
769540,True,0,1 user reviews,1,0,1
769550,True,0,5 user reviews,3,2,5
769560,True,0,9 user reviews,9,0,9
769570,True,0,No user reviews,0,0,0
769580,True,0,1 user reviews,1,0,1
769590,True,0,4 user reviews,4,0,4
769600,True,0,No user reviews,0,0,0
769610,True,0,No user reviews,0,0,0
769620,True,0,8 user reviews,4,4,8
769630,True,0,No user reviews,0,0,0
769640,True,0,2 user reviews,1,1,2
769670,True,5,Mixed,43,23,66
769680,True,0,2 user reviews,2,0,2
769690,True,5,Mixed,13,7,20
769710,True,0,3 user reviews,2,1,3
769720,True,0,3 user reviews,1,2,3
769730,True,5,Mixed,8,6,14
769740,True,0,2 user reviews,1,1,2
769750,True,0,4 user reviews,3,1,4
769760,True,0,No user reviews,0,0,0
769770,True,0,No user reviews,0,0,0
769780,True,0,2 user reviews,1,1,2
769790,True,0,No user reviews,0,0,0
769800,True,0,No user reviews,0,0,0
769810,True,0,No user reviews,0,0,0
769820,True,0,No user reviews,0,0,0
769830,True,0,No user reviews,0,0,0
769840,True,7,Positive,19,2,21
769850,True,0,No user reviews,0,0,0
769860,True,0,No user reviews,0,0,0
769910,True,0,8 user reviews,8,0,8
769920,True,7,Positive,14,0,14
769930,True,0,1 user reviews,1,0,1
769940,True,0,5 user reviews,5,0,5
769950,True,5,Mixed,131,85,216
769970,True,6,Mostly Positive,119,35,154
769980,True,6,Mostly Positive,9,3,12
769990,True,0,No user reviews,0,0,0
770000,True,0,No user reviews,0,0,0
770010,True,0,1 user reviews,1,0,1
770020,True,0,6 user reviews,5,1,6
770030,True,0,No user reviews,0,0,0
770050,True,0,6 user reviews,4,2,6
770060,True,0,No user reviews,0,0,0
770061,True,0,No user reviews,0,0,0
770070,True,5,Mixed,40,31,71
770080,True,0,No user reviews,0,0,0
770090,True,0,No user reviews,0,0,0
770100,True,8,Very Positive,221,52,273
770110,True,6,Mostly Positive,57,16,73
770120,True,0,1 user reviews,1,0,1
770130,True,0,No user reviews,0,0,0
770160,True,0,5 user reviews,3,2,5
770190,True,0,1 user reviews,1,0,1
770200,True,5,Mixed,19,9,28
770240,True,5,Mixed,337,354,691
770270,True,0,3 user reviews,0,3,3
770280,True,0,No user reviews,0,0,0
770281,True,0,No user reviews,0,0,0
770282,True,0,No user reviews,0,0,0
770300,True,0,No user reviews,0,0,0
770310,True,0,No user reviews,0,0,0
770320,True,0,4 user reviews,1,3,4
770330,True,0,No user reviews,0,0,0
770350,True,0,No user reviews,0,0,0
770360,True,0,No user reviews,0,0,0
770370,True,0,7 user reviews,4,3,7
770380,True,0,1 user reviews,1,0,1
770390,True,6,Mostly Positive,440,139,579
770400,True,4,Mostly Negative,7,13,20
770410,True,6,Mostly Positive,18,7,25
770420,True,0,No user reviews,0,0,0
770440,True,5,Mixed,10,11,21
770460,True,0,No user reviews,0,0,0
770480,True,0,7 user reviews,7,0,7
770490,True,5,Mixed,11,7,18
770500,True,0,No user reviews,0,0,0
770520,True,0,No user reviews,0,0,0
770560,True,0,2 user reviews,0,2,2
770580,True,0,No user reviews,0,0,0
770581,True,0,No user reviews,0,0,0
770590,True,0,No user reviews,0,0,0
770600,True,7,Positive,15,1,16
770610,True,0,3 user reviews,1,2,3
770620,True,6,Mostly Positive,11,3,14
770630,True,0,6 user reviews,6,0,6
770660,True,0,4 user reviews,4,0,4
770690,True,0,6 user reviews,0,6,6
770720,True,0,No user reviews,0,0,0
770730,True,0,No user reviews,0,0,0
770770,True,0,No user reviews,0,0,0
770780,True,7,Positive,27,1,28
770790,True,0,No user reviews,0,0,0
770810,True,8,Very Positive,55,10,65
770820,True,0,6 user reviews,6,0,6
770830,True,0,No user reviews,0,0,0
770850,True,0,7 user reviews,6,1,7
770860,True,0,9 user reviews,8,1,9
770870,True,0,3 user reviews,3,0,3
770880,True,0,1 user reviews,1,0,1
770890,True,0,No user reviews,0,0,0
770900,True,0,3 user reviews,3,0,3
770920,True,0,2 user reviews,1,1,2
770950,True,0,2 user reviews,2,0,2
770951,True,0,No user reviews,0,0,0
770970,True,0,8 user reviews,8,0,8
770972,True,7,Positive,9,2,11
770973,True,6,Mostly Positive,70,19,89
770974,True,8,Very Positive,74,0,74
770975,True,7,Positive,11,1,12
770976,True,7,Positive,31,1,32
770977,True,0,No user reviews,0,0,0
770990,True,0,No user reviews,0,0,0
771010,True,7,Positive,34,4,38
771020,True,0,No user reviews,0,0,0
771040,True,0,No user reviews,0,0,0
771060,True,0,No user reviews,0,0,0
771070,True,7,Positive,20,0,20
771100,True,0,6 user reviews,4,2,6
771110,True,0,No user reviews,0,0,0
771120,True,0,No user reviews,0,0,0
771130,True,0,8 user reviews,2,6,8
771170,True,0,No user reviews,0,0,0
771180,True,0,No user reviews,0,0,0
771190,True,0,No user reviews,0,0,0
771200,True,0,No user reviews,0,0,0
771210,True,0,No user reviews,0,0,0
771240,True,7,Positive,26,3,29
771250,True,0,No user reviews,0,0,0
771270,True,0,No user reviews,0,0,0
771290,True,0,No user reviews,0,0,0
771300,True,5,Mixed,421,274,695
771310,True,0,No user reviews,0,0,0
771320,True,5,Mixed,6,6,12
771340,True,0,4 user reviews,3,1,4
771350,True,8,Very Positive,101,25,126
771370,True,0,3 user reviews,0,3,3
771380,True,0,3 user reviews,3,0,3
771390,True,0,No user reviews,0,0,0
771400,True,0,5 user reviews,0,5,5
771410,True,7,Positive,38,4,42
771420,True,8,Very Positive,51,2,53
771430,True,0,7 user reviews,5,2,7
771450,True,0,No user reviews,0,0,0
771470,True,0,9 user reviews,3,6,9
771480,True,0,No user reviews,0,0,0
771490,True,0,1 user reviews,1,0,1
771500,True,0,6 user reviews,1,5,6
771530,True,7,Positive,20,4,24
771540,True,0,No user reviews,0,0,0
771560,True,0,No user reviews,0,0,0
771570,True,0,6 user reviews,2,4,6
771600,True,0,No user reviews,0,0,0
771601,True,0,No user reviews,0,0,0
771602,True,0,No user reviews,0,0,0
771610,True,0,8 user reviews,7,1,8
771640,True,0,1 user reviews,1,0,1
771670,True,0,4 user reviews,2,2,4
771680,True,7,Positive,17,4,21
771690,True,0,7 user reviews,2,5,7
771700,True,0,No user reviews,0,0,0
771710,True,6,Mostly Positive,26,9,35
771720,True,5,Mixed,33,21,54
771730,True,0,No user reviews,0,0,0
771740,True,0,No user reviews,0,0,0
771750,True,0,4 user reviews,1,3,4
771760,True,0,No user reviews,0,0,0
771770,True,0,No user reviews,0,0,0
771780,True,0,3 user reviews,2,1,3
771790,True,0,No user reviews,0,0,0
771800,True,0,No user reviews,0,0,0
771810,True,6,Mostly Positive,56,16,72
771820,True,0,2 user reviews,0,2,2
771830,True,0,4 user reviews,4,0,4
771840,True,6,Mostly Positive,22,6,28
771860,True,0,No user reviews,0,0,0
771880,True,0,No user reviews,0,0,0
771890,True,0,8 user reviews,5,3,8
771900,True,0,No user reviews,0,0,0
771920,True,5,Mixed,68,42,110
771950,True,6,Mostly Positive,12,4,16
771960,True,0,No user reviews,0,0,0
771970,True,0,No user reviews,0,0,0
772010,True,0,No user reviews,0,0,0
772030,True,0,No user reviews,0,0,0
772040,True,0,No user reviews,0,0,0
772060,True,0,5 user reviews,3,2,5
772070,True,0,No user reviews,0,0,0
772080,True,0,4 user reviews,2,2,4
772090,True,7,Positive,10,0,10
772100,True,0,1 user reviews,0,1,1
772110,True,0,No user reviews,0,0,0
772140,True,0,No user reviews,0,0,0
772150,True,6,Mostly Positive,106,29,135
772160,True,0,No user reviews,0,0,0
772180,True,8,Very Positive,79,8,87
772200,True,6,Mostly Positive,11,4,15
772210,True,0,No user reviews,0,0,0
772220,True,0,5 user reviews,3,2,5
772230,True,0,No user reviews,0,0,0
772240,True,0,3 user reviews,2,1,3
772250,True,0,No user reviews,0,0,0
772260,True,0,No user reviews,0,0,0
772270,True,8,Very Positive,57,6,63
772280,True,0,No user reviews,0,0,0
772290,True,8,Very Positive,80,10,90
772300,True,0,2 user reviews,0,2,2
772310,True,0,No user reviews,0,0,0
772320,True,0,5 user reviews,3,2,5
772330,True,0,No user reviews,0,0,0
772340,True,0,5 user reviews,5,0,5
772350,True,0,No user reviews,0,0,0
772360,True,0,5 user reviews,3,2,5
772370,True,0,No user reviews,0,0,0
772400,True,0,No user reviews,0,0,0
772410,True,0,No user reviews,0,0,0
772420,True,0,1 user reviews,0,1,1
772430,True,8,Very Positive,256,63,319
772440,True,0,1 user reviews,0,1,1
772450,True,0,No user reviews,0,0,0
772460,True,0,No user reviews,0,0,0
772470,True,7,Positive,12,2,14
772480,True,6,Mostly Positive,31,8,39
772500,True,5,Mixed,16,16,32
772520,True,0,No user reviews,0,0,0
772530,True,7,Positive,12,1,13
772540,True,6,Mostly Positive,163,69,232
772570,True,7,Positive,12,0,12
772590,True,0,No user reviews,0,0,0
772600,True,0,3 user reviews,1,2,3
772610,True,7,Positive,46,1,47
772630,True,0,No user reviews,0,0,0
772650,True,0,No user reviews,0,0,0
772660,True,0,No user reviews,0,0,0
772670,True,0,5 user reviews,2,3,5
772680,True,0,No user reviews,0,0,0
772700,True,0,No user reviews,0,0,0
772730,True,7,Positive,9,2,11
772750,True,0,8 user reviews,8,0,8
772770,True,0,No user reviews,0,0,0
772771,True,0,No user reviews,0,0,0
772772,True,0,No user reviews,0,0,0
772773,True,0,No user reviews,0,0,0
772774,True,0,No user reviews,0,0,0
772775,True,0,No user reviews,0,0,0
772776,True,0,No user reviews,0,0,0
772777,True,0,No user reviews,0,0,0
772780,True,0,No user reviews,0,0,0
772781,True,0,No user reviews,0,0,0
772782,True,0,No user reviews,0,0,0
772810,True,0,No user reviews,0,0,0
772811,True,0,No user reviews,0,0,0
772812,True,0,No user reviews,0,0,0
772813,True,0,No user reviews,0,0,0
772814,True,0,No user reviews,0,0,0
772830,True,0,No user reviews,0,0,0
772840,True,0,No user reviews,0,0,0
772860,True,0,No user reviews,0,0,0
772870,True,0,No user reviews,0,0,0
772880,True,0,No user reviews,0,0,0
772890,True,0,No user reviews,0,0,0
772900,True,0,No user reviews,0,0,0
772910,True,0,No user reviews,0,0,0
772930,True,0,No user reviews,0,0,0
772940,True,0,No user reviews,0,0,0
772970,True,0,No user reviews,0,0,0
772980,True,0,No user reviews,0,0,0
772990,True,5,Mixed,8,9,17
773000,True,0,No user reviews,0,0,0
773010,True,0,4 user reviews,1,3,4
773040,True,0,No user reviews,0,0,0
773090,True,6,Mostly Positive,42,16,58
773100,True,0,No user reviews,0,0,0
773110,True,0,5 user reviews,3,2,5
773120,True,0,3 user reviews,0,3,3
773130,True,0,2 user reviews,2,0,2
773150,True,0,No user reviews,0,0,0
773160,True,0,No user reviews,0,0,0
773170,True,0,4 user reviews,3,1,4
773190,True,0,No user reviews,0,0,0
773210,True,0,7 user reviews,7,0,7
773230,True,0,3 user reviews,2,1,3
773240,True,4,Mostly Negative,3,7,10
773280,True,0,1 user reviews,0,1,1
773300,True,0,No user reviews,0,0,0
773310,True,0,No user reviews,0,0,0
773320,True,0,1 user reviews,0,1,1
773330,True,5,Mixed,7,5,12
773340,True,0,No user reviews,0,0,0
773350,True,0,No user reviews,0,0,0
773360,True,0,1 user reviews,1,0,1
773370,True,0,No user reviews,0,0,0
773380,True,0,No user reviews,0,0,0
773390,True,5,Mixed,35,18,53
773420,True,0,5 user reviews,3,2,5
773430,True,7,Positive,37,3,40
773440,True,0,4 user reviews,1,3,4
773460,True,5,Mixed,14,8,22
773470,True,0,1 user reviews,0,1,1
773471,True,0,8 user reviews,4,4,8
773472,True,0,7 user reviews,6,1,7
773490,True,0,No user reviews,0,0,0
773500,True,6,Mostly Positive,36,11,47
773510,True,0,8 user reviews,5,3,8
773520,True,0,No user reviews,0,0,0
773530,True,0,2 user reviews,2,0,2
773540,True,6,Mostly Positive,18,6,24
773570,True,0,2 user reviews,1,1,2
773580,True,8,Very Positive,204,25,229
773590,True,5,Mixed,23,10,33
773600,True,0,6 user reviews,3,3,6
773610,True,0,1 user reviews,1,0,1
773620,True,0,2 user reviews,2,0,2
773630,True,0,No user reviews,0,0,0
773640,True,0,5 user reviews,1,4,5
773650,True,0,2 user reviews,0,2,2
773660,True,0,No user reviews,0,0,0
773670,True,8,Very Positive,348,11,359
773680,True,0,No user reviews,0,0,0
773690,True,0,No user reviews,0,0,0
773710,True,0,5 user reviews,5,0,5
773740,True,8,Very Positive,54,2,56
773760,True,0,No user reviews,0,0,0
773761,True,0,No user reviews,0,0,0
773762,True,0,No user reviews,0,0,0
773763,True,0,1 user reviews,1,0,1
773765,True,0,1 user reviews,1,0,1
773770,True,5,Mixed,18,13,31
773790,True,8,Very Positive,637,85,722
773800,True,0,No user reviews,0,0,0
773801,True,0,No user reviews,0,0,0
773802,True,0,No user reviews,0,0,0
773803,True,0,No user reviews,0,0,0
773804,True,0,No user reviews,0,0,0
773805,True,0,No user reviews,0,0,0
773806,True,0,No user reviews,0,0,0
773810,True,0,1 user reviews,1,0,1
773830,True,6,Mostly Positive,14,4,18
773840,True,8,Very Positive,55,6,61
773850,True,0,No user reviews,0,0,0
773860,True,0,No user reviews,0,0,0
773870,True,0,No user reviews,0,0,0
773900,True,7,Positive,43,1,44
773910,True,0,1 user reviews,0,1,1
773920,True,0,3 user reviews,1,2,3
773930,True,7,Positive,10,2,12
773951,True,6,Mostly Positive,3209,848,4057
773971,True,0,No user reviews,0,0,0
773991,True,5,Mixed,56,70,126
774011,True,4,Mostly Negative,41,124,165
774041,True,8,Very Positive,43,9,52
774051,True,0,1 user reviews,0,1,1
774061,True,0,No user reviews,0,0,0
774071,True,0,6 user reviews,4,2,6
774081,True,0,5 user reviews,4,1,5
774091,True,8,Very Positive,144,14,158
774111,True,0,No user reviews,0,0,0
774121,True,0,1 user reviews,1,0,1
774131,True,0,1 user reviews,0,1,1
774141,True,7,Positive,9,2,11
774151,True,7,Positive,12,2,14
774161,True,0,7 user reviews,5,2,7
774171,True,9,Overwhelmingly Positive,7473,160,7633
774181,True,0,No user reviews,0,0,0
774191,True,7,Positive,10,2,12
774201,True,8,Very Positive,705,49,754
774211,True,0,No user reviews,0,0,0
774221,True,7,Positive,15,1,16
774231,True,0,7 user reviews,5,2,7
774241,True,5,Mixed,466,419,885
774251,True,0,No user reviews,0,0,0
774261,True,7,Positive,22,3,25
774271,True,0,No user reviews,0,0,0
774272,True,0,No user reviews,0,0,0
774273,True,0,No user reviews,0,0,0
774274,True,0,No user reviews,0,0,0
774275,True,0,No user reviews,0,0,0
774276,True,0,No user reviews,0,0,0
774277,True,0,No user reviews,0,0,0
774278,True,0,No user reviews,0,0,0
774279,True,0,No user reviews,0,0,0
774281,True,5,Mixed,12,7,19
774291,True,0,No user reviews,0,0,0
774301,True,0,No user reviews,0,0,0
774321,True,5,Mixed,30,24,54
774331,True,0,9 user reviews,2,7,9
774341,True,0,No user reviews,0,0,0
774342,True,0,No user reviews,0,0,0
774351,True,6,Mostly Positive,343,138,481
774361,True,8,Very Positive,2704,311,3015
774401,True,6,Mostly Positive,11,3,14
774411,True,0,6 user reviews,4,2,6
774421,True,0,No user reviews,0,0,0
774431,True,0,No user reviews,0,0,0
774441,True,5,Mixed,17,9,26
774451,True,0,No user reviews,0,0,0
774461,True,8,Very Positive,672,68,740
774471,True,0,No user reviews,0,0,0
774501,True,0,1 user reviews,1,0,1
774511,True,5,Mixed,121,72,193
774521,True,0,4 user reviews,2,2,4
774531,True,7,Positive,22,0,22
774541,True,6,Mostly Positive,332,102,434
774551,True,5,Mixed,9,5,14
774561,True,7,Positive,25,5,30
774611,True,0,1 user reviews,1,0,1
774621,True,0,1 user reviews,1,0,1
774631,True,0,No user reviews,0,0,0
774641,True,0,1 user reviews,1,0,1
774651,True,7,Positive,33,2,35
774661,True,0,4 user reviews,2,2,4
774711,True,0,8 user reviews,7,1,8
774721,True,0,No user reviews,0,0,0
774741,True,0,No user reviews,0,0,0
774751,True,0,No user reviews,0,0,0
774752,True,0,No user reviews,0,0,0
774753,True,0,No user reviews,0,0,0
774754,True,0,6 user reviews,5,1,6
774755,True,0,No user reviews,0,0,0
774756,True,0,1 user reviews,1,0,1
774757,True,0,2 user reviews,2,0,2
774758,True,7,Positive,15,0,15
774759,True,5,Mixed,10,9,19
774760,True,0,2 user reviews,1,1,2
774761,True,0,No user reviews,0,0,0
774771,True,0,No user reviews,0,0,0
774781,True,6,Mostly Positive,7,3,10
774801,True,0,No user reviews,0,0,0
774811,True,5,Mixed,285,126,411
774821,True,0,No user reviews,0,0,0
774822,True,0,No user reviews,0,0,0
774823,True,0,No user reviews,0,0,0
774841,True,0,2 user reviews,2,0,2
774861,True,8,Very Positive,2434,298,2732
774871,True,0,4 user reviews,4,0,4
774891,True,0,4 user reviews,3,1,4
774901,True,5,Mixed,9,6,15
774911,True,5,Mixed,22,18,40
774931,True,0,1 user reviews,1,0,1
774941,True,0,No user reviews,0,0,0
774961,True,0,No user reviews,0,0,0
774971,True,0,No user reviews,0,0,0
774981,True,0,No user reviews,0,0,0
774991,True,0,No user reviews,0,0,0
775031,True,0,1 user reviews,1,0,1
775050,True,0,No user reviews,0,0,0
775200,True,0,1 user reviews,1,0,1
775210,True,0,No user reviews,0,0,0
775220,True,0,No user reviews,0,0,0
775240,True,0,No user reviews,0,0,0
775250,True,0,No user reviews,0,0,0
775260,True,0,1 user reviews,1,0,1
775270,True,0,2 user reviews,2,0,2
775300,True,0,No user reviews,0,0,0
775310,True,7,Positive,12,0,12
775360,True,0,No user reviews,0,0,0
775370,True,0,No user reviews,0,0,0
775380,True,0,No user reviews,0,0,0
775390,True,0,No user reviews,0,0,0
775410,True,7,Positive,24,0,24
775460,True,0,7 user reviews,5,2,7
775470,True,0,No user reviews,0,0,0
775480,True,0,No user reviews,0,0,0
775490,True,7,Positive,13,0,13
775510,True,0,No user reviews,0,0,0
775520,True,6,Mostly Positive,8,3,11
775530,True,8,Very Positive,55,10,65
775550,True,0,No user reviews,0,0,0
775570,True,0,1 user reviews,0,1,1
775580,True,8,Very Positive,103,6,109
775590,True,0,No user reviews,0,0,0
775600,True,0,No user reviews,0,0,0
775620,True,0,1 user reviews,0,1,1
775630,True,5,Mixed,34,27,61
775640,True,0,No user reviews,0,0,0
775650,True,0,No user reviews,0,0,0
775651,True,0,No user reviews,0,0,0
775652,True,0,No user reviews,0,0,0
775660,True,0,No user reviews,0,0,0
775670,True,0,No user reviews,0,0,0
775680,True,0,No user reviews,0,0,0
775681,True,0,No user reviews,0,0,0
775682,True,0,No user reviews,0,0,0
775683,True,0,No user reviews,0,0,0
775690,True,0,3 user reviews,3,0,3
775700,True,0,No user reviews,0,0,0
775720,True,0,3 user reviews,2,1,3
775730,True,0,1 user reviews,1,0,1
775760,True,5,Mixed,7,5,12
775790,True,0,3 user reviews,1,2,3
775800,True,0,5 user reviews,3,2,5
775820,True,5,Mixed,5,6,11
775830,True,0,No user reviews,0,0,0
775850,True,0,No user reviews,0,0,0
775860,True,0,9 user reviews,5,4,9
775880,True,0,No user reviews,0,0,0
775881,True,0,1 user reviews,0,1,1
775900,True,6,Mostly Positive,108,43,151
775910,True,6,Mostly Positive,9,3,12
775920,True,0,1 user reviews,0,1,1
775940,True,8,Very Positive,800,109,909
775960,True,7,Positive,18,4,22
775990,True,0,No user reviews,0,0,0
776000,True,5,Mixed,8,8,16
776010,True,0,No user reviews,0,0,0
776020,True,0,5 user reviews,4,1,5
776030,True,0,No user reviews,0,0,0
776040,True,0,8 user reviews,6,2,8
776070,True,0,No user reviews,0,0,0
776090,True,0,No user reviews,0,0,0
776100,True,0,1 user reviews,0,1,1
776110,True,0,No user reviews,0,0,0
776120,True,0,No user reviews,0,0,0
776140,True,0,4 user reviews,2,2,4
776160,True,0,3 user reviews,3,0,3
776170,True,0,No user reviews,0,0,0
776180,True,0,8 user reviews,8,0,8
776190,True,0,5 user reviews,1,4,5
776210,True,0,No user reviews,0,0,0
776280,True,0,No user reviews,0,0,0
776290,True,0,3 user reviews,0,3,3
776300,True,0,No user reviews,0,0,0
776320,True,0,4 user reviews,2,2,4
776340,True,8,Very Positive,89,17,106
776360,True,0,2 user reviews,2,0,2
776370,True,5,Mixed,13,7,20
776380,True,0,No user reviews,0,0,0
776390,True,0,No user reviews,0,0,0
776410,True,0,No user reviews,0,0,0
776420,True,0,No user reviews,0,0,0
776430,True,0,2 user reviews,1,1,2
776440,True,0,No user reviews,0,0,0
776450,True,0,No user reviews,0,0,0
776480,True,0,7 user reviews,6,1,7
776490,True,8,Very Positive,353,53,406
776510,True,0,No user reviews,0,0,0
776520,True,5,Mixed,6,5,11
776530,True,0,7 user reviews,5,2,7
776540,True,5,Mixed,11,9,20
776550,True,5,Mixed,6,6,12
776560,True,0,9 user reviews,8,1,9
776570,True,0,No user reviews,0,0,0
776580,True,5,Mixed,12,17,29
776590,True,0,No user reviews,0,0,0
776600,True,0,5 user reviews,4,1,5
776610,True,0,3 user reviews,1,2,3
776650,True,0,4 user reviews,4,0,4
776670,True,0,3 user reviews,1,2,3
776720,True,0,3 user reviews,3,0,3
776740,True,0,No user reviews,0,0,0
776780,True,0,5 user reviews,5,0,5
776790,True,7,Positive,10,1,11
776800,True,0,No user reviews,0,0,0
776820,True,0,8 user reviews,4,4,8
776830,True,0,7 user reviews,7,0,7
776840,True,0,No user reviews,0,0,0
776850,True,0,2 user reviews,2,0,2
776890,True,4,Mostly Negative,13,21,34
776900,True,0,No user reviews,0,0,0
776920,True,0,8 user reviews,6,2,8
776930,True,0,4 user reviews,1,3,4
776950,True,5,Mixed,7,10,17
776960,True,5,Mixed,52,24,76
776970,True,0,No user reviews,0,0,0
776990,True,0,1 user reviews,1,0,1
777000,True,0,4 user reviews,1,3,4
777020,True,7,Positive,9,1,10
777030,True,0,No user reviews,0,0,0
777040,True,0,6 user reviews,2,4,6
777050,True,5,Mixed,11,6,17
777080,True,0,1 user reviews,1,0,1
777090,True,0,7 user reviews,4,3,7
777110,True,0,3 user reviews,3,0,3
777120,True,0,1 user reviews,1,0,1
777130,True,7,Positive,13,1,14
777140,True,0,No user reviews,0,0,0
777150,True,8,Very Positive,59,10,69
777160,True,7,Positive,21,5,26
777170,True,0,No user reviews,0,0,0
777180,True,0,8 user reviews,4,4,8
777200,True,0,3 user reviews,3,0,3
777210,True,0,No user reviews,0,0,0
777220,True,0,No user reviews,0,0,0
777230,True,0,No user reviews,0,0,0
777240,True,0,1 user reviews,0,1,1
777250,True,0,No user reviews,0,0,0
777270,True,0,1 user reviews,1,0,1
777290,True,0,No user reviews,0,0,0
777300,True,0,No user reviews,0,0,0
777310,True,0,2 user reviews,1,1,2
777320,True,3,Negative,5,36,41
777340,True,0,6 user reviews,4,2,6
777350,True,0,5 user reviews,2,3,5
777360,True,0,No user reviews,0,0,0
777380,True,0,1 user reviews,1,0,1
777400,True,4,Mostly Negative,8,17,25
777410,True,0,9 user reviews,9,0,9
777420,True,0,8 user reviews,5,3,8
777430,True,5,Mixed,14,10,24
777450,True,0,No user reviews,0,0,0
777460,True,0,No user reviews,0,0,0
777490,True,0,No user reviews,0,0,0
777530,True,0,1 user reviews,0,1,1
777540,True,0,1 user reviews,1,0,1
777550,True,0,1 user reviews,1,0,1
777560,True,0,No user reviews,0,0,0
777580,True,0,No user reviews,0,0,0
777590,True,0,2 user reviews,1,1,2
777610,True,0,3 user reviews,3,0,3
777620,True,0,No user reviews,0,0,0
777640,True,0,2 user reviews,0,2,2
777650,True,7,Positive,22,5,27
777660,True,0,1 user reviews,0,1,1
777680,True,0,No user reviews,0,0,0
777700,True,0,4 user reviews,4,0,4
777730,True,0,No user reviews,0,0,0
777760,True,0,3 user reviews,3,0,3
777770,True,5,Mixed,135,60,195
777790,True,8,Very Positive,67,7,74
777820,True,0,7 user reviews,5,2,7
777850,True,0,1 user reviews,0,1,1
777860,True,0,No user reviews,0,0,0
777870,True,0,5 user reviews,5,0,5
777880,True,6,Mostly Positive,41,11,52
777890,True,0,No user reviews,0,0,0
777910,True,0,No user reviews,0,0,0
777920,True,0,No user reviews,0,0,0
777930,True,0,No user reviews,0,0,0
777940,True,0,No user reviews,0,0,0
777950,True,0,No user reviews,0,0,0
777960,True,0,No user reviews,0,0,0
777970,True,0,No user reviews,0,0,0
777971,True,0,No user reviews,0,0,0
777972,True,0,No user reviews,0,0,0
777973,True,0,No user reviews,0,0,0
778000,True,0,1 user reviews,1,0,1
778010,True,0,No user reviews,0,0,0
778020,True,0,1 user reviews,1,0,1
778030,True,0,No user reviews,0,0,0
778040,True,0,No user reviews,0,0,0
778041,True,0,No user reviews,0,0,0
778050,True,0,4 user reviews,2,2,4
778060,True,0,No user reviews,0,0,0
778070,True,0,No user reviews,0,0,0
778080,True,0,7 user reviews,2,5,7
778090,True,0,No user reviews,0,0,0
778110,True,0,8 user reviews,1,7,8
778120,True,0,1 user reviews,0,1,1
778140,True,0,1 user reviews,1,0,1
778150,True,6,Mostly Positive,35,11,46
778160,True,0,5 user reviews,4,1,5
778190,True,0,2 user reviews,1,1,2
778210,True,0,1 user reviews,1,0,1
778230,True,0,2 user reviews,2,0,2
778240,True,0,1 user reviews,0,1,1
778250,True,6,Mostly Positive,17,6,23
778260,True,0,No user reviews,0,0,0
778270,True,0,1 user reviews,0,1,1
778330,True,8,Very Positive,113,3,116
778340,True,0,9 user reviews,6,3,9
778350,True,0,No user reviews,0,0,0
778360,True,0,2 user reviews,1,1,2
778370,True,0,No user reviews,0,0,0
778380,True,0,No user reviews,0,0,0
778390,True,8,Very Positive,104,14,118
778400,True,8,Very Positive,47,4,51
778410,True,5,Mixed,13,9,22
778460,True,0,8 user reviews,6,2,8
778470,True,0,5 user reviews,5,0,5
778480,True,0,No user reviews,0,0,0
778490,True,0,No user reviews,0,0,0
778500,True,0,No user reviews,0,0,0
778530,True,7,Positive,20,1,21
778540,True,0,No user reviews,0,0,0
778550,True,0,5 user reviews,0,5,5
778560,True,0,No user reviews,0,0,0
778570,True,5,Mixed,7,6,13
778580,True,0,1 user reviews,1,0,1
778590,True,0,5 user reviews,2,3,5
778600,True,0,No user reviews,0,0,0
778610,True,8,Very Positive,182,11,193
778630,True,0,No user reviews,0,0,0
778640,True,0,6 user reviews,6,0,6
778650,True,0,6 user reviews,6,0,6
778660,True,0,No user reviews,0,0,0
778700,True,0,No user reviews,0,0,0
778710,True,0,1 user reviews,0,1,1
778720,True,0,No user reviews,0,0,0
778740,True,0,No user reviews,0,0,0
778741,True,0,No user reviews,0,0,0
778760,True,0,7 user reviews,3,4,7
778770,True,0,No user reviews,0,0,0
778780,True,0,2 user reviews,2,0,2
778790,True,0,No user reviews,0,0,0
778800,True,7,Positive,24,0,24
778810,True,0,1 user reviews,0,1,1
778830,True,0,1 user reviews,0,1,1
778840,True,7,Positive,25,1,26
778850,True,0,2 user reviews,1,1,2
778860,True,0,9 user reviews,7,2,9
778870,True,0,2 user reviews,1,1,2
778880,True,0,No user reviews,0,0,0
778881,True,0,No user reviews,0,0,0
778890,True,0,No user reviews,0,0,0
778900,True,0,No user reviews,0,0,0
778920,True,0,No user reviews,0,0,0
778930,True,6,Mostly Positive,26,7,33
778960,True,0,No user reviews,0,0,0
778970,True,0,No user reviews,0,0,0
778980,True,0,No user reviews,0,0,0
779000,True,0,No user reviews,0,0,0
779010,True,0,1 user reviews,0,1,1
779050,True,0,No user reviews,0,0,0
779060,True,0,4 user reviews,1,3,4
779070,True,0,1 user reviews,1,0,1
779080,True,0,No user reviews,0,0,0
779090,True,7,Positive,39,5,44
779100,True,6,Mostly Positive,25,10,35
779110,True,0,4 user reviews,3,1,4
779120,True,0,4 user reviews,4,0,4
779130,True,5,Mixed,41,18,59
779140,True,0,5 user reviews,4,1,5
779150,True,0,2 user reviews,0,2,2
779160,True,0,2 user reviews,1,1,2
779170,True,0,No user reviews,0,0,0
779180,True,0,No user reviews,0,0,0
779210,True,0,No user reviews,0,0,0
779220,True,0,No user reviews,0,0,0
779240,True,0,9 user reviews,6,3,9
779250,True,7,Positive,8,2,10
779260,True,0,No user reviews,0,0,0
779280,True,7,Positive,16,0,16
779290,True,6,Mostly Positive,247,104,351
779300,True,0,9 user reviews,5,4,9
779320,True,0,2 user reviews,1,1,2
779330,True,5,Mixed,79,39,118
779340,True,8,Very Positive,9728,1576,11304
779350,True,0,No user reviews,0,0,0
779360,True,6,Mostly Positive,17,6,23
779370,True,0,No user reviews,0,0,0
779380,True,5,Mixed,7,4,11
779390,True,0,3 user reviews,1,2,3
779400,True,0,4 user reviews,4,0,4
779401,True,0,8 user reviews,7,1,8
779410,True,0,No user reviews,0,0,0
779430,True,8,Very Positive,47,9,56
779450,True,5,Mixed,6,5,11
779500,True,0,No user reviews,0,0,0
779520,True,0,No user reviews,0,0,0
779530,True,0,No user reviews,0,0,0
779550,True,0,1 user reviews,1,0,1
779560,True,0,No user reviews,0,0,0
779570,True,5,Mixed,8,8,16
779580,True,0,4 user reviews,4,0,4
779590,True,8,Very Positive,181,27,208
779610,True,4,Mostly Negative,8,22,30
779620,True,0,2 user reviews,2,0,2
779630,True,0,No user reviews,0,0,0
779640,True,6,Mostly Positive,8,3,11
779650,True,0,No user reviews,0,0,0
779660,True,0,No user reviews,0,0,0
779700,True,0,3 user reviews,2,1,3
779720,True,0,No user reviews,0,0,0
779730,True,0,5 user reviews,5,0,5
779750,True,0,No user reviews,0,0,0
779760,True,0,1 user reviews,1,0,1
779780,True,0,No user reviews,0,0,0
779790,True,0,2 user reviews,0,2,2
779800,True,0,3 user reviews,1,2,3
779810,True,0,4 user reviews,2,2,4
779840,True,0,1 user reviews,0,1,1
779870,True,0,No user reviews,0,0,0
779880,True,6,Mostly Positive,157,57,214
779890,True,0,No user reviews,0,0,0
779892,True,0,6 user reviews,4,2,6
779893,True,0,No user reviews,0,0,0
779894,True,7,Positive,23,1,24
779895,True,0,No user reviews,0,0,0
779896,True,0,3 user reviews,2,1,3
779897,True,0,No user reviews,0,0,0
779898,True,0,6 user reviews,5,1,6
779899,True,0,No user reviews,0,0,0
779900,True,0,No user reviews,0,0,0
779920,True,0,2 user reviews,2,0,2
779930,True,4,Mostly Negative,10,26,36
779931,True,0,4 user reviews,3,1,4
779932,True,8,Very Positive,67,4,71
779933,True,8,Very Positive,71,5,76
779934,True,7,Positive,40,0,40
779935,True,7,Positive,46,3,49
779936,True,7,Positive,37,5,42
779937,True,7,Positive,30,5,35
779938,True,7,Positive,23,5,28
779939,True,7,Positive,31,3,34
779950,True,0,3 user reviews,2,1,3
779960,True,5,Mixed,13,7,20
779990,True,0,No user reviews,0,0,0
780000,True,0,3 user reviews,3,0,3
780020,True,6,Mostly Positive,37,12,49
780080,True,0,7 user reviews,5,2,7
780100,True,6,Mostly Positive,29,12,41
780110,True,0,No user reviews,0,0,0
780120,True,0,No user reviews,0,0,0
780140,True,0,7 user reviews,3,4,7
780150,True,0,No user reviews,0,0,0
780160,True,0,7 user reviews,2,5,7
780170,True,0,No user reviews,0,0,0
780180,True,0,No user reviews,0,0,0
780210,True,6,Mostly Positive,147,37,184
780230,True,0,1 user reviews,1,0,1
780240,True,0,No user reviews,0,0,0
780250,True,0,No user reviews,0,0,0
780260,True,0,1 user reviews,1,0,1
780270,True,0,6 user reviews,6,0,6
780280,True,8,Very Positive,78,7,85
780290,True,8,Very Positive,1536,279,1815
780310,True,0,No user reviews,0,0,0
780320,True,0,7 user reviews,4,3,7
780340,True,7,Positive,35,3,38
780350,True,6,Mostly Positive,66,26,92
780370,True,0,No user reviews,0,0,0
780390,True,8,Very Positive,56,6,62
780400,True,0,No user reviews,0,0,0
780430,True,0,No user reviews,0,0,0
780460,True,0,No user reviews,0,0,0
780470,True,0,No user reviews,0,0,0
780490,True,0,No user reviews,0,0,0
780500,True,8,Very Positive,84,10,94
780520,True,0,3 user reviews,3,0,3
780550,True,0,5 user reviews,5,0,5
780560,True,7,Positive,13,2,15
780561,True,0,6 user reviews,5,1,6
780570,True,0,2 user reviews,2,0,2
780580,True,5,Mixed,12,14,26
780590,True,0,3 user reviews,1,2,3
780630,True,0,1 user reviews,1,0,1
780650,True,0,No user reviews,0,0,0
780670,True,7,Positive,24,2,26
780690,True,3,Negative,0,11,11
780710,True,0,2 user reviews,1,1,2
780730,True,0,No user reviews,0,0,0
780740,True,0,1 user reviews,1,0,1
780750,True,5,Mixed,24,15,39
780760,True,0,5 user reviews,4,1,5
780770,True,0,No user reviews,0,0,0
780800,True,0,4 user reviews,3,1,4
780820,True,0,No user reviews,0,0,0
780830,True,0,No user reviews,0,0,0
780840,True,7,Positive,14,2,16
780850,True,0,4 user reviews,4,0,4
780930,True,0,No user reviews,0,0,0
780960,True,0,No user reviews,0,0,0
780970,True,0,No user reviews,0,0,0
780980,True,0,No user reviews,0,0,0
780990,True,7,Positive,16,0,16
781000,True,0,1 user reviews,1,0,1
781010,True,7,Positive,13,0,13
781030,True,0,No user reviews,0,0,0
781040,True,0,No user reviews,0,0,0
781050,True,5,Mixed,14,15,29
781060,True,0,No user reviews,0,0,0
781100,True,0,9 user reviews,3,6,9
781110,True,7,Positive,16,0,16
781120,True,0,2 user reviews,2,0,2
781130,True,6,Mostly Positive,20,6,26
781190,True,0,No user reviews,0,0,0
781200,True,0,No user reviews,0,0,0
781220,True,0,9 user reviews,7,2,9
781230,True,0,1 user reviews,1,0,1
781240,True,0,No user reviews,0,0,0
781250,True,0,2 user reviews,2,0,2
781260,True,0,3 user reviews,2,1,3
781270,True,0,1 user reviews,1,0,1
781280,True,0,5 user reviews,4,1,5
781290,True,0,3 user reviews,1,2,3
781320,True,0,9 user reviews,7,2,9
781340,True,0,No user reviews,0,0,0
781350,True,0,No user reviews,0,0,0
781351,True,0,No user reviews,0,0,0
781352,True,0,No user reviews,0,0,0
781353,True,0,No user reviews,0,0,0
781354,True,0,No user reviews,0,0,0
781355,True,0,No user reviews,0,0,0
781356,True,0,No user reviews,0,0,0
781357,True,0,No user reviews,0,0,0
781358,True,0,No user reviews,0,0,0
781359,True,0,No user reviews,0,0,0
781360,True,0,No user reviews,0,0,0
781361,True,0,No user reviews,0,0,0
781362,True,0,No user reviews,0,0,0
781370,True,0,No user reviews,0,0,0
781390,True,0,No user reviews,0,0,0
781400,True,0,No user reviews,0,0,0
781410,True,0,No user reviews,0,0,0
781440,True,0,No user reviews,0,0,0
781470,True,0,No user reviews,0,0,0
781480,True,6,Mostly Positive,119,41,160
781490,True,0,No user reviews,0,0,0
781500,True,0,No user reviews,0,0,0
781510,True,0,1 user reviews,1,0,1
781520,True,0,6 user reviews,3,3,6
781530,True,0,No user reviews,0,0,0
781531,True,0,1 user reviews,1,0,1
781532,True,0,1 user reviews,0,1,1
781540,True,0,No user reviews,0,0,0
781541,True,0,No user reviews,0,0,0
781590,True,0,No user reviews,0,0,0
781610,True,0,2 user reviews,1,1,2
781630,True,0,No user reviews,0,0,0
781640,True,7,Positive,9,2,11
781650,True,0,1 user reviews,1,0,1
781660,True,5,Mixed,9,5,14
781670,True,0,3 user reviews,2,1,3
781680,True,0,3 user reviews,2,1,3
781730,True,0,No user reviews,0,0,0
781760,True,0,8 user reviews,4,4,8
781780,True,0,No user reviews,0,0,0
781790,True,0,No user reviews,0,0,0
781800,True,0,2 user reviews,1,1,2
781810,True,8,Very Positive,47,8,55
781820,True,7,Positive,21,4,25
781830,True,0,No user reviews,0,0,0
781840,True,0,1 user reviews,1,0,1
781850,True,0,2 user reviews,2,0,2
781860,True,0,2 user reviews,2,0,2
781870,True,0,No user reviews,0,0,0
781880,True,0,4 user reviews,2,2,4
781890,True,0,7 user reviews,7,0,7
781920,True,0,8 user reviews,8,0,8
781930,True,0,3 user reviews,2,1,3
781950,True,0,1 user reviews,1,0,1
781970,True,0,No user reviews,0,0,0
781990,True,0,No user reviews,0,0,0
782020,True,0,3 user reviews,1,2,3
782050,True,0,7 user reviews,5,2,7
782060,True,0,No user reviews,0,0,0
782070,True,5,Mixed,14,15,29
782090,True,0,4 user reviews,3,1,4
782100,True,0,8 user reviews,5,3,8
782110,True,5,Mixed,7,6,13
782120,True,7,Positive,11,0,11
782130,True,0,No user reviews,0,0,0
782140,True,5,Mixed,63,39,102
782160,True,0,3 user reviews,1,2,3
782180,True,0,1 user reviews,1,0,1
782190,True,0,3 user reviews,2,1,3
782210,True,0,4 user reviews,4,0,4
782230,True,7,Positive,41,8,49
782250,True,0,No user reviews,0,0,0
782270,True,7,Positive,11,1,12
782280,True,0,3 user reviews,3,0,3
782290,True,0,No user reviews,0,0,0
782300,True,7,Positive,9,2,11
782310,True,0,4 user reviews,4,0,4
782330,True,8,Very Positive,44566,6756,51322
782340,True,0,No user reviews,0,0,0
782380,True,6,Mostly Positive,7,3,10
782410,True,0,3 user reviews,0,3,3
782420,True,0,No user reviews,0,0,0
782430,True,0,No user reviews,0,0,0
782450,True,0,1 user reviews,0,1,1
782460,True,0,No user reviews,0,0,0
782470,True,0,No user reviews,0,0,0
782510,True,0,9 user reviews,3,6,9
782550,True,0,No user reviews,0,0,0
782560,True,0,No user reviews,0,0,0
782570,True,0,7 user reviews,3,4,7
782580,True,0,No user reviews,0,0,0
782600,True,0,No user reviews,0,0,0
782610,True,0,2 user reviews,2,0,2
782620,True,0,No user reviews,0,0,0
782630,True,0,No user reviews,0,0,0
782640,True,0,No user reviews,0,0,0
782650,True,0,1 user reviews,1,0,1
782660,True,0,No user reviews,0,0,0
782670,True,0,No user reviews,0,0,0
782680,True,0,No user reviews,0,0,0
782690,True,5,Mixed,26,16,42
782700,True,0,5 user reviews,2,3,5
782770,True,0,No user reviews,0,0,0
782940,True,0,No user reviews,0,0,0
783030,True,0,No user reviews,0,0,0
783040,True,0,No user reviews,0,0,0
783050,True,7,Positive,29,0,29
783060,True,0,2 user reviews,0,2,2
783070,True,0,1 user reviews,1,0,1
783090,True,0,No user reviews,0,0,0
783120,True,0,5 user reviews,5,0,5
783130,True,0,No user reviews,0,0,0
783150,True,7,Positive,20,2,22
783170,True,5,Mixed,149,101,250
783180,True,0,8 user reviews,7,1,8
783190,True,5,Mixed,52,40,92
783200,True,6,Mostly Positive,18,6,24
783210,True,6,Mostly Positive,91,28,119
783220,True,0,6 user reviews,1,5,6
783230,True,0,No user reviews,0,0,0
783240,True,0,No user reviews,0,0,0
783250,True,0,No user reviews,0,0,0
783260,True,0,6 user reviews,4,2,6
783270,True,0,1 user reviews,0,1,1
783280,True,0,1 user reviews,1,0,1
783310,True,4,Mostly Negative,4,11,15
783320,True,0,No user reviews,0,0,0
783330,True,0,4 user reviews,3,1,4
783340,True,6,Mostly Positive,10,3,13
783370,True,0,No user reviews,0,0,0
783380,True,0,1 user reviews,0,1,1
783390,True,0,2 user reviews,2,0,2
783391,True,0,No user reviews,0,0,0
783392,True,0,No user reviews,0,0,0
783400,True,0,No user reviews,0,0,0
783410,True,0,No user reviews,0,0,0
783420,True,0,5 user reviews,2,3,5
783430,True,0,4 user reviews,4,0,4
783440,True,6,Mostly Positive,12,5,17
783450,True,4,Mostly Negative,8,15,23
783490,True,0,No user reviews,0,0,0
783500,True,0,No user reviews,0,0,0
783501,True,0,No user reviews,0,0,0
783502,True,0,No user reviews,0,0,0
783503,True,0,No user reviews,0,0,0
783504,True,0,No user reviews,0,0,0
783505,True,0,No user reviews,0,0,0
783506,True,0,No user reviews,0,0,0
783507,True,0,1 user reviews,0,1,1
783508,True,0,No user reviews,0,0,0
783530,True,0,No user reviews,0,0,0
783540,True,0,No user reviews,0,0,0
783541,True,0,No user reviews,0,0,0
783542,True,0,2 user reviews,0,2,2
783543,True,0,No user reviews,0,0,0
783544,True,0,2 user reviews,1,1,2
783545,True,0,5 user reviews,4,1,5
783546,True,0,3 user reviews,3,0,3
783560,True,0,No user reviews,0,0,0
783570,True,0,No user reviews,0,0,0
783580,True,0,No user reviews,0,0,0
783590,True,5,Mixed,95,43,138
783610,True,0,No user reviews,0,0,0
783620,True,0,No user reviews,0,0,0
783630,True,0,No user reviews,0,0,0
783631,True,0,No user reviews,0,0,0
783632,True,0,No user reviews,0,0,0
783640,True,0,2 user reviews,1,1,2
783650,True,0,No user reviews,0,0,0
783660,True,0,No user reviews,0,0,0
783670,True,0,No user reviews,0,0,0
783680,True,0,No user reviews,0,0,0
783690,True,0,No user reviews,0,0,0
783710,True,5,Mixed,13,16,29
783720,True,0,No user reviews,0,0,0
783750,True,0,No user reviews,0,0,0
783770,True,0,No user reviews,0,0,0
783780,True,0,No user reviews,0,0,0
783790,True,0,5 user reviews,5,0,5
783800,True,0,No user reviews,0,0,0
783810,True,0,4 user reviews,3,1,4
783840,True,8,Very Positive,170,34,204
783850,True,0,2 user reviews,0,2,2
783860,True,5,Mixed,9,5,14
783870,True,0,1 user reviews,1,0,1
783880,True,0,No user reviews,0,0,0
783890,True,0,2 user reviews,0,2,2
783910,True,0,9 user reviews,5,4,9
783940,True,7,Positive,29,2,31
783960,True,0,No user reviews,0,0,0
783990,True,7,Positive,43,5,48
784010,True,0,6 user reviews,6,0,6
784040,True,0,1 user reviews,1,0,1
784050,True,6,Mostly Positive,27,7,34
784060,True,0,No user reviews,0,0,0
784070,True,6,Mostly Positive,11,4,15
784100,True,0,5 user reviews,5,0,5
784110,True,0,No user reviews,0,0,0
784120,True,0,No user reviews,0,0,0
784130,True,0,7 user reviews,7,0,7
784150,True,8,Very Positive,1780,229,2009
784160,True,0,8 user reviews,4,4,8
784180,True,0,1 user reviews,1,0,1
784330,True,0,No user reviews,0,0,0
784710,True,0,No user reviews,0,0,0
784730,True,0,No user reviews,0,0,0
784750,True,0,No user reviews,0,0,0
784760,True,0,No user reviews,0,0,0
784770,True,0,No user reviews,0,0,0
784780,True,0,No user reviews,0,0,0
784790,True,0,No user reviews,0,0,0
784800,True,0,No user reviews,0,0,0
784810,True,0,No user reviews,0,0,0
784820,True,0,No user reviews,0,0,0
784840,True,0,No user reviews,0,0,0
784841,True,0,No user reviews,0,0,0
784842,True,0,No user reviews,0,0,0
784843,True,0,No user reviews,0,0,0
784844,True,0,No user reviews,0,0,0
784845,True,0,No user reviews,0,0,0
784846,True,0,No user reviews,0,0,0
784847,True,0,No user reviews,0,0,0
784850,True,0,No user reviews,0,0,0
784851,True,0,No user reviews,0,0,0
784852,True,0,No user reviews,0,0,0
784853,True,0,No user reviews,0,0,0
784854,True,0,No user reviews,0,0,0
784856,True,0,No user reviews,0,0,0
784857,True,0,No user reviews,0,0,0
784858,True,0,No user reviews,0,0,0
784860,True,0,No user reviews,0,0,0
784870,True,0,No user reviews,0,0,0
784880,True,0,No user reviews,0,0,0
784890,True,0,No user reviews,0,0,0
784900,True,0,No user reviews,0,0,0
784930,True,0,6 user reviews,6,0,6
784940,True,5,Mixed,19,9,28
784950,True,0,1 user reviews,1,0,1
784980,True,0,No user reviews,0,0,0
784990,True,0,No user reviews,0,0,0
785010,True,0,No user reviews,0,0,0
785030,True,0,No user reviews,0,0,0
785050,True,0,No user reviews,0,0,0
785060,True,0,No user reviews,0,0,0
785070,True,0,No user reviews,0,0,0
785080,True,0,2 user reviews,2,0,2
785100,True,7,Positive,10,1,11
785110,True,7,Positive,36,8,44
785130,True,0,No user reviews,0,0,0
785150,True,0,1 user reviews,1,0,1
785200,True,0,No user reviews,0,0,0
785260,True,5,Mixed,518,252,770
785300,True,6,Mostly Positive,86,25,111
785320,True,0,No user reviews,0,0,0
785330,True,0,No user reviews,0,0,0
785340,True,0,No user reviews,0,0,0
785350,True,0,No user reviews,0,0,0
785360,True,0,No user reviews,0,0,0
785370,True,0,No user reviews,0,0,0
785380,True,0,No user reviews,0,0,0
785390,True,0,No user reviews,0,0,0
785400,True,0,No user reviews,0,0,0
785410,True,0,No user reviews,0,0,0
785420,True,0,No user reviews,0,0,0
785430,True,0,2 user reviews,0,2,2
785440,True,0,1 user reviews,1,0,1
785460,True,0,No user reviews,0,0,0
785480,True,8,Very Positive,110,18,128
785500,True,0,No user reviews,0,0,0
785510,True,0,No user reviews,0,0,0
785511,True,0,No user reviews,0,0,0
785512,True,0,No user reviews,0,0,0
785513,True,0,No user reviews,0,0,0
785514,True,0,No user reviews,0,0,0
785540,True,0,No user reviews,0,0,0
785560,True,0,2 user reviews,2,0,2
785590,True,0,6 user reviews,5,1,6
785620,True,0,No user reviews,0,0,0
785630,True,0,No user reviews,0,0,0
785640,True,5,Mixed,15,10,25
785660,True,5,Mixed,28,23,51
785670,True,5,Mixed,5,7,12
785680,True,3,Negative,0,10,10
785690,True,0,1 user reviews,1,0,1
785740,True,5,Mixed,537,318,855
785750,True,0,8 user reviews,8,0,8
785760,True,7,Positive,16,2,18
785770,True,0,No user reviews,0,0,0
785780,True,7,Positive,18,3,21
785790,True,8,Very Positive,131,6,137
785810,True,0,No user reviews,0,0,0
785820,True,0,No user reviews,0,0,0
785830,True,0,No user reviews,0,0,0
785840,True,8,Very Positive,59,3,62
785850,True,5,Mixed,46,33,79
785860,True,5,Mixed,10,14,24
785870,True,0,2 user reviews,2,0,2
785880,True,8,Very Positive,87,20,107
785890,True,8,Very Positive,161,9,170
785900,True,0,1 user reviews,0,1,1
785910,True,5,Mixed,10,10,20
785920,True,0,6 user reviews,1,5,6
785930,True,5,Mixed,5,6,11
785940,True,0,2 user reviews,1,1,2
785950,True,0,No user reviews,0,0,0
785980,True,0,No user reviews,0,0,0
785990,True,0,No user reviews,0,0,0
786010,True,0,2 user reviews,2,0,2
786020,True,0,No user reviews,0,0,0
786040,True,0,1 user reviews,1,0,1
786050,True,0,No user reviews,0,0,0
786060,True,0,No user reviews,0,0,0
786070,True,0,1 user reviews,1,0,1
786080,True,0,No user reviews,0,0,0
786090,True,0,2 user reviews,2,0,2
786100,True,0,2 user reviews,2,0,2
786110,True,0,No user reviews,0,0,0
786120,True,0,1 user reviews,1,0,1
786130,True,0,1 user reviews,0,1,1
786140,True,0,No user reviews,0,0,0
786160,True,0,No user reviews,0,0,0
786170,True,0,2 user reviews,2,0,2
786180,True,0,3 user reviews,1,2,3
786280,True,0,2 user reviews,1,1,2
786290,True,5,Mixed,6,4,10
786300,True,0,No user reviews,0,0,0
786320,True,0,No user reviews,0,0,0
786330,True,0,No user reviews,0,0,0
786340,True,0,4 user reviews,3,1,4
786350,True,0,1 user reviews,1,0,1
786370,True,0,No user reviews,0,0,0
786380,True,0,No user reviews,0,0,0
786390,True,7,Positive,9,2,11
786410,True,0,No user reviews,0,0,0
786420,True,0,2 user reviews,1,1,2
786430,True,0,No user reviews,0,0,0
786450,True,6,Mostly Positive,61,18,79
786460,True,0,No user reviews,0,0,0
786470,True,0,No user reviews,0,0,0
786490,True,0,No user reviews,0,0,0
786510,True,6,Mostly Positive,10,4,14
786520,True,8,Very Positive,122,19,141
786530,True,0,No user reviews,0,0,0
786540,True,0,1 user reviews,1,0,1
786550,True,0,No user reviews,0,0,0
786560,True,0,6 user reviews,4,2,6
786570,True,0,No user reviews,0,0,0
786580,True,5,Mixed,126,57,183
786590,True,0,No user reviews,0,0,0
786600,True,0,No user reviews,0,0,0
786620,True,0,1 user reviews,1,0,1
786630,True,7,Positive,26,4,30
786640,True,0,No user reviews,0,0,0
786650,True,0,2 user reviews,2,0,2
786670,True,0,9 user reviews,6,3,9
786680,True,0,No user reviews,0,0,0
786710,True,0,8 user reviews,8,0,8
786720,True,4,Mostly Negative,3,8,11
786730,True,0,No user reviews,0,0,0
786740,True,0,5 user reviews,1,4,5
786750,True,0,6 user reviews,3,3,6
786760,True,0,No user reviews,0,0,0
786770,True,0,3 user reviews,3,0,3
786780,True,0,No user reviews,0,0,0
786800,True,0,3 user reviews,3,0,3
786810,True,0,No user reviews,0,0,0
786820,True,0,9 user reviews,9,0,9
786840,True,0,2 user reviews,1,1,2
786850,True,0,No user reviews,0,0,0
786860,True,0,No user reviews,0,0,0
786870,True,0,No user reviews,0,0,0
786890,True,0,2 user reviews,2,0,2
786910,True,5,Mixed,14,12,26
786920,True,0,No user reviews,0,0,0
786940,True,0,No user reviews,0,0,0
786950,True,0,2 user reviews,2,0,2
786960,True,0,No user reviews,0,0,0
786980,True,0,5 user reviews,1,4,5
786990,True,7,Positive,12,1,13
787000,True,0,No user reviews,0,0,0
787040,True,5,Mixed,12,13,25
787050,True,0,2 user reviews,2,0,2
787070,True,8,Very Positive,234,5,239
787100,True,0,No user reviews,0,0,0
787110,True,0,1 user reviews,1,0,1
787120,True,0,3 user reviews,1,2,3
787130,True,0,No user reviews,0,0,0
787140,True,0,2 user reviews,0,2,2
787150,True,0,No user reviews,0,0,0
787160,True,0,No user reviews,0,0,0
787170,True,0,4 user reviews,4,0,4
787180,True,0,No user reviews,0,0,0
787200,True,0,7 user reviews,6,1,7
787220,True,0,No user reviews,0,0,0
787250,True,5,Mixed,6,5,11
787260,True,0,No user reviews,0,0,0
787280,True,0,No user reviews,0,0,0
787290,True,0,No user reviews,0,0,0
787291,True,0,No user reviews,0,0,0
787292,True,0,No user reviews,0,0,0
787300,True,4,Mostly Negative,3,7,10
787320,True,0,No user reviews,0,0,0
787321,True,0,No user reviews,0,0,0
787322,True,0,No user reviews,0,0,0
787323,True,0,No user reviews,0,0,0
787324,True,0,No user reviews,0,0,0
787340,True,5,Mixed,362,179,541
787350,True,0,No user reviews,0,0,0
787370,True,4,Mostly Negative,4,7,11
787380,True,0,No user reviews,0,0,0
787400,True,7,Positive,35,7,42
787410,True,0,1 user reviews,0,1,1
787420,True,0,5 user reviews,1,4,5
787430,True,0,1 user reviews,0,1,1
787440,True,0,7 user reviews,4,3,7
787450,True,0,No user reviews,0,0,0
787460,True,0,4 user reviews,1,3,4
787480,True,9,Overwhelmingly Positive,1968,33,2001
787500,True,0,No user reviews,0,0,0
787530,True,0,4 user reviews,3,1,4
787550,True,0,7 user reviews,3,4,7
787560,True,0,No user reviews,0,0,0
787620,True,0,5 user reviews,5,0,5
787630,True,0,No user reviews,0,0,0
787640,True,0,No user reviews,0,0,0
787650,True,0,4 user reviews,4,0,4
787660,True,0,No user reviews,0,0,0
787680,True,0,1 user reviews,0,1,1
787681,True,0,1 user reviews,0,1,1
787682,True,0,2 user reviews,0,2,2
787690,True,0,5 user reviews,3,2,5
787710,True,7,Positive,15,3,18
787720,True,4,Mostly Negative,3,7,10
787730,True,0,2 user reviews,1,1,2
787740,True,5,Mixed,72,38,110
787750,True,0,No user reviews,0,0,0
787770,True,0,No user reviews,0,0,0
787780,True,5,Mixed,6,4,10
787790,True,0,6 user reviews,4,2,6
787810,True,0,No user reviews,0,0,0
787820,True,0,No user reviews,0,0,0
787830,True,0,No user reviews,0,0,0
787840,True,6,Mostly Positive,18,5,23
787850,True,7,Positive,17,3,20
787860,True,8,Very Positive,9624,1021,10645
787890,True,0,1 user reviews,1,0,1
787910,True,7,Positive,14,0,14
787930,True,7,Positive,35,8,43
787940,True,0,1 user reviews,0,1,1
787950,True,0,No user reviews,0,0,0
787960,True,0,3 user reviews,2,1,3
787970,True,7,Positive,24,5,29
787980,True,0,2 user reviews,1,1,2
787990,True,0,No user reviews,0,0,0
788000,True,0,1 user reviews,1,0,1
788010,True,0,No user reviews,0,0,0
788020,True,0,1 user reviews,0,1,1
788040,True,0,No user reviews,0,0,0
788050,True,7,Positive,16,4,20
788060,True,0,3 user reviews,3,0,3
788100,True,6,Mostly Positive,748,188,936
788120,True,0,2 user reviews,2,0,2
788130,True,5,Mixed,28,13,41
788150,True,0,4 user reviews,4,0,4
788160,True,0,No user reviews,0,0,0
788170,True,0,No user reviews,0,0,0
788180,True,0,1 user reviews,1,0,1
788190,True,0,4 user reviews,1,3,4
788200,True,0,2 user reviews,0,2,2
788210,True,5,Mixed,29,19,48
788230,True,0,No user reviews,0,0,0
788231,True,0,No user reviews,0,0,0
788240,True,0,No user reviews,0,0,0
788250,True,0,3 user reviews,2,1,3
788260,True,5,Mixed,1242,822,2064
788270,True,8,Very Positive,201,50,251
788290,True,0,No user reviews,0,0,0
788310,True,0,No user reviews,0,0,0
788320,True,0,8 user reviews,6,2,8
788330,True,0,4 user reviews,4,0,4
788350,True,0,No user reviews,0,0,0
788380,True,7,Positive,17,4,21
788390,True,7,Positive,11,1,12
788400,True,0,1 user reviews,1,0,1
788410,True,7,Positive,30,5,35
788420,True,7,Positive,22,4,26
788430,True,5,Mixed,9,5,14
788440,True,0,No user reviews,0,0,0
788460,True,0,No user reviews,0,0,0
788470,True,0,No user reviews,0,0,0
788480,True,0,9 user reviews,5,4,9
788490,True,4,Mostly Negative,5,8,13
788500,True,0,2 user reviews,0,2,2
788510,True,0,5 user reviews,2,3,5
788520,True,0,3 user reviews,2,1,3
788540,True,0,No user reviews,0,0,0
788580,True,0,No user reviews,0,0,0
788590,True,0,No user reviews,0,0,0
788610,True,6,Mostly Positive,8,3,11
788620,True,0,No user reviews,0,0,0
788630,True,6,Mostly Positive,71,30,101
788640,True,0,8 user reviews,6,2,8
788670,True,0,4 user reviews,4,0,4
788680,True,0,No user reviews,0,0,0
788690,True,8,Very Positive,164,21,185
788700,True,6,Mostly Positive,67,23,90
788720,True,0,2 user reviews,2,0,2
788730,True,0,1 user reviews,1,0,1
788740,True,5,Mixed,16,15,31
788750,True,0,No user reviews,0,0,0
788760,True,0,6 user reviews,5,1,6
788770,True,0,No user reviews,0,0,0
788800,True,0,No user reviews,0,0,0
788810,True,5,Mixed,6,6,12
788820,True,0,No user reviews,0,0,0
788840,True,0,No user reviews,0,0,0
788860,True,0,No user reviews,0,0,0
788870,True,4,Mostly Negative,5,9,14
788890,True,0,5 user reviews,4,1,5
788900,True,0,3 user reviews,2,1,3
788910,True,5,Mixed,15,13,28
788930,True,7,Positive,45,2,47
788950,True,0,No user reviews,0,0,0
788960,True,0,3 user reviews,1,2,3
788970,True,5,Mixed,18,10,28
788980,True,0,1 user reviews,1,0,1
788981,True,0,No user reviews,0,0,0
788982,True,0,No user reviews,0,0,0
788983,True,0,No user reviews,0,0,0
789010,True,0,3 user reviews,2,1,3
789040,True,0,No user reviews,0,0,0
789041,True,0,No user reviews,0,0,0
789050,True,0,No user reviews,0,0,0
789070,True,0,4 user reviews,4,0,4
789080,True,0,No user reviews,0,0,0
789090,True,7,Positive,38,3,41
789100,True,0,No user reviews,0,0,0
789140,True,0,No user reviews,0,0,0
789150,True,0,No user reviews,0,0,0
789160,True,0,5 user reviews,3,2,5
789170,True,0,4 user reviews,2,2,4
789200,True,0,5 user reviews,5,0,5
789210,True,0,No user reviews,0,0,0
789220,True,0,6 user reviews,1,5,6
789230,True,0,No user reviews,0,0,0
789240,True,0,7 user reviews,5,2,7
789260,True,6,Mostly Positive,33,10,43
789280,True,0,1 user reviews,1,0,1
789290,True,5,Mixed,6,4,10
789380,True,7,Positive,23,2,25
789391,True,0,No user reviews,0,0,0
789393,True,0,9 user reviews,5,4,9
789460,True,0,8 user reviews,6,2,8
789480,True,7,Positive,10,0,10
789490,True,0,2 user reviews,1,1,2
789500,True,0,No user reviews,0,0,0
789510,True,0,1 user reviews,0,1,1
789520,True,0,6 user reviews,2,4,6
789530,True,0,1 user reviews,0,1,1
789540,True,0,No user reviews,0,0,0
789550,True,0,1 user reviews,1,0,1
789570,True,8,Very Positive,50,4,54
789580,True,0,No user reviews,0,0,0
789600,True,0,No user reviews,0,0,0
789610,True,0,No user reviews,0,0,0
789620,True,0,No user reviews,0,0,0
789640,True,0,2 user reviews,1,1,2
789650,True,0,No user reviews,0,0,0
789660,True,0,No user reviews,0,0,0
789670,True,0,3 user reviews,1,2,3
789680,True,0,2 user reviews,1,1,2
789700,True,0,1 user reviews,0,1,1
789710,True,0,No user reviews,0,0,0
789720,True,0,No user reviews,0,0,0
789730,True,7,Positive,35,4,39
789740,True,7,Positive,15,3,18
789750,True,6,Mostly Positive,10,3,13
789760,True,8,Very Positive,231,20,251
789770,True,0,3 user reviews,3,0,3
789780,True,0,No user reviews,0,0,0
789790,True,0,No user reviews,0,0,0
789800,True,0,1 user reviews,1,0,1
789801,True,0,No user reviews,0,0,0
789810,True,0,No user reviews,0,0,0
789811,True,0,No user reviews,0,0,0
789820,True,0,No user reviews,0,0,0
789840,True,0,No user reviews,0,0,0
789870,True,0,No user reviews,0,0,0
789880,True,0,9 user reviews,2,7,9
789890,True,0,4 user reviews,0,4,4
789900,True,0,8 user reviews,5,3,8
789910,True,5,Mixed,19,12,31
789920,True,0,No user reviews,0,0,0
789930,True,0,4 user reviews,3,1,4
789950,True,8,Very Positive,54,11,65
789960,True,4,Mostly Negative,5,10,15
789970,True,0,No user reviews,0,0,0
789980,True,0,1 user reviews,0,1,1
790010,True,0,No user reviews,0,0,0
790020,True,7,Positive,16,3,19
790050,True,0,No user reviews,0,0,0
790060,True,8,Very Positive,127,0,127
790070,True,0,No user reviews,0,0,0
790080,True,7,Positive,12,2,14
790090,True,0,8 user reviews,6,2,8
790100,True,0,No user reviews,0,0,0
790120,True,7,Positive,14,2,16
790130,True,7,Positive,8,2,10
790150,True,0,No user reviews,0,0,0
790160,True,0,1 user reviews,0,1,1
790170,True,0,4 user reviews,4,0,4
790180,True,0,4 user reviews,3,1,4
790210,True,0,4 user reviews,2,2,4
790230,True,0,9 user reviews,1,8,9
790250,True,0,1 user reviews,1,0,1
790260,True,0,4 user reviews,4,0,4
790280,True,0,No user reviews,0,0,0
790290,True,7,Positive,10,2,12
790300,True,0,6 user reviews,2,4,6
790350,True,7,Positive,16,3,19
790360,True,7,Positive,28,0,28
790390,True,0,1 user reviews,1,0,1
790410,True,0,No user reviews,0,0,0
790450,True,0,No user reviews,0,0,0
790460,True,0,1 user reviews,1,0,1
790480,True,0,No user reviews,0,0,0
790490,True,0,No user reviews,0,0,0
790500,True,0,No user reviews,0,0,0
790510,True,0,No user reviews,0,0,0
790520,True,0,2 user reviews,2,0,2
790530,True,0,No user reviews,0,0,0
790540,True,4,Mostly Negative,50,109,159
790550,True,0,No user reviews,0,0,0
790560,True,0,No user reviews,0,0,0
790570,True,0,5 user reviews,2,3,5
790600,True,0,No user reviews,0,0,0
790610,True,0,No user reviews,0,0,0
790630,True,0,5 user reviews,4,1,5
790650,True,0,No user reviews,0,0,0
790680,True,0,No user reviews,0,0,0
790700,True,5,Mixed,7,9,16
790710,True,0,2 user reviews,2,0,2
790730,True,0,3 user reviews,0,3,3
790740,True,8,Very Positive,1155,83,1238
790750,True,7,Positive,8,2,10
790760,True,0,4 user reviews,2,2,4
790780,True,0,1 user reviews,1,0,1
790790,True,0,No user reviews,0,0,0
790800,True,0,2 user reviews,0,2,2
790810,True,0,5 user reviews,1,4,5
790820,True,8,Very Positive,1304,153,1457
790830,True,0,5 user reviews,4,1,5
790831,True,7,Positive,15,2,17
790832,True,7,Positive,8,2,10
790840,True,0,1 user reviews,0,1,1
790850,True,8,Very Positive,334,39,373
790860,True,7,Positive,9,1,10
790870,True,0,No user reviews,0,0,0
790890,True,0,No user reviews,0,0,0
790900,True,0,1 user reviews,0,1,1
790923,True,0,1 user reviews,1,0,1
790924,True,0,2 user reviews,2,0,2
790930,True,0,4 user reviews,3,1,4
790950,True,0,4 user reviews,1,3,4
790960,True,0,1 user reviews,1,0,1
790970,True,0,No user reviews,0,0,0
791000,True,0,1 user reviews,1,0,1
791020,True,7,Positive,21,1,22
791040,True,0,No user reviews,0,0,0
791050,True,0,5 user reviews,2,3,5
791070,True,0,No user reviews,0,0,0
791090,True,0,No user reviews,0,0,0
791110,True,0,No user reviews,0,0,0
791120,True,0,No user reviews,0,0,0
791130,True,0,No user reviews,0,0,0
791140,True,0,3 user reviews,3,0,3
791150,True,0,No user reviews,0,0,0
791160,True,0,1 user reviews,1,0,1
791180,True,8,Very Positive,114,17,131
791190,True,0,No user reviews,0,0,0
791220,True,0,No user reviews,0,0,0
791230,True,0,No user reviews,0,0,0
791240,True,7,Positive,24,0,24
791250,True,0,No user reviews,0,0,0
791260,True,0,3 user reviews,1,2,3
791290,True,0,2 user reviews,2,0,2
791300,True,0,No user reviews,0,0,0
791310,True,0,No user reviews,0,0,0
791320,True,0,7 user reviews,3,4,7
791330,True,8,Very Positive,150,17,167
791370,True,0,1 user reviews,1,0,1
791380,True,0,1 user reviews,0,1,1
791390,True,0,No user reviews,0,0,0
791400,True,6,Mostly Positive,15,4,19
791420,True,0,1 user reviews,1,0,1
791430,True,0,8 user reviews,4,4,8
791460,True,0,No user reviews,0,0,0
791470,True,7,Positive,15,0,15
791490,True,0,1 user reviews,1,0,1
791500,True,7,Positive,15,3,18
791510,True,0,No user reviews,0,0,0
791520,True,0,No user reviews,0,0,0
791560,True,0,No user reviews,0,0,0
791570,True,5,Mixed,7,9,16
791580,True,0,1 user reviews,0,1,1
791590,True,5,Mixed,5,7,12
791600,True,0,4 user reviews,3,1,4
791620,True,0,No user reviews,0,0,0
791630,True,0,No user reviews,0,0,0
791650,True,0,No user reviews,0,0,0
791660,True,0,No user reviews,0,0,0
791670,True,0,No user reviews,0,0,0
791700,True,7,Positive,29,4,33
791720,True,0,No user reviews,0,0,0
791740,True,0,1 user reviews,1,0,1
791750,True,8,Very Positive,49,9,58
791760,True,0,7 user reviews,4,3,7
791770,True,8,Very Positive,56,5,61
791790,True,0,No user reviews,0,0,0
791800,True,0,6 user reviews,6,0,6
791830,True,0,No user reviews,0,0,0
791831,True,0,No user reviews,0,0,0
791870,True,0,2 user reviews,2,0,2
791871,True,0,3 user reviews,3,0,3
791872,True,0,2 user reviews,1,1,2
791880,True,0,4 user reviews,3,1,4
791890,True,0,5 user reviews,5,0,5
791930,True,0,1 user reviews,1,0,1
791950,True,4,Mostly Negative,4,7,11
791960,True,0,5 user reviews,5,0,5
791980,True,0,No user reviews,0,0,0
791990,True,4,Mostly Negative,3,7,10
792000,True,0,3 user reviews,2,1,3
792010,True,0,No user reviews,0,0,0
792030,True,0,1 user reviews,1,0,1
792040,True,8,Very Positive,102,9,111
792050,True,0,No user reviews,0,0,0
792060,True,0,2 user reviews,1,1,2
792070,True,0,2 user reviews,1,1,2
792080,True,0,No user reviews,0,0,0
792100,True,8,Very Positive,399,21,420
792110,True,0,4 user reviews,4,0,4
792120,True,0,No user reviews,0,0,0
792140,True,0,No user reviews,0,0,0
792150,True,0,No user reviews,0,0,0
792160,True,0,5 user reviews,4,1,5
792190,True,0,No user reviews,0,0,0
792220,True,0,No user reviews,0,0,0
792230,True,0,No user reviews,0,0,0
792280,True,0,No user reviews,0,0,0
792290,True,0,No user reviews,0,0,0
792300,True,8,Very Positive,431,94,525
792320,True,0,5 user reviews,4,1,5
792330,True,7,Positive,18,3,21
792331,True,7,Positive,32,2,34
792340,True,0,2 user reviews,1,1,2
792350,True,0,3 user reviews,2,1,3
792360,True,0,No user reviews,0,0,0
792370,True,0,7 user reviews,6,1,7
792380,True,0,No user reviews,0,0,0
792390,True,0,No user reviews,0,0,0
792400,True,0,1 user reviews,0,1,1
792410,True,7,Positive,15,2,17
792420,True,7,Positive,16,2,18
792440,True,0,No user reviews,0,0,0
792470,True,0,No user reviews,0,0,0
792480,True,0,No user reviews,0,0,0
792490,True,0,1 user reviews,1,0,1
792500,True,0,4 user reviews,2,2,4
792510,True,0,No user reviews,0,0,0
792520,True,5,Mixed,76,35,111
792530,True,0,No user reviews,0,0,0
792550,True,0,3 user reviews,1,2,3
792560,True,7,Positive,9,1,10
792570,True,0,No user reviews,0,0,0
792610,True,0,No user reviews,0,0,0
792620,True,0,No user reviews,0,0,0
792630,True,0,No user reviews,0,0,0
792640,True,0,5 user reviews,4,1,5
792650,True,7,Positive,26,4,30
792660,True,6,Mostly Positive,40,13,53
792670,True,0,5 user reviews,1,4,5
792680,True,0,6 user reviews,5,1,6
792710,True,8,Very Positive,395,11,406
792720,True,0,4 user reviews,3,1,4
792750,True,0,No user reviews,0,0,0
792760,True,0,1 user reviews,1,0,1
792770,True,0,No user reviews,0,0,0
792800,True,0,2 user reviews,2,0,2
792810,True,0,1 user reviews,1,0,1
792820,True,0,No user reviews,0,0,0
792840,True,0,3 user reviews,1,2,3
792850,True,0,8 user reviews,7,1,8
792860,True,0,7 user reviews,7,0,7
792870,True,0,1 user reviews,1,0,1
792880,True,5,Mixed,13,10,23
792900,True,0,2 user reviews,0,2,2
792910,True,0,No user reviews,0,0,0
792920,True,0,No user reviews,0,0,0
792930,True,6,Mostly Positive,17,6,23
792940,True,0,8 user reviews,2,6,8
792970,True,6,Mostly Positive,8,3,11
792980,True,0,7 user reviews,3,4,7
792990,True,4,Mostly Negative,54,190,244
793000,True,0,2 user reviews,2,0,2
793010,True,0,5 user reviews,5,0,5
793020,True,0,No user reviews,0,0,0
793030,True,0,1 user reviews,1,0,1
793040,True,0,No user reviews,0,0,0
793050,True,0,No user reviews,0,0,0
793070,True,0,No user reviews,0,0,0
793080,True,0,No user reviews,0,0,0
793090,True,0,No user reviews,0,0,0
793091,True,0,No user reviews,0,0,0
793100,True,0,No user reviews,0,0,0
793120,True,0,No user reviews,0,0,0
793130,True,0,No user reviews,0,0,0
793150,True,0,No user reviews,0,0,0
793170,True,0,No user reviews,0,0,0
793180,True,0,No user reviews,0,0,0
793190,True,5,Mixed,20,12,32
793200,True,0,3 user reviews,3,0,3
793210,True,0,7 user reviews,5,2,7
793220,True,6,Mostly Positive,10,3,13
793240,True,6,Mostly Positive,7,3,10
793250,True,0,No user reviews,0,0,0
793260,True,0,3 user reviews,2,1,3
793270,True,0,1 user reviews,1,0,1
793280,True,0,No user reviews,0,0,0
793310,True,0,No user reviews,0,0,0
793320,True,0,1 user reviews,1,0,1
793330,True,0,No user reviews,0,0,0
793340,True,0,No user reviews,0,0,0
793350,True,9,Overwhelmingly Positive,614,18,632
793360,True,0,3 user reviews,3,0,3
793370,True,8,Very Positive,427,78,505
793390,True,0,1 user reviews,1,0,1
793400,True,0,No user reviews,0,0,0
793410,True,0,No user reviews,0,0,0
793450,True,7,Positive,32,1,33
793460,True,8,Very Positive,437,73,510
793470,True,0,No user reviews,0,0,0
793480,True,0,No user reviews,0,0,0
793490,True,0,No user reviews,0,0,0
793510,True,0,8 user reviews,1,7,8
793530,True,0,No user reviews,0,0,0
793531,True,0,1 user reviews,1,0,1
793532,True,0,1 user reviews,1,0,1
793533,True,0,1 user reviews,1,0,1
793534,True,0,1 user reviews,1,0,1
793535,True,0,2 user reviews,2,0,2
793536,True,0,4 user reviews,4,0,4
793537,True,0,3 user reviews,3,0,3
793538,True,0,No user reviews,0,0,0
793539,True,0,No user reviews,0,0,0
793540,True,0,No user reviews,0,0,0
793541,True,0,No user reviews,0,0,0
793542,True,0,No user reviews,0,0,0
793543,True,0,No user reviews,0,0,0
793544,True,0,1 user reviews,1,0,1
793545,True,0,2 user reviews,2,0,2
793546,True,0,5 user reviews,5,0,5
793547,True,0,1 user reviews,1,0,1
793548,True,0,1 user reviews,1,0,1
793549,True,0,1 user reviews,1,0,1
793550,True,0,No user reviews,0,0,0
793551,True,7,Positive,14,2,16
793552,True,0,No user reviews,0,0,0
793553,True,0,1 user reviews,1,0,1
793554,True,0,No user reviews,0,0,0
793560,True,7,Positive,39,7,46
793570,True,0,No user reviews,0,0,0
793580,True,0,No user reviews,0,0,0
793600,True,7,Positive,12,2,14
793610,True,3,Negative,2,14,16
793620,True,6,Mostly Positive,9,3,12
793630,True,7,Positive,8,2,10
793640,True,0,5 user reviews,4,1,5
793650,True,0,1 user reviews,0,1,1
793670,True,5,Mixed,11,5,16
793680,True,8,Very Positive,67,7,74
793690,True,8,Very Positive,184,16,200
793730,True,0,2 user reviews,2,0,2
793740,True,8,Very Positive,123,7,130
793750,True,0,1 user reviews,0,1,1
793751,True,0,2 user reviews,1,1,2
793760,True,5,Mixed,11,10,21
793770,True,0,1 user reviews,0,1,1
793771,True,0,1 user reviews,0,1,1
793790,True,0,No user reviews,0,0,0
793820,True,0,6 user reviews,6,0,6
793830,True,7,Positive,10,0,10
793860,True,0,No user reviews,0,0,0
793861,True,0,No user reviews,0,0,0
793880,True,0,8 user reviews,8,0,8
793900,True,0,No user reviews,0,0,0
793910,True,0,No user reviews,0,0,0
793940,True,5,Mixed,7,4,11
793950,True,0,No user reviews,0,0,0
793970,True,0,9 user reviews,1,8,9
793980,True,0,No user reviews,0,0,0
793990,True,0,4 user reviews,3,1,4
794000,True,0,No user reviews,0,0,0
794010,True,0,No user reviews,0,0,0
794020,True,0,No user reviews,0,0,0
794030,True,7,Positive,12,0,12
794040,True,0,1 user reviews,0,1,1
794050,True,0,6 user reviews,1,5,6
794060,True,5,Mixed,9,5,14
794101,True,0,2 user reviews,2,0,2
794102,True,0,3 user reviews,1,2,3
794103,True,0,3 user reviews,2,1,3
794104,True,0,4 user reviews,1,3,4
794105,True,0,9 user reviews,3,6,9
794106,True,0,1 user reviews,0,1,1
794107,True,0,2 user reviews,2,0,2
794108,True,0,1 user reviews,1,0,1
794109,True,0,6 user reviews,5,1,6
794110,True,0,No user reviews,0,0,0
794111,True,0,No user reviews,0,0,0
794140,True,0,4 user reviews,3,1,4
794141,True,0,2 user reviews,1,1,2
794143,True,0,2 user reviews,2,0,2
794150,True,5,Mixed,25,13,38
794170,True,0,1 user reviews,1,0,1
794180,True,0,5 user reviews,1,4,5
794190,True,5,Mixed,10,5,15
794210,True,0,No user reviews,0,0,0
794220,True,7,Positive,16,3,19
794230,True,0,No user reviews,0,0,0
794240,True,7,Positive,32,6,38
794260,True,6,Mostly Positive,5606,1851,7457
794270,True,5,Mixed,88,65,153
794280,True,0,No user reviews,0,0,0
794300,True,0,5 user reviews,2,3,5
794310,True,7,Positive,27,0,27
794320,True,0,1 user reviews,1,0,1
794340,True,0,3 user reviews,3,0,3
794341,True,0,4 user reviews,3,1,4
794342,True,0,3 user reviews,3,0,3
794343,True,7,Positive,43,1,44
794344,True,0,2 user reviews,2,0,2
794345,True,7,Positive,25,2,27
794350,True,0,1 user reviews,1,0,1
794390,True,7,Positive,26,1,27
794400,True,0,No user reviews,0,0,0
794401,True,0,2 user reviews,1,1,2
794410,True,6,Mostly Positive,17,6,23
794420,True,0,No user reviews,0,0,0
794430,True,0,No user reviews,0,0,0
794440,True,0,No user reviews,0,0,0
794441,True,0,No user reviews,0,0,0
794442,True,0,No user reviews,0,0,0
794443,True,0,No user reviews,0,0,0
794444,True,0,No user reviews,0,0,0
794445,True,0,No user reviews,0,0,0
794446,True,0,No user reviews,0,0,0
794447,True,0,No user reviews,0,0,0
794448,True,0,No user reviews,0,0,0
794449,True,0,No user reviews,0,0,0
794450,True,0,No user reviews,0,0,0
794451,True,0,No user reviews,0,0,0
794480,True,0,2 user reviews,2,0,2
794490,True,6,Mostly Positive,192,75,267
794530,True,0,No user reviews,0,0,0
794540,True,8,Very Positive,295,38,333
794550,True,8,Very Positive,64,5,69
794560,True,0,2 user reviews,2,0,2
794570,True,0,2 user reviews,2,0,2
794580,True,8,Very Positive,58,14,72
794590,True,0,No user reviews,0,0,0
794600,True,0,2 user reviews,2,0,2
794610,True,0,No user reviews,0,0,0
794630,True,0,No user reviews,0,0,0
794640,True,0,3 user reviews,2,1,3
794650,True,4,Mostly Negative,5,13,18
794690,True,0,No user reviews,0,0,0
794700,True,0,No user reviews,0,0,0
794710,True,0,No user reviews,0,0,0
794720,True,0,No user reviews,0,0,0
794730,True,0,1 user reviews,1,0,1
794740,True,0,9 user reviews,5,4,9
794750,True,0,No user reviews,0,0,0
794760,True,7,Positive,12,3,15
794780,True,0,2 user reviews,2,0,2
794800,True,8,Very Positive,494,87,581
794820,True,0,No user reviews,0,0,0
794830,True,0,3 user reviews,3,0,3
794850,True,0,No user reviews,0,0,0
794860,True,8,Very Positive,147,7,154
794880,True,0,No user reviews,0,0,0
794890,True,0,No user reviews,0,0,0
794930,True,0,5 user reviews,2,3,5
794940,True,7,Positive,30,3,33
794950,True,0,1 user reviews,1,0,1
794960,True,7,Positive,9,2,11
794990,True,0,4 user reviews,1,3,4
795000,True,0,No user reviews,0,0,0
795020,True,0,No user reviews,0,0,0
795040,True,7,Positive,45,2,47
795050,True,0,4 user reviews,4,0,4
795100,True,7,Positive,18,2,20
795110,True,7,Positive,8,2,10
795120,True,0,1 user reviews,1,0,1
795160,True,5,Mixed,12,8,20
795170,True,0,No user reviews,0,0,0
795210,True,0,No user reviews,0,0,0
795220,True,7,Positive,10,1,11
795230,True,0,5 user reviews,2,3,5
795250,True,0,No user reviews,0,0,0
795260,True,0,No user reviews,0,0,0
795290,True,0,No user reviews,0,0,0
795310,True,5,Mixed,9,7,16
795320,True,0,2 user reviews,1,1,2
795330,True,0,No user reviews,0,0,0
795340,True,0,No user reviews,0,0,0
795350,True,0,No user reviews,0,0,0
795360,True,0,No user reviews,0,0,0
795380,True,0,No user reviews,0,0,0
795390,True,0,No user reviews,0,0,0
795400,True,0,No user reviews,0,0,0
795410,True,0,No user reviews,0,0,0
795420,True,0,No user reviews,0,0,0
795440,True,0,2 user reviews,2,0,2
795460,True,0,No user reviews,0,0,0
795461,True,0,No user reviews,0,0,0
795462,True,0,No user reviews,0,0,0
795470,True,0,No user reviews,0,0,0
795480,True,0,No user reviews,0,0,0
795490,True,0,5 user reviews,2,3,5
795510,True,7,Positive,24,2,26
795530,True,0,1 user reviews,0,1,1
795550,True,0,No user reviews,0,0,0
795570,True,7,Positive,19,2,21
795580,True,0,No user reviews,0,0,0
795600,True,0,No user reviews,0,0,0
795610,True,0,9 user reviews,5,4,9
795620,True,0,No user reviews,0,0,0
795621,True,7,Positive,17,1,18
795630,True,6,Mostly Positive,239,79,318
795640,True,0,No user reviews,0,0,0
795650,True,0,1 user reviews,1,0,1
795680,True,6,Mostly Positive,18,5,23
795720,True,0,2 user reviews,1,1,2
795731,True,7,Positive,11,2,13
795732,True,0,5 user reviews,4,1,5
795760,True,6,Mostly Positive,10,3,13
795910,True,0,3 user reviews,2,1,3
795920,True,0,2 user reviews,2,0,2
795940,True,0,3 user reviews,3,0,3
795950,True,0,No user reviews,0,0,0
795960,True,0,1 user reviews,0,1,1
795990,True,0,8 user reviews,5,3,8
796030,True,0,5 user reviews,3,2,5
796050,True,0,5 user reviews,4,1,5
796060,True,0,3 user reviews,3,0,3
796070,True,0,2 user reviews,2,0,2
796080,True,0,No user reviews,0,0,0
796090,True,0,1 user reviews,1,0,1
796100,True,0,2 user reviews,2,0,2
796110,True,0,No user reviews,0,0,0
796120,True,0,No user reviews,0,0,0
796130,True,0,2 user reviews,1,1,2
796140,True,0,No user reviews,0,0,0
796160,True,0,No user reviews,0,0,0
796170,True,0,No user reviews,0,0,0
796190,True,0,No user reviews,0,0,0
796200,True,0,No user reviews,0,0,0
796210,True,0,No user reviews,0,0,0
796240,True,0,No user reviews,0,0,0
796241,True,0,No user reviews,0,0,0
796242,True,0,No user reviews,0,0,0
796260,True,0,No user reviews,0,0,0
796290,True,0,No user reviews,0,0,0
796300,True,0,No user reviews,0,0,0
796310,True,0,No user reviews,0,0,0
796320,True,0,2 user reviews,1,1,2
796330,True,3,Negative,0,11,11
796340,True,0,5 user reviews,3,2,5
796350,True,0,4 user reviews,3,1,4
796360,True,5,Mixed,11,9,20
796370,True,0,8 user reviews,7,1,8
796380,True,7,Positive,15,1,16
796400,True,0,No user reviews,0,0,0
796410,True,0,No user reviews,0,0,0
796430,True,6,Mostly Positive,17,5,22
796440,True,0,7 user reviews,1,6,7
796460,True,5,Mixed,7,9,16
796480,True,5,Mixed,8,5,13
796490,True,0,3 user reviews,3,0,3
796500,True,0,No user reviews,0,0,0
796510,True,5,Mixed,16,9,25
796520,True,0,No user reviews,0,0,0
796530,True,0,No user reviews,0,0,0
796560,True,0,No user reviews,0,0,0
796580,True,0,No user reviews,0,0,0
796590,True,5,Mixed,9,6,15
796600,True,5,Mixed,9,5,14
796620,True,5,Mixed,23,12,35
796640,True,0,4 user reviews,4,0,4
796650,True,7,Positive,8,2,10
796660,True,0,No user reviews,0,0,0
796710,True,0,1 user reviews,0,1,1
796760,True,0,1 user reviews,1,0,1
796770,True,6,Mostly Positive,7,3,10
796780,True,7,Positive,13,1,14
796790,True,0,8 user reviews,6,2,8
796800,True,0,No user reviews,0,0,0
796820,True,0,No user reviews,0,0,0
796840,True,0,8 user reviews,7,1,8
796850,True,0,No user reviews,0,0,0
796860,True,4,Mostly Negative,47,104,151
796900,True,0,9 user reviews,6,3,9
796910,True,0,No user reviews,0,0,0
796920,True,0,1 user reviews,0,1,1
796930,True,0,No user reviews,0,0,0
796940,True,8,Very Positive,61,3,64
796950,True,0,No user reviews,0,0,0
796970,True,0,No user reviews,0,0,0
796980,True,0,2 user reviews,1,1,2
797010,True,0,No user reviews,0,0,0
797020,True,0,No user reviews,0,0,0
797040,True,5,Mixed,7,10,17
797050,True,0,No user reviews,0,0,0
797060,True,0,No user reviews,0,0,0
797070,True,0,8 user reviews,6,2,8
797090,True,5,Mixed,4,6,10
797110,True,0,No user reviews,0,0,0
797150,True,0,5 user reviews,4,1,5
797180,True,0,No user reviews,0,0,0
797190,True,0,2 user reviews,1,1,2
797200,True,0,No user reviews,0,0,0
797210,True,0,No user reviews,0,0,0
797220,True,5,Mixed,9,5,14
797230,True,0,No user reviews,0,0,0
797240,True,0,1 user reviews,1,0,1
797260,True,0,No user reviews,0,0,0
797280,True,7,Positive,19,1,20
797300,True,0,4 user reviews,3,1,4
797310,True,0,1 user reviews,1,0,1
797330,True,0,3 user reviews,3,0,3
797340,True,0,3 user reviews,3,0,3
797350,True,0,1 user reviews,1,0,1
797360,True,0,No user reviews,0,0,0
797370,True,0,No user reviews,0,0,0
797390,True,0,No user reviews,0,0,0
797400,True,5,Mixed,196,93,289
797410,True,7,Positive,22,4,26
797420,True,0,2 user reviews,2,0,2
797430,True,0,No user reviews,0,0,0
797440,True,0,2 user reviews,2,0,2
797450,True,0,1 user reviews,1,0,1
797460,True,0,No user reviews,0,0,0
797470,True,0,No user reviews,0,0,0
797500,True,0,1 user reviews,1,0,1
797510,True,0,No user reviews,0,0,0
797520,True,0,No user reviews,0,0,0
797540,True,0,No user reviews,0,0,0
797550,True,0,1 user reviews,0,1,1
797560,True,0,No user reviews,0,0,0
797570,True,0,9 user reviews,9,0,9
797580,True,0,No user reviews,0,0,0
797610,True,0,9 user reviews,9,0,9
797620,True,7,Positive,22,2,24
797630,True,0,1 user reviews,1,0,1
797631,True,0,No user reviews,0,0,0
797632,True,0,No user reviews,0,0,0
797660,True,0,1 user reviews,0,1,1
797670,True,0,1 user reviews,1,0,1
797671,True,0,1 user reviews,1,0,1
797672,True,0,No user reviews,0,0,0
797710,True,5,Mixed,9,4,13
797730,True,0,No user reviews,0,0,0
797740,True,0,No user reviews,0,0,0
797750,True,0,No user reviews,0,0,0
797760,True,0,1 user reviews,0,1,1
797770,True,0,2 user reviews,1,1,2
797780,True,0,1 user reviews,0,1,1
797790,True,0,1 user reviews,0,1,1
797800,True,0,1 user reviews,0,1,1
797810,True,0,No user reviews,0,0,0
797820,True,0,No user reviews,0,0,0
797830,True,0,No user reviews,0,0,0
797840,True,0,1 user reviews,1,0,1
797850,True,0,No user reviews,0,0,0
797860,True,0,1 user reviews,1,0,1
797870,True,0,No user reviews,0,0,0
797880,True,0,No user reviews,0,0,0
797890,True,0,No user reviews,0,0,0
797900,True,0,No user reviews,0,0,0
797910,True,0,No user reviews,0,0,0
797920,True,0,No user reviews,0,0,0
797930,True,0,No user reviews,0,0,0
797940,True,0,No user reviews,0,0,0
797950,True,0,No user reviews,0,0,0
797960,True,0,No user reviews,0,0,0
797970,True,0,No user reviews,0,0,0
797980,True,0,No user reviews,0,0,0
797990,True,0,No user reviews,0,0,0
798000,True,0,No user reviews,0,0,0
798010,True,0,No user reviews,0,0,0
798020,True,0,No user reviews,0,0,0
798030,True,0,1 user reviews,1,0,1
798050,True,0,No user reviews,0,0,0
798060,True,0,No user reviews,0,0,0
798070,True,0,No user reviews,0,0,0
798080,True,0,1 user reviews,0,1,1
798090,True,0,No user reviews,0,0,0
798100,True,0,No user reviews,0,0,0
798110,True,0,No user reviews,0,0,0
798140,True,0,5 user reviews,5,0,5
798150,True,0,No user reviews,0,0,0
798170,True,0,7 user reviews,7,0,7
798180,True,0,No user reviews,0,0,0
798190,True,0,No user reviews,0,0,0
798200,True,0,1 user reviews,1,0,1
798210,True,0,4 user reviews,3,1,4
798230,True,0,5 user reviews,2,3,5
798240,True,0,3 user reviews,3,0,3
798250,True,0,No user reviews,0,0,0
798252,True,0,1 user reviews,1,0,1
798280,True,0,No user reviews,0,0,0
798290,True,5,Mixed,110,50,160
798300,True,0,No user reviews,0,0,0
798310,True,0,No user reviews,0,0,0
798320,True,0,1 user reviews,1,0,1
798330,True,0,2 user reviews,2,0,2
798350,True,0,No user reviews,0,0,0
798360,True,0,No user reviews,0,0,0
798380,True,0,3 user reviews,1,2,3
798390,True,8,Very Positive,104,22,126
798400,True,0,No user reviews,0,0,0
798410,True,0,No user reviews,0,0,0
798420,True,0,3 user reviews,1,2,3
798430,True,0,7 user reviews,7,0,7
798440,True,0,No user reviews,0,0,0
798450,True,0,No user reviews,0,0,0
798460,True,8,Very Positive,546,74,620
798480,True,0,No user reviews,0,0,0
798490,True,8,Very Positive,536,103,639
798510,True,8,Very Positive,316,38,354
798520,True,0,1 user reviews,0,1,1
798540,True,0,No user reviews,0,0,0
798541,True,0,No user reviews,0,0,0
798542,True,0,No user reviews,0,0,0
798543,True,0,No user reviews,0,0,0
798560,True,0,9 user reviews,3,6,9
798580,True,0,No user reviews,0,0,0
798590,True,5,Mixed,25,32,57
798610,True,0,No user reviews,0,0,0
798620,True,0,No user reviews,0,0,0
798630,True,0,No user reviews,0,0,0
798650,True,7,Positive,16,0,16
798660,True,0,No user reviews,0,0,0
798670,True,0,No user reviews,0,0,0
798680,True,0,5 user reviews,4,1,5
798710,True,0,7 user reviews,2,5,7
798720,True,0,No user reviews,0,0,0
798740,True,0,7 user reviews,7,0,7
798750,True,7,Positive,9,1,10
798780,True,0,No user reviews,0,0,0
798790,True,0,7 user reviews,6,1,7
798800,True,0,No user reviews,0,0,0
798810,True,8,Very Positive,274,33,307
798820,True,0,No user reviews,0,0,0
798830,True,5,Mixed,12,18,30
798840,True,6,Mostly Positive,37,13,50
798850,True,5,Mixed,9,6,15
798860,True,0,1 user reviews,1,0,1
798870,True,0,6 user reviews,5,1,6
798880,True,0,3 user reviews,3,0,3
798892,True,0,No user reviews,0,0,0
798893,True,0,No user reviews,0,0,0
798894,True,0,No user reviews,0,0,0
798895,True,0,No user reviews,0,0,0
798896,True,0,No user reviews,0,0,0
798901,True,0,1 user reviews,1,0,1
798902,True,0,1 user reviews,1,0,1
798930,True,0,No user reviews,0,0,0
798940,True,0,No user reviews,0,0,0
798950,True,0,No user reviews,0,0,0
798960,True,0,9 user reviews,7,2,9
798970,True,0,No user reviews,0,0,0
798980,True,0,No user reviews,0,0,0
798990,True,0,No user reviews,0,0,0
799010,True,0,No user reviews,0,0,0
799030,True,0,No user reviews,0,0,0
799060,True,0,No user reviews,0,0,0
799070,True,8,Very Positive,390,15,405
799080,True,0,4 user reviews,2,2,4
799090,True,0,No user reviews,0,0,0
799110,True,7,Positive,22,3,25
799120,True,0,3 user reviews,1,2,3
799130,True,0,No user reviews,0,0,0
799140,True,0,No user reviews,0,0,0
799160,True,0,No user reviews,0,0,0
799180,True,0,2 user reviews,1,1,2
799200,True,8,Very Positive,154,35,189
799210,True,0,1 user reviews,0,1,1
799240,True,0,No user reviews,0,0,0
799260,True,6,Mostly Positive,12,4,16
799270,True,0,2 user reviews,1,1,2
799280,True,0,No user reviews,0,0,0
799300,True,0,No user reviews,0,0,0
799310,True,0,1 user reviews,1,0,1
799330,True,0,2 user reviews,2,0,2
799331,True,0,5 user reviews,5,0,5
799340,True,0,No user reviews,0,0,0
799350,True,5,Mixed,71,56,127
799360,True,0,No user reviews,0,0,0
799420,True,0,4 user reviews,1,3,4
799430,True,0,No user reviews,0,0,0
799460,True,0,No user reviews,0,0,0
799470,True,0,No user reviews,0,0,0
799480,True,0,No user reviews,0,0,0
799481,True,0,No user reviews,0,0,0
799482,True,0,2 user reviews,2,0,2
799500,True,5,Mixed,26,15,41
799510,True,8,Very Positive,185,6,191
799520,True,8,Very Positive,81,13,94
799521,True,0,No user reviews,0,0,0
799522,True,0,No user reviews,0,0,0
799524,True,0,No user reviews,0,0,0
799530,True,5,Mixed,9,5,14
799540,True,0,No user reviews,0,0,0
799560,True,0,2 user reviews,1,1,2
799570,True,0,No user reviews,0,0,0
799580,True,0,No user reviews,0,0,0
799590,True,0,4 user reviews,4,0,4
799600,True,0,No user reviews,0,0,0
799610,True,0,1 user reviews,0,1,1
799620,True,0,6 user reviews,5,1,6
799640,True,8,Very Positive,232,9,241
799660,True,0,No user reviews,0,0,0
799670,True,5,Mixed,6,4,10
799680,True,0,No user reviews,0,0,0
799690,True,0,No user reviews,0,0,0
799700,True,0,No user reviews,0,0,0
799710,True,0,No user reviews,0,0,0
799730,True,7,Positive,8,2,10
799750,True,5,Mixed,16,10,26
799751,True,4,Mostly Negative,11,20,31
799770,True,0,2 user reviews,2,0,2
799790,True,7,Positive,24,4,28
799800,True,7,Positive,14,3,17
799810,True,5,Mixed,14,7,21
799820,True,0,3 user reviews,2,1,3
799840,True,5,Mixed,10,8,18
799860,True,0,No user reviews,0,0,0
799870,True,0,1 user reviews,1,0,1
799890,True,0,4 user reviews,1,3,4
799910,True,0,9 user reviews,6,3,9
799920,True,0,No user reviews,0,0,0
799950,True,0,No user reviews,0,0,0
799960,True,0,No user reviews,0,0,0
799980,True,0,No user reviews,0,0,0
799990,True,0,No user reviews,0,0,0
800010,True,0,No user reviews,0,0,0
800020,True,0,1 user reviews,1,0,1
800030,True,0,8 user reviews,3,5,8
800040,True,0,No user reviews,0,0,0
800050,True,7,Positive,14,2,16
800060,True,0,No user reviews,0,0,0
800090,True,0,No user reviews,0,0,0
800100,True,0,No user reviews,0,0,0
800120,True,7,Positive,29,5,34
800130,True,0,2 user reviews,1,1,2
800140,True,0,No user reviews,0,0,0
800150,True,0,No user reviews,0,0,0
800170,True,0,No user reviews,0,0,0
800180,True,7,Positive,26,0,26
800190,True,7,Positive,15,1,16
800200,True,6,Mostly Positive,48,16,64
800210,True,0,No user reviews,0,0,0
800220,True,0,1 user reviews,0,1,1
800221,True,0,2 user reviews,1,1,2
800222,True,0,1 user reviews,1,0,1
800230,True,7,Positive,15,0,15
800240,True,6,Mostly Positive,10,4,14
800250,True,0,No user reviews,0,0,0
800260,True,0,No user reviews,0,0,0
800261,True,0,No user reviews,0,0,0
800270,True,6,Mostly Positive,944,338,1282
800280,True,0,No user reviews,0,0,0
800290,True,0,9 user reviews,8,1,9
800300,True,0,No user reviews,0,0,0
800310,True,0,5 user reviews,0,5,5
800320,True,0,1 user reviews,1,0,1
800330,True,0,1 user reviews,1,0,1
800340,True,5,Mixed,7,4,11
800341,True,0,2 user reviews,2,0,2
800342,True,0,7 user reviews,7,0,7
800350,True,0,3 user reviews,3,0,3
800370,True,8,Very Positive,302,20,322
800380,True,5,Mixed,9,7,16
800390,True,7,Positive,21,0,21
800450,True,5,Mixed,25,11,36
800460,True,0,No user reviews,0,0,0
800490,True,7,Positive,9,2,11
800510,True,0,6 user reviews,4,2,6
800520,True,0,1 user reviews,1,0,1
800530,True,0,1 user reviews,0,1,1
800540,True,0,No user reviews,0,0,0
800550,True,0,4 user reviews,3,1,4
800560,True,5,Mixed,6,5,11
800570,True,0,No user reviews,0,0,0
800580,True,5,Mixed,6,4,10
800590,True,0,No user reviews,0,0,0
800600,True,8,Very Positive,177,9,186
800610,True,0,No user reviews,0,0,0
800620,True,8,Very Positive,181,5,186
800630,True,0,No user reviews,0,0,0
800640,True,0,7 user reviews,6,1,7
800650,True,5,Mixed,8,6,14
800660,True,0,2 user reviews,2,0,2
800670,True,5,Mixed,9,5,14
800680,True,0,No user reviews,0,0,0
800690,True,7,Positive,16,0,16
800700,True,0,8 user reviews,7,1,8
800710,True,0,No user reviews,0,0,0
800720,True,0,No user reviews,0,0,0
800740,True,0,1 user reviews,1,0,1
800810,True,0,No user reviews,0,0,0
800820,True,0,9 user reviews,9,0,9
800830,True,0,No user reviews,0,0,0
800840,True,0,1 user reviews,0,1,1
800860,True,0,3 user reviews,3,0,3
800910,True,0,2 user reviews,2,0,2
800930,True,7,Positive,12,1,13
800950,True,0,No user reviews,0,0,0
800980,True,0,2 user reviews,0,2,2
801010,True,5,Mixed,4,6,10
801020,True,0,2 user reviews,0,2,2
801040,True,8,Very Positive,50,8,58
801060,True,0,2 user reviews,0,2,2
801070,True,0,No user reviews,0,0,0
801080,True,0,No user reviews,0,0,0
801120,True,0,No user reviews,0,0,0
801140,True,0,No user reviews,0,0,0
801150,True,0,2 user reviews,1,1,2
801180,True,0,4 user reviews,1,3,4
801210,True,5,Mixed,20,12,32
801220,True,0,No user reviews,0,0,0
801230,True,0,No user reviews,0,0,0
801250,True,0,1 user reviews,1,0,1
801260,True,0,5 user reviews,4,1,5
801280,True,0,2 user reviews,1,1,2
801290,True,8,Very Positive,50,3,53
801300,True,0,7 user reviews,7,0,7
801310,True,0,No user reviews,0,0,0
801320,True,0,8 user reviews,4,4,8
801330,True,0,2 user reviews,1,1,2
801340,True,0,7 user reviews,1,6,7
801370,True,0,No user reviews,0,0,0
801380,True,0,1 user reviews,1,0,1
801390,True,0,No user reviews,0,0,0
801400,True,0,No user reviews,0,0,0
801410,True,0,2 user reviews,2,0,2
801420,True,0,No user reviews,0,0,0
801440,True,0,9 user reviews,4,5,9
801450,True,0,No user reviews,0,0,0
801460,True,0,No user reviews,0,0,0
801461,True,0,No user reviews,0,0,0
801462,True,0,No user reviews,0,0,0
801480,True,8,Very Positive,351,11,362
801490,True,0,3 user reviews,0,3,3
801500,True,0,2 user reviews,2,0,2
801550,True,0,No user reviews,0,0,0
801560,True,0,2 user reviews,2,0,2
801561,True,0,1 user reviews,1,0,1
801570,True,0,No user reviews,0,0,0
801571,True,0,No user reviews,0,0,0
801580,True,0,1 user reviews,1,0,1
801590,True,0,No user reviews,0,0,0
801591,True,0,No user reviews,0,0,0
801592,True,0,No user reviews,0,0,0
801593,True,0,No user reviews,0,0,0
801594,True,0,No user reviews,0,0,0
801595,True,0,No user reviews,0,0,0
801596,True,0,No user reviews,0,0,0
801600,True,0,No user reviews,0,0,0
801610,True,0,No user reviews,0,0,0
801630,True,9,Overwhelmingly Positive,1037,45,1082
801640,True,0,No user reviews,0,0,0
801660,True,0,1 user reviews,1,0,1
801670,True,6,Mostly Positive,26,8,34
801690,True,0,3 user reviews,3,0,3
801700,True,0,2 user reviews,1,1,2
801710,True,7,Positive,22,3,25
801740,True,0,No user reviews,0,0,0
801750,True,7,Positive,20,0,20
801760,True,0,3 user reviews,3,0,3
801770,True,0,4 user reviews,1,3,4
801780,True,0,3 user reviews,0,3,3
801790,True,0,No user reviews,0,0,0
801830,True,0,1 user reviews,0,1,1
801840,True,0,No user reviews,0,0,0
801860,True,8,Very Positive,284,5,289
801870,True,0,No user reviews,0,0,0
801880,True,5,Mixed,41,40,81
801890,True,0,2 user reviews,2,0,2
801900,True,0,9 user reviews,7,2,9
801910,True,0,No user reviews,0,0,0
801920,True,0,6 user reviews,6,0,6
801930,True,0,No user reviews,0,0,0
801940,True,0,3 user reviews,1,2,3
801970,True,0,No user reviews,0,0,0
801980,True,7,Positive,16,0,16
801990,True,0,No user reviews,0,0,0
802000,True,0,2 user reviews,2,0,2
802020,True,0,No user reviews,0,0,0
802040,True,7,Positive,35,4,39
802050,True,0,No user reviews,0,0,0
802060,True,0,1 user reviews,1,0,1
802070,True,7,Positive,8,2,10
802080,True,0,9 user reviews,7,2,9
802090,True,0,2 user reviews,2,0,2
802100,True,0,No user reviews,0,0,0
802120,True,0,2 user reviews,0,2,2
802130,True,0,3 user reviews,3,0,3
802150,True,0,No user reviews,0,0,0
802170,True,0,No user reviews,0,0,0
802180,True,0,1 user reviews,1,0,1
802190,True,0,6 user reviews,3,3,6
802200,True,0,No user reviews,0,0,0
802210,True,0,7 user reviews,6,1,7
802240,True,0,No user reviews,0,0,0
802260,True,0,2 user reviews,2,0,2
802270,True,0,No user reviews,0,0,0
802280,True,0,1 user reviews,1,0,1
802290,True,0,1 user reviews,0,1,1
802300,True,0,2 user reviews,1,1,2
802310,True,0,4 user reviews,3,1,4
802320,True,0,3 user reviews,1,2,3
802330,True,4,Mostly Negative,5,8,13
802340,True,0,4 user reviews,3,1,4
802350,True,0,No user reviews,0,0,0
802360,True,0,8 user reviews,3,5,8
802370,True,0,No user reviews,0,0,0
802390,True,0,No user reviews,0,0,0
802400,True,7,Positive,30,2,32
802410,True,0,No user reviews,0,0,0
802420,True,0,No user reviews,0,0,0
802440,True,0,No user reviews,0,0,0
802450,True,7,Positive,37,7,44
802460,True,0,1 user reviews,1,0,1
802470,True,0,No user reviews,0,0,0
802480,True,0,1 user reviews,0,1,1
802490,True,5,Mixed,8,4,12
802500,True,0,No user reviews,0,0,0
802510,True,0,No user reviews,0,0,0
802530,True,0,2 user reviews,0,2,2
802540,True,0,No user reviews,0,0,0
802550,True,0,No user reviews,0,0,0
802580,True,0,No user reviews,0,0,0
802590,True,0,No user reviews,0,0,0
802600,True,0,No user reviews,0,0,0
802610,True,0,No user reviews,0,0,0
802620,True,0,No user reviews,0,0,0
802630,True,0,No user reviews,0,0,0
802640,True,8,Very Positive,53,2,55
802650,True,0,5 user reviews,5,0,5
802660,True,0,2 user reviews,1,1,2
802690,True,5,Mixed,7,7,14
802700,True,5,Mixed,24,14,38
802720,True,0,2 user reviews,2,0,2
802730,True,8,Very Positive,83,14,97
802740,True,7,Positive,12,1,13
802770,True,0,No user reviews,0,0,0
802780,True,0,5 user reviews,4,1,5
802810,True,5,Mixed,7,6,13
802820,True,0,9 user reviews,7,2,9
802850,True,5,Mixed,13,8,21
802860,True,0,6 user reviews,6,0,6
802870,True,8,Very Positive,189,5,194
802880,True,8,Very Positive,121,5,126
802890,True,8,Very Positive,238,13,251
802900,True,0,8 user reviews,5,3,8
802910,True,7,Positive,18,1,19
802920,True,0,9 user reviews,5,4,9
802930,True,0,6 user reviews,6,0,6
802960,True,0,No user reviews,0,0,0
802980,True,0,2 user reviews,2,0,2
803030,True,0,No user reviews,0,0,0
803040,True,5,Mixed,37,23,60
803050,True,0,No user reviews,0,0,0
803060,True,0,No user reviews,0,0,0
803080,True,0,4 user reviews,3,1,4
803090,True,0,No user reviews,0,0,0
803100,True,0,No user reviews,0,0,0
803110,True,0,4 user reviews,1,3,4
803130,True,5,Mixed,6,5,11
803140,True,0,No user reviews,0,0,0
803150,True,7,Positive,32,4,36
803170,True,0,1 user reviews,1,0,1
803210,True,0,No user reviews,0,0,0
803220,True,0,No user reviews,0,0,0
803240,True,0,1 user reviews,0,1,1
803260,True,5,Mixed,8,4,12
803270,True,0,6 user reviews,6,0,6
803280,True,0,5 user reviews,5,0,5
803290,True,0,1 user reviews,1,0,1
803310,True,0,9 user reviews,1,8,9
803320,True,0,1 user reviews,0,1,1
803330,True,9,Overwhelmingly Positive,2845,137,2982
803340,True,0,No user reviews,0,0,0
803350,True,0,No user reviews,0,0,0
803360,True,0,5 user reviews,4,1,5
803380,True,7,Positive,16,1,17
803381,True,7,Positive,18,3,21
803390,True,0,3 user reviews,2,1,3
803450,True,0,No user reviews,0,0,0
803500,True,0,No user reviews,0,0,0
803510,True,0,8 user reviews,7,1,8
803520,True,0,No user reviews,0,0,0
803570,True,0,5 user reviews,1,4,5
803580,True,0,1 user reviews,1,0,1
803590,True,0,6 user reviews,6,0,6
803600,True,8,Very Positive,828,113,941
803610,True,0,2 user reviews,2,0,2
803660,True,0,No user reviews,0,0,0
803670,True,0,No user reviews,0,0,0
803680,True,0,1 user reviews,0,1,1
803690,True,0,No user reviews,0,0,0
803700,True,0,No user reviews,0,0,0
803710,True,0,No user reviews,0,0,0
803711,True,0,No user reviews,0,0,0
803712,True,0,No user reviews,0,0,0
803720,True,0,4 user reviews,2,2,4
803750,True,0,7 user reviews,6,1,7
803760,True,0,1 user reviews,1,0,1
803780,True,0,1 user reviews,1,0,1
803800,True,0,7 user reviews,3,4,7
803810,True,0,No user reviews,0,0,0
803830,True,6,Mostly Positive,97,26,123
803840,True,0,1 user reviews,1,0,1
803850,True,6,Mostly Positive,17,7,24
803860,True,0,No user reviews,0,0,0
803870,True,0,1 user reviews,1,0,1
803890,True,4,Mostly Negative,3,7,10
803910,True,0,No user reviews,0,0,0
803920,True,0,6 user reviews,5,1,6
803930,True,0,3 user reviews,3,0,3
803960,True,0,No user reviews,0,0,0
803970,True,0,No user reviews,0,0,0
803980,True,5,Mixed,389,170,559
804000,True,6,Mostly Positive,8,3,11
804010,True,8,Very Positive,435,52,487
804030,True,0,3 user reviews,3,0,3
804070,True,0,No user reviews,0,0,0
804120,True,0,5 user reviews,4,1,5
804130,True,6,Mostly Positive,9,3,12
804190,True,0,No user reviews,0,0,0
804200,True,0,No user reviews,0,0,0
804210,True,5,Mixed,9,7,16
804230,True,0,No user reviews,0,0,0
804270,True,0,No user reviews,0,0,0
804290,True,5,Mixed,6,5,11
804310,True,0,2 user reviews,2,0,2
804320,True,0,No user reviews,0,0,0
804330,True,0,No user reviews,0,0,0
804340,True,0,No user reviews,0,0,0
804350,True,6,Mostly Positive,21,6,27
804390,True,0,No user reviews,0,0,0
804400,True,0,5 user reviews,5,0,5
804410,True,0,No user reviews,0,0,0
804430,True,0,7 user reviews,2,5,7
804440,True,0,6 user reviews,5,1,6
804450,True,0,No user reviews,0,0,0
804460,True,0,6 user reviews,3,3,6
804490,True,6,Mostly Positive,446,112,558
804500,True,0,No user reviews,0,0,0
804530,True,0,5 user reviews,5,0,5
804540,True,0,No user reviews,0,0,0
804560,True,0,No user reviews,0,0,0
804580,True,0,No user reviews,0,0,0
804590,True,0,No user reviews,0,0,0
804600,True,0,6 user reviews,4,2,6
804610,True,5,Mixed,7,4,11
804620,True,0,No user reviews,0,0,0
804630,True,0,No user reviews,0,0,0
804640,True,7,Positive,15,2,17
804641,True,7,Positive,13,1,14
804642,True,7,Positive,9,1,10
804643,True,0,7 user reviews,6,1,7
804644,True,7,Positive,9,1,10
804645,True,0,8 user reviews,7,1,8
804646,True,7,Positive,10,2,12
804647,True,0,9 user reviews,7,2,9
804680,True,0,1 user reviews,0,1,1
804690,True,0,No user reviews,0,0,0
804700,True,8,Very Positive,92,4,96
804730,True,5,Mixed,31,44,75
804740,True,0,No user reviews,0,0,0
804741,True,0,No user reviews,0,0,0
804742,True,0,No user reviews,0,0,0
804750,True,0,No user reviews,0,0,0
804760,True,7,Positive,32,5,37
804780,True,0,4 user reviews,3,1,4
804790,True,0,No user reviews,0,0,0
804820,True,0,No user reviews,0,0,0
804830,True,0,9 user reviews,3,6,9
804850,True,5,Mixed,90,66,156
804860,True,0,No user reviews,0,0,0
804870,True,6,Mostly Positive,61,24,85
804900,True,0,5 user reviews,3,2,5
804910,True,0,No user reviews,0,0,0
804920,True,0,No user reviews,0,0,0
804930,True,0,No user reviews,0,0,0
804950,True,0,2 user reviews,2,0,2
804970,True,0,No user reviews,0,0,0
804980,True,0,No user reviews,0,0,0
804990,True,0,No user reviews,0,0,0
805000,True,0,1 user reviews,1,0,1
805010,True,0,4 user reviews,3,1,4
805020,True,0,2 user reviews,2,0,2
805030,True,0,2 user reviews,2,0,2
805040,True,0,2 user reviews,2,0,2
805060,True,0,1 user reviews,1,0,1
805070,True,0,1 user reviews,1,0,1
805080,True,0,No user reviews,0,0,0
805090,True,5,Mixed,5,6,11
805100,True,0,No user reviews,0,0,0
805110,True,0,No user reviews,0,0,0
805120,True,0,7 user reviews,3,4,7
805130,True,0,No user reviews,0,0,0
805140,True,0,No user reviews,0,0,0
805150,True,4,Mostly Negative,4,7,11
805180,True,0,No user reviews,0,0,0
805200,True,0,No user reviews,0,0,0
805210,True,0,No user reviews,0,0,0
805220,True,0,No user reviews,0,0,0
805250,True,0,No user reviews,0,0,0
805260,True,0,No user reviews,0,0,0
805270,True,0,No user reviews,0,0,0
805320,True,7,Positive,19,0,19
805330,True,0,No user reviews,0,0,0
805340,True,0,1 user reviews,1,0,1
805350,True,0,1 user reviews,1,0,1
805360,True,0,8 user reviews,6,2,8
805370,True,0,6 user reviews,6,0,6
805380,True,0,No user reviews,0,0,0
805400,True,6,Mostly Positive,10,4,14
805420,True,0,3 user reviews,3,0,3
805440,True,0,6 user reviews,4,2,6
805470,True,0,1 user reviews,1,0,1
805480,True,0,No user reviews,0,0,0
805500,True,6,Mostly Positive,9,3,12
805510,True,0,No user reviews,0,0,0
805520,True,0,3 user reviews,3,0,3
805540,True,0,No user reviews,0,0,0
805550,True,8,Very Positive,3045,447,3492
805560,True,0,No user reviews,0,0,0
805590,True,8,Very Positive,70,0,70
805610,True,0,8 user reviews,6,2,8
805620,True,0,No user reviews,0,0,0
805660,True,6,Mostly Positive,18,6,24
805690,True,0,1 user reviews,0,1,1
805710,True,0,6 user reviews,3,3,6
805720,True,0,2 user reviews,1,1,2
805730,True,0,No user reviews,0,0,0
805760,True,5,Mixed,5,5,10
805770,True,0,No user reviews,0,0,0
805790,True,0,1 user reviews,1,0,1
805800,True,0,No user reviews,0,0,0
805820,True,8,Very Positive,97,3,100
805840,True,0,3 user reviews,3,0,3
805850,True,0,No user reviews,0,0,0
805870,True,6,Mostly Positive,22,8,30
805880,True,0,7 user reviews,4,3,7
805890,True,0,No user reviews,0,0,0
805900,True,0,3 user reviews,3,0,3
805920,True,6,Mostly Positive,21,6,27
805930,True,0,No user reviews,0,0,0
805940,True,8,Very Positive,525,125,650
805950,True,0,No user reviews,0,0,0
805970,True,0,3 user reviews,3,0,3
805980,True,0,6 user reviews,3,3,6
805990,True,0,No user reviews,0,0,0
806000,True,0,No user reviews,0,0,0
806010,True,0,2 user reviews,1,1,2
806020,True,0,9 user reviews,7,2,9
806050,True,0,No user reviews,0,0,0
806100,True,6,Mostly Positive,9,3,12
806120,True,0,3 user reviews,3,0,3
806140,True,8,Very Positive,107,17,124
806150,True,0,No user reviews,0,0,0
806160,True,3,Negative,2,9,11
806180,True,0,No user reviews,0,0,0
806200,True,0,No user reviews,0,0,0
806220,True,5,Mixed,5,5,10
806230,True,0,7 user reviews,3,4,7
806240,True,0,1 user reviews,1,0,1
806280,True,0,No user reviews,0,0,0
806300,True,0,No user reviews,0,0,0
806320,True,0,No user reviews,0,0,0
806330,True,0,No user reviews,0,0,0
806350,True,0,4 user reviews,4,0,4
806360,True,0,No user reviews,0,0,0
806370,True,0,1 user reviews,1,0,1
806390,True,0,No user reviews,0,0,0
806410,True,0,No user reviews,0,0,0
806420,True,0,No user reviews,0,0,0
806430,True,0,No user reviews,0,0,0
806440,True,0,No user reviews,0,0,0
806450,True,0,No user reviews,0,0,0
806460,True,0,No user reviews,0,0,0
806470,True,0,8 user reviews,4,4,8
806480,True,0,No user reviews,0,0,0
806490,True,7,Positive,9,1,10
806500,True,0,No user reviews,0,0,0
806501,True,0,3 user reviews,0,3,3
806510,True,0,1 user reviews,1,0,1
806521,True,0,No user reviews,0,0,0
806530,True,6,Mostly Positive,20,8,28
806540,True,0,No user reviews,0,0,0
806550,True,0,1 user reviews,1,0,1
806560,True,0,No user reviews,0,0,0
806570,True,0,No user reviews,0,0,0
806580,True,7,Positive,10,0,10
806600,True,0,No user reviews,0,0,0
806610,True,0,7 user reviews,6,1,7
806630,True,0,5 user reviews,5,0,5
806650,True,0,No user reviews,0,0,0
806670,True,0,4 user reviews,4,0,4
806710,True,0,No user reviews,0,0,0
806711,True,0,No user reviews,0,0,0
806712,True,0,No user reviews,0,0,0
806713,True,0,No user reviews,0,0,0
806714,True,0,No user reviews,0,0,0
806715,True,0,No user reviews,0,0,0
806716,True,0,No user reviews,0,0,0
806720,True,0,6 user reviews,6,0,6
806740,True,0,4 user reviews,2,2,4
806750,True,0,No user reviews,0,0,0
806760,True,0,No user reviews,0,0,0
806770,True,6,Mostly Positive,22,7,29
806780,True,5,Mixed,70,38,108
806790,True,0,No user reviews,0,0,0
806800,True,0,No user reviews,0,0,0
806830,True,0,5 user reviews,1,4,5
806840,True,0,4 user reviews,4,0,4
806850,True,5,Mixed,8,6,14
806860,True,5,Mixed,56,46,102
806880,True,0,No user reviews,0,0,0
806900,True,0,3 user reviews,3,0,3
806910,True,0,9 user reviews,6,3,9
806920,True,0,No user reviews,0,0,0
806930,True,0,1 user reviews,0,1,1
806940,True,0,1 user reviews,0,1,1
806950,True,5,Mixed,166,97,263
806960,True,5,Mixed,8,6,14
806970,True,0,2 user reviews,1,1,2
806980,True,0,No user reviews,0,0,0
806990,True,0,2 user reviews,2,0,2
807020,True,0,2 user reviews,2,0,2
807040,True,0,No user reviews,0,0,0
807050,True,0,No user reviews,0,0,0
807060,True,6,Mostly Positive,24,9,33
807070,True,0,2 user reviews,2,0,2
807080,True,4,Mostly Negative,4,8,12
807100,True,0,No user reviews,0,0,0
807120,True,8,Very Positive,1278,206,1484
807140,True,0,2 user reviews,2,0,2
807150,True,0,No user reviews,0,0,0
807210,True,0,No user reviews,0,0,0
807230,True,5,Mixed,22,10,32
807250,True,0,No user reviews,0,0,0
807260,True,0,No user reviews,0,0,0
807261,True,0,No user reviews,0,0,0
807290,True,0,2 user reviews,2,0,2
807300,True,0,No user reviews,0,0,0
807310,True,0,No user reviews,0,0,0
807320,True,7,Positive,10,1,11
807340,True,0,2 user reviews,1,1,2
807420,True,0,No user reviews,0,0,0
807430,True,0,4 user reviews,2,2,4
807450,True,0,No user reviews,0,0,0
807460,True,0,No user reviews,0,0,0
807470,True,0,No user reviews,0,0,0
807480,True,0,No user reviews,0,0,0
807490,True,0,No user reviews,0,0,0
807500,True,0,No user reviews,0,0,0
807510,True,0,No user reviews,0,0,0
807520,True,0,3 user reviews,3,0,3
807530,True,0,2 user reviews,2,0,2
807540,True,0,1 user reviews,1,0,1
807550,True,0,No user reviews,0,0,0
807560,True,0,2 user reviews,2,0,2
807570,True,0,No user reviews,0,0,0
807620,True,0,2 user reviews,2,0,2
807630,True,0,2 user reviews,2,0,2
807640,True,0,1 user reviews,1,0,1
807650,True,0,No user reviews,0,0,0
807660,True,0,No user reviews,0,0,0
807661,True,0,No user reviews,0,0,0
807662,True,0,No user reviews,0,0,0
807663,True,0,No user reviews,0,0,0
807670,True,0,No user reviews,0,0,0
807671,True,0,No user reviews,0,0,0
807680,True,0,No user reviews,0,0,0
807681,True,0,No user reviews,0,0,0
807682,True,0,No user reviews,0,0,0
807683,True,0,No user reviews,0,0,0
807684,True,0,No user reviews,0,0,0
807685,True,0,No user reviews,0,0,0
807686,True,0,No user reviews,0,0,0
807687,True,0,No user reviews,0,0,0
807688,True,0,No user reviews,0,0,0
807689,True,0,No user reviews,0,0,0
807690,True,0,No user reviews,0,0,0
807710,True,0,No user reviews,0,0,0
807711,True,0,No user reviews,0,0,0
807712,True,0,No user reviews,0,0,0
807713,True,0,No user reviews,0,0,0
807714,True,0,No user reviews,0,0,0
807715,True,0,No user reviews,0,0,0
807716,True,0,No user reviews,0,0,0
807717,True,0,No user reviews,0,0,0
807718,True,0,No user reviews,0,0,0
807719,True,0,No user reviews,0,0,0
807720,True,0,No user reviews,0,0,0
807730,True,5,Mixed,8,4,12
807750,True,0,No user reviews,0,0,0
807751,True,0,No user reviews,0,0,0
807752,True,0,No user reviews,0,0,0
807753,True,0,No user reviews,0,0,0
807754,True,0,No user reviews,0,0,0
807755,True,0,No user reviews,0,0,0
807756,True,0,No user reviews,0,0,0
807757,True,0,No user reviews,0,0,0
807758,True,0,No user reviews,0,0,0
807759,True,0,No user reviews,0,0,0
807760,True,0,No user reviews,0,0,0
807761,True,0,No user reviews,0,0,0
807762,True,0,No user reviews,0,0,0
807763,True,0,No user reviews,0,0,0
807764,True,0,No user reviews,0,0,0
807765,True,0,No user reviews,0,0,0
807766,True,0,No user reviews,0,0,0
807770,True,0,6 user reviews,5,1,6
807780,True,0,3 user reviews,1,2,3
807790,True,5,Mixed,4,6,10
807800,True,0,1 user reviews,1,0,1
807810,True,0,No user reviews,0,0,0
807820,True,0,1 user reviews,0,1,1
807830,True,0,5 user reviews,0,5,5
807840,True,0,No user reviews,0,0,0
807850,True,0,1 user reviews,0,1,1
807860,True,0,2 user reviews,0,2,2
807870,True,0,1 user reviews,0,1,1
807880,True,0,5 user reviews,2,3,5
807890,True,0,2 user reviews,0,2,2
807900,True,0,No user reviews,0,0,0
807910,True,0,No user reviews,0,0,0
807920,True,5,Mixed,53,40,93
807930,True,0,1 user reviews,0,1,1
807940,True,0,3 user reviews,1,2,3
807950,True,0,2 user reviews,0,2,2
807960,True,0,1 user reviews,1,0,1
807990,True,0,No user reviews,0,0,0
808020,True,0,1 user reviews,0,1,1
808080,True,8,Very Positive,131,16,147
808090,True,5,Mixed,8,5,13
808100,True,8,Very Positive,152,23,175
808110,True,0,No user reviews,0,0,0
808120,True,0,2 user reviews,1,1,2
808130,True,0,8 user reviews,4,4,8
808140,True,0,No user reviews,0,0,0
808150,True,0,No user reviews,0,0,0
808160,True,6,Mostly Positive,7,3,10
808190,True,0,1 user reviews,1,0,1
808210,True,0,7 user reviews,5,2,7
808220,True,0,9 user reviews,8,1,9
808230,True,0,No user reviews,0,0,0
808270,True,0,2 user reviews,0,2,2
808290,True,0,2 user reviews,1,1,2
808360,True,0,5 user reviews,5,0,5
808390,True,0,No user reviews,0,0,0
808400,True,0,1 user reviews,1,0,1
808410,True,0,2 user reviews,2,0,2
808420,True,0,4 user reviews,1,3,4
808430,True,0,No user reviews,0,0,0
808440,True,0,1 user reviews,1,0,1
808450,True,0,6 user reviews,5,1,6
808470,True,0,No user reviews,0,0,0
808540,True,0,9 user reviews,5,4,9
808580,True,0,3 user reviews,3,0,3
808590,True,0,No user reviews,0,0,0
808600,True,0,No user reviews,0,0,0
808610,True,0,No user reviews,0,0,0
808620,True,0,No user reviews,0,0,0
808630,True,0,No user reviews,0,0,0
808640,True,0,No user reviews,0,0,0
808650,True,0,No user reviews,0,0,0
808660,True,0,No user reviews,0,0,0
808670,True,0,No user reviews,0,0,0
808680,True,0,No user reviews,0,0,0
808690,True,0,No user reviews,0,0,0
808700,True,0,No user reviews,0,0,0
808710,True,0,No user reviews,0,0,0
808720,True,0,1 user reviews,0,1,1
808730,True,0,No user reviews,0,0,0
808740,True,0,No user reviews,0,0,0
808750,True,0,1 user reviews,0,1,1
808760,True,0,No user reviews,0,0,0
808770,True,5,Mixed,9,4,13
808790,True,0,No user reviews,0,0,0
808800,True,7,Positive,30,5,35
808810,True,0,No user reviews,0,0,0
808870,True,0,No user reviews,0,0,0
808880,True,0,No user reviews,0,0,0
808890,True,0,No user reviews,0,0,0
808900,True,0,No user reviews,0,0,0
808901,True,0,No user reviews,0,0,0
808902,True,0,No user reviews,0,0,0
808903,True,0,No user reviews,0,0,0
808910,True,8,Very Positive,596,95,691
808931,True,0,1 user reviews,1,0,1
808932,True,0,4 user reviews,3,1,4
808934,True,0,3 user reviews,3,0,3
808935,True,0,1 user reviews,1,0,1
808936,True,0,No user reviews,0,0,0
808937,True,0,No user reviews,0,0,0
808938,True,0,No user reviews,0,0,0
808939,True,0,No user reviews,0,0,0
808940,True,0,No user reviews,0,0,0
808941,True,0,No user reviews,0,0,0
808950,True,0,5 user reviews,4,1,5
808960,True,0,No user reviews,0,0,0
808980,True,0,7 user reviews,7,0,7
808990,True,0,4 user reviews,3,1,4
809000,True,5,Mixed,18,16,34
809010,True,0,No user reviews,0,0,0
809020,True,9,Overwhelmingly Positive,477,23,500
809040,True,0,No user reviews,0,0,0
809050,True,5,Mixed,12,7,19
809060,True,0,No user reviews,0,0,0
809070,True,0,No user reviews,0,0,0
809080,True,0,6 user reviews,1,5,6
809100,True,0,No user reviews,0,0,0
809140,True,8,Very Positive,999,182,1181
809150,True,0,No user reviews,0,0,0
809180,True,0,4 user reviews,4,0,4
809190,True,0,No user reviews,0,0,0
809200,True,0,4 user reviews,3,1,4
809210,True,6,Mostly Positive,45,12,57
809220,True,0,1 user reviews,0,1,1
809230,True,8,Very Positive,374,83,457
809240,True,6,Mostly Positive,10,4,14
809250,True,0,No user reviews,0,0,0
809260,True,0,1 user reviews,1,0,1
809270,True,0,4 user reviews,2,2,4
809280,True,5,Mixed,57,44,101
809290,True,0,No user reviews,0,0,0
809300,True,0,No user reviews,0,0,0
809310,True,7,Positive,29,5,34
809320,True,0,3 user reviews,3,0,3
809330,True,0,1 user reviews,1,0,1
809340,True,5,Mixed,8,4,12
809350,True,0,No user reviews,0,0,0
809360,True,0,7 user reviews,6,1,7
809380,True,0,No user reviews,0,0,0
809410,True,7,Positive,9,2,11
809430,True,0,No user reviews,0,0,0
809440,True,8,Very Positive,183,28,211
809450,True,0,2 user reviews,0,2,2
809460,True,0,2 user reviews,2,0,2
809470,True,0,3 user reviews,1,2,3
809480,True,0,2 user reviews,1,1,2
809490,True,0,5 user reviews,2,3,5
809500,True,0,5 user reviews,2,3,5
809530,True,7,Positive,20,3,23
809540,True,8,Very Positive,109,13,122
809550,True,0,No user reviews,0,0,0
809570,True,0,1 user reviews,1,0,1
809580,True,5,Mixed,19,10,29
809600,True,0,No user reviews,0,0,0
809610,True,0,No user reviews,0,0,0
809630,True,0,No user reviews,0,0,0
809631,True,0,No user reviews,0,0,0
809632,True,0,No user reviews,0,0,0
809640,True,0,No user reviews,0,0,0
809650,True,0,No user reviews,0,0,0
809670,True,0,No user reviews,0,0,0
809680,True,7,Positive,17,0,17
809690,True,0,No user reviews,0,0,0
809700,True,0,1 user reviews,1,0,1
809720,True,6,Mostly Positive,148,38,186
809730,True,6,Mostly Positive,55,16,71
809740,True,0,No user reviews,0,0,0
809760,True,0,1 user reviews,0,1,1
809770,True,0,8 user reviews,2,6,8
809780,True,0,No user reviews,0,0,0
809790,True,0,8 user reviews,3,5,8
809800,True,0,1 user reviews,0,1,1
809820,True,0,No user reviews,0,0,0
809830,True,0,No user reviews,0,0,0
809840,True,5,Mixed,7,5,12
809850,True,7,Positive,35,5,40
809860,True,0,No user reviews,0,0,0
809870,True,8,Very Positive,74,1,75
809880,True,8,Very Positive,144,16,160
809890,True,6,Mostly Positive,181,63,244
809900,True,0,6 user reviews,5,1,6
809910,True,0,No user reviews,0,0,0
809930,True,0,No user reviews,0,0,0
809950,True,0,8 user reviews,7,1,8
809960,True,8,Very Positive,47,7,54
809970,True,0,No user reviews,0,0,0
809980,True,0,No user reviews,0,0,0
809990,True,0,No user reviews,0,0,0
810000,True,0,5 user reviews,5,0,5
810010,True,0,No user reviews,0,0,0
810020,True,0,No user reviews,0,0,0
810040,True,8,Very Positive,184,16,200
810050,True,0,4 user reviews,2,2,4
810060,True,0,6 user reviews,4,2,6
810070,True,0,No user reviews,0,0,0
810080,True,0,1 user reviews,0,1,1
810090,True,0,No user reviews,0,0,0
810100,True,0,No user reviews,0,0,0
810110,True,0,No user reviews,0,0,0
810140,True,0,No user reviews,0,0,0
810150,True,0,No user reviews,0,0,0
810190,True,0,No user reviews,0,0,0
810200,True,0,No user reviews,0,0,0
810220,True,0,No user reviews,0,0,0
810230,True,0,No user reviews,0,0,0
810240,True,0,No user reviews,0,0,0
810250,True,0,3 user reviews,2,1,3
810260,True,0,No user reviews,0,0,0
810280,True,0,No user reviews,0,0,0
810290,True,0,No user reviews,0,0,0
810300,True,0,No user reviews,0,0,0
810310,True,0,No user reviews,0,0,0
810320,True,0,No user reviews,0,0,0
810330,True,0,5 user reviews,4,1,5
810340,True,0,6 user reviews,4,2,6
810360,True,0,7 user reviews,5,2,7
810370,True,0,No user reviews,0,0,0
810380,True,7,Positive,10,0,10
810390,True,0,1 user reviews,1,0,1
810420,True,0,3 user reviews,3,0,3
810450,True,0,4 user reviews,4,0,4
810460,True,5,Mixed,17,14,31
810470,True,7,Positive,12,2,14
810480,True,0,No user reviews,0,0,0
810490,True,0,No user reviews,0,0,0
810500,True,8,Very Positive,60,8,68
810510,True,0,7 user reviews,4,3,7
810520,True,0,No user reviews,0,0,0
810530,True,0,2 user reviews,2,0,2
810540,True,0,3 user reviews,1,2,3
810570,True,0,3 user reviews,3,0,3
810580,True,0,2 user reviews,2,0,2
810590,True,7,Positive,9,2,11
810600,True,0,3 user reviews,3,0,3
810610,True,0,1 user reviews,1,0,1
810630,True,0,7 user reviews,6,1,7
810640,True,7,Positive,26,3,29
810650,True,0,3 user reviews,0,3,3
810660,True,8,Very Positive,53,6,59
810670,True,6,Mostly Positive,75,29,104
810680,True,0,4 user reviews,3,1,4
810690,True,0,No user reviews,0,0,0
810700,True,0,2 user reviews,1,1,2
810720,True,0,2 user reviews,2,0,2
810740,True,0,No user reviews,0,0,0
810760,True,0,No user reviews,0,0,0
810770,True,5,Mixed,9,7,16
810780,True,6,Mostly Positive,25,8,33
810800,True,0,9 user reviews,6,3,9
810820,True,0,No user reviews,0,0,0
810830,True,0,No user reviews,0,0,0
810840,True,0,No user reviews,0,0,0
810850,True,0,2 user reviews,2,0,2
810860,True,0,No user reviews,0,0,0
810870,True,0,No user reviews,0,0,0
810880,True,0,No user reviews,0,0,0
810890,True,0,1 user reviews,1,0,1
810900,True,0,1 user reviews,1,0,1
810910,True,0,No user reviews,0,0,0
810920,True,0,2 user reviews,2,0,2
810930,True,0,No user reviews,0,0,0
810940,True,0,No user reviews,0,0,0
810950,True,0,No user reviews,0,0,0
810960,True,0,No user reviews,0,0,0
810970,True,0,2 user reviews,2,0,2
810980,True,0,No user reviews,0,0,0
810990,True,0,No user reviews,0,0,0
811000,True,0,No user reviews,0,0,0
811010,True,0,No user reviews,0,0,0
811020,True,0,1 user reviews,1,0,1
811030,True,0,No user reviews,0,0,0
811040,True,0,3 user reviews,3,0,3
811050,True,0,No user reviews,0,0,0
811070,True,0,5 user reviews,5,0,5
811080,True,0,4 user reviews,1,3,4
811090,True,0,No user reviews,0,0,0
811100,True,0,No user reviews,0,0,0
811110,True,7,Positive,10,0,10
811130,True,0,No user reviews,0,0,0
811160,True,0,1 user reviews,1,0,1
811170,True,5,Mixed,16,14,30
811180,True,0,3 user reviews,1,2,3
811190,True,0,4 user reviews,1,3,4
811200,True,0,No user reviews,0,0,0
811210,True,4,Mostly Negative,5,15,20
811220,True,0,No user reviews,0,0,0
811230,True,0,1 user reviews,1,0,1
811240,True,6,Mostly Positive,7,3,10
811250,True,0,6 user reviews,1,5,6
811270,True,7,Positive,39,4,43
811290,True,7,Positive,10,1,11
811300,True,0,3 user reviews,2,1,3
811310,True,5,Mixed,15,19,34
811320,True,8,Very Positive,169,20,189
811360,True,0,No user reviews,0,0,0
811430,True,0,No user reviews,0,0,0
811431,True,0,No user reviews,0,0,0
811440,True,0,2 user reviews,2,0,2
811450,True,0,2 user reviews,1,1,2
811460,True,7,Positive,10,0,10
811470,True,0,No user reviews,0,0,0
811480,True,0,8 user reviews,5,3,8
811500,True,0,No user reviews,0,0,0
811540,True,0,No user reviews,0,0,0
811550,True,0,No user reviews,0,0,0
811620,True,7,Positive,8,2,10
811630,True,0,5 user reviews,2,3,5
811640,True,0,3 user reviews,3,0,3
811650,True,0,No user reviews,0,0,0
811660,True,0,No user reviews,0,0,0
811670,True,0,No user reviews,0,0,0
811690,True,0,1 user reviews,0,1,1
811710,True,0,2 user reviews,2,0,2
811720,True,6,Mostly Positive,28,11,39
811750,True,0,No user reviews,0,0,0
811770,True,0,No user reviews,0,0,0
811790,True,0,No user reviews,0,0,0
811800,True,0,No user reviews,0,0,0
811840,True,7,Positive,43,1,44
811850,True,0,No user reviews,0,0,0
811860,True,0,No user reviews,0,0,0
811870,True,8,Very Positive,129,7,136
811880,True,5,Mixed,82,92,174
811890,True,8,Very Positive,118,13,131
811900,True,0,7 user reviews,4,3,7
811910,True,7,Positive,12,0,12
811940,True,0,No user reviews,0,0,0
811950,True,0,4 user reviews,2,2,4
812000,True,0,No user reviews,0,0,0
812020,True,6,Mostly Positive,31,13,44
812030,True,0,No user reviews,0,0,0
812040,True,6,Mostly Positive,527,173,700
812050,True,0,No user reviews,0,0,0
812060,True,0,No user reviews,0,0,0
812070,True,6,Mostly Positive,17,5,22
812090,True,0,6 user reviews,6,0,6
812100,True,0,4 user reviews,3,1,4
812110,True,5,Mixed,11,5,16
812120,True,0,No user reviews,0,0,0
812130,True,0,3 user reviews,3,0,3
812140,True,8,Very Positive,24074,2674,26748
812160,True,6,Mostly Positive,19,6,25
812170,True,0,2 user reviews,2,0,2
812180,True,0,4 user reviews,1,3,4
812190,True,0,7 user reviews,7,0,7
812200,True,0,No user reviews,0,0,0
812210,True,0,No user reviews,0,0,0
812220,True,0,No user reviews,0,0,0
812230,True,0,No user reviews,0,0,0
812240,True,0,No user reviews,0,0,0
812250,True,0,No user reviews,0,0,0
812260,True,0,No user reviews,0,0,0
812270,True,0,No user reviews,0,0,0
812280,True,0,No user reviews,0,0,0
812320,True,0,No user reviews,0,0,0
812360,True,0,3 user reviews,3,0,3
812380,True,0,No user reviews,0,0,0
812390,True,0,1 user reviews,0,1,1
812400,True,0,No user reviews,0,0,0
812410,True,8,Very Positive,74,9,83
812430,True,0,No user reviews,0,0,0
812440,True,0,No user reviews,0,0,0
812450,True,0,3 user reviews,2,1,3
812460,True,0,No user reviews,0,0,0
812470,True,0,1 user reviews,0,1,1
812480,True,0,No user reviews,0,0,0
812490,True,0,No user reviews,0,0,0
812500,True,0,No user reviews,0,0,0
812501,True,0,No user reviews,0,0,0
812502,True,0,No user reviews,0,0,0
812503,True,0,No user reviews,0,0,0
812510,True,0,No user reviews,0,0,0
812530,True,0,No user reviews,0,0,0
812550,True,6,Mostly Positive,67,23,90
812560,True,5,Mixed,15,10,25
812580,True,0,8 user reviews,7,1,8
812590,True,0,No user reviews,0,0,0
812610,True,0,No user reviews,0,0,0
812650,True,7,Positive,14,2,16
812690,True,0,2 user reviews,2,0,2
812700,True,0,No user reviews,0,0,0
812710,True,0,No user reviews,0,0,0
812711,True,0,No user reviews,0,0,0
812712,True,0,No user reviews,0,0,0
812713,True,0,No user reviews,0,0,0
812714,True,0,No user reviews,0,0,0
812715,True,0,No user reviews,0,0,0
812718,True,0,No user reviews,0,0,0
812720,True,0,No user reviews,0,0,0
812723,True,0,No user reviews,0,0,0
812724,True,0,No user reviews,0,0,0
812725,True,0,No user reviews,0,0,0
812727,True,0,No user reviews,0,0,0
812740,True,0,No user reviews,0,0,0
812750,True,0,1 user reviews,1,0,1
812760,True,0,1 user reviews,0,1,1
812770,True,0,9 user reviews,6,3,9
812780,True,0,No user reviews,0,0,0
812800,True,7,Positive,15,0,15
812810,True,0,6 user reviews,6,0,6
812820,True,0,No user reviews,0,0,0
812830,True,0,No user reviews,0,0,0
812840,True,8,Very Positive,99,3,102
812850,True,0,5 user reviews,2,3,5
812860,True,7,Positive,9,2,11
812870,True,6,Mostly Positive,83,32,115
812890,True,0,1 user reviews,1,0,1
812900,True,0,1 user reviews,1,0,1
812930,True,0,8 user reviews,6,2,8
812940,True,0,1 user reviews,0,1,1
812960,True,6,Mostly Positive,19,6,25
812970,True,0,1 user reviews,1,0,1
812980,True,0,9 user reviews,7,2,9
813020,True,0,1 user reviews,1,0,1
813030,True,6,Mostly Positive,7,3,10
813080,True,0,No user reviews,0,0,0
813090,True,0,No user reviews,0,0,0
813091,True,0,No user reviews,0,0,0
813100,True,0,No user reviews,0,0,0
813110,True,0,1 user reviews,0,1,1
813120,True,0,No user reviews,0,0,0
813150,True,0,7 user reviews,4,3,7
813170,True,5,Mixed,7,10,17
813200,True,0,No user reviews,0,0,0
813210,True,0,No user reviews,0,0,0
813240,True,0,3 user reviews,1,2,3
813250,True,0,7 user reviews,7,0,7
813260,True,0,1 user reviews,1,0,1
813280,True,0,1 user reviews,0,1,1
813290,True,0,No user reviews,0,0,0
813300,True,0,1 user reviews,1,0,1
813310,True,0,No user reviews,0,0,0
813320,True,0,No user reviews,0,0,0
813330,True,0,No user reviews,0,0,0
813350,True,0,No user reviews,0,0,0
813360,True,0,No user reviews,0,0,0
813370,True,0,1 user reviews,1,0,1
813380,True,0,No user reviews,0,0,0
813390,True,0,7 user reviews,6,1,7
813400,True,0,No user reviews,0,0,0
813410,True,7,Positive,17,0,17
813420,True,7,Positive,36,1,37
813440,True,0,No user reviews,0,0,0
813450,True,7,Positive,16,3,19
813460,True,7,Positive,16,2,18
813480,True,7,Positive,11,1,12
813490,True,0,No user reviews,0,0,0
813491,True,0,No user reviews,0,0,0
813500,True,0,No user reviews,0,0,0
813510,True,0,No user reviews,0,0,0
813520,True,0,No user reviews,0,0,0
813530,True,7,Positive,22,2,24
813540,True,8,Very Positive,78,15,93
813560,True,0,No user reviews,0,0,0
813590,True,7,Positive,11,1,12
813610,True,0,No user reviews,0,0,0
813611,True,0,No user reviews,0,0,0
813612,True,0,No user reviews,0,0,0
813613,True,0,No user reviews,0,0,0
813614,True,0,No user reviews,0,0,0
813615,True,0,No user reviews,0,0,0
813616,True,0,No user reviews,0,0,0
813620,True,0,No user reviews,0,0,0
813621,True,0,No user reviews,0,0,0
813622,True,0,No user reviews,0,0,0
813623,True,0,No user reviews,0,0,0
813624,True,0,No user reviews,0,0,0
813625,True,0,No user reviews,0,0,0
813626,True,0,No user reviews,0,0,0
813627,True,0,No user reviews,0,0,0
813630,True,9,Overwhelmingly Positive,2817,90,2907
813650,True,7,Positive,35,3,38
813700,True,8,Very Positive,100,13,113
813730,True,0,2 user reviews,2,0,2
813740,True,0,No user reviews,0,0,0
813750,True,0,No user reviews,0,0,0
813751,True,0,No user reviews,0,0,0
813752,True,0,No user reviews,0,0,0
813753,True,0,No user reviews,0,0,0
813754,True,0,No user reviews,0,0,0
813755,True,0,No user reviews,0,0,0
813756,True,0,No user reviews,0,0,0
813757,True,0,No user reviews,0,0,0
813758,True,0,No user reviews,0,0,0
813759,True,0,No user reviews,0,0,0
813760,True,0,No user reviews,0,0,0
813761,True,0,No user reviews,0,0,0
813762,True,0,No user reviews,0,0,0
813763,True,0,No user reviews,0,0,0
813764,True,0,No user reviews,0,0,0
813765,True,0,No user reviews,0,0,0
813766,True,0,No user reviews,0,0,0
813767,True,0,No user reviews,0,0,0
813768,True,0,No user reviews,0,0,0
813769,True,0,No user reviews,0,0,0
813770,True,0,No user reviews,0,0,0
813771,True,0,No user reviews,0,0,0
813780,True,8,Very Positive,19367,1393,20760
813790,True,0,No user reviews,0,0,0
813791,True,0,No user reviews,0,0,0
813792,True,0,No user reviews,0,0,0
813793,True,0,No user reviews,0,0,0
813794,True,0,No user reviews,0,0,0
813795,True,0,No user reviews,0,0,0
813796,True,0,No user reviews,0,0,0
813797,True,0,No user reviews,0,0,0
813798,True,0,No user reviews,0,0,0
813799,True,0,No user reviews,0,0,0
813800,True,0,No user reviews,0,0,0
813801,True,0,No user reviews,0,0,0
813802,True,0,No user reviews,0,0,0
813803,True,0,No user reviews,0,0,0
813804,True,0,No user reviews,0,0,0
813805,True,0,No user reviews,0,0,0
813806,True,0,No user reviews,0,0,0
813807,True,0,No user reviews,0,0,0
813808,True,0,No user reviews,0,0,0
813809,True,0,No user reviews,0,0,0
813810,True,0,No user reviews,0,0,0
813820,True,7,Positive,12,1,13
813840,True,0,3 user reviews,2,1,3
813850,True,0,No user reviews,0,0,0
813860,True,0,No user reviews,0,0,0
813870,True,0,No user reviews,0,0,0
813900,True,0,2 user reviews,0,2,2
813920,True,0,No user reviews,0,0,0
813930,True,5,Mixed,10,5,15
813950,True,0,No user reviews,0,0,0
813970,True,0,4 user reviews,3,1,4
814010,True,0,No user reviews,0,0,0
814020,True,0,2 user reviews,2,0,2
814030,True,6,Mostly Positive,11,3,14
814060,True,0,1 user reviews,1,0,1
814070,True,0,1 user reviews,1,0,1
814100,True,0,1 user reviews,1,0,1
814110,True,5,Mixed,14,8,22
814140,True,0,4 user reviews,2,2,4
814190,True,0,2 user reviews,1,1,2
814200,True,5,Mixed,10,6,16
814210,True,0,2 user reviews,1,1,2
814230,True,0,1 user reviews,1,0,1
814251,True,0,4 user reviews,1,3,4
814300,True,7,Positive,24,1,25
814310,True,0,7 user reviews,3,4,7
814320,True,0,1 user reviews,1,0,1
814330,True,0,No user reviews,0,0,0
814340,True,4,Mostly Negative,4,8,12
814360,True,7,Positive,40,1,41
814370,True,9,Overwhelmingly Positive,876,34,910
814380,True,8,Very Positive,22355,1937,24292
814390,True,0,No user reviews,0,0,0
814400,True,5,Mixed,26,13,39
814420,True,7,Positive,10,0,10
814440,True,0,No user reviews,0,0,0
814480,True,6,Mostly Positive,84,32,116
814510,True,0,1 user reviews,1,0,1
814520,True,0,No user reviews,0,0,0
814530,True,8,Very Positive,76,12,88
814540,True,8,Very Positive,1202,95,1297
814550,True,0,No user reviews,0,0,0
814560,True,0,1 user reviews,1,0,1
814570,True,0,2 user reviews,1,1,2
814580,True,0,1 user reviews,1,0,1
814590,True,0,4 user reviews,2,2,4
814600,True,0,4 user reviews,3,1,4
814610,True,6,Mostly Positive,9,3,12
814620,True,0,1 user reviews,1,0,1
814630,True,0,No user reviews,0,0,0
814640,True,0,No user reviews,0,0,0
814650,True,0,6 user reviews,5,1,6
814660,True,0,6 user reviews,3,3,6
814680,True,0,No user reviews,0,0,0
814700,True,0,No user reviews,0,0,0
814710,True,0,1 user reviews,1,0,1
814720,True,0,No user reviews,0,0,0
814730,True,0,No user reviews,0,0,0
814740,True,8,Very Positive,142,35,177
814750,True,0,No user reviews,0,0,0
814760,True,0,No user reviews,0,0,0
814770,True,0,9 user reviews,3,6,9
814780,True,0,No user reviews,0,0,0
814790,True,0,No user reviews,0,0,0
814800,True,0,No user reviews,0,0,0
814870,True,0,3 user reviews,2,1,3
814890,True,0,2 user reviews,2,0,2
814900,True,5,Mixed,11,11,22
814930,True,0,No user reviews,0,0,0
814940,True,0,No user reviews,0,0,0
814960,True,0,No user reviews,0,0,0
814990,True,0,1 user reviews,1,0,1
815000,True,7,Positive,30,7,37
815010,True,0,9 user reviews,8,1,9
815020,True,0,No user reviews,0,0,0
815030,True,0,No user reviews,0,0,0
815040,True,0,No user reviews,0,0,0
815060,True,0,No user reviews,0,0,0
815070,True,0,3 user reviews,2,1,3
815080,True,5,Mixed,11,11,22
815090,True,0,No user reviews,0,0,0
815100,True,0,No user reviews,0,0,0
815110,True,0,No user reviews,0,0,0
815120,True,0,No user reviews,0,0,0
815150,True,8,Very Positive,55,1,56
815160,True,0,2 user reviews,2,0,2
815170,True,0,3 user reviews,0,3,3
815210,True,5,Mixed,20,14,34
815240,True,0,3 user reviews,0,3,3
815250,True,0,5 user reviews,1,4,5
815260,True,0,No user reviews,0,0,0
815280,True,0,5 user reviews,4,1,5
815290,True,5,Mixed,13,7,20
815300,True,0,1 user reviews,1,0,1
815320,True,5,Mixed,11,5,16
815330,True,0,No user reviews,0,0,0
815340,True,0,No user reviews,0,0,0
815350,True,0,No user reviews,0,0,0
815351,True,0,2 user reviews,1,1,2
815352,True,0,1 user reviews,1,0,1
815353,True,0,No user reviews,0,0,0
815354,True,0,3 user reviews,3,0,3
815355,True,0,1 user reviews,1,0,1
815356,True,0,2 user reviews,2,0,2
815357,True,0,No user reviews,0,0,0
815358,True,0,No user reviews,0,0,0
815359,True,0,No user reviews,0,0,0
815360,True,0,8 user reviews,3,5,8
815370,True,8,Very Positive,6174,1010,7184
815380,True,7,Positive,36,6,42
815390,True,0,8 user reviews,5,3,8
815410,True,0,7 user reviews,7,0,7
815420,True,0,2 user reviews,1,1,2
815440,True,6,Mostly Positive,17,7,24
815450,True,8,Very Positive,119,7,126
815460,True,5,Mixed,406,351,757
815480,True,0,1 user reviews,0,1,1
815490,True,0,No user reviews,0,0,0
815540,True,0,3 user reviews,3,0,3
815550,True,0,3 user reviews,3,0,3
815560,True,0,3 user reviews,2,1,3
815570,True,0,4 user reviews,3,1,4
815580,True,7,Positive,14,1,15
815600,True,0,No user reviews,0,0,0
815610,True,0,No user reviews,0,0,0
815620,True,0,1 user reviews,0,1,1
815630,True,0,2 user reviews,2,0,2
815640,True,0,No user reviews,0,0,0
815660,True,7,Positive,9,1,10
815680,True,0,No user reviews,0,0,0
815690,True,0,1 user reviews,1,0,1
815700,True,0,No user reviews,0,0,0
815710,True,0,No user reviews,0,0,0
815720,True,0,No user reviews,0,0,0
815730,True,0,3 user reviews,2,1,3
815740,True,0,No user reviews,0,0,0
815750,True,0,No user reviews,0,0,0
815760,True,0,6 user reviews,6,0,6
815770,True,0,7 user reviews,6,1,7
815780,True,8,Very Positive,959,138,1097
815790,True,0,No user reviews,0,0,0
815800,True,0,No user reviews,0,0,0
815810,True,0,1 user reviews,1,0,1
815820,True,0,No user reviews,0,0,0
815830,True,7,Positive,10,1,11
815840,True,0,2 user reviews,1,1,2
815860,True,0,7 user reviews,4,3,7
815940,True,0,No user reviews,0,0,0
815950,True,7,Positive,9,1,10
815980,True,0,1 user reviews,1,0,1
816000,True,0,No user reviews,0,0,0
816020,True,5,Mixed,1896,894,2790
816030,True,0,1 user reviews,1,0,1
816050,True,0,No user reviews,0,0,0
816060,True,5,Mixed,5,5,10
816070,True,0,No user reviews,0,0,0
816080,True,0,No user reviews,0,0,0
816090,True,6,Mostly Positive,2150,754,2904
816110,True,0,No user reviews,0,0,0
816140,True,0,No user reviews,0,0,0
816150,True,0,No user reviews,0,0,0
816160,True,0,8 user reviews,5,3,8
816170,True,0,No user reviews,0,0,0
816180,True,0,5 user reviews,4,1,5
816190,True,0,7 user reviews,6,1,7
816200,True,0,No user reviews,0,0,0
816210,True,0,4 user reviews,3,1,4
816220,True,0,7 user reviews,3,4,7
816240,True,0,1 user reviews,1,0,1
816250,True,7,Positive,13,1,14
816270,True,8,Very Positive,52,10,62
816280,True,0,2 user reviews,2,0,2
816290,True,0,No user reviews,0,0,0
816300,True,0,No user reviews,0,0,0
816310,True,0,No user reviews,0,0,0
816320,True,0,No user reviews,0,0,0
816330,True,5,Mixed,13,9,22
816340,True,8,Very Positive,680,42,722
816350,True,0,No user reviews,0,0,0
816360,True,0,2 user reviews,1,1,2
816370,True,0,No user reviews,0,0,0
816380,True,0,2 user reviews,1,1,2
816390,True,0,1 user reviews,1,0,1
816400,True,0,No user reviews,0,0,0
816410,True,0,1 user reviews,1,0,1
816430,True,6,Mostly Positive,23,8,31
816440,True,0,No user reviews,0,0,0
816470,True,0,No user reviews,0,0,0
816490,True,8,Very Positive,138,15,153
816500,True,7,Positive,9,1,10
816510,True,0,No user reviews,0,0,0
816540,True,0,No user reviews,0,0,0
816550,True,0,2 user reviews,1,1,2
816560,True,5,Mixed,8,5,13
816570,True,0,1 user reviews,0,1,1
816580,True,0,6 user reviews,3,3,6
816590,True,0,No user reviews,0,0,0
816600,True,0,No user reviews,0,0,0
816610,True,0,2 user reviews,2,0,2
816620,True,0,No user reviews,0,0,0
816630,True,0,4 user reviews,3,1,4
816650,True,0,7 user reviews,5,2,7
816660,True,0,2 user reviews,1,1,2
816670,True,0,6 user reviews,2,4,6
816710,True,5,Mixed,12,6,18
816720,True,7,Positive,8,2,10
816730,True,0,No user reviews,0,0,0
816760,True,0,8 user reviews,7,1,8
816770,True,0,9 user reviews,8,1,9
816780,True,7,Positive,10,1,11
816790,True,0,4 user reviews,3,1,4
816810,True,0,No user reviews,0,0,0
816830,True,7,Positive,11,1,12
816840,True,0,1 user reviews,0,1,1
816850,True,0,No user reviews,0,0,0
816870,True,0,8 user reviews,7,1,8
816880,True,0,No user reviews,0,0,0
816890,True,0,1 user reviews,1,0,1
816920,True,0,5 user reviews,1,4,5
816930,True,0,No user reviews,0,0,0
816940,True,0,No user reviews,0,0,0
816950,True,0,No user reviews,0,0,0
816970,True,0,No user reviews,0,0,0
816980,True,0,No user reviews,0,0,0
816981,True,0,1 user reviews,1,0,1
816982,True,0,1 user reviews,1,0,1
816990,True,0,6 user reviews,3,3,6
817020,True,0,No user reviews,0,0,0
817050,True,0,No user reviews,0,0,0
817060,True,0,No user reviews,0,0,0
817070,True,0,No user reviews,0,0,0
817080,True,0,No user reviews,0,0,0
817090,True,0,No user reviews,0,0,0
817100,True,0,No user reviews,0,0,0
817110,True,0,1 user reviews,0,1,1
817120,True,0,No user reviews,0,0,0
817130,True,5,Mixed,613,311,924
817150,True,0,2 user reviews,1,1,2
817160,True,0,1 user reviews,1,0,1
817170,True,0,No user reviews,0,0,0
817190,True,7,Positive,27,4,31
817200,True,0,7 user reviews,2,5,7
817220,True,0,5 user reviews,5,0,5
817230,True,8,Very Positive,71,8,79
817240,True,0,No user reviews,0,0,0
817250,True,0,1 user reviews,1,0,1
817260,True,0,1 user reviews,1,0,1
817270,True,0,1 user reviews,0,1,1
817300,True,0,No user reviews,0,0,0
817310,True,0,5 user reviews,0,5,5
817320,True,0,No user reviews,0,0,0
817360,True,0,No user reviews,0,0,0
817370,True,0,No user reviews,0,0,0
817390,True,0,6 user reviews,3,3,6
817410,True,0,No user reviews,0,0,0
817440,True,0,No user reviews,0,0,0
817450,True,0,No user reviews,0,0,0
817460,True,5,Mixed,9,5,14
817470,True,0,2 user reviews,2,0,2
817480,True,0,No user reviews,0,0,0
817490,True,7,Positive,12,0,12
817510,True,5,Mixed,149,85,234
817530,True,0,5 user reviews,4,1,5
817540,True,8,Very Positive,437,74,511
817550,True,6,Mostly Positive,126,37,163
817560,True,0,3 user reviews,2,1,3
817570,True,0,No user reviews,0,0,0
817600,True,0,No user reviews,0,0,0
817610,True,0,2 user reviews,1,1,2
817620,True,0,No user reviews,0,0,0
817630,True,0,2 user reviews,1,1,2
817640,True,0,4 user reviews,1,3,4
817660,True,0,7 user reviews,5,2,7
817670,True,0,No user reviews,0,0,0
817680,True,4,Mostly Negative,5,11,16
817710,True,0,2 user reviews,2,0,2
817720,True,5,Mixed,36,22,58
817730,True,0,No user reviews,0,0,0
817750,True,0,No user reviews,0,0,0
817760,True,0,2 user reviews,2,0,2
817770,True,5,Mixed,11,6,17
817800,True,0,No user reviews,0,0,0
817810,True,0,No user reviews,0,0,0
817820,True,0,3 user reviews,3,0,3
817840,True,8,Very Positive,459,41,500
817850,True,0,No user reviews,0,0,0
817860,True,7,Positive,40,0,40
817880,True,0,No user reviews,0,0,0
817890,True,0,No user reviews,0,0,0
817900,True,0,No user reviews,0,0,0
817901,True,0,No user reviews,0,0,0
817902,True,0,No user reviews,0,0,0
817910,True,0,No user reviews,0,0,0
817920,True,0,1 user reviews,1,0,1
817950,True,0,3 user reviews,1,2,3
817970,True,0,No user reviews,0,0,0
817980,True,0,3 user reviews,3,0,3
818000,True,0,No user reviews,0,0,0
818030,True,0,4 user reviews,1,3,4
818040,True,0,No user reviews,0,0,0
818050,True,7,Positive,19,0,19
818060,True,6,Mostly Positive,8,3,11
818070,True,0,No user reviews,0,0,0
818090,True,0,No user reviews,0,0,0
818110,True,0,No user reviews,0,0,0
818130,True,0,No user reviews,0,0,0
818140,True,0,5 user reviews,5,0,5
818150,True,7,Positive,13,2,15
818180,True,0,No user reviews,0,0,0
818190,True,0,No user reviews,0,0,0
818200,True,0,No user reviews,0,0,0
818210,True,8,Very Positive,118,25,143
818220,True,0,7 user reviews,3,4,7
818240,True,0,No user reviews,0,0,0
818270,True,0,2 user reviews,1,1,2
818280,True,0,No user reviews,0,0,0
818300,True,0,No user reviews,0,0,0
818320,True,8,Very Positive,147,30,177
818330,True,0,9 user reviews,3,6,9
818340,True,0,No user reviews,0,0,0
818350,True,0,2 user reviews,2,0,2
818360,True,0,1 user reviews,1,0,1
818370,True,0,No user reviews,0,0,0
818380,True,0,No user reviews,0,0,0
818390,True,0,7 user reviews,3,4,7
818400,True,0,8 user reviews,5,3,8
818410,True,7,Positive,13,0,13
818420,True,0,No user reviews,0,0,0
818430,True,0,2 user reviews,0,2,2
818440,True,5,Mixed,6,6,12
818480,True,0,7 user reviews,3,4,7
818500,True,7,Positive,34,2,36
818520,True,0,No user reviews,0,0,0
818530,True,7,Positive,12,3,15
818570,True,7,Positive,19,4,23
818580,True,0,No user reviews,0,0,0
818590,True,0,4 user reviews,1,3,4
818610,True,7,Positive,34,5,39
818620,True,0,2 user reviews,1,1,2
818640,True,0,1 user reviews,0,1,1
818650,True,0,5 user reviews,3,2,5
818670,True,0,3 user reviews,3,0,3
818690,True,0,No user reviews,0,0,0
818700,True,0,7 user reviews,6,1,7
818710,True,0,No user reviews,0,0,0
818720,True,0,No user reviews,0,0,0
818730,True,6,Mostly Positive,16,5,21
818760,True,7,Positive,11,0,11
818780,True,0,1 user reviews,0,1,1
818790,True,0,1 user reviews,1,0,1
818800,True,7,Positive,8,2,10
818810,True,0,No user reviews,0,0,0
818820,True,0,No user reviews,0,0,0
818830,True,0,2 user reviews,2,0,2
818860,True,0,6 user reviews,6,0,6
818870,True,0,No user reviews,0,0,0
818880,True,0,No user reviews,0,0,0
818890,True,0,No user reviews,0,0,0
818900,True,0,No user reviews,0,0,0
818920,True,0,No user reviews,0,0,0
818940,True,7,Positive,22,4,26
818950,True,0,7 user reviews,6,1,7
818960,True,7,Positive,13,2,15
818980,True,0,No user reviews,0,0,0
818981,True,0,1 user reviews,1,0,1
818982,True,0,No user reviews,0,0,0
818990,True,0,2 user reviews,1,1,2
819000,True,0,No user reviews,0,0,0
819020,True,6,Mostly Positive,172,48,220
819030,True,8,Very Positive,228,19,247
819040,True,7,Positive,19,0,19
819060,True,7,Positive,10,2,12
819070,True,0,3 user reviews,1,2,3
819080,True,0,2 user reviews,0,2,2
819090,True,0,No user reviews,0,0,0
819100,True,0,1 user reviews,1,0,1
819101,True,0,No user reviews,0,0,0
819102,True,0,No user reviews,0,0,0
819103,True,0,No user reviews,0,0,0
819104,True,0,No user reviews,0,0,0
819105,True,0,No user reviews,0,0,0
819110,True,0,No user reviews,0,0,0
819111,True,0,No user reviews,0,0,0
819112,True,0,No user reviews,0,0,0
819150,True,0,No user reviews,0,0,0
819160,True,0,2 user reviews,2,0,2
819170,True,0,No user reviews,0,0,0
819180,True,0,1 user reviews,0,1,1
819190,True,0,No user reviews,0,0,0
819200,True,0,No user reviews,0,0,0
819210,True,0,2 user reviews,0,2,2
819220,True,0,3 user reviews,3,0,3
819230,True,8,Very Positive,67,6,73
819240,True,0,1 user reviews,1,0,1
819260,True,0,No user reviews,0,0,0
819270,True,0,No user reviews,0,0,0
819280,True,0,5 user reviews,4,1,5
819290,True,0,No user reviews,0,0,0
819300,True,0,No user reviews,0,0,0
819310,True,0,No user reviews,0,0,0
819320,True,0,5 user reviews,4,1,5
819330,True,0,7 user reviews,7,0,7
819340,True,0,No user reviews,0,0,0
819350,True,0,No user reviews,0,0,0
819360,True,0,No user reviews,0,0,0
819370,True,0,No user reviews,0,0,0
819390,True,0,No user reviews,0,0,0
819400,True,5,Mixed,7,7,14
819410,True,0,9 user reviews,2,7,9
819420,True,0,No user reviews,0,0,0
819430,True,0,No user reviews,0,0,0
819440,True,0,No user reviews,0,0,0
819450,True,0,No user reviews,0,0,0
819460,True,0,No user reviews,0,0,0
819470,True,0,No user reviews,0,0,0
819480,True,7,Positive,22,2,24
819490,True,0,No user reviews,0,0,0
819500,True,5,Mixed,267,200,467
819510,True,7,Positive,10,1,11
819520,True,0,7 user reviews,6,1,7
819550,True,0,No user reviews,0,0,0
819560,True,0,6 user reviews,5,1,6
819580,True,0,No user reviews,0,0,0
819590,True,0,No user reviews,0,0,0
819610,True,0,No user reviews,0,0,0
819630,True,8,Very Positive,77,2,79
819640,True,0,2 user reviews,1,1,2
819650,True,5,Mixed,14,16,30
819660,True,0,1 user reviews,0,1,1
819670,True,0,2 user reviews,2,0,2
819730,True,0,No user reviews,0,0,0
819740,True,5,Mixed,10,5,15
819750,True,0,No user reviews,0,0,0
819760,True,0,No user reviews,0,0,0
819780,True,7,Positive,10,0,10
819790,True,0,No user reviews,0,0,0
819800,True,0,1 user reviews,1,0,1
819810,True,0,No user reviews,0,0,0
819820,True,0,No user reviews,0,0,0
819830,True,0,No user reviews,0,0,0
819840,True,0,No user reviews,0,0,0
819850,True,0,No user reviews,0,0,0
819860,True,0,1 user reviews,1,0,1
819870,True,0,1 user reviews,1,0,1
819880,True,0,1 user reviews,1,0,1
819940,True,0,1 user reviews,1,0,1
819950,True,0,No user reviews,0,0,0
819960,True,0,8 user reviews,7,1,8
819970,True,0,No user reviews,0,0,0
819980,True,0,3 user reviews,3,0,3
820010,True,0,No user reviews,0,0,0
820020,True,5,Mixed,46,29,75
820030,True,5,Mixed,37,16,53
820040,True,5,Mixed,10,6,16
820060,True,0,No user reviews,0,0,0
820070,True,0,4 user reviews,4,0,4
820090,True,0,No user reviews,0,0,0
820140,True,8,Very Positive,55,1,56
820150,True,0,1 user reviews,1,0,1
820151,True,0,2 user reviews,2,0,2
820152,True,0,No user reviews,0,0,0
820153,True,0,No user reviews,0,0,0
820170,True,0,2 user reviews,2,0,2
820180,True,0,2 user reviews,2,0,2
820190,True,0,No user reviews,0,0,0
820200,True,0,4 user reviews,2,2,4
820201,True,0,4 user reviews,4,0,4
820203,True,6,Mostly Positive,57,24,81
820210,True,0,8 user reviews,8,0,8
820220,True,0,No user reviews,0,0,0
820230,True,0,No user reviews,0,0,0
820231,True,0,1 user reviews,1,0,1
820232,True,0,1 user reviews,1,0,1
820240,True,5,Mixed,19,10,29
820250,True,0,8 user reviews,4,4,8
820270,True,0,No user reviews,0,0,0
820300,True,0,3 user reviews,3,0,3
820310,True,0,4 user reviews,1,3,4
820320,True,5,Mixed,9,6,15
820370,True,0,No user reviews,0,0,0
820380,True,5,Mixed,11,8,19
820400,True,0,No user reviews,0,0,0
820430,True,0,No user reviews,0,0,0
820440,True,0,No user reviews,0,0,0
820441,True,0,No user reviews,0,0,0
820442,True,7,Positive,32,4,36
820460,True,0,7 user reviews,5,2,7
820480,True,0,2 user reviews,2,0,2
820490,True,0,No user reviews,0,0,0
820500,True,0,No user reviews,0,0,0
820510,True,7,Positive,12,1,13
820520,True,0,No user reviews,0,0,0
820530,True,0,1 user reviews,1,0,1
820540,True,0,No user reviews,0,0,0
820570,True,0,No user reviews,0,0,0
820580,True,5,Mixed,7,8,15
820590,True,0,No user reviews,0,0,0
820600,True,7,Positive,17,0,17
820610,True,6,Mostly Positive,27,7,34
820620,True,6,Mostly Positive,16,6,22
820630,True,8,Very Positive,209,24,233
820640,True,0,5 user reviews,5,0,5
820660,True,0,2 user reviews,0,2,2
820680,True,0,2 user reviews,1,1,2
820690,True,0,No user reviews,0,0,0
820700,True,0,7 user reviews,5,2,7
820710,True,0,3 user reviews,2,1,3
820720,True,0,No user reviews,0,0,0
820730,True,8,Very Positive,77,4,81
820760,True,0,5 user reviews,3,2,5
820780,True,0,1 user reviews,1,0,1
820790,True,0,No user reviews,0,0,0
820820,True,0,No user reviews,0,0,0
820821,True,0,No user reviews,0,0,0
820830,True,0,2 user reviews,2,0,2
820840,True,0,7 user reviews,5,2,7
820860,True,0,No user reviews,0,0,0
820870,True,0,1 user reviews,1,0,1
820880,True,5,Mixed,11,7,18
820890,True,0,1 user reviews,1,0,1
820900,True,8,Very Positive,73,7,80
820910,True,7,Positive,39,3,42
820930,True,7,Positive,28,7,35
820940,True,0,1 user reviews,0,1,1
820950,True,0,9 user reviews,9,0,9
820980,True,0,No user reviews,0,0,0
820990,True,0,No user reviews,0,0,0
821020,True,0,No user reviews,0,0,0
821030,True,0,2 user reviews,1,1,2
821060,True,5,Mixed,58,33,91
821090,True,8,Very Positive,50,7,57
821100,True,0,4 user reviews,2,2,4
821120,True,0,8 user reviews,6,2,8
821170,True,0,5 user reviews,5,0,5
821180,True,0,3 user reviews,0,3,3
821190,True,0,4 user reviews,3,1,4
821210,True,0,No user reviews,0,0,0
821230,True,7,Positive,17,1,18
821250,True,6,Mostly Positive,442,119,561
821260,True,0,1 user reviews,0,1,1
821280,True,0,No user reviews,0,0,0
821290,True,0,No user reviews,0,0,0
821310,True,0,No user reviews,0,0,0
821320,True,8,Very Positive,70,6,76
821330,True,0,4 user reviews,2,2,4
821350,True,5,Mixed,79,57,136
821360,True,0,1 user reviews,1,0,1
821370,True,5,Mixed,8,5,13
821380,True,0,No user reviews,0,0,0
821390,True,5,Mixed,11,6,17
821400,True,0,2 user reviews,2,0,2
821410,True,0,5 user reviews,4,1,5
821430,True,0,No user reviews,0,0,0
821440,True,0,No user reviews,0,0,0
821450,True,0,2 user reviews,2,0,2
821470,True,0,No user reviews,0,0,0
821480,True,0,1 user reviews,0,1,1
821490,True,0,5 user reviews,5,0,5
821500,True,0,9 user reviews,8,1,9
821520,True,0,6 user reviews,4,2,6
821550,True,0,6 user reviews,4,2,6
821560,True,0,6 user reviews,6,0,6
821570,True,0,5 user reviews,5,0,5
821590,True,0,No user reviews,0,0,0
821600,True,0,No user reviews,0,0,0
821601,True,0,No user reviews,0,0,0
821610,True,0,No user reviews,0,0,0
821620,True,0,No user reviews,0,0,0
821630,True,0,1 user reviews,1,0,1
821640,True,7,Positive,30,2,32
821670,True,0,No user reviews,0,0,0
821680,True,0,No user reviews,0,0,0
821710,True,0,1 user reviews,1,0,1
821720,True,0,6 user reviews,5,1,6
821740,True,0,No user reviews,0,0,0
821750,True,0,No user reviews,0,0,0
821760,True,0,No user reviews,0,0,0
821770,True,0,No user reviews,0,0,0
821780,True,7,Positive,11,2,13
821790,True,6,Mostly Positive,26,7,33
821800,True,0,No user reviews,0,0,0
821820,True,0,No user reviews,0,0,0
821850,True,0,6 user reviews,1,5,6
821860,True,0,3 user reviews,1,2,3
821880,True,0,No user reviews,0,0,0
821890,True,8,Very Positive,296,37,333
821910,True,0,5 user reviews,0,5,5
821920,True,0,No user reviews,0,0,0
821940,True,6,Mostly Positive,58,23,81
821950,True,7,Positive,40,7,47
821970,True,0,No user reviews,0,0,0
821980,True,0,No user reviews,0,0,0
821990,True,0,No user reviews,0,0,0
822000,True,0,No user reviews,0,0,0
822010,True,0,5 user reviews,5,0,5
822030,True,0,No user reviews,0,0,0
822040,True,7,Positive,24,2,26
822060,True,0,No user reviews,0,0,0
822061,True,0,No user reviews,0,0,0
822070,True,0,1 user reviews,0,1,1
822080,True,0,9 user reviews,9,0,9
822090,True,0,No user reviews,0,0,0
822091,True,0,1 user reviews,0,1,1
822093,True,0,No user reviews,0,0,0
822094,True,7,Positive,16,1,17
822110,True,0,No user reviews,0,0,0
822130,True,0,6 user reviews,1,5,6
822140,True,0,2 user reviews,1,1,2
822150,True,0,3 user reviews,1,2,3
822170,True,0,No user reviews,0,0,0
822180,True,0,1 user reviews,1,0,1
822190,True,7,Positive,21,0,21
822210,True,0,No user reviews,0,0,0
822230,True,0,No user reviews,0,0,0
822240,True,0,No user reviews,0,0,0
822250,True,0,2 user reviews,1,1,2
822260,True,0,No user reviews,0,0,0
822270,True,0,No user reviews,0,0,0
822300,True,0,No user reviews,0,0,0
822310,True,0,No user reviews,0,0,0
822330,True,0,2 user reviews,1,1,2
822340,True,0,1 user reviews,1,0,1
822350,True,0,No user reviews,0,0,0
822380,True,0,4 user reviews,0,4,4
822400,True,0,1 user reviews,1,0,1
822410,True,0,No user reviews,0,0,0
822420,True,0,No user reviews,0,0,0
822421,True,0,No user reviews,0,0,0
822422,True,0,No user reviews,0,0,0
822440,True,0,3 user reviews,1,2,3
822450,True,0,5 user reviews,5,0,5
822460,True,0,5 user reviews,4,1,5
822470,True,0,No user reviews,0,0,0
822480,True,0,No user reviews,0,0,0
822510,True,0,7 user reviews,4,3,7
822530,True,0,5 user reviews,2,3,5
822540,True,6,Mostly Positive,37,13,50
822550,True,0,1 user reviews,1,0,1
822570,True,0,No user reviews,0,0,0
822610,True,0,No user reviews,0,0,0
822640,True,0,2 user reviews,2,0,2
822650,True,5,Mixed,15,16,31
822660,True,0,6 user reviews,6,0,6
822670,True,0,No user reviews,0,0,0
822680,True,0,6 user reviews,1,5,6
822690,True,0,No user reviews,0,0,0
822700,True,0,2 user reviews,2,0,2
822710,True,0,No user reviews,0,0,0
822720,True,0,4 user reviews,3,1,4
822730,True,0,No user reviews,0,0,0
822740,True,0,1 user reviews,1,0,1
822750,True,0,4 user reviews,3,1,4
822760,True,8,Very Positive,101,2,103
822770,True,0,6 user reviews,1,5,6
822780,True,0,No user reviews,0,0,0
822800,True,6,Mostly Positive,23,6,29
822810,True,0,2 user reviews,2,0,2
822820,True,0,No user reviews,0,0,0
822830,True,8,Very Positive,69,0,69
822840,True,0,1 user reviews,0,1,1
822860,True,0,1 user reviews,1,0,1
822870,True,0,No user reviews,0,0,0
822900,True,0,8 user reviews,6,2,8
822910,True,0,2 user reviews,1,1,2
822920,True,7,Positive,9,2,11
822930,True,8,Very Positive,417,14,431
822940,True,0,9 user reviews,9,0,9
822970,True,0,1 user reviews,1,0,1
822980,True,0,No user reviews,0,0,0
822990,True,6,Mostly Positive,147,40,187
823000,True,0,No user reviews,0,0,0
823010,True,0,No user reviews,0,0,0
823020,True,0,3 user reviews,3,0,3
823030,True,0,1 user reviews,1,0,1
823040,True,6,Mostly Positive,10,3,13
823080,True,0,No user reviews,0,0,0
823100,True,0,5 user reviews,3,2,5
823110,True,0,No user reviews,0,0,0
823120,True,0,No user reviews,0,0,0
823130,True,8,Very Positive,3258,729,3987
823140,True,0,No user reviews,0,0,0
823150,True,0,No user reviews,0,0,0
823160,True,0,No user reviews,0,0,0
823170,True,0,No user reviews,0,0,0
823180,True,0,1 user reviews,1,0,1
823190,True,0,No user reviews,0,0,0
823200,True,0,No user reviews,0,0,0
823210,True,0,No user reviews,0,0,0
823240,True,0,No user reviews,0,0,0
823250,True,0,No user reviews,0,0,0
823260,True,0,2 user reviews,2,0,2
823261,True,0,2 user reviews,2,0,2
823262,True,0,2 user reviews,2,0,2
823280,True,5,Mixed,6,5,11
823290,True,0,No user reviews,0,0,0
823300,True,0,No user reviews,0,0,0
823301,True,0,No user reviews,0,0,0
823310,True,0,2 user reviews,1,1,2
823320,True,0,No user reviews,0,0,0
823330,True,0,2 user reviews,1,1,2
823340,True,0,4 user reviews,3,1,4
823360,True,0,4 user reviews,3,1,4
823370,True,0,3 user reviews,3,0,3
823400,True,0,No user reviews,0,0,0
823420,True,0,No user reviews,0,0,0
823430,True,0,No user reviews,0,0,0
823460,True,0,No user reviews,0,0,0
823470,True,0,No user reviews,0,0,0
823500,True,8,Very Positive,11295,1247,12542
823510,True,0,1 user reviews,1,0,1
823520,True,0,No user reviews,0,0,0
823530,True,7,Positive,29,5,34
823550,True,0,No user reviews,0,0,0
823580,True,7,Positive,16,1,17
823590,True,0,No user reviews,0,0,0
823600,True,0,No user reviews,0,0,0
823610,True,6,Mostly Positive,54,19,73
823640,True,4,Mostly Negative,9,14,23
823650,True,0,2 user reviews,2,0,2
823660,True,0,No user reviews,0,0,0
823670,True,0,1 user reviews,0,1,1
823680,True,0,No user reviews,0,0,0
823690,True,0,2 user reviews,2,0,2
823700,True,5,Mixed,11,6,17
823710,True,0,8 user reviews,3,5,8
823720,True,0,No user reviews,0,0,0
823730,True,0,7 user reviews,5,2,7
823740,True,0,4 user reviews,1,3,4
823770,True,0,6 user reviews,1,5,6
823780,True,0,No user reviews,0,0,0
823800,True,0,4 user reviews,2,2,4
823810,True,0,6 user reviews,4,2,6
823820,True,0,No user reviews,0,0,0
823830,True,0,No user reviews,0,0,0
823840,True,7,Positive,40,1,41
823850,True,0,No user reviews,0,0,0
823860,True,0,No user reviews,0,0,0
823870,True,0,No user reviews,0,0,0
823900,True,0,No user reviews,0,0,0
823910,True,8,Very Positive,509,42,551
823920,True,0,5 user reviews,3,2,5
823930,True,0,1 user reviews,1,0,1
823940,True,6,Mostly Positive,197,76,273
823950,True,5,Mixed,394,244,638
823960,True,0,No user reviews,0,0,0
823970,True,0,No user reviews,0,0,0
823980,True,0,No user reviews,0,0,0
823981,True,0,No user reviews,0,0,0
823990,True,5,Mixed,43,37,80
824000,True,0,No user reviews,0,0,0
824010,True,0,No user reviews,0,0,0
824011,True,0,No user reviews,0,0,0
824020,True,0,No user reviews,0,0,0
824030,True,0,No user reviews,0,0,0
824040,True,0,No user reviews,0,0,0
824041,True,0,No user reviews,0,0,0
824050,True,0,No user reviews,0,0,0
824070,True,5,Mixed,211,175,386
824080,True,0,No user reviews,0,0,0
824090,True,0,No user reviews,0,0,0
824110,True,0,No user reviews,0,0,0
824140,True,0,No user reviews,0,0,0
824141,True,0,No user reviews,0,0,0
824142,True,0,No user reviews,0,0,0
824143,True,0,No user reviews,0,0,0
824144,True,0,No user reviews,0,0,0
824145,True,0,No user reviews,0,0,0
824146,True,0,No user reviews,0,0,0
824147,True,0,No user reviews,0,0,0
824148,True,0,No user reviews,0,0,0
824149,True,0,No user reviews,0,0,0
824150,True,0,No user reviews,0,0,0
824151,True,0,No user reviews,0,0,0
824160,True,0,No user reviews,0,0,0
824170,True,0,No user reviews,0,0,0
824180,True,0,No user reviews,0,0,0
824190,True,8,Very Positive,133,24,157
824200,True,7,Positive,8,2,10
824220,True,0,No user reviews,0,0,0
824230,True,0,3 user reviews,2,1,3
824240,True,0,No user reviews,0,0,0
824250,True,0,3 user reviews,3,0,3
824260,True,0,No user reviews,0,0,0
824270,True,8,Very Positive,7450,678,8128
824280,True,6,Mostly Positive,86,36,122
824300,True,0,No user reviews,0,0,0
824320,True,0,No user reviews,0,0,0
824330,True,0,No user reviews,0,0,0
824350,True,0,No user reviews,0,0,0
824360,True,0,No user reviews,0,0,0
824380,True,0,2 user reviews,2,0,2
824381,True,0,2 user reviews,2,0,2
824382,True,0,2 user reviews,2,0,2
824400,True,0,No user reviews,0,0,0
824420,True,0,No user reviews,0,0,0
824430,True,0,No user reviews,0,0,0
824440,True,0,No user reviews,0,0,0
824450,True,5,Mixed,10,5,15
824460,True,7,Positive,15,0,15
824470,True,0,6 user reviews,4,2,6
824480,True,0,No user reviews,0,0,0
824500,True,0,No user reviews,0,0,0
824520,True,0,No user reviews,0,0,0
824540,True,0,No user reviews,0,0,0
824570,True,7,Positive,13,0,13
824580,True,0,4 user reviews,2,2,4
824590,True,0,No user reviews,0,0,0
824600,True,0,No user reviews,0,0,0
824610,True,7,Positive,18,3,21
824620,True,0,9 user reviews,9,0,9
824640,True,0,2 user reviews,2,0,2
824720,True,8,Very Positive,424,59,483
824760,True,7,Positive,12,2,14
824770,True,0,1 user reviews,1,0,1
824810,True,0,No user reviews,0,0,0
824820,True,0,No user reviews,0,0,0
824830,True,8,Very Positive,72,11,83
824840,True,0,No user reviews,0,0,0
824850,True,7,Positive,44,4,48
824860,True,0,No user reviews,0,0,0
824880,True,0,No user reviews,0,0,0
824890,True,0,No user reviews,0,0,0
824900,True,0,No user reviews,0,0,0
824910,True,0,No user reviews,0,0,0
824920,True,0,No user reviews,0,0,0
824940,True,0,No user reviews,0,0,0
824950,True,0,No user reviews,0,0,0
824960,True,0,No user reviews,0,0,0
824970,True,0,No user reviews,0,0,0
824980,True,0,No user reviews,0,0,0
824990,True,0,No user reviews,0,0,0
825000,True,0,3 user reviews,1,2,3
825010,True,0,No user reviews,0,0,0
825020,True,0,1 user reviews,1,0,1
825030,True,0,No user reviews,0,0,0
825040,True,0,1 user reviews,1,0,1
825060,True,0,No user reviews,0,0,0
825090,True,0,2 user reviews,1,1,2
825100,True,0,No user reviews,0,0,0
825110,True,0,No user reviews,0,0,0
825170,True,0,No user reviews,0,0,0
825180,True,0,No user reviews,0,0,0
825210,True,0,No user reviews,0,0,0
825220,True,0,No user reviews,0,0,0
825221,True,0,No user reviews,0,0,0
825240,True,0,7 user reviews,7,0,7
825260,True,0,No user reviews,0,0,0
825270,True,0,No user reviews,0,0,0
825271,True,0,No user reviews,0,0,0
825272,True,0,No user reviews,0,0,0
825273,True,0,No user reviews,0,0,0
825274,True,0,No user reviews,0,0,0
825275,True,0,No user reviews,0,0,0
825276,True,0,No user reviews,0,0,0
825277,True,0,No user reviews,0,0,0
825278,True,0,No user reviews,0,0,0
825279,True,0,No user reviews,0,0,0
825280,True,0,No user reviews,0,0,0
825300,True,8,Very Positive,59,10,69
825310,True,5,Mixed,132,183,315
825320,True,0,4 user reviews,4,0,4
825350,True,0,2 user reviews,1,1,2
825370,True,6,Mostly Positive,8,3,11
825380,True,0,No user reviews,0,0,0
825400,True,0,5 user reviews,5,0,5
825420,True,0,No user reviews,0,0,0
825430,True,0,No user reviews,0,0,0
825450,True,0,No user reviews,0,0,0
825470,True,0,2 user reviews,2,0,2
825480,True,0,3 user reviews,3,0,3
825490,True,0,1 user reviews,0,1,1
825500,True,5,Mixed,5,5,10
825550,True,5,Mixed,20,15,35
825570,True,8,Very Positive,134,9,143
825580,True,0,No user reviews,0,0,0
825590,True,0,1 user reviews,1,0,1
825610,True,0,No user reviews,0,0,0
825620,True,0,2 user reviews,1,1,2
825630,True,9,Overwhelmingly Positive,641,29,670
825640,True,0,No user reviews,0,0,0
825650,True,0,1 user reviews,0,1,1
825660,True,0,1 user reviews,0,1,1
825670,True,0,No user reviews,0,0,0
825680,True,0,2 user reviews,0,2,2
825690,True,0,No user reviews,0,0,0
825700,True,0,1 user reviews,1,0,1
825710,True,0,2 user reviews,1,1,2
825730,True,8,Very Positive,66,7,73
825930,True,6,Mostly Positive,10,4,14
825970,True,0,7 user reviews,4,3,7
826000,True,5,Mixed,13,11,24
826010,True,6,Mostly Positive,14,6,20
826020,True,0,No user reviews,0,0,0
826030,True,0,5 user reviews,3,2,5
826040,True,0,4 user reviews,3,1,4
826050,True,0,1 user reviews,1,0,1
826080,True,0,6 user reviews,5,1,6
826081,True,0,No user reviews,0,0,0
826082,True,0,No user reviews,0,0,0
826083,True,0,3 user reviews,2,1,3
826084,True,0,1 user reviews,0,1,1
826085,True,0,1 user reviews,1,0,1
826086,True,0,1 user reviews,1,0,1
826087,True,0,2 user reviews,1,1,2
826088,True,0,No user reviews,0,0,0
826090,True,0,No user reviews,0,0,0
826100,True,0,No user reviews,0,0,0
826110,True,0,No user reviews,0,0,0
826111,True,0,No user reviews,0,0,0
826112,True,0,No user reviews,0,0,0
826113,True,0,No user reviews,0,0,0
826114,True,0,No user reviews,0,0,0
826115,True,0,No user reviews,0,0,0
826116,True,0,No user reviews,0,0,0
826117,True,0,No user reviews,0,0,0
826118,True,0,No user reviews,0,0,0
826119,True,0,No user reviews,0,0,0
826120,True,0,No user reviews,0,0,0
826121,True,0,No user reviews,0,0,0
826140,True,0,No user reviews,0,0,0
826141,True,0,No user reviews,0,0,0
826142,True,0,No user reviews,0,0,0
826143,True,0,No user reviews,0,0,0
826144,True,0,No user reviews,0,0,0
826145,True,0,No user reviews,0,0,0
826146,True,0,No user reviews,0,0,0
826147,True,0,No user reviews,0,0,0
826148,True,0,No user reviews,0,0,0
826149,True,0,No user reviews,0,0,0
826150,True,0,No user reviews,0,0,0
826151,True,0,No user reviews,0,0,0
826160,True,5,Mixed,11,9,20
826170,True,0,2 user reviews,2,0,2
826180,True,6,Mostly Positive,13,4,17
826190,True,0,No user reviews,0,0,0
826200,True,0,No user reviews,0,0,0
826210,True,0,No user reviews,0,0,0
826220,True,0,No user reviews,0,0,0
826230,True,0,No user reviews,0,0,0
826240,True,0,No user reviews,0,0,0
826241,True,0,No user reviews,0,0,0
826242,True,0,No user reviews,0,0,0
826243,True,0,No user reviews,0,0,0
826244,True,0,No user reviews,0,0,0
826245,True,0,No user reviews,0,0,0
826246,True,0,No user reviews,0,0,0
826247,True,0,No user reviews,0,0,0
826248,True,0,No user reviews,0,0,0
826249,True,0,No user reviews,0,0,0
826250,True,0,No user reviews,0,0,0
826251,True,0,No user reviews,0,0,0
826260,True,0,No user reviews,0,0,0
826290,True,0,6 user reviews,6,0,6
826300,True,0,No user reviews,0,0,0
826330,True,0,No user reviews,0,0,0
826331,True,0,No user reviews,0,0,0
826332,True,0,No user reviews,0,0,0
826333,True,0,No user reviews,0,0,0
826334,True,0,No user reviews,0,0,0
826335,True,0,No user reviews,0,0,0
826336,True,0,No user reviews,0,0,0
826337,True,0,No user reviews,0,0,0
826338,True,0,No user reviews,0,0,0
826339,True,0,No user reviews,0,0,0
826340,True,0,No user reviews,0,0,0
826341,True,0,No user reviews,0,0,0
826360,True,0,No user reviews,0,0,0
826370,True,0,1 user reviews,1,0,1
826380,True,0,1 user reviews,1,0,1
826390,True,0,1 user reviews,1,0,1
826420,True,0,8 user reviews,7,1,8
826430,True,0,2 user reviews,1,1,2
826440,True,0,1 user reviews,1,0,1
826450,True,0,5 user reviews,4,1,5
826460,True,5,Mixed,5,7,12
826470,True,0,No user reviews,0,0,0
826480,True,0,No user reviews,0,0,0
826490,True,0,1 user reviews,1,0,1
826491,True,0,1 user reviews,1,0,1
826492,True,0,1 user reviews,1,0,1
826493,True,0,1 user reviews,1,0,1
826494,True,0,1 user reviews,1,0,1
826495,True,0,1 user reviews,1,0,1
826496,True,0,1 user reviews,1,0,1
826497,True,0,1 user reviews,1,0,1
826498,True,0,1 user reviews,1,0,1
826499,True,0,1 user reviews,1,0,1
826500,True,0,1 user reviews,1,0,1
826501,True,0,1 user reviews,1,0,1
826502,True,0,1 user reviews,1,0,1
826503,True,0,1 user reviews,1,0,1
826504,True,0,1 user reviews,1,0,1
826505,True,0,1 user reviews,1,0,1
826506,True,0,1 user reviews,1,0,1
826507,True,0,1 user reviews,1,0,1
826510,True,0,No user reviews,0,0,0
826520,True,0,No user reviews,0,0,0
826530,True,0,No user reviews,0,0,0
826540,True,8,Very Positive,67,7,74
826550,True,0,No user reviews,0,0,0
826580,True,0,1 user reviews,0,1,1
826590,True,0,No user reviews,0,0,0
826600,True,6,Mostly Positive,85,28,113
826610,True,0,No user reviews,0,0,0
826620,True,0,1 user reviews,1,0,1
826630,True,6,Mostly Positive,920,347,1267
826640,True,0,No user reviews,0,0,0
826650,True,7,Positive,13,1,14
826660,True,0,7 user reviews,5,2,7
826740,True,7,Positive,30,6,36
826810,True,0,No user reviews,0,0,0
826930,True,0,4 user reviews,3,1,4
826940,True,8,Very Positive,101,24,125
827000,True,7,Positive,17,4,21
827050,True,6,Mostly Positive,26,7,33
827100,True,0,8 user reviews,4,4,8
827110,True,0,6 user reviews,2,4,6
827120,True,0,7 user reviews,3,4,7
827130,True,0,4 user reviews,2,2,4
827170,True,0,No user reviews,0,0,0
827200,True,0,No user reviews,0,0,0
827210,True,0,No user reviews,0,0,0
827220,True,0,No user reviews,0,0,0
827240,True,4,Mostly Negative,120,188,308
827250,True,7,Positive,8,2,10
827270,True,0,1 user reviews,1,0,1
827280,True,0,3 user reviews,2,1,3
827290,True,8,Very Positive,158,4,162
827320,True,0,No user reviews,0,0,0
827340,True,0,No user reviews,0,0,0
827350,True,0,No user reviews,0,0,0
827360,True,0,No user reviews,0,0,0
827380,True,6,Mostly Positive,10,3,13
827390,True,0,No user reviews,0,0,0
827391,True,0,No user reviews,0,0,0
827392,True,0,No user reviews,0,0,0
827393,True,0,No user reviews,0,0,0
827394,True,0,No user reviews,0,0,0
827395,True,0,No user reviews,0,0,0
827396,True,0,No user reviews,0,0,0
827397,True,0,No user reviews,0,0,0
827398,True,0,No user reviews,0,0,0
827399,True,0,No user reviews,0,0,0
827400,True,0,No user reviews,0,0,0
827401,True,0,No user reviews,0,0,0
827410,True,0,1 user reviews,0,1,1
827420,True,5,Mixed,9,6,15
827430,True,0,No user reviews,0,0,0
827431,True,0,No user reviews,0,0,0
827432,True,0,No user reviews,0,0,0
827433,True,0,No user reviews,0,0,0
827434,True,0,No user reviews,0,0,0
827435,True,0,No user reviews,0,0,0
827436,True,0,No user reviews,0,0,0
827437,True,0,No user reviews,0,0,0
827438,True,0,No user reviews,0,0,0
827439,True,0,No user reviews,0,0,0
827440,True,0,No user reviews,0,0,0
827450,True,0,2 user reviews,1,1,2
827460,True,0,7 user reviews,7,0,7
827490,True,0,No user reviews,0,0,0
827491,True,0,No user reviews,0,0,0
827492,True,0,No user reviews,0,0,0
827493,True,0,No user reviews,0,0,0
827494,True,0,No user reviews,0,0,0
827495,True,0,No user reviews,0,0,0
827496,True,0,No user reviews,0,0,0
827497,True,0,No user reviews,0,0,0
827498,True,0,No user reviews,0,0,0
827499,True,0,No user reviews,0,0,0
827500,True,0,No user reviews,0,0,0
827501,True,0,No user reviews,0,0,0
827502,True,0,No user reviews,0,0,0
827520,True,0,3 user reviews,3,0,3
827530,True,0,7 user reviews,4,3,7
827540,True,0,No user reviews,0,0,0
827560,True,0,No user reviews,0,0,0
827580,True,0,No user reviews,0,0,0
827590,True,0,3 user reviews,3,0,3
827600,True,0,No user reviews,0,0,0
827610,True,0,7 user reviews,6,1,7
827640,True,6,Mostly Positive,32,10,42
827690,True,0,No user reviews,0,0,0
827700,True,0,1 user reviews,0,1,1
827710,True,0,1 user reviews,1,0,1
827720,True,0,2 user reviews,0,2,2
827730,True,0,7 user reviews,7,0,7
827770,True,0,2 user reviews,0,2,2
827780,True,0,1 user reviews,0,1,1
827810,True,0,1 user reviews,1,0,1
827820,True,0,1 user reviews,1,0,1
827830,True,0,9 user reviews,8,1,9
827860,True,0,No user reviews,0,0,0
827880,True,0,4 user reviews,4,0,4
827900,True,0,No user reviews,0,0,0
827920,True,0,5 user reviews,4,1,5
827930,True,0,No user reviews,0,0,0
827940,True,7,Positive,9,2,11
827950,True,0,1 user reviews,1,0,1
827960,True,0,No user reviews,0,0,0
827961,True,0,No user reviews,0,0,0
827962,True,0,No user reviews,0,0,0
827963,True,0,No user reviews,0,0,0
827964,True,0,No user reviews,0,0,0
827965,True,0,No user reviews,0,0,0
827966,True,0,No user reviews,0,0,0
827967,True,0,No user reviews,0,0,0
827968,True,0,No user reviews,0,0,0
827969,True,0,No user reviews,0,0,0
827970,True,0,No user reviews,0,0,0
827971,True,0,No user reviews,0,0,0
827990,True,0,No user reviews,0,0,0
828020,True,0,No user reviews,0,0,0
828030,True,0,No user reviews,0,0,0
828040,True,0,No user reviews,0,0,0
828050,True,0,No user reviews,0,0,0
828070,True,8,Very Positive,147,17,164
828080,True,0,No user reviews,0,0,0
828090,True,0,2 user reviews,1,1,2
828100,True,0,No user reviews,0,0,0
828130,True,0,No user reviews,0,0,0
828150,True,6,Mostly Positive,21,7,28
828160,True,0,4 user reviews,2,2,4
828170,True,0,No user reviews,0,0,0
828180,True,0,No user reviews,0,0,0
828200,True,0,No user reviews,0,0,0
828220,True,0,No user reviews,0,0,0
828230,True,0,No user reviews,0,0,0
828240,True,7,Positive,15,1,16
828250,True,0,No user reviews,0,0,0
828260,True,0,No user reviews,0,0,0
828270,True,0,2 user reviews,2,0,2
828300,True,0,1 user reviews,1,0,1
828310,True,0,No user reviews,0,0,0
828320,True,7,Positive,8,2,10
828350,True,0,3 user reviews,3,0,3
828360,True,0,3 user reviews,2,1,3
828370,True,0,No user reviews,0,0,0
828380,True,0,No user reviews,0,0,0
828390,True,0,No user reviews,0,0,0
828410,True,0,4 user reviews,2,2,4
828420,True,0,1 user reviews,1,0,1
828430,True,0,No user reviews,0,0,0
828440,True,0,3 user reviews,1,2,3
828450,True,0,No user reviews,0,0,0
828460,True,0,2 user reviews,1,1,2
828470,True,0,No user reviews,0,0,0
828480,True,0,4 user reviews,2,2,4
828490,True,0,1 user reviews,1,0,1
828500,True,0,2 user reviews,2,0,2
828520,True,0,2 user reviews,2,0,2
828540,True,0,1 user reviews,1,0,1
828550,True,5,Mixed,8,4,12
828560,True,0,No user reviews,0,0,0
828580,True,7,Positive,42,5,47
828590,True,7,Positive,11,1,12
828600,True,0,1 user reviews,1,0,1
828610,True,0,No user reviews,0,0,0
828611,True,0,No user reviews,0,0,0
828612,True,0,No user reviews,0,0,0
828613,True,0,No user reviews,0,0,0
828614,True,0,No user reviews,0,0,0
828615,True,0,No user reviews,0,0,0
828616,True,0,No user reviews,0,0,0
828620,True,0,No user reviews,0,0,0
828621,True,0,No user reviews,0,0,0
828622,True,0,No user reviews,0,0,0
828623,True,0,No user reviews,0,0,0
828624,True,0,No user reviews,0,0,0
828625,True,0,No user reviews,0,0,0
828626,True,0,1 user reviews,1,0,1
828630,True,0,No user reviews,0,0,0
828631,True,0,No user reviews,0,0,0
828632,True,0,No user reviews,0,0,0
828640,True,7,Positive,19,4,23
828660,True,6,Mostly Positive,26,7,33
828680,True,7,Positive,11,0,11
828690,True,0,No user reviews,0,0,0
828710,True,0,No user reviews,0,0,0
828730,True,0,2 user reviews,0,2,2
828740,True,6,Mostly Positive,107,27,134
828760,True,0,No user reviews,0,0,0
828770,True,0,3 user reviews,2,1,3
828790,True,5,Mixed,200,206,406
828800,True,0,9 user reviews,6,3,9
828830,True,0,1 user reviews,0,1,1
828860,True,0,3 user reviews,3,0,3
828880,True,0,No user reviews,0,0,0
828890,True,5,Mixed,13,8,21
828900,True,6,Mostly Positive,123,43,166
828910,True,5,Mixed,6,5,11
828920,True,0,No user reviews,0,0,0
828940,True,0,No user reviews,0,0,0
828950,True,6,Mostly Positive,12,4,16
828960,True,5,Mixed,14,14,28
828970,True,0,2 user reviews,0,2,2
829000,True,0,No user reviews,0,0,0
829020,True,0,No user reviews,0,0,0
829021,True,0,No user reviews,0,0,0
829022,True,0,No user reviews,0,0,0
829023,True,0,No user reviews,0,0,0
829024,True,0,No user reviews,0,0,0
829025,True,0,No user reviews,0,0,0
829026,True,0,No user reviews,0,0,0
829027,True,0,No user reviews,0,0,0
829028,True,0,No user reviews,0,0,0
829029,True,0,No user reviews,0,0,0
829030,True,0,No user reviews,0,0,0
829031,True,0,No user reviews,0,0,0
829032,True,0,No user reviews,0,0,0
829033,True,0,No user reviews,0,0,0
829034,True,0,No user reviews,0,0,0
829035,True,0,No user reviews,0,0,0
829036,True,0,No user reviews,0,0,0
829037,True,0,No user reviews,0,0,0
829038,True,0,No user reviews,0,0,0
829039,True,0,No user reviews,0,0,0
829040,True,0,3 user reviews,3,0,3
829060,True,0,No user reviews,0,0,0
829070,True,0,No user reviews,0,0,0
829071,True,0,No user reviews,0,0,0
829072,True,0,No user reviews,0,0,0
829073,True,0,No user reviews,0,0,0
829074,True,0,No user reviews,0,0,0
829075,True,0,No user reviews,0,0,0
829076,True,0,No user reviews,0,0,0
829077,True,0,No user reviews,0,0,0
829078,True,0,No user reviews,0,0,0
829079,True,0,No user reviews,0,0,0
829080,True,0,8 user reviews,7,1,8
829090,True,0,No user reviews,0,0,0
829100,True,0,No user reviews,0,0,0
829101,True,0,No user reviews,0,0,0
829102,True,0,No user reviews,0,0,0
829103,True,0,No user reviews,0,0,0
829110,True,8,Very Positive,484,66,550
829120,True,0,No user reviews,0,0,0
829130,True,0,No user reviews,0,0,0
829200,True,0,2 user reviews,2,0,2
829210,True,7,Positive,9,2,11
829230,True,0,No user reviews,0,0,0
829250,True,4,Mostly Negative,7,11,18
829260,True,7,Positive,15,2,17
829270,True,0,No user reviews,0,0,0
829280,True,0,No user reviews,0,0,0
829300,True,0,5 user reviews,4,1,5
829350,True,0,1 user reviews,1,0,1
829351,True,0,No user reviews,0,0,0
829352,True,0,No user reviews,0,0,0
829353,True,0,No user reviews,0,0,0
829354,True,0,No user reviews,0,0,0
829355,True,0,No user reviews,0,0,0
829356,True,0,No user reviews,0,0,0
829357,True,0,No user reviews,0,0,0
829358,True,0,No user reviews,0,0,0
829359,True,0,No user reviews,0,0,0
829360,True,0,No user reviews,0,0,0
829370,True,0,5 user reviews,4,1,5
829390,True,5,Mixed,7,4,11
829410,True,0,4 user reviews,2,2,4
829420,True,0,No user reviews,0,0,0
829430,True,0,No user reviews,0,0,0
829440,True,0,No user reviews,0,0,0
829441,True,0,No user reviews,0,0,0
829442,True,0,No user reviews,0,0,0
829443,True,0,No user reviews,0,0,0
829444,True,0,No user reviews,0,0,0
829445,True,0,No user reviews,0,0,0
829446,True,0,No user reviews,0,0,0
829447,True,0,No user reviews,0,0,0
829448,True,0,No user reviews,0,0,0
829449,True,0,No user reviews,0,0,0
829450,True,0,No user reviews,0,0,0
829460,True,0,No user reviews,0,0,0
829490,True,0,2 user reviews,2,0,2
829500,True,0,No user reviews,0,0,0
829501,True,0,No user reviews,0,0,0
829502,True,0,No user reviews,0,0,0
829503,True,0,No user reviews,0,0,0
829504,True,0,No user reviews,0,0,0
829510,True,0,No user reviews,0,0,0
829540,True,7,Positive,14,0,14
829550,True,0,1 user reviews,1,0,1
829560,True,7,Positive,15,2,17
829580,True,0,No user reviews,0,0,0
829581,True,0,No user reviews,0,0,0
829590,True,6,Mostly Positive,401,119,520
829610,True,0,2 user reviews,1,1,2
829620,True,0,No user reviews,0,0,0
829630,True,0,3 user reviews,1,2,3
829660,True,8,Very Positive,202,15,217
829690,True,0,No user reviews,0,0,0
829700,True,0,No user reviews,0,0,0
829710,True,0,No user reviews,0,0,0
829720,True,0,4 user reviews,3,1,4
829730,True,0,No user reviews,0,0,0
829731,True,0,1 user reviews,0,1,1
829732,True,0,No user reviews,0,0,0
829733,True,0,No user reviews,0,0,0
829734,True,0,No user reviews,0,0,0
829735,True,0,No user reviews,0,0,0
829736,True,0,1 user reviews,1,0,1
829737,True,0,No user reviews,0,0,0
829750,True,0,1 user reviews,1,0,1
829760,True,0,1 user reviews,1,0,1
829780,True,5,Mixed,6,6,12
829940,True,0,9 user reviews,9,0,9
829960,True,7,Positive,13,3,16
829990,True,0,No user reviews,0,0,0
829991,True,0,No user reviews,0,0,0
829992,True,0,No user reviews,0,0,0
829993,True,0,No user reviews,0,0,0
829994,True,0,No user reviews,0,0,0
829995,True,0,No user reviews,0,0,0
829996,True,0,No user reviews,0,0,0
829997,True,0,No user reviews,0,0,0
829998,True,0,No user reviews,0,0,0
829999,True,0,No user reviews,0,0,0
830000,True,0,No user reviews,0,0,0
830001,True,0,No user reviews,0,0,0
830002,True,0,No user reviews,0,0,0
830003,True,0,No user reviews,0,0,0
830004,True,0,No user reviews,0,0,0
830005,True,0,No user reviews,0,0,0
830010,True,0,No user reviews,0,0,0
830360,True,0,2 user reviews,1,1,2
830370,True,8,Very Positive,147,18,165
830380,True,0,4 user reviews,1,3,4
830390,True,0,No user reviews,0,0,0
830400,True,6,Mostly Positive,12,5,17
830410,True,0,1 user reviews,1,0,1
830420,True,0,No user reviews,0,0,0
830430,True,0,2 user reviews,0,2,2
830440,True,0,No user reviews,0,0,0
830450,True,8,Very Positive,68,7,75
830451,True,6,Mostly Positive,19,7,26
830460,True,7,Positive,28,5,33
830461,True,6,Mostly Positive,31,10,41
830470,True,0,No user reviews,0,0,0
830480,True,0,No user reviews,0,0,0
830481,True,0,No user reviews,0,0,0
830482,True,0,No user reviews,0,0,0
830483,True,0,No user reviews,0,0,0
830484,True,0,No user reviews,0,0,0
830485,True,0,No user reviews,0,0,0
830486,True,0,No user reviews,0,0,0
830487,True,0,No user reviews,0,0,0
830488,True,0,No user reviews,0,0,0
830490,True,5,Mixed,5,5,10
830500,True,0,1 user reviews,1,0,1
830510,True,0,No user reviews,0,0,0
830520,True,0,3 user reviews,3,0,3
830530,True,0,4 user reviews,3,1,4
830540,True,0,No user reviews,0,0,0
830550,True,0,No user reviews,0,0,0
830560,True,0,No user reviews,0,0,0
830570,True,0,No user reviews,0,0,0
830580,True,0,No user reviews,0,0,0
830590,True,6,Mostly Positive,29,10,39
830620,True,0,3 user reviews,3,0,3
830630,True,5,Mixed,9,6,15
830640,True,6,Mostly Positive,27,8,35
830650,True,0,No user reviews,0,0,0
830660,True,0,No user reviews,0,0,0
830710,True,7,Positive,18,4,22
830720,True,0,3 user reviews,3,0,3
830740,True,0,No user reviews,0,0,0
830750,True,0,3 user reviews,2,1,3
830810,True,0,1 user reviews,0,1,1
830820,True,8,Very Positive,367,17,384
830840,True,0,No user reviews,0,0,0
830850,True,0,6 user reviews,6,0,6
830890,True,0,1 user reviews,0,1,1
830910,True,0,No user reviews,0,0,0
830920,True,0,No user reviews,0,0,0
830930,True,0,No user reviews,0,0,0
830940,True,0,No user reviews,0,0,0
830950,True,0,No user reviews,0,0,0
830980,True,5,Mixed,88,41,129
830990,True,0,No user reviews,0,0,0
830991,True,0,No user reviews,0,0,0
830992,True,0,No user reviews,0,0,0
830993,True,0,No user reviews,0,0,0
830994,True,0,No user reviews,0,0,0
830995,True,0,No user reviews,0,0,0
830996,True,0,No user reviews,0,0,0
830997,True,0,No user reviews,0,0,0
830998,True,0,No user reviews,0,0,0
830999,True,0,No user reviews,0,0,0
831000,True,0,No user reviews,0,0,0
831001,True,0,No user reviews,0,0,0
831002,True,0,No user reviews,0,0,0
831040,True,0,No user reviews,0,0,0
831050,True,0,No user reviews,0,0,0
831060,True,0,4 user reviews,1,3,4
831070,True,7,Positive,20,2,22
831090,True,7,Positive,18,2,20
831100,True,0,No user reviews,0,0,0
831110,True,0,No user reviews,0,0,0
831120,True,7,Positive,23,2,25
831150,True,0,2 user reviews,2,0,2
831160,True,0,5 user reviews,5,0,5
831161,True,0,4 user reviews,2,2,4
831162,True,0,5 user reviews,5,0,5
831170,True,0,No user reviews,0,0,0
831210,True,0,No user reviews,0,0,0
831211,True,0,No user reviews,0,0,0
831212,True,0,No user reviews,0,0,0
831213,True,0,No user reviews,0,0,0
831214,True,0,No user reviews,0,0,0
831215,True,0,No user reviews,0,0,0
831216,True,0,No user reviews,0,0,0
831217,True,0,No user reviews,0,0,0
831218,True,0,No user reviews,0,0,0
831219,True,0,No user reviews,0,0,0
831220,True,0,No user reviews,0,0,0
831221,True,0,No user reviews,0,0,0
831222,True,0,No user reviews,0,0,0
831223,True,0,No user reviews,0,0,0
831224,True,0,No user reviews,0,0,0
831225,True,0,No user reviews,0,0,0
831226,True,0,No user reviews,0,0,0
831227,True,0,No user reviews,0,0,0
831228,True,0,No user reviews,0,0,0
831230,True,0,No user reviews,0,0,0
831250,True,0,4 user reviews,2,2,4
831260,True,0,3 user reviews,3,0,3
831310,True,0,No user reviews,0,0,0
831311,True,0,No user reviews,0,0,0
831312,True,0,3 user reviews,3,0,3
831350,True,0,1 user reviews,0,1,1
831390,True,0,No user reviews,0,0,0
831450,True,0,No user reviews,0,0,0
831460,True,0,1 user reviews,1,0,1
831470,True,5,Mixed,8,5,13
831490,True,0,No user reviews,0,0,0
831510,True,0,2 user reviews,1,1,2
831520,True,0,8 user reviews,2,6,8
831530,True,7,Positive,28,3,31
831540,True,0,1 user reviews,0,1,1
831550,True,0,No user reviews,0,0,0
831560,True,8,Very Positive,404,72,476
831570,True,7,Positive,21,0,21
831590,True,0,No user reviews,0,0,0
831640,True,0,No user reviews,0,0,0
831650,True,0,1 user reviews,1,0,1
831660,True,0,2 user reviews,2,0,2
831670,True,0,8 user reviews,5,3,8
831680,True,0,3 user reviews,3,0,3
831690,True,0,2 user reviews,0,2,2
831700,True,0,6 user reviews,1,5,6
831710,True,5,Mixed,5,6,11
831720,True,7,Positive,19,1,20
831740,True,0,No user reviews,0,0,0
831760,True,0,No user reviews,0,0,0
831770,True,5,Mixed,7,4,11
831790,True,0,2 user reviews,1,1,2
831810,True,0,No user reviews,0,0,0
831830,True,0,No user reviews,0,0,0
831840,True,8,Very Positive,54,5,59
831890,True,0,No user reviews,0,0,0
831900,True,0,No user reviews,0,0,0
831910,True,0,1 user reviews,0,1,1
831920,True,0,No user reviews,0,0,0
831950,True,0,6 user reviews,3,3,6
831960,True,0,No user reviews,0,0,0
831961,True,0,No user reviews,0,0,0
831962,True,0,No user reviews,0,0,0
831963,True,0,No user reviews,0,0,0
831964,True,0,No user reviews,0,0,0
831965,True,0,No user reviews,0,0,0
831966,True,0,No user reviews,0,0,0
831967,True,0,No user reviews,0,0,0
831968,True,0,No user reviews,0,0,0
831969,True,0,No user reviews,0,0,0
831970,True,0,No user reviews,0,0,0
831971,True,0,No user reviews,0,0,0
831972,True,0,No user reviews,0,0,0
831973,True,0,No user reviews,0,0,0
831974,True,0,No user reviews,0,0,0
831980,True,8,Very Positive,745,55,800
832010,True,0,No user reviews,0,0,0
832020,True,0,No user reviews,0,0,0
832060,True,0,No user reviews,0,0,0
832080,True,0,No user reviews,0,0,0
832090,True,0,No user reviews,0,0,0
832100,True,0,No user reviews,0,0,0
832130,True,0,6 user reviews,5,1,6
832140,True,0,5 user reviews,5,0,5
832220,True,0,No user reviews,0,0,0
832221,True,0,No user reviews,0,0,0
832222,True,0,No user reviews,0,0,0
832310,True,0,No user reviews,0,0,0
832311,True,0,No user reviews,0,0,0
832312,True,0,No user reviews,0,0,0
832313,True,0,No user reviews,0,0,0
832314,True,0,No user reviews,0,0,0
832320,True,7,Positive,15,1,16
832350,True,5,Mixed,13,16,29
832360,True,0,No user reviews,0,0,0
832370,True,0,No user reviews,0,0,0
832380,True,0,2 user reviews,2,0,2
832400,True,0,No user reviews,0,0,0
832410,True,0,No user reviews,0,0,0
832411,True,0,No user reviews,0,0,0
832412,True,0,No user reviews,0,0,0
832420,True,0,6 user reviews,3,3,6
832430,True,0,No user reviews,0,0,0
832440,True,0,No user reviews,0,0,0
832450,True,0,No user reviews,0,0,0
832451,True,0,No user reviews,0,0,0
832452,True,0,No user reviews,0,0,0
832453,True,0,No user reviews,0,0,0
832460,True,0,No user reviews,0,0,0
832470,True,0,5 user reviews,4,1,5
832480,True,0,No user reviews,0,0,0
832481,True,0,No user reviews,0,0,0
832482,True,0,No user reviews,0,0,0
832483,True,0,No user reviews,0,0,0
832484,True,0,No user reviews,0,0,0
832485,True,0,No user reviews,0,0,0
832486,True,0,No user reviews,0,0,0
832487,True,0,No user reviews,0,0,0
832500,True,0,No user reviews,0,0,0
832510,True,0,No user reviews,0,0,0
832520,True,0,No user reviews,0,0,0
832530,True,0,No user reviews,0,0,0
832540,True,5,Mixed,16,7,23
832550,True,0,5 user reviews,1,4,5
832580,True,0,1 user reviews,1,0,1
832610,True,0,9 user reviews,1,8,9
832620,True,0,No user reviews,0,0,0
832640,True,0,No user reviews,0,0,0
832650,True,0,7 user reviews,5,2,7
832680,True,5,Mixed,8,4,12
832690,True,0,6 user reviews,4,2,6
832700,True,5,Mixed,35,28,63
832710,True,7,Positive,18,3,21
832720,True,5,Mixed,26,12,38
832730,True,0,No user reviews,0,0,0
832770,True,7,Positive,29,0,29
832780,True,0,No user reviews,0,0,0
832950,True,0,No user reviews,0,0,0
832990,True,0,6 user reviews,1,5,6
833010,True,0,4 user reviews,2,2,4
833020,True,0,No user reviews,0,0,0
833030,True,7,Positive,23,4,27
833040,True,8,Very Positive,780,51,831
833050,True,0,No user reviews,0,0,0
833051,True,0,No user reviews,0,0,0
833052,True,0,No user reviews,0,0,0
833053,True,0,No user reviews,0,0,0
833054,True,0,No user reviews,0,0,0
833055,True,0,No user reviews,0,0,0
833056,True,0,No user reviews,0,0,0
833060,True,0,No user reviews,0,0,0
833070,True,0,5 user reviews,5,0,5
833080,True,0,No user reviews,0,0,0
833081,True,0,No user reviews,0,0,0
833082,True,0,No user reviews,0,0,0
833083,True,0,No user reviews,0,0,0
833084,True,0,No user reviews,0,0,0
833085,True,0,No user reviews,0,0,0
833086,True,0,No user reviews,0,0,0
833087,True,0,No user reviews,0,0,0
833088,True,0,No user reviews,0,0,0
833089,True,0,No user reviews,0,0,0
833090,True,8,Very Positive,266,34,300
833110,True,0,4 user reviews,2,2,4
833130,True,0,No user reviews,0,0,0
833131,True,0,No user reviews,0,0,0
833140,True,7,Positive,40,3,43
833150,True,0,4 user reviews,2,2,4
833170,True,6,Mostly Positive,23,6,29
833180,True,0,7 user reviews,3,4,7
833240,True,0,No user reviews,0,0,0
833260,True,7,Positive,8,2,10
833270,True,7,Positive,11,1,12
833300,True,0,No user reviews,0,0,0
833310,True,0,No user reviews,0,0,0
833330,True,0,No user reviews,0,0,0
833340,True,0,No user reviews,0,0,0
833360,True,8,Very Positive,236,22,258
833370,True,5,Mixed,5,5,10
833380,True,0,2 user reviews,0,2,2
833390,True,0,2 user reviews,2,0,2
833400,True,5,Mixed,13,8,21
833420,True,0,No user reviews,0,0,0
833440,True,0,No user reviews,0,0,0
833450,True,0,No user reviews,0,0,0
833470,True,0,5 user reviews,4,1,5
833500,True,7,Positive,12,0,12
833510,True,0,1 user reviews,0,1,1
833530,True,0,No user reviews,0,0,0
833540,True,0,2 user reviews,1,1,2
833570,True,0,No user reviews,0,0,0
833580,True,0,No user reviews,0,0,0
833590,True,0,6 user reviews,6,0,6
833600,True,0,No user reviews,0,0,0
833610,True,0,No user reviews,0,0,0
833620,True,0,No user reviews,0,0,0
833640,True,0,4 user reviews,2,2,4
833650,True,0,1 user reviews,0,1,1
833660,True,0,9 user reviews,5,4,9
833670,True,0,2 user reviews,1,1,2
833690,True,0,6 user reviews,6,0,6
833700,True,0,7 user reviews,1,6,7
833730,True,0,No user reviews,0,0,0
833740,True,0,No user reviews,0,0,0
833750,True,0,1 user reviews,1,0,1
833760,True,0,No user reviews,0,0,0
833770,True,0,3 user reviews,2,1,3
833780,True,0,No user reviews,0,0,0
833800,True,0,1 user reviews,0,1,1
833810,True,0,4 user reviews,1,3,4
833820,True,0,7 user reviews,1,6,7
833830,True,0,No user reviews,0,0,0
833840,True,0,No user reviews,0,0,0
833850,True,0,No user reviews,0,0,0
833860,True,0,2 user reviews,1,1,2
833870,True,0,No user reviews,0,0,0
833880,True,0,No user reviews,0,0,0
833890,True,0,6 user reviews,5,1,6
833910,True,7,Positive,33,5,38
833920,True,0,5 user reviews,1,4,5
833940,True,0,1 user reviews,1,0,1
833950,True,7,Positive,19,0,19
833960,True,0,No user reviews,0,0,0
833980,True,0,4 user reviews,4,0,4
833990,True,7,Positive,23,1,24
834000,True,0,3 user reviews,1,2,3
834020,True,0,2 user reviews,0,2,2
834030,True,0,No user reviews,0,0,0
834040,True,0,No user reviews,0,0,0
834050,True,0,No user reviews,0,0,0
834060,True,5,Mixed,34,37,71
834070,True,5,Mixed,6,7,13
834100,True,0,1 user reviews,0,1,1
834110,True,0,No user reviews,0,0,0
834120,True,0,No user reviews,0,0,0
834130,True,0,2 user reviews,1,1,2
834131,True,0,2 user reviews,1,1,2
834140,True,5,Mixed,6,6,12
834150,True,6,Mostly Positive,10,4,14
834170,True,0,7 user reviews,4,3,7
834180,True,0,6 user reviews,5,1,6
834210,True,0,1 user reviews,0,1,1
834280,True,5,Mixed,168,75,243
834290,True,0,No user reviews,0,0,0
834320,True,0,No user reviews,0,0,0
834340,True,6,Mostly Positive,12,4,16
834350,True,0,1 user reviews,1,0,1
834360,True,0,2 user reviews,1,1,2
834380,True,0,5 user reviews,5,0,5
834390,True,5,Mixed,12,6,18
834400,True,0,1 user reviews,0,1,1
834401,True,0,8 user reviews,8,0,8
834402,True,0,No user reviews,0,0,0
834403,True,5,Mixed,9,5,14
834404,True,0,4 user reviews,4,0,4
834405,True,0,2 user reviews,2,0,2
834406,True,0,2 user reviews,0,2,2
834407,True,5,Mixed,9,13,22
834408,True,0,3 user reviews,2,1,3
834410,True,0,No user reviews,0,0,0
834420,True,0,2 user reviews,1,1,2
834430,True,0,No user reviews,0,0,0
834440,True,0,No user reviews,0,0,0
834450,True,5,Mixed,5,6,11
834470,True,0,No user reviews,0,0,0
834490,True,0,No user reviews,0,0,0
834500,True,0,No user reviews,0,0,0
834510,True,0,No user reviews,0,0,0
834520,True,0,No user reviews,0,0,0
834530,True,8,Very Positive,2454,138,2592
834550,True,0,No user reviews,0,0,0
834560,True,0,No user reviews,0,0,0
834580,True,7,Positive,16,0,16
834590,True,0,No user reviews,0,0,0
834730,True,0,No user reviews,0,0,0
834740,True,8,Very Positive,704,103,807
834750,True,5,Mixed,16,12,28
834760,True,8,Very Positive,49,1,50
834800,True,5,Mixed,26,19,45
834880,True,0,No user reviews,0,0,0
834910,True,5,Mixed,7748,8876,16624
834920,True,0,No user reviews,0,0,0
834930,True,0,3 user reviews,3,0,3
835040,True,0,7 user reviews,5,2,7
835110,True,7,Positive,34,3,37
835130,True,0,4 user reviews,2,2,4
835140,True,0,No user reviews,0,0,0
835280,True,0,No user reviews,0,0,0
835430,True,8,Very Positive,235,36,271
835440,True,0,1 user reviews,0,1,1
835450,True,0,1 user reviews,0,1,1
835460,True,0,1 user reviews,1,0,1
835470,True,0,No user reviews,0,0,0
835471,True,0,1 user reviews,0,1,1
835480,True,0,No user reviews,0,0,0
835490,True,0,2 user reviews,1,1,2
835500,True,0,No user reviews,0,0,0
835510,True,0,9 user reviews,4,5,9
835520,True,0,2 user reviews,2,0,2
835530,True,0,No user reviews,0,0,0
835560,True,0,3 user reviews,3,0,3
835570,True,6,Mostly Positive,145,47,192
835590,True,0,No user reviews,0,0,0
835600,True,0,3 user reviews,2,1,3
835620,True,0,No user reviews,0,0,0
835630,True,0,7 user reviews,7,0,7
835640,True,0,4 user reviews,4,0,4
835650,True,8,Very Positive,60,7,67
835660,True,0,1 user reviews,0,1,1
835670,True,8,Very Positive,466,108,574
835671,True,0,No user reviews,0,0,0
835680,True,0,2 user reviews,2,0,2
835690,True,0,3 user reviews,3,0,3
835700,True,7,Positive,21,4,25
835710,True,0,8 user reviews,8,0,8
835720,True,0,No user reviews,0,0,0
835730,True,0,3 user reviews,3,0,3
835740,True,0,1 user reviews,1,0,1
835750,True,0,No user reviews,0,0,0
835770,True,0,No user reviews,0,0,0
835780,True,0,No user reviews,0,0,0
835790,True,0,No user reviews,0,0,0
835800,True,0,No user reviews,0,0,0
835830,True,0,No user reviews,0,0,0
835860,True,0,1 user reviews,0,1,1
835910,True,5,Mixed,6,5,11
835950,True,7,Positive,38,1,39
836010,True,0,No user reviews,0,0,0
836040,True,0,No user reviews,0,0,0
836080,True,6,Mostly Positive,10,4,14
836090,True,0,No user reviews,0,0,0
836110,True,5,Mixed,11,9,20
836120,True,0,No user reviews,0,0,0
836230,True,0,1 user reviews,1,0,1
836260,True,0,4 user reviews,4,0,4
836270,True,0,No user reviews,0,0,0
836280,True,0,3 user reviews,2,1,3
836290,True,0,4 user reviews,3,1,4
836300,True,0,4 user reviews,4,0,4
836310,True,0,No user reviews,0,0,0
836320,True,0,No user reviews,0,0,0
836321,True,0,No user reviews,0,0,0
836330,True,0,8 user reviews,3,5,8
836340,True,0,No user reviews,0,0,0
836350,True,7,Positive,15,2,17
836370,True,0,No user reviews,0,0,0
836380,True,0,No user reviews,0,0,0
836400,True,0,1 user reviews,1,0,1
836420,True,0,1 user reviews,0,1,1
836440,True,0,No user reviews,0,0,0
836450,True,8,Very Positive,213,14,227
836460,True,0,6 user reviews,5,1,6
836470,True,0,3 user reviews,1,2,3
836480,True,0,8 user reviews,5,3,8
836490,True,7,Positive,37,5,42
836510,True,0,No user reviews,0,0,0
836520,True,0,No user reviews,0,0,0
836530,True,0,No user reviews,0,0,0
836540,True,0,6 user reviews,6,0,6
836550,True,0,4 user reviews,4,0,4
836560,True,0,6 user reviews,5,1,6
836570,True,0,No user reviews,0,0,0
836580,True,4,Mostly Negative,5,11,16
836590,True,0,7 user reviews,4,3,7
836600,True,0,6 user reviews,5,1,6
836610,True,0,7 user reviews,7,0,7
836620,True,6,Mostly Positive,13342,5203,18545
836630,True,0,4 user reviews,3,1,4
836631,True,0,1 user reviews,1,0,1
836632,True,0,1 user reviews,0,1,1
836640,True,7,Positive,9,1,10
836680,True,0,No user reviews,0,0,0
836690,True,0,2 user reviews,2,0,2
836700,True,0,5 user reviews,3,2,5
836710,True,0,No user reviews,0,0,0
836730,True,0,No user reviews,0,0,0
836750,True,5,Mixed,12,14,26
836760,True,6,Mostly Positive,39,13,52
836770,True,5,Mixed,12,8,20
836781,True,7,Positive,12,2,14
836783,True,0,3 user reviews,3,0,3
836785,True,0,7 user reviews,6,1,7
836790,True,0,7 user reviews,5,2,7
836810,True,5,Mixed,19,24,43
836811,True,5,Mixed,20,10,30
836812,True,7,Positive,12,1,13
836820,True,0,6 user reviews,5,1,6
836830,True,0,No user reviews,0,0,0
836840,True,0,No user reviews,0,0,0
836841,True,0,No user reviews,0,0,0
836842,True,0,No user reviews,0,0,0
836843,True,0,No user reviews,0,0,0
836844,True,0,No user reviews,0,0,0
836845,True,0,No user reviews,0,0,0
836846,True,0,No user reviews,0,0,0
836850,True,5,Mixed,44,24,68
836860,True,3,Negative,2,13,15
836870,True,4,Mostly Negative,3,12,15
836880,True,0,No user reviews,0,0,0
836890,True,0,No user reviews,0,0,0
836900,True,7,Positive,11,1,12
836910,True,0,No user reviews,0,0,0
836920,True,0,No user reviews,0,0,0
836930,True,0,No user reviews,0,0,0
836940,True,0,No user reviews,0,0,0
837040,True,7,Positive,9,1,10
837060,True,0,No user reviews,0,0,0
837090,True,0,9 user reviews,8,1,9
837100,True,5,Mixed,4,6,10
837110,True,3,Negative,1,10,11
837140,True,0,No user reviews,0,0,0
837150,True,0,No user reviews,0,0,0
837160,True,0,No user reviews,0,0,0
837170,True,0,No user reviews,0,0,0
837180,True,0,3 user reviews,3,0,3
837190,True,7,Positive,26,3,29
837200,True,6,Mostly Positive,14,6,20
837210,True,0,2 user reviews,1,1,2
837220,True,0,1 user reviews,0,1,1
837240,True,0,9 user reviews,5,4,9
837260,True,0,2 user reviews,1,1,2
837270,True,0,4 user reviews,3,1,4
837280,True,0,No user reviews,0,0,0
837290,True,0,1 user reviews,0,1,1
837310,True,0,No user reviews,0,0,0
837330,True,0,5 user reviews,5,0,5
837340,True,0,No user reviews,0,0,0
837350,True,0,No user reviews,0,0,0
837360,True,0,2 user reviews,1,1,2
837380,True,0,No user reviews,0,0,0
837390,True,0,No user reviews,0,0,0
837400,True,8,Very Positive,82,13,95
837430,True,5,Mixed,8,7,15
837440,True,6,Mostly Positive,13,4,17
837450,True,0,2 user reviews,2,0,2
837460,True,7,Positive,33,1,34
837470,True,8,Very Positive,766,52,818
837500,True,0,No user reviews,0,0,0
837510,True,6,Mostly Positive,59,24,83
837530,True,0,8 user reviews,1,7,8
837550,True,0,2 user reviews,1,1,2
837570,True,0,No user reviews,0,0,0
837590,True,5,Mixed,38,22,60
837600,True,5,Mixed,15,13,28
837610,True,8,Very Positive,198,30,228
837640,True,0,No user reviews,0,0,0
837720,True,0,No user reviews,0,0,0
837780,True,0,9 user reviews,4,5,9
837790,True,5,Mixed,9,5,14
837800,True,6,Mostly Positive,13,4,17
837810,True,0,3 user reviews,0,3,3
837830,True,7,Positive,13,0,13
837840,True,0,7 user reviews,7,0,7
837841,True,0,7 user reviews,5,2,7
837850,True,7,Positive,13,1,14
837860,True,0,4 user reviews,4,0,4
837861,True,0,5 user reviews,5,0,5
837880,True,0,No user reviews,0,0,0
837900,True,0,7 user reviews,3,4,7
837910,True,0,No user reviews,0,0,0
837920,True,0,No user reviews,0,0,0
837930,True,6,Mostly Positive,9,3,12
837940,True,7,Positive,17,1,18
837950,True,0,No user reviews,0,0,0
837970,True,0,No user reviews,0,0,0
837990,True,0,No user reviews,0,0,0
838000,True,0,No user reviews,0,0,0
838010,True,7,Positive,26,4,30
838020,True,0,1 user reviews,1,0,1
838030,True,0,No user reviews,0,0,0
838050,True,5,Mixed,8,11,19
838060,True,0,No user reviews,0,0,0
838080,True,0,No user reviews,0,0,0
838090,True,0,No user reviews,0,0,0
838100,True,0,6 user reviews,6,0,6
838110,True,7,Positive,39,6,45
838120,True,0,6 user reviews,6,0,6
838130,True,0,2 user reviews,2,0,2
838140,True,0,2 user reviews,2,0,2
838150,True,0,1 user reviews,0,1,1
838160,True,0,6 user reviews,3,3,6
838170,True,0,No user reviews,0,0,0
838180,True,7,Positive,35,7,42
838190,True,0,No user reviews,0,0,0
838210,True,0,No user reviews,0,0,0
838220,True,0,No user reviews,0,0,0
838230,True,0,No user reviews,0,0,0
838240,True,0,No user reviews,0,0,0
838250,True,0,No user reviews,0,0,0
838251,True,0,No user reviews,0,0,0
838270,True,5,Mixed,7,10,17
838300,True,0,No user reviews,0,0,0
838310,True,8,Very Positive,1202,86,1288
838330,True,5,Mixed,85,48,133
838340,True,0,8 user reviews,6,2,8
838350,True,8,Very Positive,339,38,377
838360,True,0,No user reviews,0,0,0
838370,True,0,No user reviews,0,0,0
838380,True,5,Mixed,590,271,861
838390,True,7,Positive,28,3,31
838400,True,0,No user reviews,0,0,0
838410,True,7,Positive,18,2,20
838420,True,0,6 user reviews,1,5,6
838430,True,0,No user reviews,0,0,0
838440,True,0,No user reviews,0,0,0
838450,True,0,No user reviews,0,0,0
838490,True,0,8 user reviews,8,0,8
838510,True,0,No user reviews,0,0,0
838530,True,0,2 user reviews,2,0,2
838540,True,0,1 user reviews,1,0,1
838610,True,0,No user reviews,0,0,0
838620,True,8,Very Positive,67,5,72
838630,True,5,Mixed,197,147,344
838680,True,0,No user reviews,0,0,0
838690,True,0,No user reviews,0,0,0
838700,True,0,3 user reviews,3,0,3
838710,True,0,2 user reviews,2,0,2
838720,True,0,3 user reviews,3,0,3
838730,True,0,3 user reviews,2,1,3
838740,True,0,No user reviews,0,0,0
838750,True,0,1 user reviews,1,0,1
838760,True,0,2 user reviews,1,1,2
838770,True,8,Very Positive,141,20,161
838790,True,0,3 user reviews,2,1,3
838800,True,0,No user reviews,0,0,0
838810,True,0,1 user reviews,1,0,1
838820,True,4,Mostly Negative,7,11,18
838840,True,0,3 user reviews,0,3,3
838850,True,0,No user reviews,0,0,0
838860,True,7,Positive,29,0,29
838870,True,0,No user reviews,0,0,0
838900,True,0,No user reviews,0,0,0
838920,True,0,No user reviews,0,0,0
838930,True,0,No user reviews,0,0,0
838940,True,0,5 user reviews,3,2,5
838970,True,0,No user reviews,0,0,0
838980,True,0,1 user reviews,0,1,1
838990,True,8,Very Positive,67,13,80
839000,True,0,No user reviews,0,0,0
839010,True,0,2 user reviews,2,0,2
839020,True,7,Positive,19,4,23
839030,True,0,1 user reviews,0,1,1
839040,True,0,4 user reviews,2,2,4
839080,True,0,2 user reviews,1,1,2
839090,True,0,6 user reviews,5,1,6
839110,True,0,1 user reviews,1,0,1
839130,True,0,3 user reviews,3,0,3
839170,True,0,8 user reviews,5,3,8
839180,True,0,No user reviews,0,0,0
839190,True,0,No user reviews,0,0,0
839200,True,0,No user reviews,0,0,0
839210,True,0,3 user reviews,3,0,3
839230,True,0,4 user reviews,4,0,4
839240,True,0,No user reviews,0,0,0
839250,True,0,1 user reviews,0,1,1
839260,True,5,Mixed,6,7,13
839270,True,0,No user reviews,0,0,0
839280,True,7,Positive,20,3,23
839290,True,0,No user reviews,0,0,0
839300,True,5,Mixed,6,5,11
839310,True,8,Very Positive,380,69,449
839320,True,0,No user reviews,0,0,0
839330,True,0,No user reviews,0,0,0
839340,True,7,Positive,14,1,15
839350,True,0,No user reviews,0,0,0
839360,True,0,No user reviews,0,0,0
839370,True,0,No user reviews,0,0,0
839400,True,0,No user reviews,0,0,0
839410,True,0,No user reviews,0,0,0
839420,True,7,Positive,15,1,16
839430,True,0,No user reviews,0,0,0
839450,True,8,Very Positive,66,10,76
839460,True,0,No user reviews,0,0,0
839470,True,0,No user reviews,0,0,0
839500,True,0,No user reviews,0,0,0
839510,True,0,No user reviews,0,0,0
839520,True,0,1 user reviews,0,1,1
839530,True,0,1 user reviews,1,0,1
839540,True,0,2 user reviews,0,2,2
839550,True,0,No user reviews,0,0,0
839560,True,0,No user reviews,0,0,0
839570,True,6,Mostly Positive,11,3,14
839580,True,0,3 user reviews,1,2,3
839590,True,0,2 user reviews,0,2,2
839610,True,0,No user reviews,0,0,0
839620,True,0,1 user reviews,0,1,1
839630,True,5,Mixed,90,70,160
839660,True,0,No user reviews,0,0,0
839670,True,6,Mostly Positive,10,4,14
839680,True,0,No user reviews,0,0,0
839690,True,0,No user reviews,0,0,0
839710,True,0,No user reviews,0,0,0
839730,True,0,4 user reviews,2,2,4
839750,True,0,No user reviews,0,0,0
839760,True,0,No user reviews,0,0,0
839770,True,0,No user reviews,0,0,0
839810,True,0,No user reviews,0,0,0
839820,True,0,2 user reviews,1,1,2
839850,True,7,Positive,20,0,20
839860,True,0,No user reviews,0,0,0
839870,True,8,Very Positive,163,9,172
839890,True,0,7 user reviews,3,4,7
839910,True,0,No user reviews,0,0,0
839920,True,0,2 user reviews,1,1,2
839930,True,5,Mixed,82,39,121
839940,True,7,Positive,16,0,16
839950,True,0,No user reviews,0,0,0
839960,True,7,Positive,18,1,19
839970,True,0,1 user reviews,1,0,1
839990,True,0,No user reviews,0,0,0
840010,True,8,Very Positive,804,96,900
840020,True,0,3 user reviews,3,0,3
840030,True,0,No user reviews,0,0,0
840040,True,0,No user reviews,0,0,0
840050,True,0,No user reviews,0,0,0
840060,True,0,2 user reviews,2,0,2
840070,True,0,No user reviews,0,0,0
840090,True,0,2 user reviews,0,2,2
840100,True,6,Mostly Positive,8,3,11
840110,True,0,No user reviews,0,0,0
840130,True,0,3 user reviews,1,2,3
840140,True,4,Mostly Negative,56,97,153
840160,True,0,7 user reviews,7,0,7
840170,True,0,2 user reviews,0,2,2
840180,True,0,No user reviews,0,0,0
840190,True,0,8 user reviews,4,4,8
840210,True,0,No user reviews,0,0,0
840220,True,0,No user reviews,0,0,0
840230,True,0,3 user reviews,3,0,3
840240,True,0,9 user reviews,7,2,9
840260,True,0,4 user reviews,3,1,4
840280,True,0,No user reviews,0,0,0
840300,True,0,3 user reviews,3,0,3
840310,True,7,Positive,13,1,14
840370,True,6,Mostly Positive,84,29,113
840380,True,0,3 user reviews,3,0,3
840390,True,0,No user reviews,0,0,0
840410,True,0,No user reviews,0,0,0
840430,True,7,Positive,22,2,24
840440,True,0,4 user reviews,4,0,4
840460,True,0,No user reviews,0,0,0
840490,True,0,No user reviews,0,0,0
840500,True,0,3 user reviews,1,2,3
840510,True,0,No user reviews,0,0,0
840520,True,0,No user reviews,0,0,0
840540,True,0,No user reviews,0,0,0
840580,True,0,2 user reviews,1,1,2
840590,True,0,6 user reviews,3,3,6
840610,True,7,Positive,25,0,25
840620,True,0,No user reviews,0,0,0
840630,True,0,No user reviews,0,0,0
840640,True,0,No user reviews,0,0,0
840670,True,0,No user reviews,0,0,0
840680,True,0,No user reviews,0,0,0
840690,True,0,6 user reviews,6,0,6
840700,True,0,8 user reviews,8,0,8
840710,True,0,7 user reviews,4,3,7
840720,True,6,Mostly Positive,198,50,248
840730,True,0,5 user reviews,4,1,5
840750,True,0,8 user reviews,7,1,8
840760,True,0,5 user reviews,5,0,5
840770,True,0,3 user reviews,3,0,3
840790,True,0,2 user reviews,1,1,2
840800,True,5,Mixed,1615,747,2362
840810,True,0,No user reviews,0,0,0
840820,True,0,No user reviews,0,0,0
840830,True,0,No user reviews,0,0,0
840840,True,0,No user reviews,0,0,0
840850,True,0,No user reviews,0,0,0
840860,True,0,1 user reviews,1,0,1
840880,True,0,No user reviews,0,0,0
840890,True,0,No user reviews,0,0,0
840910,True,0,2 user reviews,2,0,2
840920,True,0,1 user reviews,0,1,1
840930,True,8,Very Positive,72,9,81
840940,True,0,1 user reviews,1,0,1
840980,True,0,5 user reviews,4,1,5
840991,True,0,2 user reviews,2,0,2
841000,True,0,No user reviews,0,0,0
841010,True,0,2 user reviews,2,0,2
841020,True,0,No user reviews,0,0,0
841030,True,0,6 user reviews,3,3,6
841070,True,0,No user reviews,0,0,0
841080,True,0,No user reviews,0,0,0
841110,True,0,No user reviews,0,0,0
841120,True,7,Positive,9,2,11
841140,True,4,Mostly Negative,4,7,11
841150,True,5,Mixed,8,5,13
841160,True,0,3 user reviews,2,1,3
841161,True,0,No user reviews,0,0,0
841162,True,0,4 user reviews,2,2,4
841163,True,0,No user reviews,0,0,0
841164,True,0,No user reviews,0,0,0
841165,True,0,No user reviews,0,0,0
841166,True,0,No user reviews,0,0,0
841167,True,0,No user reviews,0,0,0
841168,True,0,1 user reviews,1,0,1
841170,True,0,No user reviews,0,0,0
841190,True,0,No user reviews,0,0,0
841200,True,0,6 user reviews,5,1,6
841210,True,0,2 user reviews,2,0,2
841220,True,0,No user reviews,0,0,0
841240,True,0,No user reviews,0,0,0
841250,True,6,Mostly Positive,22,8,30
841260,True,0,6 user reviews,2,4,6
841270,True,0,No user reviews,0,0,0
841280,True,0,1 user reviews,1,0,1
841290,True,0,No user reviews,0,0,0
841300,True,0,No user reviews,0,0,0
841310,True,0,No user reviews,0,0,0
841320,True,6,Mostly Positive,8,3,11
841330,True,0,No user reviews,0,0,0
841340,True,0,9 user reviews,6,3,9
841350,True,5,Mixed,14,11,25
841370,True,5,Mixed,1675,1640,3315
841440,True,0,2 user reviews,2,0,2
841460,True,8,Very Positive,110,13,123
841470,True,0,1 user reviews,1,0,1
841500,True,0,No user reviews,0,0,0
841570,True,0,2 user reviews,1,1,2
841580,True,0,1 user reviews,1,0,1
841600,True,8,Very Positive,54,2,56
841640,True,0,No user reviews,0,0,0
841650,True,0,No user reviews,0,0,0
841660,True,7,Positive,39,7,46
841670,True,0,No user reviews,0,0,0
841680,True,0,3 user reviews,3,0,3
841690,True,0,1 user reviews,1,0,1
841700,True,0,No user reviews,0,0,0
841710,True,0,No user reviews,0,0,0
841720,True,0,No user reviews,0,0,0
841730,True,0,No user reviews,0,0,0
841740,True,0,1 user reviews,1,0,1
841750,True,0,No user reviews,0,0,0
841770,True,9,Overwhelmingly Positive,685,34,719
841790,True,0,1 user reviews,0,1,1
841800,True,0,3 user reviews,1,2,3
841820,True,0,3 user reviews,3,0,3
841821,True,0,1 user reviews,0,1,1
841830,True,0,No user reviews,0,0,0
841840,True,0,9 user reviews,5,4,9
841850,True,0,No user reviews,0,0,0
841870,True,0,No user reviews,0,0,0
841900,True,0,No user reviews,0,0,0
841910,True,0,1 user reviews,1,0,1
841940,True,0,No user reviews,0,0,0
841950,True,0,7 user reviews,5,2,7
841970,True,0,No user reviews,0,0,0
841980,True,6,Mostly Positive,9,3,12
841990,True,0,1 user reviews,0,1,1
842000,True,0,2 user reviews,2,0,2
842020,True,0,6 user reviews,5,1,6
842030,True,0,2 user reviews,1,1,2
842050,True,0,6 user reviews,2,4,6
842070,True,0,1 user reviews,0,1,1
842080,True,0,No user reviews,0,0,0
842090,True,0,No user reviews,0,0,0
842100,True,6,Mostly Positive,397,158,555
842120,True,0,8 user reviews,7,1,8
842130,True,0,No user reviews,0,0,0
842140,True,7,Positive,26,4,30
842150,True,0,No user reviews,0,0,0
842160,True,0,No user reviews,0,0,0
842170,True,7,Positive,30,3,33
842180,True,0,No user reviews,0,0,0
842190,True,0,No user reviews,0,0,0
842210,True,0,No user reviews,0,0,0
842211,True,0,No user reviews,0,0,0
842212,True,0,No user reviews,0,0,0
842213,True,0,No user reviews,0,0,0
842214,True,0,No user reviews,0,0,0
842215,True,0,No user reviews,0,0,0
842240,True,0,No user reviews,0,0,0
842250,True,4,Mostly Negative,16,27,43
842270,True,0,No user reviews,0,0,0
842290,True,0,1 user reviews,0,1,1
842300,True,0,No user reviews,0,0,0
842310,True,0,2 user reviews,1,1,2
842330,True,0,4 user reviews,3,1,4
842331,True,0,No user reviews,0,0,0
842340,True,0,No user reviews,0,0,0
842350,True,0,1 user reviews,0,1,1
842360,True,0,No user reviews,0,0,0
842361,True,0,1 user reviews,1,0,1
842362,True,0,No user reviews,0,0,0
842363,True,0,1 user reviews,1,0,1
842364,True,0,2 user reviews,2,0,2
842365,True,0,No user reviews,0,0,0
842366,True,0,1 user reviews,0,1,1
842367,True,0,No user reviews,0,0,0
842368,True,0,No user reviews,0,0,0
842369,True,0,1 user reviews,0,1,1
842370,True,0,No user reviews,0,0,0
842381,True,0,No user reviews,0,0,0
842382,True,0,2 user reviews,2,0,2
842383,True,0,No user reviews,0,0,0
842384,True,0,No user reviews,0,0,0
842390,True,0,No user reviews,0,0,0
842420,True,0,No user reviews,0,0,0
842430,True,0,5 user reviews,5,0,5
842450,True,0,No user reviews,0,0,0
842451,True,0,No user reviews,0,0,0
842452,True,0,No user reviews,0,0,0
842453,True,0,No user reviews,0,0,0
842470,True,0,3 user reviews,3,0,3
842480,True,0,No user reviews,0,0,0
842490,True,0,2 user reviews,1,1,2
842500,True,0,No user reviews,0,0,0
842510,True,0,1 user reviews,0,1,1
842520,True,0,No user reviews,0,0,0
842530,True,0,6 user reviews,2,4,6
842540,True,0,No user reviews,0,0,0
842541,True,0,No user reviews,0,0,0
842542,True,0,No user reviews,0,0,0
842543,True,0,No user reviews,0,0,0
842550,True,0,No user reviews,0,0,0
842560,True,0,5 user reviews,0,5,5
842570,True,0,No user reviews,0,0,0
842590,True,0,1 user reviews,1,0,1
842620,True,0,No user reviews,0,0,0
842640,True,0,8 user reviews,3,5,8
842650,True,0,No user reviews,0,0,0
842651,True,0,No user reviews,0,0,0
842660,True,0,No user reviews,0,0,0
842670,True,0,No user reviews,0,0,0
842680,True,7,Positive,31,6,37
842690,True,0,No user reviews,0,0,0
842700,True,0,No user reviews,0,0,0
842710,True,0,No user reviews,0,0,0
842711,True,0,No user reviews,0,0,0
842720,True,0,No user reviews,0,0,0
842750,True,7,Positive,23,2,25
842760,True,0,3 user reviews,3,0,3
842770,True,0,7 user reviews,7,0,7
842780,True,8,Very Positive,64,16,80
842810,True,8,Very Positive,55,7,62
842820,True,0,1 user reviews,1,0,1
842840,True,0,No user reviews,0,0,0
842841,True,0,No user reviews,0,0,0
842850,True,7,Positive,9,2,11
842870,True,0,2 user reviews,1,1,2
842880,True,0,No user reviews,0,0,0
842910,True,8,Very Positive,308,27,335
842940,True,0,No user reviews,0,0,0
842950,True,0,4 user reviews,4,0,4
842951,True,0,2 user reviews,2,0,2
842952,True,0,No user reviews,0,0,0
842960,True,0,2 user reviews,2,0,2
842990,True,0,4 user reviews,4,0,4
843000,True,0,1 user reviews,0,1,1
843010,True,6,Mostly Positive,13,5,18
843020,True,0,No user reviews,0,0,0
843040,True,5,Mixed,4,6,10
843050,True,0,No user reviews,0,0,0
843070,True,0,No user reviews,0,0,0
843080,True,0,1 user reviews,1,0,1
843100,True,0,No user reviews,0,0,0
843101,True,0,No user reviews,0,0,0
843102,True,0,No user reviews,0,0,0
843103,True,0,No user reviews,0,0,0
843120,True,0,6 user reviews,6,0,6
843130,True,0,No user reviews,0,0,0
843160,True,0,7 user reviews,4,3,7
843170,True,7,Positive,27,0,27
843180,True,0,No user reviews,0,0,0
843190,True,0,3 user reviews,0,3,3
843200,True,0,No user reviews,0,0,0
843240,True,0,No user reviews,0,0,0
843250,True,5,Mixed,8,4,12
843260,True,9,Overwhelmingly Positive,509,19,528
843270,True,0,7 user reviews,4,3,7
843280,True,0,No user reviews,0,0,0
843290,True,0,No user reviews,0,0,0
843330,True,0,No user reviews,0,0,0
843340,True,0,3 user reviews,2,1,3
843360,True,5,Mixed,4,6,10
843370,True,0,8 user reviews,8,0,8
843380,True,9,Overwhelmingly Positive,2521,72,2593
843390,True,0,No user reviews,0,0,0
843400,True,0,1 user reviews,0,1,1
843420,True,0,3 user reviews,1,2,3
843430,True,8,Very Positive,57,4,61
843440,True,8,Very Positive,64,4,68
843500,True,0,No user reviews,0,0,0
843510,True,7,Positive,14,3,17
843520,True,6,Mostly Positive,11,4,15
843580,True,0,1 user reviews,0,1,1
843590,True,0,3 user reviews,3,0,3
843600,True,0,No user reviews,0,0,0
843620,True,0,No user reviews,0,0,0
843630,True,0,No user reviews,0,0,0
843640,True,7,Positive,16,3,19
843650,True,0,1 user reviews,1,0,1
843660,True,0,No user reviews,0,0,0
843671,True,0,No user reviews,0,0,0
843700,True,0,No user reviews,0,0,0
843710,True,0,1 user reviews,1,0,1
843720,True,0,7 user reviews,5,2,7
843730,True,5,Mixed,16,7,23
843740,True,6,Mostly Positive,8,3,11
843760,True,0,2 user reviews,1,1,2
843770,True,0,No user reviews,0,0,0
843780,True,0,4 user reviews,3,1,4
843790,True,0,No user reviews,0,0,0
843800,True,0,No user reviews,0,0,0
843810,True,0,No user reviews,0,0,0
843820,True,0,5 user reviews,2,3,5
843830,True,0,No user reviews,0,0,0
843840,True,7,Positive,9,1,10
843850,True,0,No user reviews,0,0,0
843860,True,4,Mostly Negative,10,19,29
843870,True,5,Mixed,9,6,15
843890,True,5,Mixed,18,9,27
843900,True,8,Very Positive,43,9,52
843910,True,0,No user reviews,0,0,0
843920,True,0,No user reviews,0,0,0
843930,True,0,3 user reviews,3,0,3
843980,True,0,1 user reviews,1,0,1
843990,True,0,3 user reviews,3,0,3
844020,True,0,No user reviews,0,0,0
844030,True,0,No user reviews,0,0,0
844040,True,8,Very Positive,67,14,81
844050,True,7,Positive,26,6,32
844060,True,0,No user reviews,0,0,0
844070,True,0,No user reviews,0,0,0
844090,True,0,6 user reviews,0,6,6
844120,True,0,No user reviews,0,0,0
844130,True,7,Positive,21,0,21
844140,True,6,Mostly Positive,7,3,10
844160,True,0,8 user reviews,8,0,8
844180,True,6,Mostly Positive,22,6,28
844190,True,7,Positive,21,1,22
844210,True,5,Mixed,23,10,33
844220,True,0,No user reviews,0,0,0
844240,True,0,1 user reviews,1,0,1
844250,True,0,4 user reviews,0,4,4
844260,True,0,No user reviews,0,0,0
844290,True,0,5 user reviews,1,4,5
844300,True,0,8 user reviews,3,5,8
844310,True,0,9 user reviews,3,6,9
844320,True,0,No user reviews,0,0,0
844330,True,5,Mixed,73,40,113
844340,True,0,3 user reviews,2,1,3
844350,True,0,1 user reviews,1,0,1
844370,True,0,No user reviews,0,0,0
844380,True,7,Positive,11,1,12
844410,True,0,No user reviews,0,0,0
844420,True,8,Very Positive,70,14,84
844440,True,0,7 user reviews,7,0,7
844460,True,0,No user reviews,0,0,0
844470,True,0,No user reviews,0,0,0
844480,True,0,No user reviews,0,0,0
844490,True,0,No user reviews,0,0,0
844500,True,6,Mostly Positive,21,9,30
844510,True,0,4 user reviews,4,0,4
844520,True,0,No user reviews,0,0,0
844530,True,0,No user reviews,0,0,0
844540,True,0,No user reviews,0,0,0
844550,True,0,4 user reviews,4,0,4
844580,True,0,No user reviews,0,0,0
844590,True,9,Overwhelmingly Positive,1245,27,1272
844610,True,0,5 user reviews,1,4,5
844620,True,0,1 user reviews,1,0,1
844650,True,0,No user reviews,0,0,0
844660,True,8,Very Positive,277,4,281
844670,True,0,No user reviews,0,0,0
844680,True,0,No user reviews,0,0,0
844690,True,0,No user reviews,0,0,0
844710,True,0,No user reviews,0,0,0
844740,True,0,No user reviews,0,0,0
844750,True,5,Mixed,15,16,31
844760,True,0,4 user reviews,3,1,4
844810,True,6,Mostly Positive,159,58,217
844820,True,0,2 user reviews,1,1,2
844830,True,0,5 user reviews,3,2,5
844840,True,0,No user reviews,0,0,0
844850,True,5,Mixed,78,51,129
844860,True,7,Positive,26,3,29
844870,True,5,Mixed,22,17,39
844880,True,0,No user reviews,0,0,0
844890,True,6,Mostly Positive,135,49,184
844900,True,0,5 user reviews,3,2,5
844920,True,0,6 user reviews,3,3,6
844930,True,8,Very Positive,395,26,421
844940,True,0,No user reviews,0,0,0
844950,True,0,1 user reviews,1,0,1
844960,True,0,No user reviews,0,0,0
844970,True,0,6 user reviews,6,0,6
844980,True,0,No user reviews,0,0,0
844990,True,0,1 user reviews,0,1,1
845000,True,7,Positive,16,3,19
845010,True,6,Mostly Positive,29,8,37
845020,True,0,6 user reviews,4,2,6
845030,True,7,Positive,16,0,16
845040,True,7,Positive,18,4,22
845050,True,7,Positive,32,3,35
845070,True,0,No user reviews,0,0,0
845090,True,0,No user reviews,0,0,0
845110,True,0,No user reviews,0,0,0
845120,True,0,1 user reviews,1,0,1
845130,True,0,No user reviews,0,0,0
845140,True,0,3 user reviews,1,2,3
845142,True,0,1 user reviews,1,0,1
845143,True,0,3 user reviews,2,1,3
845144,True,0,1 user reviews,1,0,1
845147,True,0,1 user reviews,0,1,1
845148,True,0,1 user reviews,1,0,1
845149,True,0,5 user reviews,5,0,5
845150,True,0,9 user reviews,8,1,9
845170,True,0,No user reviews,0,0,0
845190,True,0,1 user reviews,1,0,1
845200,True,0,3 user reviews,0,3,3
845210,True,0,2 user reviews,1,1,2
845250,True,0,No user reviews,0,0,0
845270,True,7,Positive,45,1,46
845290,True,0,2 user reviews,1,1,2
845330,True,0,9 user reviews,3,6,9
845340,True,0,1 user reviews,1,0,1
845350,True,0,3 user reviews,2,1,3
845370,True,0,No user reviews,0,0,0
845380,True,5,Mixed,13,9,22
845390,True,0,5 user reviews,3,2,5
845400,True,0,9 user reviews,2,7,9
845410,True,0,3 user reviews,1,2,3
845420,True,0,9 user reviews,5,4,9
845440,True,0,7 user reviews,0,7,7
845450,True,0,No user reviews,0,0,0
845460,True,0,3 user reviews,1,2,3
845470,True,0,No user reviews,0,0,0
845480,True,0,3 user reviews,0,3,3
845490,True,5,Mixed,22,12,34
845500,True,0,3 user reviews,0,3,3
845510,True,0,No user reviews,0,0,0
845520,True,0,9 user reviews,3,6,9
845530,True,4,Mostly Negative,9,17,26
845570,True,0,2 user reviews,0,2,2
845580,True,0,1 user reviews,1,0,1
845581,True,0,No user reviews,0,0,0
845582,True,0,1 user reviews,1,0,1
845590,True,0,9 user reviews,4,5,9
845600,True,0,4 user reviews,3,1,4
845630,True,0,8 user reviews,5,3,8
845640,True,8,Very Positive,246,29,275
845650,True,0,1 user reviews,1,0,1
845660,True,0,No user reviews,0,0,0
845690,True,7,Positive,30,1,31
845700,True,0,3 user reviews,3,0,3
845710,True,0,No user reviews,0,0,0
845730,True,0,8 user reviews,7,1,8
845750,True,0,7 user reviews,7,0,7
845800,True,0,1 user reviews,1,0,1
845820,True,0,3 user reviews,2,1,3
845830,True,0,No user reviews,0,0,0
845840,True,7,Positive,13,0,13
845860,True,0,5 user reviews,4,1,5
845870,True,0,1 user reviews,0,1,1
845880,True,8,Very Positive,108,7,115
845900,True,6,Mostly Positive,25,8,33
845910,True,0,3 user reviews,3,0,3
845920,True,0,No user reviews,0,0,0
845930,True,0,No user reviews,0,0,0
845940,True,0,8 user reviews,7,1,8
845950,True,0,No user reviews,0,0,0
845960,True,0,9 user reviews,4,5,9
845970,True,0,7 user reviews,4,3,7
845980,True,0,2 user reviews,1,1,2
845990,True,0,No user reviews,0,0,0
846000,True,0,No user reviews,0,0,0
846010,True,5,Mixed,8,4,12
846020,True,0,5 user reviews,3,2,5
846030,True,8,Very Positive,68,9,77
846040,True,0,No user reviews,0,0,0
846050,True,5,Mixed,11,15,26
846080,True,7,Positive,16,2,18
846100,True,0,1 user reviews,1,0,1
846110,True,8,Very Positive,199,19,218
846120,True,0,1 user reviews,0,1,1
846130,True,0,4 user reviews,4,0,4
846140,True,0,No user reviews,0,0,0
846200,True,5,Mixed,15,14,29
846210,True,0,No user reviews,0,0,0
846220,True,0,1 user reviews,1,0,1
846230,True,0,No user reviews,0,0,0
846250,True,0,4 user reviews,2,2,4
846260,True,0,No user reviews,0,0,0
846280,True,0,No user reviews,0,0,0
846290,True,0,No user reviews,0,0,0
846310,True,0,3 user reviews,2,1,3
846320,True,0,No user reviews,0,0,0
846330,True,0,1 user reviews,1,0,1
846340,True,0,No user reviews,0,0,0
846350,True,0,No user reviews,0,0,0
846360,True,0,1 user reviews,1,0,1
846370,True,0,No user reviews,0,0,0
846400,True,0,1 user reviews,0,1,1
846410,True,0,No user reviews,0,0,0
846420,True,0,No user reviews,0,0,0
846421,True,0,1 user reviews,0,1,1
846450,True,0,No user reviews,0,0,0
846470,True,8,Very Positive,846,59,905
846480,True,0,No user reviews,0,0,0
846490,True,0,2 user reviews,2,0,2
846500,True,0,No user reviews,0,0,0
846520,True,0,No user reviews,0,0,0
846530,True,0,1 user reviews,0,1,1
846560,True,0,No user reviews,0,0,0
846570,True,0,No user reviews,0,0,0
846580,True,0,1 user reviews,1,0,1
846590,True,0,1 user reviews,1,0,1
846610,True,0,No user reviews,0,0,0
846620,True,0,No user reviews,0,0,0
846621,True,0,No user reviews,0,0,0
846630,True,0,No user reviews,0,0,0
846650,True,0,1 user reviews,1,0,1
846660,True,0,No user reviews,0,0,0
846670,True,0,3 user reviews,3,0,3
846680,True,0,No user reviews,0,0,0
846690,True,7,Positive,16,4,20
846700,True,7,Positive,12,1,13
846710,True,7,Positive,15,3,18
846720,True,0,3 user reviews,3,0,3
846730,True,5,Mixed,34,17,51
846740,True,0,No user reviews,0,0,0
846750,True,0,No user reviews,0,0,0
846760,True,0,No user reviews,0,0,0
846770,True,0,No user reviews,0,0,0
846780,True,0,No user reviews,0,0,0
846790,True,6,Mostly Positive,7,3,10
846800,True,8,Very Positive,191,25,216
846820,True,5,Mixed,11,6,17
846830,True,5,Mixed,8,6,14
846840,True,0,No user reviews,0,0,0
846850,True,0,5 user reviews,1,4,5
846860,True,0,No user reviews,0,0,0
846870,True,8,Very Positive,210,20,230
846880,True,8,Very Positive,155,9,164
846900,True,0,No user reviews,0,0,0
846910,True,0,No user reviews,0,0,0
846920,True,0,No user reviews,0,0,0
846930,True,0,No user reviews,0,0,0
846940,True,0,No user reviews,0,0,0
846950,True,0,No user reviews,0,0,0
846960,True,0,No user reviews,0,0,0
846970,True,0,No user reviews,0,0,0
846980,True,0,No user reviews,0,0,0
846990,True,0,No user reviews,0,0,0
847000,True,0,No user reviews,0,0,0
847010,True,0,1 user reviews,1,0,1
847020,True,0,No user reviews,0,0,0
847030,True,0,No user reviews,0,0,0
847040,True,0,No user reviews,0,0,0
847041,True,0,No user reviews,0,0,0
847042,True,0,No user reviews,0,0,0
847043,True,0,No user reviews,0,0,0
847044,True,0,No user reviews,0,0,0
847045,True,0,No user reviews,0,0,0
847046,True,0,No user reviews,0,0,0
847047,True,0,No user reviews,0,0,0
847048,True,0,No user reviews,0,0,0
847049,True,0,No user reviews,0,0,0
847050,True,0,No user reviews,0,0,0
847060,True,0,No user reviews,0,0,0
847061,True,0,No user reviews,0,0,0
847062,True,0,No user reviews,0,0,0
847063,True,0,No user reviews,0,0,0
847064,True,0,No user reviews,0,0,0
847065,True,0,No user reviews,0,0,0
847066,True,0,No user reviews,0,0,0
847067,True,0,No user reviews,0,0,0
847068,True,0,No user reviews,0,0,0
847069,True,0,No user reviews,0,0,0
847070,True,0,No user reviews,0,0,0
847071,True,0,No user reviews,0,0,0
847072,True,0,No user reviews,0,0,0
847073,True,0,No user reviews,0,0,0
847074,True,0,No user reviews,0,0,0
847075,True,0,No user reviews,0,0,0
847076,True,0,No user reviews,0,0,0
847077,True,0,No user reviews,0,0,0
847078,True,0,No user reviews,0,0,0
847079,True,0,No user reviews,0,0,0
847080,True,0,No user reviews,0,0,0
847081,True,0,No user reviews,0,0,0
847090,True,0,No user reviews,0,0,0
847100,True,0,No user reviews,0,0,0
847110,True,0,No user reviews,0,0,0
847120,True,0,No user reviews,0,0,0
847121,True,0,No user reviews,0,0,0
847122,True,0,No user reviews,0,0,0
847123,True,0,No user reviews,0,0,0
847124,True,0,No user reviews,0,0,0
847125,True,0,No user reviews,0,0,0
847126,True,0,No user reviews,0,0,0
847127,True,0,No user reviews,0,0,0
847128,True,0,No user reviews,0,0,0
847129,True,0,No user reviews,0,0,0
847130,True,0,No user reviews,0,0,0
847131,True,0,No user reviews,0,0,0
847132,True,0,No user reviews,0,0,0
847133,True,0,No user reviews,0,0,0
847134,True,0,No user reviews,0,0,0
847135,True,0,No user reviews,0,0,0
847136,True,0,No user reviews,0,0,0
847137,True,0,No user reviews,0,0,0
847138,True,0,No user reviews,0,0,0
847139,True,0,No user reviews,0,0,0
847140,True,0,No user reviews,0,0,0
847141,True,0,No user reviews,0,0,0
847180,True,0,No user reviews,0,0,0
847181,True,0,No user reviews,0,0,0
847182,True,0,No user reviews,0,0,0
847183,True,0,No user reviews,0,0,0
847184,True,0,No user reviews,0,0,0
847185,True,0,No user reviews,0,0,0
847186,True,0,No user reviews,0,0,0
847187,True,0,No user reviews,0,0,0
847188,True,0,No user reviews,0,0,0
847189,True,0,No user reviews,0,0,0
847190,True,0,No user reviews,0,0,0
847191,True,0,No user reviews,0,0,0
847192,True,0,No user reviews,0,0,0
847193,True,0,No user reviews,0,0,0
847194,True,0,No user reviews,0,0,0
847195,True,0,No user reviews,0,0,0
847196,True,0,No user reviews,0,0,0
847197,True,0,No user reviews,0,0,0
847198,True,0,No user reviews,0,0,0
847199,True,0,No user reviews,0,0,0
847200,True,0,No user reviews,0,0,0
847201,True,0,No user reviews,0,0,0
847210,True,7,Positive,10,0,10
847230,True,0,4 user reviews,3,1,4
847240,True,0,9 user reviews,7,2,9
847260,True,4,Mostly Negative,4,7,11
847270,True,0,No user reviews,0,0,0
847271,True,0,No user reviews,0,0,0
847272,True,0,No user reviews,0,0,0
847273,True,0,No user reviews,0,0,0
847274,True,0,No user reviews,0,0,0
847275,True,0,No user reviews,0,0,0
847276,True,0,No user reviews,0,0,0
847277,True,0,No user reviews,0,0,0
847278,True,0,No user reviews,0,0,0
847279,True,0,No user reviews,0,0,0
847280,True,0,No user reviews,0,0,0
847281,True,0,No user reviews,0,0,0
847282,True,0,No user reviews,0,0,0
847290,True,7,Positive,20,2,22
847300,True,0,5 user reviews,2,3,5
847310,True,0,6 user reviews,2,4,6
847320,True,0,No user reviews,0,0,0
847321,True,0,No user reviews,0,0,0
847322,True,0,No user reviews,0,0,0
847323,True,0,No user reviews,0,0,0
847324,True,0,No user reviews,0,0,0
847325,True,0,No user reviews,0,0,0
847326,True,0,No user reviews,0,0,0
847327,True,0,No user reviews,0,0,0
847328,True,0,No user reviews,0,0,0
847329,True,0,No user reviews,0,0,0
847330,True,0,No user reviews,0,0,0
847331,True,0,No user reviews,0,0,0
847332,True,0,No user reviews,0,0,0
847333,True,0,No user reviews,0,0,0
847334,True,0,No user reviews,0,0,0
847335,True,0,No user reviews,0,0,0
847340,True,0,No user reviews,0,0,0
847341,True,0,No user reviews,0,0,0
847342,True,0,No user reviews,0,0,0
847343,True,0,No user reviews,0,0,0
847344,True,0,No user reviews,0,0,0
847345,True,0,No user reviews,0,0,0
847346,True,0,No user reviews,0,0,0
847347,True,0,No user reviews,0,0,0
847348,True,0,No user reviews,0,0,0
847349,True,0,No user reviews,0,0,0
847350,True,0,No user reviews,0,0,0
847351,True,0,No user reviews,0,0,0
847352,True,0,No user reviews,0,0,0
847353,True,0,No user reviews,0,0,0
847354,True,0,No user reviews,0,0,0
847355,True,0,No user reviews,0,0,0
847360,True,8,Very Positive,143,20,163
847370,True,8,Very Positive,2320,225,2545
847390,True,0,5 user reviews,4,1,5
847400,True,0,No user reviews,0,0,0
847410,True,0,No user reviews,0,0,0
847411,True,0,No user reviews,0,0,0
847412,True,0,No user reviews,0,0,0
847413,True,0,No user reviews,0,0,0
847414,True,0,No user reviews,0,0,0
847415,True,0,No user reviews,0,0,0
847416,True,0,No user reviews,0,0,0
847417,True,0,No user reviews,0,0,0
847418,True,0,No user reviews,0,0,0
847420,True,0,1 user reviews,0,1,1
847421,True,0,1 user reviews,0,1,1
847422,True,0,1 user reviews,1,0,1
847423,True,0,6 user reviews,5,1,6
847440,True,0,No user reviews,0,0,0
847450,True,0,3 user reviews,2,1,3
847460,True,0,No user reviews,0,0,0
847470,True,0,No user reviews,0,0,0
847480,True,0,1 user reviews,1,0,1
847490,True,0,No user reviews,0,0,0
847510,True,0,No user reviews,0,0,0
847530,True,7,Positive,18,0,18
847540,True,0,2 user reviews,2,0,2
847550,True,0,No user reviews,0,0,0
847560,True,0,6 user reviews,6,0,6
847570,True,0,3 user reviews,1,2,3
847580,True,0,6 user reviews,1,5,6
847590,True,0,7 user reviews,6,1,7
847600,True,0,No user reviews,0,0,0
847640,True,0,No user reviews,0,0,0
847650,True,0,No user reviews,0,0,0
847660,True,0,7 user reviews,2,5,7
847670,True,0,No user reviews,0,0,0
847700,True,0,No user reviews,0,0,0
847750,True,0,3 user reviews,3,0,3
847760,True,0,No user reviews,0,0,0
847770,True,0,No user reviews,0,0,0
847780,True,0,No user reviews,0,0,0
847790,True,0,No user reviews,0,0,0
847800,True,0,No user reviews,0,0,0
847810,True,0,1 user reviews,1,0,1
847820,True,0,1 user reviews,1,0,1
847850,True,0,No user reviews,0,0,0
847860,True,0,2 user reviews,1,1,2
847890,True,0,No user reviews,0,0,0
847900,True,0,2 user reviews,2,0,2
847940,True,0,2 user reviews,2,0,2
847950,True,7,Positive,23,5,28
847990,True,0,No user reviews,0,0,0
848000,True,0,No user reviews,0,0,0
848010,True,6,Mostly Positive,60,22,82
848020,True,7,Positive,43,2,45
848030,True,8,Very Positive,88,20,108
848040,True,0,No user reviews,0,0,0
848041,True,0,No user reviews,0,0,0
848042,True,0,No user reviews,0,0,0
848043,True,0,No user reviews,0,0,0
848060,True,7,Positive,23,2,25
848070,True,0,No user reviews,0,0,0
848080,True,0,No user reviews,0,0,0
848090,True,0,No user reviews,0,0,0
848100,True,0,1 user reviews,1,0,1
848110,True,0,4 user reviews,2,2,4
848120,True,0,No user reviews,0,0,0
848130,True,0,No user reviews,0,0,0
848140,True,0,No user reviews,0,0,0
848150,True,0,2 user reviews,0,2,2
848160,True,0,No user reviews,0,0,0
848180,True,0,No user reviews,0,0,0
848190,True,0,No user reviews,0,0,0
848200,True,7,Positive,10,2,12
848210,True,0,No user reviews,0,0,0
848230,True,0,3 user reviews,2,1,3
848260,True,0,7 user reviews,3,4,7
848270,True,0,3 user reviews,2,1,3
848280,True,7,Positive,23,0,23
848300,True,5,Mixed,10,8,18
848310,True,5,Mixed,26,28,54
848320,True,0,8 user reviews,8,0,8
848330,True,0,5 user reviews,5,0,5
848340,True,0,No user reviews,0,0,0
848350,True,8,Very Positive,1342,116,1458
848370,True,0,No user reviews,0,0,0
848400,True,0,No user reviews,0,0,0
848410,True,6,Mostly Positive,11,3,14
848420,True,0,No user reviews,0,0,0
848430,True,0,2 user reviews,1,1,2
848440,True,0,No user reviews,0,0,0
848450,True,8,Very Positive,11774,835,12609
848460,True,0,No user reviews,0,0,0
848470,True,0,1 user reviews,1,0,1
848480,True,0,No user reviews,0,0,0
848490,True,0,No user reviews,0,0,0
848500,True,0,No user reviews,0,0,0
848520,True,7,Positive,13,1,14
848530,True,7,Positive,9,2,11
848550,True,0,4 user reviews,3,1,4
848590,True,0,No user reviews,0,0,0
848610,True,0,2 user reviews,0,2,2
848630,True,0,3 user reviews,2,1,3
848660,True,0,3 user reviews,3,0,3
848700,True,0,No user reviews,0,0,0
848710,True,0,5 user reviews,3,2,5
848720,True,0,No user reviews,0,0,0
848730,True,0,4 user reviews,0,4,4
848740,True,0,1 user reviews,1,0,1
848750,True,0,No user reviews,0,0,0
848760,True,0,1 user reviews,1,0,1
848770,True,0,8 user reviews,8,0,8
848780,True,0,No user reviews,0,0,0
848790,True,0,7 user reviews,4,3,7
848810,True,0,1 user reviews,1,0,1
848840,True,0,No user reviews,0,0,0
848850,True,0,No user reviews,0,0,0
848890,True,0,5 user reviews,1,4,5
848920,True,0,1 user reviews,1,0,1
848930,True,7,Positive,23,1,24
848960,True,0,2 user reviews,1,1,2
848970,True,0,2 user reviews,2,0,2
848980,True,0,No user reviews,0,0,0
848990,True,0,4 user reviews,4,0,4
848991,True,0,1 user reviews,1,0,1
849000,True,0,5 user reviews,5,0,5
849010,True,0,No user reviews,0,0,0
849030,True,0,No user reviews,0,0,0
849040,True,0,No user reviews,0,0,0
849050,True,0,No user reviews,0,0,0
849070,True,0,5 user reviews,1,4,5
849090,True,0,No user reviews,0,0,0
849100,True,0,No user reviews,0,0,0
849130,True,0,No user reviews,0,0,0
849140,True,0,1 user reviews,1,0,1
849160,True,0,No user reviews,0,0,0
849161,True,0,No user reviews,0,0,0
849162,True,0,No user reviews,0,0,0
849163,True,0,No user reviews,0,0,0
849164,True,0,No user reviews,0,0,0
849165,True,0,No user reviews,0,0,0
849166,True,0,No user reviews,0,0,0
849167,True,0,No user reviews,0,0,0
849168,True,0,No user reviews,0,0,0
849170,True,0,No user reviews,0,0,0
849176,True,0,No user reviews,0,0,0
849177,True,0,No user reviews,0,0,0
849178,True,0,No user reviews,0,0,0
849179,True,0,No user reviews,0,0,0
849180,True,0,No user reviews,0,0,0
849186,True,0,No user reviews,0,0,0
849187,True,0,No user reviews,0,0,0
849200,True,0,No user reviews,0,0,0
849210,True,7,Positive,12,1,13
849230,True,0,3 user reviews,2,1,3
849240,True,0,No user reviews,0,0,0
849260,True,5,Mixed,14,11,25
849261,True,5,Mixed,15,11,26
849262,True,5,Mixed,34,28,62
849270,True,0,5 user reviews,5,0,5
849280,True,0,No user reviews,0,0,0
849290,True,0,No user reviews,0,0,0
849300,True,5,Mixed,11,8,19
849301,True,5,Mixed,5,6,11
849302,True,5,Mixed,7,6,13
849303,True,5,Mixed,10,6,16
849304,True,4,Mostly Negative,5,8,13
849305,True,4,Mostly Negative,5,9,14
849306,True,4,Mostly Negative,19,29,48
849307,True,5,Mixed,24,13,37
849308,True,5,Mixed,19,9,28
849309,True,6,Mostly Positive,19,5,24
849310,True,5,Mixed,9,8,17
849311,True,6,Mostly Positive,15,5,20
849320,True,0,No user reviews,0,0,0
849330,True,0,No user reviews,0,0,0
849350,True,0,No user reviews,0,0,0
849360,True,0,No user reviews,0,0,0
849370,True,0,No user reviews,0,0,0
849390,True,0,2 user reviews,1,1,2
849410,True,0,No user reviews,0,0,0
849420,True,0,2 user reviews,0,2,2
849520,True,0,7 user reviews,6,1,7
849530,True,0,No user reviews,0,0,0
849540,True,0,3 user reviews,3,0,3
849560,True,6,Mostly Positive,8,3,11
849570,True,0,No user reviews,0,0,0
849600,True,0,6 user reviews,3,3,6
849620,True,0,6 user reviews,4,2,6
849630,True,0,5 user reviews,5,0,5
849670,True,7,Positive,14,3,17
849680,True,7,Positive,15,0,15
849690,True,0,4 user reviews,2,2,4
849700,True,0,No user reviews,0,0,0
849740,True,8,Very Positive,309,20,329
849750,True,0,No user reviews,0,0,0
849760,True,0,No user reviews,0,0,0
849790,True,6,Mostly Positive,13,4,17
849800,True,0,4 user reviews,4,0,4
849840,True,0,2 user reviews,1,1,2
849860,True,0,5 user reviews,0,5,5
849870,True,0,1 user reviews,0,1,1
849880,True,0,No user reviews,0,0,0
849890,True,0,No user reviews,0,0,0
849920,True,0,4 user reviews,4,0,4
849930,True,0,5 user reviews,5,0,5
849931,True,0,4 user reviews,4,0,4
849940,True,5,Mixed,13,9,22
849950,True,0,No user reviews,0,0,0
849970,True,0,1 user reviews,0,1,1
849980,True,0,1 user reviews,1,0,1
850000,True,8,Very Positive,67,10,77
850010,True,5,Mixed,186,135,321
850020,True,0,No user reviews,0,0,0
850030,True,0,No user reviews,0,0,0
850040,True,7,Positive,12,0,12
850050,True,6,Mostly Positive,34,13,47
850060,True,5,Mixed,16,7,23
850110,True,0,No user reviews,0,0,0
850130,True,0,No user reviews,0,0,0
850150,True,0,No user reviews,0,0,0
850160,True,0,No user reviews,0,0,0
850200,True,0,No user reviews,0,0,0
850210,True,6,Mostly Positive,76,26,102
850220,True,0,No user reviews,0,0,0
850230,True,0,No user reviews,0,0,0
850240,True,0,No user reviews,0,0,0
850250,True,0,5 user reviews,1,4,5
850260,True,7,Positive,9,2,11
850270,True,0,No user reviews,0,0,0
850280,True,0,1 user reviews,1,0,1
850281,True,0,1 user reviews,1,0,1
850290,True,0,No user reviews,0,0,0
850310,True,0,No user reviews,0,0,0
850320,True,0,No user reviews,0,0,0
850330,True,0,No user reviews,0,0,0
850340,True,0,1 user reviews,1,0,1
850350,True,0,No user reviews,0,0,0
850360,True,0,No user reviews,0,0,0
850370,True,0,No user reviews,0,0,0
850380,True,0,No user reviews,0,0,0
850390,True,0,No user reviews,0,0,0
850400,True,0,No user reviews,0,0,0
850410,True,0,No user reviews,0,0,0
850420,True,0,No user reviews,0,0,0
850430,True,0,No user reviews,0,0,0
850440,True,0,No user reviews,0,0,0
850450,True,5,Mixed,67,49,116
850470,True,0,No user reviews,0,0,0
850480,True,0,No user reviews,0,0,0
850481,True,0,No user reviews,0,0,0
850482,True,0,No user reviews,0,0,0
850483,True,0,No user reviews,0,0,0
850484,True,0,No user reviews,0,0,0
850485,True,0,No user reviews,0,0,0
850486,True,0,No user reviews,0,0,0
850487,True,0,No user reviews,0,0,0
850488,True,0,No user reviews,0,0,0
850489,True,0,No user reviews,0,0,0
850490,True,0,No user reviews,0,0,0
850491,True,0,No user reviews,0,0,0
850492,True,0,No user reviews,0,0,0
850493,True,0,No user reviews,0,0,0
850494,True,0,No user reviews,0,0,0
850495,True,0,No user reviews,0,0,0
850496,True,0,No user reviews,0,0,0
850497,True,0,No user reviews,0,0,0
850498,True,0,No user reviews,0,0,0
850500,True,0,No user reviews,0,0,0
850530,True,0,No user reviews,0,0,0
850540,True,0,No user reviews,0,0,0
850550,True,0,No user reviews,0,0,0
850560,True,0,No user reviews,0,0,0
850570,True,0,No user reviews,0,0,0
850580,True,0,No user reviews,0,0,0
850600,True,0,No user reviews,0,0,0
850610,True,0,No user reviews,0,0,0
850620,True,0,No user reviews,0,0,0
850630,True,6,Mostly Positive,50,15,65
850640,True,0,No user reviews,0,0,0
850650,True,0,No user reviews,0,0,0
850660,True,0,No user reviews,0,0,0
850670,True,0,No user reviews,0,0,0
850680,True,0,No user reviews,0,0,0
850690,True,5,Mixed,35,23,58
850700,True,0,No user reviews,0,0,0
850710,True,0,No user reviews,0,0,0
850740,True,0,2 user reviews,1,1,2
850750,True,0,No user reviews,0,0,0
850760,True,0,No user reviews,0,0,0
850780,True,5,Mixed,9,4,13
850800,True,0,No user reviews,0,0,0
850810,True,0,2 user reviews,2,0,2
850820,True,0,No user reviews,0,0,0
850830,True,0,4 user reviews,0,4,4
850840,True,0,4 user reviews,3,1,4
850850,True,0,8 user reviews,8,0,8
850880,True,0,2 user reviews,2,0,2
850920,True,0,5 user reviews,5,0,5
850930,True,0,1 user reviews,1,0,1
850940,True,0,8 user reviews,3,5,8
850950,True,0,3 user reviews,1,2,3
850960,True,0,4 user reviews,1,3,4
850970,True,0,No user reviews,0,0,0
850980,True,7,Positive,38,5,43
850990,True,0,No user reviews,0,0,0
851000,True,7,Positive,35,4,39
851010,True,0,3 user reviews,0,3,3
851040,True,0,2 user reviews,1,1,2
851050,True,4,Mostly Negative,4,7,11
851100,True,9,Overwhelmingly Positive,2302,51,2353
851110,True,0,No user reviews,0,0,0
851150,True,7,Positive,28,5,33
851180,True,7,Positive,25,5,30
851200,True,6,Mostly Positive,7,3,10
851210,True,0,No user reviews,0,0,0
851220,True,0,No user reviews,0,0,0
851240,True,0,No user reviews,0,0,0
851250,True,0,5 user reviews,2,3,5
851270,True,0,1 user reviews,1,0,1
851271,True,0,1 user reviews,1,0,1
851272,True,0,1 user reviews,1,0,1
851273,True,0,1 user reviews,1,0,1
851274,True,0,No user reviews,0,0,0
851275,True,0,No user reviews,0,0,0
851278,True,0,No user reviews,0,0,0
851279,True,0,1 user reviews,1,0,1
851280,True,5,Mixed,39,17,56
851290,True,0,No user reviews,0,0,0
851310,True,0,No user reviews,0,0,0
851312,True,0,No user reviews,0,0,0
851313,True,0,No user reviews,0,0,0
851318,True,0,No user reviews,0,0,0
851320,True,0,No user reviews,0,0,0
851350,True,0,9 user reviews,4,5,9
851360,True,0,No user reviews,0,0,0
851370,True,0,8 user reviews,4,4,8
851396,True,0,No user reviews,0,0,0
851397,True,0,No user reviews,0,0,0
851398,True,0,No user reviews,0,0,0
851470,True,0,No user reviews,0,0,0
851490,True,0,No user reviews,0,0,0
851500,True,0,No user reviews,0,0,0
851510,True,0,No user reviews,0,0,0
851520,True,0,5 user reviews,2,3,5
851530,True,0,No user reviews,0,0,0
851570,True,0,3 user reviews,0,3,3
851580,True,0,3 user reviews,2,1,3
851590,True,0,No user reviews,0,0,0
851600,True,0,No user reviews,0,0,0
851601,True,0,1 user reviews,0,1,1
851610,True,0,No user reviews,0,0,0
851620,True,0,No user reviews,0,0,0
851640,True,7,Positive,30,4,34
851650,True,0,No user reviews,0,0,0
851670,True,8,Very Positive,144,6,150
851690,True,0,No user reviews,0,0,0
851710,True,0,4 user reviews,2,2,4
851730,True,7,Positive,39,3,42
851750,True,0,No user reviews,0,0,0
851770,True,0,1 user reviews,1,0,1
851780,True,0,No user reviews,0,0,0
851790,True,6,Mostly Positive,12,4,16
851800,True,7,Positive,40,6,46
851810,True,0,No user reviews,0,0,0
851820,True,5,Mixed,15,7,22
851840,True,0,7 user reviews,7,0,7
851850,True,8,Very Positive,4955,485,5440
851860,True,0,5 user reviews,5,0,5
851870,True,0,5 user reviews,5,0,5
851880,True,0,9 user reviews,6,3,9
851890,True,8,Very Positive,199,23,222
851900,True,0,No user reviews,0,0,0
851910,True,0,No user reviews,0,0,0
851920,True,0,4 user reviews,1,3,4
851930,True,6,Mostly Positive,151,58,209
851940,True,0,8 user reviews,3,5,8
851950,True,7,Positive,21,3,24
851960,True,0,No user reviews,0,0,0
851970,True,0,No user reviews,0,0,0
851980,True,5,Mixed,5,5,10
852000,True,0,3 user reviews,2,1,3
852020,True,0,No user reviews,0,0,0
852030,True,0,No user reviews,0,0,0
852090,True,7,Positive,31,0,31
852100,True,0,No user reviews,0,0,0
852110,True,8,Very Positive,214,8,222
852130,True,0,No user reviews,0,0,0
852160,True,5,Mixed,6,6,12
852180,True,5,Mixed,4,6,10
852190,True,0,4 user reviews,4,0,4
852200,True,0,No user reviews,0,0,0
852220,True,8,Very Positive,59,12,71
852240,True,0,No user reviews,0,0,0
852250,True,0,No user reviews,0,0,0
852270,True,0,No user reviews,0,0,0
852290,True,0,No user reviews,0,0,0
852300,True,6,Mostly Positive,87,27,114
852310,True,0,No user reviews,0,0,0
852320,True,0,1 user reviews,1,0,1
852340,True,0,No user reviews,0,0,0
852370,True,0,No user reviews,0,0,0
852390,True,0,9 user reviews,9,0,9
852420,True,0,No user reviews,0,0,0
852440,True,0,No user reviews,0,0,0
852450,True,0,No user reviews,0,0,0
852470,True,0,No user reviews,0,0,0
852480,True,8,Very Positive,471,28,499
852500,True,0,No user reviews,0,0,0
852530,True,0,1 user reviews,1,0,1
852560,True,0,No user reviews,0,0,0
852570,True,0,2 user reviews,1,1,2
852580,True,0,1 user reviews,1,0,1
852590,True,0,2 user reviews,1,1,2
852610,True,0,No user reviews,0,0,0
852620,True,0,No user reviews,0,0,0
852630,True,0,4 user reviews,3,1,4
852640,True,0,No user reviews,0,0,0
852650,True,0,1 user reviews,0,1,1
852660,True,0,6 user reviews,4,2,6
852710,True,0,No user reviews,0,0,0
852720,True,5,Mixed,7,4,11
852750,True,0,No user reviews,0,0,0
852760,True,0,1 user reviews,1,0,1
852790,True,7,Positive,17,4,21
852800,True,0,No user reviews,0,0,0
852830,True,0,No user reviews,0,0,0
852840,True,0,No user reviews,0,0,0
852850,True,0,No user reviews,0,0,0
852860,True,0,No user reviews,0,0,0
852870,True,0,No user reviews,0,0,0
852880,True,0,No user reviews,0,0,0
852890,True,0,No user reviews,0,0,0
852900,True,7,Positive,18,1,19
852910,True,8,Very Positive,53,9,62
852920,True,0,1 user reviews,1,0,1
852930,True,0,No user reviews,0,0,0
852940,True,0,No user reviews,0,0,0
852970,True,0,No user reviews,0,0,0
852980,True,0,No user reviews,0,0,0
852991,True,0,2 user reviews,1,1,2
852992,True,0,3 user reviews,2,1,3
852993,True,0,1 user reviews,1,0,1
852994,True,0,1 user reviews,1,0,1
852995,True,0,5 user reviews,4,1,5
852996,True,0,No user reviews,0,0,0
853000,True,0,No user reviews,0,0,0
853011,True,0,No user reviews,0,0,0
853012,True,0,No user reviews,0,0,0
853013,True,0,No user reviews,0,0,0
853014,True,0,1 user reviews,0,1,1
853015,True,0,No user reviews,0,0,0
853020,True,0,4 user reviews,1,3,4
853040,True,0,5 user reviews,3,2,5
853050,True,0,No user reviews,0,0,0
853110,True,7,Positive,14,1,15
853120,True,0,4 user reviews,2,2,4
853140,True,6,Mostly Positive,159,42,201
853150,True,0,No user reviews,0,0,0
853170,True,0,1 user reviews,1,0,1
853180,True,0,1 user reviews,0,1,1
853190,True,0,No user reviews,0,0,0
853200,True,7,Positive,39,5,44
853210,True,0,9 user reviews,4,5,9
853220,True,0,1 user reviews,0,1,1
853230,True,0,No user reviews,0,0,0
853240,True,5,Mixed,56,33,89
853250,True,0,No user reviews,0,0,0
853260,True,0,3 user reviews,3,0,3
853270,True,0,No user reviews,0,0,0
853280,True,0,3 user reviews,2,1,3
853281,True,0,No user reviews,0,0,0
853282,True,0,No user reviews,0,0,0
853290,True,0,1 user reviews,1,0,1
853300,True,0,8 user reviews,7,1,8
853310,True,7,Positive,12,1,13
853320,True,0,No user reviews,0,0,0
853330,True,0,1 user reviews,1,0,1
853360,True,8,Very Positive,126,26,152
853370,True,0,No user reviews,0,0,0
853380,True,5,Mixed,9,4,13
853390,True,0,No user reviews,0,0,0
853410,True,0,3 user reviews,3,0,3
853440,True,0,No user reviews,0,0,0
853450,True,0,No user reviews,0,0,0
853460,True,0,No user reviews,0,0,0
853480,True,7,Positive,15,2,17
853500,True,8,Very Positive,266,35,301
853530,True,0,No user reviews,0,0,0
853531,True,0,No user reviews,0,0,0
853532,True,0,No user reviews,0,0,0
853533,True,0,No user reviews,0,0,0
853534,True,0,No user reviews,0,0,0
853535,True,0,No user reviews,0,0,0
853536,True,0,No user reviews,0,0,0
853537,True,0,No user reviews,0,0,0
853538,True,0,No user reviews,0,0,0
853539,True,0,No user reviews,0,0,0
853540,True,0,No user reviews,0,0,0
853541,True,0,No user reviews,0,0,0
853542,True,0,No user reviews,0,0,0
853543,True,0,No user reviews,0,0,0
853550,True,8,Very Positive,1432,98,1530
853580,True,0,3 user reviews,0,3,3
853590,True,0,5 user reviews,5,0,5
853600,True,0,No user reviews,0,0,0
853610,True,0,2 user reviews,2,0,2
853620,True,0,6 user reviews,3,3,6
853630,True,0,No user reviews,0,0,0
853631,True,0,No user reviews,0,0,0
853632,True,0,No user reviews,0,0,0
853633,True,0,No user reviews,0,0,0
853634,True,0,No user reviews,0,0,0
853635,True,0,No user reviews,0,0,0
853636,True,0,No user reviews,0,0,0
853637,True,0,No user reviews,0,0,0
853638,True,0,No user reviews,0,0,0
853639,True,0,No user reviews,0,0,0
853640,True,0,No user reviews,0,0,0
853641,True,0,No user reviews,0,0,0
853650,True,0,No user reviews,0,0,0
853700,True,0,1 user reviews,1,0,1
853730,True,0,No user reviews,0,0,0
853760,True,0,2 user reviews,0,2,2
853770,True,8,Very Positive,1542,169,1711
853780,True,0,No user reviews,0,0,0
853830,True,0,1 user reviews,1,0,1
853850,True,0,3 user reviews,2,1,3
853860,True,7,Positive,27,5,32
853870,True,0,No user reviews,0,0,0
853871,True,0,No user reviews,0,0,0
853872,True,0,No user reviews,0,0,0
853873,True,0,No user reviews,0,0,0
853874,True,0,No user reviews,0,0,0
853875,True,0,No user reviews,0,0,0
853876,True,0,No user reviews,0,0,0
853877,True,0,No user reviews,0,0,0
853881,True,0,No user reviews,0,0,0
853882,True,0,No user reviews,0,0,0
853883,True,0,No user reviews,0,0,0
853884,True,0,No user reviews,0,0,0
853885,True,0,No user reviews,0,0,0
853886,True,0,No user reviews,0,0,0
853887,True,0,No user reviews,0,0,0
853890,True,0,No user reviews,0,0,0
853940,True,0,6 user reviews,2,4,6
853980,True,0,No user reviews,0,0,0
854030,True,0,7 user reviews,2,5,7
854050,True,0,1 user reviews,0,1,1
854060,True,0,1 user reviews,1,0,1
854070,True,6,Mostly Positive,48,18,66
854110,True,0,No user reviews,0,0,0
854120,True,0,4 user reviews,4,0,4
854130,True,0,No user reviews,0,0,0
854150,True,0,1 user reviews,1,0,1
854160,True,0,6 user reviews,0,6,6
854180,True,0,No user reviews,0,0,0
854190,True,5,Mixed,10,5,15
854210,True,0,No user reviews,0,0,0
854220,True,0,6 user reviews,6,0,6
854230,True,0,1 user reviews,1,0,1
854240,True,0,2 user reviews,2,0,2
854250,True,7,Positive,29,5,34
854270,True,0,No user reviews,0,0,0
854290,True,7,Positive,10,0,10
854310,True,0,No user reviews,0,0,0
854320,True,0,No user reviews,0,0,0
854321,True,0,No user reviews,0,0,0
854330,True,0,No user reviews,0,0,0
854340,True,0,No user reviews,0,0,0
854370,True,0,No user reviews,0,0,0
854390,True,0,2 user reviews,2,0,2
854400,True,5,Mixed,6,4,10
854410,True,0,No user reviews,0,0,0
854420,True,0,No user reviews,0,0,0
854430,True,0,No user reviews,0,0,0
854450,True,7,Positive,11,0,11
854490,True,0,No user reviews,0,0,0
854500,True,0,2 user reviews,2,0,2
854510,True,0,1 user reviews,0,1,1
854520,True,0,No user reviews,0,0,0
854530,True,0,No user reviews,0,0,0
854540,True,0,No user reviews,0,0,0
854550,True,5,Mixed,5,7,12
854570,True,8,Very Positive,220,28,248
854600,True,0,No user reviews,0,0,0
854640,True,0,No user reviews,0,0,0
854650,True,0,1 user reviews,0,1,1
854660,True,0,No user reviews,0,0,0
854670,True,0,1 user reviews,1,0,1
854680,True,0,2 user reviews,1,1,2
854690,True,5,Mixed,5,6,11
854710,True,0,2 user reviews,0,2,2
854740,True,0,4 user reviews,2,2,4
854750,True,6,Mostly Positive,39,10,49
854770,True,5,Mixed,28,28,56
854780,True,0,1 user reviews,0,1,1
854800,True,0,No user reviews,0,0,0
854810,True,0,7 user reviews,1,6,7
854820,True,0,No user reviews,0,0,0
854830,True,0,7 user reviews,7,0,7
854860,True,8,Very Positive,258,17,275
854870,True,7,Positive,9,1,10
854880,True,0,No user reviews,0,0,0
854890,True,5,Mixed,18,14,32
854900,True,0,No user reviews,0,0,0
854910,True,0,No user reviews,0,0,0
854940,True,8,Very Positive,117,6,123
854950,True,0,2 user reviews,2,0,2
854960,True,7,Positive,28,5,33
854961,True,0,2 user reviews,2,0,2
854980,True,0,No user reviews,0,0,0
854990,True,0,No user reviews,0,0,0
855010,True,0,No user reviews,0,0,0
855020,True,0,No user reviews,0,0,0
855030,True,0,4 user reviews,2,2,4
855040,True,0,No user reviews,0,0,0
855050,True,0,5 user reviews,3,2,5
855060,True,0,No user reviews,0,0,0
855100,True,0,5 user reviews,3,2,5
855120,True,0,No user reviews,0,0,0
855130,True,0,No user reviews,0,0,0
855150,True,0,No user reviews,0,0,0
855151,True,0,No user reviews,0,0,0
855152,True,0,No user reviews,0,0,0
855160,True,0,2 user reviews,0,2,2
855170,True,4,Mostly Negative,7,11,18
855180,True,0,No user reviews,0,0,0
855190,True,6,Mostly Positive,17,7,24
855220,True,0,2 user reviews,2,0,2
855230,True,0,1 user reviews,1,0,1
855240,True,0,No user reviews,0,0,0
855250,True,0,2 user reviews,2,0,2
855260,True,0,1 user reviews,1,0,1
855270,True,0,1 user reviews,1,0,1
855280,True,0,1 user reviews,1,0,1
855290,True,0,1 user reviews,1,0,1
855300,True,0,1 user reviews,1,0,1
855310,True,0,1 user reviews,1,0,1
855320,True,5,Mixed,6,8,14
855330,True,0,1 user reviews,1,0,1
855340,True,0,1 user reviews,1,0,1
855350,True,0,1 user reviews,1,0,1
855360,True,0,2 user reviews,2,0,2
855380,True,0,No user reviews,0,0,0
855390,True,0,No user reviews,0,0,0
855400,True,0,1 user reviews,1,0,1
855410,True,0,1 user reviews,1,0,1
855420,True,0,1 user reviews,1,0,1
855430,True,0,1 user reviews,1,0,1
855440,True,0,1 user reviews,1,0,1
855450,True,0,1 user reviews,1,0,1
855460,True,0,1 user reviews,1,0,1
855470,True,0,1 user reviews,1,0,1
855480,True,0,No user reviews,0,0,0
855490,True,0,4 user reviews,2,2,4
855510,True,0,1 user reviews,1,0,1
855530,True,0,6 user reviews,5,1,6
855550,True,0,No user reviews,0,0,0
855580,True,0,No user reviews,0,0,0
855610,True,0,No user reviews,0,0,0
855620,True,0,1 user reviews,1,0,1
855630,True,7,Positive,33,6,39
855640,True,8,Very Positive,208,8,216
855650,True,0,2 user reviews,2,0,2
855660,True,0,No user reviews,0,0,0
855670,True,0,No user reviews,0,0,0
855680,True,0,No user reviews,0,0,0
855700,True,0,3 user reviews,3,0,3
855710,True,0,No user reviews,0,0,0
855730,True,0,1 user reviews,1,0,1
855740,True,0,No user reviews,0,0,0
855760,True,0,1 user reviews,1,0,1
855770,True,0,1 user reviews,1,0,1
855780,True,0,No user reviews,0,0,0
855781,True,0,No user reviews,0,0,0
855782,True,0,No user reviews,0,0,0
855783,True,0,No user reviews,0,0,0
855784,True,0,No user reviews,0,0,0
855785,True,0,No user reviews,0,0,0
855786,True,0,No user reviews,0,0,0
855787,True,0,No user reviews,0,0,0
855788,True,0,No user reviews,0,0,0
855789,True,0,No user reviews,0,0,0
855790,True,0,No user reviews,0,0,0
855791,True,0,No user reviews,0,0,0
855792,True,0,No user reviews,0,0,0
855793,True,0,No user reviews,0,0,0
855800,True,0,1 user reviews,1,0,1
855810,True,0,No user reviews,0,0,0
855830,True,0,No user reviews,0,0,0
855850,True,8,Very Positive,46,8,54
855860,True,8,Very Positive,381,48,429
855880,True,0,No user reviews,0,0,0
855890,True,0,No user reviews,0,0,0
855900,True,0,No user reviews,0,0,0
855910,True,0,No user reviews,0,0,0
855920,True,0,No user reviews,0,0,0
855930,True,0,No user reviews,0,0,0
855940,True,0,9 user reviews,3,6,9
855970,True,5,Mixed,7,6,13
855980,True,0,No user reviews,0,0,0
855990,True,0,No user reviews,0,0,0
856000,True,0,No user reviews,0,0,0
856001,True,0,No user reviews,0,0,0
856010,True,5,Mixed,11,8,19
856020,True,0,No user reviews,0,0,0
856030,True,0,No user reviews,0,0,0
856040,True,0,1 user reviews,1,0,1
856050,True,0,No user reviews,0,0,0
856060,True,0,No user reviews,0,0,0
856070,True,0,No user reviews,0,0,0
856080,True,0,7 user reviews,4,3,7
856090,True,0,No user reviews,0,0,0
856100,True,0,2 user reviews,2,0,2
856110,True,0,8 user reviews,7,1,8
856120,True,7,Positive,28,3,31
856130,True,5,Mixed,24,21,45
856140,True,0,No user reviews,0,0,0
856141,True,0,No user reviews,0,0,0
856142,True,0,1 user reviews,1,0,1
856143,True,0,No user reviews,0,0,0
856144,True,0,No user reviews,0,0,0
856145,True,0,No user reviews,0,0,0
856146,True,0,No user reviews,0,0,0
856147,True,0,No user reviews,0,0,0
856148,True,0,No user reviews,0,0,0
856149,True,0,No user reviews,0,0,0
856150,True,0,No user reviews,0,0,0
856160,True,0,1 user reviews,1,0,1
856170,True,0,4 user reviews,3,1,4
856180,True,0,No user reviews,0,0,0
856190,True,0,No user reviews,0,0,0
856200,True,0,No user reviews,0,0,0
856210,True,6,Mostly Positive,47,18,65
856220,True,0,7 user reviews,5,2,7
856240,True,0,1 user reviews,1,0,1
856260,True,0,4 user reviews,0,4,4
856270,True,0,4 user reviews,4,0,4
856300,True,0,No user reviews,0,0,0
856310,True,0,No user reviews,0,0,0
856320,True,5,Mixed,14,10,24
856350,True,0,1 user reviews,0,1,1
856370,True,0,1 user reviews,1,0,1
856380,True,0,1 user reviews,1,0,1
856390,True,0,1 user reviews,1,0,1
856400,True,0,5 user reviews,3,2,5
856410,True,0,4 user reviews,0,4,4
856420,True,0,No user reviews,0,0,0
856430,True,0,9 user reviews,3,6,9
856440,True,0,5 user reviews,2,3,5
856450,True,7,Positive,12,1,13
856490,True,5,Mixed,6,5,11
856530,True,0,No user reviews,0,0,0
856540,True,7,Positive,41,1,42
856550,True,0,1 user reviews,1,0,1
856560,True,0,1 user reviews,1,0,1
856570,True,7,Positive,11,0,11
856600,True,0,No user reviews,0,0,0
856610,True,7,Positive,18,3,21
856620,True,0,No user reviews,0,0,0
856630,True,0,No user reviews,0,0,0
856640,True,0,No user reviews,0,0,0
856650,True,0,5 user reviews,5,0,5
856660,True,0,No user reviews,0,0,0
856670,True,0,1 user reviews,1,0,1
856680,True,0,No user reviews,0,0,0
856700,True,0,No user reviews,0,0,0
856710,True,0,No user reviews,0,0,0
856730,True,0,No user reviews,0,0,0
856750,True,0,5 user reviews,4,1,5
856760,True,0,3 user reviews,1,2,3
856770,True,0,No user reviews,0,0,0
856780,True,0,No user reviews,0,0,0
856790,True,0,5 user reviews,1,4,5
856820,True,0,No user reviews,0,0,0
856840,True,0,1 user reviews,0,1,1
856850,True,7,Positive,38,9,47
856880,True,0,9 user reviews,7,2,9
856890,True,0,No user reviews,0,0,0
856900,True,0,3 user reviews,3,0,3
856910,True,0,1 user reviews,1,0,1
856920,True,0,3 user reviews,3,0,3
856930,True,0,1 user reviews,1,0,1
856940,True,0,1 user reviews,1,0,1
856950,True,0,1 user reviews,1,0,1
856960,True,0,3 user reviews,3,0,3
856970,True,0,No user reviews,0,0,0
856971,True,0,No user reviews,0,0,0
856972,True,0,No user reviews,0,0,0
856980,True,0,7 user reviews,2,5,7
856990,True,5,Mixed,14,12,26
857010,True,5,Mixed,10,5,15
857020,True,0,5 user reviews,3,2,5
857050,True,5,Mixed,8,6,14
857060,True,5,Mixed,22,24,46
857080,True,7,Positive,36,6,42
857110,True,0,1 user reviews,0,1,1
857130,True,0,No user reviews,0,0,0
857140,True,0,5 user reviews,3,2,5
857150,True,0,No user reviews,0,0,0
857151,True,0,No user reviews,0,0,0
857152,True,0,No user reviews,0,0,0
857153,True,0,No user reviews,0,0,0
857180,True,5,Mixed,16,9,25
857200,True,7,Positive,19,2,21
857210,True,0,No user reviews,0,0,0
857230,True,0,No user reviews,0,0,0
857240,True,0,4 user reviews,0,4,4
857250,True,0,No user reviews,0,0,0
857260,True,0,No user reviews,0,0,0
857280,True,7,Positive,11,0,11
857300,True,0,7 user reviews,6,1,7
857320,True,7,Positive,40,7,47
857350,True,0,No user reviews,0,0,0
857370,True,0,9 user reviews,5,4,9
857380,True,0,1 user reviews,1,0,1
857381,True,0,1 user reviews,1,0,1
857390,True,0,3 user reviews,0,3,3
857410,True,0,No user reviews,0,0,0
857420,True,0,9 user reviews,7,2,9
857450,True,8,Very Positive,106,3,109
857460,True,0,6 user reviews,6,0,6
857470,True,7,Positive,12,3,15
857480,True,0,7 user reviews,7,0,7
857500,True,7,Positive,28,1,29
857510,True,0,2 user reviews,1,1,2
857520,True,0,5 user reviews,2,3,5
857540,True,0,7 user reviews,6,1,7
857570,True,0,3 user reviews,0,3,3
857590,True,0,No user reviews,0,0,0
857600,True,0,3 user reviews,2,1,3
857620,True,0,No user reviews,0,0,0
857630,True,0,3 user reviews,1,2,3
857640,True,0,No user reviews,0,0,0
857680,True,6,Mostly Positive,37,10,47
857690,True,8,Very Positive,47,4,51
857700,True,0,4 user reviews,1,3,4
857710,True,0,1 user reviews,1,0,1
857720,True,0,No user reviews,0,0,0
857740,True,0,2 user reviews,2,0,2
857760,True,0,No user reviews,0,0,0
857770,True,0,2 user reviews,2,0,2
857830,True,0,No user reviews,0,0,0
857850,True,0,5 user reviews,3,2,5
857860,True,0,5 user reviews,5,0,5
857880,True,0,1 user reviews,1,0,1
857890,True,0,No user reviews,0,0,0
857900,True,0,6 user reviews,4,2,6
857910,True,0,No user reviews,0,0,0
857940,True,0,9 user reviews,7,2,9
857950,True,0,5 user reviews,3,2,5
857960,True,0,No user reviews,0,0,0
857970,True,0,2 user reviews,2,0,2
857980,True,8,Very Positive,1523,202,1725
858010,True,0,1 user reviews,0,1,1
858020,True,0,No user reviews,0,0,0
858030,True,0,No user reviews,0,0,0
858040,True,7,Positive,18,4,22
858050,True,7,Positive,31,0,31
858060,True,0,No user reviews,0,0,0
858070,True,0,No user reviews,0,0,0
858080,True,0,2 user reviews,1,1,2
858090,True,0,No user reviews,0,0,0
858100,True,7,Positive,16,4,20
858110,True,0,No user reviews,0,0,0
858130,True,0,No user reviews,0,0,0
858170,True,0,3 user reviews,3,0,3
858180,True,0,6 user reviews,1,5,6
858210,True,9,Overwhelmingly Positive,1544,23,1567
858230,True,0,2 user reviews,2,0,2
858240,True,7,Positive,16,3,19
858250,True,6,Mostly Positive,9,3,12
858260,True,9,Overwhelmingly Positive,1047,45,1092
858270,True,0,1 user reviews,1,0,1
858290,True,0,No user reviews,0,0,0
858300,True,0,2 user reviews,1,1,2
858320,True,0,1 user reviews,1,0,1
858350,True,0,No user reviews,0,0,0
858360,True,7,Positive,41,5,46
858380,True,0,No user reviews,0,0,0
858420,True,0,5 user reviews,2,3,5
858440,True,0,2 user reviews,1,1,2
858450,True,0,No user reviews,0,0,0
858460,True,0,No user reviews,0,0,0
858480,True,0,No user reviews,0,0,0
858500,True,0,No user reviews,0,0,0
858560,True,0,No user reviews,0,0,0
858590,True,5,Mixed,254,139,393
858600,True,0,No user reviews,0,0,0
858610,True,0,No user reviews,0,0,0
858620,True,0,No user reviews,0,0,0
858630,True,7,Positive,34,5,39
858640,True,0,No user reviews,0,0,0
858660,True,0,No user reviews,0,0,0
858680,True,6,Mostly Positive,28,9,37
858690,True,0,8 user reviews,3,5,8
858700,True,0,No user reviews,0,0,0
858710,True,0,No user reviews,0,0,0
858720,True,0,No user reviews,0,0,0
858730,True,0,No user reviews,0,0,0
858740,True,0,No user reviews,0,0,0
858760,True,8,Very Positive,274,5,279
858770,True,0,No user reviews,0,0,0
858780,True,5,Mixed,8,7,15
858790,True,0,No user reviews,0,0,0
858800,True,0,No user reviews,0,0,0
858810,True,8,Very Positive,4964,807,5771
858820,True,0,No user reviews,0,0,0
858830,True,0,9 user reviews,9,0,9
858840,True,0,2 user reviews,1,1,2
858860,True,7,Positive,26,1,27
858870,True,7,Positive,9,2,11
858880,True,7,Positive,19,0,19
858900,True,0,No user reviews,0,0,0
858930,True,0,7 user reviews,2,5,7
858940,True,7,Positive,49,0,49
858950,True,0,No user reviews,0,0,0
858960,True,0,6 user reviews,5,1,6
858970,True,0,1 user reviews,1,0,1
858980,True,0,1 user reviews,1,0,1
858990,True,0,No user reviews,0,0,0
859010,True,0,No user reviews,0,0,0
859040,True,6,Mostly Positive,25,7,32
859041,True,0,No user reviews,0,0,0
859050,True,0,1 user reviews,1,0,1
859060,True,0,No user reviews,0,0,0
859090,True,0,No user reviews,0,0,0
859100,True,0,No user reviews,0,0,0
859110,True,0,No user reviews,0,0,0
859120,True,0,No user reviews,0,0,0
859130,True,7,Positive,34,0,34
859150,True,0,4 user reviews,3,1,4
859160,True,0,No user reviews,0,0,0
859170,True,0,No user reviews,0,0,0
859180,True,0,No user reviews,0,0,0
859200,True,0,3 user reviews,3,0,3
859220,True,0,No user reviews,0,0,0
859240,True,0,No user reviews,0,0,0
859250,True,0,No user reviews,0,0,0
859270,True,0,No user reviews,0,0,0
859280,True,0,No user reviews,0,0,0
859290,True,0,No user reviews,0,0,0
859300,True,0,3 user reviews,3,0,3
859310,True,0,1 user reviews,0,1,1
859320,True,0,No user reviews,0,0,0
859340,True,5,Mixed,162,96,258
859350,True,7,Positive,11,1,12
859370,True,7,Positive,12,0,12
859380,True,0,3 user reviews,2,1,3
859400,True,0,No user reviews,0,0,0
859420,True,0,1 user reviews,1,0,1
859430,True,0,1 user reviews,1,0,1
859440,True,5,Mixed,6,7,13
859460,True,0,1 user reviews,0,1,1
859470,True,0,No user reviews,0,0,0
859490,True,0,No user reviews,0,0,0
859500,True,0,4 user reviews,1,3,4
859510,True,0,No user reviews,0,0,0
859530,True,0,1 user reviews,1,0,1
859540,True,0,No user reviews,0,0,0
859550,True,0,No user reviews,0,0,0
859560,True,0,4 user reviews,2,2,4
859570,True,8,Very Positive,1904,299,2203
859580,True,5,Mixed,4394,3878,8272
859600,True,0,1 user reviews,1,0,1
859610,True,0,1 user reviews,1,0,1
859640,True,7,Positive,21,3,24
859660,True,0,2 user reviews,2,0,2
859670,True,0,No user reviews,0,0,0
859680,True,9,Overwhelmingly Positive,499,16,515
859700,True,7,Positive,35,5,40
859720,True,0,No user reviews,0,0,0
859740,True,7,Positive,17,4,21
859770,True,0,No user reviews,0,0,0
859790,True,0,No user reviews,0,0,0
859820,True,0,3 user reviews,3,0,3
859870,True,0,2 user reviews,1,1,2
859900,True,0,4 user reviews,1,3,4
859910,True,0,No user reviews,0,0,0
859920,True,0,1 user reviews,0,1,1
859930,True,0,No user reviews,0,0,0
859940,True,0,No user reviews,0,0,0
859950,True,0,1 user reviews,1,0,1
859960,True,0,8 user reviews,8,0,8
859970,True,0,1 user reviews,1,0,1
859990,True,7,Positive,24,1,25
860000,True,0,No user reviews,0,0,0
860010,True,0,No user reviews,0,0,0
860020,True,0,No user reviews,0,0,0
860030,True,0,2 user reviews,2,0,2
860050,True,0,No user reviews,0,0,0
860060,True,0,No user reviews,0,0,0
860070,True,0,9 user reviews,6,3,9
860080,True,0,6 user reviews,6,0,6
860090,True,6,Mostly Positive,11,3,14
860100,True,0,No user reviews,0,0,0
860110,True,0,No user reviews,0,0,0
860120,True,0,No user reviews,0,0,0
860130,True,0,No user reviews,0,0,0
860140,True,0,No user reviews,0,0,0
860150,True,0,No user reviews,0,0,0
860190,True,3,Negative,2,9,11
860210,True,0,No user reviews,0,0,0
860230,True,0,No user reviews,0,0,0
860231,True,0,No user reviews,0,0,0
860232,True,0,No user reviews,0,0,0
860233,True,0,No user reviews,0,0,0
860260,True,0,4 user reviews,1,3,4
860270,True,0,No user reviews,0,0,0
860290,True,0,No user reviews,0,0,0
860320,True,0,3 user reviews,2,1,3
860330,True,0,No user reviews,0,0,0
860340,True,0,6 user reviews,3,3,6
860350,True,0,4 user reviews,1,3,4
860400,True,0,2 user reviews,1,1,2
860430,True,0,1 user reviews,0,1,1
860440,True,5,Mixed,13,7,20
860450,True,5,Mixed,11,6,17
860470,True,0,No user reviews,0,0,0
860480,True,0,3 user reviews,1,2,3
860490,True,0,1 user reviews,1,0,1
860500,True,5,Mixed,5,5,10
860530,True,0,8 user reviews,6,2,8
860540,True,0,No user reviews,0,0,0
860550,True,0,4 user reviews,4,0,4
860570,True,0,4 user reviews,0,4,4
860580,True,0,1 user reviews,0,1,1
860590,True,0,3 user reviews,3,0,3
860600,True,0,4 user reviews,3,1,4
860610,True,0,No user reviews,0,0,0
860620,True,4,Mostly Negative,20,45,65
860630,True,0,1 user reviews,1,0,1
860640,True,5,Mixed,12,12,24
860650,True,6,Mostly Positive,38,12,50
860660,True,0,8 user reviews,5,3,8
860670,True,0,No user reviews,0,0,0
860680,True,0,3 user reviews,2,1,3
860690,True,0,No user reviews,0,0,0
860700,True,0,No user reviews,0,0,0
860710,True,0,No user reviews,0,0,0
860720,True,0,3 user reviews,3,0,3
860730,True,0,No user reviews,0,0,0
860750,True,0,No user reviews,0,0,0
860770,True,0,8 user reviews,4,4,8
860790,True,0,5 user reviews,4,1,5
860820,True,0,6 user reviews,2,4,6
860840,True,0,No user reviews,0,0,0
860850,True,0,No user reviews,0,0,0
860860,True,5,Mixed,30,14,44
860870,True,0,1 user reviews,1,0,1
860880,True,0,6 user reviews,6,0,6
860890,True,8,Very Positive,961,91,1052
860900,True,3,Negative,3,13,16
860910,True,6,Mostly Positive,101,40,141
860930,True,0,No user reviews,0,0,0
860950,True,9,Overwhelmingly Positive,982,30,1012
860980,True,0,3 user reviews,2,1,3
860981,True,0,1 user reviews,0,1,1
860990,True,5,Mixed,9,5,14
861000,True,0,No user reviews,0,0,0
861010,True,0,5 user reviews,5,0,5
861020,True,0,No user reviews,0,0,0
861030,True,5,Mixed,6,5,11
861050,True,0,No user reviews,0,0,0
861080,True,0,4 user reviews,2,2,4
861090,True,0,8 user reviews,7,1,8
861100,True,0,5 user reviews,4,1,5
861110,True,0,1 user reviews,1,0,1
861120,True,0,No user reviews,0,0,0
861130,True,0,No user reviews,0,0,0
861150,True,0,No user reviews,0,0,0
861160,True,0,4 user reviews,2,2,4
861180,True,3,Negative,1,9,10
861190,True,4,Mostly Negative,4,9,13
861200,True,0,1 user reviews,1,0,1
861210,True,0,No user reviews,0,0,0
861230,True,0,2 user reviews,1,1,2
861240,True,0,4 user reviews,4,0,4
861250,True,0,No user reviews,0,0,0
861260,True,0,No user reviews,0,0,0
861270,True,7,Positive,15,2,17
861280,True,0,1 user reviews,1,0,1
861290,True,0,4 user reviews,2,2,4
861300,True,7,Positive,19,0,19
861320,True,0,4 user reviews,2,2,4
861330,True,7,Positive,16,0,16
861350,True,5,Mixed,30,23,53
861380,True,0,No user reviews,0,0,0
861390,True,0,No user reviews,0,0,0
861400,True,0,No user reviews,0,0,0
861440,True,0,No user reviews,0,0,0
861510,True,0,No user reviews,0,0,0
861530,True,0,No user reviews,0,0,0
861540,True,8,Very Positive,2292,228,2520
861550,True,0,7 user reviews,6,1,7
861580,True,0,No user reviews,0,0,0
861600,True,0,No user reviews,0,0,0
861640,True,0,3 user reviews,2,1,3
861641,True,0,5 user reviews,2,3,5
861642,True,0,2 user reviews,2,0,2
861650,True,8,Very Positive,3353,543,3896
861670,True,0,5 user reviews,4,1,5
861710,True,7,Positive,11,1,12
861720,True,5,Mixed,4,6,10
861730,True,0,1 user reviews,0,1,1
861731,True,0,2 user reviews,2,0,2
861732,True,5,Mixed,6,6,12
861740,True,0,3 user reviews,1,2,3
861750,True,0,1 user reviews,1,0,1
861751,True,0,No user reviews,0,0,0
861752,True,0,No user reviews,0,0,0
861753,True,0,No user reviews,0,0,0
861760,True,5,Mixed,25,17,42
861770,True,0,No user reviews,0,0,0
861790,True,0,No user reviews,0,0,0
861800,True,0,No user reviews,0,0,0
861810,True,0,No user reviews,0,0,0
861860,True,0,2 user reviews,2,0,2
861870,True,6,Mostly Positive,7,3,10
861871,True,0,3 user reviews,2,1,3
861872,True,0,4 user reviews,3,1,4
861880,True,0,6 user reviews,6,0,6
861881,True,7,Positive,13,3,16
861882,True,0,2 user reviews,2,0,2
861883,True,0,2 user reviews,2,0,2
861884,True,0,2 user reviews,2,0,2
861885,True,0,5 user reviews,5,0,5
861887,True,0,6 user reviews,4,2,6
861888,True,7,Positive,8,2,10
861889,True,5,Mixed,12,9,21
861910,True,0,No user reviews,0,0,0
861920,True,0,No user reviews,0,0,0
861930,True,0,No user reviews,0,0,0
861940,True,0,No user reviews,0,0,0
861960,True,0,2 user reviews,2,0,2
861990,True,0,No user reviews,0,0,0
862000,True,0,No user reviews,0,0,0
862070,True,0,No user reviews,0,0,0
862090,True,0,No user reviews,0,0,0
862100,True,0,No user reviews,0,0,0
862110,True,7,Positive,19,0,19
862120,True,0,5 user reviews,1,4,5
862130,True,7,Positive,11,0,11
862140,True,0,No user reviews,0,0,0
862141,True,0,No user reviews,0,0,0
862142,True,0,No user reviews,0,0,0
862143,True,0,No user reviews,0,0,0
862150,True,0,5 user reviews,3,2,5
862160,True,0,No user reviews,0,0,0
862170,True,0,No user reviews,0,0,0
862190,True,0,2 user reviews,0,2,2
862200,True,0,No user reviews,0,0,0
862210,True,4,Mostly Negative,4,10,14
862220,True,0,No user reviews,0,0,0
862230,True,0,No user reviews,0,0,0
862240,True,0,No user reviews,0,0,0
862250,True,0,1 user reviews,1,0,1
862260,True,5,Mixed,9,5,14
862280,True,0,6 user reviews,2,4,6
862300,True,0,7 user reviews,5,2,7
862370,True,0,1 user reviews,0,1,1
862390,True,5,Mixed,52,25,77
862400,True,0,No user reviews,0,0,0
862401,True,0,No user reviews,0,0,0
862430,True,0,No user reviews,0,0,0
862440,True,0,No user reviews,0,0,0
862450,True,0,8 user reviews,6,2,8
862460,True,7,Positive,11,0,11
862480,True,8,Very Positive,239,21,260
862490,True,0,1 user reviews,1,0,1
862500,True,0,2 user reviews,0,2,2
862510,True,0,No user reviews,0,0,0
862520,True,3,Negative,0,13,13
862550,True,0,No user reviews,0,0,0
862560,True,0,No user reviews,0,0,0
862570,True,8,Very Positive,226,6,232
862580,True,6,Mostly Positive,191,52,243
862590,True,0,5 user reviews,0,5,5
862610,True,0,No user reviews,0,0,0
862630,True,0,No user reviews,0,0,0
862640,True,0,1 user reviews,1,0,1
862650,True,0,4 user reviews,0,4,4
862660,True,0,8 user reviews,3,5,8
862670,True,0,No user reviews,0,0,0
862690,True,0,1 user reviews,1,0,1
862700,True,0,1 user reviews,1,0,1
862710,True,0,No user reviews,0,0,0
862730,True,0,No user reviews,0,0,0
862740,True,0,7 user reviews,6,1,7
862760,True,0,1 user reviews,1,0,1
862770,True,7,Positive,13,3,16
862790,True,0,2 user reviews,2,0,2
862800,True,8,Very Positive,514,52,566
862810,True,0,9 user reviews,7,2,9
862820,True,0,No user reviews,0,0,0
862840,True,0,No user reviews,0,0,0
862850,True,0,3 user reviews,1,2,3
862880,True,0,5 user reviews,2,3,5
862890,True,0,No user reviews,0,0,0
862900,True,0,No user reviews,0,0,0
862910,True,0,No user reviews,0,0,0
862911,True,0,No user reviews,0,0,0
862912,True,0,No user reviews,0,0,0
862913,True,0,No user reviews,0,0,0
862914,True,0,No user reviews,0,0,0
862915,True,0,No user reviews,0,0,0
862920,True,7,Positive,16,1,17
862930,True,0,No user reviews,0,0,0
862931,True,0,No user reviews,0,0,0
862940,True,3,Negative,2,9,11
862970,True,0,No user reviews,0,0,0
862990,True,0,3 user reviews,0,3,3
863110,True,0,No user reviews,0,0,0
863120,True,0,No user reviews,0,0,0
863140,True,0,No user reviews,0,0,0
863150,True,0,5 user reviews,3,2,5
863160,True,0,No user reviews,0,0,0
863170,True,0,No user reviews,0,0,0
863180,True,0,3 user reviews,3,0,3
863181,True,0,1 user reviews,1,0,1
863182,True,0,No user reviews,0,0,0
863190,True,0,1 user reviews,1,0,1
863210,True,0,5 user reviews,5,0,5
863220,True,0,No user reviews,0,0,0
863270,True,0,1 user reviews,1,0,1
863280,True,0,3 user reviews,2,1,3
863290,True,0,1 user reviews,1,0,1
863300,True,0,No user reviews,0,0,0
863310,True,0,2 user reviews,2,0,2
863320,True,0,No user reviews,0,0,0
863330,True,0,No user reviews,0,0,0
863360,True,0,No user reviews,0,0,0
863370,True,0,No user reviews,0,0,0
863380,True,5,Mixed,6,5,11
863400,True,0,No user reviews,0,0,0
863410,True,0,No user reviews,0,0,0
863420,True,4,Mostly Negative,8,13,21
863430,True,0,4 user reviews,4,0,4
863460,True,5,Mixed,17,15,32
863470,True,7,Positive,12,0,12
863490,True,5,Mixed,18,11,29
863520,True,0,6 user reviews,6,0,6
863550,True,8,Very Positive,7746,750,8496
863560,True,0,No user reviews,0,0,0
863570,True,8,Very Positive,215,42,257
863580,True,0,9 user reviews,3,6,9
863590,True,8,Very Positive,780,57,837
863600,True,0,No user reviews,0,0,0
863610,True,0,No user reviews,0,0,0
863620,True,0,1 user reviews,1,0,1
863640,True,0,No user reviews,0,0,0
863650,True,0,No user reviews,0,0,0
863660,True,0,2 user reviews,1,1,2
863670,True,0,No user reviews,0,0,0
863680,True,0,No user reviews,0,0,0
863681,True,0,No user reviews,0,0,0
863690,True,0,1 user reviews,0,1,1
863700,True,0,No user reviews,0,0,0
863720,True,0,No user reviews,0,0,0
863730,True,0,1 user reviews,1,0,1
863740,True,0,No user reviews,0,0,0
863760,True,0,1 user reviews,1,0,1
863780,True,0,No user reviews,0,0,0
863790,True,0,No user reviews,0,0,0
863810,True,0,7 user reviews,5,2,7
863820,True,0,No user reviews,0,0,0
863840,True,0,1 user reviews,0,1,1
863870,True,0,2 user reviews,1,1,2
863880,True,0,No user reviews,0,0,0
863900,True,0,6 user reviews,6,0,6
863910,True,0,No user reviews,0,0,0
863920,True,0,No user reviews,0,0,0
863930,True,0,No user reviews,0,0,0
863960,True,0,No user reviews,0,0,0
863980,True,5,Mixed,9,8,17
864010,True,0,6 user reviews,4,2,6
864020,True,0,3 user reviews,2,1,3
864030,True,0,No user reviews,0,0,0
864050,True,0,No user reviews,0,0,0
864060,True,8,Very Positive,312,17,329
864080,True,0,1 user reviews,1,0,1
864100,True,8,Very Positive,88,6,94
864110,True,0,3 user reviews,2,1,3
864130,True,6,Mostly Positive,20,6,26
864150,True,0,9 user reviews,5,4,9
864160,True,6,Mostly Positive,108,31,139
864180,True,0,No user reviews,0,0,0
864181,True,0,No user reviews,0,0,0
864182,True,0,No user reviews,0,0,0
864183,True,0,No user reviews,0,0,0
864184,True,0,No user reviews,0,0,0
864185,True,0,No user reviews,0,0,0
864186,True,0,No user reviews,0,0,0
864187,True,0,No user reviews,0,0,0
864188,True,0,No user reviews,0,0,0
864189,True,0,No user reviews,0,0,0
864190,True,0,1 user reviews,1,0,1
864200,True,0,1 user reviews,0,1,1
864210,True,0,No user reviews,0,0,0
864220,True,0,3 user reviews,3,0,3
864230,True,0,No user reviews,0,0,0
864240,True,0,No user reviews,0,0,0
864250,True,0,No user reviews,0,0,0
864270,True,0,No user reviews,0,0,0
864290,True,0,No user reviews,0,0,0
864300,True,8,Very Positive,64,5,69
864310,True,0,1 user reviews,1,0,1
864320,True,0,No user reviews,0,0,0
864330,True,0,No user reviews,0,0,0
864360,True,0,1 user reviews,1,0,1
864370,True,0,2 user reviews,2,0,2
864420,True,0,No user reviews,0,0,0
864430,True,0,4 user reviews,3,1,4
864450,True,0,8 user reviews,6,2,8
864480,True,0,No user reviews,0,0,0
864500,True,0,2 user reviews,2,0,2
864510,True,6,Mostly Positive,12,4,16
864530,True,0,5 user reviews,3,2,5
864540,True,7,Positive,40,8,48
864550,True,6,Mostly Positive,36,11,47
864560,True,0,No user reviews,0,0,0
864570,True,0,9 user reviews,7,2,9
864590,True,0,No user reviews,0,0,0
864600,True,0,2 user reviews,2,0,2
864610,True,6,Mostly Positive,16,5,21
864660,True,0,2 user reviews,1,1,2
864670,True,0,No user reviews,0,0,0
864680,True,8,Very Positive,67,5,72
864700,True,0,No user reviews,0,0,0
864710,True,0,No user reviews,0,0,0
864720,True,0,No user reviews,0,0,0
864730,True,6,Mostly Positive,29,10,39
864740,True,0,6 user reviews,6,0,6
864750,True,0,No user reviews,0,0,0
864760,True,0,3 user reviews,1,2,3
864780,True,0,No user reviews,0,0,0
864790,True,5,Mixed,6,4,10
864810,True,0,6 user reviews,3,3,6
864820,True,0,No user reviews,0,0,0
864850,True,0,3 user reviews,2,1,3
864860,True,7,Positive,12,1,13
864880,True,0,5 user reviews,3,2,5
864890,True,0,No user reviews,0,0,0
864900,True,0,No user reviews,0,0,0
864930,True,0,No user reviews,0,0,0
864940,True,4,Mostly Negative,3,9,12
864960,True,0,2 user reviews,2,0,2
864970,True,7,Positive,32,7,39
864980,True,7,Positive,23,2,25
865010,True,0,No user reviews,0,0,0
865011,True,0,No user reviews,0,0,0
865012,True,0,No user reviews,0,0,0
865013,True,0,No user reviews,0,0,0
865014,True,0,No user reviews,0,0,0
865040,True,8,Very Positive,101,6,107
865060,True,0,6 user reviews,6,0,6
865070,True,0,2 user reviews,0,2,2
865090,True,8,Very Positive,279,29,308
865100,True,0,No user reviews,0,0,0
865120,True,0,1 user reviews,0,1,1
865130,True,0,No user reviews,0,0,0
865140,True,0,No user reviews,0,0,0
865150,True,0,No user reviews,0,0,0
865160,True,5,Mixed,10,9,19
865170,True,0,3 user reviews,3,0,3
865180,True,0,3 user reviews,1,2,3
865190,True,5,Mixed,7,4,11
865200,True,0,No user reviews,0,0,0
865210,True,0,1 user reviews,1,0,1
865220,True,7,Positive,17,1,18
865250,True,6,Mostly Positive,62,21,83
865260,True,0,2 user reviews,2,0,2
865270,True,8,Very Positive,75,5,80
865290,True,0,1 user reviews,1,0,1
865310,True,5,Mixed,4,6,10
865320,True,0,9 user reviews,6,3,9
865330,True,0,2 user reviews,1,1,2
865351,True,0,No user reviews,0,0,0
865360,True,8,Very Positive,1264,135,1399
865370,True,0,No user reviews,0,0,0
865380,True,0,No user reviews,0,0,0
865390,True,4,Mostly Negative,11,19,30
865400,True,0,No user reviews,0,0,0
865420,True,0,No user reviews,0,0,0
865430,True,0,No user reviews,0,0,0
865540,True,8,Very Positive,455,13,468
865570,True,0,No user reviews,0,0,0
865590,True,0,No user reviews,0,0,0
865610,True,0,No user reviews,0,0,0
865620,True,0,No user reviews,0,0,0
865630,True,0,3 user reviews,3,0,3
865640,True,0,No user reviews,0,0,0
865650,True,0,No user reviews,0,0,0
865670,True,6,Mostly Positive,521,157,678
865700,True,0,No user reviews,0,0,0
865701,True,0,No user reviews,0,0,0
865720,True,0,1 user reviews,0,1,1
865740,True,0,No user reviews,0,0,0
865750,True,0,1 user reviews,1,0,1
865760,True,0,1 user reviews,1,0,1
865770,True,0,No user reviews,0,0,0
865780,True,0,No user reviews,0,0,0
865800,True,0,2 user reviews,2,0,2
865810,True,0,No user reviews,0,0,0
865820,True,8,Very Positive,74,10,84
865830,True,7,Positive,38,4,42
865840,True,0,No user reviews,0,0,0
865850,True,5,Mixed,8,6,14
865860,True,0,2 user reviews,0,2,2
865870,True,0,4 user reviews,2,2,4
865880,True,0,No user reviews,0,0,0
865890,True,0,No user reviews,0,0,0
865920,True,0,No user reviews,0,0,0
865930,True,0,8 user reviews,7,1,8
865940,True,7,Positive,24,5,29
865960,True,0,No user reviews,0,0,0
865970,True,0,1 user reviews,1,0,1
865980,True,6,Mostly Positive,52,15,67
865990,True,0,3 user reviews,2,1,3
866010,True,7,Positive,31,7,38
866040,True,0,No user reviews,0,0,0
866060,True,0,No user reviews,0,0,0
866080,True,0,No user reviews,0,0,0
866100,True,0,3 user reviews,1,2,3
866120,True,0,No user reviews,0,0,0
866130,True,0,No user reviews,0,0,0
866140,True,0,No user reviews,0,0,0
866150,True,0,3 user reviews,2,1,3
866180,True,0,4 user reviews,0,4,4
866190,True,8,Very Positive,89,10,99
866200,True,0,No user reviews,0,0,0
866210,True,0,No user reviews,0,0,0
866211,True,0,1 user reviews,0,1,1
866212,True,0,3 user reviews,3,0,3
866260,True,5,Mixed,6,8,14
866270,True,0,No user reviews,0,0,0
866280,True,0,2 user reviews,0,2,2
866290,True,0,No user reviews,0,0,0
866300,True,0,No user reviews,0,0,0
866310,True,6,Mostly Positive,11,4,15
866320,True,0,2 user reviews,2,0,2
866330,True,0,No user reviews,0,0,0
866340,True,0,1 user reviews,0,1,1
866350,True,0,No user reviews,0,0,0
866360,True,0,No user reviews,0,0,0
866400,True,7,Positive,28,7,35
866410,True,0,No user reviews,0,0,0
866420,True,7,Positive,15,1,16
866430,True,0,No user reviews,0,0,0
866440,True,0,No user reviews,0,0,0
866450,True,0,2 user reviews,2,0,2
866480,True,0,No user reviews,0,0,0
866500,True,0,3 user reviews,3,0,3
866510,True,5,Mixed,20,17,37
866520,True,6,Mostly Positive,7,3,10
866530,True,0,No user reviews,0,0,0
866540,True,0,3 user reviews,3,0,3
866560,True,0,No user reviews,0,0,0
866590,True,0,No user reviews,0,0,0
866600,True,0,2 user reviews,2,0,2
866610,True,0,No user reviews,0,0,0
866620,True,0,No user reviews,0,0,0
866630,True,0,1 user reviews,0,1,1
866640,True,0,No user reviews,0,0,0
866650,True,0,No user reviews,0,0,0
866660,True,0,No user reviews,0,0,0
866670,True,0,1 user reviews,0,1,1
866700,True,0,3 user reviews,2,1,3
866710,True,0,3 user reviews,2,1,3
866720,True,0,2 user reviews,2,0,2
866730,True,0,2 user reviews,2,0,2
866740,True,0,No user reviews,0,0,0
866750,True,0,2 user reviews,2,0,2
866770,True,0,7 user reviews,3,4,7
866780,True,0,No user reviews,0,0,0
866790,True,0,1 user reviews,1,0,1
866800,True,8,Very Positive,3146,318,3464
866810,True,0,No user reviews,0,0,0
866820,True,0,No user reviews,0,0,0
866840,True,0,No user reviews,0,0,0
866850,True,0,No user reviews,0,0,0
866880,True,0,No user reviews,0,0,0
866900,True,0,No user reviews,0,0,0
866950,True,0,No user reviews,0,0,0
866960,True,0,No user reviews,0,0,0
866980,True,0,No user reviews,0,0,0
866990,True,0,No user reviews,0,0,0
867010,True,0,2 user reviews,2,0,2
867020,True,0,1 user reviews,1,0,1
867030,True,0,No user reviews,0,0,0
867050,True,5,Mixed,17,9,26
867070,True,0,1 user reviews,1,0,1
867080,True,0,No user reviews,0,0,0
867090,True,0,No user reviews,0,0,0
867100,True,0,No user reviews,0,0,0
867110,True,0,3 user reviews,3,0,3
867120,True,5,Mixed,8,5,13
867130,True,0,No user reviews,0,0,0
867140,True,5,Mixed,11,5,16
867150,True,0,No user reviews,0,0,0
867180,True,7,Positive,26,3,29
867200,True,0,1 user reviews,1,0,1
867220,True,0,1 user reviews,0,1,1
867230,True,0,No user reviews,0,0,0
867240,True,7,Positive,22,3,25
867250,True,0,9 user reviews,9,0,9
867290,True,5,Mixed,801,516,1317
867380,True,8,Very Positive,109,9,118
867390,True,0,1 user reviews,1,0,1
867400,True,8,Very Positive,52,8,60
867420,True,5,Mixed,8,5,13
867460,True,0,No user reviews,0,0,0
867470,True,0,1 user reviews,0,1,1
867480,True,5,Mixed,7,6,13
867490,True,7,Positive,33,7,40
867510,True,0,2 user reviews,2,0,2
867530,True,0,1 user reviews,1,0,1
867540,True,0,4 user reviews,2,2,4
867550,True,0,2 user reviews,1,1,2
867570,True,0,1 user reviews,0,1,1
867580,True,0,4 user reviews,1,3,4
867590,True,0,3 user reviews,2,1,3
867600,True,0,1 user reviews,1,0,1
867610,True,5,Mixed,10,9,19
867620,True,0,7 user reviews,0,7,7
867630,True,0,No user reviews,0,0,0
867640,True,0,5 user reviews,3,2,5
867660,True,0,No user reviews,0,0,0
867680,True,0,No user reviews,0,0,0
867690,True,0,No user reviews,0,0,0
867700,True,7,Positive,30,6,36
867710,True,0,1 user reviews,1,0,1
867720,True,0,No user reviews,0,0,0
867730,True,0,8 user reviews,3,5,8
867740,True,0,No user reviews,0,0,0
867750,True,0,No user reviews,0,0,0
867760,True,0,No user reviews,0,0,0
867770,True,0,No user reviews,0,0,0
867780,True,0,No user reviews,0,0,0
867790,True,0,2 user reviews,2,0,2
867800,True,0,5 user reviews,3,2,5
867810,True,0,No user reviews,0,0,0
867850,True,0,3 user reviews,1,2,3
867860,True,0,6 user reviews,6,0,6
867870,True,0,No user reviews,0,0,0
867880,True,0,No user reviews,0,0,0
867890,True,0,No user reviews,0,0,0
867900,True,0,No user reviews,0,0,0
867910,True,0,No user reviews,0,0,0
867920,True,0,1 user reviews,1,0,1
867930,True,0,No user reviews,0,0,0
867940,True,0,1 user reviews,0,1,1
867941,True,0,No user reviews,0,0,0
867942,True,0,No user reviews,0,0,0
867943,True,0,No user reviews,0,0,0
867944,True,0,No user reviews,0,0,0
867945,True,0,No user reviews,0,0,0
867946,True,0,No user reviews,0,0,0
867947,True,0,No user reviews,0,0,0
867948,True,0,No user reviews,0,0,0
867949,True,0,No user reviews,0,0,0
867950,True,0,No user reviews,0,0,0
867951,True,0,No user reviews,0,0,0
867960,True,0,No user reviews,0,0,0
867980,True,7,Positive,24,1,25
867990,True,0,No user reviews,0,0,0
868000,True,0,3 user reviews,0,3,3
868010,True,0,3 user reviews,3,0,3
868020,True,0,No user reviews,0,0,0
868030,True,0,No user reviews,0,0,0
868040,True,0,1 user reviews,1,0,1
868060,True,7,Positive,26,5,31
868070,True,0,No user reviews,0,0,0
868080,True,7,Positive,26,5,31
868090,True,0,No user reviews,0,0,0
868100,True,0,No user reviews,0,0,0
868110,True,0,No user reviews,0,0,0
868111,True,0,1 user reviews,1,0,1
868112,True,0,No user reviews,0,0,0
868120,True,0,No user reviews,0,0,0
868130,True,0,1 user reviews,1,0,1
868140,True,0,No user reviews,0,0,0
868150,True,8,Very Positive,96,10,106
868170,True,0,No user reviews,0,0,0
868180,True,0,No user reviews,0,0,0
868190,True,0,No user reviews,0,0,0
868200,True,0,No user reviews,0,0,0
868210,True,0,1 user reviews,1,0,1
868220,True,0,No user reviews,0,0,0
868221,True,0,No user reviews,0,0,0
868230,True,6,Mostly Positive,18,6,24
868240,True,0,1 user reviews,1,0,1
868250,True,0,No user reviews,0,0,0
868260,True,5,Mixed,8,6,14
868270,True,0,No user reviews,0,0,0
868280,True,7,Positive,41,3,44
868310,True,7,Positive,31,6,37
868311,True,7,Positive,16,2,18
868312,True,6,Mostly Positive,21,7,28
868320,True,0,No user reviews,0,0,0
868330,True,0,No user reviews,0,0,0
868340,True,7,Positive,10,1,11
868350,True,0,3 user reviews,0,3,3
868360,True,8,Very Positive,1075,215,1290
868370,True,0,No user reviews,0,0,0
868380,True,5,Mixed,44,32,76
868390,True,0,1 user reviews,0,1,1
868400,True,0,3 user reviews,1,2,3
868410,True,4,Mostly Negative,10,16,26
868422,True,6,Mostly Positive,28,11,39
868423,True,6,Mostly Positive,12,4,16
868424,True,5,Mixed,26,18,44
868430,True,0,3 user reviews,3,0,3
868440,True,0,3 user reviews,3,0,3
868450,True,0,No user reviews,0,0,0
868460,True,0,1 user reviews,0,1,1
868470,True,0,2 user reviews,0,2,2
868480,True,0,3 user reviews,2,1,3
868490,True,0,No user reviews,0,0,0
868500,True,7,Positive,11,0,11
868510,True,0,1 user reviews,1,0,1
868520,True,9,Overwhelmingly Positive,734,25,759
868530,True,0,No user reviews,0,0,0
868540,True,0,No user reviews,0,0,0
868550,True,5,Mixed,9,4,13
868560,True,0,4 user reviews,3,1,4
868570,True,5,Mixed,12,6,18
868580,True,7,Positive,23,5,28
868600,True,0,1 user reviews,1,0,1
868610,True,0,No user reviews,0,0,0
868620,True,0,No user reviews,0,0,0
868621,True,0,No user reviews,0,0,0
868622,True,0,No user reviews,0,0,0
868623,True,0,No user reviews,0,0,0
868624,True,0,No user reviews,0,0,0
868625,True,0,No user reviews,0,0,0
868626,True,0,No user reviews,0,0,0
868627,True,0,No user reviews,0,0,0
868628,True,0,No user reviews,0,0,0
868629,True,0,No user reviews,0,0,0
868630,True,0,No user reviews,0,0,0
868631,True,0,No user reviews,0,0,0
868650,True,0,No user reviews,0,0,0
868660,True,0,6 user reviews,5,1,6
868670,True,0,No user reviews,0,0,0
868680,True,0,No user reviews,0,0,0
868710,True,3,Negative,1,9,10
868720,True,0,No user reviews,0,0,0
868730,True,0,1 user reviews,1,0,1
868750,True,0,No user reviews,0,0,0
868760,True,0,No user reviews,0,0,0
868770,True,0,1 user reviews,1,0,1
868780,True,7,Positive,22,2,24
868790,True,0,No user reviews,0,0,0
868810,True,0,No user reviews,0,0,0
868820,True,0,4 user reviews,4,0,4
868830,True,0,No user reviews,0,0,0
868870,True,0,6 user reviews,6,0,6
868880,True,0,4 user reviews,3,1,4
868890,True,5,Mixed,7,4,11
868900,True,0,No user reviews,0,0,0
868910,True,0,1 user reviews,1,0,1
868920,True,0,4 user reviews,2,2,4
868930,True,0,7 user reviews,7,0,7
868940,True,0,No user reviews,0,0,0
868950,True,0,No user reviews,0,0,0
868960,True,0,1 user reviews,0,1,1
868970,True,0,4 user reviews,1,3,4
868980,True,8,Very Positive,412,10,422
868990,True,0,No user reviews,0,0,0
869010,True,0,No user reviews,0,0,0
869030,True,0,2 user reviews,2,0,2
869060,True,5,Mixed,33,44,77
869080,True,0,1 user reviews,1,0,1
869090,True,0,No user reviews,0,0,0
869100,True,0,6 user reviews,5,1,6
869120,True,0,4 user reviews,4,0,4
869130,True,0,3 user reviews,1,2,3
869140,True,0,No user reviews,0,0,0
869160,True,0,2 user reviews,2,0,2
869170,True,7,Positive,23,4,27
869210,True,0,No user reviews,0,0,0
869230,True,0,No user reviews,0,0,0
869240,True,0,No user reviews,0,0,0
869241,True,0,1 user reviews,0,1,1
869270,True,0,No user reviews,0,0,0
869280,True,0,7 user reviews,1,6,7
869290,True,0,8 user reviews,8,0,8
869300,True,7,Positive,9,1,10
869330,True,0,No user reviews,0,0,0
869340,True,0,4 user reviews,0,4,4
869350,True,8,Very Positive,51,3,54
869360,True,0,No user reviews,0,0,0
869370,True,0,2 user reviews,2,0,2
869390,True,7,Positive,13,0,13
869410,True,0,No user reviews,0,0,0
869420,True,0,2 user reviews,0,2,2
869430,True,0,No user reviews,0,0,0
869440,True,0,3 user reviews,3,0,3
869450,True,0,No user reviews,0,0,0
869460,True,0,No user reviews,0,0,0
869470,True,0,5 user reviews,5,0,5
869480,True,0,No user reviews,0,0,0
869500,True,0,1 user reviews,1,0,1
869530,True,0,2 user reviews,2,0,2
869540,True,0,3 user reviews,2,1,3
869550,True,7,Positive,10,1,11
869560,True,0,4 user reviews,2,2,4
869580,True,0,No user reviews,0,0,0
869600,True,0,No user reviews,0,0,0
869620,True,7,Positive,10,2,12
869630,True,0,No user reviews,0,0,0
869640,True,0,No user reviews,0,0,0
869650,True,0,No user reviews,0,0,0
869660,True,0,1 user reviews,0,1,1
869670,True,7,Positive,15,1,16
869680,True,0,5 user reviews,0,5,5
869690,True,7,Positive,21,0,21
869700,True,0,No user reviews,0,0,0
869710,True,0,No user reviews,0,0,0
869730,True,0,No user reviews,0,0,0
869740,True,0,No user reviews,0,0,0
869750,True,0,3 user reviews,2,1,3
869760,True,0,No user reviews,0,0,0
869780,True,6,Mostly Positive,8,3,11
869790,True,0,No user reviews,0,0,0
869830,True,7,Positive,24,3,27
869840,True,0,5 user reviews,4,1,5
869850,True,0,7 user reviews,7,0,7
869860,True,0,No user reviews,0,0,0
869870,True,0,4 user reviews,4,0,4
869880,True,0,No user reviews,0,0,0
869910,True,0,4 user reviews,4,0,4
869930,True,0,1 user reviews,0,1,1
870000,True,0,No user reviews,0,0,0
870010,True,0,2 user reviews,0,2,2
870020,True,0,3 user reviews,3,0,3
870030,True,0,1 user reviews,1,0,1
870080,True,6,Mostly Positive,20,6,26
870090,True,0,3 user reviews,3,0,3
870100,True,0,1 user reviews,0,1,1
870110,True,0,5 user reviews,2,3,5
870120,True,0,6 user reviews,2,4,6
870140,True,0,7 user reviews,6,1,7
870150,True,0,No user reviews,0,0,0
870160,True,0,3 user reviews,2,1,3
870180,True,0,7 user reviews,4,3,7
870190,True,0,3 user reviews,3,0,3
870200,True,8,Very Positive,529,53,582
870240,True,0,2 user reviews,2,0,2
870260,True,0,7 user reviews,7,0,7
870270,True,5,Mixed,16,7,23
870271,True,0,3 user reviews,3,0,3
870272,True,0,5 user reviews,5,0,5
870273,True,0,3 user reviews,3,0,3
870274,True,0,No user reviews,0,0,0
870275,True,0,No user reviews,0,0,0
870276,True,0,1 user reviews,1,0,1
870277,True,0,4 user reviews,3,1,4
870279,True,0,No user reviews,0,0,0
870280,True,0,7 user reviews,6,1,7
870290,True,6,Mostly Positive,195,62,257
870300,True,0,No user reviews,0,0,0
870310,True,0,No user reviews,0,0,0
870320,True,0,No user reviews,0,0,0
870321,True,0,No user reviews,0,0,0
870322,True,0,No user reviews,0,0,0
870323,True,0,No user reviews,0,0,0
870324,True,0,No user reviews,0,0,0
870325,True,0,No user reviews,0,0,0
870326,True,0,No user reviews,0,0,0
870327,True,0,No user reviews,0,0,0
870328,True,0,No user reviews,0,0,0
870329,True,0,No user reviews,0,0,0
870330,True,0,No user reviews,0,0,0
870331,True,0,No user reviews,0,0,0
870340,True,0,No user reviews,0,0,0
870341,True,0,No user reviews,0,0,0
870342,True,0,No user reviews,0,0,0
870343,True,0,No user reviews,0,0,0
870344,True,0,No user reviews,0,0,0
870345,True,0,1 user reviews,1,0,1
870346,True,0,No user reviews,0,0,0
870347,True,0,No user reviews,0,0,0
870348,True,0,No user reviews,0,0,0
870349,True,0,No user reviews,0,0,0
870350,True,0,No user reviews,0,0,0
870351,True,0,No user reviews,0,0,0
870390,True,0,4 user reviews,3,1,4
870400,True,0,4 user reviews,2,2,4
870420,True,8,Very Positive,213,31,244
870430,True,0,2 user reviews,0,2,2
870450,True,0,1 user reviews,0,1,1
870460,True,0,1 user reviews,0,1,1
870461,True,0,1 user reviews,0,1,1
870462,True,0,1 user reviews,0,1,1
870470,True,0,1 user reviews,1,0,1
870490,True,0,No user reviews,0,0,0
870500,True,0,No user reviews,0,0,0
870510,True,0,2 user reviews,2,0,2
870520,True,0,1 user reviews,0,1,1
870570,True,0,No user reviews,0,0,0
870580,True,0,4 user reviews,3,1,4
870590,True,0,3 user reviews,3,0,3
870600,True,0,8 user reviews,8,0,8
870620,True,0,1 user reviews,0,1,1
870621,True,0,No user reviews,0,0,0
870630,True,0,No user reviews,0,0,0
870640,True,0,No user reviews,0,0,0
870650,True,0,1 user reviews,0,1,1
870670,True,0,5 user reviews,5,0,5
870680,True,0,2 user reviews,1,1,2
870690,True,8,Very Positive,65,4,69
870710,True,0,No user reviews,0,0,0
870720,True,0,No user reviews,0,0,0
870730,True,7,Positive,30,3,33
870740,True,0,No user reviews,0,0,0
870750,True,0,2 user reviews,2,0,2
870760,True,0,No user reviews,0,0,0
870780,True,8,Very Positive,2862,284,3146
870800,True,0,5 user reviews,5,0,5
870810,True,0,No user reviews,0,0,0
870820,True,0,No user reviews,0,0,0
870830,True,0,No user reviews,0,0,0
870890,True,0,No user reviews,0,0,0
870900,True,0,No user reviews,0,0,0
870920,True,0,2 user reviews,2,0,2
870940,True,0,No user reviews,0,0,0
870950,True,0,No user reviews,0,0,0
870960,True,0,No user reviews,0,0,0
870990,True,0,3 user reviews,1,2,3
871030,True,0,No user reviews,0,0,0
871031,True,0,No user reviews,0,0,0
871040,True,0,No user reviews,0,0,0
871041,True,0,No user reviews,0,0,0
871050,True,0,No user reviews,0,0,0
871051,True,0,No user reviews,0,0,0
871060,True,0,No user reviews,0,0,0
871070,True,0,No user reviews,0,0,0
871080,True,0,No user reviews,0,0,0
871081,True,0,No user reviews,0,0,0
871082,True,0,No user reviews,0,0,0
871100,True,0,6 user reviews,6,0,6
871140,True,0,1 user reviews,0,1,1
871150,True,0,3 user reviews,2,1,3
871160,True,0,No user reviews,0,0,0
871170,True,0,No user reviews,0,0,0
871190,True,7,Positive,17,1,18
871200,True,8,Very Positive,208,25,233
871220,True,0,No user reviews,0,0,0
871230,True,0,8 user reviews,5,3,8
871240,True,0,No user reviews,0,0,0
871241,True,0,No user reviews,0,0,0
871250,True,0,No user reviews,0,0,0
871260,True,0,3 user reviews,2,1,3
871270,True,0,No user reviews,0,0,0
871280,True,7,Positive,15,0,15
871290,True,0,4 user reviews,3,1,4
871300,True,0,1 user reviews,0,1,1
871310,True,6,Mostly Positive,9,3,12
871320,True,0,No user reviews,0,0,0
871330,True,0,4 user reviews,4,0,4
871340,True,0,No user reviews,0,0,0
871380,True,0,No user reviews,0,0,0
871390,True,0,4 user reviews,3,1,4
871400,True,0,No user reviews,0,0,0
871410,True,0,No user reviews,0,0,0
871420,True,8,Very Positive,165,34,199
871490,True,0,No user reviews,0,0,0
871510,True,0,4 user reviews,3,1,4
871530,True,6,Mostly Positive,329,86,415
871550,True,0,No user reviews,0,0,0
871570,True,0,1 user reviews,1,0,1
871580,True,0,2 user reviews,2,0,2
871590,True,0,6 user reviews,4,2,6
871600,True,0,No user reviews,0,0,0
871620,True,0,No user reviews,0,0,0
871630,True,0,No user reviews,0,0,0
871640,True,0,No user reviews,0,0,0
871650,True,7,Positive,27,1,28
871651,True,0,9 user reviews,3,6,9
871670,True,0,No user reviews,0,0,0
871710,True,0,7 user reviews,3,4,7
871720,True,0,3 user reviews,3,0,3
871810,True,0,8 user reviews,4,4,8
871830,True,0,No user reviews,0,0,0
871850,True,0,5 user reviews,4,1,5
871860,True,0,1 user reviews,0,1,1
871870,True,5,Mixed,6,4,10
871900,True,0,9 user reviews,9,0,9
871920,True,0,2 user reviews,2,0,2
871930,True,8,Very Positive,369,27,396
871940,True,0,No user reviews,0,0,0
871950,True,8,Very Positive,100,16,116
871970,True,0,No user reviews,0,0,0
871990,True,5,Mixed,86,59,145
872000,True,0,No user reviews,0,0,0
872040,True,0,6 user reviews,6,0,6
872050,True,0,No user reviews,0,0,0
872060,True,6,Mostly Positive,7,3,10
872070,True,0,3 user reviews,3,0,3
872090,True,5,Mixed,7,6,13
872100,True,0,No user reviews,0,0,0
872110,True,7,Positive,13,1,14
872120,True,0,No user reviews,0,0,0
872130,True,8,Very Positive,237,20,257
872140,True,0,No user reviews,0,0,0
872170,True,0,No user reviews,0,0,0
872180,True,0,3 user reviews,2,1,3
872190,True,0,No user reviews,0,0,0
872210,True,0,No user reviews,0,0,0
872220,True,0,1 user reviews,1,0,1
872230,True,0,No user reviews,0,0,0
872240,True,0,1 user reviews,1,0,1
872250,True,0,No user reviews,0,0,0
872260,True,0,No user reviews,0,0,0
872270,True,0,No user reviews,0,0,0
872280,True,4,Mostly Negative,36,60,96
872300,True,0,No user reviews,0,0,0
872310,True,0,1 user reviews,1,0,1
872330,True,0,1 user reviews,0,1,1
872340,True,0,No user reviews,0,0,0
872350,True,5,Mixed,17,15,32
872360,True,0,3 user reviews,2,1,3
872370,True,0,1 user reviews,1,0,1
872380,True,0,9 user reviews,8,1,9
872390,True,0,No user reviews,0,0,0
872400,True,0,5 user reviews,1,4,5
872410,True,5,Mixed,190,131,321
872420,True,0,No user reviews,0,0,0
872430,True,0,No user reviews,0,0,0
872440,True,0,No user reviews,0,0,0
872450,True,0,No user reviews,0,0,0
872460,True,0,No user reviews,0,0,0
872470,True,7,Positive,14,1,15
872490,True,0,6 user reviews,3,3,6
872500,True,0,No user reviews,0,0,0
872520,True,0,No user reviews,0,0,0
872530,True,0,2 user reviews,1,1,2
872540,True,0,No user reviews,0,0,0
872550,True,0,4 user reviews,2,2,4
872560,True,0,No user reviews,0,0,0
872580,True,0,9 user reviews,9,0,9
872590,True,0,No user reviews,0,0,0
872600,True,0,No user reviews,0,0,0
872610,True,0,No user reviews,0,0,0
872630,True,0,8 user reviews,1,7,8
872640,True,0,No user reviews,0,0,0
872650,True,0,No user reviews,0,0,0
872670,True,0,No user reviews,0,0,0
872680,True,5,Mixed,50,26,76
872690,True,0,4 user reviews,2,2,4
872700,True,0,1 user reviews,1,0,1
872720,True,0,No user reviews,0,0,0
872730,True,0,7 user reviews,6,1,7
872750,True,8,Very Positive,88,8,96
872770,True,0,7 user reviews,5,2,7
872790,True,8,Very Positive,2094,321,2415
872810,True,7,Positive,17,2,19
872820,True,8,Very Positive,65,13,78
872860,True,0,No user reviews,0,0,0
872870,True,0,No user reviews,0,0,0
872970,True,0,No user reviews,0,0,0
872990,True,0,4 user reviews,2,2,4
873030,True,7,Positive,20,5,25
873040,True,0,No user reviews,0,0,0
873050,True,0,1 user reviews,0,1,1
873070,True,7,Positive,16,1,17
873090,True,0,No user reviews,0,0,0
873100,True,0,No user reviews,0,0,0
873120,True,0,6 user reviews,4,2,6
873130,True,0,No user reviews,0,0,0
873140,True,0,1 user reviews,0,1,1
873160,True,0,1 user reviews,0,1,1
873180,True,0,1 user reviews,0,1,1
873190,True,7,Positive,26,2,28
873200,True,8,Very Positive,99,4,103
873210,True,0,1 user reviews,0,1,1
873220,True,5,Mixed,37,24,61
873230,True,0,No user reviews,0,0,0
873240,True,8,Very Positive,252,32,284
873250,True,0,No user reviews,0,0,0
873280,True,0,No user reviews,0,0,0
873290,True,0,5 user reviews,5,0,5
873300,True,0,No user reviews,0,0,0
873310,True,0,No user reviews,0,0,0
873320,True,0,1 user reviews,0,1,1
873330,True,0,No user reviews,0,0,0
873340,True,0,No user reviews,0,0,0
873370,True,0,No user reviews,0,0,0
873380,True,0,No user reviews,0,0,0
873390,True,7,Positive,15,1,16
873400,True,0,No user reviews,0,0,0
873410,True,6,Mostly Positive,11,3,14
873470,True,0,2 user reviews,2,0,2
873480,True,0,No user reviews,0,0,0
873490,True,0,1 user reviews,1,0,1
873500,True,0,3 user reviews,2,1,3
873530,True,0,No user reviews,0,0,0
873540,True,0,No user reviews,0,0,0
873541,True,0,No user reviews,0,0,0
873560,True,7,Positive,14,1,15
873570,True,0,No user reviews,0,0,0
873580,True,0,No user reviews,0,0,0
873590,True,0,2 user reviews,1,1,2
873600,True,0,No user reviews,0,0,0
873610,True,6,Mostly Positive,22,6,28
873630,True,0,No user reviews,0,0,0
873640,True,0,No user reviews,0,0,0
873650,True,0,No user reviews,0,0,0
873660,True,0,No user reviews,0,0,0
873670,True,0,No user reviews,0,0,0
873680,True,0,No user reviews,0,0,0
873690,True,0,No user reviews,0,0,0
873710,True,0,2 user reviews,0,2,2
873720,True,0,No user reviews,0,0,0
873730,True,0,No user reviews,0,0,0
873740,True,0,1 user reviews,0,1,1
873780,True,0,3 user reviews,3,0,3
873790,True,0,9 user reviews,7,2,9
873810,True,0,No user reviews,0,0,0
873820,True,0,No user reviews,0,0,0
873830,True,0,1 user reviews,1,0,1
873840,True,5,Mixed,99,45,144
873850,True,0,4 user reviews,0,4,4
873860,True,0,1 user reviews,0,1,1
873870,True,7,Positive,10,2,12
873871,True,6,Mostly Positive,7,3,10
873880,True,7,Positive,28,6,34
873890,True,8,Very Positive,76,5,81
873900,True,0,9 user reviews,7,2,9
873910,True,0,No user reviews,0,0,0
873920,True,0,No user reviews,0,0,0
873930,True,7,Positive,11,2,13
873940,True,8,Very Positive,897,144,1041
873960,True,0,No user reviews,0,0,0
873970,True,5,Mixed,7,5,12
873980,True,5,Mixed,30,17,47
874010,True,6,Mostly Positive,12,4,16
874020,True,0,5 user reviews,2,3,5
874030,True,0,No user reviews,0,0,0
874040,True,6,Mostly Positive,44,13,57
874060,True,0,3 user reviews,3,0,3
874070,True,0,No user reviews,0,0,0
874080,True,0,1 user reviews,1,0,1
874090,True,0,2 user reviews,2,0,2
874110,True,0,No user reviews,0,0,0
874121,True,0,No user reviews,0,0,0
874130,True,0,1 user reviews,1,0,1
874140,True,0,3 user reviews,1,2,3
874150,True,0,No user reviews,0,0,0
874151,True,0,No user reviews,0,0,0
874152,True,0,No user reviews,0,0,0
874153,True,0,No user reviews,0,0,0
874160,True,0,No user reviews,0,0,0
874180,True,0,No user reviews,0,0,0
874200,True,0,2 user reviews,2,0,2
874230,True,5,Mixed,11,5,16
874240,True,0,4 user reviews,1,3,4
874250,True,0,2 user reviews,2,0,2
874260,True,0,No user reviews,0,0,0
874270,True,5,Mixed,7,4,11
874300,True,0,No user reviews,0,0,0
874310,True,4,Mostly Negative,222,468,690
874320,True,0,No user reviews,0,0,0
874330,True,0,2 user reviews,0,2,2
874340,True,5,Mixed,20,10,30
874341,True,5,Mixed,17,25,42
874342,True,7,Positive,26,2,28
874343,True,4,Mostly Negative,7,18,25
874344,True,8,Very Positive,82,12,94
874345,True,5,Mixed,21,26,47
874360,True,5,Mixed,46,47,93
874370,True,0,8 user reviews,5,3,8
874380,True,4,Mostly Negative,4,8,12
874390,True,8,Very Positive,479,16,495
874400,True,0,No user reviews,0,0,0
874410,True,0,No user reviews,0,0,0
874420,True,0,No user reviews,0,0,0
874421,True,0,No user reviews,0,0,0
874430,True,0,No user reviews,0,0,0
874431,True,0,No user reviews,0,0,0
874440,True,0,No user reviews,0,0,0
874450,True,0,No user reviews,0,0,0
874460,True,6,Mostly Positive,32,13,45
874470,True,0,No user reviews,0,0,0
874480,True,0,No user reviews,0,0,0
874520,True,0,No user reviews,0,0,0
874580,True,0,No user reviews,0,0,0
874620,True,0,No user reviews,0,0,0
874630,True,0,No user reviews,0,0,0
874640,True,0,5 user reviews,1,4,5
874650,True,0,No user reviews,0,0,0
874661,True,7,Positive,39,8,47
874680,True,0,No user reviews,0,0,0
874690,True,0,2 user reviews,2,0,2
874700,True,0,3 user reviews,3,0,3
874710,True,0,2 user reviews,2,0,2
874720,True,0,3 user reviews,2,1,3
874730,True,0,1 user reviews,1,0,1
874740,True,0,5 user reviews,5,0,5
874750,True,0,2 user reviews,1,1,2
874760,True,0,No user reviews,0,0,0
874770,True,0,5 user reviews,5,0,5
874780,True,0,2 user reviews,1,1,2
874800,True,0,6 user reviews,5,1,6
874810,True,0,1 user reviews,1,0,1
874830,True,0,7 user reviews,0,7,7
874840,True,0,No user reviews,0,0,0
874850,True,0,No user reviews,0,0,0
874860,True,0,No user reviews,0,0,0
874880,True,0,No user reviews,0,0,0
874890,True,0,2 user reviews,2,0,2
874891,True,0,No user reviews,0,0,0
874892,True,0,No user reviews,0,0,0
874893,True,0,3 user reviews,3,0,3
874920,True,0,No user reviews,0,0,0
874930,True,0,No user reviews,0,0,0
874940,True,0,2 user reviews,1,1,2
874960,True,0,1 user reviews,1,0,1
874970,True,0,1 user reviews,0,1,1
874980,True,0,No user reviews,0,0,0
875000,True,0,No user reviews,0,0,0
875010,True,0,1 user reviews,0,1,1
875030,True,0,No user reviews,0,0,0
875040,True,0,No user reviews,0,0,0
875050,True,0,No user reviews,0,0,0
875060,True,0,No user reviews,0,0,0
875070,True,0,1 user reviews,1,0,1
875080,True,0,5 user reviews,5,0,5
875090,True,0,1 user reviews,1,0,1
875100,True,0,No user reviews,0,0,0
875110,True,7,Positive,12,2,14
875120,True,0,No user reviews,0,0,0
875150,True,0,3 user reviews,2,1,3
875151,True,0,2 user reviews,2,0,2
875152,True,0,2 user reviews,2,0,2
875153,True,0,No user reviews,0,0,0
875160,True,0,6 user reviews,5,1,6
875190,True,0,No user reviews,0,0,0
875200,True,0,No user reviews,0,0,0
875210,True,0,No user reviews,0,0,0
875220,True,0,No user reviews,0,0,0
875230,True,0,No user reviews,0,0,0
875240,True,6,Mostly Positive,44,13,57
875250,True,0,1 user reviews,1,0,1
875260,True,0,9 user reviews,1,8,9
875270,True,0,4 user reviews,3,1,4
875290,True,0,No user reviews,0,0,0
875300,True,0,No user reviews,0,0,0
875310,True,5,Mixed,22,12,34
875320,True,0,No user reviews,0,0,0
875330,True,0,No user reviews,0,0,0
875340,True,0,No user reviews,0,0,0
875360,True,0,2 user reviews,0,2,2
875370,True,0,No user reviews,0,0,0
875371,True,0,1 user reviews,1,0,1
875400,True,0,No user reviews,0,0,0
875410,True,0,No user reviews,0,0,0
875430,True,5,Mixed,11,7,18
875440,True,0,5 user reviews,2,3,5
875460,True,7,Positive,11,2,13
875480,True,0,No user reviews,0,0,0
875500,True,0,1 user reviews,0,1,1
875510,True,0,4 user reviews,3,1,4
875520,True,0,No user reviews,0,0,0
875530,True,0,No user reviews,0,0,0
875540,True,0,9 user reviews,5,4,9
875550,True,0,3 user reviews,0,3,3
875560,True,0,No user reviews,0,0,0
875610,True,0,No user reviews,0,0,0
875620,True,0,4 user reviews,4,0,4
875621,True,0,1 user reviews,1,0,1
875630,True,0,No user reviews,0,0,0
875640,True,0,No user reviews,0,0,0
875650,True,0,No user reviews,0,0,0
875660,True,0,3 user reviews,3,0,3
875670,True,0,1 user reviews,0,1,1
875680,True,0,No user reviews,0,0,0
875710,True,0,No user reviews,0,0,0
875740,True,0,No user reviews,0,0,0
875750,True,0,No user reviews,0,0,0
875760,True,6,Mostly Positive,70,22,92
875780,True,0,2 user reviews,1,1,2
875790,True,0,No user reviews,0,0,0
875800,True,6,Mostly Positive,49,14,63
875810,True,0,1 user reviews,1,0,1
875830,True,7,Positive,18,3,21
875840,True,0,No user reviews,0,0,0
875850,True,0,1 user reviews,1,0,1
875860,True,0,No user reviews,0,0,0
875890,True,0,7 user reviews,6,1,7
875930,True,0,6 user reviews,5,1,6
875950,True,2,Very Negative,7,81,88
875960,True,2,Very Negative,5,62,67
875980,True,0,No user reviews,0,0,0
875990,True,0,No user reviews,0,0,0
876000,True,0,No user reviews,0,0,0
876100,True,0,No user reviews,0,0,0
876110,True,0,No user reviews,0,0,0
876130,True,0,2 user reviews,2,0,2
876140,True,0,4 user reviews,1,3,4
876150,True,0,No user reviews,0,0,0
876160,True,0,No user reviews,0,0,0
876170,True,0,No user reviews,0,0,0
876180,True,0,3 user reviews,3,0,3
876190,True,5,Mixed,15,7,22
876200,True,0,4 user reviews,3,1,4
876210,True,0,2 user reviews,1,1,2
876220,True,0,8 user reviews,7,1,8
876240,True,0,No user reviews,0,0,0
876260,True,0,2 user reviews,2,0,2
876270,True,0,1 user reviews,1,0,1
876290,True,0,2 user reviews,1,1,2
876300,True,0,4 user reviews,4,0,4
876310,True,0,5 user reviews,5,0,5
876320,True,7,Positive,23,2,25
876330,True,0,No user reviews,0,0,0
876340,True,0,No user reviews,0,0,0
876360,True,7,Positive,11,0,11
876380,True,0,2 user reviews,2,0,2
876400,True,0,No user reviews,0,0,0
876401,True,0,No user reviews,0,0,0
876410,True,0,1 user reviews,0,1,1
876420,True,0,No user reviews,0,0,0
876430,True,0,No user reviews,0,0,0
876440,True,0,No user reviews,0,0,0
876450,True,0,5 user reviews,3,2,5
876470,True,0,No user reviews,0,0,0
876480,True,0,3 user reviews,3,0,3
876490,True,0,No user reviews,0,0,0
876500,True,0,9 user reviews,8,1,9
876510,True,0,No user reviews,0,0,0
876520,True,0,No user reviews,0,0,0
876540,True,0,2 user reviews,1,1,2
876550,True,0,1 user reviews,1,0,1
876570,True,0,No user reviews,0,0,0
876580,True,0,No user reviews,0,0,0
876590,True,0,No user reviews,0,0,0
876610,True,0,No user reviews,0,0,0
876640,True,0,No user reviews,0,0,0
876650,True,8,Very Positive,393,27,420
876660,True,0,No user reviews,0,0,0
876680,True,0,No user reviews,0,0,0
876681,True,0,No user reviews,0,0,0
876682,True,0,No user reviews,0,0,0
876683,True,0,No user reviews,0,0,0
876690,True,0,No user reviews,0,0,0
876691,True,0,No user reviews,0,0,0
876692,True,0,No user reviews,0,0,0
876693,True,0,No user reviews,0,0,0
876694,True,0,No user reviews,0,0,0
876700,True,0,No user reviews,0,0,0
876701,True,0,No user reviews,0,0,0
876710,True,0,No user reviews,0,0,0
876720,True,0,No user reviews,0,0,0
876721,True,0,No user reviews,0,0,0
876722,True,0,No user reviews,0,0,0
876723,True,0,No user reviews,0,0,0
876730,True,0,No user reviews,0,0,0
876731,True,0,No user reviews,0,0,0
876732,True,0,No user reviews,0,0,0
876733,True,0,No user reviews,0,0,0
876734,True,0,No user reviews,0,0,0
876735,True,0,No user reviews,0,0,0
876740,True,0,No user reviews,0,0,0
876760,True,0,No user reviews,0,0,0
876780,True,0,4 user reviews,3,1,4
876810,True,0,No user reviews,0,0,0
876840,True,0,2 user reviews,1,1,2
876850,True,0,4 user reviews,4,0,4
876860,True,0,1 user reviews,0,1,1
876870,True,0,2 user reviews,1,1,2
876880,True,0,7 user reviews,3,4,7
876890,True,0,No user reviews,0,0,0
876900,True,0,No user reviews,0,0,0
876910,True,0,2 user reviews,1,1,2
876920,True,0,No user reviews,0,0,0
876930,True,0,5 user reviews,3,2,5
876960,True,0,No user reviews,0,0,0
876970,True,0,No user reviews,0,0,0
876971,True,0,No user reviews,0,0,0
876980,True,7,Positive,16,0,16
877040,True,0,2 user reviews,1,1,2
877060,True,0,2 user reviews,2,0,2
877070,True,0,No user reviews,0,0,0
877080,True,5,Mixed,39,19,58
877090,True,0,No user reviews,0,0,0
877100,True,0,No user reviews,0,0,0
877110,True,0,No user reviews,0,0,0
877120,True,0,No user reviews,0,0,0
877130,True,0,No user reviews,0,0,0
877150,True,0,2 user reviews,1,1,2
877160,True,0,No user reviews,0,0,0
877180,True,0,No user reviews,0,0,0
877190,True,0,7 user reviews,3,4,7
877200,True,8,Very Positive,1310,269,1579
877210,True,0,No user reviews,0,0,0
877230,True,0,9 user reviews,5,4,9
877240,True,0,No user reviews,0,0,0
877250,True,0,3 user reviews,2,1,3
877260,True,0,7 user reviews,3,4,7
877270,True,0,3 user reviews,2,1,3
877300,True,0,No user reviews,0,0,0
877310,True,0,1 user reviews,1,0,1
877330,True,0,4 user reviews,3,1,4
877340,True,0,No user reviews,0,0,0
877360,True,5,Mixed,39,17,56
877380,True,0,5 user reviews,4,1,5
877400,True,0,No user reviews,0,0,0
877420,True,0,No user reviews,0,0,0
877440,True,0,7 user reviews,7,0,7
877450,True,0,No user reviews,0,0,0
877460,True,0,No user reviews,0,0,0
877470,True,0,2 user reviews,1,1,2
877480,True,0,5 user reviews,5,0,5
877490,True,0,No user reviews,0,0,0
877500,True,0,No user reviews,0,0,0
877510,True,0,7 user reviews,4,3,7
877520,True,0,No user reviews,0,0,0
877530,True,0,No user reviews,0,0,0
877550,True,7,Positive,9,1,10
877570,True,0,2 user reviews,2,0,2
877580,True,0,No user reviews,0,0,0
877590,True,0,2 user reviews,0,2,2
877600,True,0,No user reviews,0,0,0
877610,True,0,No user reviews,0,0,0
877620,True,0,6 user reviews,6,0,6
877680,True,0,4 user reviews,2,2,4
877700,True,0,No user reviews,0,0,0
877710,True,0,1 user reviews,1,0,1
877730,True,0,6 user reviews,3,3,6
877740,True,0,No user reviews,0,0,0
877750,True,0,No user reviews,0,0,0
877770,True,0,No user reviews,0,0,0
877780,True,0,7 user reviews,5,2,7
877800,True,0,2 user reviews,2,0,2
877810,True,8,Very Positive,242,18,260
877840,True,7,Positive,23,5,28
877850,True,7,Positive,38,4,42
877870,True,0,1 user reviews,1,0,1
877910,True,0,No user reviews,0,0,0
877940,True,0,6 user reviews,6,0,6
877950,True,0,No user reviews,0,0,0
877960,True,0,1 user reviews,0,1,1
877980,True,0,1 user reviews,0,1,1
878020,True,7,Positive,26,4,30
878030,True,0,1 user reviews,1,0,1
878040,True,0,No user reviews,0,0,0
878060,True,0,No user reviews,0,0,0
878070,True,0,No user reviews,0,0,0
878080,True,5,Mixed,6,4,10
878090,True,7,Positive,12,1,13
878100,True,0,No user reviews,0,0,0
878110,True,0,No user reviews,0,0,0
878120,True,0,2 user reviews,1,1,2
878130,True,0,No user reviews,0,0,0
878140,True,0,1 user reviews,0,1,1
878150,True,0,5 user reviews,5,0,5
878160,True,0,8 user reviews,1,7,8
878170,True,6,Mostly Positive,10,4,14
878180,True,6,Mostly Positive,7,3,10
878200,True,0,No user reviews,0,0,0
878220,True,0,No user reviews,0,0,0
878230,True,0,No user reviews,0,0,0
878240,True,0,No user reviews,0,0,0
878250,True,7,Positive,14,0,14
878260,True,0,No user reviews,0,0,0
878270,True,0,5 user reviews,2,3,5
878280,True,0,No user reviews,0,0,0
878290,True,7,Positive,13,2,15
878300,True,0,2 user reviews,1,1,2
878310,True,0,No user reviews,0,0,0
878320,True,0,No user reviews,0,0,0
878330,True,0,7 user reviews,6,1,7
878340,True,0,1 user reviews,1,0,1
878350,True,5,Mixed,9,4,13
878380,True,8,Very Positive,46,8,54
878400,True,0,1 user reviews,0,1,1
878410,True,0,No user reviews,0,0,0
878420,True,7,Positive,35,8,43
878440,True,0,No user reviews,0,0,0
878460,True,7,Positive,19,2,21
878461,True,7,Positive,29,5,34
878462,True,7,Positive,16,3,19
878463,True,7,Positive,37,1,38
878464,True,7,Positive,17,2,19
878465,True,8,Very Positive,49,4,53
878467,True,8,Very Positive,88,12,100
878470,True,0,1 user reviews,0,1,1
878500,True,0,No user reviews,0,0,0
878510,True,0,1 user reviews,1,0,1
878520,True,5,Mixed,12,9,21
878530,True,0,No user reviews,0,0,0
878540,True,0,1 user reviews,0,1,1
878570,True,0,2 user reviews,0,2,2
878580,True,6,Mostly Positive,49,14,63
878590,True,0,No user reviews,0,0,0
878600,True,0,No user reviews,0,0,0
878610,True,0,No user reviews,0,0,0
878620,True,0,1 user reviews,1,0,1
878630,True,0,1 user reviews,0,1,1
878640,True,0,7 user reviews,5,2,7
878660,True,0,4 user reviews,2,2,4
878670,True,0,No user reviews,0,0,0
878680,True,7,Positive,22,2,24
878690,True,0,No user reviews,0,0,0
878710,True,0,8 user reviews,4,4,8
878750,True,8,Very Positive,1530,124,1654
878760,True,0,No user reviews,0,0,0
878770,True,0,4 user reviews,3,1,4
878780,True,0,9 user reviews,8,1,9
878810,True,0,3 user reviews,0,3,3
878820,True,0,1 user reviews,0,1,1
878830,True,0,No user reviews,0,0,0
878840,True,0,No user reviews,0,0,0
878880,True,0,No user reviews,0,0,0
878890,True,0,2 user reviews,1,1,2
878910,True,0,1 user reviews,1,0,1
878920,True,7,Positive,25,0,25
878940,True,0,No user reviews,0,0,0
878950,True,7,Positive,13,2,15
878960,True,0,No user reviews,0,0,0
878970,True,0,No user reviews,0,0,0
878980,True,0,2 user reviews,2,0,2
878990,True,0,No user reviews,0,0,0
879000,True,6,Mostly Positive,60,24,84
879030,True,0,No user reviews,0,0,0
879050,True,0,No user reviews,0,0,0
879060,True,0,5 user reviews,3,2,5
879080,True,0,No user reviews,0,0,0
879090,True,0,2 user reviews,1,1,2
879100,True,0,1 user reviews,1,0,1
879110,True,0,1 user reviews,1,0,1
879120,True,0,4 user reviews,2,2,4
879160,True,5,Mixed,974,498,1472
879180,True,0,No user reviews,0,0,0
879190,True,0,No user reviews,0,0,0
879200,True,0,3 user reviews,2,1,3
879240,True,5,Mixed,17,18,35
879250,True,0,No user reviews,0,0,0
879260,True,0,2 user reviews,2,0,2
879270,True,0,3 user reviews,3,0,3
879280,True,0,2 user reviews,1,1,2
879290,True,7,Positive,11,0,11
879300,True,0,No user reviews,0,0,0
879310,True,0,8 user reviews,4,4,8
879320,True,0,No user reviews,0,0,0
879330,True,0,No user reviews,0,0,0
879380,True,0,No user reviews,0,0,0
879390,True,0,No user reviews,0,0,0
879410,True,0,No user reviews,0,0,0
879420,True,5,Mixed,613,288,901
879430,True,0,3 user reviews,3,0,3
879450,True,0,No user reviews,0,0,0
879460,True,0,No user reviews,0,0,0
879470,True,5,Mixed,23,12,35
879480,True,0,No user reviews,0,0,0
879490,True,0,No user reviews,0,0,0
879500,True,0,No user reviews,0,0,0
879510,True,8,Very Positive,174,9,183
879520,True,0,4 user reviews,4,0,4
879530,True,0,No user reviews,0,0,0
879550,True,0,No user reviews,0,0,0
879580,True,0,No user reviews,0,0,0
879600,True,0,5 user reviews,5,0,5
879610,True,5,Mixed,5,5,10
879620,True,0,7 user reviews,2,5,7
879650,True,0,No user reviews,0,0,0
879660,True,0,2 user reviews,2,0,2
879670,True,5,Mixed,18,27,45
879720,True,0,No user reviews,0,0,0
879730,True,0,No user reviews,0,0,0
879731,True,0,No user reviews,0,0,0
879732,True,0,1 user reviews,1,0,1
879733,True,0,2 user reviews,2,0,2
879740,True,0,9 user reviews,8,1,9
879760,True,0,No user reviews,0,0,0
879780,True,0,No user reviews,0,0,0
879790,True,0,No user reviews,0,0,0
879800,True,0,No user reviews,0,0,0
879810,True,0,No user reviews,0,0,0
879811,True,0,No user reviews,0,0,0
879812,True,0,No user reviews,0,0,0
879813,True,0,No user reviews,0,0,0
879814,True,0,No user reviews,0,0,0
879815,True,0,No user reviews,0,0,0
879816,True,0,No user reviews,0,0,0
879817,True,0,No user reviews,0,0,0
879818,True,0,No user reviews,0,0,0
879819,True,0,No user reviews,0,0,0
879820,True,0,No user reviews,0,0,0
879821,True,0,No user reviews,0,0,0
879830,True,0,No user reviews,0,0,0
879831,True,0,No user reviews,0,0,0
879832,True,0,No user reviews,0,0,0
879833,True,0,No user reviews,0,0,0
879834,True,0,No user reviews,0,0,0
879835,True,0,No user reviews,0,0,0
879836,True,0,No user reviews,0,0,0
879837,True,0,No user reviews,0,0,0
879838,True,0,No user reviews,0,0,0
879839,True,0,No user reviews,0,0,0
879840,True,0,No user reviews,0,0,0
879841,True,0,No user reviews,0,0,0
879850,True,0,No user reviews,0,0,0
879860,True,0,No user reviews,0,0,0
879870,True,0,No user reviews,0,0,0
879920,True,0,No user reviews,0,0,0
879930,True,0,No user reviews,0,0,0
880130,True,7,Positive,36,1,37
880170,True,0,No user reviews,0,0,0
880180,True,0,No user reviews,0,0,0
880200,True,0,6 user reviews,2,4,6
880210,True,0,No user reviews,0,0,0
880220,True,0,2 user reviews,1,1,2
880240,True,0,1 user reviews,1,0,1
880250,True,0,3 user reviews,3,0,3
880270,True,0,No user reviews,0,0,0
880281,True,7,Positive,29,0,29
880282,True,0,6 user reviews,6,0,6
880283,True,0,No user reviews,0,0,0
880290,True,0,No user reviews,0,0,0
880300,True,6,Mostly Positive,14,6,20
880310,True,0,6 user reviews,3,3,6
880320,True,0,1 user reviews,1,0,1
880330,True,0,No user reviews,0,0,0
880340,True,0,2 user reviews,2,0,2
880350,True,0,No user reviews,0,0,0
880351,True,0,No user reviews,0,0,0
880370,True,0,4 user reviews,3,1,4
880380,True,5,Mixed,60,51,111
880400,True,7,Positive,33,2,35
880460,True,0,No user reviews,0,0,0
880470,True,5,Mixed,8,8,16
880480,True,0,No user reviews,0,0,0
880490,True,7,Positive,34,3,37
880510,True,8,Very Positive,246,35,281
880520,True,7,Positive,10,2,12
880521,True,6,Mostly Positive,16,5,21
880540,True,0,No user reviews,0,0,0
880550,True,0,5 user reviews,4,1,5
880570,True,0,3 user reviews,3,0,3
880580,True,8,Very Positive,58,9,67
880590,True,0,No user reviews,0,0,0
880610,True,7,Positive,26,1,27
880620,True,0,3 user reviews,0,3,3
880630,True,0,No user reviews,0,0,0
880640,True,6,Mostly Positive,206,71,277
880670,True,0,No user reviews,0,0,0
880680,True,0,No user reviews,0,0,0
880700,True,0,No user reviews,0,0,0
880710,True,0,No user reviews,0,0,0
880720,True,0,5 user reviews,5,0,5
880730,True,0,No user reviews,0,0,0
880740,True,0,2 user reviews,2,0,2
880750,True,5,Mixed,10,12,22
880760,True,0,No user reviews,0,0,0
880770,True,0,No user reviews,0,0,0
880780,True,0,6 user reviews,5,1,6
880790,True,0,No user reviews,0,0,0
880800,True,0,5 user reviews,3,2,5
880830,True,7,Positive,12,1,13
880840,True,0,No user reviews,0,0,0
880850,True,0,No user reviews,0,0,0
880860,True,0,9 user reviews,6,3,9
880880,True,0,No user reviews,0,0,0
880910,True,0,No user reviews,0,0,0
880923,True,0,1 user reviews,0,1,1
880924,True,0,1 user reviews,1,0,1
880940,True,8,Very Positive,5406,559,5965
880950,True,7,Positive,20,1,21
880990,True,0,5 user reviews,0,5,5
881000,True,0,No user reviews,0,0,0
881030,True,0,No user reviews,0,0,0
881040,True,7,Positive,15,0,15
881050,True,0,1 user reviews,0,1,1
881060,True,0,2 user reviews,2,0,2
881070,True,0,No user reviews,0,0,0
881080,True,0,3 user reviews,1,2,3
881090,True,0,1 user reviews,1,0,1
881100,True,9,Overwhelmingly Positive,10346,441,10787
881110,True,0,5 user reviews,4,1,5
881130,True,7,Positive,24,0,24
881150,True,0,No user reviews,0,0,0
881170,True,0,4 user reviews,2,2,4
881190,True,0,1 user reviews,1,0,1
881210,True,0,No user reviews,0,0,0
881220,True,0,No user reviews,0,0,0
881230,True,0,No user reviews,0,0,0
881260,True,0,3 user reviews,3,0,3
881290,True,0,No user reviews,0,0,0
881300,True,0,No user reviews,0,0,0
881310,True,0,3 user reviews,2,1,3
881320,True,5,Mixed,86,42,128
881330,True,0,2 user reviews,2,0,2
881340,True,0,No user reviews,0,0,0
881390,True,0,4 user reviews,3,1,4
881420,True,8,Very Positive,179,35,214
881430,True,0,No user reviews,0,0,0
881470,True,0,2 user reviews,2,0,2
881480,True,7,Positive,11,1,12
881490,True,0,No user reviews,0,0,0
881500,True,5,Mixed,7,4,11
881510,True,0,4 user reviews,2,2,4
881520,True,0,7 user reviews,4,3,7
881530,True,0,No user reviews,0,0,0
881550,True,0,No user reviews,0,0,0
881560,True,8,Very Positive,181,29,210
881590,True,0,No user reviews,0,0,0
881591,True,0,No user reviews,0,0,0
881600,True,0,No user reviews,0,0,0
881610,True,0,7 user reviews,1,6,7
881620,True,0,1 user reviews,1,0,1
881660,True,0,1 user reviews,1,0,1
881670,True,0,3 user reviews,2,1,3
881680,True,6,Mostly Positive,30,10,40
881690,True,6,Mostly Positive,118,45,163
881710,True,0,No user reviews,0,0,0
881730,True,0,3 user reviews,2,1,3
881750,True,5,Mixed,9,4,13
881800,True,0,No user reviews,0,0,0
881810,True,0,No user reviews,0,0,0
881820,True,0,No user reviews,0,0,0
881830,True,0,No user reviews,0,0,0
881840,True,0,No user reviews,0,0,0
881841,True,0,No user reviews,0,0,0
881880,True,0,8 user reviews,3,5,8
881900,True,0,No user reviews,0,0,0
881910,True,0,1 user reviews,0,1,1
881920,True,5,Mixed,65,28,93
881930,True,0,5 user reviews,1,4,5
881950,True,0,No user reviews,0,0,0
881960,True,0,1 user reviews,1,0,1
881970,True,0,No user reviews,0,0,0
881980,True,0,No user reviews,0,0,0
881990,True,0,No user reviews,0,0,0
882020,True,6,Mostly Positive,167,45,212
882030,True,0,No user reviews,0,0,0
882040,True,7,Positive,17,3,20
882070,True,0,6 user reviews,4,2,6
882080,True,0,3 user reviews,2,1,3
882100,True,6,Mostly Positive,6855,2151,9006
882110,True,0,No user reviews,0,0,0
882140,True,8,Very Positive,185,7,192
882150,True,7,Positive,34,1,35
882180,True,0,No user reviews,0,0,0
882200,True,5,Mixed,5,6,11
882210,True,7,Positive,19,3,22
882220,True,0,No user reviews,0,0,0
882230,True,0,1 user reviews,1,0,1
882250,True,8,Very Positive,60,11,71
882260,True,0,No user reviews,0,0,0
882270,True,0,2 user reviews,2,0,2
882280,True,0,No user reviews,0,0,0
882290,True,0,3 user reviews,2,1,3
882300,True,0,No user reviews,0,0,0
882330,True,0,3 user reviews,1,2,3
882340,True,0,No user reviews,0,0,0
882350,True,0,No user reviews,0,0,0
882380,True,0,No user reviews,0,0,0
882390,True,0,1 user reviews,1,0,1
882400,True,0,No user reviews,0,0,0
882410,True,0,No user reviews,0,0,0
882430,True,0,No user reviews,0,0,0
882440,True,0,No user reviews,0,0,0
882450,True,0,No user reviews,0,0,0
882460,True,0,4 user reviews,1,3,4
882540,True,0,No user reviews,0,0,0
882550,True,0,No user reviews,0,0,0
882560,True,5,Mixed,28,23,51
882590,True,0,No user reviews,0,0,0
882600,True,0,1 user reviews,1,0,1
882620,True,0,4 user reviews,4,0,4
882630,True,0,1 user reviews,1,0,1
882640,True,7,Positive,17,2,19
882650,True,0,No user reviews,0,0,0
882660,True,0,No user reviews,0,0,0
882670,True,0,2 user reviews,2,0,2
882680,True,7,Positive,10,1,11
882700,True,0,1 user reviews,1,0,1
882710,True,8,Very Positive,142,10,152
882720,True,0,No user reviews,0,0,0
882740,True,0,No user reviews,0,0,0
882750,True,0,1 user reviews,1,0,1
882760,True,0,2 user reviews,1,1,2
882790,True,8,Very Positive,123,5,128
882800,True,0,1 user reviews,0,1,1
882830,True,0,No user reviews,0,0,0
882840,True,0,2 user reviews,1,1,2
882860,True,0,No user reviews,0,0,0
882870,True,0,No user reviews,0,0,0
882890,True,0,No user reviews,0,0,0
882900,True,0,9 user reviews,8,1,9
882910,True,0,6 user reviews,0,6,6
882940,True,6,Mostly Positive,8,3,11
882960,True,5,Mixed,10,6,16
882990,True,0,No user reviews,0,0,0
883000,True,0,5 user reviews,2,3,5
883020,True,7,Positive,10,1,11
883060,True,0,No user reviews,0,0,0
883061,True,0,No user reviews,0,0,0
883062,True,0,No user reviews,0,0,0
883070,True,7,Positive,40,9,49
883080,True,7,Positive,36,9,45
883100,True,8,Very Positive,210,22,232
883110,True,0,No user reviews,0,0,0
883120,True,0,No user reviews,0,0,0
883130,True,8,Very Positive,111,17,128
883140,True,5,Mixed,41,20,61
883150,True,5,Mixed,224,149,373
883160,True,0,No user reviews,0,0,0
883170,True,0,6 user reviews,2,4,6
883180,True,0,No user reviews,0,0,0
883181,True,0,No user reviews,0,0,0
883182,True,0,No user reviews,0,0,0
883190,True,0,3 user reviews,3,0,3
883200,True,0,1 user reviews,1,0,1
883210,True,0,No user reviews,0,0,0
883220,True,5,Mixed,49,25,74
883240,True,0,No user reviews,0,0,0
883250,True,0,No user reviews,0,0,0
883270,True,0,No user reviews,0,0,0
883280,True,0,No user reviews,0,0,0
883290,True,0,No user reviews,0,0,0
883300,True,0,6 user reviews,4,2,6
883310,True,0,4 user reviews,3,1,4
883320,True,0,No user reviews,0,0,0
883330,True,0,5 user reviews,3,2,5
883340,True,0,No user reviews,0,0,0
883360,True,8,Very Positive,175,38,213
883390,True,0,3 user reviews,2,1,3
883400,True,0,No user reviews,0,0,0
883430,True,0,No user reviews,0,0,0
883440,True,0,No user reviews,0,0,0
883450,True,0,No user reviews,0,0,0
883460,True,0,No user reviews,0,0,0
883470,True,0,No user reviews,0,0,0
883480,True,0,No user reviews,0,0,0
883490,True,0,No user reviews,0,0,0
883510,True,0,No user reviews,0,0,0
883520,True,0,No user reviews,0,0,0
883530,True,0,No user reviews,0,0,0
883540,True,0,No user reviews,0,0,0
883550,True,0,No user reviews,0,0,0
883560,True,0,4 user reviews,4,0,4
883570,True,0,No user reviews,0,0,0
883590,True,0,No user reviews,0,0,0
883620,True,0,No user reviews,0,0,0
883630,True,0,2 user reviews,2,0,2
883640,True,0,No user reviews,0,0,0
883670,True,5,Mixed,14,10,24
883680,True,0,1 user reviews,1,0,1
883700,True,0,No user reviews,0,0,0
883710,True,9,Overwhelmingly Positive,19091,514,19605
883750,True,0,No user reviews,0,0,0
883780,True,0,No user reviews,0,0,0
883790,True,0,3 user reviews,2,1,3
883800,True,0,1 user reviews,1,0,1
883810,True,0,1 user reviews,1,0,1
883820,True,0,No user reviews,0,0,0
883830,True,0,4 user reviews,3,1,4
883840,True,0,No user reviews,0,0,0
883850,True,0,No user reviews,0,0,0
883860,True,0,No user reviews,0,0,0
883870,True,0,No user reviews,0,0,0
883880,True,0,No user reviews,0,0,0
883900,True,0,No user reviews,0,0,0
883930,True,0,2 user reviews,1,1,2
883960,True,0,1 user reviews,0,1,1
883970,True,0,6 user reviews,0,6,6
884000,True,0,8 user reviews,2,6,8
884010,True,0,No user reviews,0,0,0
884020,True,0,No user reviews,0,0,0
884030,True,0,1 user reviews,1,0,1
884031,True,0,No user reviews,0,0,0
884070,True,0,No user reviews,0,0,0
884080,True,0,1 user reviews,1,0,1
884090,True,0,No user reviews,0,0,0
884110,True,0,No user reviews,0,0,0
884140,True,7,Positive,16,1,17
884141,True,6,Mostly Positive,33,11,44
884142,True,7,Positive,11,1,12
884143,True,6,Mostly Positive,16,5,21
884160,True,0,No user reviews,0,0,0
884180,True,0,No user reviews,0,0,0
884200,True,5,Mixed,26,15,41
884240,True,0,No user reviews,0,0,0
884260,True,9,Overwhelmingly Positive,644,23,667
884270,True,0,2 user reviews,2,0,2
884290,True,0,4 user reviews,2,2,4
884320,True,5,Mixed,63,51,114
884340,True,5,Mixed,15,11,26
884350,True,0,No user reviews,0,0,0
884370,True,0,4 user reviews,3,1,4
884390,True,0,5 user reviews,1,4,5
884400,True,7,Positive,10,0,10
884410,True,5,Mixed,6,4,10
884420,True,7,Positive,14,1,15
884430,True,5,Mixed,5,6,11
884440,True,0,3 user reviews,1,2,3
884460,True,0,3 user reviews,2,1,3
884470,True,0,3 user reviews,3,0,3
884490,True,0,No user reviews,0,0,0
884500,True,0,2 user reviews,0,2,2
884510,True,0,No user reviews,0,0,0
884530,True,0,6 user reviews,0,6,6
884540,True,0,No user reviews,0,0,0
884550,True,0,No user reviews,0,0,0
884560,True,0,No user reviews,0,0,0
884580,True,0,No user reviews,0,0,0
884590,True,0,3 user reviews,0,3,3
884610,True,0,No user reviews,0,0,0
884620,True,5,Mixed,47,53,100
884630,True,0,2 user reviews,2,0,2
884640,True,5,Mixed,11,11,22
884650,True,0,No user reviews,0,0,0
884660,True,0,2 user reviews,2,0,2
884700,True,0,No user reviews,0,0,0
884710,True,0,1 user reviews,1,0,1
884730,True,0,No user reviews,0,0,0
884760,True,0,3 user reviews,3,0,3
884761,True,0,2 user reviews,2,0,2
884762,True,0,2 user reviews,2,0,2
884770,True,0,4 user reviews,2,2,4
884780,True,0,No user reviews,0,0,0
884790,True,0,1 user reviews,1,0,1
884791,True,0,No user reviews,0,0,0
884830,True,0,No user reviews,0,0,0
884860,True,0,2 user reviews,2,0,2
884870,True,0,3 user reviews,2,1,3
884880,True,0,6 user reviews,5,1,6
884890,True,0,No user reviews,0,0,0
884900,True,0,1 user reviews,0,1,1
884910,True,0,No user reviews,0,0,0
884920,True,0,No user reviews,0,0,0
884960,True,7,Positive,20,2,22
884970,True,0,No user reviews,0,0,0
884980,True,7,Positive,16,0,16
884990,True,6,Mostly Positive,38,10,48
885000,True,8,Very Positive,267,19,286
885030,True,0,No user reviews,0,0,0
885070,True,0,No user reviews,0,0,0
885071,True,0,No user reviews,0,0,0
885080,True,0,No user reviews,0,0,0
885090,True,0,9 user reviews,1,8,9
885100,True,4,Mostly Negative,7,14,21
885110,True,4,Mostly Negative,4,7,11
885120,True,7,Positive,41,5,46
885130,True,0,No user reviews,0,0,0
885140,True,0,3 user reviews,1,2,3
885150,True,8,Very Positive,140,19,159
885170,True,0,2 user reviews,0,2,2
885180,True,0,4 user reviews,1,3,4
885190,True,5,Mixed,9,6,15
885210,True,0,No user reviews,0,0,0
885220,True,0,1 user reviews,1,0,1
885240,True,0,3 user reviews,2,1,3
885250,True,0,1 user reviews,1,0,1
885260,True,0,2 user reviews,2,0,2
885270,True,5,Mixed,25,14,39
885290,True,0,4 user reviews,3,1,4
885300,True,0,No user reviews,0,0,0
885320,True,0,5 user reviews,1,4,5
885380,True,5,Mixed,7,7,14
885390,True,4,Mostly Negative,6,12,18
885410,True,0,No user reviews,0,0,0
885430,True,0,1 user reviews,1,0,1
885440,True,6,Mostly Positive,31,10,41
885450,True,0,No user reviews,0,0,0
885460,True,0,No user reviews,0,0,0
885470,True,0,No user reviews,0,0,0
885480,True,0,No user reviews,0,0,0
885490,True,0,No user reviews,0,0,0
885520,True,0,No user reviews,0,0,0
885540,True,0,No user reviews,0,0,0
885550,True,7,Positive,29,4,33
885570,True,0,3 user reviews,2,1,3
885590,True,0,No user reviews,0,0,0
885630,True,6,Mostly Positive,7,3,10
885640,True,0,No user reviews,0,0,0
885650,True,0,No user reviews,0,0,0
885660,True,0,2 user reviews,1,1,2
885690,True,0,No user reviews,0,0,0
885700,True,0,No user reviews,0,0,0
885701,True,0,No user reviews,0,0,0
885720,True,0,No user reviews,0,0,0
885730,True,0,No user reviews,0,0,0
885780,True,7,Positive,21,5,26
885790,True,0,4 user reviews,3,1,4
885810,True,8,Very Positive,201,5,206
885850,True,0,No user reviews,0,0,0
885851,True,0,No user reviews,0,0,0
885860,True,0,No user reviews,0,0,0
885890,True,0,No user reviews,0,0,0
885910,True,7,Positive,11,0,11
885920,True,0,2 user reviews,2,0,2
885940,True,8,Very Positive,66,5,71
885950,True,8,Very Positive,64,2,66
885960,True,7,Positive,15,1,16
885980,True,0,No user reviews,0,0,0
886010,True,0,4 user reviews,2,2,4
886020,True,0,3 user reviews,0,3,3
886030,True,0,No user reviews,0,0,0
886040,True,6,Mostly Positive,90,25,115
886050,True,0,No user reviews,0,0,0
886060,True,0,No user reviews,0,0,0
886070,True,7,Positive,35,4,39
886110,True,7,Positive,11,1,12
886120,True,0,7 user reviews,3,4,7
886130,True,0,No user reviews,0,0,0
886140,True,0,1 user reviews,1,0,1
886150,True,0,No user reviews,0,0,0
886160,True,0,No user reviews,0,0,0
886170,True,0,No user reviews,0,0,0
886180,True,6,Mostly Positive,9,3,12
886190,True,0,No user reviews,0,0,0
886200,True,7,Positive,32,0,32
886210,True,0,No user reviews,0,0,0
886220,True,0,No user reviews,0,0,0
886230,True,0,3 user reviews,0,3,3
886250,True,0,No user reviews,0,0,0
886270,True,5,Mixed,7,5,12
886280,True,5,Mixed,5,5,10
886290,True,0,1 user reviews,1,0,1
886300,True,0,3 user reviews,3,0,3
886310,True,0,2 user reviews,0,2,2
886330,True,0,2 user reviews,1,1,2
886340,True,0,No user reviews,0,0,0
886341,True,0,No user reviews,0,0,0
886342,True,0,No user reviews,0,0,0
886343,True,0,No user reviews,0,0,0
886344,True,0,No user reviews,0,0,0
886345,True,0,No user reviews,0,0,0
886346,True,0,No user reviews,0,0,0
886350,True,0,4 user reviews,3,1,4
886360,True,7,Positive,9,1,10
886370,True,5,Mixed,14,12,26
886380,True,0,4 user reviews,4,0,4
886390,True,0,1 user reviews,1,0,1
886400,True,0,No user reviews,0,0,0
886420,True,0,1 user reviews,0,1,1
886430,True,0,No user reviews,0,0,0
886440,True,0,No user reviews,0,0,0
886450,True,0,1 user reviews,0,1,1
886460,True,0,No user reviews,0,0,0
886470,True,0,7 user reviews,7,0,7
886480,True,0,1 user reviews,1,0,1
886490,True,0,5 user reviews,2,3,5
886520,True,4,Mostly Negative,14,23,37
886530,True,0,No user reviews,0,0,0
886540,True,0,No user reviews,0,0,0
886590,True,0,4 user reviews,3,1,4
886600,True,0,4 user reviews,3,1,4
886610,True,0,2 user reviews,0,2,2
886620,True,0,No user reviews,0,0,0
886630,True,7,Positive,11,1,12
886650,True,0,No user reviews,0,0,0
886660,True,0,No user reviews,0,0,0
886661,True,0,No user reviews,0,0,0
886670,True,0,3 user reviews,3,0,3
886710,True,5,Mixed,13,18,31
886720,True,0,No user reviews,0,0,0
886730,True,5,Mixed,7,7,14
886750,True,0,No user reviews,0,0,0
886780,True,0,2 user reviews,1,1,2
886820,True,6,Mostly Positive,30,10,40
886830,True,0,1 user reviews,1,0,1
886840,True,0,No user reviews,0,0,0
886860,True,0,No user reviews,0,0,0
886890,True,0,No user reviews,0,0,0
886900,True,6,Mostly Positive,316,101,417
886910,True,0,No user reviews,0,0,0
886920,True,5,Mixed,12,7,19
886930,True,7,Positive,22,0,22
886950,True,0,6 user reviews,5,1,6
886960,True,8,Very Positive,105,25,130
886970,True,7,Positive,16,4,20
887030,True,0,3 user reviews,2,1,3
887040,True,0,No user reviews,0,0,0
887050,True,0,6 user reviews,5,1,6
887060,True,6,Mostly Positive,75,22,97
887070,True,0,No user reviews,0,0,0
887090,True,5,Mixed,18,9,27
887120,True,5,Mixed,34,15,49
887130,True,0,No user reviews,0,0,0
887160,True,0,1 user reviews,1,0,1
887170,True,0,No user reviews,0,0,0
887180,True,0,No user reviews,0,0,0
887190,True,0,No user reviews,0,0,0
887230,True,0,No user reviews,0,0,0
887280,True,0,No user reviews,0,0,0
887300,True,0,3 user reviews,3,0,3
887340,True,6,Mostly Positive,40,14,54
887350,True,0,No user reviews,0,0,0
887370,True,5,Mixed,72,32,104
887380,True,5,Mixed,467,369,836
887390,True,0,No user reviews,0,0,0
887400,True,7,Positive,14,0,14
887420,True,7,Positive,13,1,14
887430,True,0,No user reviews,0,0,0
887440,True,0,No user reviews,0,0,0
887450,True,0,No user reviews,0,0,0
887490,True,0,No user reviews,0,0,0
887510,True,7,Positive,16,0,16
887520,True,0,5 user reviews,3,2,5
887530,True,8,Very Positive,51,12,63
887550,True,7,Positive,11,1,12
887570,True,0,No user reviews,0,0,0
887580,True,0,No user reviews,0,0,0
887590,True,0,No user reviews,0,0,0
887630,True,0,No user reviews,0,0,0
887660,True,0,3 user reviews,2,1,3
887680,True,0,No user reviews,0,0,0
887690,True,0,5 user reviews,2,3,5
887700,True,0,No user reviews,0,0,0
887710,True,0,3 user reviews,2,1,3
887720,True,5,Mixed,57,44,101
887730,True,6,Mostly Positive,15,5,20
887740,True,0,No user reviews,0,0,0
887750,True,0,1 user reviews,1,0,1
887760,True,0,No user reviews,0,0,0
887780,True,6,Mostly Positive,10,4,14
887790,True,0,No user reviews,0,0,0
887800,True,5,Mixed,123,76,199
887820,True,6,Mostly Positive,14,6,20
887850,True,0,8 user reviews,7,1,8
887870,True,0,No user reviews,0,0,0
887880,True,0,No user reviews,0,0,0
887890,True,0,6 user reviews,6,0,6
887900,True,7,Positive,12,1,13
887910,True,0,2 user reviews,1,1,2
887920,True,0,No user reviews,0,0,0
887930,True,0,2 user reviews,2,0,2
887940,True,0,1 user reviews,1,0,1
887950,True,0,1 user reviews,1,0,1
887960,True,0,9 user reviews,4,5,9
887970,True,6,Mostly Positive,7,3,10
887980,True,0,No user reviews,0,0,0
888000,True,7,Positive,16,0,16
888010,True,6,Mostly Positive,15,4,19
888020,True,0,No user reviews,0,0,0
888040,True,8,Very Positive,116,11,127
888060,True,0,No user reviews,0,0,0
888070,True,0,No user reviews,0,0,0
888090,True,0,No user reviews,0,0,0
888110,True,0,No user reviews,0,0,0
888130,True,6,Mostly Positive,27,8,35
888150,True,0,No user reviews,0,0,0
888200,True,0,No user reviews,0,0,0
888210,True,0,2 user reviews,2,0,2
888220,True,0,4 user reviews,4,0,4
888240,True,0,4 user reviews,3,1,4
888250,True,0,1 user reviews,0,1,1
888260,True,8,Very Positive,95,10,105
888310,True,0,2 user reviews,2,0,2
888330,True,0,No user reviews,0,0,0
888350,True,0,No user reviews,0,0,0
888360,True,0,5 user reviews,5,0,5
888370,True,0,9 user reviews,7,2,9
888380,True,0,2 user reviews,1,1,2
888390,True,0,No user reviews,0,0,0
888400,True,0,3 user reviews,0,3,3
888430,True,0,No user reviews,0,0,0
888440,True,0,No user reviews,0,0,0
888450,True,0,No user reviews,0,0,0
888451,True,0,No user reviews,0,0,0
888452,True,0,No user reviews,0,0,0
888480,True,0,No user reviews,0,0,0
888490,True,0,No user reviews,0,0,0
888491,True,0,No user reviews,0,0,0
888492,True,0,No user reviews,0,0,0
888493,True,0,No user reviews,0,0,0
888494,True,0,No user reviews,0,0,0
888495,True,0,No user reviews,0,0,0
888496,True,0,No user reviews,0,0,0
888497,True,0,No user reviews,0,0,0
888498,True,0,No user reviews,0,0,0
888499,True,0,No user reviews,0,0,0
888510,True,0,No user reviews,0,0,0
888511,True,0,No user reviews,0,0,0
888512,True,0,No user reviews,0,0,0
888513,True,0,No user reviews,0,0,0
888514,True,0,1 user reviews,1,0,1
888515,True,0,1 user reviews,0,1,1
888516,True,0,No user reviews,0,0,0
888517,True,0,No user reviews,0,0,0
888520,True,0,No user reviews,0,0,0
888530,True,0,No user reviews,0,0,0
888540,True,0,No user reviews,0,0,0
888560,True,0,1 user reviews,0,1,1
888570,True,0,1 user reviews,1,0,1
888590,True,0,No user reviews,0,0,0
888600,True,0,No user reviews,0,0,0
888601,True,0,No user reviews,0,0,0
888602,True,0,No user reviews,0,0,0
888603,True,0,No user reviews,0,0,0
888604,True,0,No user reviews,0,0,0
888605,True,0,No user reviews,0,0,0
888610,True,0,8 user reviews,4,4,8
888620,True,0,1 user reviews,0,1,1
888630,True,7,Positive,41,3,44
888640,True,0,1 user reviews,1,0,1
888650,True,6,Mostly Positive,53,16,69
888670,True,0,No user reviews,0,0,0
888680,True,0,No user reviews,0,0,0
888690,True,5,Mixed,6,6,12
888700,True,0,No user reviews,0,0,0
888701,True,7,Positive,10,2,12
888710,True,0,3 user reviews,2,1,3
888720,True,0,No user reviews,0,0,0
888740,True,0,1 user reviews,0,1,1
888750,True,0,1 user reviews,1,0,1
888760,True,0,No user reviews,0,0,0
888770,True,5,Mixed,327,472,799
888780,True,0,No user reviews,0,0,0
888790,True,8,Very Positive,237,8,245
888800,True,0,No user reviews,0,0,0
888810,True,0,5 user reviews,1,4,5
888820,True,0,5 user reviews,4,1,5
888830,True,0,No user reviews,0,0,0
888850,True,0,3 user reviews,3,0,3
888851,True,0,5 user reviews,4,1,5
888852,True,0,8 user reviews,5,3,8
888853,True,0,3 user reviews,3,0,3
888854,True,0,6 user reviews,4,2,6
888855,True,5,Mixed,9,5,14
888856,True,0,2 user reviews,2,0,2
888857,True,0,3 user reviews,3,0,3
888858,True,0,5 user reviews,4,1,5
888859,True,0,1 user reviews,0,1,1
888870,True,0,8 user reviews,2,6,8
888871,True,0,No user reviews,0,0,0
888872,True,5,Mixed,12,6,18
888880,True,0,1 user reviews,0,1,1
888900,True,0,4 user reviews,4,0,4
888910,True,0,No user reviews,0,0,0
888950,True,0,No user reviews,0,0,0
888960,True,0,No user reviews,0,0,0
888970,True,0,7 user reviews,2,5,7
888990,True,7,Positive,11,0,11
889000,True,0,No user reviews,0,0,0
889010,True,0,No user reviews,0,0,0
889030,True,0,3 user reviews,3,0,3
889040,True,6,Mostly Positive,74,25,99
889060,True,0,No user reviews,0,0,0
889070,True,0,1 user reviews,1,0,1
889071,True,0,No user reviews,0,0,0
889072,True,0,No user reviews,0,0,0
889073,True,0,No user reviews,0,0,0
889080,True,8,Very Positive,162,13,175
889100,True,0,1 user reviews,1,0,1
889110,True,0,No user reviews,0,0,0
889120,True,0,1 user reviews,1,0,1
889130,True,0,No user reviews,0,0,0
889150,True,0,1 user reviews,1,0,1
889160,True,0,No user reviews,0,0,0
889170,True,7,Positive,20,5,25
889180,True,0,No user reviews,0,0,0
889200,True,0,No user reviews,0,0,0
889210,True,0,No user reviews,0,0,0
889220,True,0,No user reviews,0,0,0
889240,True,0,No user reviews,0,0,0
889260,True,0,9 user reviews,9,0,9
889280,True,7,Positive,9,1,10
889290,True,0,1 user reviews,1,0,1
889300,True,0,No user reviews,0,0,0
889320,True,0,No user reviews,0,0,0
889330,True,0,2 user reviews,1,1,2
889340,True,5,Mixed,6,5,11
889350,True,0,No user reviews,0,0,0
889360,True,0,No user reviews,0,0,0
889380,True,0,2 user reviews,1,1,2
889400,True,7,Positive,11,0,11
889420,True,0,No user reviews,0,0,0
889430,True,0,No user reviews,0,0,0
889440,True,0,1 user reviews,1,0,1
889450,True,0,3 user reviews,3,0,3
889460,True,0,8 user reviews,5,3,8
889470,True,0,3 user reviews,1,2,3
889480,True,8,Very Positive,333,22,355
889510,True,8,Very Positive,330,23,353
889520,True,7,Positive,22,3,25
889530,True,0,No user reviews,0,0,0
889580,True,0,No user reviews,0,0,0
889590,True,0,No user reviews,0,0,0
889600,True,6,Mostly Positive,73,22,95
889610,True,0,No user reviews,0,0,0
889611,True,0,No user reviews,0,0,0
889612,True,0,No user reviews,0,0,0
889613,True,0,No user reviews,0,0,0
889614,True,0,No user reviews,0,0,0
889620,True,0,No user reviews,0,0,0
889630,True,0,2 user reviews,1,1,2
889640,True,0,1 user reviews,1,0,1
889650,True,0,No user reviews,0,0,0
889670,True,0,No user reviews,0,0,0
889680,True,0,No user reviews,0,0,0
889700,True,7,Positive,29,2,31
889710,True,7,Positive,30,5,35
889720,True,5,Mixed,7,5,12
889730,True,0,No user reviews,0,0,0
889740,True,0,No user reviews,0,0,0
889760,True,0,1 user reviews,0,1,1
889770,True,8,Very Positive,47,9,56
889790,True,0,3 user reviews,2,1,3
889800,True,0,5 user reviews,5,0,5
889820,True,7,Positive,33,1,34
889830,True,0,No user reviews,0,0,0
889840,True,0,No user reviews,0,0,0
889850,True,0,No user reviews,0,0,0
889870,True,0,No user reviews,0,0,0
889871,True,0,No user reviews,0,0,0
889872,True,0,No user reviews,0,0,0
889890,True,6,Mostly Positive,29,10,39
889902,True,5,Mixed,20,18,38
889903,True,5,Mixed,27,16,43
889910,True,0,No user reviews,0,0,0
889920,True,8,Very Positive,345,67,412
889921,True,6,Mostly Positive,204,64,268
889940,True,0,No user reviews,0,0,0
889970,True,0,3 user reviews,0,3,3
889990,True,0,2 user reviews,0,2,2
890010,True,0,No user reviews,0,0,0
890020,True,0,No user reviews,0,0,0
890030,True,0,No user reviews,0,0,0
890031,True,0,No user reviews,0,0,0
890032,True,0,No user reviews,0,0,0
890050,True,0,No user reviews,0,0,0
890070,True,0,No user reviews,0,0,0
890080,True,0,No user reviews,0,0,0
890100,True,0,No user reviews,0,0,0
890110,True,0,No user reviews,0,0,0
890130,True,0,3 user reviews,3,0,3
890180,True,5,Mixed,13,12,25
890200,True,0,No user reviews,0,0,0
890210,True,0,1 user reviews,0,1,1
890220,True,7,Positive,22,4,26
890230,True,0,No user reviews,0,0,0
890240,True,0,No user reviews,0,0,0
890250,True,0,6 user reviews,4,2,6
890280,True,7,Positive,14,3,17
890290,True,0,8 user reviews,5,3,8
890300,True,0,No user reviews,0,0,0
890310,True,7,Positive,18,0,18
890320,True,0,No user reviews,0,0,0
890330,True,0,No user reviews,0,0,0
890340,True,0,7 user reviews,7,0,7
890350,True,0,No user reviews,0,0,0
890370,True,0,No user reviews,0,0,0
890371,True,0,No user reviews,0,0,0
890372,True,0,No user reviews,0,0,0
890373,True,0,No user reviews,0,0,0
890374,True,0,No user reviews,0,0,0
890375,True,0,No user reviews,0,0,0
890376,True,0,No user reviews,0,0,0
890377,True,0,No user reviews,0,0,0
890378,True,0,No user reviews,0,0,0
890379,True,0,No user reviews,0,0,0
890380,True,0,No user reviews,0,0,0
890381,True,0,No user reviews,0,0,0
890382,True,0,No user reviews,0,0,0
890383,True,0,No user reviews,0,0,0
890384,True,0,No user reviews,0,0,0
890385,True,0,No user reviews,0,0,0
890386,True,0,No user reviews,0,0,0
890387,True,0,No user reviews,0,0,0
890388,True,0,No user reviews,0,0,0
890389,True,0,No user reviews,0,0,0
890390,True,0,No user reviews,0,0,0
890391,True,0,No user reviews,0,0,0
890392,True,0,No user reviews,0,0,0
890393,True,0,No user reviews,0,0,0
890394,True,0,No user reviews,0,0,0
890400,True,0,No user reviews,0,0,0
890410,True,0,No user reviews,0,0,0
890420,True,0,1 user reviews,1,0,1
890430,True,0,No user reviews,0,0,0
890460,True,0,No user reviews,0,0,0
890470,True,0,No user reviews,0,0,0
890480,True,0,6 user reviews,4,2,6
890490,True,0,No user reviews,0,0,0
890500,True,5,Mixed,16,8,24
890520,True,7,Positive,21,3,24
890530,True,0,No user reviews,0,0,0
890540,True,0,No user reviews,0,0,0
890550,True,0,No user reviews,0,0,0
890570,True,5,Mixed,80,38,118
890590,True,0,6 user reviews,6,0,6
890600,True,0,No user reviews,0,0,0
890610,True,0,No user reviews,0,0,0
890630,True,0,1 user reviews,1,0,1
890640,True,0,5 user reviews,3,2,5
890650,True,0,No user reviews,0,0,0
890651,True,0,No user reviews,0,0,0
890652,True,0,No user reviews,0,0,0
890653,True,0,No user reviews,0,0,0
890680,True,0,1 user reviews,0,1,1
890690,True,0,No user reviews,0,0,0
890700,True,7,Positive,12,1,13
890710,True,6,Mostly Positive,12,4,16
890720,True,8,Very Positive,238,13,251
890740,True,0,5 user reviews,4,1,5
890750,True,8,Very Positive,52,0,52
890770,True,0,No user reviews,0,0,0
890800,True,0,1 user reviews,1,0,1
890820,True,0,No user reviews,0,0,0
890840,True,0,No user reviews,0,0,0
890850,True,0,No user reviews,0,0,0
890860,True,0,No user reviews,0,0,0
890880,True,0,No user reviews,0,0,0
890900,True,0,1 user reviews,1,0,1
890910,True,0,1 user reviews,1,0,1
890920,True,0,No user reviews,0,0,0
890930,True,0,No user reviews,0,0,0
890940,True,5,Mixed,9,4,13
890960,True,0,No user reviews,0,0,0
890970,True,8,Very Positive,83,17,100
890980,True,0,No user reviews,0,0,0
890990,True,0,No user reviews,0,0,0
891010,True,0,No user reviews,0,0,0
891020,True,0,No user reviews,0,0,0
891030,True,0,No user reviews,0,0,0
891031,True,0,No user reviews,0,0,0
891033,True,0,No user reviews,0,0,0
891035,True,0,No user reviews,0,0,0
891040,True,0,No user reviews,0,0,0
891050,True,0,3 user reviews,2,1,3
891060,True,0,No user reviews,0,0,0
891090,True,0,4 user reviews,1,3,4
891100,True,0,7 user reviews,3,4,7
891110,True,0,4 user reviews,4,0,4
891120,True,0,5 user reviews,2,3,5
891130,True,0,No user reviews,0,0,0
891140,True,0,No user reviews,0,0,0
891170,True,0,No user reviews,0,0,0
891180,True,0,No user reviews,0,0,0
891190,True,0,No user reviews,0,0,0
891200,True,0,No user reviews,0,0,0
891220,True,0,1 user reviews,1,0,1
891230,True,6,Mostly Positive,23,7,30
891240,True,5,Mixed,6,4,10
891250,True,0,No user reviews,0,0,0
891260,True,0,1 user reviews,1,0,1
891270,True,0,6 user reviews,2,4,6
891280,True,0,No user reviews,0,0,0
891290,True,0,1 user reviews,1,0,1
891300,True,5,Mixed,10,5,15
891301,True,5,Mixed,18,14,32
891302,True,5,Mixed,7,10,17
891310,True,0,8 user reviews,3,5,8
891320,True,0,6 user reviews,4,2,6
891330,True,0,1 user reviews,0,1,1
891340,True,0,2 user reviews,2,0,2
891350,True,0,6 user reviews,5,1,6
891370,True,8,Very Positive,86,13,99
891380,True,0,2 user reviews,1,1,2
891420,True,5,Mixed,15,7,22
891430,True,0,No user reviews,0,0,0
891440,True,0,No user reviews,0,0,0
891460,True,0,No user reviews,0,0,0
891470,True,0,1 user reviews,0,1,1
891480,True,0,1 user reviews,1,0,1
891490,True,0,8 user reviews,6,2,8
891510,True,8,Very Positive,51,4,55
891520,True,0,No user reviews,0,0,0
891530,True,0,No user reviews,0,0,0
891540,True,0,No user reviews,0,0,0
891550,True,0,No user reviews,0,0,0
891630,True,0,No user reviews,0,0,0
891660,True,0,No user reviews,0,0,0
891700,True,0,5 user reviews,2,3,5
891710,True,0,3 user reviews,3,0,3
891720,True,0,8 user reviews,6,2,8
891730,True,5,Mixed,54,34,88
891770,True,0,No user reviews,0,0,0
891780,True,0,No user reviews,0,0,0
891790,True,6,Mostly Positive,37,13,50
891810,True,5,Mixed,52,26,78
891830,True,0,No user reviews,0,0,0
891840,True,0,No user reviews,0,0,0
891850,True,0,2 user reviews,2,0,2
891860,True,0,No user reviews,0,0,0
891870,True,6,Mostly Positive,7,3,10
891880,True,0,No user reviews,0,0,0
891881,True,0,No user reviews,0,0,0
891882,True,0,No user reviews,0,0,0
891883,True,0,No user reviews,0,0,0
891900,True,0,No user reviews,0,0,0
891910,True,0,No user reviews,0,0,0
891930,True,0,No user reviews,0,0,0
891950,True,0,No user reviews,0,0,0
891960,True,0,No user reviews,0,0,0
891970,True,0,No user reviews,0,0,0
891990,True,0,1 user reviews,1,0,1
892020,True,0,3 user reviews,2,1,3
892030,True,0,7 user reviews,5,2,7
892040,True,0,7 user reviews,5,2,7
892050,True,0,1 user reviews,1,0,1
892130,True,0,3 user reviews,1,2,3
892140,True,0,No user reviews,0,0,0
892160,True,0,3 user reviews,3,0,3
892170,True,0,No user reviews,0,0,0
892180,True,0,2 user reviews,2,0,2
892200,True,0,No user reviews,0,0,0
892210,True,0,3 user reviews,2,1,3
892220,True,0,No user reviews,0,0,0
892240,True,0,No user reviews,0,0,0
892250,True,0,2 user reviews,2,0,2
892260,True,0,No user reviews,0,0,0
892270,True,0,No user reviews,0,0,0
892280,True,0,No user reviews,0,0,0
892281,True,0,No user reviews,0,0,0
892282,True,0,No user reviews,0,0,0
892283,True,0,No user reviews,0,0,0
892284,True,0,No user reviews,0,0,0
892285,True,0,No user reviews,0,0,0
892286,True,0,No user reviews,0,0,0
892287,True,0,No user reviews,0,0,0
892288,True,0,No user reviews,0,0,0
892289,True,0,No user reviews,0,0,0
892290,True,0,No user reviews,0,0,0
892291,True,0,1 user reviews,1,0,1
892292,True,0,No user reviews,0,0,0
892293,True,0,No user reviews,0,0,0
892294,True,0,No user reviews,0,0,0
892295,True,0,No user reviews,0,0,0
892300,True,0,No user reviews,0,0,0
892310,True,0,3 user reviews,2,1,3
892350,True,0,No user reviews,0,0,0
892351,True,0,No user reviews,0,0,0
892352,True,0,No user reviews,0,0,0
892353,True,0,No user reviews,0,0,0
892354,True,0,No user reviews,0,0,0
892380,True,6,Mostly Positive,20,6,26
892390,True,0,No user reviews,0,0,0
892391,True,0,No user reviews,0,0,0
892392,True,0,No user reviews,0,0,0
892393,True,0,No user reviews,0,0,0
892394,True,0,No user reviews,0,0,0
892395,True,0,No user reviews,0,0,0
892396,True,0,No user reviews,0,0,0
892397,True,0,1 user reviews,1,0,1
892398,True,0,1 user reviews,1,0,1
892399,True,0,No user reviews,0,0,0
892400,True,7,Positive,21,0,21
892410,True,0,No user reviews,0,0,0
892420,True,0,8 user reviews,6,2,8
892430,True,0,No user reviews,0,0,0
892440,True,0,8 user reviews,5,3,8
892450,True,0,No user reviews,0,0,0
892460,True,0,No user reviews,0,0,0
892470,True,0,8 user reviews,8,0,8
892480,True,0,No user reviews,0,0,0
892490,True,0,2 user reviews,2,0,2
892500,True,0,No user reviews,0,0,0
892510,True,0,5 user reviews,3,2,5
892530,True,0,No user reviews,0,0,0
892550,True,7,Positive,12,3,15
892560,True,0,No user reviews,0,0,0
892570,True,0,No user reviews,0,0,0
892580,True,0,4 user reviews,4,0,4
892600,True,0,No user reviews,0,0,0
892610,True,0,No user reviews,0,0,0
892620,True,0,No user reviews,0,0,0
892630,True,0,1 user reviews,0,1,1
892640,True,0,2 user reviews,2,0,2
892650,True,5,Mixed,9,5,14
892660,True,0,No user reviews,0,0,0
892690,True,7,Positive,36,5,41
892700,True,0,No user reviews,0,0,0
892710,True,0,No user reviews,0,0,0
892720,True,0,No user reviews,0,0,0
892740,True,0,No user reviews,0,0,0
892750,True,0,No user reviews,0,0,0
892760,True,7,Positive,23,2,25
892780,True,7,Positive,15,3,18
892810,True,0,9 user reviews,7,2,9
892830,True,0,4 user reviews,4,0,4
892860,True,0,No user reviews,0,0,0
892870,True,0,No user reviews,0,0,0
892880,True,0,6 user reviews,6,0,6
892900,True,0,No user reviews,0,0,0
892910,True,0,3 user reviews,2,1,3
892920,True,0,No user reviews,0,0,0
892921,True,0,No user reviews,0,0,0
892922,True,0,No user reviews,0,0,0
892923,True,0,No user reviews,0,0,0
892924,True,0,No user reviews,0,0,0
892925,True,0,No user reviews,0,0,0
892926,True,0,No user reviews,0,0,0
892930,True,0,5 user reviews,3,2,5
892940,True,0,No user reviews,0,0,0
892941,True,0,No user reviews,0,0,0
892942,True,0,1 user reviews,1,0,1
892960,True,0,No user reviews,0,0,0
892970,True,0,No user reviews,0,0,0
892980,True,7,Positive,9,1,10
892990,True,7,Positive,20,0,20
893000,True,0,No user reviews,0,0,0
893001,True,0,3 user reviews,1,2,3
893010,True,6,Mostly Positive,41,15,56
893020,True,5,Mixed,23,10,33
893030,True,8,Very Positive,508,121,629
893040,True,4,Mostly Negative,5,9,14
893050,True,7,Positive,29,3,32
893060,True,0,8 user reviews,2,6,8
893070,True,5,Mixed,5,7,12
893090,True,0,4 user reviews,2,2,4
893120,True,0,No user reviews,0,0,0
893130,True,0,No user reviews,0,0,0
893140,True,0,2 user reviews,1,1,2
893150,True,0,No user reviews,0,0,0
893160,True,0,No user reviews,0,0,0
893170,True,0,No user reviews,0,0,0
893180,True,8,Very Positive,1759,149,1908
893190,True,0,No user reviews,0,0,0
893210,True,0,No user reviews,0,0,0
893220,True,0,No user reviews,0,0,0
893230,True,0,No user reviews,0,0,0
893240,True,0,No user reviews,0,0,0
893250,True,0,No user reviews,0,0,0
893260,True,0,No user reviews,0,0,0
893270,True,0,No user reviews,0,0,0
893280,True,0,No user reviews,0,0,0
893320,True,0,1 user reviews,0,1,1
893321,True,0,2 user reviews,2,0,2
893330,True,5,Mixed,13,10,23
893340,True,0,No user reviews,0,0,0
893350,True,0,No user reviews,0,0,0
893360,True,0,No user reviews,0,0,0
893370,True,0,No user reviews,0,0,0
893380,True,0,No user reviews,0,0,0
893390,True,0,No user reviews,0,0,0
893400,True,0,No user reviews,0,0,0
893410,True,0,No user reviews,0,0,0
893420,True,7,Positive,10,0,10
893450,True,0,3 user reviews,2,1,3
893460,True,0,4 user reviews,1,3,4
893470,True,7,Positive,12,0,12
893480,True,0,No user reviews,0,0,0
893490,True,0,No user reviews,0,0,0
893500,True,5,Mixed,7,5,12
893510,True,0,8 user reviews,3,5,8
893520,True,5,Mixed,152,72,224
893550,True,0,No user reviews,0,0,0
893560,True,0,No user reviews,0,0,0
893570,True,0,No user reviews,0,0,0
893590,True,0,2 user reviews,0,2,2
893610,True,7,Positive,34,4,38
893620,True,7,Positive,11,1,12
893630,True,0,2 user reviews,2,0,2
893640,True,0,No user reviews,0,0,0
893650,True,0,4 user reviews,1,3,4
893670,True,0,No user reviews,0,0,0
893680,True,8,Very Positive,942,95,1037
893690,True,8,Very Positive,52,3,55
893700,True,0,No user reviews,0,0,0
893710,True,0,2 user reviews,2,0,2
893720,True,0,No user reviews,0,0,0
893730,True,0,No user reviews,0,0,0
893740,True,0,5 user reviews,5,0,5
893750,True,0,No user reviews,0,0,0
893760,True,0,8 user reviews,8,0,8
893770,True,7,Positive,34,1,35
893780,True,0,No user reviews,0,0,0
893790,True,8,Very Positive,150,6,156
893800,True,0,2 user reviews,2,0,2
893810,True,0,No user reviews,0,0,0
893820,True,0,No user reviews,0,0,0
893830,True,0,No user reviews,0,0,0
893840,True,7,Positive,29,1,30
893850,True,8,Very Positive,799,73,872
893860,True,0,No user reviews,0,0,0
893870,True,5,Mixed,19,14,33
893880,True,0,No user reviews,0,0,0
893881,True,0,No user reviews,0,0,0
893882,True,0,No user reviews,0,0,0
893900,True,0,3 user reviews,3,0,3
893940,True,0,1 user reviews,1,0,1
893950,True,7,Positive,15,2,17
893960,True,0,4 user reviews,1,3,4
893980,True,0,1 user reviews,0,1,1
893981,True,0,1 user reviews,0,1,1
893982,True,0,No user reviews,0,0,0
893983,True,0,No user reviews,0,0,0
893984,True,0,No user reviews,0,0,0
894000,True,7,Positive,15,1,16
894010,True,0,3 user reviews,2,1,3
894070,True,0,4 user reviews,3,1,4
894080,True,0,1 user reviews,1,0,1
894090,True,0,No user reviews,0,0,0
894110,True,0,No user reviews,0,0,0
894120,True,0,2 user reviews,2,0,2
894130,True,0,No user reviews,0,0,0
894150,True,0,No user reviews,0,0,0
894160,True,0,2 user reviews,2,0,2
894200,True,0,No user reviews,0,0,0
894230,True,0,No user reviews,0,0,0
894270,True,6,Mostly Positive,21,7,28
894280,True,0,No user reviews,0,0,0
894310,True,0,6 user reviews,6,0,6
894320,True,0,No user reviews,0,0,0
894330,True,0,7 user reviews,5,2,7
894340,True,0,3 user reviews,3,0,3
894350,True,0,No user reviews,0,0,0
894360,True,0,No user reviews,0,0,0
894380,True,0,No user reviews,0,0,0
894390,True,5,Mixed,13,6,19
894400,True,0,No user reviews,0,0,0
894420,True,7,Positive,15,0,15
894430,True,0,7 user reviews,7,0,7
894440,True,0,No user reviews,0,0,0
894460,True,8,Very Positive,56,3,59
894500,True,0,1 user reviews,1,0,1
894540,True,6,Mostly Positive,12,5,17
894550,True,0,No user reviews,0,0,0
894570,True,0,3 user reviews,3,0,3
894580,True,0,No user reviews,0,0,0
894581,True,0,No user reviews,0,0,0
894582,True,0,No user reviews,0,0,0
894583,True,0,No user reviews,0,0,0
894584,True,0,No user reviews,0,0,0
894585,True,0,No user reviews,0,0,0
894600,True,5,Mixed,124,101,225
894610,True,0,2 user reviews,1,1,2
894620,True,0,No user reviews,0,0,0
894630,True,8,Very Positive,139,30,169
894640,True,0,No user reviews,0,0,0
894650,True,0,No user reviews,0,0,0
894660,True,0,No user reviews,0,0,0
894670,True,0,5 user reviews,5,0,5
894690,True,0,5 user reviews,5,0,5
894700,True,0,8 user reviews,8,0,8
894710,True,0,9 user reviews,9,0,9
894720,True,0,2 user reviews,2,0,2
894730,True,0,6 user reviews,3,3,6
894740,True,0,4 user reviews,3,1,4
894750,True,0,4 user reviews,2,2,4
894780,True,0,No user reviews,0,0,0
894790,True,0,1 user reviews,1,0,1
894820,True,0,No user reviews,0,0,0
894830,True,0,No user reviews,0,0,0
894840,True,0,No user reviews,0,0,0
894850,True,0,No user reviews,0,0,0
894860,True,0,No user reviews,0,0,0
894870,True,0,No user reviews,0,0,0
894890,True,0,No user reviews,0,0,0
894900,True,0,6 user reviews,2,4,6
894930,True,0,2 user reviews,0,2,2
894940,True,9,Overwhelmingly Positive,1835,87,1922
894950,True,0,3 user reviews,2,1,3
894970,True,0,4 user reviews,3,1,4
894980,True,0,1 user reviews,1,0,1
895000,True,0,4 user reviews,4,0,4
895040,True,5,Mixed,50,26,76
895060,True,4,Mostly Negative,13,21,34
895070,True,0,1 user reviews,1,0,1
895120,True,0,4 user reviews,2,2,4
895130,True,0,No user reviews,0,0,0
895140,True,7,Positive,8,2,10
895150,True,0,No user reviews,0,0,0
895160,True,0,No user reviews,0,0,0
895170,True,0,3 user reviews,3,0,3
895180,True,0,2 user reviews,2,0,2
895190,True,0,No user reviews,0,0,0
895200,True,5,Mixed,43,37,80
895210,True,0,No user reviews,0,0,0
895220,True,0,5 user reviews,4,1,5
895240,True,0,No user reviews,0,0,0
895250,True,0,No user reviews,0,0,0
895260,True,0,1 user reviews,1,0,1
895270,True,0,1 user reviews,1,0,1
895280,True,0,1 user reviews,1,0,1
895290,True,0,No user reviews,0,0,0
895300,True,0,1 user reviews,1,0,1
895330,True,0,6 user reviews,6,0,6
895370,True,0,3 user reviews,2,1,3
895390,True,0,No user reviews,0,0,0
895391,True,0,No user reviews,0,0,0
895392,True,0,No user reviews,0,0,0
895393,True,0,No user reviews,0,0,0
895394,True,0,No user reviews,0,0,0
895400,True,6,Mostly Positive,5192,1341,6533
895420,True,7,Positive,28,2,30
895430,True,0,No user reviews,0,0,0
895440,True,0,4 user reviews,3,1,4
895450,True,0,1 user reviews,1,0,1
895470,True,6,Mostly Positive,14,5,19
895480,True,8,Very Positive,53,5,58
895490,True,5,Mixed,50,28,78
895491,True,6,Mostly Positive,47,17,64
895492,True,5,Mixed,48,67,115
895493,True,5,Mixed,41,23,64
895510,True,0,No user reviews,0,0,0
895520,True,0,No user reviews,0,0,0
895530,True,0,No user reviews,0,0,0
895540,True,0,No user reviews,0,0,0
895550,True,0,No user reviews,0,0,0
895570,True,0,1 user reviews,0,1,1
895580,True,0,5 user reviews,0,5,5
895600,True,7,Positive,24,3,27
895610,True,0,5 user reviews,5,0,5
895620,True,6,Mostly Positive,110,36,146
895650,True,0,No user reviews,0,0,0
895670,True,0,No user reviews,0,0,0
895690,True,7,Positive,28,6,34
895710,True,0,2 user reviews,1,1,2
895720,True,0,7 user reviews,7,0,7
895740,True,0,3 user reviews,2,1,3
895750,True,6,Mostly Positive,7,3,10
895760,True,0,No user reviews,0,0,0
895790,True,0,No user reviews,0,0,0
895800,True,0,3 user reviews,3,0,3
895810,True,0,No user reviews,0,0,0
895820,True,0,4 user reviews,3,1,4
895840,True,0,No user reviews,0,0,0
895850,True,0,2 user reviews,2,0,2
895860,True,0,2 user reviews,2,0,2
895870,True,0,No user reviews,0,0,0
895880,True,0,No user reviews,0,0,0
895890,True,0,4 user reviews,3,1,4
895900,True,0,No user reviews,0,0,0
895930,True,0,1 user reviews,1,0,1
895940,True,0,2 user reviews,1,1,2
895950,True,0,7 user reviews,4,3,7
895960,True,0,1 user reviews,0,1,1
895970,True,0,No user reviews,0,0,0
895980,True,0,No user reviews,0,0,0
895990,True,0,No user reviews,0,0,0
896000,True,0,4 user reviews,4,0,4
896010,True,0,No user reviews,0,0,0
896020,True,0,No user reviews,0,0,0
896030,True,5,Mixed,6,6,12
896040,True,0,No user reviews,0,0,0
896050,True,0,No user reviews,0,0,0
896070,True,0,6 user reviews,4,2,6
896100,True,0,No user reviews,0,0,0
896101,True,0,No user reviews,0,0,0
896102,True,0,No user reviews,0,0,0
896110,True,0,2 user reviews,2,0,2
896160,True,6,Mostly Positive,331,122,453
896170,True,0,No user reviews,0,0,0
896180,True,0,5 user reviews,3,2,5
896190,True,0,1 user reviews,1,0,1
896220,True,0,No user reviews,0,0,0
896230,True,0,2 user reviews,0,2,2
896240,True,0,2 user reviews,0,2,2
896250,True,0,No user reviews,0,0,0
896260,True,0,No user reviews,0,0,0
896270,True,0,No user reviews,0,0,0
896290,True,0,No user reviews,0,0,0
896340,True,7,Positive,21,5,26
896350,True,0,1 user reviews,1,0,1
896370,True,0,3 user reviews,3,0,3
896380,True,0,6 user reviews,3,3,6
896400,True,0,6 user reviews,6,0,6
896410,True,0,No user reviews,0,0,0
896420,True,0,2 user reviews,1,1,2
896440,True,5,Mixed,25,17,42
896460,True,8,Very Positive,160,6,166
896500,True,0,2 user reviews,2,0,2
896510,True,5,Mixed,9,6,15
896520,True,0,No user reviews,0,0,0
896530,True,0,No user reviews,0,0,0
896540,True,0,No user reviews,0,0,0
896541,True,0,No user reviews,0,0,0
896542,True,0,No user reviews,0,0,0
896543,True,0,No user reviews,0,0,0
896544,True,0,No user reviews,0,0,0
896546,True,0,No user reviews,0,0,0
896548,True,0,No user reviews,0,0,0
896550,True,7,Positive,14,0,14
896570,True,0,6 user reviews,4,2,6
896580,True,0,No user reviews,0,0,0
896590,True,0,No user reviews,0,0,0
896620,True,0,No user reviews,0,0,0
896630,True,0,No user reviews,0,0,0
896640,True,7,Positive,10,0,10
896650,True,0,3 user reviews,2,1,3
896670,True,0,1 user reviews,1,0,1
896680,True,5,Mixed,10,11,21
896700,True,0,3 user reviews,2,1,3
896712,True,0,2 user reviews,2,0,2
896713,True,6,Mostly Positive,10,4,14
896715,True,7,Positive,19,4,23
896716,True,0,1 user reviews,0,1,1
896717,True,5,Mixed,12,10,22
896718,True,0,9 user reviews,4,5,9
896719,True,7,Positive,18,2,20
896730,True,0,1 user reviews,1,0,1
896741,True,0,5 user reviews,3,2,5
896742,True,0,4 user reviews,3,1,4
896743,True,0,4 user reviews,4,0,4
896744,True,0,8 user reviews,7,1,8
896745,True,0,6 user reviews,4,2,6
896746,True,0,5 user reviews,3,2,5
896747,True,0,6 user reviews,3,3,6
896748,True,5,Mixed,6,5,11
896749,True,0,2 user reviews,0,2,2
896750,True,8,Very Positive,58,12,70
896761,True,0,1 user reviews,1,0,1
896762,True,0,No user reviews,0,0,0
896764,True,0,2 user reviews,2,0,2
896765,True,0,2 user reviews,2,0,2
896766,True,0,1 user reviews,1,0,1
896767,True,0,2 user reviews,1,1,2
896780,True,0,2 user reviews,2,0,2
896790,True,0,No user reviews,0,0,0
896800,True,0,No user reviews,0,0,0
896830,True,0,1 user reviews,1,0,1
896840,True,0,No user reviews,0,0,0
896850,True,0,3 user reviews,1,2,3
896860,True,0,2 user reviews,0,2,2
896870,True,0,No user reviews,0,0,0
896880,True,5,Mixed,6,4,10
896890,True,8,Very Positive,238,24,262
896910,True,0,No user reviews,0,0,0
896940,True,0,No user reviews,0,0,0
896950,True,0,7 user reviews,4,3,7
896960,True,6,Mostly Positive,20,7,27
896970,True,0,4 user reviews,3,1,4
896980,True,0,No user reviews,0,0,0
896990,True,0,4 user reviews,1,3,4
897000,True,0,1 user reviews,1,0,1
897010,True,0,1 user reviews,1,0,1
897020,True,0,5 user reviews,4,1,5
897030,True,8,Very Positive,401,81,482
897040,True,5,Mixed,23,14,37
897060,True,0,No user reviews,0,0,0
897061,True,0,No user reviews,0,0,0
897062,True,0,No user reviews,0,0,0
897063,True,0,No user reviews,0,0,0
897064,True,0,No user reviews,0,0,0
897065,True,0,No user reviews,0,0,0
897066,True,0,No user reviews,0,0,0
897067,True,0,No user reviews,0,0,0
897068,True,0,No user reviews,0,0,0
897069,True,0,No user reviews,0,0,0
897070,True,0,No user reviews,0,0,0
897071,True,0,No user reviews,0,0,0
897072,True,0,No user reviews,0,0,0
897073,True,0,No user reviews,0,0,0
897074,True,0,No user reviews,0,0,0
897075,True,0,No user reviews,0,0,0
897080,True,0,No user reviews,0,0,0
897090,True,0,No user reviews,0,0,0
897100,True,0,4 user reviews,3,1,4
897110,True,0,No user reviews,0,0,0
897120,True,0,No user reviews,0,0,0
897130,True,0,No user reviews,0,0,0
897150,True,0,No user reviews,0,0,0
897180,True,0,2 user reviews,2,0,2
897190,True,0,1 user reviews,1,0,1
897210,True,0,No user reviews,0,0,0
897220,True,8,Very Positive,232,5,237
897230,True,0,1 user reviews,1,0,1
897240,True,0,1 user reviews,1,0,1
897250,True,0,1 user reviews,1,0,1
897270,True,0,No user reviews,0,0,0
897280,True,0,2 user reviews,1,1,2
897290,True,0,No user reviews,0,0,0
897300,True,5,Mixed,12,8,20
897310,True,0,No user reviews,0,0,0
897330,True,7,Positive,14,0,14
897340,True,0,No user reviews,0,0,0
897350,True,0,No user reviews,0,0,0
897360,True,0,1 user reviews,1,0,1
897380,True,0,No user reviews,0,0,0
897390,True,0,2 user reviews,1,1,2
897400,True,0,4 user reviews,1,3,4
897410,True,5,Mixed,103,76,179
897420,True,0,3 user reviews,2,1,3
897440,True,5,Mixed,23,13,36
897450,True,5,Mixed,192,137,329
897510,True,0,No user reviews,0,0,0
897530,True,0,No user reviews,0,0,0
897550,True,0,6 user reviews,1,5,6
897560,True,0,1 user reviews,1,0,1
897580,True,0,No user reviews,0,0,0
897590,True,0,No user reviews,0,0,0
897630,True,5,Mixed,11,7,18
897640,True,6,Mostly Positive,15,4,19
897650,True,0,No user reviews,0,0,0
897670,True,8,Very Positive,350,50,400
897690,True,7,Positive,38,0,38
897700,True,0,7 user reviews,4,3,7
897730,True,0,No user reviews,0,0,0
897760,True,7,Positive,10,0,10
897770,True,0,2 user reviews,1,1,2
897800,True,7,Positive,22,2,24
897820,True,6,Mostly Positive,151,61,212
897830,True,7,Positive,12,3,15
897840,True,0,1 user reviews,0,1,1
897870,True,0,No user reviews,0,0,0
897880,True,0,2 user reviews,1,1,2
897890,True,0,No user reviews,0,0,0
897900,True,0,3 user reviews,3,0,3
897910,True,0,2 user reviews,1,1,2
897920,True,0,1 user reviews,1,0,1
897930,True,8,Very Positive,81,16,97
897940,True,0,No user reviews,0,0,0
897950,True,0,2 user reviews,0,2,2
897970,True,0,No user reviews,0,0,0
898000,True,5,Mixed,12,16,28
898010,True,0,No user reviews,0,0,0
898030,True,0,No user reviews,0,0,0
898040,True,0,No user reviews,0,0,0
898050,True,0,No user reviews,0,0,0
898060,True,0,No user reviews,0,0,0
898080,True,0,No user reviews,0,0,0
898090,True,0,1 user reviews,1,0,1
898100,True,0,No user reviews,0,0,0
898110,True,0,1 user reviews,1,0,1
898120,True,0,4 user reviews,2,2,4
898130,True,0,No user reviews,0,0,0
898160,True,0,No user reviews,0,0,0
898170,True,0,1 user reviews,0,1,1
898190,True,0,3 user reviews,3,0,3
898200,True,0,No user reviews,0,0,0
898230,True,0,No user reviews,0,0,0
898240,True,0,5 user reviews,5,0,5
898250,True,0,1 user reviews,1,0,1
898260,True,7,Positive,11,0,11
898290,True,0,No user reviews,0,0,0
898310,True,0,5 user reviews,5,0,5
898320,True,0,1 user reviews,0,1,1
898330,True,0,No user reviews,0,0,0
898340,True,0,7 user reviews,2,5,7
898380,True,0,4 user reviews,3,1,4
898390,True,5,Mixed,22,11,33
898400,True,0,No user reviews,0,0,0
898420,True,0,No user reviews,0,0,0
898430,True,0,1 user reviews,0,1,1
898440,True,0,4 user reviews,3,1,4
898450,True,8,Very Positive,69,2,71
898460,True,6,Mostly Positive,13,4,17
898490,True,0,No user reviews,0,0,0
898500,True,0,3 user reviews,2,1,3
898520,True,0,No user reviews,0,0,0
898530,True,0,5 user reviews,1,4,5
898540,True,0,3 user reviews,0,3,3
898550,True,0,No user reviews,0,0,0
898551,True,0,No user reviews,0,0,0
898552,True,0,No user reviews,0,0,0
898553,True,0,No user reviews,0,0,0
898554,True,0,No user reviews,0,0,0
898555,True,0,No user reviews,0,0,0
898560,True,0,No user reviews,0,0,0
898570,True,0,No user reviews,0,0,0
898580,True,8,Very Positive,116,6,122
898590,True,0,No user reviews,0,0,0
898600,True,0,1 user reviews,0,1,1
898640,True,0,No user reviews,0,0,0
898650,True,8,Very Positive,185,37,222
898660,True,0,No user reviews,0,0,0
898670,True,0,No user reviews,0,0,0
898680,True,0,No user reviews,0,0,0
898690,True,0,2 user reviews,1,1,2
898700,True,5,Mixed,9,6,15
898710,True,0,No user reviews,0,0,0
898720,True,6,Mostly Positive,105,27,132
898730,True,0,No user reviews,0,0,0
898760,True,0,1 user reviews,1,0,1
898770,True,0,No user reviews,0,0,0
898780,True,7,Positive,38,6,44
898790,True,7,Positive,18,0,18
898800,True,8,Very Positive,71,7,78
898810,True,0,No user reviews,0,0,0
898820,True,0,No user reviews,0,0,0
898830,True,0,4 user reviews,4,0,4
898880,True,0,No user reviews,0,0,0
898890,True,0,No user reviews,0,0,0
898910,True,7,Positive,11,0,11
898920,True,6,Mostly Positive,1225,404,1629
898930,True,0,3 user reviews,3,0,3
898940,True,0,5 user reviews,3,2,5
898950,True,0,No user reviews,0,0,0
898960,True,6,Mostly Positive,16,5,21
898961,True,0,7 user reviews,6,1,7
898962,True,0,9 user reviews,3,6,9
898980,True,0,No user reviews,0,0,0
898990,True,0,No user reviews,0,0,0
899000,True,0,2 user reviews,2,0,2
899020,True,0,3 user reviews,2,1,3
899030,True,0,2 user reviews,2,0,2
899060,True,0,No user reviews,0,0,0
899061,True,0,No user reviews,0,0,0
899070,True,0,No user reviews,0,0,0
899090,True,0,No user reviews,0,0,0
899100,True,7,Positive,8,2,10
899130,True,0,5 user reviews,4,1,5
899140,True,0,No user reviews,0,0,0
899150,True,0,2 user reviews,1,1,2
899160,True,0,No user reviews,0,0,0
899180,True,7,Positive,20,3,23
899190,True,0,No user reviews,0,0,0
899200,True,6,Mostly Positive,10,3,13
899210,True,0,No user reviews,0,0,0
899211,True,0,No user reviews,0,0,0
899212,True,0,No user reviews,0,0,0
899213,True,0,No user reviews,0,0,0
899214,True,0,No user reviews,0,0,0
899220,True,0,No user reviews,0,0,0
899230,True,0,No user reviews,0,0,0
899240,True,0,1 user reviews,1,0,1
899250,True,0,No user reviews,0,0,0
899270,True,7,Positive,18,0,18
899280,True,0,2 user reviews,2,0,2
899290,True,0,No user reviews,0,0,0
899310,True,8,Very Positive,91,19,110
899330,True,0,No user reviews,0,0,0
899340,True,7,Positive,10,0,10
899350,True,0,2 user reviews,1,1,2
899360,True,0,No user reviews,0,0,0
899380,True,0,No user reviews,0,0,0
899390,True,5,Mixed,98,47,145
899410,True,0,1 user reviews,0,1,1
899411,True,0,2 user reviews,1,1,2
899440,True,8,Very Positive,1280,153,1433
899450,True,0,No user reviews,0,0,0
899460,True,0,No user reviews,0,0,0
899470,True,7,Positive,46,3,49
899480,True,6,Mostly Positive,13,5,18
899490,True,0,No user reviews,0,0,0
899510,True,0,No user reviews,0,0,0
899530,True,0,No user reviews,0,0,0
899540,True,5,Mixed,12,10,22
899550,True,0,No user reviews,0,0,0
899551,True,0,No user reviews,0,0,0
899570,True,0,4 user reviews,0,4,4
899580,True,0,No user reviews,0,0,0
899590,True,0,8 user reviews,8,0,8
899610,True,0,No user reviews,0,0,0
899630,True,5,Mixed,6,9,15
899640,True,0,No user reviews,0,0,0
899650,True,0,No user reviews,0,0,0
899660,True,0,No user reviews,0,0,0
899760,True,0,3 user reviews,3,0,3
899770,True,8,Very Positive,1403,241,1644
899781,True,0,No user reviews,0,0,0
899782,True,0,No user reviews,0,0,0
899783,True,0,No user reviews,0,0,0
899784,True,0,No user reviews,0,0,0
899785,True,0,No user reviews,0,0,0
899786,True,0,No user reviews,0,0,0
899787,True,0,No user reviews,0,0,0
899788,True,0,No user reviews,0,0,0
899789,True,0,No user reviews,0,0,0
899790,True,0,No user reviews,0,0,0
899791,True,0,No user reviews,0,0,0
899792,True,0,No user reviews,0,0,0
899793,True,0,No user reviews,0,0,0
899794,True,0,No user reviews,0,0,0
899795,True,0,1 user reviews,1,0,1
899796,True,0,1 user reviews,1,0,1
899797,True,0,No user reviews,0,0,0
899798,True,0,No user reviews,0,0,0
899799,True,0,No user reviews,0,0,0
899800,True,0,No user reviews,0,0,0
899801,True,0,No user reviews,0,0,0
899802,True,0,No user reviews,0,0,0
899803,True,0,No user reviews,0,0,0
899804,True,0,1 user reviews,1,0,1
899805,True,0,No user reviews,0,0,0
899806,True,0,2 user reviews,0,2,2
899807,True,0,No user reviews,0,0,0
899808,True,0,1 user reviews,1,0,1
899809,True,0,No user reviews,0,0,0
899810,True,0,1 user reviews,1,0,1
899811,True,0,No user reviews,0,0,0
899812,True,0,No user reviews,0,0,0
899813,True,0,No user reviews,0,0,0
899814,True,0,No user reviews,0,0,0
899815,True,0,No user reviews,0,0,0
899816,True,0,No user reviews,0,0,0
899817,True,0,No user reviews,0,0,0
899818,True,0,No user reviews,0,0,0
899819,True,0,No user reviews,0,0,0
899820,True,0,No user reviews,0,0,0
899821,True,0,1 user reviews,1,0,1
899822,True,0,No user reviews,0,0,0
899823,True,0,1 user reviews,1,0,1
899824,True,0,No user reviews,0,0,0
899825,True,0,No user reviews,0,0,0
899826,True,0,1 user reviews,1,0,1
899827,True,0,No user reviews,0,0,0
899828,True,0,No user reviews,0,0,0
899829,True,0,No user reviews,0,0,0
899830,True,0,No user reviews,0,0,0
899831,True,0,No user reviews,0,0,0
899832,True,0,No user reviews,0,0,0
899833,True,0,2 user reviews,1,1,2
899834,True,0,4 user reviews,3,1,4
899835,True,0,No user reviews,0,0,0
899836,True,0,No user reviews,0,0,0
899837,True,0,No user reviews,0,0,0
899838,True,0,No user reviews,0,0,0
899839,True,0,No user reviews,0,0,0
899840,True,0,No user reviews,0,0,0
899841,True,0,No user reviews,0,0,0
899842,True,0,No user reviews,0,0,0
899843,True,0,1 user reviews,1,0,1
899844,True,0,No user reviews,0,0,0
899845,True,0,No user reviews,0,0,0
899846,True,0,No user reviews,0,0,0
899847,True,0,No user reviews,0,0,0
899848,True,0,No user reviews,0,0,0
899849,True,0,No user reviews,0,0,0
899850,True,0,No user reviews,0,0,0
899851,True,0,No user reviews,0,0,0
899852,True,0,No user reviews,0,0,0
899853,True,0,No user reviews,0,0,0
899854,True,0,No user reviews,0,0,0
899855,True,0,No user reviews,0,0,0
899856,True,0,No user reviews,0,0,0
899857,True,0,No user reviews,0,0,0
899858,True,0,2 user reviews,2,0,2
899859,True,0,1 user reviews,1,0,1
899860,True,0,No user reviews,0,0,0
899861,True,0,No user reviews,0,0,0
899862,True,0,No user reviews,0,0,0
899863,True,0,No user reviews,0,0,0
899864,True,0,1 user reviews,0,1,1
899865,True,0,No user reviews,0,0,0
899866,True,0,No user reviews,0,0,0
899867,True,0,No user reviews,0,0,0
899868,True,0,No user reviews,0,0,0
899869,True,0,No user reviews,0,0,0
899870,True,0,No user reviews,0,0,0
899871,True,0,No user reviews,0,0,0
899872,True,0,1 user reviews,1,0,1
899873,True,0,No user reviews,0,0,0
899874,True,0,No user reviews,0,0,0
899875,True,0,No user reviews,0,0,0
899876,True,0,No user reviews,0,0,0
899877,True,0,No user reviews,0,0,0
899878,True,0,No user reviews,0,0,0
899879,True,0,No user reviews,0,0,0
899880,True,0,No user reviews,0,0,0
899881,True,0,No user reviews,0,0,0
899882,True,0,No user reviews,0,0,0
899883,True,0,No user reviews,0,0,0
899884,True,0,No user reviews,0,0,0
899885,True,0,No user reviews,0,0,0
899886,True,0,No user reviews,0,0,0
899887,True,0,No user reviews,0,0,0
899888,True,0,No user reviews,0,0,0
899889,True,0,No user reviews,0,0,0
899890,True,0,No user reviews,0,0,0
899891,True,0,No user reviews,0,0,0
899892,True,0,1 user reviews,1,0,1
899893,True,0,No user reviews,0,0,0
899894,True,0,No user reviews,0,0,0
899895,True,0,No user reviews,0,0,0
899896,True,0,No user reviews,0,0,0
899897,True,0,No user reviews,0,0,0
899898,True,0,No user reviews,0,0,0
899899,True,0,No user reviews,0,0,0
899900,True,0,7 user reviews,5,2,7
899901,True,0,No user reviews,0,0,0
899902,True,0,No user reviews,0,0,0
899903,True,0,No user reviews,0,0,0
899904,True,0,No user reviews,0,0,0
899905,True,0,No user reviews,0,0,0
899906,True,0,No user reviews,0,0,0
899907,True,0,No user reviews,0,0,0
899908,True,0,No user reviews,0,0,0
899909,True,0,No user reviews,0,0,0
899910,True,0,No user reviews,0,0,0
899920,True,0,No user reviews,0,0,0
899930,True,0,No user reviews,0,0,0
899940,True,0,7 user reviews,6,1,7
899960,True,7,Positive,16,1,17
899970,True,9,Overwhelmingly Positive,488,17,505
899990,True,0,6 user reviews,0,6,6
900010,True,5,Mixed,171,95,266
900030,True,0,1 user reviews,1,0,1
900050,True,7,Positive,19,4,23
900060,True,0,No user reviews,0,0,0
900070,True,0,No user reviews,0,0,0
900090,True,7,Positive,19,1,20
900100,True,0,No user reviews,0,0,0
900101,True,0,No user reviews,0,0,0
900102,True,0,No user reviews,0,0,0
900103,True,0,No user reviews,0,0,0
900110,True,0,No user reviews,0,0,0
900130,True,0,No user reviews,0,0,0
900150,True,0,No user reviews,0,0,0
900170,True,0,No user reviews,0,0,0
900180,True,0,No user reviews,0,0,0
900190,True,0,No user reviews,0,0,0
900210,True,0,No user reviews,0,0,0
900230,True,0,No user reviews,0,0,0
900231,True,0,1 user reviews,1,0,1
900240,True,0,No user reviews,0,0,0
900241,True,0,No user reviews,0,0,0
900242,True,0,No user reviews,0,0,0
900250,True,0,No user reviews,0,0,0
900260,True,0,No user reviews,0,0,0
900270,True,8,Very Positive,1284,85,1369
900280,True,0,No user reviews,0,0,0
900290,True,6,Mostly Positive,16,5,21
900310,True,0,No user reviews,0,0,0
900330,True,0,No user reviews,0,0,0
900340,True,0,6 user reviews,4,2,6
900350,True,0,No user reviews,0,0,0
900370,True,0,9 user reviews,6,3,9
900380,True,0,3 user reviews,3,0,3
900390,True,0,1 user reviews,1,0,1
900400,True,0,No user reviews,0,0,0
900447,True,6,Mostly Positive,44,13,57
900448,True,5,Mixed,32,39,71
900449,True,6,Mostly Positive,37,15,52
900450,True,0,No user reviews,0,0,0
900460,True,0,No user reviews,0,0,0
900470,True,0,No user reviews,0,0,0
900480,True,0,No user reviews,0,0,0
900490,True,7,Positive,19,0,19
900510,True,0,No user reviews,0,0,0
900530,True,0,1 user reviews,1,0,1
900540,True,0,1 user reviews,1,0,1
900550,True,0,2 user reviews,2,0,2
900560,True,0,1 user reviews,1,0,1
900570,True,0,No user reviews,0,0,0
900580,True,0,No user reviews,0,0,0
900610,True,0,1 user reviews,1,0,1
900700,True,0,No user reviews,0,0,0
900710,True,0,No user reviews,0,0,0
900790,True,7,Positive,16,2,18
900820,True,0,No user reviews,0,0,0
900883,True,9,Overwhelmingly Positive,14817,669,15486
901000,True,0,2 user reviews,2,0,2
901020,True,0,2 user reviews,2,0,2
903040,True,6,Mostly Positive,38,12,50
903090,True,0,No user reviews,0,0,0
903110,True,0,1 user reviews,1,0,1
903130,True,0,No user reviews,0,0,0
903140,True,0,No user reviews,0,0,0
903150,True,0,1 user reviews,1,0,1
903160,True,0,1 user reviews,1,0,1
903180,True,0,4 user reviews,3,1,4
903240,True,0,1 user reviews,0,1,1
903241,True,0,No user reviews,0,0,0
903242,True,0,No user reviews,0,0,0
903243,True,0,1 user reviews,1,0,1
903244,True,0,No user reviews,0,0,0
903245,True,0,No user reviews,0,0,0
903246,True,0,No user reviews,0,0,0
903247,True,0,No user reviews,0,0,0
903248,True,0,No user reviews,0,0,0
903249,True,0,No user reviews,0,0,0
903250,True,0,No user reviews,0,0,0
903251,True,0,No user reviews,0,0,0
903252,True,0,No user reviews,0,0,0
903253,True,0,No user reviews,0,0,0
903260,True,0,No user reviews,0,0,0
903261,True,0,No user reviews,0,0,0
903262,True,0,No user reviews,0,0,0
903263,True,0,No user reviews,0,0,0
903410,True,0,No user reviews,0,0,0
903460,True,0,3 user reviews,3,0,3
903560,True,0,No user reviews,0,0,0
903570,True,0,No user reviews,0,0,0
903580,True,0,6 user reviews,6,0,6
903590,True,0,No user reviews,0,0,0
903610,True,0,1 user reviews,1,0,1
903620,True,0,7 user reviews,3,4,7
903630,True,0,No user reviews,0,0,0
903640,True,0,No user reviews,0,0,0
903660,True,0,No user reviews,0,0,0
903670,True,0,6 user reviews,1,5,6
903680,True,0,1 user reviews,1,0,1
903690,True,0,No user reviews,0,0,0
903700,True,0,No user reviews,0,0,0
903710,True,5,Mixed,12,8,20
903730,True,0,No user reviews,0,0,0
903740,True,0,9 user reviews,3,6,9
903750,True,0,No user reviews,0,0,0
903760,True,0,No user reviews,0,0,0
903770,True,0,1 user reviews,1,0,1
903771,True,0,2 user reviews,2,0,2
903772,True,0,2 user reviews,0,2,2
903780,True,0,6 user reviews,5,1,6
903790,True,0,No user reviews,0,0,0
903820,True,0,No user reviews,0,0,0
903830,True,5,Mixed,13,7,20
903840,True,0,No user reviews,0,0,0
903850,True,0,5 user reviews,5,0,5
903860,True,0,2 user reviews,2,0,2
903870,True,0,No user reviews,0,0,0
903880,True,0,6 user reviews,2,4,6
903910,True,0,5 user reviews,5,0,5
903930,True,0,No user reviews,0,0,0
903940,True,0,No user reviews,0,0,0
903950,True,6,Mostly Positive,6930,2045,8975
903970,True,0,No user reviews,0,0,0
903980,True,0,No user reviews,0,0,0
903990,True,0,No user reviews,0,0,0
904010,True,0,No user reviews,0,0,0
904020,True,0,No user reviews,0,0,0
904050,True,0,5 user reviews,2,3,5
904110,True,0,No user reviews,0,0,0
904120,True,0,2 user reviews,1,1,2
904121,True,0,No user reviews,0,0,0
904122,True,0,1 user reviews,1,0,1
904123,True,0,1 user reviews,1,0,1
904124,True,0,No user reviews,0,0,0
904125,True,0,No user reviews,0,0,0
904126,True,0,1 user reviews,1,0,1
904127,True,0,No user reviews,0,0,0
904130,True,7,Positive,22,3,25
904150,True,0,No user reviews,0,0,0
904160,True,0,7 user reviews,5,2,7
904170,True,0,4 user reviews,2,2,4
904190,True,0,No user reviews,0,0,0
904200,True,0,No user reviews,0,0,0
904210,True,0,No user reviews,0,0,0
904220,True,0,No user reviews,0,0,0
904230,True,0,No user reviews,0,0,0
904260,True,0,5 user reviews,5,0,5
904270,True,0,No user reviews,0,0,0
904300,True,0,No user reviews,0,0,0
904310,True,6,Mostly Positive,25,9,34
904320,True,0,1 user reviews,1,0,1
904340,True,0,2 user reviews,1,1,2
904360,True,8,Very Positive,102,25,127
904370,True,7,Positive,11,0,11
904380,True,6,Mostly Positive,80,32,112
904390,True,0,No user reviews,0,0,0
904400,True,7,Positive,22,0,22
904410,True,0,No user reviews,0,0,0
904430,True,0,2 user reviews,2,0,2
904440,True,5,Mixed,22,11,33
904450,True,0,No user reviews,0,0,0
904460,True,0,No user reviews,0,0,0
904490,True,0,No user reviews,0,0,0
904500,True,0,No user reviews,0,0,0
904510,True,0,No user reviews,0,0,0
904520,True,6,Mostly Positive,88,26,114
904530,True,0,4 user reviews,4,0,4
904540,True,8,Very Positive,70,9,79
904550,True,0,1 user reviews,1,0,1
904560,True,0,No user reviews,0,0,0
904570,True,8,Very Positive,56,5,61
904580,True,7,Positive,24,0,24
904590,True,0,No user reviews,0,0,0
904600,True,5,Mixed,5,6,11
904610,True,0,No user reviews,0,0,0
904620,True,0,No user reviews,0,0,0
904640,True,0,No user reviews,0,0,0
904650,True,0,No user reviews,0,0,0
904680,True,0,2 user reviews,1,1,2
904700,True,0,No user reviews,0,0,0
904710,True,0,No user reviews,0,0,0
904730,True,0,No user reviews,0,0,0
904740,True,0,No user reviews,0,0,0
904750,True,0,No user reviews,0,0,0
904770,True,0,2 user reviews,2,0,2
904780,True,5,Mixed,7,4,11
904800,True,0,No user reviews,0,0,0
904810,True,0,2 user reviews,2,0,2
904820,True,0,No user reviews,0,0,0
904840,True,0,No user reviews,0,0,0
904850,True,0,No user reviews,0,0,0
904860,True,0,5 user reviews,2,3,5
904870,True,0,No user reviews,0,0,0
904890,True,5,Mixed,6,6,12
904900,True,5,Mixed,24,12,36
904920,True,0,No user reviews,0,0,0
904930,True,0,2 user reviews,1,1,2
904950,True,0,2 user reviews,0,2,2
904960,True,6,Mostly Positive,95,33,128
904970,True,0,No user reviews,0,0,0
904990,True,5,Mixed,7,5,12
905010,True,0,No user reviews,0,0,0
905020,True,0,2 user reviews,1,1,2
905040,True,0,No user reviews,0,0,0
905050,True,7,Positive,10,2,12
905060,True,0,8 user reviews,2,6,8
905070,True,0,4 user reviews,4,0,4
905090,True,5,Mixed,7,9,16
905100,True,0,No user reviews,0,0,0
905120,True,0,1 user reviews,1,0,1
905130,True,0,2 user reviews,2,0,2
905150,True,0,8 user reviews,4,4,8
905170,True,0,No user reviews,0,0,0
905180,True,0,No user reviews,0,0,0
905190,True,0,No user reviews,0,0,0
905210,True,0,1 user reviews,1,0,1
905220,True,0,4 user reviews,4,0,4
905240,True,0,No user reviews,0,0,0
905250,True,0,No user reviews,0,0,0
905260,True,0,No user reviews,0,0,0
905270,True,0,1 user reviews,0,1,1
905280,True,0,No user reviews,0,0,0
905300,True,0,5 user reviews,1,4,5
905320,True,0,No user reviews,0,0,0
905330,True,0,2 user reviews,2,0,2
905340,True,8,Very Positive,473,17,490
905350,True,0,4 user reviews,4,0,4
905360,True,0,No user reviews,0,0,0
905370,True,5,Mixed,317,179,496
905380,True,0,1 user reviews,1,0,1
905390,True,0,No user reviews,0,0,0
905400,True,0,No user reviews,0,0,0
905420,True,0,No user reviews,0,0,0
905440,True,0,No user reviews,0,0,0
905450,True,5,Mixed,151,67,218
905460,True,0,No user reviews,0,0,0
905470,True,0,No user reviews,0,0,0
905490,True,6,Mostly Positive,69,26,95
905510,True,0,4 user reviews,4,0,4
905520,True,0,2 user reviews,0,2,2
905530,True,0,No user reviews,0,0,0
905540,True,0,No user reviews,0,0,0
905560,True,0,No user reviews,0,0,0
905590,True,0,No user reviews,0,0,0
905630,True,0,1 user reviews,0,1,1
905640,True,0,No user reviews,0,0,0
905650,True,0,No user reviews,0,0,0
905660,True,7,Positive,13,1,14
905670,True,0,No user reviews,0,0,0
905680,True,0,No user reviews,0,0,0
905681,True,0,No user reviews,0,0,0
905682,True,0,5 user reviews,5,0,5
905683,True,0,No user reviews,0,0,0
905684,True,0,No user reviews,0,0,0
905685,True,0,No user reviews,0,0,0
905686,True,0,No user reviews,0,0,0
905687,True,0,No user reviews,0,0,0
905688,True,0,No user reviews,0,0,0
905689,True,0,No user reviews,0,0,0
905690,True,0,2 user reviews,2,0,2
905700,True,0,No user reviews,0,0,0
905701,True,0,No user reviews,0,0,0
905702,True,0,No user reviews,0,0,0
905703,True,0,No user reviews,0,0,0
905704,True,0,2 user reviews,2,0,2
905705,True,0,1 user reviews,1,0,1
905706,True,0,No user reviews,0,0,0
905707,True,0,No user reviews,0,0,0
905708,True,0,No user reviews,0,0,0
905730,True,0,No user reviews,0,0,0
905740,True,0,No user reviews,0,0,0
905750,True,0,No user reviews,0,0,0
905760,True,0,No user reviews,0,0,0
905770,True,0,No user reviews,0,0,0
905780,True,0,No user reviews,0,0,0
905790,True,0,2 user reviews,2,0,2
905800,True,0,7 user reviews,4,3,7
905820,True,0,No user reviews,0,0,0
905840,True,0,No user reviews,0,0,0
905860,True,0,1 user reviews,0,1,1
905870,True,0,3 user reviews,3,0,3
905880,True,0,6 user reviews,5,1,6
905890,True,0,1 user reviews,1,0,1
905960,True,0,1 user reviews,1,0,1
905970,True,0,No user reviews,0,0,0
905980,True,0,No user reviews,0,0,0
905990,True,0,No user reviews,0,0,0
906000,True,5,Mixed,8,7,15
906010,True,0,5 user reviews,4,1,5
906020,True,0,2 user reviews,1,1,2
906030,True,0,No user reviews,0,0,0
906040,True,0,No user reviews,0,0,0
906050,True,6,Mostly Positive,74,27,101
906060,True,0,No user reviews,0,0,0
906100,True,6,Mostly Positive,841,222,1063
906110,True,7,Positive,35,0,35
906120,True,8,Very Positive,102,8,110
906130,True,0,2 user reviews,1,1,2
906160,True,0,2 user reviews,1,1,2
906170,True,0,2 user reviews,1,1,2
906190,True,0,2 user reviews,2,0,2
906200,True,0,No user reviews,0,0,0
906240,True,0,1 user reviews,0,1,1
906250,True,0,2 user reviews,0,2,2
906260,True,0,No user reviews,0,0,0
906280,True,0,5 user reviews,5,0,5
906290,True,0,6 user reviews,6,0,6
906300,True,7,Positive,44,4,48
906310,True,0,2 user reviews,2,0,2
906320,True,0,No user reviews,0,0,0
906360,True,0,3 user reviews,2,1,3
906370,True,0,5 user reviews,5,0,5
906390,True,7,Positive,15,1,16
906430,True,0,No user reviews,0,0,0
906440,True,0,1 user reviews,1,0,1
906460,True,0,No user reviews,0,0,0
906470,True,0,No user reviews,0,0,0
906480,True,0,1 user reviews,1,0,1
906490,True,0,No user reviews,0,0,0
906500,True,0,No user reviews,0,0,0
906510,True,7,Positive,26,4,30
906520,True,0,No user reviews,0,0,0
906530,True,0,No user reviews,0,0,0
906531,True,0,No user reviews,0,0,0
906560,True,0,1 user reviews,0,1,1
906590,True,7,Positive,27,4,31
906600,True,7,Positive,30,0,30
906610,True,0,No user reviews,0,0,0
906630,True,0,1 user reviews,0,1,1
906631,True,0,1 user reviews,1,0,1
906632,True,0,No user reviews,0,0,0
906633,True,0,No user reviews,0,0,0
906634,True,0,No user reviews,0,0,0
906635,True,0,No user reviews,0,0,0
906636,True,0,1 user reviews,0,1,1
906637,True,0,No user reviews,0,0,0
906638,True,0,1 user reviews,1,0,1
906650,True,0,3 user reviews,3,0,3
906660,True,0,7 user reviews,4,3,7
906680,True,0,7 user reviews,5,2,7
906700,True,0,No user reviews,0,0,0
906720,True,0,No user reviews,0,0,0
906730,True,7,Positive,17,2,19
906740,True,5,Mixed,46,20,66
906750,True,0,1 user reviews,0,1,1
906770,True,5,Mixed,8,6,14
906780,True,0,No user reviews,0,0,0
906790,True,5,Mixed,23,16,39
906800,True,0,No user reviews,0,0,0
906810,True,5,Mixed,7,8,15
906820,True,0,No user reviews,0,0,0
906840,True,0,No user reviews,0,0,0
906850,True,0,2 user reviews,2,0,2
906870,True,0,No user reviews,0,0,0
906880,True,0,3 user reviews,3,0,3
906910,True,0,No user reviews,0,0,0
906920,True,5,Mixed,5,6,11
906950,True,0,1 user reviews,1,0,1
907000,True,0,No user reviews,0,0,0
907020,True,0,5 user reviews,3,2,5
907030,True,0,No user reviews,0,0,0
907040,True,0,7 user reviews,5,2,7
907050,True,0,No user reviews,0,0,0
907080,True,0,5 user reviews,4,1,5
907120,True,0,No user reviews,0,0,0
907140,True,0,No user reviews,0,0,0
907150,True,0,3 user reviews,3,0,3
907160,True,0,No user reviews,0,0,0
907170,True,0,No user reviews,0,0,0
907180,True,0,No user reviews,0,0,0
907190,True,0,3 user reviews,3,0,3
907210,True,5,Mixed,18,19,37
907220,True,0,1 user reviews,0,1,1
907230,True,0,1 user reviews,1,0,1
907240,True,0,1 user reviews,1,0,1
907250,True,0,2 user reviews,1,1,2
907270,True,8,Very Positive,67,16,83
907280,True,0,5 user reviews,4,1,5
907290,True,0,No user reviews,0,0,0
907310,True,0,No user reviews,0,0,0
907320,True,0,1 user reviews,1,0,1
907330,True,0,No user reviews,0,0,0
907350,True,0,3 user reviews,2,1,3
907360,True,0,No user reviews,0,0,0
907370,True,8,Very Positive,192,12,204
907380,True,6,Mostly Positive,17,7,24
907390,True,0,No user reviews,0,0,0
907410,True,0,6 user reviews,5,1,6
907420,True,0,1 user reviews,1,0,1
907421,True,0,No user reviews,0,0,0
907430,True,0,No user reviews,0,0,0
907440,True,5,Mixed,11,6,17
907460,True,0,5 user reviews,2,3,5
907470,True,8,Very Positive,153,26,179
907480,True,0,No user reviews,0,0,0
907490,True,0,No user reviews,0,0,0
907500,True,0,No user reviews,0,0,0
907510,True,7,Positive,11,2,13
907520,True,0,No user reviews,0,0,0
907540,True,0,2 user reviews,2,0,2
907560,True,0,3 user reviews,3,0,3
907570,True,0,No user reviews,0,0,0
907571,True,0,No user reviews,0,0,0
907572,True,0,No user reviews,0,0,0
907580,True,0,No user reviews,0,0,0
907590,True,0,5 user reviews,1,4,5
907600,True,0,5 user reviews,5,0,5
907610,True,0,No user reviews,0,0,0
907611,True,0,No user reviews,0,0,0
907613,True,0,No user reviews,0,0,0
907614,True,0,No user reviews,0,0,0
907620,True,0,8 user reviews,7,1,8
907630,True,0,No user reviews,0,0,0
907650,True,0,No user reviews,0,0,0
907670,True,7,Positive,35,0,35
907680,True,5,Mixed,13,8,21
907710,True,5,Mixed,4,6,10
907760,True,8,Very Positive,44,9,53
907770,True,6,Mostly Positive,27,11,38
907780,True,0,No user reviews,0,0,0
907790,True,0,No user reviews,0,0,0
907800,True,0,No user reviews,0,0,0
907820,True,7,Positive,42,5,47
907870,True,0,2 user reviews,1,1,2
907880,True,0,1 user reviews,1,0,1
907881,True,0,3 user reviews,3,0,3
907890,True,0,4 user reviews,3,1,4
907900,True,0,2 user reviews,2,0,2
907910,True,0,No user reviews,0,0,0
907920,True,0,No user reviews,0,0,0
907940,True,0,No user reviews,0,0,0
907950,True,0,7 user reviews,5,2,7
907970,True,0,4 user reviews,2,2,4
907980,True,0,No user reviews,0,0,0
908000,True,0,No user reviews,0,0,0
908010,True,0,1 user reviews,1,0,1
908020,True,0,2 user reviews,2,0,2
908030,True,0,1 user reviews,0,1,1
908040,True,0,No user reviews,0,0,0
908050,True,6,Mostly Positive,19,8,27
908070,True,8,Very Positive,131,16,147
908090,True,0,2 user reviews,0,2,2
908100,True,0,No user reviews,0,0,0
908120,True,0,1 user reviews,1,0,1
908130,True,0,6 user reviews,6,0,6
908150,True,0,1 user reviews,1,0,1
908180,True,7,Positive,8,2,10
908190,True,0,No user reviews,0,0,0
908210,True,5,Mixed,14,8,22
908211,True,0,6 user reviews,5,1,6
908212,True,0,3 user reviews,1,2,3
908213,True,0,7 user reviews,7,0,7
908220,True,0,No user reviews,0,0,0
908221,True,0,1 user reviews,1,0,1
908222,True,0,1 user reviews,1,0,1
908223,True,0,1 user reviews,1,0,1
908224,True,0,1 user reviews,1,0,1
908225,True,0,1 user reviews,1,0,1
908226,True,0,No user reviews,0,0,0
908227,True,0,No user reviews,0,0,0
908230,True,0,4 user reviews,1,3,4
908240,True,0,No user reviews,0,0,0
908250,True,0,No user reviews,0,0,0
908260,True,0,1 user reviews,1,0,1
908270,True,0,No user reviews,0,0,0
908290,True,0,1 user reviews,1,0,1
908310,True,0,4 user reviews,2,2,4
908320,True,0,No user reviews,0,0,0
908330,True,0,No user reviews,0,0,0
908340,True,0,No user reviews,0,0,0
908350,True,0,2 user reviews,2,0,2
908360,True,0,No user reviews,0,0,0
908380,True,0,No user reviews,0,0,0
908390,True,0,No user reviews,0,0,0
908400,True,0,1 user reviews,1,0,1
908420,True,0,No user reviews,0,0,0
908430,True,0,No user reviews,0,0,0
908450,True,0,No user reviews,0,0,0
908460,True,0,5 user reviews,4,1,5
908461,True,0,No user reviews,0,0,0
908470,True,0,No user reviews,0,0,0
908471,True,0,1 user reviews,1,0,1
908472,True,0,1 user reviews,1,0,1
908473,True,0,1 user reviews,1,0,1
908474,True,0,2 user reviews,1,1,2
908480,True,0,No user reviews,0,0,0
908500,True,0,No user reviews,0,0,0
908510,True,0,No user reviews,0,0,0
908520,True,9,Overwhelmingly Positive,530,8,538
908560,True,0,4 user reviews,4,0,4
908570,True,0,No user reviews,0,0,0
908580,True,0,No user reviews,0,0,0
908590,True,0,No user reviews,0,0,0
908620,True,0,1 user reviews,1,0,1
908640,True,0,No user reviews,0,0,0
908650,True,0,No user reviews,0,0,0
908660,True,0,No user reviews,0,0,0
908670,True,0,No user reviews,0,0,0
908680,True,0,No user reviews,0,0,0
908690,True,0,No user reviews,0,0,0
908710,True,0,3 user reviews,2,1,3
908730,True,0,No user reviews,0,0,0
908740,True,5,Mixed,19,18,37
908750,True,0,3 user reviews,3,0,3
908760,True,0,No user reviews,0,0,0
908770,True,0,No user reviews,0,0,0
908790,True,6,Mostly Positive,25,7,32
908810,True,0,No user reviews,0,0,0
908820,True,0,No user reviews,0,0,0
908830,True,0,1 user reviews,1,0,1
908840,True,0,1 user reviews,1,0,1
908860,True,0,No user reviews,0,0,0
908920,True,0,1 user reviews,0,1,1
908940,True,0,No user reviews,0,0,0
908950,True,0,2 user reviews,0,2,2
908960,True,0,No user reviews,0,0,0
908970,True,0,No user reviews,0,0,0
908990,True,7,Positive,13,1,14
909000,True,5,Mixed,21,20,41
909010,True,0,4 user reviews,4,0,4
909020,True,0,No user reviews,0,0,0
909050,True,0,6 user reviews,2,4,6
909080,True,8,Very Positive,83,2,85
909090,True,0,No user reviews,0,0,0
909100,True,0,No user reviews,0,0,0
909110,True,0,No user reviews,0,0,0
909140,True,0,No user reviews,0,0,0
909150,True,7,Positive,43,2,45
909170,True,0,No user reviews,0,0,0
909190,True,0,No user reviews,0,0,0
909200,True,0,1 user reviews,1,0,1
909220,True,7,Positive,9,1,10
909250,True,0,No user reviews,0,0,0
909270,True,0,3 user reviews,2,1,3
909320,True,8,Very Positive,192,37,229
909330,True,0,1 user reviews,1,0,1
909340,True,0,No user reviews,0,0,0
909350,True,0,No user reviews,0,0,0
909360,True,0,No user reviews,0,0,0
909370,True,0,No user reviews,0,0,0
909380,True,0,No user reviews,0,0,0
909390,True,0,No user reviews,0,0,0
909420,True,0,1 user reviews,0,1,1
909430,True,0,No user reviews,0,0,0
909450,True,0,No user reviews,0,0,0
909460,True,0,1 user reviews,1,0,1
909470,True,0,No user reviews,0,0,0
909480,True,0,5 user reviews,3,2,5
909490,True,0,1 user reviews,1,0,1
909500,True,0,No user reviews,0,0,0
909510,True,8,Very Positive,158,37,195
909530,True,0,No user reviews,0,0,0
909550,True,0,No user reviews,0,0,0
909570,True,6,Mostly Positive,17,5,22
909580,True,5,Mixed,4,6,10
909590,True,0,No user reviews,0,0,0
909600,True,0,No user reviews,0,0,0
909610,True,7,Positive,28,0,28
909630,True,5,Mixed,7,5,12
909640,True,7,Positive,16,0,16
909650,True,0,No user reviews,0,0,0
909660,True,8,Very Positive,86,13,99
909670,True,7,Positive,11,2,13
909690,True,0,No user reviews,0,0,0
909720,True,6,Mostly Positive,37,14,51
909730,True,0,No user reviews,0,0,0
909770,True,0,1 user reviews,1,0,1
909780,True,6,Mostly Positive,15,6,21
909790,True,0,No user reviews,0,0,0
909800,True,0,No user reviews,0,0,0
909801,True,0,No user reviews,0,0,0
909802,True,0,No user reviews,0,0,0
909803,True,0,No user reviews,0,0,0
909804,True,0,No user reviews,0,0,0
909805,True,0,No user reviews,0,0,0
909806,True,0,No user reviews,0,0,0
909807,True,0,No user reviews,0,0,0
909808,True,0,No user reviews,0,0,0
909809,True,0,No user reviews,0,0,0
909810,True,0,No user reviews,0,0,0
909820,True,8,Very Positive,87,5,92
909830,True,0,9 user reviews,5,4,9
909850,True,0,4 user reviews,0,4,4
909851,True,0,6 user reviews,6,0,6
909870,True,0,No user reviews,0,0,0
909890,True,0,No user reviews,0,0,0
909900,True,0,No user reviews,0,0,0
909910,True,0,No user reviews,0,0,0
909911,True,0,No user reviews,0,0,0
909912,True,0,No user reviews,0,0,0
909913,True,0,No user reviews,0,0,0
909914,True,0,No user reviews,0,0,0
909915,True,0,No user reviews,0,0,0
909916,True,0,No user reviews,0,0,0
909917,True,0,No user reviews,0,0,0
909918,True,0,No user reviews,0,0,0
909919,True,0,No user reviews,0,0,0
909920,True,0,No user reviews,0,0,0
909921,True,0,No user reviews,0,0,0
909930,True,0,No user reviews,0,0,0
909940,True,0,No user reviews,0,0,0
909941,True,0,No user reviews,0,0,0
909942,True,0,No user reviews,0,0,0
909943,True,0,No user reviews,0,0,0
909944,True,0,No user reviews,0,0,0
909945,True,0,No user reviews,0,0,0
909946,True,0,No user reviews,0,0,0
909947,True,0,No user reviews,0,0,0
909948,True,0,No user reviews,0,0,0
909949,True,0,No user reviews,0,0,0
909950,True,0,No user reviews,0,0,0
909951,True,0,No user reviews,0,0,0
909952,True,0,No user reviews,0,0,0
909953,True,0,No user reviews,0,0,0
909954,True,0,No user reviews,0,0,0
909955,True,0,No user reviews,0,0,0
909956,True,0,No user reviews,0,0,0
909957,True,0,No user reviews,0,0,0
909958,True,0,No user reviews,0,0,0
909959,True,0,No user reviews,0,0,0
909960,True,0,No user reviews,0,0,0
909961,True,0,No user reviews,0,0,0
909962,True,0,No user reviews,0,0,0
909963,True,0,No user reviews,0,0,0
909970,True,4,Mostly Negative,30,71,101
909980,True,0,No user reviews,0,0,0
909990,True,0,No user reviews,0,0,0
909991,True,0,No user reviews,0,0,0
909992,True,0,No user reviews,0,0,0
909993,True,0,No user reviews,0,0,0
909994,True,0,No user reviews,0,0,0
909995,True,0,No user reviews,0,0,0
909996,True,0,No user reviews,0,0,0
909997,True,0,No user reviews,0,0,0
909998,True,0,No user reviews,0,0,0
909999,True,0,No user reviews,0,0,0
910000,True,0,No user reviews,0,0,0
910001,True,0,No user reviews,0,0,0
910002,True,0,No user reviews,0,0,0
910040,True,0,No user reviews,0,0,0
910050,True,0,No user reviews,0,0,0
910150,True,0,6 user reviews,4,2,6
910160,True,0,No user reviews,0,0,0
910180,True,0,No user reviews,0,0,0
910190,True,0,No user reviews,0,0,0
910200,True,0,3 user reviews,1,2,3
910210,True,0,No user reviews,0,0,0
910220,True,0,3 user reviews,1,2,3
910230,True,0,No user reviews,0,0,0
910250,True,0,4 user reviews,2,2,4
910260,True,0,No user reviews,0,0,0
910280,True,0,1 user reviews,1,0,1
910290,True,0,1 user reviews,0,1,1
910320,True,0,No user reviews,0,0,0
910370,True,5,Mixed,5,7,12
910380,True,0,3 user reviews,3,0,3
910390,True,0,1 user reviews,1,0,1
910400,True,0,2 user reviews,1,1,2
910410,True,0,No user reviews,0,0,0
910420,True,0,No user reviews,0,0,0
910430,True,0,9 user reviews,3,6,9
910450,True,5,Mixed,45,41,86
910460,True,0,No user reviews,0,0,0
910470,True,0,7 user reviews,7,0,7
910490,True,5,Mixed,468,226,694
910500,True,0,No user reviews,0,0,0
910530,True,0,4 user reviews,2,2,4
910540,True,0,5 user reviews,4,1,5
910560,True,0,No user reviews,0,0,0
910590,True,0,3 user reviews,1,2,3
910600,True,0,No user reviews,0,0,0
910620,True,0,No user reviews,0,0,0
910630,True,8,Very Positive,195,2,197
910640,True,0,No user reviews,0,0,0
910650,True,0,No user reviews,0,0,0
910660,True,0,7 user reviews,6,1,7
910700,True,0,No user reviews,0,0,0
910710,True,0,No user reviews,0,0,0
910711,True,0,No user reviews,0,0,0
910730,True,0,6 user reviews,6,0,6
910740,True,0,No user reviews,0,0,0
910750,True,0,No user reviews,0,0,0
910760,True,0,No user reviews,0,0,0
910770,True,0,No user reviews,0,0,0
910800,True,0,No user reviews,0,0,0
910820,True,0,1 user reviews,1,0,1
910821,True,0,1 user reviews,1,0,1
910830,True,5,Mixed,105,53,158
910850,True,0,1 user reviews,0,1,1
910880,True,8,Very Positive,109,25,134
910930,True,0,5 user reviews,5,0,5
910931,True,0,No user reviews,0,0,0
910932,True,0,No user reviews,0,0,0
910940,True,5,Mixed,22,10,32
910980,True,0,No user reviews,0,0,0
910990,True,0,5 user reviews,4,1,5
911000,True,0,2 user reviews,2,0,2
911010,True,0,1 user reviews,1,0,1
911020,True,0,No user reviews,0,0,0
911040,True,5,Mixed,6,6,12
911050,True,0,No user reviews,0,0,0
911070,True,0,No user reviews,0,0,0
911080,True,0,No user reviews,0,0,0
911100,True,0,8 user reviews,8,0,8
911120,True,0,9 user reviews,9,0,9
911130,True,0,5 user reviews,1,4,5
911170,True,0,No user reviews,0,0,0
911180,True,0,4 user reviews,2,2,4
911200,True,0,3 user reviews,1,2,3
911210,True,0,4 user reviews,1,3,4
911220,True,8,Very Positive,56,4,60
911230,True,0,4 user reviews,4,0,4
911240,True,0,2 user reviews,2,0,2
911250,True,0,No user reviews,0,0,0
911260,True,0,No user reviews,0,0,0
911270,True,0,1 user reviews,1,0,1
911280,True,0,2 user reviews,0,2,2
911290,True,0,2 user reviews,2,0,2
911310,True,0,5 user reviews,5,0,5
911320,True,0,No user reviews,0,0,0
911380,True,0,No user reviews,0,0,0
911400,True,5,Mixed,556,483,1039
911410,True,0,No user reviews,0,0,0
911420,True,0,4 user reviews,3,1,4
911430,True,6,Mostly Positive,222,80,302
911440,True,0,2 user reviews,1,1,2
911450,True,0,No user reviews,0,0,0
911480,True,0,3 user reviews,3,0,3
911490,True,0,No user reviews,0,0,0
911500,True,0,No user reviews,0,0,0
911510,True,5,Mixed,6,8,14
911520,True,7,Positive,22,1,23
911540,True,0,No user reviews,0,0,0
911550,True,6,Mostly Positive,75,22,97
911580,True,0,2 user reviews,2,0,2
911590,True,0,5 user reviews,2,3,5
911610,True,0,4 user reviews,4,0,4
911630,True,0,No user reviews,0,0,0
911640,True,0,No user reviews,0,0,0
911660,True,0,No user reviews,0,0,0
911680,True,0,6 user reviews,5,1,6
911690,True,0,1 user reviews,1,0,1
911700,True,0,No user reviews,0,0,0
911720,True,0,No user reviews,0,0,0
911760,True,7,Positive,8,2,10
911780,True,0,No user reviews,0,0,0
911820,True,0,No user reviews,0,0,0
911840,True,0,5 user reviews,4,1,5
911850,True,0,No user reviews,0,0,0
911860,True,0,No user reviews,0,0,0
911880,True,0,2 user reviews,0,2,2
911920,True,0,2 user reviews,2,0,2
911930,True,5,Mixed,84,81,165
911950,True,0,2 user reviews,2,0,2
911970,True,0,No user reviews,0,0,0
911980,True,0,No user reviews,0,0,0
911990,True,0,No user reviews,0,0,0
912000,True,0,No user reviews,0,0,0
912010,True,0,No user reviews,0,0,0
912020,True,0,3 user reviews,2,1,3
912070,True,0,1 user reviews,1,0,1
912110,True,5,Mixed,18,11,29
912120,True,0,1 user reviews,0,1,1
912140,True,0,No user reviews,0,0,0
912170,True,7,Positive,10,1,11
912180,True,0,No user reviews,0,0,0
912190,True,6,Mostly Positive,12,5,17
912210,True,0,No user reviews,0,0,0
912240,True,0,No user reviews,0,0,0
912250,True,0,No user reviews,0,0,0
912260,True,0,No user reviews,0,0,0
912270,True,0,8 user reviews,8,0,8
912290,True,0,No user reviews,0,0,0
912310,True,0,No user reviews,0,0,0
912330,True,0,No user reviews,0,0,0
912340,True,0,No user reviews,0,0,0
912350,True,0,No user reviews,0,0,0
912360,True,0,No user reviews,0,0,0
912370,True,6,Mostly Positive,33,11,44
912390,True,0,7 user reviews,7,0,7
912410,True,0,No user reviews,0,0,0
912420,True,0,7 user reviews,3,4,7
912450,True,6,Mostly Positive,22,8,30
912460,True,7,Positive,29,3,32
912470,True,0,3 user reviews,3,0,3
912500,True,0,2 user reviews,2,0,2
912510,True,0,No user reviews,0,0,0
912520,True,0,No user reviews,0,0,0
912540,True,7,Positive,30,1,31
912550,True,7,Positive,18,2,20
912560,True,0,No user reviews,0,0,0
912570,True,8,Very Positive,91,22,113
912580,True,0,2 user reviews,2,0,2
912590,True,0,2 user reviews,1,1,2
912630,True,0,No user reviews,0,0,0
912650,True,0,1 user reviews,1,0,1
912660,True,0,9 user reviews,6,3,9
912690,True,0,No user reviews,0,0,0
912720,True,0,No user reviews,0,0,0
912730,True,0,No user reviews,0,0,0
912760,True,0,3 user reviews,2,1,3
912770,True,0,No user reviews,0,0,0
912780,True,0,No user reviews,0,0,0
912790,True,0,2 user reviews,1,1,2
912810,True,0,No user reviews,0,0,0
912820,True,0,5 user reviews,4,1,5
912830,True,0,No user reviews,0,0,0
912831,True,0,3 user reviews,3,0,3
912832,True,0,No user reviews,0,0,0
912833,True,0,No user reviews,0,0,0
912834,True,0,No user reviews,0,0,0
912835,True,0,No user reviews,0,0,0
912840,True,0,No user reviews,0,0,0
912850,True,0,2 user reviews,2,0,2
912870,True,0,No user reviews,0,0,0
912880,True,0,No user reviews,0,0,0
912900,True,0,3 user reviews,2,1,3
912910,True,0,No user reviews,0,0,0
912920,True,7,Positive,15,0,15
912930,True,7,Positive,19,0,19
912970,True,0,No user reviews,0,0,0
912980,True,0,No user reviews,0,0,0
912990,True,0,No user reviews,0,0,0
913000,True,0,1 user reviews,1,0,1
913010,True,0,No user reviews,0,0,0
913020,True,0,No user reviews,0,0,0
913050,True,0,No user reviews,0,0,0
913060,True,8,Very Positive,196,12,208
913090,True,7,Positive,29,1,30
913100,True,0,9 user reviews,8,1,9
913110,True,7,Positive,27,0,27
913120,True,0,3 user reviews,3,0,3
913130,True,0,4 user reviews,4,0,4
913140,True,0,No user reviews,0,0,0
913150,True,0,1 user reviews,1,0,1
913160,True,0,1 user reviews,1,0,1
913180,True,0,9 user reviews,4,5,9
913210,True,0,1 user reviews,1,0,1
913250,True,0,2 user reviews,0,2,2
913260,True,0,3 user reviews,2,1,3
913270,True,0,No user reviews,0,0,0
913280,True,0,7 user reviews,5,2,7
913320,True,0,No user reviews,0,0,0
913330,True,7,Positive,19,3,22
913340,True,5,Mixed,9,4,13
913350,True,0,1 user reviews,0,1,1
913370,True,0,No user reviews,0,0,0
913380,True,0,No user reviews,0,0,0
913400,True,0,No user reviews,0,0,0
913420,True,0,1 user reviews,1,0,1
913440,True,0,4 user reviews,3,1,4
913460,True,0,No user reviews,0,0,0
913480,True,0,No user reviews,0,0,0
913500,True,0,3 user reviews,3,0,3
913510,True,0,No user reviews,0,0,0
913550,True,0,2 user reviews,2,0,2
913570,True,0,No user reviews,0,0,0
913590,True,7,Positive,14,2,16
913600,True,0,No user reviews,0,0,0
913610,True,0,No user reviews,0,0,0
913611,True,0,No user reviews,0,0,0
913620,True,0,No user reviews,0,0,0
913630,True,0,No user reviews,0,0,0
913650,True,0,4 user reviews,3,1,4
913660,True,0,No user reviews,0,0,0
913670,True,0,3 user reviews,3,0,3
913680,True,0,1 user reviews,1,0,1
913690,True,0,No user reviews,0,0,0
913710,True,5,Mixed,17,8,25
913720,True,0,No user reviews,0,0,0
913730,True,0,No user reviews,0,0,0
913740,True,9,Overwhelmingly Positive,1842,43,1885
913750,True,0,8 user reviews,5,3,8
913770,True,0,1 user reviews,1,0,1
913780,True,2,Very Negative,10,43,53
913810,True,7,Positive,21,0,21
913820,True,5,Mixed,8,12,20
913830,True,0,6 user reviews,4,2,6
913840,True,0,4 user reviews,4,0,4
913850,True,6,Mostly Positive,27,11,38
913890,True,6,Mostly Positive,48,20,68
913900,True,0,No user reviews,0,0,0
913910,True,0,1 user reviews,0,1,1
913920,True,0,No user reviews,0,0,0
913930,True,0,1 user reviews,1,0,1
913970,True,0,3 user reviews,3,0,3
914000,True,7,Positive,16,4,20
914010,True,8,Very Positive,380,74,454
914020,True,8,Very Positive,331,41,372
914030,True,0,No user reviews,0,0,0
914050,True,0,No user reviews,0,0,0
914060,True,0,1 user reviews,1,0,1
914070,True,0,5 user reviews,1,4,5
914080,True,7,Positive,8,2,10
914090,True,0,5 user reviews,3,2,5
914110,True,5,Mixed,23,22,45
914120,True,0,No user reviews,0,0,0
914130,True,0,6 user reviews,1,5,6
914140,True,5,Mixed,24,18,42
914160,True,4,Mostly Negative,5,10,15
914170,True,6,Mostly Positive,54,14,68
914180,True,5,Mixed,12,14,26
914190,True,0,3 user reviews,3,0,3
914200,True,0,5 user reviews,2,3,5
914210,True,0,No user reviews,0,0,0
914220,True,0,4 user reviews,2,2,4
914230,True,0,2 user reviews,1,1,2
914250,True,0,No user reviews,0,0,0
914260,True,8,Very Positive,453,81,534
914270,True,0,No user reviews,0,0,0
914280,True,0,4 user reviews,4,0,4
914290,True,8,Very Positive,86,18,104
914310,True,0,2 user reviews,2,0,2
914320,True,0,No user reviews,0,0,0
914340,True,0,2 user reviews,1,1,2
914350,True,0,1 user reviews,1,0,1
914360,True,0,No user reviews,0,0,0
914390,True,0,No user reviews,0,0,0
914400,True,7,Positive,22,4,26
914410,True,0,No user reviews,0,0,0
914420,True,0,1 user reviews,1,0,1
914430,True,0,No user reviews,0,0,0
914440,True,0,1 user reviews,1,0,1
914450,True,0,No user reviews,0,0,0
914460,True,0,No user reviews,0,0,0
914480,True,0,1 user reviews,1,0,1
914490,True,0,No user reviews,0,0,0
914500,True,0,6 user reviews,3,3,6
914510,True,0,No user reviews,0,0,0
914520,True,0,No user reviews,0,0,0
914540,True,0,2 user reviews,2,0,2
914560,True,0,No user reviews,0,0,0
914570,True,0,No user reviews,0,0,0
914600,True,0,No user reviews,0,0,0
914620,True,6,Mostly Positive,2701,698,3399
914630,True,0,5 user reviews,3,2,5
914640,True,5,Mixed,7,4,11
914660,True,0,No user reviews,0,0,0
914661,True,0,No user reviews,0,0,0
914662,True,0,1 user reviews,1,0,1
914680,True,0,4 user reviews,1,3,4
914690,True,6,Mostly Positive,129,38,167
914700,True,0,1 user reviews,1,0,1
914710,True,9,Overwhelmingly Positive,492,13,505
914750,True,0,No user reviews,0,0,0
914770,True,0,No user reviews,0,0,0
914780,True,0,No user reviews,0,0,0
914790,True,0,No user reviews,0,0,0
914800,True,8,Very Positive,697,48,745
914810,True,0,No user reviews,0,0,0
914820,True,0,No user reviews,0,0,0
914830,True,0,No user reviews,0,0,0
914831,True,0,No user reviews,0,0,0
914840,True,0,1 user reviews,0,1,1
914850,True,8,Very Positive,46,6,52
914870,True,0,No user reviews,0,0,0
914890,True,0,No user reviews,0,0,0
914900,True,0,1 user reviews,1,0,1
914950,True,5,Mixed,9,5,14
914970,True,5,Mixed,20,16,36
914990,True,0,No user reviews,0,0,0
915000,True,0,No user reviews,0,0,0
915020,True,0,3 user reviews,3,0,3
915050,True,0,No user reviews,0,0,0
915060,True,0,No user reviews,0,0,0
915070,True,0,No user reviews,0,0,0
915080,True,0,8 user reviews,7,1,8
915090,True,0,3 user reviews,3,0,3
915100,True,0,No user reviews,0,0,0
915120,True,0,1 user reviews,1,0,1
915130,True,7,Positive,10,0,10
915140,True,7,Positive,40,4,44
915160,True,0,7 user reviews,6,1,7
915170,True,0,1 user reviews,0,1,1
915180,True,0,No user reviews,0,0,0
915190,True,0,No user reviews,0,0,0
915200,True,7,Positive,8,2,10
915210,True,0,No user reviews,0,0,0
915230,True,0,No user reviews,0,0,0
915250,True,0,No user reviews,0,0,0
915300,True,0,1 user reviews,1,0,1
915320,True,0,No user reviews,0,0,0
915330,True,7,Positive,17,3,20
915340,True,0,No user reviews,0,0,0
915350,True,0,No user reviews,0,0,0
915360,True,0,1 user reviews,1,0,1
915380,True,0,2 user reviews,2,0,2
915390,True,0,3 user reviews,2,1,3
915420,True,0,2 user reviews,2,0,2
915430,True,0,No user reviews,0,0,0
915440,True,5,Mixed,7,5,12
915460,True,8,Very Positive,680,49,729
915480,True,0,No user reviews,0,0,0
915490,True,5,Mixed,39,22,61
915520,True,0,No user reviews,0,0,0
915540,True,0,5 user reviews,3,2,5
915560,True,0,4 user reviews,3,1,4
915570,True,0,No user reviews,0,0,0
915580,True,0,No user reviews,0,0,0
915590,True,0,1 user reviews,1,0,1
915591,True,0,No user reviews,0,0,0
915600,True,8,Very Positive,96,14,110
915610,True,0,No user reviews,0,0,0
915630,True,5,Mixed,4,6,10
915631,True,0,2 user reviews,2,0,2
915650,True,0,3 user reviews,1,2,3
915652,True,5,Mixed,15,17,32
915653,True,4,Mostly Negative,5,8,13
915660,True,0,No user reviews,0,0,0
915661,True,0,No user reviews,0,0,0
915670,True,5,Mixed,47,46,93
915690,True,0,No user reviews,0,0,0
915710,True,5,Mixed,17,13,30
915720,True,0,No user reviews,0,0,0
915730,True,0,3 user reviews,3,0,3
915760,True,0,No user reviews,0,0,0
915770,True,0,No user reviews,0,0,0
915810,True,0,No user reviews,0,0,0
915820,True,0,5 user reviews,5,0,5
915850,True,0,4 user reviews,4,0,4
915860,True,0,1 user reviews,1,0,1
915870,True,0,No user reviews,0,0,0
915890,True,0,No user reviews,0,0,0
915930,True,0,2 user reviews,2,0,2
915960,True,0,No user reviews,0,0,0
915980,True,0,No user reviews,0,0,0
915990,True,0,No user reviews,0,0,0
916000,True,8,Very Positive,81,13,94
916010,True,0,2 user reviews,2,0,2
916030,True,0,7 user reviews,7,0,7
916040,True,7,Positive,32,1,33
916050,True,0,5 user reviews,4,1,5
916060,True,7,Positive,26,3,29
916070,True,0,1 user reviews,1,0,1
916071,True,0,1 user reviews,0,1,1
916100,True,6,Mostly Positive,20,8,28
916110,True,0,No user reviews,0,0,0
916120,True,0,No user reviews,0,0,0
916130,True,0,No user reviews,0,0,0
916150,True,0,No user reviews,0,0,0
916160,True,6,Mostly Positive,17,7,24
916170,True,0,No user reviews,0,0,0
916180,True,0,8 user reviews,6,2,8
916190,True,0,9 user reviews,8,1,9
916200,True,0,No user reviews,0,0,0
916220,True,0,2 user reviews,2,0,2
916240,True,0,5 user reviews,5,0,5
916260,True,0,3 user reviews,0,3,3
916280,True,0,2 user reviews,2,0,2
916290,True,0,3 user reviews,3,0,3
916300,True,0,No user reviews,0,0,0
916320,True,0,8 user reviews,8,0,8
916330,True,0,No user reviews,0,0,0
916340,True,0,1 user reviews,0,1,1
916360,True,0,No user reviews,0,0,0
916361,True,0,No user reviews,0,0,0
916370,True,0,1 user reviews,1,0,1
916380,True,0,5 user reviews,4,1,5
916390,True,0,No user reviews,0,0,0
916410,True,0,3 user reviews,2,1,3
916420,True,0,No user reviews,0,0,0
916430,True,4,Mostly Negative,44,79,123
916431,True,0,No user reviews,0,0,0
916440,True,8,Very Positive,932,168,1100
916451,True,0,No user reviews,0,0,0
916452,True,0,No user reviews,0,0,0
916470,True,0,1 user reviews,0,1,1
916500,True,0,No user reviews,0,0,0
916510,True,0,6 user reviews,4,2,6
916530,True,0,No user reviews,0,0,0
916540,True,0,4 user reviews,3,1,4
916570,True,0,No user reviews,0,0,0
916580,True,7,Positive,9,2,11
916590,True,0,No user reviews,0,0,0
916600,True,0,1 user reviews,1,0,1
916630,True,0,No user reviews,0,0,0
916640,True,0,4 user reviews,0,4,4
916650,True,0,No user reviews,0,0,0
916660,True,0,No user reviews,0,0,0
916661,True,0,No user reviews,0,0,0
916662,True,0,No user reviews,0,0,0
916663,True,0,No user reviews,0,0,0
916664,True,0,No user reviews,0,0,0
916665,True,0,No user reviews,0,0,0
916666,True,0,No user reviews,0,0,0
916667,True,0,No user reviews,0,0,0
916668,True,0,No user reviews,0,0,0
916669,True,0,No user reviews,0,0,0
916670,True,0,No user reviews,0,0,0
916671,True,0,No user reviews,0,0,0
916672,True,0,No user reviews,0,0,0
916673,True,0,No user reviews,0,0,0
916674,True,0,No user reviews,0,0,0
916675,True,0,No user reviews,0,0,0
916676,True,0,No user reviews,0,0,0
916677,True,0,No user reviews,0,0,0
916678,True,0,No user reviews,0,0,0
916679,True,0,No user reviews,0,0,0
916680,True,0,No user reviews,0,0,0
916681,True,0,No user reviews,0,0,0
916682,True,0,No user reviews,0,0,0
916683,True,0,No user reviews,0,0,0
916690,True,0,No user reviews,0,0,0
916720,True,0,No user reviews,0,0,0
916730,True,8,Very Positive,788,42,830
916760,True,0,No user reviews,0,0,0
916771,True,0,2 user reviews,1,1,2
916772,True,0,No user reviews,0,0,0
916780,True,0,3 user reviews,2,1,3
916820,True,0,No user reviews,0,0,0
916840,True,8,Very Positive,2270,285,2555
916850,True,0,No user reviews,0,0,0
916860,True,0,5 user reviews,1,4,5
916880,True,0,1 user reviews,0,1,1
916900,True,8,Very Positive,51,6,57
916910,True,0,No user reviews,0,0,0
916920,True,0,No user reviews,0,0,0
916930,True,5,Mixed,65,86,151
916950,True,7,Positive,13,1,14
916960,True,0,4 user reviews,4,0,4
916970,True,0,No user reviews,0,0,0
917000,True,5,Mixed,7,4,11
917010,True,0,No user reviews,0,0,0
917011,True,0,No user reviews,0,0,0
917012,True,0,No user reviews,0,0,0
917013,True,0,7 user reviews,7,0,7
917014,True,0,1 user reviews,1,0,1
917015,True,0,No user reviews,0,0,0
917016,True,0,No user reviews,0,0,0
917017,True,0,No user reviews,0,0,0
917018,True,0,No user reviews,0,0,0
917019,True,0,No user reviews,0,0,0
917020,True,0,No user reviews,0,0,0
917030,True,0,No user reviews,0,0,0
917031,True,0,No user reviews,0,0,0
917032,True,0,No user reviews,0,0,0
917033,True,0,No user reviews,0,0,0
917040,True,0,No user reviews,0,0,0
917050,True,0,1 user reviews,0,1,1
917080,True,0,2 user reviews,2,0,2
917090,True,0,3 user reviews,1,2,3
917110,True,0,No user reviews,0,0,0
917130,True,0,1 user reviews,1,0,1
917140,True,0,No user reviews,0,0,0
917150,True,6,Mostly Positive,311,116,427
917170,True,0,No user reviews,0,0,0
917190,True,0,4 user reviews,4,0,4
917200,True,0,5 user reviews,2,3,5
917210,True,0,No user reviews,0,0,0
917220,True,0,No user reviews,0,0,0
917240,True,0,No user reviews,0,0,0
917250,True,0,No user reviews,0,0,0
917260,True,0,No user reviews,0,0,0
917280,True,0,No user reviews,0,0,0
917290,True,8,Very Positive,73,1,74
917310,True,0,No user reviews,0,0,0
917330,True,0,No user reviews,0,0,0
917331,True,0,No user reviews,0,0,0
917332,True,0,No user reviews,0,0,0
917333,True,0,No user reviews,0,0,0
917334,True,0,No user reviews,0,0,0
917335,True,0,No user reviews,0,0,0
917336,True,0,No user reviews,0,0,0
917337,True,0,No user reviews,0,0,0
917338,True,0,No user reviews,0,0,0
917339,True,0,No user reviews,0,0,0
917340,True,0,No user reviews,0,0,0
917341,True,0,No user reviews,0,0,0
917342,True,0,No user reviews,0,0,0
917350,True,0,No user reviews,0,0,0
917360,True,0,No user reviews,0,0,0
917380,True,0,6 user reviews,6,0,6
917390,True,7,Positive,14,2,16
917400,True,0,No user reviews,0,0,0
917410,True,0,No user reviews,0,0,0
917411,True,0,No user reviews,0,0,0
917412,True,0,No user reviews,0,0,0
917413,True,0,No user reviews,0,0,0
917414,True,0,No user reviews,0,0,0
917415,True,0,No user reviews,0,0,0
917416,True,0,No user reviews,0,0,0
917417,True,0,No user reviews,0,0,0
917418,True,0,No user reviews,0,0,0
917419,True,0,No user reviews,0,0,0
917420,True,0,No user reviews,0,0,0
917421,True,0,No user reviews,0,0,0
917422,True,0,No user reviews,0,0,0
917423,True,0,No user reviews,0,0,0
917424,True,0,No user reviews,0,0,0
917425,True,0,No user reviews,0,0,0
917426,True,0,No user reviews,0,0,0
917427,True,0,No user reviews,0,0,0
917428,True,0,No user reviews,0,0,0
917429,True,0,No user reviews,0,0,0
917430,True,0,No user reviews,0,0,0
917431,True,0,No user reviews,0,0,0
917432,True,0,No user reviews,0,0,0
917440,True,0,No user reviews,0,0,0
917441,True,0,No user reviews,0,0,0
917442,True,0,No user reviews,0,0,0
917443,True,0,No user reviews,0,0,0
917444,True,0,No user reviews,0,0,0
917445,True,0,No user reviews,0,0,0
917446,True,0,No user reviews,0,0,0
917447,True,0,No user reviews,0,0,0
917448,True,0,No user reviews,0,0,0
917449,True,0,No user reviews,0,0,0
917450,True,0,No user reviews,0,0,0
917451,True,0,No user reviews,0,0,0
917452,True,0,No user reviews,0,0,0
917453,True,0,No user reviews,0,0,0
917454,True,0,No user reviews,0,0,0
917455,True,0,No user reviews,0,0,0
917456,True,0,No user reviews,0,0,0
917457,True,0,No user reviews,0,0,0
917458,True,0,No user reviews,0,0,0
917459,True,0,No user reviews,0,0,0
917460,True,0,No user reviews,0,0,0
917461,True,0,No user reviews,0,0,0
917462,True,0,No user reviews,0,0,0
917463,True,0,No user reviews,0,0,0
917470,True,0,No user reviews,0,0,0
917490,True,0,No user reviews,0,0,0
917500,True,0,1 user reviews,1,0,1
917510,True,0,No user reviews,0,0,0
917511,True,0,No user reviews,0,0,0
917512,True,0,No user reviews,0,0,0
917513,True,0,No user reviews,0,0,0
917514,True,0,No user reviews,0,0,0
917515,True,0,No user reviews,0,0,0
917516,True,0,No user reviews,0,0,0
917517,True,0,No user reviews,0,0,0
917518,True,0,No user reviews,0,0,0
917519,True,0,No user reviews,0,0,0
917520,True,0,No user reviews,0,0,0
917521,True,0,No user reviews,0,0,0
917530,True,0,No user reviews,0,0,0
917531,True,0,No user reviews,0,0,0
917532,True,0,No user reviews,0,0,0
917533,True,0,No user reviews,0,0,0
917534,True,0,No user reviews,0,0,0
917535,True,0,No user reviews,0,0,0
917536,True,0,No user reviews,0,0,0
917537,True,0,No user reviews,0,0,0
917538,True,0,No user reviews,0,0,0
917539,True,0,No user reviews,0,0,0
917540,True,0,No user reviews,0,0,0
917541,True,0,No user reviews,0,0,0
917550,True,0,No user reviews,0,0,0
917590,True,0,No user reviews,0,0,0
917600,True,0,4 user reviews,1,3,4
917610,True,0,No user reviews,0,0,0
917630,True,0,No user reviews,0,0,0
917640,True,0,No user reviews,0,0,0
917680,True,0,No user reviews,0,0,0
917690,True,7,Positive,12,0,12
917710,True,0,No user reviews,0,0,0
917720,True,0,No user reviews,0,0,0
917740,True,8,Very Positive,60,9,69
917760,True,0,No user reviews,0,0,0
917770,True,0,1 user reviews,1,0,1
917780,True,0,No user reviews,0,0,0
917800,True,0,1 user reviews,0,1,1
917810,True,0,1 user reviews,1,0,1
917820,True,0,No user reviews,0,0,0
917830,True,0,9 user reviews,7,2,9
917840,True,8,Very Positive,128,5,133
917850,True,6,Mostly Positive,7,3,10
917870,True,0,1 user reviews,1,0,1
917880,True,0,No user reviews,0,0,0
917890,True,0,1 user reviews,0,1,1
917900,True,0,1 user reviews,1,0,1
917910,True,0,5 user reviews,4,1,5
917920,True,8,Very Positive,42,9,51
917930,True,0,No user reviews,0,0,0
917940,True,0,No user reviews,0,0,0
917970,True,0,No user reviews,0,0,0
917990,True,0,No user reviews,0,0,0
918000,True,0,No user reviews,0,0,0
918060,True,0,6 user reviews,3,3,6
918070,True,6,Mostly Positive,19,7,26
918080,True,0,9 user reviews,5,4,9
918100,True,0,No user reviews,0,0,0
918110,True,0,5 user reviews,5,0,5
918150,True,0,No user reviews,0,0,0
918151,True,0,No user reviews,0,0,0
918160,True,0,No user reviews,0,0,0
918170,True,0,No user reviews,0,0,0
918180,True,0,8 user reviews,7,1,8
918190,True,0,No user reviews,0,0,0
918200,True,0,No user reviews,0,0,0
918210,True,0,No user reviews,0,0,0
918260,True,0,3 user reviews,2,1,3
918270,True,0,No user reviews,0,0,0
918290,True,0,No user reviews,0,0,0
918300,True,0,1 user reviews,1,0,1
918310,True,0,No user reviews,0,0,0
918320,True,0,4 user reviews,2,2,4
918330,True,0,No user reviews,0,0,0
918331,True,0,No user reviews,0,0,0
918332,True,0,No user reviews,0,0,0
918333,True,0,No user reviews,0,0,0
918334,True,0,No user reviews,0,0,0
918335,True,0,No user reviews,0,0,0
918336,True,0,No user reviews,0,0,0
918337,True,0,No user reviews,0,0,0
918338,True,0,No user reviews,0,0,0
918339,True,0,No user reviews,0,0,0
918340,True,0,No user reviews,0,0,0
918341,True,0,No user reviews,0,0,0
918342,True,0,No user reviews,0,0,0
918343,True,0,No user reviews,0,0,0
918344,True,0,No user reviews,0,0,0
918345,True,0,No user reviews,0,0,0
918346,True,0,No user reviews,0,0,0
918347,True,0,No user reviews,0,0,0
918348,True,0,No user reviews,0,0,0
918349,True,0,No user reviews,0,0,0
918360,True,0,No user reviews,0,0,0
918380,True,8,Very Positive,98,8,106
918390,True,0,No user reviews,0,0,0
918400,True,0,No user reviews,0,0,0
918410,True,0,No user reviews,0,0,0
918420,True,0,No user reviews,0,0,0
918430,True,6,Mostly Positive,15,5,20
918440,True,0,1 user reviews,0,1,1
918450,True,0,1 user reviews,1,0,1
918460,True,0,No user reviews,0,0,0
918470,True,0,No user reviews,0,0,0
918480,True,0,No user reviews,0,0,0
918490,True,0,6 user reviews,6,0,6
918500,True,0,8 user reviews,7,1,8
918520,True,0,No user reviews,0,0,0
918530,True,8,Very Positive,88,7,95
918540,True,0,No user reviews,0,0,0
918550,True,0,No user reviews,0,0,0
918590,True,4,Mostly Negative,3,7,10
918610,True,0,1 user reviews,0,1,1
918620,True,0,1 user reviews,1,0,1
918640,True,0,No user reviews,0,0,0
918650,True,0,No user reviews,0,0,0
918660,True,0,No user reviews,0,0,0
918670,True,7,Positive,29,0,29
918680,True,0,5 user reviews,2,3,5
918690,True,0,2 user reviews,2,0,2
918700,True,0,1 user reviews,1,0,1
918710,True,0,No user reviews,0,0,0
918720,True,0,2 user reviews,0,2,2
918740,True,0,2 user reviews,2,0,2
918760,True,0,No user reviews,0,0,0
918770,True,0,No user reviews,0,0,0
918792,True,0,1 user reviews,1,0,1
918793,True,0,2 user reviews,1,1,2
918794,True,0,1 user reviews,1,0,1
918795,True,0,No user reviews,0,0,0
918800,True,0,No user reviews,0,0,0
918810,True,0,No user reviews,0,0,0
918820,True,8,Very Positive,293,20,313
918830,True,0,No user reviews,0,0,0
918850,True,0,No user reviews,0,0,0
918870,True,0,1 user reviews,0,1,1
918900,True,5,Mixed,5,6,11
918950,True,7,Positive,11,2,13
918970,True,3,Negative,3,14,17
918980,True,0,No user reviews,0,0,0
918990,True,6,Mostly Positive,26,7,33
919000,True,0,7 user reviews,6,1,7
919020,True,0,No user reviews,0,0,0
919021,True,0,No user reviews,0,0,0
919022,True,0,No user reviews,0,0,0
919023,True,0,No user reviews,0,0,0
919024,True,0,No user reviews,0,0,0
919025,True,0,No user reviews,0,0,0
919026,True,0,No user reviews,0,0,0
919027,True,0,No user reviews,0,0,0
919028,True,0,No user reviews,0,0,0
919029,True,0,No user reviews,0,0,0
919030,True,0,No user reviews,0,0,0
919031,True,0,No user reviews,0,0,0
919032,True,0,No user reviews,0,0,0
919040,True,0,1 user reviews,0,1,1
919050,True,0,6 user reviews,5,1,6
919051,True,0,2 user reviews,2,0,2
919070,True,0,1 user reviews,1,0,1
919080,True,0,No user reviews,0,0,0
919081,True,0,No user reviews,0,0,0
919082,True,0,No user reviews,0,0,0
919083,True,0,No user reviews,0,0,0
919084,True,0,No user reviews,0,0,0
919085,True,0,No user reviews,0,0,0
919086,True,0,No user reviews,0,0,0
919087,True,0,No user reviews,0,0,0
919088,True,0,No user reviews,0,0,0
919089,True,0,No user reviews,0,0,0
919090,True,0,No user reviews,0,0,0
919091,True,0,No user reviews,0,0,0
919092,True,0,No user reviews,0,0,0
919140,True,0,2 user reviews,1,1,2
919150,True,0,4 user reviews,3,1,4
919160,True,6,Mostly Positive,13,4,17
919170,True,0,No user reviews,0,0,0
919180,True,0,1 user reviews,1,0,1
919190,True,0,No user reviews,0,0,0
919200,True,0,8 user reviews,5,3,8
919210,True,0,No user reviews,0,0,0
919220,True,5,Mixed,26,15,41
919230,True,0,No user reviews,0,0,0
919240,True,0,1 user reviews,0,1,1
919260,True,8,Very Positive,64,11,75
919280,True,5,Mixed,132,100,232
919300,True,0,7 user reviews,5,2,7
919310,True,0,No user reviews,0,0,0
919320,True,0,8 user reviews,8,0,8
919330,True,0,No user reviews,0,0,0
919340,True,0,3 user reviews,3,0,3
919360,True,0,No user reviews,0,0,0
919370,True,6,Mostly Positive,169,47,216
919390,True,6,Mostly Positive,28,9,37
919400,True,0,2 user reviews,2,0,2
919410,True,6,Mostly Positive,28,8,36
919420,True,0,No user reviews,0,0,0
919440,True,0,No user reviews,0,0,0
919450,True,0,4 user reviews,4,0,4
919520,True,0,No user reviews,0,0,0
919560,True,5,Mixed,10,5,15
919610,True,0,No user reviews,0,0,0
919640,True,6,Mostly Positive,1339,377,1716
919670,True,0,No user reviews,0,0,0
919680,True,8,Very Positive,223,20,243
919690,True,0,4 user reviews,1,3,4
919700,True,0,No user reviews,0,0,0
919720,True,5,Mixed,7,4,11
919730,True,0,No user reviews,0,0,0
919740,True,0,No user reviews,0,0,0
919770,True,7,Positive,10,0,10
919890,True,0,4 user reviews,4,0,4
919990,True,0,No user reviews,0,0,0
920000,True,0,No user reviews,0,0,0
920070,True,0,No user reviews,0,0,0
920080,True,0,No user reviews,0,0,0
920090,True,0,No user reviews,0,0,0
920100,True,0,No user reviews,0,0,0
920110,True,0,No user reviews,0,0,0
920111,True,0,No user reviews,0,0,0
920112,True,0,No user reviews,0,0,0
920113,True,0,No user reviews,0,0,0
920114,True,0,No user reviews,0,0,0
920115,True,0,No user reviews,0,0,0
920116,True,0,No user reviews,0,0,0
920117,True,0,No user reviews,0,0,0
920118,True,0,No user reviews,0,0,0
920119,True,0,No user reviews,0,0,0
920120,True,0,No user reviews,0,0,0
920121,True,0,No user reviews,0,0,0
920122,True,0,No user reviews,0,0,0
920140,True,0,No user reviews,0,0,0
920141,True,0,No user reviews,0,0,0
920142,True,0,No user reviews,0,0,0
920143,True,0,No user reviews,0,0,0
920144,True,0,No user reviews,0,0,0
920145,True,0,No user reviews,0,0,0
920146,True,0,No user reviews,0,0,0
920147,True,0,No user reviews,0,0,0
920148,True,0,No user reviews,0,0,0
920149,True,0,No user reviews,0,0,0
920150,True,0,No user reviews,0,0,0
920151,True,0,No user reviews,0,0,0
920152,True,0,No user reviews,0,0,0
920190,True,0,No user reviews,0,0,0
920200,True,7,Positive,15,0,15
920280,True,0,3 user reviews,3,0,3
920320,True,8,Very Positive,199,15,214
920330,True,0,No user reviews,0,0,0
920331,True,0,No user reviews,0,0,0
920332,True,0,No user reviews,0,0,0
920333,True,0,No user reviews,0,0,0
920334,True,0,No user reviews,0,0,0
920335,True,0,No user reviews,0,0,0
920336,True,0,No user reviews,0,0,0
920337,True,0,No user reviews,0,0,0
920338,True,0,No user reviews,0,0,0
920339,True,0,No user reviews,0,0,0
920340,True,0,No user reviews,0,0,0
920341,True,0,No user reviews,0,0,0
920342,True,0,No user reviews,0,0,0
920350,True,0,2 user reviews,2,0,2
920351,True,0,No user reviews,0,0,0
920352,True,0,4 user reviews,4,0,4
920353,True,0,2 user reviews,2,0,2
920370,True,0,No user reviews,0,0,0
920371,True,0,No user reviews,0,0,0
920372,True,0,No user reviews,0,0,0
920373,True,0,No user reviews,0,0,0
920374,True,0,No user reviews,0,0,0
920375,True,0,No user reviews,0,0,0
920376,True,0,No user reviews,0,0,0
920377,True,0,No user reviews,0,0,0
920378,True,0,No user reviews,0,0,0
920379,True,0,No user reviews,0,0,0
920380,True,0,No user reviews,0,0,0
920381,True,0,No user reviews,0,0,0
920382,True,0,No user reviews,0,0,0
920390,True,0,No user reviews,0,0,0
920391,True,0,No user reviews,0,0,0
920392,True,0,No user reviews,0,0,0
920393,True,0,No user reviews,0,0,0
920394,True,0,No user reviews,0,0,0
920395,True,0,No user reviews,0,0,0
920396,True,0,No user reviews,0,0,0
920397,True,0,No user reviews,0,0,0
920398,True,0,No user reviews,0,0,0
920399,True,0,No user reviews,0,0,0
920400,True,0,No user reviews,0,0,0
920401,True,0,No user reviews,0,0,0
920410,True,0,No user reviews,0,0,0
920411,True,0,No user reviews,0,0,0
920412,True,0,No user reviews,0,0,0
920413,True,0,No user reviews,0,0,0
920414,True,0,No user reviews,0,0,0
920415,True,0,No user reviews,0,0,0
920416,True,0,No user reviews,0,0,0
920417,True,0,No user reviews,0,0,0
920418,True,0,No user reviews,0,0,0
920419,True,0,No user reviews,0,0,0
920420,True,0,No user reviews,0,0,0
920421,True,0,No user reviews,0,0,0
920422,True,0,No user reviews,0,0,0
920430,True,0,No user reviews,0,0,0
920450,True,0,No user reviews,0,0,0
920460,True,7,Positive,33,7,40
920470,True,0,No user reviews,0,0,0
920490,True,7,Positive,15,1,16
920500,True,0,No user reviews,0,0,0
920510,True,0,5 user reviews,4,1,5
920520,True,7,Positive,24,5,29
920530,True,0,2 user reviews,1,1,2
920560,True,7,Positive,22,1,23
920561,True,7,Positive,25,3,28
920562,True,6,Mostly Positive,18,7,25
920563,True,7,Positive,19,2,21
920564,True,7,Positive,48,1,49
920565,True,0,No user reviews,0,0,0
920566,True,0,No user reviews,0,0,0
920567,True,8,Very Positive,102,16,118
920568,True,7,Positive,33,8,41
920571,True,8,Very Positive,126,8,134
920580,True,0,No user reviews,0,0,0
920590,True,0,No user reviews,0,0,0
920591,True,0,No user reviews,0,0,0
920592,True,0,No user reviews,0,0,0
920593,True,0,No user reviews,0,0,0
920594,True,0,No user reviews,0,0,0
920595,True,0,No user reviews,0,0,0
920596,True,0,No user reviews,0,0,0
920597,True,0,No user reviews,0,0,0
920598,True,0,No user reviews,0,0,0
920601,True,0,No user reviews,0,0,0
920620,True,0,4 user reviews,3,1,4
920630,True,5,Mixed,16,11,27
920640,True,0,No user reviews,0,0,0
920650,True,0,No user reviews,0,0,0
920680,True,8,Very Positive,211,52,263
920690,True,5,Mixed,392,273,665
920700,True,0,1 user reviews,1,0,1
920710,True,0,2 user reviews,0,2,2
920730,True,0,No user reviews,0,0,0
920770,True,0,8 user reviews,7,1,8
920780,True,0,2 user reviews,1,1,2
920800,True,0,1 user reviews,1,0,1
920820,True,0,1 user reviews,0,1,1
920840,True,5,Mixed,45,46,91
920870,True,0,2 user reviews,2,0,2
920880,True,0,1 user reviews,1,0,1
920890,True,0,1 user reviews,1,0,1
920891,True,0,No user reviews,0,0,0
920892,True,0,No user reviews,0,0,0
920893,True,0,No user reviews,0,0,0
920894,True,0,No user reviews,0,0,0
920895,True,0,No user reviews,0,0,0
920896,True,0,No user reviews,0,0,0
920897,True,0,No user reviews,0,0,0
920898,True,0,No user reviews,0,0,0
920899,True,0,No user reviews,0,0,0
920900,True,0,No user reviews,0,0,0
920901,True,0,No user reviews,0,0,0
920930,True,0,1 user reviews,1,0,1
920931,True,0,No user reviews,0,0,0
920932,True,0,No user reviews,0,0,0
920933,True,0,No user reviews,0,0,0
920934,True,0,No user reviews,0,0,0
920935,True,0,No user reviews,0,0,0
920936,True,0,No user reviews,0,0,0
920937,True,0,No user reviews,0,0,0
920938,True,0,No user reviews,0,0,0
920939,True,0,No user reviews,0,0,0
920940,True,0,No user reviews,0,0,0
920941,True,0,No user reviews,0,0,0
920960,True,0,7 user reviews,4,3,7
921010,True,0,No user reviews,0,0,0
921050,True,0,1 user reviews,0,1,1
921060,True,0,No user reviews,0,0,0
921070,True,0,No user reviews,0,0,0
921090,True,0,No user reviews,0,0,0
921120,True,0,No user reviews,0,0,0
921130,True,0,No user reviews,0,0,0
921140,True,0,No user reviews,0,0,0
921150,True,0,No user reviews,0,0,0
921160,True,0,No user reviews,0,0,0
921180,True,0,No user reviews,0,0,0
921190,True,0,No user reviews,0,0,0
921230,True,0,No user reviews,0,0,0
921240,True,0,No user reviews,0,0,0
921250,True,0,No user reviews,0,0,0
921260,True,0,No user reviews,0,0,0
921290,True,0,No user reviews,0,0,0
921300,True,0,No user reviews,0,0,0
921310,True,0,No user reviews,0,0,0
921330,True,0,No user reviews,0,0,0
921340,True,0,No user reviews,0,0,0
921360,True,0,No user reviews,0,0,0
921370,True,0,No user reviews,0,0,0
921390,True,6,Mostly Positive,30,12,42
921410,True,0,No user reviews,0,0,0
921420,True,0,2 user reviews,2,0,2
921430,True,7,Positive,33,1,34
921450,True,0,3 user reviews,2,1,3
921460,True,0,No user reviews,0,0,0
921480,True,0,No user reviews,0,0,0
921481,True,0,1 user reviews,1,0,1
921482,True,0,2 user reviews,2,0,2
921483,True,0,No user reviews,0,0,0
921484,True,0,No user reviews,0,0,0
921485,True,0,No user reviews,0,0,0
921486,True,0,No user reviews,0,0,0
921487,True,0,No user reviews,0,0,0
921488,True,0,No user reviews,0,0,0
921489,True,0,No user reviews,0,0,0
921500,True,5,Mixed,6,4,10
921520,True,0,4 user reviews,3,1,4
921530,True,5,Mixed,34,19,53
921540,True,0,7 user reviews,6,1,7
921541,True,0,No user reviews,0,0,0
921542,True,0,4 user reviews,4,0,4
921543,True,0,No user reviews,0,0,0
921550,True,0,No user reviews,0,0,0
921570,True,8,Very Positive,1272,190,1462
921590,True,5,Mixed,174,113,287
921610,True,0,No user reviews,0,0,0
921620,True,0,No user reviews,0,0,0
921630,True,8,Very Positive,209,36,245
921650,True,0,No user reviews,0,0,0
921660,True,0,1 user reviews,1,0,1
921670,True,0,No user reviews,0,0,0
921680,True,0,No user reviews,0,0,0
921690,True,0,No user reviews,0,0,0
921700,True,0,No user reviews,0,0,0
921710,True,6,Mostly Positive,149,41,190
921720,True,0,No user reviews,0,0,0
921730,True,0,4 user reviews,3,1,4
921740,True,0,2 user reviews,2,0,2
921760,True,0,No user reviews,0,0,0
921770,True,5,Mixed,6,4,10
921780,True,5,Mixed,142,78,220
921790,True,0,No user reviews,0,0,0
921800,True,6,Mostly Positive,275,81,356
921810,True,0,No user reviews,0,0,0
921830,True,0,No user reviews,0,0,0
921840,True,0,No user reviews,0,0,0
921850,True,0,No user reviews,0,0,0
921870,True,0,3 user reviews,2,1,3
921890,True,0,2 user reviews,2,0,2
921900,True,7,Positive,43,6,49
921920,True,0,No user reviews,0,0,0
921940,True,0,No user reviews,0,0,0
921950,True,5,Mixed,101,96,197
921960,True,0,1 user reviews,0,1,1
921970,True,4,Mostly Negative,9,30,39
922020,True,0,4 user reviews,4,0,4
922040,True,6,Mostly Positive,19,5,24
922060,True,0,No user reviews,0,0,0
922090,True,0,No user reviews,0,0,0
922100,True,8,Very Positive,138,5,143
922130,True,0,2 user reviews,1,1,2
922140,True,6,Mostly Positive,15,5,20
922150,True,6,Mostly Positive,16,5,21
922160,True,0,No user reviews,0,0,0
922170,True,0,1 user reviews,1,0,1
922200,True,0,No user reviews,0,0,0
922220,True,0,2 user reviews,1,1,2
922230,True,0,No user reviews,0,0,0
922250,True,7,Positive,11,1,12
922260,True,0,No user reviews,0,0,0
922280,True,0,No user reviews,0,0,0
922290,True,7,Positive,15,1,16
922300,True,0,No user reviews,0,0,0
922310,True,0,No user reviews,0,0,0
922311,True,0,No user reviews,0,0,0
922312,True,0,No user reviews,0,0,0
922313,True,0,No user reviews,0,0,0
922320,True,0,No user reviews,0,0,0
922400,True,8,Very Positive,145,4,149
922410,True,0,6 user reviews,4,2,6
922420,True,0,No user reviews,0,0,0
922430,True,7,Positive,16,0,16
922450,True,0,No user reviews,0,0,0
922460,True,0,No user reviews,0,0,0
922470,True,7,Positive,12,0,12
922480,True,0,No user reviews,0,0,0
922500,True,5,Mixed,139,64,203
922510,True,0,3 user reviews,3,0,3
922520,True,0,1 user reviews,1,0,1
922530,True,7,Positive,11,2,13
922540,True,0,No user reviews,0,0,0
922550,True,6,Mostly Positive,9,3,12
922560,True,0,No user reviews,0,0,0
922580,True,0,1 user reviews,1,0,1
922581,True,0,No user reviews,0,0,0
922590,True,0,1 user reviews,0,1,1
922600,True,0,No user reviews,0,0,0
922610,True,0,No user reviews,0,0,0
922620,True,0,No user reviews,0,0,0
922630,True,0,No user reviews,0,0,0
922640,True,0,No user reviews,0,0,0
922650,True,0,4 user reviews,4,0,4
922660,True,5,Mixed,17,8,25
922670,True,0,9 user reviews,5,4,9
922700,True,7,Positive,19,0,19
922710,True,7,Positive,41,6,47
922740,True,0,No user reviews,0,0,0
922741,True,0,No user reviews,0,0,0
922750,True,0,No user reviews,0,0,0
922800,True,4,Mostly Negative,5,14,19
922810,True,0,6 user reviews,4,2,6
922870,True,0,No user reviews,0,0,0
922880,True,0,No user reviews,0,0,0
922920,True,6,Mostly Positive,15,4,19
922940,True,0,No user reviews,0,0,0
922970,True,0,No user reviews,0,0,0
922971,True,0,No user reviews,0,0,0
922972,True,0,No user reviews,0,0,0
922973,True,0,No user reviews,0,0,0
923010,True,0,No user reviews,0,0,0
923030,True,0,No user reviews,0,0,0
923050,True,0,1 user reviews,1,0,1
923080,True,0,2 user reviews,2,0,2
923100,True,0,No user reviews,0,0,0
923110,True,0,No user reviews,0,0,0
923120,True,0,No user reviews,0,0,0
923130,True,0,No user reviews,0,0,0
923140,True,0,No user reviews,0,0,0
923151,True,0,No user reviews,0,0,0
923152,True,0,No user reviews,0,0,0
923180,True,0,No user reviews,0,0,0
923220,True,0,No user reviews,0,0,0
923230,True,0,6 user reviews,5,1,6
923240,True,0,1 user reviews,0,1,1
923250,True,0,No user reviews,0,0,0
923260,True,8,Very Positive,65,4,69
923270,True,0,3 user reviews,0,3,3
923280,True,0,No user reviews,0,0,0
923290,True,0,1 user reviews,1,0,1
923300,True,0,No user reviews,0,0,0
923310,True,0,1 user reviews,1,0,1
923340,True,0,No user reviews,0,0,0
923350,True,0,1 user reviews,0,1,1
923360,True,0,No user reviews,0,0,0
923370,True,0,8 user reviews,8,0,8
923380,True,0,3 user reviews,3,0,3
923390,True,0,No user reviews,0,0,0
923400,True,0,No user reviews,0,0,0
923420,True,7,Positive,14,2,16
923430,True,0,No user reviews,0,0,0
923460,True,0,No user reviews,0,0,0
923470,True,8,Very Positive,103,20,123
923480,True,0,3 user reviews,3,0,3
923500,True,0,No user reviews,0,0,0
923510,True,0,No user reviews,0,0,0
923530,True,0,6 user reviews,2,4,6
923540,True,0,No user reviews,0,0,0
923550,True,0,3 user reviews,3,0,3
923560,True,0,No user reviews,0,0,0
923570,True,8,Very Positive,59,3,62
923580,True,0,No user reviews,0,0,0
923590,True,5,Mixed,14,20,34
923600,True,0,No user reviews,0,0,0
923610,True,0,No user reviews,0,0,0
923620,True,0,No user reviews,0,0,0
923630,True,0,5 user reviews,4,1,5
923640,True,0,No user reviews,0,0,0
923650,True,0,3 user reviews,3,0,3
923670,True,0,7 user reviews,7,0,7
923690,True,4,Mostly Negative,3,8,11
923710,True,6,Mostly Positive,28,10,38
923720,True,0,1 user reviews,1,0,1
923730,True,0,4 user reviews,3,1,4
923750,True,0,No user reviews,0,0,0
923760,True,0,No user reviews,0,0,0
923780,True,0,No user reviews,0,0,0
923790,True,0,2 user reviews,1,1,2
923800,True,0,No user reviews,0,0,0
923810,True,8,Very Positive,75,8,83
923820,True,0,No user reviews,0,0,0
923830,True,0,No user reviews,0,0,0
923840,True,0,1 user reviews,1,0,1
923850,True,0,No user reviews,0,0,0
923851,True,0,No user reviews,0,0,0
923880,True,0,2 user reviews,1,1,2
923890,True,5,Mixed,20,15,35
923900,True,0,5 user reviews,5,0,5
923910,True,7,Positive,10,0,10
923920,True,0,No user reviews,0,0,0
923930,True,0,No user reviews,0,0,0
923970,True,4,Mostly Negative,24,41,65
924020,True,3,Negative,5,26,31
924040,True,0,5 user reviews,2,3,5
924050,True,0,No user reviews,0,0,0
924051,True,0,1 user reviews,1,0,1
924070,True,6,Mostly Positive,40,16,56
924080,True,0,No user reviews,0,0,0
924090,True,0,6 user reviews,3,3,6
924100,True,5,Mixed,6,7,13
924110,True,0,5 user reviews,1,4,5
924120,True,0,No user reviews,0,0,0
924130,True,0,No user reviews,0,0,0
924140,True,8,Very Positive,1030,170,1200
924150,True,0,5 user reviews,4,1,5
924151,True,0,4 user reviews,4,0,4
924160,True,0,No user reviews,0,0,0
924170,True,0,No user reviews,0,0,0
924180,True,0,No user reviews,0,0,0
924181,True,5,Mixed,7,8,15
924182,True,0,No user reviews,0,0,0
924183,True,0,4 user reviews,2,2,4
924184,True,0,No user reviews,0,0,0
924185,True,0,3 user reviews,2,1,3
924190,True,0,No user reviews,0,0,0
924200,True,0,No user reviews,0,0,0
924210,True,0,1 user reviews,1,0,1
924220,True,8,Very Positive,73,14,87
924230,True,0,No user reviews,0,0,0
924240,True,0,No user reviews,0,0,0
924250,True,6,Mostly Positive,27,11,38
924280,True,0,5 user reviews,5,0,5
924310,True,6,Mostly Positive,8,3,11
924330,True,0,4 user reviews,4,0,4
924331,True,0,2 user reviews,2,0,2
924332,True,0,1 user reviews,1,0,1
924340,True,0,No user reviews,0,0,0
924360,True,0,No user reviews,0,0,0
924370,True,0,8 user reviews,3,5,8
924380,True,0,No user reviews,0,0,0
924390,True,0,2 user reviews,0,2,2
924430,True,0,No user reviews,0,0,0
924450,True,0,No user reviews,0,0,0
924460,True,0,2 user reviews,1,1,2
924470,True,0,No user reviews,0,0,0
924471,True,0,No user reviews,0,0,0
924472,True,0,No user reviews,0,0,0
924473,True,0,No user reviews,0,0,0
924474,True,0,No user reviews,0,0,0
924475,True,0,No user reviews,0,0,0
924476,True,0,No user reviews,0,0,0
924477,True,0,No user reviews,0,0,0
924478,True,0,No user reviews,0,0,0
924479,True,0,No user reviews,0,0,0
924480,True,0,No user reviews,0,0,0
924481,True,0,No user reviews,0,0,0
924482,True,0,No user reviews,0,0,0
924483,True,0,No user reviews,0,0,0
924490,True,0,1 user reviews,1,0,1
924500,True,0,1 user reviews,0,1,1
924520,True,0,1 user reviews,1,0,1
924560,True,0,2 user reviews,2,0,2
924650,True,7,Positive,39,5,44
924660,True,0,No user reviews,0,0,0
924670,True,5,Mixed,6,8,14
924690,True,0,No user reviews,0,0,0
924730,True,0,No user reviews,0,0,0
924740,True,0,4 user reviews,1,3,4
924750,True,0,No user reviews,0,0,0
924770,True,0,2 user reviews,2,0,2
924780,True,7,Positive,10,0,10
924790,True,0,4 user reviews,4,0,4
924800,True,6,Mostly Positive,14,4,18
924810,True,0,No user reviews,0,0,0
924830,True,0,No user reviews,0,0,0
924840,True,0,No user reviews,0,0,0
924841,True,0,No user reviews,0,0,0
924870,True,0,6 user reviews,5,1,6
924900,True,7,Positive,19,1,20
924920,True,0,No user reviews,0,0,0
924930,True,0,No user reviews,0,0,0
924940,True,7,Positive,14,0,14
924950,True,0,No user reviews,0,0,0
924960,True,0,2 user reviews,1,1,2
924980,True,8,Very Positive,1100,60,1160
925000,True,0,No user reviews,0,0,0
925010,True,0,No user reviews,0,0,0
925020,True,0,No user reviews,0,0,0
925040,True,0,8 user reviews,6,2,8
925050,True,0,1 user reviews,1,0,1
925060,True,0,3 user reviews,3,0,3
925070,True,0,2 user reviews,1,1,2
925090,True,0,4 user reviews,3,1,4
925100,True,6,Mostly Positive,179,47,226
925102,True,0,No user reviews,0,0,0
925110,True,0,8 user reviews,5,3,8
925120,True,0,No user reviews,0,0,0
925160,True,0,No user reviews,0,0,0
925170,True,7,Positive,14,2,16
925180,True,0,1 user reviews,1,0,1
925190,True,0,4 user reviews,3,1,4
925191,True,0,2 user reviews,2,0,2
925280,True,0,1 user reviews,1,0,1
925290,True,0,No user reviews,0,0,0
925300,True,0,No user reviews,0,0,0
925310,True,0,No user reviews,0,0,0
925330,True,0,No user reviews,0,0,0
925340,True,7,Positive,19,0,19
925360,True,0,3 user reviews,2,1,3
925370,True,0,3 user reviews,3,0,3
925380,True,0,No user reviews,0,0,0
925390,True,0,No user reviews,0,0,0
925400,True,0,No user reviews,0,0,0
925410,True,0,No user reviews,0,0,0
925420,True,0,No user reviews,0,0,0
925440,True,7,Positive,32,3,35
925460,True,8,Very Positive,85,3,88
925470,True,5,Mixed,18,8,26
925490,True,0,9 user reviews,8,1,9
925520,True,8,Very Positive,50,7,57
925540,True,0,1 user reviews,0,1,1
925550,True,7,Positive,21,1,22
925560,True,0,No user reviews,0,0,0
925570,True,5,Mixed,40,32,72
925580,True,8,Very Positive,320,27,347
925590,True,0,No user reviews,0,0,0
925600,True,0,1 user reviews,0,1,1
925610,True,0,1 user reviews,0,1,1
925620,True,0,No user reviews,0,0,0
925621,True,0,No user reviews,0,0,0
925640,True,0,No user reviews,0,0,0
925650,True,7,Positive,23,0,23
925660,True,0,2 user reviews,2,0,2
925670,True,3,Negative,1,10,11
925680,True,0,No user reviews,0,0,0
925690,True,0,4 user reviews,3,1,4
925700,True,0,1 user reviews,0,1,1
925720,True,0,No user reviews,0,0,0
925740,True,0,No user reviews,0,0,0
925750,True,8,Very Positive,167,41,208
925760,True,0,2 user reviews,2,0,2
925810,True,0,No user reviews,0,0,0
925820,True,0,No user reviews,0,0,0
925821,True,0,No user reviews,0,0,0
925822,True,0,No user reviews,0,0,0
925823,True,0,No user reviews,0,0,0
925824,True,0,No user reviews,0,0,0
925825,True,0,1 user reviews,1,0,1
925826,True,0,4 user reviews,4,0,4
925827,True,0,6 user reviews,2,4,6
925828,True,0,No user reviews,0,0,0
925829,True,0,No user reviews,0,0,0
925830,True,0,No user reviews,0,0,0
925850,True,0,No user reviews,0,0,0
925851,True,0,No user reviews,0,0,0
925852,True,0,No user reviews,0,0,0
925853,True,0,No user reviews,0,0,0
925854,True,0,No user reviews,0,0,0
925855,True,0,No user reviews,0,0,0
925856,True,0,No user reviews,0,0,0
925858,True,0,No user reviews,0,0,0
925859,True,0,No user reviews,0,0,0
925860,True,0,No user reviews,0,0,0
925861,True,0,No user reviews,0,0,0
925862,True,0,No user reviews,0,0,0
925863,True,0,1 user reviews,1,0,1
925864,True,0,No user reviews,0,0,0
925865,True,0,No user reviews,0,0,0
925866,True,0,No user reviews,0,0,0
925867,True,0,No user reviews,0,0,0
925868,True,0,No user reviews,0,0,0
925869,True,0,No user reviews,0,0,0
925870,True,0,No user reviews,0,0,0
925871,True,0,No user reviews,0,0,0
925880,True,0,6 user reviews,3,3,6
925900,True,0,No user reviews,0,0,0
925910,True,5,Mixed,6,4,10
925930,True,8,Very Positive,74,3,77
925940,True,5,Mixed,37,18,55
925970,True,0,No user reviews,0,0,0
925980,True,0,No user reviews,0,0,0
926010,True,5,Mixed,10,10,20
926020,True,7,Positive,24,0,24
926050,True,0,No user reviews,0,0,0
926070,True,0,1 user reviews,1,0,1
926080,True,0,No user reviews,0,0,0
926090,True,0,4 user reviews,3,1,4
926100,True,0,3 user reviews,3,0,3
926110,True,0,2 user reviews,2,0,2
926120,True,0,3 user reviews,3,0,3
926130,True,0,2 user reviews,0,2,2
926140,True,8,Very Positive,628,52,680
926170,True,7,Positive,12,2,14
926180,True,5,Mixed,17,10,27
926210,True,0,7 user reviews,6,1,7
926220,True,0,No user reviews,0,0,0
926240,True,0,1 user reviews,1,0,1
926250,True,0,7 user reviews,7,0,7
926310,True,0,1 user reviews,1,0,1
926320,True,0,No user reviews,0,0,0
926340,True,7,Positive,33,1,34
926350,True,0,3 user reviews,3,0,3
926370,True,0,4 user reviews,2,2,4
926390,True,7,Positive,22,5,27
926400,True,0,5 user reviews,4,1,5
926410,True,0,6 user reviews,3,3,6
926420,True,0,No user reviews,0,0,0
926440,True,0,No user reviews,0,0,0
926450,True,0,5 user reviews,5,0,5
926460,True,0,No user reviews,0,0,0
926470,True,0,9 user reviews,7,2,9
926480,True,0,1 user reviews,0,1,1
926490,True,0,1 user reviews,1,0,1
926510,True,0,No user reviews,0,0,0
926520,True,7,Positive,40,4,44
926540,True,5,Mixed,46,28,74
926560,True,0,No user reviews,0,0,0
926561,True,0,No user reviews,0,0,0
926562,True,0,No user reviews,0,0,0
926580,True,6,Mostly Positive,177,46,223
926590,True,0,1 user reviews,1,0,1
926600,True,0,No user reviews,0,0,0
926610,True,0,3 user reviews,3,0,3
926650,True,0,7 user reviews,6,1,7
926660,True,0,No user reviews,0,0,0
926670,True,0,No user reviews,0,0,0
926720,True,0,No user reviews,0,0,0
926730,True,4,Mostly Negative,7,15,22
926800,True,0,6 user reviews,6,0,6
926810,True,4,Mostly Negative,6,11,17
926820,True,0,5 user reviews,5,0,5
926830,True,0,No user reviews,0,0,0
926850,True,0,No user reviews,0,0,0
926860,True,8,Very Positive,106,7,113
926870,True,0,No user reviews,0,0,0
926890,True,0,No user reviews,0,0,0
926920,True,0,No user reviews,0,0,0
926940,True,0,No user reviews,0,0,0
926960,True,0,No user reviews,0,0,0
926970,True,0,No user reviews,0,0,0
926980,True,0,No user reviews,0,0,0
926990,True,9,Overwhelmingly Positive,1033,50,1083
927020,True,0,No user reviews,0,0,0
927030,True,0,No user reviews,0,0,0
927040,True,0,No user reviews,0,0,0
927050,True,0,No user reviews,0,0,0
927070,True,0,No user reviews,0,0,0
927080,True,0,3 user reviews,3,0,3
927090,True,0,No user reviews,0,0,0
927100,True,0,No user reviews,0,0,0
927110,True,0,No user reviews,0,0,0
927120,True,0,No user reviews,0,0,0
927140,True,0,No user reviews,0,0,0
927150,True,0,No user reviews,0,0,0
927180,True,0,No user reviews,0,0,0
927190,True,0,7 user reviews,5,2,7
927210,True,0,No user reviews,0,0,0
927240,True,0,3 user reviews,2,1,3
927250,True,8,Very Positive,263,26,289
927270,True,8,Very Positive,362,89,451
927310,True,0,4 user reviews,3,1,4
927330,True,0,No user reviews,0,0,0
927340,True,0,1 user reviews,1,0,1
927350,True,0,No user reviews,0,0,0
927370,True,0,2 user reviews,2,0,2
927380,True,9,Overwhelmingly Positive,2248,61,2309
927460,True,0,No user reviews,0,0,0
927470,True,0,No user reviews,0,0,0
927480,True,0,No user reviews,0,0,0
927490,True,0,No user reviews,0,0,0
927580,True,0,2 user reviews,1,1,2
927590,True,0,No user reviews,0,0,0
927660,True,0,No user reviews,0,0,0
927670,True,0,No user reviews,0,0,0
927700,True,0,No user reviews,0,0,0
927720,True,0,No user reviews,0,0,0
927730,True,6,Mostly Positive,42,18,60
927740,True,0,No user reviews,0,0,0
927760,True,0,No user reviews,0,0,0
927780,True,0,No user reviews,0,0,0
927800,True,0,No user reviews,0,0,0
927820,True,0,No user reviews,0,0,0
927840,True,6,Mostly Positive,11,4,15
927850,True,0,No user reviews,0,0,0
927860,True,0,No user reviews,0,0,0
927870,True,0,No user reviews,0,0,0
927880,True,0,No user reviews,0,0,0
927890,True,8,Very Positive,519,39,558
927900,True,0,No user reviews,0,0,0
927920,True,0,No user reviews,0,0,0
927930,True,6,Mostly Positive,12,4,16
927940,True,0,No user reviews,0,0,0
927970,True,0,No user reviews,0,0,0
927990,True,0,No user reviews,0,0,0
928000,True,0,No user reviews,0,0,0
928020,True,0,No user reviews,0,0,0
928050,True,0,No user reviews,0,0,0
928060,True,4,Mostly Negative,8,16,24
928070,True,0,9 user reviews,1,8,9
928080,True,0,No user reviews,0,0,0
928090,True,0,No user reviews,0,0,0
928100,True,7,Positive,26,2,28
928110,True,0,No user reviews,0,0,0
928130,True,0,No user reviews,0,0,0
928140,True,0,3 user reviews,2,1,3
928160,True,0,4 user reviews,4,0,4
928170,True,5,Mixed,8,9,17
928180,True,6,Mostly Positive,11,4,15
928190,True,0,No user reviews,0,0,0
928210,True,0,2 user reviews,1,1,2
928220,True,0,No user reviews,0,0,0
928230,True,0,4 user reviews,3,1,4
928240,True,0,No user reviews,0,0,0
928290,True,0,1 user reviews,0,1,1
928300,True,7,Positive,31,2,33
928340,True,0,No user reviews,0,0,0
928350,True,0,3 user reviews,3,0,3
928370,True,0,5 user reviews,5,0,5
928380,True,0,No user reviews,0,0,0
928390,True,8,Very Positive,63,8,71
928410,True,0,3 user reviews,1,2,3
928420,True,0,No user reviews,0,0,0
928440,True,7,Positive,13,3,16
928460,True,4,Mostly Negative,3,7,10
928480,True,0,9 user reviews,9,0,9
928500,True,0,No user reviews,0,0,0
928520,True,6,Mostly Positive,39,11,50
928530,True,0,No user reviews,0,0,0
928540,True,0,No user reviews,0,0,0
928550,True,0,No user reviews,0,0,0
928560,True,0,No user reviews,0,0,0
928570,True,0,No user reviews,0,0,0
928580,True,0,No user reviews,0,0,0
928600,True,8,Very Positive,3926,389,4315
928610,True,4,Mostly Negative,5,9,14
928660,True,0,7 user reviews,7,0,7
928670,True,7,Positive,11,1,12
928680,True,0,9 user reviews,9,0,9
928690,True,0,No user reviews,0,0,0
928770,True,0,No user reviews,0,0,0
928771,True,0,No user reviews,0,0,0
928830,True,0,5 user reviews,4,1,5
928840,True,5,Mixed,16,8,24
928860,True,0,No user reviews,0,0,0
928870,True,0,No user reviews,0,0,0
928880,True,4,Mostly Negative,5,12,17
928920,True,0,No user reviews,0,0,0
928940,True,0,No user reviews,0,0,0
928950,True,0,No user reviews,0,0,0
928970,True,0,8 user reviews,8,0,8
928980,True,0,No user reviews,0,0,0
928990,True,0,No user reviews,0,0,0
929010,True,5,Mixed,349,415,764
929020,True,0,No user reviews,0,0,0
929030,True,0,7 user reviews,3,4,7
929060,True,5,Mixed,52,24,76
929070,True,0,No user reviews,0,0,0
929080,True,0,1 user reviews,0,1,1
929090,True,0,No user reviews,0,0,0
929100,True,8,Very Positive,62,9,71
929101,True,7,Positive,44,2,46
929102,True,7,Positive,47,2,49
929103,True,7,Positive,20,1,21
929104,True,0,No user reviews,0,0,0
929105,True,0,No user reviews,0,0,0
929106,True,8,Very Positive,49,11,60
929111,True,0,No user reviews,0,0,0
929120,True,0,6 user reviews,5,1,6
929130,True,0,No user reviews,0,0,0
929140,True,7,Positive,18,2,20
929150,True,0,1 user reviews,0,1,1
929160,True,0,2 user reviews,2,0,2
929170,True,0,6 user reviews,5,1,6
929180,True,0,1 user reviews,1,0,1
929190,True,0,No user reviews,0,0,0
929191,True,0,No user reviews,0,0,0
929192,True,0,1 user reviews,0,1,1
929193,True,0,No user reviews,0,0,0
929200,True,0,6 user reviews,1,5,6
929210,True,0,1 user reviews,0,1,1
929230,True,0,6 user reviews,5,1,6
929270,True,6,Mostly Positive,36,13,49
929280,True,0,No user reviews,0,0,0
929290,True,0,9 user reviews,4,5,9
929300,True,6,Mostly Positive,18,7,25
929310,True,0,9 user reviews,8,1,9
929320,True,7,Positive,12,0,12
929330,True,0,5 user reviews,3,2,5
929350,True,0,3 user reviews,3,0,3
929360,True,0,2 user reviews,2,0,2
929390,True,0,No user reviews,0,0,0
929400,True,0,1 user reviews,1,0,1
929410,True,0,1 user reviews,1,0,1
929420,True,0,2 user reviews,2,0,2
929430,True,0,8 user reviews,5,3,8
929440,True,0,2 user reviews,2,0,2
929450,True,0,No user reviews,0,0,0
929460,True,0,No user reviews,0,0,0
929470,True,0,1 user reviews,1,0,1
929480,True,0,6 user reviews,5,1,6
929490,True,0,No user reviews,0,0,0
929510,True,0,4 user reviews,2,2,4
929520,True,0,No user reviews,0,0,0
929530,True,0,1 user reviews,0,1,1
929540,True,0,No user reviews,0,0,0
929550,True,0,3 user reviews,2,1,3
929570,True,0,2 user reviews,1,1,2
929600,True,6,Mostly Positive,8,3,11
929610,True,0,1 user reviews,0,1,1
929630,True,0,No user reviews,0,0,0
929640,True,0,3 user reviews,3,0,3
929660,True,0,No user reviews,0,0,0
929670,True,6,Mostly Positive,12,4,16
929680,True,7,Positive,9,1,10
929690,True,0,No user reviews,0,0,0
929720,True,0,No user reviews,0,0,0
929740,True,0,No user reviews,0,0,0
929800,True,0,2 user reviews,1,1,2
929820,True,0,No user reviews,0,0,0
929830,True,0,No user reviews,0,0,0
929850,True,0,8 user reviews,8,0,8
929860,True,0,No user reviews,0,0,0
929880,True,0,1 user reviews,0,1,1
929910,True,7,Positive,10,0,10
930010,True,0,1 user reviews,1,0,1
930020,True,0,4 user reviews,3,1,4
930030,True,0,1 user reviews,0,1,1
930100,True,0,7 user reviews,7,0,7
930110,True,0,No user reviews,0,0,0
930130,True,0,No user reviews,0,0,0
930150,True,0,No user reviews,0,0,0
930180,True,0,No user reviews,0,0,0
930200,True,0,6 user reviews,6,0,6
930220,True,0,No user reviews,0,0,0
930230,True,0,No user reviews,0,0,0
930240,True,0,No user reviews,0,0,0
930250,True,0,No user reviews,0,0,0
930260,True,0,No user reviews,0,0,0
930280,True,0,No user reviews,0,0,0
930290,True,0,1 user reviews,1,0,1
930300,True,0,2 user reviews,1,1,2
930310,True,0,6 user reviews,6,0,6
930320,True,0,6 user reviews,6,0,6
930360,True,0,No user reviews,0,0,0
930370,True,0,No user reviews,0,0,0
930410,True,0,No user reviews,0,0,0
930430,True,0,2 user reviews,2,0,2
930440,True,0,No user reviews,0,0,0
930460,True,7,Positive,30,5,35
930470,True,0,No user reviews,0,0,0
930480,True,0,2 user reviews,2,0,2
930490,True,0,No user reviews,0,0,0
930500,True,0,4 user reviews,3,1,4
930570,True,0,No user reviews,0,0,0
930600,True,0,1 user reviews,1,0,1
930620,True,5,Mixed,40,34,74
930630,True,7,Positive,12,0,12
930640,True,0,7 user reviews,7,0,7
930650,True,0,1 user reviews,0,1,1
930690,True,0,3 user reviews,3,0,3
930700,True,0,No user reviews,0,0,0
930710,True,0,5 user reviews,4,1,5
930720,True,0,No user reviews,0,0,0
930780,True,8,Very Positive,142,33,175
930790,True,0,No user reviews,0,0,0
930840,True,0,No user reviews,0,0,0
930850,True,0,1 user reviews,0,1,1
930860,True,0,No user reviews,0,0,0
930870,True,0,No user reviews,0,0,0
930890,True,0,No user reviews,0,0,0
930910,True,8,Very Positive,110,1,111
930920,True,0,No user reviews,0,0,0
930940,True,0,2 user reviews,1,1,2
930970,True,0,1 user reviews,0,1,1
930980,True,0,4 user reviews,3,1,4
930981,True,0,No user reviews,0,0,0
930982,True,0,9 user reviews,9,0,9
930983,True,0,No user reviews,0,0,0
930984,True,0,5 user reviews,5,0,5
930985,True,0,No user reviews,0,0,0
930990,True,7,Positive,12,0,12
930991,True,0,No user reviews,0,0,0
931000,True,0,4 user reviews,3,1,4
931010,True,0,No user reviews,0,0,0
931020,True,0,No user reviews,0,0,0
931040,True,0,2 user reviews,2,0,2
931050,True,0,No user reviews,0,0,0
931060,True,0,No user reviews,0,0,0
931070,True,0,No user reviews,0,0,0
931090,True,0,6 user reviews,6,0,6
931120,True,0,4 user reviews,2,2,4
931140,True,0,No user reviews,0,0,0
931150,True,0,2 user reviews,2,0,2
931180,True,0,No user reviews,0,0,0
931191,True,0,No user reviews,0,0,0
931193,True,0,No user reviews,0,0,0
931200,True,0,3 user reviews,3,0,3
931210,True,0,2 user reviews,1,1,2
931220,True,0,No user reviews,0,0,0
931250,True,0,5 user reviews,1,4,5
931260,True,0,3 user reviews,2,1,3
931270,True,8,Very Positive,188,10,198
931280,True,8,Very Positive,198,43,241
931300,True,0,No user reviews,0,0,0
931310,True,5,Mixed,22,24,46
931320,True,7,Positive,11,0,11
931330,True,0,No user reviews,0,0,0
931360,True,0,3 user reviews,2,1,3
931370,True,0,3 user reviews,3,0,3
931420,True,0,No user reviews,0,0,0
931430,True,0,9 user reviews,4,5,9
931440,True,0,2 user reviews,0,2,2
931450,True,0,9 user reviews,8,1,9
931460,True,0,No user reviews,0,0,0
931470,True,0,6 user reviews,5,1,6
931480,True,0,2 user reviews,1,1,2
931500,True,8,Very Positive,107,6,113
931520,True,0,No user reviews,0,0,0
931530,True,0,2 user reviews,2,0,2
931540,True,0,4 user reviews,3,1,4
931560,True,7,Positive,18,0,18
931570,True,0,2 user reviews,2,0,2
931580,True,0,No user reviews,0,0,0
931590,True,0,No user reviews,0,0,0
931600,True,0,No user reviews,0,0,0
931610,True,0,No user reviews,0,0,0
931620,True,0,3 user reviews,3,0,3
931630,True,0,9 user reviews,7,2,9
931640,True,0,8 user reviews,4,4,8
931650,True,0,No user reviews,0,0,0
931670,True,0,8 user reviews,8,0,8
931690,True,0,No user reviews,0,0,0
931700,True,0,No user reviews,0,0,0
931720,True,0,No user reviews,0,0,0
931740,True,0,No user reviews,0,0,0
931760,True,0,No user reviews,0,0,0
931780,True,0,No user reviews,0,0,0
931790,True,0,No user reviews,0,0,0
931791,True,0,No user reviews,0,0,0
931800,True,0,1 user reviews,1,0,1
931810,True,0,No user reviews,0,0,0
931820,True,0,1 user reviews,1,0,1
931830,True,6,Mostly Positive,7,3,10
931860,True,7,Positive,26,4,30
931870,True,0,No user reviews,0,0,0
931880,True,0,No user reviews,0,0,0
931900,True,0,No user reviews,0,0,0
931920,True,7,Positive,18,0,18
931930,True,7,Positive,32,2,34
931940,True,0,No user reviews,0,0,0
931950,True,8,Very Positive,40,10,50
931960,True,0,1 user reviews,1,0,1
931970,True,0,No user reviews,0,0,0
931980,True,0,1 user reviews,1,0,1
932000,True,0,No user reviews,0,0,0
932010,True,0,No user reviews,0,0,0
932030,True,0,No user reviews,0,0,0
932050,True,0,No user reviews,0,0,0
932060,True,0,No user reviews,0,0,0
932070,True,0,No user reviews,0,0,0
932080,True,0,No user reviews,0,0,0
932090,True,0,No user reviews,0,0,0
932120,True,0,4 user reviews,3,1,4
932150,True,0,No user reviews,0,0,0
932160,True,5,Mixed,4,6,10
932170,True,0,No user reviews,0,0,0
932190,True,0,No user reviews,0,0,0
932200,True,0,No user reviews,0,0,0
932210,True,5,Mixed,9,5,14
932220,True,7,Positive,18,1,19
932230,True,0,No user reviews,0,0,0
932240,True,0,No user reviews,0,0,0
932270,True,0,3 user reviews,3,0,3
932290,True,0,2 user reviews,2,0,2
932300,True,0,1 user reviews,0,1,1
932310,True,0,8 user reviews,3,5,8
932330,True,7,Positive,14,2,16
932350,True,0,2 user reviews,1,1,2
932370,True,0,No user reviews,0,0,0
932380,True,0,No user reviews,0,0,0
932400,True,0,No user reviews,0,0,0
932420,True,0,7 user reviews,7,0,7
932450,True,0,6 user reviews,6,0,6
932460,True,0,No user reviews,0,0,0
932480,True,0,6 user reviews,5,1,6
932500,True,8,Very Positive,85,2,87
932510,True,0,No user reviews,0,0,0
932520,True,0,No user reviews,0,0,0
932540,True,0,No user reviews,0,0,0
932550,True,0,No user reviews,0,0,0
932560,True,0,1 user reviews,1,0,1
932570,True,0,No user reviews,0,0,0
932580,True,0,No user reviews,0,0,0
932600,True,0,No user reviews,0,0,0
932620,True,0,No user reviews,0,0,0
932621,True,0,No user reviews,0,0,0
932622,True,0,No user reviews,0,0,0
932640,True,0,No user reviews,0,0,0
932641,True,0,1 user reviews,0,1,1
932642,True,0,No user reviews,0,0,0
932643,True,0,1 user reviews,1,0,1
932644,True,0,5 user reviews,1,4,5
932660,True,6,Mostly Positive,8,3,11
932670,True,0,2 user reviews,0,2,2
932690,True,0,4 user reviews,0,4,4
932700,True,0,No user reviews,0,0,0
932730,True,0,5 user reviews,3,2,5
932740,True,0,1 user reviews,1,0,1
932741,True,0,No user reviews,0,0,0
932742,True,0,No user reviews,0,0,0
932743,True,0,No user reviews,0,0,0
932744,True,0,1 user reviews,1,0,1
932760,True,0,6 user reviews,5,1,6
932780,True,0,5 user reviews,5,0,5
932790,True,7,Positive,12,3,15
932800,True,0,No user reviews,0,0,0
932810,True,0,No user reviews,0,0,0
932820,True,0,4 user reviews,4,0,4
932830,True,0,No user reviews,0,0,0
932840,True,0,No user reviews,0,0,0
932850,True,8,Very Positive,330,45,375
932870,True,0,No user reviews,0,0,0
932920,True,0,1 user reviews,0,1,1
932930,True,0,5 user reviews,3,2,5
932940,True,5,Mixed,5,5,10
932950,True,0,1 user reviews,1,0,1
932970,True,0,4 user reviews,2,2,4
932980,True,5,Mixed,79,45,124
932990,True,0,3 user reviews,3,0,3
933000,True,0,No user reviews,0,0,0
933010,True,0,No user reviews,0,0,0
933020,True,0,1 user reviews,1,0,1
933030,True,0,5 user reviews,5,0,5
933050,True,0,2 user reviews,1,1,2
933060,True,6,Mostly Positive,12,4,16
933070,True,0,3 user reviews,1,2,3
933080,True,5,Mixed,11,8,19
933100,True,0,No user reviews,0,0,0
933110,True,5,Mixed,1614,1029,2643
933120,True,0,No user reviews,0,0,0
933130,True,7,Positive,11,2,13
933140,True,7,Positive,17,1,18
933160,True,0,2 user reviews,2,0,2
933170,True,0,No user reviews,0,0,0
933200,True,0,No user reviews,0,0,0
933210,True,0,4 user reviews,4,0,4
933230,True,5,Mixed,17,10,27
933250,True,0,No user reviews,0,0,0
933260,True,0,No user reviews,0,0,0
933261,True,0,No user reviews,0,0,0
933262,True,0,No user reviews,0,0,0
933290,True,0,No user reviews,0,0,0
933300,True,0,7 user reviews,5,2,7
933330,True,0,No user reviews,0,0,0
933340,True,0,No user reviews,0,0,0
933350,True,0,No user reviews,0,0,0
933360,True,0,No user reviews,0,0,0
933370,True,0,No user reviews,0,0,0
933380,True,0,No user reviews,0,0,0
933390,True,0,No user reviews,0,0,0
933400,True,0,1 user reviews,1,0,1
933430,True,0,1 user reviews,1,0,1
933440,True,0,No user reviews,0,0,0
933450,True,5,Mixed,26,12,38
933480,True,0,No user reviews,0,0,0
933490,True,0,No user reviews,0,0,0
933504,True,6,Mostly Positive,7,3,10
933505,True,0,No user reviews,0,0,0
933506,True,0,No user reviews,0,0,0
933509,True,0,No user reviews,0,0,0
933510,True,0,2 user reviews,1,1,2
933511,True,0,No user reviews,0,0,0
933512,True,0,1 user reviews,1,0,1
933520,True,0,No user reviews,0,0,0
933521,True,0,No user reviews,0,0,0
933522,True,0,No user reviews,0,0,0
933523,True,0,No user reviews,0,0,0
933524,True,0,1 user reviews,0,1,1
933525,True,0,1 user reviews,1,0,1
933526,True,0,1 user reviews,1,0,1
933527,True,0,No user reviews,0,0,0
933528,True,0,1 user reviews,1,0,1
933529,True,0,1 user reviews,1,0,1
933530,True,0,1 user reviews,0,1,1
933531,True,0,1 user reviews,0,1,1
933532,True,0,3 user reviews,2,1,3
933533,True,0,No user reviews,0,0,0
933534,True,0,No user reviews,0,0,0
933535,True,0,No user reviews,0,0,0
933536,True,0,No user reviews,0,0,0
933537,True,0,No user reviews,0,0,0
933538,True,0,No user reviews,0,0,0
933539,True,0,No user reviews,0,0,0
933540,True,0,No user reviews,0,0,0
933550,True,0,No user reviews,0,0,0
933551,True,0,No user reviews,0,0,0
933552,True,0,1 user reviews,1,0,1
933553,True,0,No user reviews,0,0,0
933554,True,0,No user reviews,0,0,0
933555,True,0,No user reviews,0,0,0
933556,True,0,1 user reviews,1,0,1
933557,True,0,1 user reviews,1,0,1
933558,True,0,2 user reviews,1,1,2
933560,True,0,1 user reviews,1,0,1
933561,True,0,No user reviews,0,0,0
933562,True,0,No user reviews,0,0,0
933563,True,0,No user reviews,0,0,0
933566,True,0,3 user reviews,0,3,3
933570,True,0,1 user reviews,1,0,1
933571,True,0,No user reviews,0,0,0
933572,True,0,No user reviews,0,0,0
933573,True,0,No user reviews,0,0,0
933580,True,0,No user reviews,0,0,0
933590,True,0,No user reviews,0,0,0
933600,True,0,3 user reviews,3,0,3
933610,True,8,Very Positive,84,20,104
933620,True,0,7 user reviews,6,1,7
933630,True,5,Mixed,5,5,10
933650,True,0,No user reviews,0,0,0
933660,True,0,6 user reviews,3,3,6
933670,True,0,No user reviews,0,0,0
933680,True,0,No user reviews,0,0,0
933690,True,0,5 user reviews,1,4,5
933700,True,4,Mostly Negative,11,21,32
933710,True,0,6 user reviews,2,4,6
933720,True,2,Very Negative,12,51,63
933740,True,0,No user reviews,0,0,0
933750,True,0,No user reviews,0,0,0
933751,True,0,No user reviews,0,0,0
933752,True,0,No user reviews,0,0,0
933753,True,0,1 user reviews,0,1,1
933754,True,0,No user reviews,0,0,0
933755,True,0,No user reviews,0,0,0
933756,True,0,No user reviews,0,0,0
933757,True,0,No user reviews,0,0,0
933758,True,0,No user reviews,0,0,0
933759,True,0,No user reviews,0,0,0
933760,True,0,No user reviews,0,0,0
933761,True,0,No user reviews,0,0,0
933762,True,0,No user reviews,0,0,0
933763,True,0,No user reviews,0,0,0
933764,True,0,No user reviews,0,0,0
933765,True,0,No user reviews,0,0,0
933770,True,0,8 user reviews,8,0,8
933790,True,0,1 user reviews,1,0,1
933820,True,6,Mostly Positive,504,134,638
933830,True,0,9 user reviews,6,3,9
933840,True,0,3 user reviews,1,2,3
933850,True,0,No user reviews,0,0,0
933860,True,6,Mostly Positive,81,23,104
933890,True,0,1 user reviews,1,0,1
933900,True,0,No user reviews,0,0,0
933920,True,0,8 user reviews,3,5,8
933930,True,0,No user reviews,0,0,0
933940,True,7,Positive,12,3,15
933970,True,5,Mixed,6,9,15
933980,True,0,7 user reviews,3,4,7
933990,True,0,No user reviews,0,0,0
934060,True,0,No user reviews,0,0,0
934070,True,7,Positive,30,0,30
934120,True,5,Mixed,4,6,10
934130,True,0,1 user reviews,0,1,1
934131,True,0,No user reviews,0,0,0
934170,True,0,3 user reviews,3,0,3
934180,True,0,7 user reviews,4,3,7
934200,True,0,No user reviews,0,0,0
934220,True,0,6 user reviews,3,3,6
934240,True,0,No user reviews,0,0,0
934250,True,0,No user reviews,0,0,0
934260,True,0,No user reviews,0,0,0
934300,True,0,No user reviews,0,0,0
934310,True,0,No user reviews,0,0,0
934320,True,0,No user reviews,0,0,0
934321,True,0,No user reviews,0,0,0
934330,True,0,No user reviews,0,0,0
934331,True,0,No user reviews,0,0,0
934340,True,0,No user reviews,0,0,0
934341,True,0,No user reviews,0,0,0
934350,True,0,No user reviews,0,0,0
934351,True,0,No user reviews,0,0,0
934352,True,0,No user reviews,0,0,0
934353,True,0,No user reviews,0,0,0
934360,True,0,No user reviews,0,0,0
934361,True,0,No user reviews,0,0,0
934400,True,0,No user reviews,0,0,0
934410,True,7,Positive,13,0,13
934430,True,0,1 user reviews,1,0,1
934450,True,0,No user reviews,0,0,0
934470,True,0,1 user reviews,0,1,1
934480,True,0,No user reviews,0,0,0
934500,True,0,No user reviews,0,0,0
934510,True,0,No user reviews,0,0,0
934520,True,0,No user reviews,0,0,0
934540,True,5,Mixed,12,8,20
934550,True,0,1 user reviews,1,0,1
934580,True,0,No user reviews,0,0,0
934590,True,0,2 user reviews,0,2,2
934600,True,0,4 user reviews,2,2,4
934610,True,0,No user reviews,0,0,0
934630,True,7,Positive,9,1,10
934640,True,0,No user reviews,0,0,0
934650,True,0,8 user reviews,5,3,8
934660,True,0,6 user reviews,3,3,6
934670,True,0,No user reviews,0,0,0
934680,True,0,8 user reviews,6,2,8
934690,True,0,2 user reviews,1,1,2
934710,True,0,No user reviews,0,0,0
934780,True,6,Mostly Positive,261,98,359
934790,True,0,No user reviews,0,0,0
934800,True,0,1 user reviews,1,0,1
934810,True,0,1 user reviews,1,0,1
934830,True,0,No user reviews,0,0,0
934840,True,0,No user reviews,0,0,0
934850,True,0,No user reviews,0,0,0
934860,True,0,No user reviews,0,0,0
934900,True,0,No user reviews,0,0,0
934920,True,0,1 user reviews,1,0,1
934930,True,8,Very Positive,170,38,208
934950,True,0,7 user reviews,4,3,7
934960,True,0,No user reviews,0,0,0
934961,True,0,No user reviews,0,0,0
934990,True,5,Mixed,7,4,11
935000,True,0,No user reviews,0,0,0
935010,True,0,1 user reviews,1,0,1
935040,True,0,No user reviews,0,0,0
935060,True,0,No user reviews,0,0,0
935070,True,7,Positive,37,6,43
935080,True,0,4 user reviews,4,0,4
935110,True,0,No user reviews,0,0,0
935120,True,0,No user reviews,0,0,0
935140,True,0,No user reviews,0,0,0
935180,True,0,4 user reviews,1,3,4
935190,True,0,8 user reviews,4,4,8
935240,True,0,1 user reviews,0,1,1
935250,True,0,4 user reviews,4,0,4
935270,True,8,Very Positive,160,21,181
935320,True,0,1 user reviews,1,0,1
935340,True,0,No user reviews,0,0,0
935350,True,0,2 user reviews,1,1,2
935360,True,7,Positive,13,3,16
935380,True,0,No user reviews,0,0,0
935390,True,0,No user reviews,0,0,0
935400,True,8,Very Positive,63,9,72
935420,True,0,No user reviews,0,0,0
935430,True,0,9 user reviews,5,4,9
935440,True,0,7 user reviews,7,0,7
935450,True,0,No user reviews,0,0,0
935460,True,0,3 user reviews,0,3,3
935490,True,0,4 user reviews,2,2,4
935500,True,0,6 user reviews,2,4,6
935510,True,0,6 user reviews,3,3,6
935511,True,7,Positive,10,0,10
935512,True,0,5 user reviews,4,1,5
935513,True,0,8 user reviews,6,2,8
935514,True,0,1 user reviews,1,0,1
935540,True,0,1 user reviews,1,0,1
935550,True,0,No user reviews,0,0,0
935560,True,7,Positive,20,3,23
935570,True,5,Mixed,7,7,14
935580,True,8,Very Positive,124,11,135
935590,True,0,2 user reviews,2,0,2
935600,True,0,No user reviews,0,0,0
935610,True,0,4 user reviews,1,3,4
935630,True,0,No user reviews,0,0,0
935640,True,7,Positive,14,1,15
935660,True,0,No user reviews,0,0,0
935670,True,0,No user reviews,0,0,0
935680,True,0,2 user reviews,0,2,2
935700,True,0,6 user reviews,2,4,6
935710,True,0,No user reviews,0,0,0
935720,True,0,3 user reviews,1,2,3
935750,True,7,Positive,8,2,10
935770,True,0,No user reviews,0,0,0
935790,True,0,4 user reviews,3,1,4
935810,True,0,4 user reviews,1,3,4
935830,True,0,No user reviews,0,0,0
935840,True,0,No user reviews,0,0,0
935850,True,0,No user reviews,0,0,0
935860,True,0,2 user reviews,2,0,2
935880,True,8,Very Positive,498,34,532
935910,True,0,8 user reviews,6,2,8
935920,True,0,No user reviews,0,0,0
935930,True,8,Very Positive,105,14,119
935940,True,0,3 user reviews,0,3,3
935950,True,0,1 user reviews,1,0,1
935960,True,0,4 user reviews,0,4,4
935970,True,0,No user reviews,0,0,0
935980,True,5,Mixed,12,11,23
936000,True,0,1 user reviews,1,0,1
936010,True,0,5 user reviews,3,2,5
936020,True,0,2 user reviews,2,0,2
936030,True,7,Positive,14,1,15
936040,True,0,3 user reviews,2,1,3
936060,True,0,No user reviews,0,0,0
936070,True,0,2 user reviews,2,0,2
936080,True,0,1 user reviews,1,0,1
936090,True,0,2 user reviews,1,1,2
936100,True,0,7 user reviews,1,6,7
936110,True,0,No user reviews,0,0,0
936120,True,0,No user reviews,0,0,0
936121,True,0,No user reviews,0,0,0
936140,True,5,Mixed,73,35,108
936150,True,0,No user reviews,0,0,0
936160,True,8,Very Positive,80,9,89
936170,True,0,3 user reviews,3,0,3
936180,True,6,Mostly Positive,26,9,35
936190,True,7,Positive,28,1,29
936210,True,0,1 user reviews,1,0,1
936250,True,0,No user reviews,0,0,0
936270,True,0,No user reviews,0,0,0
936280,True,0,No user reviews,0,0,0
936290,True,0,No user reviews,0,0,0
936300,True,0,No user reviews,0,0,0
936310,True,0,No user reviews,0,0,0
936340,True,0,No user reviews,0,0,0
936350,True,0,No user reviews,0,0,0
936360,True,0,No user reviews,0,0,0
936370,True,0,1 user reviews,1,0,1
936390,True,0,No user reviews,0,0,0
936400,True,0,No user reviews,0,0,0
936420,True,0,No user reviews,0,0,0
936430,True,0,No user reviews,0,0,0
936440,True,0,No user reviews,0,0,0
936450,True,0,No user reviews,0,0,0
936460,True,0,No user reviews,0,0,0
936470,True,0,No user reviews,0,0,0
936480,True,0,No user reviews,0,0,0
936490,True,5,Mixed,55,57,112
936500,True,6,Mostly Positive,66,20,86
936510,True,0,2 user reviews,1,1,2
936530,True,6,Mostly Positive,30,10,40
936560,True,0,2 user reviews,1,1,2
936570,True,0,No user reviews,0,0,0
936580,True,0,No user reviews,0,0,0
936590,True,0,No user reviews,0,0,0
936600,True,0,1 user reviews,1,0,1
936610,True,7,Positive,24,5,29
936620,True,5,Mixed,13,9,22
936630,True,0,6 user reviews,6,0,6
936650,True,7,Positive,25,0,25
936660,True,0,No user reviews,0,0,0
936670,True,5,Mixed,20,24,44
936690,True,0,No user reviews,0,0,0
936700,True,7,Positive,15,0,15
936710,True,0,No user reviews,0,0,0
936720,True,8,Very Positive,319,29,348
936740,True,7,Positive,13,2,15
936750,True,0,No user reviews,0,0,0
936770,True,0,No user reviews,0,0,0
936780,True,0,No user reviews,0,0,0
936800,True,0,4 user reviews,1,3,4
936810,True,0,3 user reviews,0,3,3
936820,True,0,2 user reviews,1,1,2
936850,True,0,No user reviews,0,0,0
936870,True,0,No user reviews,0,0,0
936890,True,0,No user reviews,0,0,0
936900,True,0,No user reviews,0,0,0
936910,True,0,No user reviews,0,0,0
936920,True,0,No user reviews,0,0,0
936930,True,0,9 user reviews,4,5,9
936940,True,0,No user reviews,0,0,0
936950,True,0,No user reviews,0,0,0
936960,True,6,Mostly Positive,82,33,115
936970,True,0,No user reviews,0,0,0
936980,True,5,Mixed,24,11,35
937020,True,0,No user reviews,0,0,0
937040,True,0,No user reviews,0,0,0
937050,True,0,5 user reviews,4,1,5
937070,True,0,1 user reviews,1,0,1
937090,True,0,1 user reviews,1,0,1
937110,True,0,No user reviews,0,0,0
937120,True,0,No user reviews,0,0,0
937130,True,0,No user reviews,0,0,0
937140,True,0,2 user reviews,2,0,2
937160,True,0,1 user reviews,1,0,1
937170,True,8,Very Positive,156,12,168
937180,True,0,No user reviews,0,0,0
937210,True,7,Positive,12,2,14
937230,True,0,No user reviews,0,0,0
937240,True,0,No user reviews,0,0,0
937250,True,0,No user reviews,0,0,0
937300,True,8,Very Positive,48,4,52
937310,True,0,No user reviews,0,0,0
937320,True,0,1 user reviews,1,0,1
937350,True,0,No user reviews,0,0,0
937360,True,0,2 user reviews,1,1,2
937370,True,0,No user reviews,0,0,0
937390,True,0,1 user reviews,1,0,1
937400,True,0,No user reviews,0,0,0
937420,True,0,No user reviews,0,0,0
937430,True,0,No user reviews,0,0,0
937440,True,0,No user reviews,0,0,0
937450,True,0,No user reviews,0,0,0
937460,True,0,No user reviews,0,0,0
937480,True,0,No user reviews,0,0,0
937490,True,7,Positive,15,0,15
937510,True,0,No user reviews,0,0,0
937520,True,0,6 user reviews,6,0,6
937530,True,7,Positive,24,6,30
937550,True,0,No user reviews,0,0,0
937570,True,7,Positive,18,0,18
937580,True,8,Very Positive,103,1,104
937600,True,0,No user reviews,0,0,0
937620,True,0,1 user reviews,0,1,1
937630,True,0,4 user reviews,4,0,4
937650,True,0,No user reviews,0,0,0
937680,True,0,No user reviews,0,0,0
937690,True,0,No user reviews,0,0,0
937720,True,0,4 user reviews,4,0,4
937730,True,5,Mixed,13,6,19
937740,True,0,6 user reviews,2,4,6
937770,True,0,8 user reviews,6,2,8
937780,True,0,2 user reviews,0,2,2
937790,True,0,No user reviews,0,0,0
937791,True,0,1 user reviews,1,0,1
937792,True,0,1 user reviews,1,0,1
937820,True,0,2 user reviews,1,1,2
937830,True,0,No user reviews,0,0,0
937850,True,8,Very Positive,58,3,61
937860,True,0,1 user reviews,0,1,1
937870,True,7,Positive,13,3,16
937880,True,0,1 user reviews,0,1,1
937890,True,6,Mostly Positive,92,28,120
937891,True,5,Mixed,148,210,358
937910,True,0,No user reviews,0,0,0
937930,True,0,No user reviews,0,0,0
937940,True,5,Mixed,17,10,27
937950,True,5,Mixed,13,14,27
937960,True,0,No user reviews,0,0,0
937970,True,0,4 user reviews,2,2,4
937980,True,0,No user reviews,0,0,0
938000,True,0,4 user reviews,2,2,4
938030,True,7,Positive,18,0,18
938040,True,0,No user reviews,0,0,0
938050,True,0,No user reviews,0,0,0
938060,True,0,No user reviews,0,0,0
938070,True,0,7 user reviews,7,0,7
938090,True,0,No user reviews,0,0,0
938100,True,0,3 user reviews,3,0,3
938110,True,0,No user reviews,0,0,0
938120,True,0,1 user reviews,1,0,1
938130,True,0,No user reviews,0,0,0
938140,True,0,No user reviews,0,0,0
938150,True,0,No user reviews,0,0,0
938160,True,0,No user reviews,0,0,0
938170,True,0,4 user reviews,4,0,4
938180,True,0,No user reviews,0,0,0
938200,True,0,No user reviews,0,0,0
938210,True,0,1 user reviews,0,1,1
938220,True,8,Very Positive,160,13,173
938240,True,7,Positive,13,2,15
938250,True,0,8 user reviews,5,3,8
938260,True,0,3 user reviews,3,0,3
938270,True,6,Mostly Positive,11,3,14
938280,True,0,2 user reviews,2,0,2
938290,True,0,No user reviews,0,0,0
938300,True,5,Mixed,27,17,44
938310,True,7,Positive,25,0,25
938320,True,0,8 user reviews,4,4,8
938340,True,0,No user reviews,0,0,0
938350,True,0,6 user reviews,4,2,6
938360,True,0,1 user reviews,1,0,1
938370,True,0,No user reviews,0,0,0
938380,True,5,Mixed,45,20,65
938390,True,3,Negative,1,9,10
938400,True,5,Mixed,7,5,12
938410,True,0,5 user reviews,5,0,5
938420,True,0,No user reviews,0,0,0
938430,True,0,No user reviews,0,0,0
938440,True,0,No user reviews,0,0,0
938450,True,0,No user reviews,0,0,0
938460,True,8,Very Positive,144,9,153
938480,True,0,9 user reviews,8,1,9
938490,True,7,Positive,15,2,17
938500,True,4,Mostly Negative,22,56,78
938510,True,0,1 user reviews,1,0,1
938520,True,0,1 user reviews,0,1,1
938530,True,0,No user reviews,0,0,0
938540,True,0,No user reviews,0,0,0
938550,True,0,No user reviews,0,0,0
938560,True,8,Very Positive,354,46,400
938590,True,0,1 user reviews,0,1,1
938600,True,0,5 user reviews,4,1,5
938610,True,0,1 user reviews,1,0,1
938630,True,0,2 user reviews,2,0,2
938640,True,0,5 user reviews,3,2,5
938660,True,0,No user reviews,0,0,0
938680,True,0,No user reviews,0,0,0
938721,True,0,1 user reviews,1,0,1
938740,True,0,6 user reviews,5,1,6
938760,True,0,7 user reviews,4,3,7
938770,True,0,No user reviews,0,0,0
938810,True,0,No user reviews,0,0,0
938820,True,0,1 user reviews,0,1,1
938840,True,0,2 user reviews,0,2,2
938870,True,0,1 user reviews,0,1,1
938880,True,0,No user reviews,0,0,0
938890,True,0,8 user reviews,6,2,8
938900,True,0,No user reviews,0,0,0
938910,True,0,No user reviews,0,0,0
938920,True,0,No user reviews,0,0,0
938940,True,0,7 user reviews,2,5,7
938950,True,0,No user reviews,0,0,0
938960,True,0,4 user reviews,4,0,4
938980,True,0,4 user reviews,4,0,4
938990,True,0,No user reviews,0,0,0
938991,True,0,No user reviews,0,0,0
939000,True,8,Very Positive,135,33,168
939010,True,0,No user reviews,0,0,0
939030,True,0,No user reviews,0,0,0
939040,True,0,No user reviews,0,0,0
939050,True,0,5 user reviews,4,1,5
939051,True,0,8 user reviews,5,3,8
939060,True,7,Positive,8,2,10
939070,True,0,No user reviews,0,0,0
939090,True,0,No user reviews,0,0,0
939100,True,6,Mostly Positive,284,105,389
939110,True,0,No user reviews,0,0,0
939120,True,5,Mixed,23,15,38
939150,True,0,2 user reviews,2,0,2
939160,True,5,Mixed,8,4,12
939180,True,5,Mixed,13,11,24
939200,True,0,2 user reviews,2,0,2
939210,True,0,No user reviews,0,0,0
939230,True,0,8 user reviews,6,2,8
939240,True,0,4 user reviews,2,2,4
939250,True,0,No user reviews,0,0,0
939300,True,0,No user reviews,0,0,0
939310,True,0,No user reviews,0,0,0
939311,True,0,No user reviews,0,0,0
939312,True,0,No user reviews,0,0,0
939320,True,0,No user reviews,0,0,0
939330,True,0,No user reviews,0,0,0
939340,True,0,No user reviews,0,0,0
939350,True,7,Positive,33,8,41
939360,True,7,Positive,25,5,30
939370,True,0,No user reviews,0,0,0
939380,True,0,No user reviews,0,0,0
939390,True,4,Mostly Negative,3,10,13
939400,True,8,Very Positive,198,16,214
939410,True,0,3 user reviews,1,2,3
939420,True,0,No user reviews,0,0,0
939450,True,6,Mostly Positive,17,6,23
939470,True,0,No user reviews,0,0,0
939480,True,0,No user reviews,0,0,0
939490,True,0,No user reviews,0,0,0
939510,True,5,Mixed,629,386,1015
939520,True,5,Mixed,389,392,781
939540,True,0,1 user reviews,1,0,1
939550,True,0,No user reviews,0,0,0
939560,True,0,2 user reviews,2,0,2
939570,True,0,No user reviews,0,0,0
939580,True,0,No user reviews,0,0,0
939590,True,0,No user reviews,0,0,0
939600,True,8,Very Positive,108,12,120
939620,True,7,Positive,17,0,17
939630,True,0,No user reviews,0,0,0
939640,True,0,No user reviews,0,0,0
939650,True,0,No user reviews,0,0,0
939670,True,0,No user reviews,0,0,0
939680,True,0,No user reviews,0,0,0
939700,True,0,No user reviews,0,0,0
939710,True,0,No user reviews,0,0,0
939730,True,0,2 user reviews,1,1,2
939740,True,0,No user reviews,0,0,0
939750,True,0,3 user reviews,1,2,3
939770,True,0,No user reviews,0,0,0
939790,True,8,Very Positive,66,3,69
939810,True,0,2 user reviews,0,2,2
939830,True,0,6 user reviews,6,0,6
939840,True,5,Mixed,25,21,46
939850,True,6,Mostly Positive,1104,453,1557
939860,True,0,No user reviews,0,0,0
939870,True,0,No user reviews,0,0,0
939890,True,0,No user reviews,0,0,0
939900,True,0,No user reviews,0,0,0
939910,True,0,No user reviews,0,0,0
939920,True,0,7 user reviews,2,5,7
939930,True,0,6 user reviews,2,4,6
939940,True,5,Mixed,8,5,13
939960,True,6,Mostly Positive,4576,1312,5888
939990,True,6,Mostly Positive,77,23,100
940010,True,0,3 user reviews,3,0,3
940020,True,0,No user reviews,0,0,0
940030,True,0,No user reviews,0,0,0
940050,True,0,No user reviews,0,0,0
940070,True,0,No user reviews,0,0,0
940090,True,0,No user reviews,0,0,0
940140,True,0,6 user reviews,6,0,6
940150,True,7,Positive,12,1,13
940180,True,0,1 user reviews,1,0,1
940190,True,0,4 user reviews,2,2,4
940200,True,0,No user reviews,0,0,0
940220,True,8,Very Positive,643,62,705
940240,True,0,1 user reviews,1,0,1
940250,True,0,No user reviews,0,0,0
940270,True,0,No user reviews,0,0,0
940290,True,0,No user reviews,0,0,0
940300,True,6,Mostly Positive,22,8,30
940310,True,8,Very Positive,98,20,118
940320,True,0,2 user reviews,2,0,2
940330,True,0,1 user reviews,0,1,1
940340,True,0,No user reviews,0,0,0
940350,True,0,1 user reviews,0,1,1
940370,True,0,No user reviews,0,0,0
940380,True,0,No user reviews,0,0,0
940390,True,0,2 user reviews,1,1,2
940400,True,0,No user reviews,0,0,0
940410,True,0,1 user reviews,1,0,1
940420,True,0,No user reviews,0,0,0
940440,True,0,No user reviews,0,0,0
940450,True,0,No user reviews,0,0,0
940460,True,0,1 user reviews,1,0,1
940480,True,0,1 user reviews,1,0,1
940510,True,0,No user reviews,0,0,0
940520,True,0,4 user reviews,1,3,4
940530,True,0,3 user reviews,3,0,3
940550,True,0,No user reviews,0,0,0
940570,True,0,No user reviews,0,0,0
940580,True,5,Mixed,13,10,23
940590,True,0,1 user reviews,1,0,1
940600,True,0,1 user reviews,0,1,1
940620,True,0,1 user reviews,1,0,1
940630,True,0,1 user reviews,0,1,1
940640,True,0,2 user reviews,2,0,2
940650,True,5,Mixed,11,7,18
940670,True,0,No user reviews,0,0,0
940671,True,0,No user reviews,0,0,0
940672,True,0,No user reviews,0,0,0
940680,True,8,Very Positive,125,16,141
940700,True,0,1 user reviews,1,0,1
940710,True,8,Very Positive,71,3,74
940730,True,0,3 user reviews,3,0,3
940731,True,0,4 user reviews,4,0,4
940732,True,0,1 user reviews,1,0,1
940733,True,0,1 user reviews,1,0,1
940734,True,0,1 user reviews,1,0,1
940735,True,0,1 user reviews,1,0,1
940736,True,0,2 user reviews,2,0,2
940737,True,0,No user reviews,0,0,0
940738,True,0,No user reviews,0,0,0
940739,True,0,1 user reviews,0,1,1
940740,True,0,1 user reviews,1,0,1
940750,True,0,2 user reviews,2,0,2
940770,True,0,2 user reviews,2,0,2
940771,True,0,No user reviews,0,0,0
940780,True,0,5 user reviews,5,0,5
940790,True,7,Positive,10,2,12
940800,True,0,5 user reviews,5,0,5
940810,True,0,3 user reviews,1,2,3
940830,True,0,3 user reviews,3,0,3
940850,True,0,1 user reviews,1,0,1
940870,True,7,Positive,17,4,21
940910,True,8,Very Positive,266,40,306
940920,True,0,5 user reviews,4,1,5
940970,True,0,No user reviews,0,0,0
940980,True,0,No user reviews,0,0,0
940990,True,0,1 user reviews,1,0,1
941000,True,0,5 user reviews,5,0,5
941010,True,0,No user reviews,0,0,0
941020,True,7,Positive,30,4,34
941030,True,0,2 user reviews,2,0,2
941040,True,0,5 user reviews,3,2,5
941050,True,0,1 user reviews,1,0,1
941080,True,0,No user reviews,0,0,0
941100,True,7,Positive,16,0,16
941120,True,0,No user reviews,0,0,0
941130,True,0,No user reviews,0,0,0
941140,True,0,No user reviews,0,0,0
941150,True,0,2 user reviews,1,1,2
941160,True,0,9 user reviews,7,2,9
941170,True,0,No user reviews,0,0,0
941180,True,0,No user reviews,0,0,0
941200,True,0,1 user reviews,0,1,1
941220,True,7,Positive,14,0,14
941241,True,0,No user reviews,0,0,0
941250,True,0,No user reviews,0,0,0
941300,True,0,2 user reviews,2,0,2
941320,True,0,5 user reviews,3,2,5
941330,True,0,No user reviews,0,0,0
941340,True,0,1 user reviews,1,0,1
941350,True,0,3 user reviews,2,1,3
941360,True,0,No user reviews,0,0,0
941390,True,0,2 user reviews,2,0,2
941400,True,0,No user reviews,0,0,0
941410,True,0,2 user reviews,2,0,2
941420,True,0,No user reviews,0,0,0
941440,True,0,1 user reviews,1,0,1
941450,True,0,No user reviews,0,0,0
941460,True,0,No user reviews,0,0,0
941480,True,8,Very Positive,60,13,73
941490,True,7,Positive,17,1,18
941540,True,7,Positive,11,0,11
941550,True,0,1 user reviews,1,0,1
941560,True,0,1 user reviews,1,0,1
941570,True,7,Positive,36,4,40
941580,True,0,No user reviews,0,0,0
941600,True,0,No user reviews,0,0,0
941620,True,0,2 user reviews,2,0,2
941630,True,0,1 user reviews,1,0,1
941640,True,0,No user reviews,0,0,0
941650,True,0,5 user reviews,5,0,5
941660,True,0,No user reviews,0,0,0
941670,True,0,No user reviews,0,0,0
941710,True,0,No user reviews,0,0,0
941730,True,6,Mostly Positive,25,8,33
941790,True,0,6 user reviews,5,1,6
941800,True,0,1 user reviews,1,0,1
941850,True,5,Mixed,37,26,63
941880,True,0,No user reviews,0,0,0
941890,True,0,No user reviews,0,0,0
941900,True,0,No user reviews,0,0,0
941910,True,0,No user reviews,0,0,0
941920,True,5,Mixed,10,7,17
941951,True,0,2 user reviews,2,0,2
941952,True,7,Positive,21,3,24
941953,True,0,3 user reviews,3,0,3
941954,True,0,5 user reviews,5,0,5
941955,True,0,9 user reviews,9,0,9
941956,True,0,6 user reviews,6,0,6
941957,True,0,4 user reviews,4,0,4
941958,True,0,6 user reviews,6,0,6
941959,True,7,Positive,12,0,12
941960,True,0,8 user reviews,8,0,8
941961,True,7,Positive,14,1,15
941962,True,0,2 user reviews,1,1,2
941963,True,0,No user reviews,0,0,0
941964,True,0,2 user reviews,2,0,2
941965,True,0,No user reviews,0,0,0
941966,True,0,1 user reviews,0,1,1
941967,True,0,3 user reviews,3,0,3
941968,True,0,1 user reviews,0,1,1
941970,True,0,2 user reviews,0,2,2
941971,True,0,2 user reviews,1,1,2
941972,True,0,1 user reviews,0,1,1
941973,True,0,1 user reviews,1,0,1
941980,True,0,1 user reviews,1,0,1
942000,True,0,No user reviews,0,0,0
942010,True,0,No user reviews,0,0,0
942020,True,0,4 user reviews,4,0,4
942030,True,0,3 user reviews,3,0,3
942050,True,7,Positive,11,2,13
942060,True,7,Positive,30,2,32
942070,True,0,No user reviews,0,0,0
942080,True,0,No user reviews,0,0,0
942100,True,0,No user reviews,0,0,0
942140,True,0,1 user reviews,0,1,1
942170,True,0,No user reviews,0,0,0
942180,True,0,3 user reviews,3,0,3
942190,True,6,Mostly Positive,10,3,13
942200,True,7,Positive,20,0,20
942210,True,0,4 user reviews,3,1,4
942220,True,0,No user reviews,0,0,0
942230,True,7,Positive,10,2,12
942240,True,0,7 user reviews,6,1,7
942250,True,7,Positive,13,3,16
942270,True,7,Positive,14,1,15
942280,True,7,Positive,11,1,12
942290,True,5,Mixed,161,105,266
942300,True,0,7 user reviews,3,4,7
942310,True,0,No user reviews,0,0,0
942340,True,0,1 user reviews,0,1,1
942350,True,0,No user reviews,0,0,0
942351,True,0,No user reviews,0,0,0
942352,True,0,No user reviews,0,0,0
942353,True,0,1 user reviews,0,1,1
942354,True,0,No user reviews,0,0,0
942355,True,0,No user reviews,0,0,0
942356,True,0,No user reviews,0,0,0
942360,True,0,No user reviews,0,0,0
942370,True,0,No user reviews,0,0,0
942380,True,0,3 user reviews,3,0,3
942390,True,0,No user reviews,0,0,0
942420,True,0,No user reviews,0,0,0
942430,True,0,3 user reviews,3,0,3
942440,True,0,No user reviews,0,0,0
942460,True,0,No user reviews,0,0,0
942480,True,0,5 user reviews,2,3,5
942490,True,0,No user reviews,0,0,0
942510,True,0,No user reviews,0,0,0
942520,True,0,6 user reviews,6,0,6
942530,True,0,1 user reviews,1,0,1
942540,True,0,6 user reviews,6,0,6
942580,True,5,Mixed,7,10,17
942590,True,0,4 user reviews,3,1,4
942600,True,0,No user reviews,0,0,0
942660,True,0,No user reviews,0,0,0
942670,True,0,No user reviews,0,0,0
942680,True,0,No user reviews,0,0,0
942760,True,0,4 user reviews,0,4,4
942770,True,0,3 user reviews,1,2,3
942790,True,0,No user reviews,0,0,0
942800,True,7,Positive,21,4,25
942810,True,0,No user reviews,0,0,0
942820,True,0,No user reviews,0,0,0
942830,True,0,No user reviews,0,0,0
942840,True,0,No user reviews,0,0,0
942850,True,8,Very Positive,71,7,78
942870,True,0,1 user reviews,1,0,1
942880,True,0,No user reviews,0,0,0
942900,True,4,Mostly Negative,4,8,12
942930,True,0,No user reviews,0,0,0
942970,True,8,Very Positive,1176,80,1256
942980,True,0,No user reviews,0,0,0
943010,True,0,No user reviews,0,0,0
943020,True,0,No user reviews,0,0,0
943030,True,0,2 user reviews,0,2,2
943040,True,0,No user reviews,0,0,0
943070,True,0,1 user reviews,1,0,1
943080,True,0,2 user reviews,0,2,2
943120,True,0,No user reviews,0,0,0
943121,True,0,No user reviews,0,0,0
943122,True,0,No user reviews,0,0,0
943123,True,0,No user reviews,0,0,0
943130,True,4,Mostly Negative,34,57,91
943140,True,8,Very Positive,75,16,91
943150,True,5,Mixed,239,280,519
943170,True,0,No user reviews,0,0,0
943180,True,0,No user reviews,0,0,0
943190,True,7,Positive,18,2,20
943200,True,6,Mostly Positive,10,4,14
943210,True,0,No user reviews,0,0,0
943230,True,0,4 user reviews,3,1,4
943240,True,0,No user reviews,0,0,0
943260,True,8,Very Positive,133,32,165
943270,True,0,No user reviews,0,0,0
943290,True,0,No user reviews,0,0,0
943310,True,0,No user reviews,0,0,0
943350,True,0,No user reviews,0,0,0
943380,True,5,Mixed,30,14,44
943390,True,0,No user reviews,0,0,0
943410,True,8,Very Positive,60,6,66
943420,True,6,Mostly Positive,8,3,11
943440,True,0,2 user reviews,1,1,2
943450,True,0,No user reviews,0,0,0
943490,True,0,No user reviews,0,0,0
943510,True,0,3 user reviews,3,0,3
943520,True,0,7 user reviews,7,0,7
943530,True,0,No user reviews,0,0,0
943590,True,0,4 user reviews,4,0,4
943640,True,0,No user reviews,0,0,0
943670,True,0,No user reviews,0,0,0
943680,True,0,8 user reviews,3,5,8
943690,True,0,1 user reviews,1,0,1
943700,True,0,No user reviews,0,0,0
943710,True,0,No user reviews,0,0,0
943720,True,0,No user reviews,0,0,0
943730,True,0,No user reviews,0,0,0
943740,True,5,Mixed,134,72,206
943750,True,0,No user reviews,0,0,0
943790,True,0,No user reviews,0,0,0
943810,True,7,Positive,11,2,13
943820,True,0,No user reviews,0,0,0
943830,True,5,Mixed,6,5,11
943831,True,0,3 user reviews,1,2,3
943840,True,0,4 user reviews,2,2,4
943841,True,0,No user reviews,0,0,0
943842,True,0,1 user reviews,1,0,1
943843,True,0,No user reviews,0,0,0
943844,True,0,4 user reviews,4,0,4
943850,True,0,No user reviews,0,0,0
943860,True,7,Positive,13,2,15
943870,True,0,No user reviews,0,0,0
943871,True,0,1 user reviews,0,1,1
943880,True,0,No user reviews,0,0,0
943900,True,6,Mostly Positive,15,5,20
943910,True,0,No user reviews,0,0,0
943920,True,0,3 user reviews,3,0,3
943930,True,0,No user reviews,0,0,0
943950,True,0,5 user reviews,5,0,5
943960,True,0,No user reviews,0,0,0
943970,True,0,2 user reviews,1,1,2
943980,True,5,Mixed,12,7,19
944010,True,8,Very Positive,113,5,118
944020,True,7,Positive,21,0,21
944030,True,0,1 user reviews,1,0,1
944050,True,0,No user reviews,0,0,0
944060,True,0,No user reviews,0,0,0
944070,True,7,Positive,27,4,31
944071,True,6,Mostly Positive,53,20,73
944080,True,7,Positive,16,0,16
944090,True,0,No user reviews,0,0,0
944100,True,0,8 user reviews,6,2,8
944110,True,0,No user reviews,0,0,0
944120,True,0,No user reviews,0,0,0
944160,True,0,No user reviews,0,0,0
944170,True,0,No user reviews,0,0,0
944180,True,7,Positive,25,5,30
944200,True,0,1 user reviews,1,0,1
944220,True,8,Very Positive,302,14,316
944240,True,0,No user reviews,0,0,0
944250,True,0,No user reviews,0,0,0
944260,True,0,3 user reviews,1,2,3
944290,True,5,Mixed,329,236,565
944300,True,0,4 user reviews,4,0,4
944330,True,8,Very Positive,125,31,156
944340,True,7,Positive,24,1,25
944350,True,0,9 user reviews,7,2,9
944380,True,0,4 user reviews,2,2,4
944420,True,0,2 user reviews,0,2,2
944430,True,0,No user reviews,0,0,0
944440,True,0,2 user reviews,2,0,2
944450,True,0,No user reviews,0,0,0
944490,True,0,No user reviews,0,0,0
944500,True,0,3 user reviews,2,1,3
944520,True,0,No user reviews,0,0,0
944530,True,0,8 user reviews,7,1,8
944540,True,0,No user reviews,0,0,0
944570,True,0,No user reviews,0,0,0
944590,True,7,Positive,16,0,16
944600,True,0,No user reviews,0,0,0
944610,True,0,2 user reviews,2,0,2
944620,True,0,No user reviews,0,0,0
944630,True,0,No user reviews,0,0,0
944640,True,0,3 user reviews,2,1,3
944650,True,7,Positive,12,3,15
944660,True,0,No user reviews,0,0,0
944690,True,7,Positive,10,1,11
944710,True,0,1 user reviews,0,1,1
944720,True,0,No user reviews,0,0,0
944730,True,0,No user reviews,0,0,0
944740,True,0,2 user reviews,0,2,2
944770,True,0,2 user reviews,2,0,2
944790,True,0,No user reviews,0,0,0
944810,True,7,Positive,9,1,10
944820,True,0,No user reviews,0,0,0
944830,True,0,1 user reviews,1,0,1
944840,True,0,No user reviews,0,0,0
944860,True,0,5 user reviews,3,2,5
944870,True,0,No user reviews,0,0,0
944890,True,0,No user reviews,0,0,0
944891,True,0,No user reviews,0,0,0
944892,True,0,No user reviews,0,0,0
944893,True,0,No user reviews,0,0,0
944900,True,0,No user reviews,0,0,0
944910,True,0,9 user reviews,7,2,9
944920,True,8,Very Positive,100,20,120
944930,True,0,No user reviews,0,0,0
944940,True,0,No user reviews,0,0,0
944950,True,0,No user reviews,0,0,0
944960,True,0,No user reviews,0,0,0
944970,True,0,No user reviews,0,0,0
944980,True,0,No user reviews,0,0,0
945000,True,0,No user reviews,0,0,0
945010,True,0,No user reviews,0,0,0
945011,True,0,No user reviews,0,0,0
945020,True,0,No user reviews,0,0,0
945031,True,0,No user reviews,0,0,0
945032,True,0,No user reviews,0,0,0
945033,True,0,No user reviews,0,0,0
945040,True,0,No user reviews,0,0,0
945050,True,0,No user reviews,0,0,0
945070,True,0,2 user reviews,0,2,2
945080,True,0,No user reviews,0,0,0
945100,True,0,7 user reviews,7,0,7
945120,True,0,No user reviews,0,0,0
945130,True,0,No user reviews,0,0,0
945140,True,5,Mixed,18,10,28
945160,True,5,Mixed,11,6,17
945170,True,0,No user reviews,0,0,0
945180,True,0,No user reviews,0,0,0
945190,True,0,No user reviews,0,0,0
945200,True,0,No user reviews,0,0,0
945220,True,0,No user reviews,0,0,0
945230,True,0,No user reviews,0,0,0
945240,True,0,5 user reviews,5,0,5
945250,True,0,No user reviews,0,0,0
945280,True,0,5 user reviews,5,0,5
945310,True,0,No user reviews,0,0,0
945330,True,0,No user reviews,0,0,0
945340,True,7,Positive,16,2,18
945350,True,0,No user reviews,0,0,0
945360,True,9,Overwhelmingly Positive,168027,5771,173798
945370,True,0,No user reviews,0,0,0
945390,True,0,1 user reviews,1,0,1
945400,True,0,No user reviews,0,0,0
945401,True,0,No user reviews,0,0,0
945402,True,0,1 user reviews,1,0,1
945403,True,0,No user reviews,0,0,0
945404,True,0,No user reviews,0,0,0
945430,True,0,No user reviews,0,0,0
945440,True,8,Very Positive,78,6,84
945450,True,0,1 user reviews,1,0,1
945460,True,8,Very Positive,82,9,91
945480,True,0,2 user reviews,2,0,2
945481,True,0,No user reviews,0,0,0
945482,True,0,1 user reviews,1,0,1
945483,True,0,1 user reviews,1,0,1
945490,True,0,1 user reviews,1,0,1
945500,True,0,No user reviews,0,0,0
945520,True,0,No user reviews,0,0,0
945530,True,0,1 user reviews,1,0,1
945550,True,0,No user reviews,0,0,0
945570,True,0,No user reviews,0,0,0
945580,True,7,Positive,19,0,19
945590,True,0,5 user reviews,4,1,5
945610,True,0,No user reviews,0,0,0
945620,True,0,No user reviews,0,0,0
945630,True,0,No user reviews,0,0,0
945640,True,0,No user reviews,0,0,0
945680,True,6,Mostly Positive,36,15,51
945690,True,0,No user reviews,0,0,0
945700,True,0,8 user reviews,0,8,8
945710,True,6,Mostly Positive,304,105,409
945720,True,7,Positive,10,1,11
945740,True,0,No user reviews,0,0,0
945760,True,0,No user reviews,0,0,0
945770,True,0,No user reviews,0,0,0
945780,True,0,1 user reviews,1,0,1
945790,True,0,1 user reviews,1,0,1
945810,True,0,No user reviews,0,0,0
945820,True,0,1 user reviews,0,1,1
945830,True,6,Mostly Positive,10,3,13
945831,True,0,9 user reviews,4,5,9
945832,True,0,7 user reviews,6,1,7
945840,True,0,No user reviews,0,0,0
945850,True,0,No user reviews,0,0,0
945870,True,0,No user reviews,0,0,0
945880,True,0,No user reviews,0,0,0
945890,True,4,Mostly Negative,5,8,13
945910,True,0,2 user reviews,0,2,2
945920,True,0,No user reviews,0,0,0
945930,True,0,No user reviews,0,0,0
945931,True,0,No user reviews,0,0,0
945940,True,0,No user reviews,0,0,0
945950,True,0,4 user reviews,2,2,4
945970,True,0,No user reviews,0,0,0
945990,True,0,No user reviews,0,0,0
946000,True,7,Positive,10,1,11
946010,True,8,Very Positive,53,9,62
946040,True,0,No user reviews,0,0,0
946050,True,0,No user reviews,0,0,0
946060,True,0,No user reviews,0,0,0
946070,True,0,4 user reviews,2,2,4
946080,True,0,1 user reviews,1,0,1
946090,True,6,Mostly Positive,156,50,206
946110,True,8,Very Positive,42,10,52
946130,True,0,No user reviews,0,0,0
946140,True,0,No user reviews,0,0,0
946150,True,0,No user reviews,0,0,0
946160,True,0,No user reviews,0,0,0
946170,True,0,1 user reviews,1,0,1
946180,True,0,1 user reviews,1,0,1
946190,True,0,1 user reviews,1,0,1
946210,True,0,3 user reviews,0,3,3
946240,True,0,No user reviews,0,0,0
946250,True,0,No user reviews,0,0,0
946300,True,0,2 user reviews,2,0,2
946310,True,0,4 user reviews,4,0,4
946330,True,0,No user reviews,0,0,0
946340,True,0,6 user reviews,5,1,6
946350,True,0,No user reviews,0,0,0
946360,True,0,No user reviews,0,0,0
946370,True,0,No user reviews,0,0,0
946380,True,7,Positive,9,1,10
946390,True,0,No user reviews,0,0,0
946391,True,0,No user reviews,0,0,0
946392,True,0,No user reviews,0,0,0
946393,True,0,No user reviews,0,0,0
946394,True,0,No user reviews,0,0,0
946395,True,0,No user reviews,0,0,0
946396,True,0,No user reviews,0,0,0
946397,True,0,No user reviews,0,0,0
946398,True,0,No user reviews,0,0,0
946399,True,0,No user reviews,0,0,0
946400,True,0,1 user reviews,1,0,1
946420,True,0,No user reviews,0,0,0
946430,True,8,Very Positive,104,4,108
946440,True,0,No user reviews,0,0,0
946460,True,7,Positive,11,2,13
946500,True,0,3 user reviews,1,2,3
946520,True,0,No user reviews,0,0,0
946530,True,0,No user reviews,0,0,0
946550,True,5,Mixed,7,6,13
946560,True,7,Positive,34,2,36
946590,True,0,No user reviews,0,0,0
946600,True,3,Negative,3,19,22
946610,True,7,Positive,36,7,43
946620,True,0,No user reviews,0,0,0
946650,True,7,Positive,15,3,18
946660,True,8,Very Positive,77,14,91
946670,True,4,Mostly Negative,8,16,24
946680,True,0,No user reviews,0,0,0
946690,True,0,No user reviews,0,0,0
946700,True,5,Mixed,11,6,17
946710,True,0,No user reviews,0,0,0
946720,True,0,No user reviews,0,0,0
946740,True,0,No user reviews,0,0,0
946750,True,0,No user reviews,0,0,0
946770,True,0,No user reviews,0,0,0
946780,True,7,Positive,17,2,19
946790,True,0,No user reviews,0,0,0
946800,True,5,Mixed,13,8,21
946810,True,0,1 user reviews,0,1,1
946820,True,0,3 user reviews,3,0,3
946860,True,0,8 user reviews,8,0,8
946870,True,0,6 user reviews,6,0,6
946900,True,0,No user reviews,0,0,0
946901,True,0,No user reviews,0,0,0
946902,True,0,No user reviews,0,0,0
946910,True,0,No user reviews,0,0,0
946920,True,0,No user reviews,0,0,0
946930,True,0,1 user reviews,1,0,1
946940,True,0,1 user reviews,1,0,1
946950,True,0,1 user reviews,1,0,1
946960,True,0,No user reviews,0,0,0
946970,True,0,3 user reviews,3,0,3
946980,True,0,No user reviews,0,0,0
946990,True,5,Mixed,33,17,50
947000,True,8,Very Positive,46,7,53
947040,True,0,No user reviews,0,0,0
947060,True,0,2 user reviews,2,0,2
947070,True,0,2 user reviews,2,0,2
947080,True,0,No user reviews,0,0,0
947110,True,0,No user reviews,0,0,0
947120,True,0,No user reviews,0,0,0
947130,True,0,No user reviews,0,0,0
947230,True,0,No user reviews,0,0,0
947240,True,0,No user reviews,0,0,0
947250,True,0,2 user reviews,2,0,2
947260,True,0,2 user reviews,2,0,2
947270,True,0,1 user reviews,0,1,1
947290,True,0,7 user reviews,6,1,7
947300,True,8,Very Positive,398,53,451
947310,True,0,1 user reviews,0,1,1
947320,True,0,No user reviews,0,0,0
947330,True,0,1 user reviews,1,0,1
947340,True,0,No user reviews,0,0,0
947350,True,0,No user reviews,0,0,0
947360,True,0,2 user reviews,2,0,2
947390,True,0,3 user reviews,2,1,3
947400,True,0,1 user reviews,1,0,1
947430,True,0,1 user reviews,1,0,1
947450,True,0,7 user reviews,7,0,7
947460,True,0,No user reviews,0,0,0
947470,True,0,1 user reviews,0,1,1
947490,True,0,3 user reviews,2,1,3
947510,True,6,Mostly Positive,580,239,819
947530,True,0,No user reviews,0,0,0
947540,True,0,No user reviews,0,0,0
947550,True,0,2 user reviews,2,0,2
947560,True,0,No user reviews,0,0,0
947580,True,0,No user reviews,0,0,0
947590,True,0,No user reviews,0,0,0
947600,True,8,Very Positive,244,28,272
947610,True,0,No user reviews,0,0,0
947620,True,0,No user reviews,0,0,0
947640,True,0,No user reviews,0,0,0
947650,True,8,Very Positive,94,2,96
947660,True,7,Positive,34,0,34
947670,True,7,Positive,27,0,27
947680,True,0,2 user reviews,2,0,2
947690,True,0,No user reviews,0,0,0
947700,True,0,6 user reviews,6,0,6
947710,True,0,No user reviews,0,0,0
947720,True,0,No user reviews,0,0,0
947730,True,0,1 user reviews,1,0,1
947740,True,0,No user reviews,0,0,0
947741,True,0,No user reviews,0,0,0
947750,True,0,No user reviews,0,0,0
947760,True,0,No user reviews,0,0,0
947770,True,0,No user reviews,0,0,0
947800,True,0,No user reviews,0,0,0
947810,True,0,No user reviews,0,0,0
947820,True,7,Positive,11,0,11
947830,True,0,2 user reviews,1,1,2
947870,True,0,No user reviews,0,0,0
947880,True,0,1 user reviews,1,0,1
947890,True,0,No user reviews,0,0,0
947910,True,0,No user reviews,0,0,0
947920,True,0,No user reviews,0,0,0
947930,True,7,Positive,15,3,18
947940,True,0,No user reviews,0,0,0
947950,True,0,5 user reviews,3,2,5
947960,True,0,2 user reviews,2,0,2
947970,True,0,7 user reviews,5,2,7
947980,True,0,No user reviews,0,0,0
948000,True,0,No user reviews,0,0,0
948020,True,7,Positive,19,2,21
948070,True,0,2 user reviews,1,1,2
948080,True,0,No user reviews,0,0,0
948100,True,0,5 user reviews,5,0,5
948110,True,0,No user reviews,0,0,0
948120,True,0,3 user reviews,0,3,3
948200,True,0,2 user reviews,0,2,2
948220,True,6,Mostly Positive,11,3,14
948230,True,0,No user reviews,0,0,0
948240,True,0,8 user reviews,8,0,8
948250,True,0,1 user reviews,1,0,1
948270,True,0,No user reviews,0,0,0
948320,True,6,Mostly Positive,28,12,40
948330,True,0,2 user reviews,1,1,2
948340,True,0,No user reviews,0,0,0
948350,True,0,No user reviews,0,0,0
948360,True,0,1 user reviews,1,0,1
948361,True,0,No user reviews,0,0,0
948370,True,0,No user reviews,0,0,0
948380,True,0,No user reviews,0,0,0
948390,True,0,No user reviews,0,0,0
948410,True,0,No user reviews,0,0,0
948411,True,0,No user reviews,0,0,0
948420,True,0,No user reviews,0,0,0
948430,True,7,Positive,14,1,15
948440,True,0,No user reviews,0,0,0
948460,True,0,No user reviews,0,0,0
948470,True,5,Mixed,9,7,16
948490,True,0,No user reviews,0,0,0
948510,True,0,No user reviews,0,0,0
948540,True,0,No user reviews,0,0,0
948541,True,0,No user reviews,0,0,0
948542,True,0,No user reviews,0,0,0
948550,True,0,No user reviews,0,0,0
948570,True,0,No user reviews,0,0,0
948571,True,0,No user reviews,0,0,0
948572,True,0,No user reviews,0,0,0
948590,True,0,No user reviews,0,0,0
948600,True,0,No user reviews,0,0,0
948620,True,0,No user reviews,0,0,0
948621,True,0,No user reviews,0,0,0
948630,True,8,Very Positive,344,48,392
948640,True,6,Mostly Positive,99,32,131
948650,True,0,2 user reviews,1,1,2
948660,True,0,2 user reviews,1,1,2
948670,True,0,No user reviews,0,0,0
948680,True,8,Very Positive,161,17,178
948690,True,0,1 user reviews,0,1,1
948710,True,6,Mostly Positive,8,3,11
948720,True,0,9 user reviews,5,4,9
948730,True,0,3 user reviews,2,1,3
948740,True,8,Very Positive,1095,76,1171
948750,True,0,No user reviews,0,0,0
948770,True,0,2 user reviews,2,0,2
948780,True,0,No user reviews,0,0,0
948790,True,0,No user reviews,0,0,0
948810,True,0,No user reviews,0,0,0
948830,True,0,3 user reviews,3,0,3
948840,True,0,No user reviews,0,0,0
948850,True,0,No user reviews,0,0,0
948880,True,0,No user reviews,0,0,0
948900,True,8,Very Positive,71,6,77
948910,True,0,No user reviews,0,0,0
948930,True,0,No user reviews,0,0,0
948940,True,0,No user reviews,0,0,0
948950,True,0,No user reviews,0,0,0
948960,True,7,Positive,24,6,30
948970,True,0,No user reviews,0,0,0
948990,True,7,Positive,10,0,10
949000,True,0,No user reviews,0,0,0
949030,True,7,Positive,17,2,19
949050,True,0,No user reviews,0,0,0
949060,True,0,No user reviews,0,0,0
949070,True,0,5 user reviews,4,1,5
949080,True,7,Positive,18,3,21
949081,True,6,Mostly Positive,10,3,13
949090,True,0,No user reviews,0,0,0
949130,True,0,No user reviews,0,0,0
949150,True,0,6 user reviews,5,1,6
949160,True,0,No user reviews,0,0,0
949170,True,0,3 user reviews,1,2,3
949200,True,0,No user reviews,0,0,0
949210,True,5,Mixed,11,5,16
949221,True,0,2 user reviews,1,1,2
949250,True,0,3 user reviews,3,0,3
949260,True,0,No user reviews,0,0,0
949261,True,0,No user reviews,0,0,0
949280,True,0,No user reviews,0,0,0
949281,True,0,No user reviews,0,0,0
949290,True,8,Very Positive,273,11,284
949300,True,0,No user reviews,0,0,0
949301,True,0,No user reviews,0,0,0
949302,True,0,No user reviews,0,0,0
949303,True,0,No user reviews,0,0,0
949304,True,0,No user reviews,0,0,0
949305,True,0,No user reviews,0,0,0
949330,True,0,No user reviews,0,0,0
949340,True,0,No user reviews,0,0,0
949350,True,0,No user reviews,0,0,0
949360,True,0,No user reviews,0,0,0
949361,True,0,No user reviews,0,0,0
949370,True,0,No user reviews,0,0,0
949380,True,0,No user reviews,0,0,0
949390,True,0,No user reviews,0,0,0
949400,True,0,No user reviews,0,0,0
949420,True,0,No user reviews,0,0,0
949430,True,0,No user reviews,0,0,0
949440,True,0,No user reviews,0,0,0
949450,True,0,2 user reviews,2,0,2
949490,True,0,No user reviews,0,0,0
949491,True,0,No user reviews,0,0,0
949492,True,0,No user reviews,0,0,0
949494,True,0,No user reviews,0,0,0
949495,True,0,No user reviews,0,0,0
949500,True,5,Mixed,17,8,25
949510,True,0,1 user reviews,0,1,1
949520,True,0,1 user reviews,0,1,1
949530,True,6,Mostly Positive,18,5,23
949550,True,0,No user reviews,0,0,0
949570,True,0,No user reviews,0,0,0
949600,True,8,Very Positive,91,2,93
949610,True,0,1 user reviews,1,0,1
949630,True,5,Mixed,11,7,18
949640,True,0,2 user reviews,2,0,2
949641,True,0,1 user reviews,1,0,1
949642,True,0,1 user reviews,1,0,1
949650,True,0,8 user reviews,8,0,8
949660,True,0,No user reviews,0,0,0
949661,True,0,No user reviews,0,0,0
949662,True,0,No user reviews,0,0,0
949663,True,0,No user reviews,0,0,0
949664,True,0,No user reviews,0,0,0
949665,True,0,No user reviews,0,0,0
949670,True,7,Positive,12,1,13
949680,True,0,8 user reviews,4,4,8
949690,True,0,No user reviews,0,0,0
949700,True,0,2 user reviews,1,1,2
949710,True,0,3 user reviews,0,3,3
949720,True,0,No user reviews,0,0,0
949730,True,0,No user reviews,0,0,0
949740,True,0,No user reviews,0,0,0
949750,True,0,2 user reviews,1,1,2
949760,True,0,No user reviews,0,0,0
949770,True,7,Positive,15,1,16
949780,True,0,1 user reviews,1,0,1
949790,True,7,Positive,37,5,42
949800,True,5,Mixed,10,6,16
949810,True,0,5 user reviews,1,4,5
949820,True,0,3 user reviews,3,0,3
949830,True,0,No user reviews,0,0,0
949860,True,0,No user reviews,0,0,0
949870,True,7,Positive,29,7,36
949880,True,0,8 user reviews,4,4,8
949890,True,0,4 user reviews,3,1,4
949900,True,0,No user reviews,0,0,0
949910,True,0,No user reviews,0,0,0
949930,True,0,1 user reviews,0,1,1
949960,True,0,9 user reviews,3,6,9
949970,True,0,3 user reviews,2,1,3
949990,True,7,Positive,10,2,12
950050,True,6,Mostly Positive,41,13,54
950080,True,0,No user reviews,0,0,0
950100,True,0,No user reviews,0,0,0
950130,True,0,4 user reviews,3,1,4
950140,True,7,Positive,30,3,33
950150,True,0,No user reviews,0,0,0
950160,True,0,3 user reviews,1,2,3
950180,True,0,No user reviews,0,0,0
950200,True,0,1 user reviews,1,0,1
950210,True,6,Mostly Positive,21,7,28
950240,True,0,No user reviews,0,0,0
950250,True,0,No user reviews,0,0,0
950260,True,0,No user reviews,0,0,0
950270,True,0,No user reviews,0,0,0
950271,True,0,No user reviews,0,0,0
950290,True,0,No user reviews,0,0,0
950300,True,7,Positive,38,3,41
950310,True,0,6 user reviews,6,0,6
950330,True,0,1 user reviews,0,1,1
950360,True,5,Mixed,17,18,35
950370,True,0,8 user reviews,4,4,8
950380,True,0,No user reviews,0,0,0
950400,True,5,Mixed,8,7,15
950460,True,0,No user reviews,0,0,0
950490,True,0,1 user reviews,1,0,1
950500,True,0,No user reviews,0,0,0
950510,True,0,1 user reviews,0,1,1
950530,True,0,1 user reviews,1,0,1
950556,True,0,6 user reviews,6,0,6
950557,True,6,Mostly Positive,11,3,14
950558,True,7,Positive,9,1,10
950559,True,0,8 user reviews,6,2,8
950560,True,0,7 user reviews,7,0,7
950561,True,0,5 user reviews,5,0,5
950562,True,0,7 user reviews,5,2,7
950570,True,0,No user reviews,0,0,0
950580,True,0,No user reviews,0,0,0
950590,True,0,1 user reviews,1,0,1
950600,True,0,No user reviews,0,0,0
950620,True,0,No user reviews,0,0,0
950630,True,0,No user reviews,0,0,0
950640,True,0,No user reviews,0,0,0
950670,True,5,Mixed,1332,855,2187
950680,True,0,No user reviews,0,0,0
950690,True,0,No user reviews,0,0,0
950700,True,5,Mixed,14,9,23
950730,True,0,No user reviews,0,0,0
950740,True,8,Very Positive,93,13,106
950750,True,0,1 user reviews,1,0,1
950760,True,7,Positive,10,0,10
950770,True,0,No user reviews,0,0,0
950780,True,0,No user reviews,0,0,0
950810,True,0,5 user reviews,3,2,5
950820,True,7,Positive,18,2,20
950850,True,7,Positive,18,3,21
950860,True,0,1 user reviews,1,0,1
950880,True,0,No user reviews,0,0,0
950890,True,0,3 user reviews,3,0,3
950910,True,0,No user reviews,0,0,0
950920,True,0,No user reviews,0,0,0
950940,True,0,No user reviews,0,0,0
950950,True,0,1 user reviews,0,1,1
950980,True,0,No user reviews,0,0,0
950990,True,5,Mixed,45,24,69
951000,True,8,Very Positive,305,18,323
951010,True,0,4 user reviews,3,1,4
951030,True,0,5 user reviews,3,2,5
951040,True,0,No user reviews,0,0,0
951050,True,0,2 user reviews,2,0,2
951070,True,0,No user reviews,0,0,0
951100,True,0,No user reviews,0,0,0
951110,True,0,2 user reviews,1,1,2
951130,True,0,2 user reviews,2,0,2
951140,True,0,4 user reviews,3,1,4
951160,True,0,1 user reviews,0,1,1
951170,True,0,No user reviews,0,0,0
951190,True,0,3 user reviews,3,0,3
951210,True,0,No user reviews,0,0,0
951220,True,0,2 user reviews,2,0,2
951240,True,6,Mostly Positive,22,7,29
951250,True,0,No user reviews,0,0,0
951260,True,6,Mostly Positive,75,19,94
951310,True,0,No user reviews,0,0,0
951320,True,0,5 user reviews,1,4,5
951330,True,6,Mostly Positive,26,8,34
951350,True,0,1 user reviews,1,0,1
951360,True,0,3 user reviews,2,1,3
951370,True,7,Positive,12,3,15
951400,True,0,No user reviews,0,0,0
951410,True,0,No user reviews,0,0,0
951420,True,0,1 user reviews,1,0,1
951430,True,8,Very Positive,88,12,100
951440,True,8,Very Positive,692,145,837
951450,True,0,4 user reviews,2,2,4
951460,True,7,Positive,14,1,15
951470,True,0,No user reviews,0,0,0
951490,True,0,No user reviews,0,0,0
951500,True,0,6 user reviews,1,5,6
951510,True,0,9 user reviews,5,4,9
951530,True,0,No user reviews,0,0,0
951550,True,0,1 user reviews,0,1,1
951560,True,0,No user reviews,0,0,0
951570,True,0,No user reviews,0,0,0
951610,True,0,2 user reviews,2,0,2
951640,True,5,Mixed,6,6,12
951650,True,7,Positive,32,1,33
951660,True,0,3 user reviews,3,0,3
951661,True,0,No user reviews,0,0,0
951664,True,0,1 user reviews,1,0,1
951668,True,0,No user reviews,0,0,0
951670,True,8,Very Positive,144,29,173
951680,True,0,9 user reviews,7,2,9
951690,True,0,No user reviews,0,0,0
951700,True,0,9 user reviews,8,1,9
951740,True,7,Positive,34,5,39
951750,True,7,Positive,22,1,23
951760,True,0,6 user reviews,1,5,6
951770,True,0,No user reviews,0,0,0
951780,True,0,2 user reviews,0,2,2
951790,True,0,No user reviews,0,0,0
951800,True,0,No user reviews,0,0,0
951820,True,0,No user reviews,0,0,0
951830,True,7,Positive,10,0,10
951840,True,0,No user reviews,0,0,0
951850,True,0,No user reviews,0,0,0
951860,True,0,No user reviews,0,0,0
951870,True,0,2 user reviews,1,1,2
951910,True,0,No user reviews,0,0,0
951920,True,0,1 user reviews,0,1,1
951930,True,0,No user reviews,0,0,0
951940,True,7,Positive,21,4,25
951950,True,0,No user reviews,0,0,0
951980,True,0,No user reviews,0,0,0
952000,True,0,No user reviews,0,0,0
952010,True,0,8 user reviews,4,4,8
952020,True,5,Mixed,6,8,14
952030,True,0,8 user reviews,1,7,8
952040,True,8,Very Positive,343,54,397
952050,True,0,9 user reviews,9,0,9
952060,True,6,Mostly Positive,6305,2156,8461
952070,True,5,Mixed,491,669,1160
952080,True,7,Positive,8,2,10
952090,True,0,No user reviews,0,0,0
952120,True,0,No user reviews,0,0,0
952130,True,0,5 user reviews,5,0,5
952140,True,0,No user reviews,0,0,0
952150,True,0,No user reviews,0,0,0
952170,True,0,No user reviews,0,0,0
952180,True,0,No user reviews,0,0,0
952200,True,7,Positive,40,5,45
952210,True,0,No user reviews,0,0,0
952230,True,0,3 user reviews,2,1,3
952240,True,0,No user reviews,0,0,0
952250,True,0,No user reviews,0,0,0
952270,True,0,No user reviews,0,0,0
952290,True,0,9 user reviews,9,0,9
952320,True,0,No user reviews,0,0,0
952330,True,0,2 user reviews,2,0,2
952340,True,0,No user reviews,0,0,0
952370,True,0,No user reviews,0,0,0
952390,True,0,4 user reviews,1,3,4
952400,True,0,9 user reviews,7,2,9
952410,True,0,No user reviews,0,0,0
952420,True,7,Positive,10,0,10
952430,True,0,No user reviews,0,0,0
952440,True,0,No user reviews,0,0,0
952460,True,5,Mixed,11,6,17
952480,True,0,No user reviews,0,0,0
952490,True,7,Positive,12,0,12
952500,True,0,No user reviews,0,0,0
952510,True,0,No user reviews,0,0,0
952540,True,8,Very Positive,63,7,70
952560,True,0,No user reviews,0,0,0
952570,True,0,3 user reviews,1,2,3
952630,True,0,No user reviews,0,0,0
952640,True,0,No user reviews,0,0,0
952650,True,0,3 user reviews,1,2,3
952651,True,0,1 user reviews,0,1,1
952652,True,0,No user reviews,0,0,0
952670,True,0,3 user reviews,3,0,3
952671,True,0,No user reviews,0,0,0
952680,True,0,1 user reviews,0,1,1
952690,True,0,No user reviews,0,0,0
952700,True,0,No user reviews,0,0,0
952710,True,0,No user reviews,0,0,0
952740,True,0,No user reviews,0,0,0
952741,True,0,No user reviews,0,0,0
952742,True,0,No user reviews,0,0,0
952743,True,0,No user reviews,0,0,0
952770,True,0,No user reviews,0,0,0
952780,True,0,No user reviews,0,0,0
952781,True,0,No user reviews,0,0,0
952782,True,0,No user reviews,0,0,0
952783,True,0,No user reviews,0,0,0
952784,True,0,No user reviews,0,0,0
952785,True,0,No user reviews,0,0,0
952786,True,0,No user reviews,0,0,0
952787,True,0,No user reviews,0,0,0
952788,True,0,No user reviews,0,0,0
952789,True,0,No user reviews,0,0,0
952790,True,0,No user reviews,0,0,0
952791,True,0,No user reviews,0,0,0
952792,True,0,No user reviews,0,0,0
952793,True,0,No user reviews,0,0,0
952794,True,0,No user reviews,0,0,0
952795,True,0,No user reviews,0,0,0
952796,True,0,No user reviews,0,0,0
952797,True,0,No user reviews,0,0,0
952798,True,0,No user reviews,0,0,0
952799,True,0,No user reviews,0,0,0
952800,True,0,No user reviews,0,0,0
952801,True,0,No user reviews,0,0,0
952802,True,0,No user reviews,0,0,0
952803,True,0,No user reviews,0,0,0
952804,True,0,No user reviews,0,0,0
952805,True,0,No user reviews,0,0,0
952806,True,0,No user reviews,0,0,0
952807,True,0,No user reviews,0,0,0
952808,True,0,No user reviews,0,0,0
952809,True,0,No user reviews,0,0,0
952810,True,0,No user reviews,0,0,0
952811,True,0,No user reviews,0,0,0
952812,True,0,No user reviews,0,0,0
952813,True,0,No user reviews,0,0,0
952814,True,0,No user reviews,0,0,0
952815,True,0,No user reviews,0,0,0
952816,True,0,No user reviews,0,0,0
952817,True,0,No user reviews,0,0,0
952818,True,0,No user reviews,0,0,0
952819,True,0,No user reviews,0,0,0
952820,True,0,No user reviews,0,0,0
952850,True,0,No user reviews,0,0,0
952860,True,8,Very Positive,143,33,176
952870,True,0,No user reviews,0,0,0
952890,True,8,Very Positive,70,12,82
952891,True,7,Positive,23,1,24
952892,True,7,Positive,14,0,14
952900,True,0,1 user reviews,1,0,1
952910,True,0,1 user reviews,1,0,1
952920,True,0,9 user reviews,6,3,9
952930,True,0,5 user reviews,3,2,5
952940,True,0,No user reviews,0,0,0
952950,True,6,Mostly Positive,42,12,54
952960,True,0,No user reviews,0,0,0
952970,True,0,No user reviews,0,0,0
952980,True,0,No user reviews,0,0,0
953000,True,0,No user reviews,0,0,0
953010,True,0,No user reviews,0,0,0
953020,True,0,4 user reviews,1,3,4
953050,True,0,9 user reviews,1,8,9
953060,True,5,Mixed,5,6,11
953080,True,7,Positive,12,0,12
953094,True,0,No user reviews,0,0,0
953095,True,0,No user reviews,0,0,0
953096,True,0,No user reviews,0,0,0
953101,True,0,No user reviews,0,0,0
953106,True,0,No user reviews,0,0,0
953110,True,0,No user reviews,0,0,0
953120,True,0,1 user reviews,0,1,1
953140,True,0,No user reviews,0,0,0
953150,True,0,2 user reviews,1,1,2
953160,True,0,No user reviews,0,0,0
953170,True,0,No user reviews,0,0,0
953190,True,0,1 user reviews,0,1,1
953210,True,0,No user reviews,0,0,0
953220,True,0,1 user reviews,1,0,1
953230,True,8,Very Positive,82,7,89
953240,True,0,2 user reviews,1,1,2
953250,True,0,No user reviews,0,0,0
953270,True,7,Positive,34,5,39
953290,True,0,No user reviews,0,0,0
953310,True,0,No user reviews,0,0,0
953340,True,0,1 user reviews,1,0,1
953350,True,0,No user reviews,0,0,0
953370,True,5,Mixed,47,33,80
953380,True,0,No user reviews,0,0,0
953390,True,0,No user reviews,0,0,0
953400,True,0,No user reviews,0,0,0
953440,True,0,No user reviews,0,0,0
953450,True,7,Positive,19,1,20
953490,True,8,Very Positive,4611,322,4933
953510,True,0,No user reviews,0,0,0
953550,True,0,No user reviews,0,0,0
953560,True,0,No user reviews,0,0,0
953570,True,0,No user reviews,0,0,0
953580,True,5,Mixed,191,136,327
953610,True,0,9 user reviews,5,4,9
953630,True,0,No user reviews,0,0,0
953631,True,0,No user reviews,0,0,0
953632,True,0,No user reviews,0,0,0
953633,True,0,No user reviews,0,0,0
953634,True,0,No user reviews,0,0,0
953635,True,0,No user reviews,0,0,0
953636,True,0,No user reviews,0,0,0
953637,True,0,No user reviews,0,0,0
953638,True,0,No user reviews,0,0,0
953639,True,0,No user reviews,0,0,0
953640,True,0,1 user reviews,0,1,1
953650,True,0,No user reviews,0,0,0
953660,True,6,Mostly Positive,31,13,44
953670,True,0,No user reviews,0,0,0
953671,True,0,No user reviews,0,0,0
953672,True,0,No user reviews,0,0,0
953673,True,0,No user reviews,0,0,0
953674,True,0,No user reviews,0,0,0
953675,True,0,No user reviews,0,0,0
953676,True,0,No user reviews,0,0,0
953680,True,0,No user reviews,0,0,0
953681,True,0,4 user reviews,3,1,4
953682,True,0,No user reviews,0,0,0
953690,True,7,Positive,11,2,13
953700,True,0,1 user reviews,1,0,1
953720,True,0,No user reviews,0,0,0
953721,True,0,No user reviews,0,0,0
953722,True,0,No user reviews,0,0,0
953723,True,0,No user reviews,0,0,0
953724,True,0,No user reviews,0,0,0
953725,True,0,No user reviews,0,0,0
953726,True,0,No user reviews,0,0,0
953727,True,0,No user reviews,0,0,0
953728,True,0,No user reviews,0,0,0
953729,True,0,No user reviews,0,0,0
953730,True,0,No user reviews,0,0,0
953740,True,0,5 user reviews,3,2,5
953750,True,0,1 user reviews,0,1,1
953760,True,0,No user reviews,0,0,0
953780,True,0,No user reviews,0,0,0
953790,True,0,1 user reviews,0,1,1
953800,True,0,1 user reviews,1,0,1
953810,True,0,No user reviews,0,0,0
953820,True,0,4 user reviews,4,0,4
953830,True,0,No user reviews,0,0,0
953840,True,6,Mostly Positive,87,22,109
953860,True,0,No user reviews,0,0,0
953870,True,5,Mixed,30,16,46
953880,True,0,No user reviews,0,0,0
953900,True,7,Positive,20,4,24
953910,True,0,No user reviews,0,0,0
953920,True,0,1 user reviews,1,0,1
953940,True,6,Mostly Positive,91,28,119
953950,True,0,6 user reviews,6,0,6
953980,True,0,3 user reviews,2,1,3
953981,True,0,6 user reviews,2,4,6
953990,True,5,Mixed,13,6,19
954000,True,5,Mixed,9,6,15
954010,True,0,4 user reviews,4,0,4
954020,True,0,No user reviews,0,0,0
954030,True,0,9 user reviews,7,2,9
954060,True,8,Very Positive,82,3,85
954070,True,0,No user reviews,0,0,0
954080,True,6,Mostly Positive,21,9,30
954090,True,0,No user reviews,0,0,0
954100,True,0,No user reviews,0,0,0
954101,True,0,5 user reviews,4,1,5
954102,True,0,No user reviews,0,0,0
954103,True,7,Positive,11,0,11
954110,True,0,No user reviews,0,0,0
954120,True,0,No user reviews,0,0,0
954130,True,0,No user reviews,0,0,0
954140,True,0,No user reviews,0,0,0
954150,True,7,Positive,22,4,26
954160,True,0,No user reviews,0,0,0
954170,True,0,No user reviews,0,0,0
954200,True,0,No user reviews,0,0,0
954210,True,0,No user reviews,0,0,0
954220,True,0,No user reviews,0,0,0
954221,True,0,No user reviews,0,0,0
954230,True,0,No user reviews,0,0,0
954240,True,0,3 user reviews,3,0,3
954250,True,0,No user reviews,0,0,0
954270,True,7,Positive,17,4,21
954280,True,8,Very Positive,62,5,67
954290,True,0,No user reviews,0,0,0
954310,True,0,No user reviews,0,0,0
954320,True,0,No user reviews,0,0,0
954350,True,0,No user reviews,0,0,0
954360,True,0,No user reviews,0,0,0
954370,True,0,No user reviews,0,0,0
954400,True,0,No user reviews,0,0,0
954410,True,0,No user reviews,0,0,0
954420,True,0,2 user reviews,2,0,2
954460,True,0,No user reviews,0,0,0
954480,True,0,No user reviews,0,0,0
954510,True,0,No user reviews,0,0,0
954530,True,5,Mixed,7,7,14
954540,True,0,No user reviews,0,0,0
954550,True,0,No user reviews,0,0,0
954560,True,7,Positive,14,1,15
954590,True,7,Positive,13,2,15
954600,True,0,2 user reviews,2,0,2
954601,True,0,1 user reviews,1,0,1
954602,True,0,5 user reviews,4,1,5
954603,True,0,9 user reviews,7,2,9
954604,True,0,No user reviews,0,0,0
954605,True,0,No user reviews,0,0,0
954606,True,0,1 user reviews,1,0,1
954607,True,0,No user reviews,0,0,0
954609,True,0,1 user reviews,1,0,1
954610,True,6,Mostly Positive,131,50,181
954620,True,0,No user reviews,0,0,0
954630,True,0,No user reviews,0,0,0
954650,True,8,Very Positive,543,100,643
954670,True,0,No user reviews,0,0,0
954680,True,0,No user reviews,0,0,0
954690,True,0,4 user reviews,4,0,4
954710,True,0,No user reviews,0,0,0
954720,True,0,8 user reviews,5,3,8
954730,True,0,No user reviews,0,0,0
954740,True,8,Very Positive,2682,208,2890
954760,True,0,No user reviews,0,0,0
954770,True,0,No user reviews,0,0,0
954780,True,0,No user reviews,0,0,0
954800,True,0,1 user reviews,1,0,1
954810,True,5,Mixed,10,6,16
954820,True,0,No user reviews,0,0,0
954860,True,0,8 user reviews,7,1,8
954870,True,8,Very Positive,316,40,356
954880,True,6,Mostly Positive,12,4,16
954920,True,0,2 user reviews,2,0,2
954940,True,0,No user reviews,0,0,0
954950,True,0,1 user reviews,1,0,1
954960,True,0,No user reviews,0,0,0
954970,True,0,2 user reviews,0,2,2
955020,True,0,No user reviews,0,0,0
955030,True,0,No user reviews,0,0,0
955050,True,8,Very Positive,3494,333,3827
955060,True,5,Mixed,187,111,298
955070,True,5,Mixed,5,7,12
955080,True,0,No user reviews,0,0,0
955090,True,0,No user reviews,0,0,0
955120,True,0,1 user reviews,1,0,1
955130,True,7,Positive,28,2,30
955140,True,0,No user reviews,0,0,0
955170,True,0,4 user reviews,3,1,4
955180,True,0,2 user reviews,2,0,2
955181,True,0,No user reviews,0,0,0
955182,True,0,1 user reviews,1,0,1
955190,True,0,4 user reviews,4,0,4
955210,True,0,1 user reviews,1,0,1
955240,True,0,No user reviews,0,0,0
955250,True,0,6 user reviews,5,1,6
955260,True,0,9 user reviews,7,2,9
955290,True,0,No user reviews,0,0,0
955300,True,0,1 user reviews,0,1,1
955320,True,8,Very Positive,61,4,65
955360,True,5,Mixed,5,5,10
955370,True,7,Positive,10,1,11
955380,True,0,6 user reviews,1,5,6
955400,True,7,Positive,19,2,21
955410,True,7,Positive,10,0,10
955440,True,0,No user reviews,0,0,0
955470,True,7,Positive,23,2,25
955480,True,0,No user reviews,0,0,0
955490,True,0,4 user reviews,3,1,4
955500,True,0,No user reviews,0,0,0
955520,True,0,No user reviews,0,0,0
955530,True,0,No user reviews,0,0,0
955540,True,0,1 user reviews,1,0,1
955550,True,0,2 user reviews,2,0,2
955560,True,8,Very Positive,428,33,461
955570,True,0,1 user reviews,1,0,1
955580,True,5,Mixed,16,9,25
955590,True,0,1 user reviews,1,0,1
955600,True,0,3 user reviews,1,2,3
955610,True,0,3 user reviews,3,0,3
955620,True,0,No user reviews,0,0,0
955640,True,7,Positive,16,2,18
955650,True,0,No user reviews,0,0,0
955670,True,0,4 user reviews,3,1,4
955700,True,0,3 user reviews,3,0,3
955710,True,0,6 user reviews,6,0,6
955740,True,8,Very Positive,204,4,208
955750,True,0,No user reviews,0,0,0
955760,True,0,No user reviews,0,0,0
955780,True,0,No user reviews,0,0,0
955790,True,0,6 user reviews,6,0,6
955810,True,0,No user reviews,0,0,0
955830,True,0,2 user reviews,2,0,2
955840,True,0,1 user reviews,1,0,1
955860,True,0,3 user reviews,2,1,3
955870,True,0,No user reviews,0,0,0
955890,True,0,1 user reviews,0,1,1
955900,True,8,Very Positive,124,11,135
955910,True,0,No user reviews,0,0,0
955940,True,0,No user reviews,0,0,0
955950,True,0,No user reviews,0,0,0
955970,True,0,No user reviews,0,0,0
955980,True,0,1 user reviews,0,1,1
955990,True,0,3 user reviews,2,1,3
956000,True,0,1 user reviews,1,0,1
956010,True,7,Positive,9,2,11
956030,True,8,Very Positive,217,17,234
956060,True,4,Mostly Negative,9,15,24
956070,True,0,7 user reviews,7,0,7
956080,True,0,No user reviews,0,0,0
956090,True,0,5 user reviews,5,0,5
956100,True,0,6 user reviews,5,1,6
956120,True,0,No user reviews,0,0,0
956140,True,0,No user reviews,0,0,0
956150,True,0,2 user reviews,0,2,2
956200,True,0,3 user reviews,3,0,3
956210,True,0,4 user reviews,3,1,4
956220,True,0,No user reviews,0,0,0
956230,True,0,No user reviews,0,0,0
956240,True,0,1 user reviews,1,0,1
956260,True,0,No user reviews,0,0,0
956270,True,0,No user reviews,0,0,0
956280,True,0,No user reviews,0,0,0
956290,True,0,No user reviews,0,0,0
956300,True,0,No user reviews,0,0,0
956310,True,0,5 user reviews,5,0,5
956320,True,0,No user reviews,0,0,0
956330,True,0,No user reviews,0,0,0
956340,True,0,No user reviews,0,0,0
956350,True,0,2 user reviews,2,0,2
956360,True,0,5 user reviews,5,0,5
956380,True,0,5 user reviews,5,0,5
956390,True,0,1 user reviews,1,0,1
956400,True,0,1 user reviews,1,0,1
956430,True,0,2 user reviews,1,1,2
956440,True,0,No user reviews,0,0,0
956450,True,8,Very Positive,194,15,209
956460,True,0,No user reviews,0,0,0
956470,True,0,No user reviews,0,0,0
956480,True,0,4 user reviews,1,3,4
956490,True,0,No user reviews,0,0,0
956500,True,7,Positive,21,3,24
956540,True,0,No user reviews,0,0,0
956550,True,0,4 user reviews,2,2,4
956560,True,7,Positive,18,1,19
956580,True,0,No user reviews,0,0,0
956590,True,0,1 user reviews,0,1,1
956600,True,6,Mostly Positive,33,12,45
956610,True,0,No user reviews,0,0,0
956620,True,0,6 user reviews,5,1,6
956630,True,0,No user reviews,0,0,0
956640,True,0,2 user reviews,2,0,2
956650,True,0,1 user reviews,1,0,1
956680,True,8,Very Positive,714,82,796
956700,True,0,No user reviews,0,0,0
956701,True,0,No user reviews,0,0,0
956702,True,0,No user reviews,0,0,0
956703,True,0,No user reviews,0,0,0
956704,True,0,No user reviews,0,0,0
956705,True,0,No user reviews,0,0,0
956706,True,0,No user reviews,0,0,0
956707,True,0,No user reviews,0,0,0
956708,True,0,No user reviews,0,0,0
956709,True,0,No user reviews,0,0,0
956720,True,0,No user reviews,0,0,0
956721,True,0,No user reviews,0,0,0
956722,True,0,No user reviews,0,0,0
956723,True,0,No user reviews,0,0,0
956724,True,0,No user reviews,0,0,0
956725,True,0,No user reviews,0,0,0
956726,True,0,1 user reviews,1,0,1
956727,True,0,No user reviews,0,0,0
956728,True,0,No user reviews,0,0,0
956729,True,0,No user reviews,0,0,0
956730,True,0,No user reviews,0,0,0
956731,True,0,No user reviews,0,0,0
956732,True,0,No user reviews,0,0,0
956733,True,0,No user reviews,0,0,0
956734,True,0,No user reviews,0,0,0
956735,True,0,No user reviews,0,0,0
956736,True,0,No user reviews,0,0,0
956737,True,0,No user reviews,0,0,0
956738,True,0,No user reviews,0,0,0
956739,True,0,No user reviews,0,0,0
956750,True,0,No user reviews,0,0,0
956751,True,0,No user reviews,0,0,0
956752,True,0,No user reviews,0,0,0
956753,True,0,No user reviews,0,0,0
956760,True,0,No user reviews,0,0,0
956761,True,0,No user reviews,0,0,0
956762,True,0,No user reviews,0,0,0
956763,True,0,No user reviews,0,0,0
956764,True,0,No user reviews,0,0,0
956765,True,0,No user reviews,0,0,0
956766,True,0,No user reviews,0,0,0
956767,True,0,No user reviews,0,0,0
956768,True,0,No user reviews,0,0,0
956769,True,0,1 user reviews,1,0,1
956770,True,0,No user reviews,0,0,0
956771,True,0,No user reviews,0,0,0
956772,True,0,No user reviews,0,0,0
956780,True,0,No user reviews,0,0,0
956840,True,0,No user reviews,0,0,0
956860,True,0,No user reviews,0,0,0
956861,True,0,No user reviews,0,0,0
956862,True,0,No user reviews,0,0,0
956863,True,0,No user reviews,0,0,0
956864,True,0,No user reviews,0,0,0
956865,True,0,No user reviews,0,0,0
956866,True,0,No user reviews,0,0,0
956867,True,0,No user reviews,0,0,0
956868,True,0,No user reviews,0,0,0
956869,True,0,No user reviews,0,0,0
956870,True,0,No user reviews,0,0,0
956880,True,0,No user reviews,0,0,0
956890,True,0,No user reviews,0,0,0
956891,True,0,No user reviews,0,0,0
956892,True,0,No user reviews,0,0,0
956893,True,0,No user reviews,0,0,0
956894,True,0,No user reviews,0,0,0
956895,True,0,No user reviews,0,0,0
956896,True,0,No user reviews,0,0,0
956897,True,0,No user reviews,0,0,0
956898,True,0,No user reviews,0,0,0
956899,True,0,No user reviews,0,0,0
956900,True,0,No user reviews,0,0,0
956920,True,0,No user reviews,0,0,0
956921,True,0,No user reviews,0,0,0
956922,True,0,No user reviews,0,0,0
956923,True,0,No user reviews,0,0,0
956924,True,0,No user reviews,0,0,0
956930,True,0,No user reviews,0,0,0
956940,True,0,No user reviews,0,0,0
956941,True,0,No user reviews,0,0,0
956942,True,0,No user reviews,0,0,0
956943,True,0,No user reviews,0,0,0
956944,True,0,No user reviews,0,0,0
956945,True,0,No user reviews,0,0,0
956946,True,0,No user reviews,0,0,0
956947,True,0,No user reviews,0,0,0
956948,True,0,No user reviews,0,0,0
956949,True,0,No user reviews,0,0,0
956990,True,0,2 user reviews,2,0,2
957040,True,0,No user reviews,0,0,0
957050,True,5,Mixed,28,38,66
957060,True,0,No user reviews,0,0,0
957070,True,0,9 user reviews,8,1,9
957080,True,0,5 user reviews,2,3,5
957090,True,0,No user reviews,0,0,0
957110,True,7,Positive,13,2,15
957120,True,0,8 user reviews,8,0,8
957122,True,0,3 user reviews,2,1,3
957124,True,0,4 user reviews,4,0,4
957126,True,0,7 user reviews,5,2,7
957130,True,0,No user reviews,0,0,0
957140,True,0,No user reviews,0,0,0
957150,True,0,No user reviews,0,0,0
957210,True,0,No user reviews,0,0,0
957220,True,0,No user reviews,0,0,0
957230,True,0,No user reviews,0,0,0
957270,True,0,No user reviews,0,0,0
957280,True,0,1 user reviews,1,0,1
957290,True,0,No user reviews,0,0,0
957300,True,0,No user reviews,0,0,0
957310,True,0,No user reviews,0,0,0
957320,True,0,No user reviews,0,0,0
957330,True,0,No user reviews,0,0,0
957340,True,0,No user reviews,0,0,0
957350,True,0,1 user reviews,1,0,1
957390,True,0,3 user reviews,2,1,3
957410,True,5,Mixed,8,8,16
957430,True,6,Mostly Positive,8,3,11
957440,True,6,Mostly Positive,12,4,16
957450,True,0,No user reviews,0,0,0
957490,True,0,No user reviews,0,0,0
957510,True,0,No user reviews,0,0,0
957530,True,0,1 user reviews,1,0,1
957531,True,0,No user reviews,0,0,0
957532,True,0,No user reviews,0,0,0
957533,True,0,No user reviews,0,0,0
957534,True,0,No user reviews,0,0,0
957535,True,0,No user reviews,0,0,0
957536,True,0,No user reviews,0,0,0
957537,True,0,1 user reviews,1,0,1
957538,True,0,1 user reviews,1,0,1
957539,True,0,No user reviews,0,0,0
957541,True,0,No user reviews,0,0,0
957570,True,0,7 user reviews,7,0,7
957590,True,0,No user reviews,0,0,0
957600,True,0,No user reviews,0,0,0
957601,True,0,No user reviews,0,0,0
957602,True,0,No user reviews,0,0,0
957603,True,0,No user reviews,0,0,0
957604,True,0,No user reviews,0,0,0
957605,True,0,No user reviews,0,0,0
957607,True,0,No user reviews,0,0,0
957610,True,0,No user reviews,0,0,0
957630,True,0,3 user reviews,3,0,3
957660,True,0,No user reviews,0,0,0
957680,True,0,8 user reviews,8,0,8
957690,True,6,Mostly Positive,142,55,197
957695,True,0,1 user reviews,1,0,1
957697,True,0,No user reviews,0,0,0
957698,True,0,No user reviews,0,0,0
957710,True,5,Mixed,67,38,105
957720,True,8,Very Positive,128,22,150
957730,True,0,1 user reviews,1,0,1
957733,True,0,No user reviews,0,0,0
957760,True,0,No user reviews,0,0,0
957761,True,0,No user reviews,0,0,0
957762,True,0,No user reviews,0,0,0
957770,True,0,3 user reviews,3,0,3
957780,True,5,Mixed,7,5,12
957790,True,6,Mostly Positive,530,168,698
957800,True,0,No user reviews,0,0,0
957810,True,0,No user reviews,0,0,0
957820,True,7,Positive,20,2,22
957830,True,0,No user reviews,0,0,0
957840,True,0,No user reviews,0,0,0
957850,True,0,3 user reviews,3,0,3
957880,True,0,No user reviews,0,0,0
957890,True,0,7 user reviews,6,1,7
957900,True,0,No user reviews,0,0,0
957901,True,0,No user reviews,0,0,0
957902,True,0,No user reviews,0,0,0
957903,True,0,No user reviews,0,0,0
957904,True,0,No user reviews,0,0,0
957905,True,0,No user reviews,0,0,0
957906,True,0,No user reviews,0,0,0
957910,True,0,No user reviews,0,0,0
957911,True,0,No user reviews,0,0,0
957912,True,0,No user reviews,0,0,0
957913,True,0,No user reviews,0,0,0
957914,True,0,No user reviews,0,0,0
957915,True,0,No user reviews,0,0,0
957916,True,0,No user reviews,0,0,0
957917,True,0,No user reviews,0,0,0
957919,True,0,No user reviews,0,0,0
957920,True,0,No user reviews,0,0,0
957921,True,0,No user reviews,0,0,0
957930,True,0,1 user reviews,0,1,1
957950,True,0,No user reviews,0,0,0
957960,True,0,No user reviews,0,0,0
957970,True,0,1 user reviews,0,1,1
957971,True,0,No user reviews,0,0,0
957972,True,0,No user reviews,0,0,0
957973,True,0,No user reviews,0,0,0
957974,True,0,No user reviews,0,0,0
957975,True,0,No user reviews,0,0,0
957976,True,0,No user reviews,0,0,0
957977,True,0,No user reviews,0,0,0
957978,True,0,No user reviews,0,0,0
957979,True,0,No user reviews,0,0,0
957980,True,0,No user reviews,0,0,0
957981,True,0,No user reviews,0,0,0
957982,True,0,No user reviews,0,0,0
957983,True,0,No user reviews,0,0,0
957984,True,0,No user reviews,0,0,0
957985,True,0,No user reviews,0,0,0
957986,True,0,No user reviews,0,0,0
957987,True,0,No user reviews,0,0,0
957988,True,0,No user reviews,0,0,0
957989,True,0,No user reviews,0,0,0
957990,True,0,No user reviews,0,0,0
957991,True,0,No user reviews,0,0,0
957992,True,0,No user reviews,0,0,0
957993,True,0,No user reviews,0,0,0
957994,True,0,No user reviews,0,0,0
957995,True,0,No user reviews,0,0,0
957996,True,0,No user reviews,0,0,0
957997,True,0,No user reviews,0,0,0
957998,True,0,No user reviews,0,0,0
957999,True,0,No user reviews,0,0,0
958000,True,0,No user reviews,0,0,0
958001,True,0,No user reviews,0,0,0
958010,True,0,No user reviews,0,0,0
958030,True,0,No user reviews,0,0,0
958050,True,7,Positive,20,3,23
958060,True,0,No user reviews,0,0,0
958070,True,0,No user reviews,0,0,0
958090,True,0,2 user reviews,2,0,2
958130,True,0,2 user reviews,0,2,2
958140,True,0,No user reviews,0,0,0
958150,True,0,No user reviews,0,0,0
958160,True,0,No user reviews,0,0,0
958190,True,0,No user reviews,0,0,0
958200,True,0,2 user reviews,2,0,2
958210,True,5,Mixed,14,7,21
958220,True,0,2 user reviews,2,0,2
958230,True,0,8 user reviews,1,7,8
958240,True,0,No user reviews,0,0,0
958250,True,0,No user reviews,0,0,0
958260,True,0,No user reviews,0,0,0
958280,True,5,Mixed,5,5,10
958290,True,0,No user reviews,0,0,0
958300,True,0,7 user reviews,5,2,7
958310,True,0,4 user reviews,2,2,4
958320,True,5,Mixed,46,27,73
958340,True,0,No user reviews,0,0,0
958360,True,0,No user reviews,0,0,0
958370,True,8,Very Positive,129,13,142
958380,True,0,2 user reviews,2,0,2
958381,True,0,2 user reviews,2,0,2
958390,True,0,No user reviews,0,0,0
958400,True,5,Mixed,244,214,458
958430,True,0,No user reviews,0,0,0
958440,True,0,No user reviews,0,0,0
958460,True,0,No user reviews,0,0,0
958480,True,6,Mostly Positive,196,57,253
958490,True,0,4 user reviews,3,1,4
958510,True,0,No user reviews,0,0,0
958530,True,0,No user reviews,0,0,0
958540,True,0,No user reviews,0,0,0
958570,True,0,No user reviews,0,0,0
958580,True,0,No user reviews,0,0,0
958590,True,0,No user reviews,0,0,0
958600,True,0,No user reviews,0,0,0
958640,True,0,1 user reviews,1,0,1
958650,True,0,No user reviews,0,0,0
958660,True,0,No user reviews,0,0,0
958680,True,0,No user reviews,0,0,0
958690,True,0,7 user reviews,7,0,7
958710,True,0,No user reviews,0,0,0
958711,True,0,No user reviews,0,0,0
958720,True,0,No user reviews,0,0,0
958730,True,0,2 user reviews,0,2,2
958740,True,8,Very Positive,47,10,57
958750,True,0,No user reviews,0,0,0
958760,True,0,No user reviews,0,0,0
958790,True,0,5 user reviews,5,0,5
958800,True,0,No user reviews,0,0,0
958820,True,0,No user reviews,0,0,0
958840,True,0,No user reviews,0,0,0
958870,True,0,1 user reviews,1,0,1
958880,True,7,Positive,18,2,20
958900,True,0,1 user reviews,0,1,1
958910,True,0,No user reviews,0,0,0
958930,True,0,No user reviews,0,0,0
958940,True,0,No user reviews,0,0,0
958950,True,0,1 user reviews,1,0,1
958960,True,0,6 user reviews,0,6,6
958970,True,0,No user reviews,0,0,0
958980,True,7,Positive,11,1,12
958990,True,0,2 user reviews,1,1,2
959000,True,7,Positive,33,2,35
959020,True,0,3 user reviews,3,0,3
959030,True,0,5 user reviews,3,2,5
959050,True,7,Positive,22,2,24
959060,True,0,1 user reviews,1,0,1
959070,True,0,No user reviews,0,0,0
959080,True,0,No user reviews,0,0,0
959090,True,0,2 user reviews,2,0,2
959110,True,0,No user reviews,0,0,0
959130,True,0,5 user reviews,4,1,5
959140,True,0,No user reviews,0,0,0
959150,True,7,Positive,12,2,14
959160,True,7,Positive,15,0,15
959170,True,0,No user reviews,0,0,0
959190,True,0,No user reviews,0,0,0
959200,True,0,8 user reviews,5,3,8
959210,True,0,No user reviews,0,0,0
959220,True,0,No user reviews,0,0,0
959230,True,0,No user reviews,0,0,0
959250,True,0,No user reviews,0,0,0
959260,True,0,2 user reviews,1,1,2
959280,True,0,No user reviews,0,0,0
959290,True,0,No user reviews,0,0,0
959320,True,0,No user reviews,0,0,0
959340,True,0,1 user reviews,0,1,1
959350,True,7,Positive,11,1,12
959380,True,0,No user reviews,0,0,0
959400,True,0,4 user reviews,4,0,4
959410,True,7,Positive,40,1,41
959430,True,0,No user reviews,0,0,0
959450,True,0,No user reviews,0,0,0
959460,True,0,No user reviews,0,0,0
959490,True,0,No user reviews,0,0,0
959500,True,0,No user reviews,0,0,0
959510,True,0,No user reviews,0,0,0
959520,True,5,Mixed,169,84,253
959530,True,0,No user reviews,0,0,0
959540,True,0,2 user reviews,1,1,2
959550,True,0,No user reviews,0,0,0
959560,True,0,No user reviews,0,0,0
959570,True,0,No user reviews,0,0,0
959580,True,0,No user reviews,0,0,0
959590,True,0,1 user reviews,1,0,1
959610,True,0,No user reviews,0,0,0
959620,True,0,No user reviews,0,0,0
959630,True,0,No user reviews,0,0,0
959640,True,0,No user reviews,0,0,0
959650,True,0,No user reviews,0,0,0
959660,True,0,No user reviews,0,0,0
959670,True,0,No user reviews,0,0,0
959680,True,0,No user reviews,0,0,0
959690,True,0,No user reviews,0,0,0
959700,True,0,No user reviews,0,0,0
959710,True,0,6 user reviews,6,0,6
959730,True,0,3 user reviews,3,0,3
959750,True,0,No user reviews,0,0,0
959760,True,0,No user reviews,0,0,0
959770,True,0,4 user reviews,2,2,4
959780,True,0,No user reviews,0,0,0
959790,True,0,No user reviews,0,0,0
959800,True,0,No user reviews,0,0,0
959816,True,0,No user reviews,0,0,0
959820,True,0,No user reviews,0,0,0
959830,True,0,2 user reviews,2,0,2
959840,True,0,No user reviews,0,0,0
959850,True,0,3 user reviews,2,1,3
959870,True,0,1 user reviews,1,0,1
959880,True,0,No user reviews,0,0,0
959890,True,8,Very Positive,51,3,54
959910,True,0,No user reviews,0,0,0
959920,True,0,6 user reviews,3,3,6
959930,True,0,No user reviews,0,0,0
959950,True,0,No user reviews,0,0,0
960030,True,0,5 user reviews,5,0,5
960040,True,6,Mostly Positive,18,6,24
960060,True,0,No user reviews,0,0,0
960090,True,9,Overwhelmingly Positive,23546,1071,24617
960120,True,0,1 user reviews,0,1,1
960130,True,0,No user reviews,0,0,0
960140,True,0,1 user reviews,1,0,1
960150,True,0,5 user reviews,3,2,5
960170,True,8,Very Positive,881,155,1036
960180,True,0,No user reviews,0,0,0
960190,True,8,Very Positive,48,12,60
960200,True,0,4 user reviews,2,2,4
960220,True,0,5 user reviews,5,0,5
960240,True,0,2 user reviews,2,0,2
960270,True,0,No user reviews,0,0,0
960290,True,0,No user reviews,0,0,0
960300,True,0,1 user reviews,0,1,1
960310,True,7,Positive,39,0,39
960320,True,0,No user reviews,0,0,0
960330,True,0,No user reviews,0,0,0
960340,True,0,No user reviews,0,0,0
960360,True,6,Mostly Positive,10,4,14
960420,True,7,Positive,21,1,22
960550,True,0,4 user reviews,4,0,4
960590,True,0,7 user reviews,5,2,7
960600,True,0,2 user reviews,1,1,2
960610,True,0,6 user reviews,1,5,6
960620,True,0,No user reviews,0,0,0
960630,True,0,No user reviews,0,0,0
960640,True,0,No user reviews,0,0,0
960650,True,0,No user reviews,0,0,0
960660,True,0,2 user reviews,1,1,2
960680,True,4,Mostly Negative,5,9,14
960690,True,9,Overwhelmingly Positive,1659,72,1731
960700,True,0,3 user reviews,3,0,3
960710,True,7,Positive,43,4,47
960720,True,0,No user reviews,0,0,0
960740,True,5,Mixed,23,17,40
960770,True,0,No user reviews,0,0,0
960771,True,0,No user reviews,0,0,0
960781,True,0,No user reviews,0,0,0
960790,True,0,No user reviews,0,0,0
960800,True,0,No user reviews,0,0,0
960820,True,0,2 user reviews,2,0,2
960831,True,8,Very Positive,51,9,60
960890,True,0,No user reviews,0,0,0
960900,True,0,5 user reviews,4,1,5
960910,True,8,Very Positive,407,92,499
960920,True,4,Mostly Negative,83,148,231
960940,True,0,No user reviews,0,0,0
960980,True,8,Very Positive,188,35,223
960990,True,8,Very Positive,753,104,857
961000,True,0,2 user reviews,2,0,2
961010,True,7,Positive,9,1,10
961020,True,0,No user reviews,0,0,0
961030,True,0,No user reviews,0,0,0
961040,True,5,Mixed,9,8,17
961060,True,0,3 user reviews,2,1,3
961080,True,0,No user reviews,0,0,0
961090,True,0,No user reviews,0,0,0
961100,True,0,No user reviews,0,0,0
961110,True,0,2 user reviews,2,0,2
961140,True,0,No user reviews,0,0,0
961150,True,5,Mixed,15,10,25
961160,True,0,No user reviews,0,0,0
961170,True,0,No user reviews,0,0,0
961190,True,0,No user reviews,0,0,0
961200,True,0,No user reviews,0,0,0
961210,True,0,No user reviews,0,0,0
961220,True,0,7 user reviews,6,1,7
961230,True,0,1 user reviews,1,0,1
961240,True,0,1 user reviews,0,1,1
961260,True,0,No user reviews,0,0,0
961280,True,0,No user reviews,0,0,0
961290,True,0,No user reviews,0,0,0
961300,True,0,No user reviews,0,0,0
961320,True,0,No user reviews,0,0,0
961330,True,0,No user reviews,0,0,0
961340,True,0,No user reviews,0,0,0
961350,True,0,No user reviews,0,0,0
961360,True,0,No user reviews,0,0,0
961370,True,0,No user reviews,0,0,0
961400,True,0,No user reviews,0,0,0
961410,True,0,1 user reviews,1,0,1
961420,True,6,Mostly Positive,15,5,20
961440,True,0,No user reviews,0,0,0
961450,True,0,No user reviews,0,0,0
961470,True,0,No user reviews,0,0,0
961471,True,0,No user reviews,0,0,0
961472,True,0,No user reviews,0,0,0
961490,True,8,Very Positive,82,13,95
961500,True,0,No user reviews,0,0,0
961510,True,7,Positive,19,3,22
961520,True,0,No user reviews,0,0,0
961540,True,0,No user reviews,0,0,0
961560,True,0,2 user reviews,1,1,2
961570,True,0,1 user reviews,1,0,1
961580,True,0,1 user reviews,1,0,1
961590,True,0,No user reviews,0,0,0
961620,True,8,Very Positive,76,10,86
961630,True,0,1 user reviews,1,0,1
961640,True,7,Positive,15,1,16
961660,True,8,Very Positive,70,2,72
961680,True,0,No user reviews,0,0,0
961700,True,0,6 user reviews,4,2,6
961710,True,0,1 user reviews,0,1,1
961720,True,0,2 user reviews,0,2,2
961730,True,0,5 user reviews,2,3,5
961740,True,0,2 user reviews,1,1,2
961750,True,0,No user reviews,0,0,0
961780,True,0,No user reviews,0,0,0
961810,True,0,No user reviews,0,0,0
961830,True,0,No user reviews,0,0,0
961840,True,7,Positive,18,4,22
961850,True,0,1 user reviews,1,0,1
961860,True,5,Mixed,22,10,32
961870,True,0,No user reviews,0,0,0
961910,True,0,No user reviews,0,0,0
961920,True,0,1 user reviews,0,1,1
961930,True,8,Very Positive,182,24,206
961960,True,0,No user reviews,0,0,0
961970,True,0,No user reviews,0,0,0
961980,True,0,1 user reviews,1,0,1
961990,True,0,6 user reviews,6,0,6
962000,True,0,No user reviews,0,0,0
962030,True,0,No user reviews,0,0,0
962040,True,0,No user reviews,0,0,0
962050,True,0,3 user reviews,1,2,3
962060,True,0,1 user reviews,1,0,1
962070,True,0,No user reviews,0,0,0
962090,True,0,No user reviews,0,0,0
962100,True,0,No user reviews,0,0,0
962120,True,0,No user reviews,0,0,0
962130,True,8,Very Positive,5853,781,6634
962140,True,0,No user reviews,0,0,0
962150,True,7,Positive,13,3,16
962160,True,0,No user reviews,0,0,0
962170,True,0,No user reviews,0,0,0
962190,True,0,No user reviews,0,0,0
962220,True,7,Positive,9,1,10
962230,True,0,No user reviews,0,0,0
962240,True,0,No user reviews,0,0,0
962250,True,0,1 user reviews,1,0,1
962270,True,0,No user reviews,0,0,0
962280,True,0,1 user reviews,1,0,1
962290,True,0,No user reviews,0,0,0
962300,True,0,No user reviews,0,0,0
962301,True,0,No user reviews,0,0,0
962302,True,0,No user reviews,0,0,0
962303,True,0,No user reviews,0,0,0
962304,True,0,No user reviews,0,0,0
962305,True,0,No user reviews,0,0,0
962306,True,0,1 user reviews,0,1,1
962310,True,0,No user reviews,0,0,0
962340,True,0,No user reviews,0,0,0
962360,True,0,No user reviews,0,0,0
962370,True,0,1 user reviews,1,0,1
962380,True,0,1 user reviews,1,0,1
962390,True,0,No user reviews,0,0,0
962400,True,8,Very Positive,298,38,336
962410,True,0,No user reviews,0,0,0
962420,True,0,No user reviews,0,0,0
962421,True,0,No user reviews,0,0,0
962430,True,0,No user reviews,0,0,0
962490,True,0,No user reviews,0,0,0
962500,True,0,1 user reviews,1,0,1
962510,True,0,5 user reviews,4,1,5
962540,True,0,8 user reviews,6,2,8
962580,True,6,Mostly Positive,141,47,188
962590,True,0,No user reviews,0,0,0
962610,True,0,2 user reviews,2,0,2
962630,True,5,Mixed,7,7,14
962640,True,0,No user reviews,0,0,0
962650,True,0,No user reviews,0,0,0
962680,True,0,1 user reviews,1,0,1
962700,True,0,No user reviews,0,0,0
962710,True,0,4 user reviews,2,2,4
962730,True,8,Very Positive,5633,829,6462
962750,True,6,Mostly Positive,141,42,183
962760,True,0,No user reviews,0,0,0
962780,True,0,No user reviews,0,0,0
962810,True,0,No user reviews,0,0,0
962820,True,0,No user reviews,0,0,0
962850,True,4,Mostly Negative,7,12,19
962860,True,0,2 user reviews,0,2,2
962880,True,0,No user reviews,0,0,0
962890,True,0,No user reviews,0,0,0
962920,True,0,No user reviews,0,0,0
962921,True,0,1 user reviews,1,0,1
962922,True,0,No user reviews,0,0,0
962923,True,0,No user reviews,0,0,0
962924,True,0,1 user reviews,1,0,1
962925,True,0,No user reviews,0,0,0
962950,True,0,No user reviews,0,0,0
962960,True,0,4 user reviews,4,0,4
962970,True,5,Mixed,28,13,41
962980,True,0,No user reviews,0,0,0
962990,True,0,No user reviews,0,0,0
963000,True,8,Very Positive,651,35,686
963020,True,0,1 user reviews,1,0,1
963040,True,0,1 user reviews,0,1,1
963050,True,0,No user reviews,0,0,0
963060,True,0,4 user reviews,4,0,4
963110,True,0,3 user reviews,0,3,3
963150,True,0,1 user reviews,0,1,1
963170,True,0,1 user reviews,0,1,1
963180,True,0,No user reviews,0,0,0
963190,True,0,No user reviews,0,0,0
963200,True,0,4 user reviews,1,3,4
963210,True,0,No user reviews,0,0,0
963220,True,0,No user reviews,0,0,0
963230,True,7,Positive,15,1,16
963260,True,0,6 user reviews,5,1,6
963280,True,7,Positive,45,3,48
963290,True,0,No user reviews,0,0,0
963300,True,5,Mixed,10,8,18
963330,True,8,Very Positive,46,7,53
963350,True,0,No user reviews,0,0,0
963370,True,0,4 user reviews,2,2,4
963400,True,5,Mixed,77,34,111
963410,True,0,No user reviews,0,0,0
963420,True,0,No user reviews,0,0,0
963450,True,8,Very Positive,213,36,249
963470,True,0,2 user reviews,2,0,2
963490,True,0,4 user reviews,3,1,4
963500,True,4,Mostly Negative,2,8,10
963510,True,0,No user reviews,0,0,0
963570,True,0,2 user reviews,2,0,2
963580,True,0,No user reviews,0,0,0
963590,True,0,No user reviews,0,0,0
963600,True,0,No user reviews,0,0,0
963660,True,0,6 user reviews,4,2,6
963670,True,0,No user reviews,0,0,0
963680,True,7,Positive,15,1,16
963690,True,8,Very Positive,422,31,453
963710,True,9,Overwhelmingly Positive,1145,55,1200
963720,True,0,No user reviews,0,0,0
963740,True,0,No user reviews,0,0,0
963750,True,0,No user reviews,0,0,0
963770,True,0,No user reviews,0,0,0
963780,True,0,No user reviews,0,0,0
963830,True,0,No user reviews,0,0,0
963860,True,0,5 user reviews,4,1,5
963870,True,0,No user reviews,0,0,0
963900,True,0,6 user reviews,4,2,6
963910,True,0,No user reviews,0,0,0
963930,True,8,Very Positive,793,195,988
963940,True,0,No user reviews,0,0,0
963960,True,0,2 user reviews,2,0,2
963980,True,0,No user reviews,0,0,0
964000,True,0,No user reviews,0,0,0
964020,True,0,No user reviews,0,0,0
964040,True,0,No user reviews,0,0,0
964050,True,0,2 user reviews,0,2,2
964060,True,0,No user reviews,0,0,0
964070,True,0,2 user reviews,2,0,2
964080,True,5,Mixed,15,7,22
964100,True,0,1 user reviews,1,0,1
964110,True,0,2 user reviews,2,0,2
964120,True,0,No user reviews,0,0,0
964130,True,7,Positive,36,8,44
964150,True,0,No user reviews,0,0,0
964170,True,0,1 user reviews,0,1,1
964180,True,0,No user reviews,0,0,0
964190,True,0,No user reviews,0,0,0
964200,True,0,No user reviews,0,0,0
964210,True,0,4 user reviews,4,0,4
964220,True,0,3 user reviews,3,0,3
964230,True,0,9 user reviews,7,2,9
964240,True,0,No user reviews,0,0,0
964280,True,0,No user reviews,0,0,0
964290,True,0,No user reviews,0,0,0
964320,True,0,No user reviews,0,0,0
964330,True,0,No user reviews,0,0,0
964340,True,0,5 user reviews,4,1,5
964350,True,0,1 user reviews,1,0,1
964370,True,0,2 user reviews,2,0,2
964390,True,0,7 user reviews,2,5,7
964420,True,0,1 user reviews,0,1,1
964450,True,0,No user reviews,0,0,0
964460,True,6,Mostly Positive,8,3,11
964480,True,0,No user reviews,0,0,0
964500,True,0,No user reviews,0,0,0
964510,True,0,No user reviews,0,0,0
964520,True,0,No user reviews,0,0,0
964530,True,0,2 user reviews,1,1,2
964540,True,0,No user reviews,0,0,0
964550,True,0,No user reviews,0,0,0
964560,True,0,No user reviews,0,0,0
964561,True,0,No user reviews,0,0,0
964562,True,0,No user reviews,0,0,0
964563,True,0,No user reviews,0,0,0
964564,True,0,No user reviews,0,0,0
964565,True,0,No user reviews,0,0,0
964566,True,0,No user reviews,0,0,0
964567,True,0,No user reviews,0,0,0
964570,True,8,Very Positive,116,24,140
964580,True,0,No user reviews,0,0,0
964590,True,0,2 user reviews,2,0,2
964620,True,0,No user reviews,0,0,0
964630,True,0,1 user reviews,1,0,1
964640,True,0,No user reviews,0,0,0
964650,True,6,Mostly Positive,169,47,216
964660,True,0,No user reviews,0,0,0
964670,True,0,No user reviews,0,0,0
964671,True,0,No user reviews,0,0,0
964672,True,0,No user reviews,0,0,0
964700,True,0,6 user reviews,5,1,6
964710,True,0,No user reviews,0,0,0
964750,True,0,3 user reviews,1,2,3
964760,True,0,No user reviews,0,0,0
964770,True,0,5 user reviews,3,2,5
964780,True,0,No user reviews,0,0,0
964800,True,0,No user reviews,0,0,0
964810,True,0,3 user reviews,3,0,3
964840,True,0,No user reviews,0,0,0
964880,True,0,1 user reviews,1,0,1
964890,True,0,No user reviews,0,0,0
964910,True,0,No user reviews,0,0,0
964920,True,0,2 user reviews,0,2,2
964930,True,0,1 user reviews,1,0,1
964931,True,0,No user reviews,0,0,0
964932,True,0,No user reviews,0,0,0
964933,True,0,No user reviews,0,0,0
964934,True,0,No user reviews,0,0,0
964935,True,0,No user reviews,0,0,0
964936,True,0,No user reviews,0,0,0
964937,True,0,No user reviews,0,0,0
964938,True,0,No user reviews,0,0,0
964960,True,0,No user reviews,0,0,0
964990,True,7,Positive,25,1,26
965000,True,0,3 user reviews,1,2,3
965010,True,7,Positive,18,2,20
965030,True,0,4 user reviews,3,1,4
965040,True,0,No user reviews,0,0,0
965060,True,0,9 user reviews,5,4,9
965070,True,0,No user reviews,0,0,0
965080,True,0,1 user reviews,0,1,1
965100,True,0,No user reviews,0,0,0
965101,True,0,No user reviews,0,0,0
965102,True,0,No user reviews,0,0,0
965110,True,0,2 user reviews,1,1,2
965120,True,0,1 user reviews,0,1,1
965130,True,0,2 user reviews,1,1,2
965140,True,0,No user reviews,0,0,0
965180,True,0,No user reviews,0,0,0
965200,True,0,No user reviews,0,0,0
965210,True,0,No user reviews,0,0,0
965220,True,8,Very Positive,382,50,432
965230,True,8,Very Positive,286,43,329
965240,True,0,2 user reviews,2,0,2
965270,True,0,No user reviews,0,0,0
965280,True,0,No user reviews,0,0,0
965290,True,0,No user reviews,0,0,0
965300,True,6,Mostly Positive,66,17,83
965310,True,5,Mixed,63,30,93
965320,True,5,Mixed,58,55,113
965340,True,7,Positive,9,1,10
965350,True,0,1 user reviews,1,0,1
965360,True,0,No user reviews,0,0,0
965370,True,0,No user reviews,0,0,0
965400,True,0,No user reviews,0,0,0
965410,True,0,3 user reviews,2,1,3
965420,True,0,No user reviews,0,0,0
965430,True,0,2 user reviews,2,0,2
965470,True,0,7 user reviews,7,0,7
965480,True,8,Very Positive,112,27,139
965490,True,7,Positive,11,0,11
965500,True,0,No user reviews,0,0,0
965510,True,0,6 user reviews,6,0,6
965520,True,0,No user reviews,0,0,0
965530,True,0,No user reviews,0,0,0
965540,True,0,No user reviews,0,0,0
965580,True,8,Very Positive,550,34,584
965590,True,8,Very Positive,68,0,68
965600,True,8,Very Positive,72,6,78
965610,True,7,Positive,22,2,24
965630,True,0,No user reviews,0,0,0
965640,True,7,Positive,28,5,33
965650,True,0,No user reviews,0,0,0
965670,True,8,Very Positive,131,9,140
965680,True,8,Very Positive,76,6,82
965690,True,0,No user reviews,0,0,0
965700,True,0,No user reviews,0,0,0
965710,True,0,No user reviews,0,0,0
965720,True,0,No user reviews,0,0,0
965730,True,0,1 user reviews,0,1,1
965750,True,0,No user reviews,0,0,0
965751,True,0,No user reviews,0,0,0
965760,True,0,No user reviews,0,0,0
965780,True,0,No user reviews,0,0,0
965781,True,0,No user reviews,0,0,0
965790,True,0,No user reviews,0,0,0
965810,True,8,Very Positive,61,7,68
965820,True,0,6 user reviews,6,0,6
965830,True,8,Very Positive,45,5,50
965840,True,0,2 user reviews,1,1,2
965850,True,0,No user reviews,0,0,0
965860,True,0,6 user reviews,6,0,6
965880,True,0,No user reviews,0,0,0
965890,True,0,No user reviews,0,0,0
965900,True,0,1 user reviews,1,0,1
965910,True,0,No user reviews,0,0,0
965920,True,0,No user reviews,0,0,0
965940,True,0,6 user reviews,3,3,6
965950,True,0,No user reviews,0,0,0
965960,True,0,2 user reviews,2,0,2
965970,True,0,No user reviews,0,0,0
965980,True,0,No user reviews,0,0,0
965990,True,0,No user reviews,0,0,0
966000,True,5,Mixed,11,5,16
966010,True,7,Positive,13,1,14
966020,True,0,4 user reviews,4,0,4
966030,True,0,No user reviews,0,0,0
966050,True,0,1 user reviews,0,1,1
966070,True,7,Positive,24,2,26
966090,True,7,Positive,12,3,15
966100,True,0,No user reviews,0,0,0
966130,True,0,No user reviews,0,0,0
966140,True,0,1 user reviews,0,1,1
966150,True,0,No user reviews,0,0,0
966160,True,0,No user reviews,0,0,0
966180,True,0,3 user reviews,3,0,3
966210,True,0,5 user reviews,4,1,5
966240,True,0,3 user reviews,2,1,3
966250,True,0,1 user reviews,1,0,1
966320,True,8,Very Positive,492,7,499
966330,True,8,Very Positive,587,119,706
966350,True,7,Positive,33,0,33
966360,True,7,Positive,14,0,14
966370,True,0,3 user reviews,1,2,3
966380,True,0,No user reviews,0,0,0
966390,True,0,No user reviews,0,0,0
966400,True,7,Positive,16,3,19
966410,True,0,No user reviews,0,0,0
966420,True,0,No user reviews,0,0,0
966430,True,6,Mostly Positive,126,34,160
966440,True,0,No user reviews,0,0,0
966450,True,0,No user reviews,0,0,0
966460,True,0,No user reviews,0,0,0
966470,True,0,No user reviews,0,0,0
966490,True,0,1 user reviews,1,0,1
966491,True,0,No user reviews,0,0,0
966492,True,0,No user reviews,0,0,0
966493,True,0,No user reviews,0,0,0
966494,True,0,No user reviews,0,0,0
966495,True,0,No user reviews,0,0,0
966497,True,0,1 user reviews,1,0,1
966498,True,0,No user reviews,0,0,0
966499,True,0,No user reviews,0,0,0
966500,True,0,No user reviews,0,0,0
966520,True,0,No user reviews,0,0,0
966521,True,0,No user reviews,0,0,0
966522,True,0,No user reviews,0,0,0
966523,True,0,No user reviews,0,0,0
966524,True,0,No user reviews,0,0,0
966525,True,0,No user reviews,0,0,0
966526,True,0,No user reviews,0,0,0
966527,True,0,No user reviews,0,0,0
966528,True,0,No user reviews,0,0,0
966529,True,0,1 user reviews,1,0,1
966530,True,5,Mixed,16,13,29
966540,True,0,No user reviews,0,0,0
966560,True,5,Mixed,29,21,50
966580,True,0,3 user reviews,3,0,3
966590,True,0,7 user reviews,7,0,7
966600,True,0,1 user reviews,0,1,1
966610,True,8,Very Positive,85,21,106
966620,True,0,No user reviews,0,0,0
966630,True,7,Positive,37,1,38
966650,True,0,No user reviews,0,0,0
966660,True,0,7 user reviews,6,1,7
966670,True,7,Positive,12,1,13
966680,True,8,Very Positive,165,9,174
966690,True,7,Positive,29,5,34
966700,True,0,No user reviews,0,0,0
966710,True,0,No user reviews,0,0,0
966720,True,5,Mixed,8,4,12
966730,True,0,No user reviews,0,0,0
966750,True,0,1 user reviews,0,1,1
966760,True,0,3 user reviews,2,1,3
966800,True,0,No user reviews,0,0,0
966810,True,0,No user reviews,0,0,0
966820,True,0,No user reviews,0,0,0
966830,True,0,No user reviews,0,0,0
966840,True,0,3 user reviews,3,0,3
966841,True,0,2 user reviews,1,1,2
966842,True,0,1 user reviews,1,0,1
966843,True,0,1 user reviews,1,0,1
966845,True,0,1 user reviews,1,0,1
966870,True,0,4 user reviews,4,0,4
967010,True,0,No user reviews,0,0,0
967020,True,0,No user reviews,0,0,0
967050,True,8,Very Positive,3856,400,4256
967060,True,0,1 user reviews,1,0,1
967070,True,0,No user reviews,0,0,0
967100,True,0,4 user reviews,3,1,4
967120,True,0,No user reviews,0,0,0
967130,True,8,Very Positive,40,10,50
967150,True,0,1 user reviews,0,1,1
967170,True,0,8 user reviews,0,8,8
967180,True,0,1 user reviews,0,1,1
967210,True,0,1 user reviews,1,0,1
967230,True,0,No user reviews,0,0,0
967240,True,7,Positive,30,7,37
967250,True,6,Mostly Positive,71,22,93
967271,True,0,1 user reviews,1,0,1
967272,True,0,3 user reviews,2,1,3
967274,True,0,2 user reviews,1,1,2
967275,True,4,Mostly Negative,3,10,13
967276,True,0,1 user reviews,0,1,1
967278,True,0,1 user reviews,0,1,1
967279,True,0,4 user reviews,1,3,4
967280,True,0,6 user reviews,6,0,6
967281,True,0,5 user reviews,3,2,5
967282,True,7,Positive,12,1,13
967283,True,0,3 user reviews,2,1,3
967285,True,0,1 user reviews,1,0,1
967287,True,0,4 user reviews,2,2,4
967288,True,0,No user reviews,0,0,0
967289,True,0,3 user reviews,1,2,3
967290,True,0,2 user reviews,2,0,2
967300,True,0,1 user reviews,1,0,1
967320,True,0,1 user reviews,0,1,1
967330,True,8,Very Positive,45,6,51
967340,True,0,No user reviews,0,0,0
967350,True,0,5 user reviews,4,1,5
967370,True,0,6 user reviews,5,1,6
967380,True,7,Positive,38,6,44
967390,True,0,No user reviews,0,0,0
967400,True,0,6 user reviews,3,3,6
967410,True,6,Mostly Positive,48,18,66
967420,True,0,No user reviews,0,0,0
967430,True,0,4 user reviews,2,2,4
967440,True,0,5 user reviews,1,4,5
967450,True,0,3 user reviews,1,2,3
967460,True,0,No user reviews,0,0,0
967490,True,0,No user reviews,0,0,0
967750,True,0,No user reviews,0,0,0
967910,True,0,2 user reviews,2,0,2
967940,True,0,2 user reviews,2,0,2
967950,True,0,No user reviews,0,0,0
967960,True,0,No user reviews,0,0,0
967980,True,0,No user reviews,0,0,0
967981,True,0,No user reviews,0,0,0
968170,True,7,Positive,10,0,10
968180,True,0,No user reviews,0,0,0
968190,True,0,No user reviews,0,0,0
968200,True,0,No user reviews,0,0,0
968210,True,0,3 user reviews,3,0,3
968220,True,0,No user reviews,0,0,0
968230,True,0,No user reviews,0,0,0
968240,True,0,No user reviews,0,0,0
968250,True,8,Very Positive,113,13,126
968260,True,0,No user reviews,0,0,0
968270,True,0,3 user reviews,3,0,3
968271,True,0,No user reviews,0,0,0
968272,True,0,No user reviews,0,0,0
968273,True,0,No user reviews,0,0,0
968290,True,7,Positive,32,2,34
968300,True,0,6 user reviews,6,0,6
968310,True,0,No user reviews,0,0,0
968320,True,0,2 user reviews,2,0,2
968350,True,7,Positive,27,0,27
968360,True,0,6 user reviews,4,2,6
968370,True,7,Positive,26,4,30
968380,True,0,3 user reviews,2,1,3
968390,True,8,Very Positive,47,7,54
968410,True,0,No user reviews,0,0,0
968420,True,0,No user reviews,0,0,0
968430,True,0,No user reviews,0,0,0
968440,True,0,No user reviews,0,0,0
968450,True,0,3 user reviews,1,2,3
968460,True,0,6 user reviews,4,2,6
968470,True,0,8 user reviews,8,0,8
968480,True,0,No user reviews,0,0,0
968490,True,0,2 user reviews,2,0,2
968500,True,0,No user reviews,0,0,0
968540,True,0,5 user reviews,1,4,5
968550,True,0,No user reviews,0,0,0
968570,True,0,2 user reviews,1,1,2
968580,True,0,3 user reviews,1,2,3
968590,True,0,No user reviews,0,0,0
968600,True,0,No user reviews,0,0,0
968620,True,0,No user reviews,0,0,0
968630,True,0,No user reviews,0,0,0
968640,True,0,No user reviews,0,0,0
968680,True,0,1 user reviews,1,0,1
968690,True,0,No user reviews,0,0,0
968700,True,0,No user reviews,0,0,0
968710,True,0,No user reviews,0,0,0
968730,True,7,Positive,8,2,10
968740,True,0,No user reviews,0,0,0
968750,True,0,No user reviews,0,0,0
968760,True,7,Positive,24,3,27
968770,True,0,No user reviews,0,0,0
968790,True,8,Very Positive,158,33,191
968800,True,0,No user reviews,0,0,0
968820,True,6,Mostly Positive,25,9,34
968830,True,0,4 user reviews,3,1,4
968840,True,0,5 user reviews,3,2,5
968860,True,0,No user reviews,0,0,0
968870,True,6,Mostly Positive,70,27,97
968880,True,0,5 user reviews,4,1,5
968890,True,0,No user reviews,0,0,0
968900,True,0,No user reviews,0,0,0
968901,True,0,No user reviews,0,0,0
968902,True,0,No user reviews,0,0,0
968910,True,0,1 user reviews,1,0,1
968911,True,0,3 user reviews,3,0,3
968920,True,0,4 user reviews,1,3,4
968930,True,0,No user reviews,0,0,0
968940,True,4,Mostly Negative,6,11,17
968950,True,6,Mostly Positive,15,6,21
968960,True,0,1 user reviews,1,0,1
968970,True,6,Mostly Positive,223,70,293
968980,True,0,No user reviews,0,0,0
968990,True,0,2 user reviews,1,1,2
969020,True,8,Very Positive,73,14,87
969030,True,0,1 user reviews,1,0,1
969040,True,0,No user reviews,0,0,0
969041,True,0,No user reviews,0,0,0
969042,True,0,No user reviews,0,0,0
969043,True,0,No user reviews,0,0,0
969044,True,0,No user reviews,0,0,0
969045,True,0,No user reviews,0,0,0
969060,True,0,2 user reviews,1,1,2
969070,True,0,No user reviews,0,0,0
969090,True,0,No user reviews,0,0,0
969100,True,0,No user reviews,0,0,0
969110,True,0,No user reviews,0,0,0
969130,True,0,5 user reviews,5,0,5
969140,True,0,3 user reviews,2,1,3
969160,True,0,No user reviews,0,0,0
969170,True,0,No user reviews,0,0,0
969180,True,0,No user reviews,0,0,0
969190,True,0,No user reviews,0,0,0
969200,True,0,1 user reviews,0,1,1
969220,True,0,4 user reviews,4,0,4
969230,True,0,4 user reviews,1,3,4
969240,True,0,No user reviews,0,0,0
969250,True,0,9 user reviews,7,2,9
969260,True,0,No user reviews,0,0,0
969261,True,0,No user reviews,0,0,0
969262,True,0,No user reviews,0,0,0
969270,True,7,Positive,10,0,10
969280,True,0,No user reviews,0,0,0
969290,True,0,No user reviews,0,0,0
969300,True,0,No user reviews,0,0,0
969310,True,0,No user reviews,0,0,0
969320,True,0,No user reviews,0,0,0
969330,True,0,No user reviews,0,0,0
969340,True,0,3 user reviews,3,0,3
969350,True,0,3 user reviews,3,0,3
969380,True,0,No user reviews,0,0,0
969410,True,0,No user reviews,0,0,0
969420,True,0,No user reviews,0,0,0
969430,True,0,No user reviews,0,0,0
969440,True,0,No user reviews,0,0,0
969450,True,0,No user reviews,0,0,0
969480,True,7,Positive,21,0,21
969510,True,0,No user reviews,0,0,0
969520,True,0,No user reviews,0,0,0
969530,True,0,3 user reviews,3,0,3
969540,True,0,8 user reviews,7,1,8
969550,True,0,No user reviews,0,0,0
969560,True,5,Mixed,10,5,15
969570,True,5,Mixed,12,17,29
969580,True,0,8 user reviews,4,4,8
969590,True,0,9 user reviews,7,2,9
969600,True,0,No user reviews,0,0,0
969620,True,0,No user reviews,0,0,0
969630,True,0,No user reviews,0,0,0
969651,True,0,No user reviews,0,0,0
969652,True,0,No user reviews,0,0,0
969653,True,0,No user reviews,0,0,0
969654,True,0,No user reviews,0,0,0
969655,True,0,No user reviews,0,0,0
969656,True,0,No user reviews,0,0,0
969657,True,0,No user reviews,0,0,0
969658,True,0,No user reviews,0,0,0
969659,True,0,No user reviews,0,0,0
969680,True,0,1 user reviews,1,0,1
969690,True,7,Positive,12,1,13
969700,True,8,Very Positive,126,7,133
969710,True,5,Mixed,7,6,13
969730,True,0,1 user reviews,1,0,1
969740,True,0,4 user reviews,4,0,4
969760,True,0,No user reviews,0,0,0
969770,True,0,1 user reviews,1,0,1
969771,True,0,No user reviews,0,0,0
969772,True,0,No user reviews,0,0,0
969773,True,0,No user reviews,0,0,0
969780,True,0,1 user reviews,1,0,1
969790,True,0,1 user reviews,1,0,1
969800,True,0,No user reviews,0,0,0
969820,True,0,No user reviews,0,0,0
969850,True,0,No user reviews,0,0,0
969860,True,0,2 user reviews,0,2,2
969870,True,0,4 user reviews,1,3,4
969880,True,5,Mixed,11,7,18
969890,True,0,6 user reviews,6,0,6
969900,True,0,5 user reviews,4,1,5
969920,True,0,No user reviews,0,0,0
969940,True,0,2 user reviews,0,2,2
969950,True,0,3 user reviews,1,2,3
969970,True,5,Mixed,7,6,13
969990,True,9,Overwhelmingly Positive,4384,161,4545
970000,True,0,2 user reviews,1,1,2
970020,True,0,No user reviews,0,0,0
970030,True,0,No user reviews,0,0,0
970060,True,7,Positive,13,0,13
970070,True,7,Positive,35,0,35
970080,True,0,No user reviews,0,0,0
970090,True,0,5 user reviews,5,0,5
970100,True,7,Positive,10,1,11
970110,True,0,5 user reviews,5,0,5
970120,True,0,No user reviews,0,0,0
970130,True,5,Mixed,7,4,11
970140,True,7,Positive,16,2,18
970150,True,0,5 user reviews,1,4,5
970160,True,0,No user reviews,0,0,0
970170,True,0,3 user reviews,3,0,3
970180,True,0,No user reviews,0,0,0
970190,True,5,Mixed,20,14,34
970200,True,0,3 user reviews,3,0,3
970210,True,0,No user reviews,0,0,0
970240,True,0,4 user reviews,4,0,4
970260,True,0,3 user reviews,1,2,3
970270,True,0,No user reviews,0,0,0
970300,True,0,4 user reviews,4,0,4
970360,True,0,1 user reviews,0,1,1
970370,True,0,No user reviews,0,0,0
970400,True,6,Mostly Positive,20,8,28
970410,True,0,No user reviews,0,0,0
970440,True,0,3 user reviews,3,0,3
970450,True,0,No user reviews,0,0,0
970460,True,0,No user reviews,0,0,0
970470,True,0,2 user reviews,2,0,2
970510,True,0,5 user reviews,5,0,5
970520,True,0,No user reviews,0,0,0
970530,True,0,No user reviews,0,0,0
970550,True,0,1 user reviews,0,1,1
970560,True,8,Very Positive,102,1,103
970570,True,8,Very Positive,410,36,446
970580,True,0,6 user reviews,5,1,6
970600,True,5,Mixed,8,4,12
970610,True,0,No user reviews,0,0,0
970620,True,0,No user reviews,0,0,0
970630,True,0,No user reviews,0,0,0
970640,True,7,Positive,12,1,13
970650,True,0,2 user reviews,0,2,2
970660,True,3,Negative,4,27,31
970670,True,0,2 user reviews,2,0,2
970680,True,0,No user reviews,0,0,0
970690,True,0,1 user reviews,0,1,1
970700,True,0,No user reviews,0,0,0
970710,True,0,8 user reviews,3,5,8
970730,True,0,No user reviews,0,0,0
970740,True,0,No user reviews,0,0,0
970760,True,0,3 user reviews,3,0,3
970780,True,0,No user reviews,0,0,0
970800,True,0,No user reviews,0,0,0
970810,True,0,2 user reviews,2,0,2
970820,True,0,No user reviews,0,0,0
970830,True,8,Very Positive,442,93,535
970840,True,0,No user reviews,0,0,0
970850,True,0,5 user reviews,5,0,5
970870,True,0,6 user reviews,5,1,6
970880,True,0,3 user reviews,3,0,3
970890,True,0,3 user reviews,3,0,3
970900,True,0,3 user reviews,3,0,3
970910,True,0,2 user reviews,2,0,2
970930,True,0,1 user reviews,1,0,1
970940,True,0,5 user reviews,1,4,5
970960,True,6,Mostly Positive,155,49,204
970970,True,3,Negative,1,10,11
970980,True,0,No user reviews,0,0,0
970990,True,0,No user reviews,0,0,0
971030,True,0,No user reviews,0,0,0
971060,True,0,8 user reviews,4,4,8
971070,True,0,7 user reviews,6,1,7
971080,True,0,1 user reviews,1,0,1
971090,True,0,3 user reviews,1,2,3
971100,True,0,2 user reviews,2,0,2
971120,True,5,Mixed,41,18,59
971130,True,0,2 user reviews,2,0,2
971150,True,0,1 user reviews,1,0,1
971170,True,0,No user reviews,0,0,0
971180,True,0,No user reviews,0,0,0
971210,True,0,No user reviews,0,0,0
971230,True,0,No user reviews,0,0,0
971240,True,0,1 user reviews,1,0,1
971241,True,0,No user reviews,0,0,0
971242,True,0,3 user reviews,2,1,3
971243,True,0,No user reviews,0,0,0
971250,True,0,1 user reviews,1,0,1
971251,True,0,2 user reviews,2,0,2
971252,True,0,No user reviews,0,0,0
971260,True,0,No user reviews,0,0,0
971280,True,0,2 user reviews,2,0,2
971340,True,0,No user reviews,0,0,0
971350,True,5,Mixed,25,22,47
971390,True,0,No user reviews,0,0,0
971400,True,0,No user reviews,0,0,0
971430,True,7,Positive,39,1,40
971460,True,5,Mixed,19,14,33
971480,True,7,Positive,15,3,18
971491,True,0,No user reviews,0,0,0
971500,True,7,Positive,13,0,13
971520,True,0,No user reviews,0,0,0
971530,True,0,No user reviews,0,0,0
971540,True,0,5 user reviews,5,0,5
971570,True,0,2 user reviews,1,1,2
971600,True,7,Positive,16,0,16
971610,True,0,4 user reviews,3,1,4
971620,True,8,Very Positive,192,35,227
971630,True,5,Mixed,24,23,47
971640,True,0,1 user reviews,1,0,1
971650,True,5,Mixed,13,13,26
971680,True,8,Very Positive,318,14,332
971690,True,7,Positive,23,0,23
971710,True,0,No user reviews,0,0,0
971720,True,0,No user reviews,0,0,0
971730,True,0,No user reviews,0,0,0
971740,True,0,3 user reviews,3,0,3
971750,True,0,3 user reviews,2,1,3
971760,True,5,Mixed,18,27,45
971770,True,0,2 user reviews,2,0,2
971780,True,0,3 user reviews,3,0,3
971790,True,5,Mixed,240,187,427
971800,True,0,No user reviews,0,0,0
971810,True,0,No user reviews,0,0,0
971880,True,0,7 user reviews,5,2,7
971900,True,0,4 user reviews,1,3,4
971910,True,0,1 user reviews,0,1,1
971924,True,8,Very Positive,56,3,59
971925,True,8,Very Positive,124,15,139
971940,True,0,No user reviews,0,0,0
971950,True,0,1 user reviews,1,0,1
971951,True,0,No user reviews,0,0,0
971952,True,0,No user reviews,0,0,0
971953,True,0,No user reviews,0,0,0
971954,True,0,No user reviews,0,0,0
971955,True,0,No user reviews,0,0,0
971956,True,0,No user reviews,0,0,0
971957,True,0,No user reviews,0,0,0
971958,True,0,No user reviews,0,0,0
971959,True,0,No user reviews,0,0,0
971960,True,0,No user reviews,0,0,0
971961,True,0,No user reviews,0,0,0
971962,True,0,No user reviews,0,0,0
971963,True,0,No user reviews,0,0,0
971964,True,0,No user reviews,0,0,0
971965,True,0,No user reviews,0,0,0
971970,True,0,No user reviews,0,0,0
971980,True,0,No user reviews,0,0,0
971995,True,7,Positive,38,3,41
971996,True,9,Overwhelmingly Positive,769,22,791
971998,True,8,Very Positive,139,9,148
971999,True,8,Very Positive,81,6,87
972000,True,0,No user reviews,0,0,0
972010,True,0,No user reviews,0,0,0
972050,True,0,No user reviews,0,0,0
972060,True,0,No user reviews,0,0,0
972070,True,0,No user reviews,0,0,0
972080,True,0,3 user reviews,3,0,3
972090,True,0,No user reviews,0,0,0
972100,True,0,No user reviews,0,0,0
972130,True,0,No user reviews,0,0,0
972150,True,0,2 user reviews,2,0,2
972160,True,7,Positive,15,2,17
972170,True,5,Mixed,159,73,232
972180,True,0,4 user reviews,2,2,4
972200,True,0,No user reviews,0,0,0
972230,True,0,4 user reviews,2,2,4
972260,True,0,2 user reviews,1,1,2
972261,True,0,2 user reviews,1,1,2
972280,True,0,5 user reviews,3,2,5
972290,True,0,7 user reviews,5,2,7
972300,True,0,No user reviews,0,0,0
972310,True,0,No user reviews,0,0,0
972350,True,7,Positive,32,4,36
972351,True,4,Mostly Negative,23,52,75
972360,True,0,No user reviews,0,0,0
972370,True,6,Mostly Positive,24,9,33
972380,True,0,No user reviews,0,0,0
972420,True,0,1 user reviews,1,0,1
972430,True,0,6 user reviews,3,3,6
972480,True,0,2 user reviews,1,1,2
972510,True,0,No user reviews,0,0,0
972520,True,0,3 user reviews,3,0,3
972530,True,0,No user reviews,0,0,0
972560,True,0,No user reviews,0,0,0
972600,True,0,No user reviews,0,0,0
972620,True,0,2 user reviews,1,1,2
972640,True,0,No user reviews,0,0,0
972650,True,0,1 user reviews,1,0,1
972660,True,9,Overwhelmingly Positive,1763,77,1840
972720,True,0,No user reviews,0,0,0
972740,True,6,Mostly Positive,104,27,131
972760,True,7,Positive,13,3,16
972770,True,7,Positive,31,1,32
972840,True,0,No user reviews,0,0,0
972850,True,0,No user reviews,0,0,0
972860,True,0,No user reviews,0,0,0
972870,True,0,No user reviews,0,0,0
972880,True,0,No user reviews,0,0,0
972890,True,0,1 user reviews,1,0,1
972910,True,7,Positive,9,2,11
972920,True,4,Mostly Negative,3,10,13
972940,True,0,3 user reviews,3,0,3
972950,True,0,No user reviews,0,0,0
972960,True,0,No user reviews,0,0,0
972980,True,0,No user reviews,0,0,0
972990,True,0,No user reviews,0,0,0
973000,True,5,Mixed,19,12,31
973020,True,0,No user reviews,0,0,0
973040,True,0,3 user reviews,1,2,3
973050,True,7,Positive,19,3,22
973060,True,0,7 user reviews,6,1,7
973070,True,0,No user reviews,0,0,0
973090,True,5,Mixed,27,24,51
973100,True,0,7 user reviews,7,0,7
973110,True,0,3 user reviews,1,2,3
973130,True,0,No user reviews,0,0,0
973170,True,0,5 user reviews,4,1,5
973180,True,0,No user reviews,0,0,0
973200,True,0,No user reviews,0,0,0
973220,True,8,Very Positive,69,2,71
973230,True,0,No user reviews,0,0,0
973240,True,5,Mixed,17,8,25
973250,True,0,No user reviews,0,0,0
973260,True,0,4 user reviews,1,3,4
973270,True,0,1 user reviews,1,0,1
973280,True,0,No user reviews,0,0,0
973290,True,0,No user reviews,0,0,0
973300,True,0,6 user reviews,6,0,6
973310,True,0,No user reviews,0,0,0
973320,True,0,No user reviews,0,0,0
973330,True,0,No user reviews,0,0,0
973350,True,0,No user reviews,0,0,0
973360,True,0,1 user reviews,1,0,1
973370,True,0,1 user reviews,1,0,1
973380,True,0,No user reviews,0,0,0
973390,True,0,No user reviews,0,0,0
973400,True,0,No user reviews,0,0,0
973410,True,0,7 user reviews,7,0,7
973430,True,0,No user reviews,0,0,0
973440,True,0,2 user reviews,2,0,2
973450,True,0,No user reviews,0,0,0
973460,True,0,No user reviews,0,0,0
973490,True,0,No user reviews,0,0,0
973500,True,0,No user reviews,0,0,0
973520,True,0,No user reviews,0,0,0
973550,True,0,2 user reviews,1,1,2
973560,True,0,No user reviews,0,0,0
973580,True,6,Mostly Positive,917,276,1193
973590,True,0,7 user reviews,4,3,7
973600,True,7,Positive,38,9,47
973610,True,0,2 user reviews,2,0,2
973611,True,0,4 user reviews,4,0,4
973612,True,0,No user reviews,0,0,0
973640,True,0,2 user reviews,0,2,2
973690,True,0,No user reviews,0,0,0
973700,True,5,Mixed,21,10,31
973720,True,0,2 user reviews,0,2,2
973740,True,0,2 user reviews,2,0,2
973750,True,0,8 user reviews,6,2,8
973760,True,8,Very Positive,2122,298,2420
973770,True,0,1 user reviews,0,1,1
973780,True,0,No user reviews,0,0,0
973800,True,5,Mixed,9,10,19
973830,True,0,1 user reviews,1,0,1
973840,True,0,1 user reviews,1,0,1
973850,True,7,Positive,18,1,19
973860,True,0,No user reviews,0,0,0
973910,True,6,Mostly Positive,23,7,30
973920,True,0,No user reviews,0,0,0
973992,True,0,No user reviews,0,0,0
973993,True,0,No user reviews,0,0,0
973994,True,0,No user reviews,0,0,0
973995,True,0,No user reviews,0,0,0
973996,True,0,No user reviews,0,0,0
973997,True,0,No user reviews,0,0,0
974000,True,0,No user reviews,0,0,0
974001,True,0,No user reviews,0,0,0
974010,True,0,No user reviews,0,0,0
974040,True,0,4 user reviews,3,1,4
974050,True,0,No user reviews,0,0,0
974060,True,0,No user reviews,0,0,0
974070,True,0,No user reviews,0,0,0
974080,True,0,No user reviews,0,0,0
974110,True,0,8 user reviews,8,0,8
974130,True,0,No user reviews,0,0,0
974140,True,0,No user reviews,0,0,0
974150,True,0,No user reviews,0,0,0
974160,True,0,2 user reviews,1,1,2
974180,True,0,8 user reviews,5,3,8
974200,True,0,No user reviews,0,0,0
974220,True,0,No user reviews,0,0,0
974240,True,0,3 user reviews,2,1,3
974250,True,0,1 user reviews,0,1,1
974260,True,0,No user reviews,0,0,0
974270,True,0,1 user reviews,1,0,1
974290,True,0,9 user reviews,8,1,9
974300,True,7,Positive,11,0,11
974301,True,0,5 user reviews,5,0,5
974302,True,0,No user reviews,0,0,0
974310,True,0,1 user reviews,1,0,1
974320,True,0,7 user reviews,3,4,7
974330,True,0,4 user reviews,1,3,4
974340,True,0,No user reviews,0,0,0
974341,True,0,No user reviews,0,0,0
974342,True,0,No user reviews,0,0,0
974350,True,0,1 user reviews,1,0,1
974351,True,0,4 user reviews,1,3,4
974352,True,0,No user reviews,0,0,0
974353,True,0,2 user reviews,2,0,2
974354,True,0,1 user reviews,1,0,1
974360,True,0,No user reviews,0,0,0
974361,True,0,No user reviews,0,0,0
974362,True,0,1 user reviews,1,0,1
974363,True,0,No user reviews,0,0,0
974364,True,0,1 user reviews,1,0,1
974370,True,0,8 user reviews,3,5,8
974390,True,7,Positive,12,2,14
974400,True,5,Mixed,7,10,17
974420,True,0,No user reviews,0,0,0
974430,True,0,1 user reviews,1,0,1
974450,True,0,1 user reviews,1,0,1
974470,True,0,No user reviews,0,0,0
974510,True,0,No user reviews,0,0,0
974520,True,0,No user reviews,0,0,0
974530,True,0,4 user reviews,2,2,4
974550,True,0,No user reviews,0,0,0
974560,True,0,No user reviews,0,0,0
974570,True,8,Very Positive,46,9,55
974590,True,0,No user reviews,0,0,0
974600,True,0,7 user reviews,6,1,7
974610,True,6,Mostly Positive,36,14,50
974620,True,0,8 user reviews,4,4,8
974630,True,0,No user reviews,0,0,0
974650,True,7,Positive,35,0,35
974670,True,0,5 user reviews,2,3,5
974680,True,0,7 user reviews,4,3,7
974720,True,0,7 user reviews,5,2,7
974721,True,4,Mostly Negative,5,8,13
974722,True,0,6 user reviews,4,2,6
974723,True,7,Positive,10,2,12
974724,True,0,3 user reviews,2,1,3
974725,True,0,4 user reviews,3,1,4
974726,True,5,Mixed,17,8,25
974727,True,0,No user reviews,0,0,0
974728,True,0,No user reviews,0,0,0
974729,True,0,No user reviews,0,0,0
974730,True,0,No user reviews,0,0,0
974740,True,0,2 user reviews,2,0,2
974750,True,0,No user reviews,0,0,0
974780,True,0,No user reviews,0,0,0
974800,True,0,No user reviews,0,0,0
974830,True,0,No user reviews,0,0,0
974840,True,0,No user reviews,0,0,0
974850,True,0,1 user reviews,1,0,1
974860,True,0,2 user reviews,2,0,2
974870,True,7,Positive,16,0,16
974880,True,0,No user reviews,0,0,0
974890,True,0,No user reviews,0,0,0
974900,True,0,No user reviews,0,0,0
974910,True,8,Very Positive,65,3,68
974920,True,0,2 user reviews,1,1,2
974930,True,0,No user reviews,0,0,0
974950,True,0,No user reviews,0,0,0
974970,True,0,6 user reviews,6,0,6
975000,True,6,Mostly Positive,20,6,26
975020,True,5,Mixed,11,9,20
975030,True,0,No user reviews,0,0,0
975040,True,0,No user reviews,0,0,0
975050,True,0,No user reviews,0,0,0
975080,True,0,No user reviews,0,0,0
975081,True,0,No user reviews,0,0,0
975082,True,0,No user reviews,0,0,0
975100,True,0,2 user reviews,1,1,2
975110,True,0,No user reviews,0,0,0
975120,True,5,Mixed,6,4,10
975150,True,7,Positive,27,4,31
975160,True,0,No user reviews,0,0,0
975200,True,0,2 user reviews,1,1,2
975220,True,0,2 user reviews,0,2,2
975230,True,7,Positive,14,2,16
975240,True,6,Mostly Positive,43,11,54
975260,True,0,No user reviews,0,0,0
975261,True,0,No user reviews,0,0,0
975270,True,7,Positive,44,2,46
975280,True,7,Positive,8,2,10
975290,True,7,Positive,11,0,11
975300,True,0,No user reviews,0,0,0
975301,True,0,No user reviews,0,0,0
975302,True,0,No user reviews,0,0,0
975303,True,0,No user reviews,0,0,0
975350,True,0,No user reviews,0,0,0
975360,True,0,7 user reviews,6,1,7
975370,True,0,No user reviews,0,0,0
975380,True,0,No user reviews,0,0,0
975390,True,7,Positive,14,3,17
975400,True,8,Very Positive,207,50,257
975410,True,6,Mostly Positive,17,5,22
975430,True,7,Positive,9,1,10
975440,True,0,No user reviews,0,0,0
975450,True,0,No user reviews,0,0,0
975460,True,0,No user reviews,0,0,0
975470,True,5,Mixed,29,16,45
975480,True,0,No user reviews,0,0,0
975490,True,0,No user reviews,0,0,0
975500,True,0,No user reviews,0,0,0
975510,True,6,Mostly Positive,58,21,79
975520,True,0,No user reviews,0,0,0
975530,True,0,2 user reviews,1,1,2
975540,True,0,No user reviews,0,0,0
975541,True,0,No user reviews,0,0,0
975542,True,0,No user reviews,0,0,0
975550,True,0,3 user reviews,2,1,3
975560,True,7,Positive,16,2,18
975600,True,0,5 user reviews,4,1,5
975610,True,0,No user reviews,0,0,0
975620,True,0,1 user reviews,1,0,1
975640,True,5,Mixed,7,7,14
975660,True,5,Mixed,5,6,11
975670,True,0,No user reviews,0,0,0
975680,True,5,Mixed,66,44,110
975690,True,0,2 user reviews,2,0,2
975700,True,0,No user reviews,0,0,0
975710,True,0,1 user reviews,1,0,1
975750,True,0,No user reviews,0,0,0
975760,True,6,Mostly Positive,19,6,25
975770,True,0,5 user reviews,4,1,5
975780,True,0,No user reviews,0,0,0
975800,True,0,2 user reviews,2,0,2
975860,True,0,No user reviews,0,0,0
975910,True,0,6 user reviews,5,1,6
975930,True,0,No user reviews,0,0,0
975950,True,7,Positive,24,6,30
975980,True,0,No user reviews,0,0,0
976010,True,8,Very Positive,160,15,175
976020,True,0,No user reviews,0,0,0
976030,True,7,Positive,36,6,42
976040,True,0,No user reviews,0,0,0
976050,True,0,1 user reviews,1,0,1
976051,True,0,No user reviews,0,0,0
976060,True,0,No user reviews,0,0,0
976070,True,0,1 user reviews,0,1,1
976080,True,0,2 user reviews,2,0,2
976090,True,0,1 user reviews,1,0,1
976100,True,0,No user reviews,0,0,0
976120,True,7,Positive,38,6,44
976160,True,0,3 user reviews,1,2,3
976170,True,0,1 user reviews,0,1,1
976180,True,7,Positive,39,0,39
976190,True,0,No user reviews,0,0,0
976210,True,5,Mixed,24,12,36
976220,True,0,No user reviews,0,0,0
976230,True,0,3 user reviews,1,2,3
976240,True,0,1 user reviews,0,1,1
976260,True,0,5 user reviews,5,0,5
976280,True,0,2 user reviews,2,0,2
976290,True,0,No user reviews,0,0,0
976310,True,8,Very Positive,6911,1707,8618
976320,True,0,No user reviews,0,0,0
976330,True,0,9 user reviews,9,0,9
976340,True,5,Mixed,9,6,15
976350,True,0,1 user reviews,1,0,1
976360,True,0,2 user reviews,2,0,2
976370,True,0,No user reviews,0,0,0
976371,True,0,No user reviews,0,0,0
976380,True,0,No user reviews,0,0,0
976390,True,8,Very Positive,52,3,55
976410,True,0,No user reviews,0,0,0
976420,True,7,Positive,13,1,14
976480,True,0,No user reviews,0,0,0
976500,True,7,Positive,11,1,12
976520,True,0,No user reviews,0,0,0
976530,True,0,No user reviews,0,0,0
976531,True,0,No user reviews,0,0,0
976540,True,0,No user reviews,0,0,0
976560,True,0,No user reviews,0,0,0
976570,True,5,Mixed,7,7,14
976630,True,0,No user reviews,0,0,0
976650,True,0,No user reviews,0,0,0
976660,True,0,No user reviews,0,0,0
976661,True,0,No user reviews,0,0,0
976662,True,0,1 user reviews,1,0,1
976663,True,0,2 user reviews,2,0,2
976664,True,0,1 user reviews,0,1,1
976680,True,0,No user reviews,0,0,0
976690,True,0,No user reviews,0,0,0
976700,True,7,Positive,15,1,16
976720,True,0,4 user reviews,3,1,4
976730,True,8,Very Positive,68308,6317,74625
976750,True,0,No user reviews,0,0,0
976770,True,0,No user reviews,0,0,0
976780,True,6,Mostly Positive,46,16,62
976800,True,4,Mostly Negative,9,16,25
976810,True,0,No user reviews,0,0,0
976830,True,0,3 user reviews,3,0,3
976840,True,0,1 user reviews,0,1,1
976850,True,0,5 user reviews,5,0,5
976870,True,0,2 user reviews,2,0,2
976890,True,0,No user reviews,0,0,0
976900,True,0,No user reviews,0,0,0
976910,True,0,No user reviews,0,0,0
976920,True,8,Very Positive,42,8,50
976930,True,0,2 user reviews,2,0,2
976940,True,0,No user reviews,0,0,0
976960,True,0,9 user reviews,9,0,9
976970,True,0,2 user reviews,2,0,2
976980,True,0,No user reviews,0,0,0
977000,True,0,4 user reviews,4,0,4
977010,True,0,No user reviews,0,0,0
977020,True,0,No user reviews,0,0,0
977040,True,0,No user reviews,0,0,0
977050,True,0,No user reviews,0,0,0
977060,True,0,No user reviews,0,0,0
977070,True,0,6 user reviews,6,0,6
977080,True,0,2 user reviews,2,0,2
977100,True,7,Positive,13,1,14
977110,True,0,3 user reviews,2,1,3
977160,True,0,No user reviews,0,0,0
977170,True,0,No user reviews,0,0,0
977180,True,0,1 user reviews,1,0,1
977210,True,0,No user reviews,0,0,0
977220,True,0,8 user reviews,5,3,8
977230,True,8,Very Positive,104,3,107
977250,True,0,1 user reviews,1,0,1
977270,True,0,No user reviews,0,0,0
977280,True,0,No user reviews,0,0,0
977290,True,0,1 user reviews,1,0,1
977300,True,6,Mostly Positive,11,3,14
977310,True,0,2 user reviews,2,0,2
977320,True,0,No user reviews,0,0,0
977330,True,0,No user reviews,0,0,0
977340,True,5,Mixed,7,9,16
977360,True,0,No user reviews,0,0,0
977370,True,0,No user reviews,0,0,0
977380,True,0,No user reviews,0,0,0
977390,True,7,Positive,14,1,15
977400,True,0,No user reviews,0,0,0
977410,True,0,No user reviews,0,0,0
977420,True,5,Mixed,126,74,200
977430,True,0,1 user reviews,1,0,1
977450,True,0,No user reviews,0,0,0
977460,True,8,Very Positive,101,14,115
977490,True,0,1 user reviews,1,0,1
977500,True,0,2 user reviews,2,0,2
977510,True,0,No user reviews,0,0,0
977520,True,0,No user reviews,0,0,0
977530,True,0,3 user reviews,3,0,3
977540,True,0,No user reviews,0,0,0
977560,True,6,Mostly Positive,7,3,10
977570,True,5,Mixed,36,32,68
977580,True,0,No user reviews,0,0,0
977590,True,0,3 user reviews,1,2,3
977610,True,8,Very Positive,151,26,177
977630,True,0,No user reviews,0,0,0
977640,True,5,Mixed,12,6,18
977650,True,8,Very Positive,66,16,82
977670,True,0,2 user reviews,2,0,2
977690,True,7,Positive,17,3,20
977710,True,0,No user reviews,0,0,0
977720,True,5,Mixed,117,66,183
977750,True,0,No user reviews,0,0,0
977770,True,0,No user reviews,0,0,0
977780,True,0,No user reviews,0,0,0
977790,True,0,3 user reviews,1,2,3
977800,True,0,No user reviews,0,0,0
977810,True,7,Positive,40,3,43
977820,True,0,No user reviews,0,0,0
977830,True,0,No user reviews,0,0,0
977840,True,0,6 user reviews,6,0,6
977880,True,0,No user reviews,0,0,0
977900,True,0,4 user reviews,3,1,4
977920,True,0,No user reviews,0,0,0
977930,True,0,2 user reviews,2,0,2
977950,True,9,Overwhelmingly Positive,915,38,953
977980,True,0,No user reviews,0,0,0
978010,True,0,4 user reviews,4,0,4
978040,True,0,3 user reviews,2,1,3
978070,True,0,No user reviews,0,0,0
978080,True,0,No user reviews,0,0,0
978110,True,0,No user reviews,0,0,0
978120,True,0,No user reviews,0,0,0
978140,True,7,Positive,17,0,17
978150,True,0,No user reviews,0,0,0
978160,True,0,No user reviews,0,0,0
978161,True,0,No user reviews,0,0,0
978162,True,0,No user reviews,0,0,0
978170,True,0,No user reviews,0,0,0
978180,True,5,Mixed,5,5,10
978190,True,6,Mostly Positive,12,5,17
978200,True,0,No user reviews,0,0,0
978210,True,0,3 user reviews,2,1,3
978240,True,0,No user reviews,0,0,0
978250,True,8,Very Positive,76,3,79
978270,True,0,No user reviews,0,0,0
978290,True,0,No user reviews,0,0,0
978310,True,0,No user reviews,0,0,0
978340,True,0,4 user reviews,4,0,4
978350,True,0,No user reviews,0,0,0
978360,True,7,Positive,17,4,21
978380,True,0,1 user reviews,1,0,1
978440,True,0,4 user reviews,4,0,4
978450,True,0,1 user reviews,0,1,1
978460,True,0,No user reviews,0,0,0
978470,True,4,Mostly Negative,5,10,15
978490,True,0,No user reviews,0,0,0
978500,True,0,No user reviews,0,0,0
978510,True,0,7 user reviews,7,0,7
978520,True,8,Very Positive,446,81,527
978530,True,0,No user reviews,0,0,0
978531,True,0,No user reviews,0,0,0
978532,True,0,No user reviews,0,0,0
978580,True,0,1 user reviews,0,1,1
978600,True,0,No user reviews,0,0,0
978610,True,0,2 user reviews,0,2,2
978620,True,0,No user reviews,0,0,0
978630,True,0,No user reviews,0,0,0
978640,True,7,Positive,10,1,11
978650,True,0,1 user reviews,0,1,1
978660,True,0,1 user reviews,1,0,1
978670,True,0,No user reviews,0,0,0
978680,True,8,Very Positive,63,15,78
978690,True,7,Positive,18,1,19
978700,True,0,No user reviews,0,0,0
978710,True,0,1 user reviews,1,0,1
978720,True,5,Mixed,32,17,49
978730,True,0,1 user reviews,1,0,1
978740,True,0,2 user reviews,2,0,2
978760,True,0,No user reviews,0,0,0
978780,True,9,Overwhelmingly Positive,1153,45,1198
978790,True,0,3 user reviews,3,0,3
978800,True,0,2 user reviews,2,0,2
978810,True,0,No user reviews,0,0,0
978830,True,0,No user reviews,0,0,0
978840,True,0,No user reviews,0,0,0
978850,True,0,No user reviews,0,0,0
978851,True,0,1 user reviews,0,1,1
978852,True,0,No user reviews,0,0,0
978853,True,0,No user reviews,0,0,0
978854,True,0,No user reviews,0,0,0
978855,True,0,No user reviews,0,0,0
978856,True,0,No user reviews,0,0,0
978857,True,0,No user reviews,0,0,0
978858,True,0,No user reviews,0,0,0
978859,True,0,No user reviews,0,0,0
978860,True,0,No user reviews,0,0,0
978861,True,0,1 user reviews,1,0,1
978862,True,0,No user reviews,0,0,0
978863,True,0,No user reviews,0,0,0
978864,True,0,No user reviews,0,0,0
978865,True,0,No user reviews,0,0,0
978866,True,0,No user reviews,0,0,0
978867,True,0,No user reviews,0,0,0
978870,True,6,Mostly Positive,19,5,24
978880,True,0,4 user reviews,4,0,4
978890,True,0,No user reviews,0,0,0
978910,True,0,No user reviews,0,0,0
978920,True,0,No user reviews,0,0,0
978960,True,5,Mixed,37,22,59
978970,True,0,No user reviews,0,0,0
978980,True,0,No user reviews,0,0,0
978990,True,0,5 user reviews,3,2,5
979000,True,0,1 user reviews,0,1,1
979010,True,5,Mixed,22,11,33
979030,True,0,No user reviews,0,0,0
979050,True,0,No user reviews,0,0,0
979060,True,0,No user reviews,0,0,0
979070,True,0,No user reviews,0,0,0
979080,True,0,No user reviews,0,0,0
979090,True,7,Positive,26,2,28
979100,True,0,No user reviews,0,0,0
979110,True,8,Very Positive,1229,179,1408
979120,True,8,Very Positive,1073,114,1187
979130,True,0,1 user reviews,1,0,1
979131,True,0,4 user reviews,4,0,4
979132,True,0,1 user reviews,0,1,1
979133,True,0,No user reviews,0,0,0
979140,True,0,No user reviews,0,0,0
979160,True,0,5 user reviews,4,1,5
979190,True,0,No user reviews,0,0,0
979220,True,0,No user reviews,0,0,0
979260,True,0,No user reviews,0,0,0
979280,True,0,3 user reviews,3,0,3
979290,True,0,No user reviews,0,0,0
979300,True,0,1 user reviews,0,1,1
979310,True,0,No user reviews,0,0,0
979330,True,5,Mixed,16,10,26
979340,True,0,No user reviews,0,0,0
979350,True,0,No user reviews,0,0,0
979360,True,0,No user reviews,0,0,0
979390,True,0,1 user reviews,0,1,1
979400,True,6,Mostly Positive,13,5,18
979410,True,0,No user reviews,0,0,0
979450,True,0,7 user reviews,7,0,7
979460,True,0,No user reviews,0,0,0
979461,True,0,No user reviews,0,0,0
979462,True,0,No user reviews,0,0,0
979463,True,0,No user reviews,0,0,0
979464,True,0,1 user reviews,1,0,1
979465,True,0,2 user reviews,0,2,2
979466,True,0,No user reviews,0,0,0
979467,True,0,No user reviews,0,0,0
979468,True,0,No user reviews,0,0,0
979469,True,0,No user reviews,0,0,0
979470,True,0,No user reviews,0,0,0
979480,True,0,No user reviews,0,0,0
979500,True,0,No user reviews,0,0,0
979510,True,0,No user reviews,0,0,0
979520,True,7,Positive,9,1,10
979530,True,0,6 user reviews,5,1,6
979550,True,0,2 user reviews,1,1,2
979560,True,5,Mixed,44,29,73
979580,True,0,2 user reviews,2,0,2
979590,True,0,No user reviews,0,0,0
979600,True,8,Very Positive,301,5,306
979610,True,0,No user reviews,0,0,0
979620,True,0,3 user reviews,2,1,3
979640,True,8,Very Positive,140,17,157
979650,True,0,1 user reviews,1,0,1
979680,True,0,No user reviews,0,0,0
979690,True,0,No user reviews,0,0,0
979700,True,0,2 user reviews,2,0,2
979710,True,8,Very Positive,69,6,75
979720,True,0,7 user reviews,5,2,7
979730,True,0,No user reviews,0,0,0
979740,True,0,7 user reviews,5,2,7
979760,True,0,No user reviews,0,0,0
979780,True,0,2 user reviews,2,0,2
979790,True,0,No user reviews,0,0,0
979800,True,5,Mixed,14,9,23
979810,True,5,Mixed,5,5,10
979830,True,0,No user reviews,0,0,0
979850,True,0,No user reviews,0,0,0
979851,True,0,No user reviews,0,0,0
979852,True,0,No user reviews,0,0,0
979860,True,0,No user reviews,0,0,0
979861,True,0,No user reviews,0,0,0
979870,True,0,No user reviews,0,0,0
979880,True,0,1 user reviews,1,0,1
979890,True,0,1 user reviews,0,1,1
979900,True,0,2 user reviews,2,0,2
979910,True,0,7 user reviews,3,4,7
979920,True,0,No user reviews,0,0,0
979930,True,8,Very Positive,52,8,60
979950,True,0,No user reviews,0,0,0
979970,True,5,Mixed,8,4,12
979990,True,0,No user reviews,0,0,0
980000,True,0,No user reviews,0,0,0
980030,True,0,No user reviews,0,0,0
980050,True,0,1 user reviews,1,0,1
980080,True,0,No user reviews,0,0,0
980090,True,0,1 user reviews,1,0,1
980100,True,0,No user reviews,0,0,0
980160,True,0,No user reviews,0,0,0
980180,True,0,No user reviews,0,0,0
980190,True,0,2 user reviews,2,0,2
980210,True,0,No user reviews,0,0,0
980240,True,0,No user reviews,0,0,0
980270,True,0,No user reviews,0,0,0
980271,True,0,No user reviews,0,0,0
980272,True,0,No user reviews,0,0,0
980290,True,0,No user reviews,0,0,0
980291,True,0,1 user reviews,1,0,1
980300,True,9,Overwhelmingly Positive,1948,62,2010
980320,True,5,Mixed,6,4,10
980330,True,0,No user reviews,0,0,0
980360,True,0,No user reviews,0,0,0
980370,True,0,2 user reviews,2,0,2
980380,True,0,No user reviews,0,0,0
980390,True,0,3 user reviews,3,0,3
980400,True,0,2 user reviews,2,0,2
980410,True,0,1 user reviews,1,0,1
980420,True,0,1 user reviews,1,0,1
980430,True,0,No user reviews,0,0,0
980440,True,0,2 user reviews,1,1,2
980450,True,0,No user reviews,0,0,0
980460,True,0,2 user reviews,2,0,2
980470,True,0,No user reviews,0,0,0
980480,True,7,Positive,19,0,19
980490,True,0,4 user reviews,4,0,4
980520,True,0,5 user reviews,5,0,5
980541,True,0,6 user reviews,1,5,6
980542,True,4,Mostly Negative,4,8,12
980543,True,0,2 user reviews,2,0,2
980544,True,5,Mixed,9,7,16
980545,True,0,4 user reviews,1,3,4
980546,True,0,4 user reviews,4,0,4
980547,True,0,7 user reviews,4,3,7
980548,True,5,Mixed,12,8,20
980549,True,0,2 user reviews,1,1,2
980550,True,0,1 user reviews,1,0,1
980560,True,0,2 user reviews,0,2,2
980570,True,0,No user reviews,0,0,0
980590,True,7,Positive,16,1,17
980591,True,6,Mostly Positive,10,3,13
980592,True,7,Positive,17,0,17
980600,True,0,3 user reviews,3,0,3
980610,True,0,No user reviews,0,0,0
980630,True,0,No user reviews,0,0,0
980690,True,0,4 user reviews,3,1,4
980700,True,0,No user reviews,0,0,0
980710,True,0,No user reviews,0,0,0
980720,True,0,5 user reviews,5,0,5
980730,True,0,No user reviews,0,0,0
980740,True,0,No user reviews,0,0,0
980750,True,0,2 user reviews,2,0,2
980760,True,0,1 user reviews,1,0,1
980770,True,0,2 user reviews,1,1,2
980800,True,0,No user reviews,0,0,0
980810,True,0,No user reviews,0,0,0
980820,True,0,No user reviews,0,0,0
980830,True,8,Very Positive,52,6,58
980850,True,0,1 user reviews,0,1,1
980860,True,0,No user reviews,0,0,0
980880,True,0,9 user reviews,8,1,9
980930,True,0,No user reviews,0,0,0
980940,True,6,Mostly Positive,152,58,210
980950,True,0,No user reviews,0,0,0
981010,True,0,No user reviews,0,0,0
981020,True,7,Positive,41,1,42
981040,True,0,No user reviews,0,0,0
981050,True,0,2 user reviews,1,1,2
981070,True,0,No user reviews,0,0,0
981080,True,0,No user reviews,0,0,0
981090,True,0,No user reviews,0,0,0
981120,True,0,No user reviews,0,0,0
981130,True,0,2 user reviews,0,2,2
981140,True,0,2 user reviews,0,2,2
981150,True,0,No user reviews,0,0,0
981160,True,6,Mostly Positive,9,3,12
981180,True,0,No user reviews,0,0,0
981230,True,0,No user reviews,0,0,0
981240,True,0,No user reviews,0,0,0
981250,True,0,1 user reviews,1,0,1
981260,True,6,Mostly Positive,46,13,59
981270,True,0,2 user reviews,2,0,2
981280,True,0,No user reviews,0,0,0
981290,True,0,No user reviews,0,0,0
981300,True,8,Very Positive,49,9,58
981310,True,0,No user reviews,0,0,0
981320,True,0,1 user reviews,0,1,1
981330,True,0,No user reviews,0,0,0
981340,True,0,No user reviews,0,0,0
981360,True,0,No user reviews,0,0,0
981380,True,0,No user reviews,0,0,0
981420,True,7,Positive,37,2,39
981430,True,8,Very Positive,447,25,472
981440,True,0,3 user reviews,3,0,3
981450,True,0,1 user reviews,1,0,1
981460,True,0,No user reviews,0,0,0
981470,True,0,No user reviews,0,0,0
981480,True,0,No user reviews,0,0,0
981500,True,0,2 user reviews,2,0,2
981510,True,0,No user reviews,0,0,0
981530,True,0,No user reviews,0,0,0
981540,True,0,No user reviews,0,0,0
981550,True,5,Mixed,13,6,19
981590,True,0,3 user reviews,2,1,3
981610,True,0,1 user reviews,1,0,1
981620,True,0,5 user reviews,5,0,5
981630,True,0,6 user reviews,6,0,6
981660,True,0,No user reviews,0,0,0
981670,True,0,1 user reviews,1,0,1
981690,True,0,2 user reviews,0,2,2
981700,True,0,1 user reviews,1,0,1
981701,True,0,2 user reviews,2,0,2
981702,True,0,1 user reviews,1,0,1
981710,True,0,1 user reviews,1,0,1
981720,True,0,No user reviews,0,0,0
981730,True,0,No user reviews,0,0,0
981750,True,8,Very Positive,151,32,183
981770,True,8,Very Positive,89,8,97
981790,True,0,7 user reviews,1,6,7
981800,True,0,3 user reviews,1,2,3
981810,True,0,No user reviews,0,0,0
981830,True,0,No user reviews,0,0,0
981840,True,0,No user reviews,0,0,0
981850,True,0,8 user reviews,6,2,8
981870,True,0,No user reviews,0,0,0
981880,True,7,Positive,14,1,15
981900,True,0,No user reviews,0,0,0
981910,True,5,Mixed,5,6,11
981960,True,6,Mostly Positive,10,4,14
981980,True,0,No user reviews,0,0,0
981990,True,0,No user reviews,0,0,0
982010,True,0,No user reviews,0,0,0
982020,True,0,1 user reviews,1,0,1
982040,True,7,Positive,13,3,16
982050,True,0,1 user reviews,1,0,1
982060,True,8,Very Positive,48,12,60
982070,True,0,No user reviews,0,0,0
982071,True,0,No user reviews,0,0,0
982090,True,0,No user reviews,0,0,0
982100,True,0,2 user reviews,0,2,2
982110,True,7,Positive,29,0,29
982120,True,0,1 user reviews,1,0,1
982130,True,0,No user reviews,0,0,0
982150,True,8,Very Positive,146,19,165
982180,True,0,5 user reviews,3,2,5
982190,True,0,No user reviews,0,0,0
982200,True,0,4 user reviews,4,0,4
982201,True,0,2 user reviews,2,0,2
982220,True,8,Very Positive,128,13,141
982240,True,0,4 user reviews,0,4,4
982250,True,0,4 user reviews,4,0,4
982260,True,0,No user reviews,0,0,0
982270,True,8,Very Positive,126,7,133
982290,True,0,No user reviews,0,0,0
982310,True,0,No user reviews,0,0,0
982320,True,0,No user reviews,0,0,0
982370,True,0,No user reviews,0,0,0
982380,True,0,No user reviews,0,0,0
982390,True,0,1 user reviews,1,0,1
982400,True,0,No user reviews,0,0,0
982410,True,0,No user reviews,0,0,0
982420,True,0,No user reviews,0,0,0
982440,True,5,Mixed,33,16,49
982450,True,6,Mostly Positive,15,6,21
982460,True,0,No user reviews,0,0,0
982461,True,0,No user reviews,0,0,0
982470,True,0,1 user reviews,1,0,1
982471,True,0,No user reviews,0,0,0
982472,True,0,No user reviews,0,0,0
982473,True,0,No user reviews,0,0,0
982480,True,0,3 user reviews,0,3,3
982490,True,0,No user reviews,0,0,0
982510,True,0,No user reviews,0,0,0
982520,True,5,Mixed,17,11,28
982540,True,7,Positive,10,0,10
982580,True,6,Mostly Positive,7,3,10
982590,True,5,Mixed,23,13,36
982600,True,0,No user reviews,0,0,0
982610,True,0,No user reviews,0,0,0
982630,True,0,No user reviews,0,0,0
982640,True,0,No user reviews,0,0,0
982650,True,0,No user reviews,0,0,0
982660,True,0,No user reviews,0,0,0
982670,True,0,3 user reviews,2,1,3
982690,True,0,1 user reviews,0,1,1
982700,True,6,Mostly Positive,36,13,49
982710,True,0,No user reviews,0,0,0
982720,True,0,No user reviews,0,0,0
982750,True,0,No user reviews,0,0,0
982760,True,5,Mixed,7,7,14
982780,True,0,No user reviews,0,0,0
982800,True,0,6 user reviews,4,2,6
982810,True,0,No user reviews,0,0,0
982830,True,0,No user reviews,0,0,0
982840,True,0,3 user reviews,3,0,3
982850,True,0,2 user reviews,1,1,2
982910,True,0,No user reviews,0,0,0
982960,True,0,No user reviews,0,0,0
982970,True,6,Mostly Positive,117,43,160
982980,True,0,No user reviews,0,0,0
982990,True,0,2 user reviews,2,0,2
983040,True,0,No user reviews,0,0,0
983050,True,7,Positive,11,0,11
983060,True,0,No user reviews,0,0,0
983070,True,0,No user reviews,0,0,0
983080,True,0,No user reviews,0,0,0
983090,True,0,No user reviews,0,0,0
983100,True,0,2 user reviews,2,0,2
983120,True,0,No user reviews,0,0,0
983140,True,7,Positive,21,0,21
983150,True,0,1 user reviews,1,0,1
983160,True,0,5 user reviews,2,3,5
983170,True,0,2 user reviews,1,1,2
983190,True,0,No user reviews,0,0,0
983240,True,0,3 user reviews,2,1,3
983260,True,0,No user reviews,0,0,0
983270,True,0,No user reviews,0,0,0
983271,True,0,No user reviews,0,0,0
983280,True,0,3 user reviews,3,0,3
983290,True,7,Positive,18,4,22
983300,True,0,1 user reviews,1,0,1
983320,True,0,No user reviews,0,0,0
983330,True,0,No user reviews,0,0,0
983340,True,0,2 user reviews,1,1,2
983350,True,8,Very Positive,151,23,174
983360,True,0,No user reviews,0,0,0
983380,True,0,No user reviews,0,0,0
983390,True,0,No user reviews,0,0,0
983440,True,4,Mostly Negative,6,10,16
983441,True,0,8 user reviews,5,3,8
983442,True,0,2 user reviews,1,1,2
983450,True,7,Positive,9,1,10
983460,True,0,No user reviews,0,0,0
983470,True,0,No user reviews,0,0,0
983480,True,0,No user reviews,0,0,0
983490,True,0,No user reviews,0,0,0
983500,True,0,No user reviews,0,0,0
983520,True,0,2 user reviews,2,0,2
983530,True,0,No user reviews,0,0,0
983580,True,0,No user reviews,0,0,0
983590,True,0,2 user reviews,2,0,2
983610,True,0,1 user reviews,0,1,1
983640,True,0,6 user reviews,6,0,6
983650,True,0,No user reviews,0,0,0
983660,True,0,No user reviews,0,0,0
983670,True,5,Mixed,8,9,17
983680,True,0,No user reviews,0,0,0
983760,True,0,9 user reviews,9,0,9
983780,True,0,2 user reviews,1,1,2
983790,True,0,3 user reviews,3,0,3
983800,True,0,No user reviews,0,0,0
983820,True,0,8 user reviews,2,6,8
983830,True,0,6 user reviews,5,1,6
983840,True,5,Mixed,5,6,11
983870,True,0,No user reviews,0,0,0
983880,True,5,Mixed,5,6,11
983890,True,0,5 user reviews,1,4,5
983900,True,0,2 user reviews,2,0,2
983920,True,0,No user reviews,0,0,0
983930,True,0,No user reviews,0,0,0
983950,True,0,No user reviews,0,0,0
983970,True,0,No user reviews,0,0,0
983980,True,0,9 user reviews,6,3,9
983990,True,0,2 user reviews,2,0,2
984000,True,0,No user reviews,0,0,0
984010,True,0,No user reviews,0,0,0
984020,True,0,5 user reviews,5,0,5
984030,True,0,1 user reviews,1,0,1
984070,True,0,9 user reviews,6,3,9
984080,True,0,5 user reviews,0,5,5
984090,True,0,No user reviews,0,0,0
984100,True,0,No user reviews,0,0,0
984110,True,0,4 user reviews,4,0,4
984130,True,0,2 user reviews,2,0,2
984150,True,0,1 user reviews,0,1,1
984160,True,0,No user reviews,0,0,0
984161,True,0,No user reviews,0,0,0
984162,True,0,No user reviews,0,0,0
984170,True,0,1 user reviews,0,1,1
984180,True,7,Positive,20,5,25
984200,True,0,1 user reviews,1,0,1
984210,True,0,7 user reviews,5,2,7
984220,True,7,Positive,12,2,14
984230,True,0,No user reviews,0,0,0
984240,True,0,No user reviews,0,0,0
984250,True,0,2 user reviews,2,0,2
984260,True,0,No user reviews,0,0,0
984270,True,0,1 user reviews,1,0,1
984280,True,0,No user reviews,0,0,0
984300,True,0,5 user reviews,4,1,5
984330,True,0,No user reviews,0,0,0
984340,True,0,1 user reviews,1,0,1
984360,True,0,5 user reviews,5,0,5
984370,True,0,No user reviews,0,0,0
984440,True,0,No user reviews,0,0,0
984450,True,7,Positive,19,0,19
984470,True,7,Positive,9,1,10
984490,True,0,No user reviews,0,0,0
984510,True,0,3 user reviews,3,0,3
984520,True,0,4 user reviews,1,3,4
984530,True,0,No user reviews,0,0,0
984540,True,0,6 user reviews,6,0,6
984550,True,0,No user reviews,0,0,0
984560,True,8,Very Positive,293,41,334
984570,True,0,No user reviews,0,0,0
984580,True,0,No user reviews,0,0,0
984590,True,0,2 user reviews,2,0,2
984610,True,7,Positive,32,1,33
984630,True,0,No user reviews,0,0,0
984660,True,5,Mixed,9,8,17
984680,True,8,Very Positive,188,45,233
984690,True,0,No user reviews,0,0,0
984710,True,0,2 user reviews,0,2,2
984711,True,0,2 user reviews,0,2,2
984720,True,7,Positive,37,5,42
984730,True,0,4 user reviews,3,1,4
984740,True,0,2 user reviews,0,2,2
984741,True,0,2 user reviews,0,2,2
984780,True,8,Very Positive,327,46,373
984800,True,6,Mostly Positive,105,39,144
984810,True,0,No user reviews,0,0,0
984820,True,0,3 user reviews,0,3,3
984830,True,0,1 user reviews,1,0,1
984850,True,0,No user reviews,0,0,0
984860,True,0,No user reviews,0,0,0
984870,True,0,No user reviews,0,0,0
984880,True,0,1 user reviews,1,0,1
984910,True,0,5 user reviews,5,0,5
984920,True,0,No user reviews,0,0,0
984930,True,0,3 user reviews,1,2,3
984970,True,0,1 user reviews,1,0,1
984980,True,0,No user reviews,0,0,0
984990,True,0,No user reviews,0,0,0
985000,True,0,No user reviews,0,0,0
985020,True,0,No user reviews,0,0,0
985040,True,7,Positive,29,5,34
985050,True,0,No user reviews,0,0,0
985060,True,0,No user reviews,0,0,0
985070,True,0,1 user reviews,0,1,1
985080,True,7,Positive,20,0,20
985090,True,0,No user reviews,0,0,0
985110,True,7,Positive,10,1,11
985130,True,0,No user reviews,0,0,0
985140,True,0,No user reviews,0,0,0
985150,True,0,No user reviews,0,0,0
985180,True,0,No user reviews,0,0,0
985190,True,0,3 user reviews,3,0,3
985200,True,0,No user reviews,0,0,0
985240,True,0,No user reviews,0,0,0
985250,True,0,No user reviews,0,0,0
985260,True,8,Very Positive,78,10,88
985270,True,0,No user reviews,0,0,0
985280,True,0,1 user reviews,0,1,1
985290,True,0,No user reviews,0,0,0
985330,True,0,6 user reviews,4,2,6
985340,True,0,No user reviews,0,0,0
985400,True,5,Mixed,11,5,16
985410,True,0,No user reviews,0,0,0
985420,True,0,1 user reviews,0,1,1
985430,True,5,Mixed,25,14,39
985450,True,0,No user reviews,0,0,0
985460,True,0,3 user reviews,3,0,3
985470,True,0,2 user reviews,2,0,2
985500,True,0,4 user reviews,2,2,4
985510,True,7,Positive,11,2,13
985520,True,0,No user reviews,0,0,0
985530,True,0,6 user reviews,4,2,6
985540,True,0,No user reviews,0,0,0
985550,True,0,No user reviews,0,0,0
985560,True,0,No user reviews,0,0,0
985580,True,0,3 user reviews,2,1,3
985590,True,7,Positive,20,0,20
985600,True,0,No user reviews,0,0,0
985620,True,0,4 user reviews,4,0,4
985630,True,0,No user reviews,0,0,0
985640,True,0,4 user reviews,2,2,4
985650,True,0,No user reviews,0,0,0
985660,True,0,1 user reviews,0,1,1
985680,True,0,No user reviews,0,0,0
985690,True,0,1 user reviews,1,0,1
985700,True,0,No user reviews,0,0,0
985710,True,0,9 user reviews,1,8,9
985720,True,4,Mostly Negative,6,12,18
985740,True,0,No user reviews,0,0,0
985750,True,0,No user reviews,0,0,0
985760,True,5,Mixed,40,19,59
985770,True,0,1 user reviews,0,1,1
985780,True,0,No user reviews,0,0,0
985790,True,0,No user reviews,0,0,0
985800,True,6,Mostly Positive,7,3,10
985830,True,0,No user reviews,0,0,0
985840,True,0,No user reviews,0,0,0
985860,True,0,1 user reviews,1,0,1
985870,True,0,No user reviews,0,0,0
985890,True,8,Very Positive,2810,262,3072
985900,True,0,No user reviews,0,0,0
985920,True,3,Negative,2,10,12
985930,True,0,No user reviews,0,0,0
985940,True,0,3 user reviews,1,2,3
985950,True,6,Mostly Positive,89,33,122
986000,True,0,No user reviews,0,0,0
986001,True,0,No user reviews,0,0,0
986010,True,0,No user reviews,0,0,0
986020,True,8,Very Positive,50,7,57
986040,True,0,No user reviews,0,0,0
986050,True,0,No user reviews,0,0,0
986060,True,0,No user reviews,0,0,0
986070,True,7,Positive,10,0,10
986080,True,5,Mixed,6,5,11
986090,True,7,Positive,41,0,41
986110,True,0,No user reviews,0,0,0
986120,True,0,2 user reviews,1,1,2
986130,True,0,No user reviews,0,0,0
986140,True,0,1 user reviews,1,0,1
986170,True,0,2 user reviews,2,0,2
986180,True,0,No user reviews,0,0,0
986220,True,0,No user reviews,0,0,0
986230,True,0,1 user reviews,1,0,1
986240,True,0,2 user reviews,2,0,2
986250,True,7,Positive,30,1,31
986280,True,7,Positive,16,1,17
986290,True,0,No user reviews,0,0,0
986300,True,0,1 user reviews,1,0,1
986310,True,0,No user reviews,0,0,0
986320,True,0,No user reviews,0,0,0
986340,True,0,7 user reviews,5,2,7
986350,True,0,No user reviews,0,0,0
986370,True,0,7 user reviews,7,0,7
986400,True,0,1 user reviews,0,1,1
986470,True,0,No user reviews,0,0,0
986490,True,0,No user reviews,0,0,0
986500,True,0,No user reviews,0,0,0
986510,True,7,Positive,17,0,17
986520,True,0,No user reviews,0,0,0
986630,True,0,No user reviews,0,0,0
986670,True,0,1 user reviews,1,0,1
986680,True,0,9 user reviews,8,1,9
986700,True,0,No user reviews,0,0,0
986710,True,7,Positive,11,1,12
986760,True,0,No user reviews,0,0,0
986770,True,0,No user reviews,0,0,0
986780,True,0,No user reviews,0,0,0
986790,True,0,2 user reviews,1,1,2
986800,True,8,Very Positive,147,1,148
986820,True,7,Positive,15,2,17
986830,True,7,Positive,11,1,12
986840,True,0,No user reviews,0,0,0
986850,True,6,Mostly Positive,54,19,73
986860,True,0,No user reviews,0,0,0
986870,True,0,1 user reviews,1,0,1
986920,True,0,1 user reviews,1,0,1
986930,True,0,No user reviews,0,0,0
986950,True,0,No user reviews,0,0,0
986970,True,0,No user reviews,0,0,0
986990,True,7,Positive,15,2,17
987000,True,7,Positive,24,6,30
987020,True,8,Very Positive,343,40,383
987040,True,0,2 user reviews,0,2,2
987050,True,6,Mostly Positive,21,8,29
987060,True,0,1 user reviews,1,0,1
987070,True,7,Positive,11,0,11
987110,True,0,No user reviews,0,0,0
987120,True,0,No user reviews,0,0,0
987140,True,0,No user reviews,0,0,0
987150,True,5,Mixed,61,37,98
987170,True,0,9 user reviews,6,3,9
987180,True,0,9 user reviews,6,3,9
987190,True,7,Positive,18,4,22
987200,True,5,Mixed,14,8,22
987210,True,6,Mostly Positive,8,3,11
987220,True,0,No user reviews,0,0,0
987230,True,6,Mostly Positive,136,55,191
987240,True,0,No user reviews,0,0,0
987250,True,0,1 user reviews,0,1,1
987260,True,0,No user reviews,0,0,0
987270,True,7,Positive,12,3,15
987280,True,0,No user reviews,0,0,0
987290,True,7,Positive,15,3,18
987310,True,0,No user reviews,0,0,0
987320,True,0,No user reviews,0,0,0
987330,True,5,Mixed,12,12,24
987340,True,0,3 user reviews,3,0,3
987350,True,8,Very Positive,52,8,60
987370,True,0,No user reviews,0,0,0
987400,True,7,Positive,37,7,44
987410,True,7,Positive,14,2,16
987430,True,0,No user reviews,0,0,0
987440,True,0,1 user reviews,1,0,1
987450,True,0,No user reviews,0,0,0
987460,True,0,No user reviews,0,0,0
987490,True,0,2 user reviews,0,2,2
987500,True,0,2 user reviews,2,0,2
987570,True,0,6 user reviews,5,1,6
987580,True,0,4 user reviews,4,0,4
987590,True,0,9 user reviews,4,5,9
987600,True,0,No user reviews,0,0,0
987620,True,0,1 user reviews,1,0,1
987630,True,5,Mixed,5,5,10
987650,True,0,No user reviews,0,0,0
987660,True,0,2 user reviews,1,1,2
987670,True,0,3 user reviews,3,0,3
987680,True,0,No user reviews,0,0,0
987710,True,0,7 user reviews,7,0,7
987720,True,5,Mixed,87,42,129
987730,True,7,Positive,10,2,12
987740,True,0,8 user reviews,6,2,8
987770,True,7,Positive,30,6,36
987780,True,0,1 user reviews,1,0,1
987790,True,0,No user reviews,0,0,0
987800,True,0,2 user reviews,1,1,2
987810,True,0,7 user reviews,6,1,7
987820,True,0,No user reviews,0,0,0
987830,True,0,No user reviews,0,0,0
987850,True,5,Mixed,19,12,31
987860,True,0,No user reviews,0,0,0
987880,True,7,Positive,18,1,19
987900,True,0,No user reviews,0,0,0
987910,True,0,No user reviews,0,0,0
987930,True,0,No user reviews,0,0,0
987950,True,6,Mostly Positive,20,6,26
987980,True,0,No user reviews,0,0,0
987990,True,0,3 user reviews,3,0,3
988000,True,0,No user reviews,0,0,0
988010,True,0,2 user reviews,2,0,2
988011,True,0,No user reviews,0,0,0
988012,True,0,No user reviews,0,0,0
988013,True,0,No user reviews,0,0,0
988014,True,0,No user reviews,0,0,0
988015,True,0,No user reviews,0,0,0
988016,True,0,No user reviews,0,0,0
988017,True,0,No user reviews,0,0,0
988018,True,0,No user reviews,0,0,0
988019,True,0,No user reviews,0,0,0
988020,True,0,No user reviews,0,0,0
988021,True,0,1 user reviews,1,0,1
988040,True,0,No user reviews,0,0,0
988041,True,0,2 user reviews,2,0,2
988042,True,0,No user reviews,0,0,0
988043,True,0,1 user reviews,1,0,1
988044,True,0,No user reviews,0,0,0
988045,True,0,No user reviews,0,0,0
988046,True,0,No user reviews,0,0,0
988047,True,0,No user reviews,0,0,0
988070,True,0,1 user reviews,0,1,1
988080,True,0,1 user reviews,0,1,1
988100,True,7,Positive,13,2,15
988110,True,0,3 user reviews,3,0,3
988150,True,0,2 user reviews,2,0,2
988160,True,7,Positive,10,0,10
988170,True,0,7 user reviews,2,5,7
988171,True,5,Mixed,12,6,18
988172,True,5,Mixed,10,9,19
988180,True,4,Mostly Negative,5,8,13
988190,True,0,7 user reviews,4,3,7
988210,True,0,No user reviews,0,0,0
988220,True,0,No user reviews,0,0,0
988230,True,0,No user reviews,0,0,0
988240,True,5,Mixed,11,8,19
988250,True,0,2 user reviews,2,0,2
988310,True,7,Positive,20,1,21
988320,True,0,5 user reviews,5,0,5
988330,True,0,1 user reviews,0,1,1
988340,True,4,Mostly Negative,3,7,10
988350,True,0,No user reviews,0,0,0
988360,True,0,No user reviews,0,0,0
988410,True,0,No user reviews,0,0,0
988430,True,0,No user reviews,0,0,0
988440,True,5,Mixed,62,77,139
988450,True,5,Mixed,25,13,38
988470,True,7,Positive,39,6,45
988480,True,0,No user reviews,0,0,0
988490,True,8,Very Positive,50,3,53
988500,True,0,No user reviews,0,0,0
988550,True,0,No user reviews,0,0,0
988590,True,0,No user reviews,0,0,0
988620,True,0,3 user reviews,3,0,3
988621,True,0,2 user reviews,2,0,2
988630,True,0,No user reviews,0,0,0
988640,True,0,No user reviews,0,0,0
988650,True,7,Positive,11,1,12
988690,True,0,No user reviews,0,0,0
988720,True,0,No user reviews,0,0,0
988740,True,0,No user reviews,0,0,0
988750,True,0,3 user reviews,3,0,3
988760,True,0,No user reviews,0,0,0
988780,True,0,No user reviews,0,0,0
988810,True,0,8 user reviews,7,1,8
988830,True,0,No user reviews,0,0,0
988840,True,0,No user reviews,0,0,0
988850,True,0,No user reviews,0,0,0
988870,True,0,2 user reviews,2,0,2
988890,True,0,4 user reviews,3,1,4
988910,True,8,Very Positive,470,40,510
988920,True,0,1 user reviews,0,1,1
988940,True,5,Mixed,14,9,23
988950,True,0,No user reviews,0,0,0
988960,True,0,No user reviews,0,0,0
988970,True,0,No user reviews,0,0,0
988980,True,0,6 user reviews,5,1,6
988990,True,0,No user reviews,0,0,0
989000,True,0,1 user reviews,0,1,1
989010,True,0,3 user reviews,1,2,3
989030,True,0,No user reviews,0,0,0
989040,True,0,3 user reviews,1,2,3
989050,True,5,Mixed,10,7,17
989060,True,0,5 user reviews,5,0,5
989080,True,7,Positive,9,1,10
989110,True,0,1 user reviews,0,1,1
989120,True,0,No user reviews,0,0,0
989140,True,0,1 user reviews,1,0,1
989150,True,0,No user reviews,0,0,0
989160,True,0,3 user reviews,2,1,3
989170,True,0,5 user reviews,5,0,5
989190,True,0,No user reviews,0,0,0
989210,True,0,No user reviews,0,0,0
989220,True,0,No user reviews,0,0,0
989230,True,0,No user reviews,0,0,0
989240,True,0,No user reviews,0,0,0
989250,True,0,2 user reviews,0,2,2
989260,True,0,2 user reviews,1,1,2
989270,True,0,No user reviews,0,0,0
989280,True,0,No user reviews,0,0,0
989320,True,0,No user reviews,0,0,0
989340,True,0,6 user reviews,5,1,6
989350,True,0,No user reviews,0,0,0
989360,True,0,No user reviews,0,0,0
989370,True,0,2 user reviews,2,0,2
989390,True,0,No user reviews,0,0,0
989400,True,0,1 user reviews,1,0,1
989430,True,0,3 user reviews,3,0,3
989450,True,0,3 user reviews,2,1,3
989460,True,0,No user reviews,0,0,0
989480,True,0,No user reviews,0,0,0
989490,True,0,No user reviews,0,0,0
989500,True,0,No user reviews,0,0,0
989520,True,0,1 user reviews,0,1,1
989530,True,0,No user reviews,0,0,0
989550,True,6,Mostly Positive,63,16,79
989560,True,0,7 user reviews,5,2,7
989580,True,5,Mixed,11,9,20
989640,True,0,2 user reviews,2,0,2
989650,True,0,2 user reviews,0,2,2
989670,True,0,No user reviews,0,0,0
989680,True,0,1 user reviews,0,1,1
989690,True,6,Mostly Positive,327,133,460
989700,True,0,No user reviews,0,0,0
989710,True,0,2 user reviews,1,1,2
989720,True,0,No user reviews,0,0,0
989730,True,0,No user reviews,0,0,0
989740,True,0,No user reviews,0,0,0
989741,True,0,No user reviews,0,0,0
989750,True,0,1 user reviews,1,0,1
989770,True,6,Mostly Positive,82,28,110
989780,True,0,7 user reviews,0,7,7
989790,True,0,No user reviews,0,0,0
989810,True,0,2 user reviews,1,1,2
989860,True,0,No user reviews,0,0,0
989870,True,0,No user reviews,0,0,0
989900,True,0,No user reviews,0,0,0
989960,True,7,Positive,13,0,13
989970,True,0,1 user reviews,1,0,1
989980,True,0,No user reviews,0,0,0
990010,True,0,No user reviews,0,0,0
990020,True,0,1 user reviews,1,0,1
990030,True,7,Positive,20,5,25
990040,True,0,No user reviews,0,0,0
990050,True,8,Very Positive,221,55,276
990060,True,0,No user reviews,0,0,0
990070,True,0,No user reviews,0,0,0
990090,True,0,No user reviews,0,0,0
990100,True,0,No user reviews,0,0,0
990160,True,0,4 user reviews,1,3,4
990170,True,0,No user reviews,0,0,0
990180,True,7,Positive,16,0,16
990200,True,0,No user reviews,0,0,0
990201,True,0,No user reviews,0,0,0
990202,True,0,No user reviews,0,0,0
990230,True,0,5 user reviews,4,1,5
990240,True,0,3 user reviews,2,1,3
990250,True,0,No user reviews,0,0,0
990270,True,0,No user reviews,0,0,0
990280,True,0,6 user reviews,5,1,6
990310,True,0,No user reviews,0,0,0
990320,True,0,No user reviews,0,0,0
990330,True,0,No user reviews,0,0,0
990340,True,0,No user reviews,0,0,0
990360,True,6,Mostly Positive,26,8,34
990390,True,0,1 user reviews,1,0,1
990400,True,0,2 user reviews,2,0,2
990410,True,0,No user reviews,0,0,0
990430,True,7,Positive,18,0,18
990480,True,0,1 user reviews,0,1,1
990500,True,0,1 user reviews,1,0,1
990630,True,0,No user reviews,0,0,0
990640,True,7,Positive,28,7,35
990650,True,4,Mostly Negative,93,280,373
990720,True,0,No user reviews,0,0,0
990730,True,5,Mixed,7,5,12
990731,True,0,3 user reviews,3,0,3
990732,True,0,1 user reviews,1,0,1
990733,True,0,7 user reviews,7,0,7
990740,True,0,8 user reviews,4,4,8
990750,True,0,6 user reviews,5,1,6
990762,True,0,2 user reviews,2,0,2
990770,True,0,No user reviews,0,0,0
990830,True,0,No user reviews,0,0,0
990840,True,0,6 user reviews,3,3,6
990850,True,5,Mixed,6,8,14
990890,True,0,No user reviews,0,0,0
990900,True,7,Positive,11,0,11
990920,True,0,No user reviews,0,0,0
990930,True,5,Mixed,11,10,21
990931,True,0,5 user reviews,4,1,5
990932,True,5,Mixed,7,5,12
990940,True,0,2 user reviews,2,0,2
990950,True,0,1 user reviews,0,1,1
990960,True,0,2 user reviews,1,1,2
990970,True,0,No user reviews,0,0,0
991010,True,0,No user reviews,0,0,0
991011,True,0,No user reviews,0,0,0
991060,True,0,1 user reviews,1,0,1
991061,True,0,No user reviews,0,0,0
991063,True,0,No user reviews,0,0,0
991064,True,0,1 user reviews,1,0,1
991065,True,0,No user reviews,0,0,0
991066,True,0,1 user reviews,0,1,1
991067,True,0,No user reviews,0,0,0
991068,True,0,No user reviews,0,0,0
991069,True,0,2 user reviews,2,0,2
991070,True,6,Mostly Positive,19,7,26
991080,True,0,2 user reviews,2,0,2
991130,True,0,No user reviews,0,0,0
991170,True,8,Very Positive,457,86,543
991220,True,0,No user reviews,0,0,0
991230,True,0,6 user reviews,3,3,6
991240,True,0,7 user reviews,6,1,7
991260,True,5,Mixed,285,134,419
991270,True,9,Overwhelmingly Positive,770,27,797
991280,True,0,9 user reviews,5,4,9
991290,True,0,No user reviews,0,0,0
991430,True,7,Positive,11,0,11
991450,True,0,No user reviews,0,0,0
991480,True,0,9 user reviews,8,1,9
991490,True,0,1 user reviews,1,0,1
991500,True,0,5 user reviews,4,1,5
991510,True,0,6 user reviews,6,0,6
991520,True,0,2 user reviews,0,2,2
991530,True,0,No user reviews,0,0,0
991560,True,5,Mixed,77,56,133
991580,True,0,No user reviews,0,0,0
991600,True,8,Very Positive,100,12,112
991610,True,0,No user reviews,0,0,0
991620,True,0,3 user reviews,3,0,3
991630,True,0,No user reviews,0,0,0
991660,True,0,1 user reviews,0,1,1
991680,True,0,No user reviews,0,0,0
991690,True,0,No user reviews,0,0,0
991730,True,0,No user reviews,0,0,0
991740,True,0,No user reviews,0,0,0
991750,True,0,4 user reviews,4,0,4
991760,True,0,No user reviews,0,0,0
991770,True,0,2 user reviews,2,0,2
991771,True,0,1 user reviews,1,0,1
991772,True,0,No user reviews,0,0,0
991773,True,0,8 user reviews,2,6,8
991774,True,0,1 user reviews,1,0,1
991780,True,5,Mixed,16,12,28
991790,True,0,No user reviews,0,0,0
991800,True,0,No user reviews,0,0,0
991810,True,5,Mixed,95,41,136
991850,True,0,No user reviews,0,0,0
991860,True,0,4 user reviews,3,1,4
991870,True,7,Positive,13,0,13
991890,True,0,1 user reviews,1,0,1
991930,True,0,No user reviews,0,0,0
991960,True,7,Positive,10,1,11
992000,True,0,1 user reviews,0,1,1
992030,True,0,No user reviews,0,0,0
992040,True,0,6 user reviews,5,1,6
992050,True,6,Mostly Positive,13,4,17
992070,True,0,No user reviews,0,0,0
992080,True,0,No user reviews,0,0,0
992100,True,0,No user reviews,0,0,0
992120,True,7,Positive,22,0,22
992130,True,0,No user reviews,0,0,0
992140,True,0,No user reviews,0,0,0
992150,True,0,No user reviews,0,0,0
992160,True,0,1 user reviews,1,0,1
992170,True,7,Positive,39,4,43
992171,True,7,Positive,18,3,21
992172,True,7,Positive,40,4,44
992173,True,7,Positive,22,1,23
992174,True,8,Very Positive,54,2,56
992175,True,8,Very Positive,57,6,63
992176,True,7,Positive,40,7,47
992180,True,0,1 user reviews,1,0,1
992200,True,7,Positive,9,1,10
992210,True,7,Positive,9,1,10
992240,True,0,No user reviews,0,0,0
992250,True,0,No user reviews,0,0,0
992260,True,0,1 user reviews,1,0,1
992270,True,0,No user reviews,0,0,0
992300,True,8,Very Positive,554,100,654
992310,True,0,No user reviews,0,0,0
992330,True,7,Positive,18,4,22
992360,True,0,1 user reviews,0,1,1
992370,True,0,No user reviews,0,0,0
992420,True,0,1 user reviews,1,0,1
992440,True,0,No user reviews,0,0,0
992470,True,0,No user reviews,0,0,0
992480,True,0,1 user reviews,0,1,1
992490,True,0,2 user reviews,1,1,2
992520,True,0,No user reviews,0,0,0
992560,True,0,No user reviews,0,0,0
992600,True,0,No user reviews,0,0,0
992610,True,0,8 user reviews,8,0,8
992620,True,0,No user reviews,0,0,0
992640,True,5,Mixed,491,494,985
992680,True,0,No user reviews,0,0,0
992690,True,0,No user reviews,0,0,0
992700,True,0,No user reviews,0,0,0
992710,True,0,No user reviews,0,0,0
992720,True,0,No user reviews,0,0,0
992730,True,8,Very Positive,56,10,66
992740,True,0,2 user reviews,2,0,2
992750,True,0,No user reviews,0,0,0
992770,True,0,No user reviews,0,0,0
992780,True,0,No user reviews,0,0,0
992790,True,0,No user reviews,0,0,0
992820,True,0,No user reviews,0,0,0
992830,True,0,No user reviews,0,0,0
992840,True,0,No user reviews,0,0,0
992850,True,0,No user reviews,0,0,0
992860,True,0,No user reviews,0,0,0
992870,True,0,4 user reviews,3,1,4
992880,True,0,1 user reviews,1,0,1
992890,True,0,3 user reviews,2,1,3
992910,True,6,Mostly Positive,286,110,396
992920,True,0,No user reviews,0,0,0
992930,True,0,No user reviews,0,0,0
992950,True,0,5 user reviews,4,1,5
992960,True,0,6 user reviews,4,2,6
992970,True,0,1 user reviews,1,0,1
992990,True,7,Positive,10,0,10
993020,True,0,5 user reviews,5,0,5
993030,True,0,No user reviews,0,0,0
993090,True,8,Very Positive,81,4,85
993100,True,0,1 user reviews,0,1,1
993110,True,0,No user reviews,0,0,0
993160,True,0,No user reviews,0,0,0
993170,True,0,1 user reviews,1,0,1
993180,True,0,1 user reviews,1,0,1
993181,True,0,No user reviews,0,0,0
993200,True,0,No user reviews,0,0,0
993220,True,0,No user reviews,0,0,0
993240,True,0,No user reviews,0,0,0
993241,True,0,No user reviews,0,0,0
993250,True,0,4 user reviews,2,2,4
993260,True,0,No user reviews,0,0,0
993270,True,0,9 user reviews,9,0,9
993290,True,0,No user reviews,0,0,0
993300,True,0,No user reviews,0,0,0
993330,True,0,No user reviews,0,0,0
993340,True,5,Mixed,38,20,58
993370,True,0,No user reviews,0,0,0
993390,True,0,No user reviews,0,0,0
993400,True,0,4 user reviews,1,3,4
993410,True,0,1 user reviews,1,0,1
993420,True,0,No user reviews,0,0,0
993490,True,0,No user reviews,0,0,0
993500,True,0,5 user reviews,4,1,5
993520,True,0,4 user reviews,2,2,4
993530,True,0,No user reviews,0,0,0
993550,True,0,No user reviews,0,0,0
993580,True,0,4 user reviews,4,0,4
993590,True,0,No user reviews,0,0,0
993610,True,0,1 user reviews,1,0,1
993620,True,0,No user reviews,0,0,0
993630,True,0,1 user reviews,1,0,1
993640,True,5,Mixed,11,5,16
993650,True,0,No user reviews,0,0,0
993660,True,0,No user reviews,0,0,0
993670,True,0,No user reviews,0,0,0
993680,True,0,5 user reviews,2,3,5
993690,True,5,Mixed,25,18,43
993710,True,0,No user reviews,0,0,0
993740,True,8,Very Positive,46,6,52
993750,True,0,6 user reviews,2,4,6
993770,True,0,No user reviews,0,0,0
993780,True,7,Positive,23,1,24
993790,True,8,Very Positive,167,10,177
993810,True,0,2 user reviews,2,0,2
993840,True,0,6 user reviews,6,0,6
993850,True,0,2 user reviews,2,0,2
993860,True,0,No user reviews,0,0,0
993870,True,0,No user reviews,0,0,0
993880,True,0,No user reviews,0,0,0
993890,True,0,4 user reviews,4,0,4
993910,True,0,No user reviews,0,0,0
993911,True,0,No user reviews,0,0,0
993912,True,0,No user reviews,0,0,0
993920,True,0,No user reviews,0,0,0
993921,True,0,1 user reviews,1,0,1
993922,True,0,1 user reviews,1,0,1
993923,True,0,No user reviews,0,0,0
993924,True,0,1 user reviews,0,1,1
993925,True,0,No user reviews,0,0,0
993926,True,0,No user reviews,0,0,0
993927,True,0,No user reviews,0,0,0
993928,True,0,No user reviews,0,0,0
993929,True,0,No user reviews,0,0,0
993930,True,0,No user reviews,0,0,0
993931,True,0,No user reviews,0,0,0
993932,True,0,No user reviews,0,0,0
993933,True,0,No user reviews,0,0,0
993940,True,0,No user reviews,0,0,0
993950,True,0,No user reviews,0,0,0
993960,True,0,No user reviews,0,0,0
993980,True,0,2 user reviews,1,1,2
993990,True,0,3 user reviews,2,1,3
994000,True,0,No user reviews,0,0,0
994020,True,7,Positive,35,2,37
994030,True,0,No user reviews,0,0,0
994040,True,7,Positive,12,0,12
994060,True,0,No user reviews,0,0,0
994110,True,0,No user reviews,0,0,0
994120,True,0,No user reviews,0,0,0
994130,True,0,No user reviews,0,0,0
994140,True,8,Very Positive,77,4,81
994160,True,6,Mostly Positive,12,5,17
994170,True,0,No user reviews,0,0,0
994180,True,0,4 user reviews,3,1,4
994190,True,0,No user reviews,0,0,0
994200,True,7,Positive,9,2,11
994210,True,6,Mostly Positive,10,3,13
994220,True,8,Very Positive,379,41,420
994230,True,0,4 user reviews,2,2,4
994250,True,0,No user reviews,0,0,0
994260,True,0,No user reviews,0,0,0
994280,True,8,Very Positive,830,140,970
994290,True,0,No user reviews,0,0,0
994300,True,0,1 user reviews,1,0,1
994310,True,0,3 user reviews,0,3,3
994320,True,5,Mixed,19,19,38
994330,True,0,No user reviews,0,0,0
994340,True,7,Positive,20,0,20
994350,True,6,Mostly Positive,9,3,12
994360,True,0,3 user reviews,3,0,3
994420,True,0,No user reviews,0,0,0
994430,True,0,No user reviews,0,0,0
994450,True,0,No user reviews,0,0,0
994460,True,0,No user reviews,0,0,0
994480,True,0,No user reviews,0,0,0
994490,True,0,No user reviews,0,0,0
994500,True,7,Positive,26,2,28
994510,True,0,No user reviews,0,0,0
994520,True,0,No user reviews,0,0,0
994530,True,0,No user reviews,0,0,0
994560,True,0,No user reviews,0,0,0
994580,True,0,No user reviews,0,0,0
994590,True,0,No user reviews,0,0,0
994610,True,0,No user reviews,0,0,0
994650,True,0,1 user reviews,1,0,1
994660,True,0,No user reviews,0,0,0
994670,True,7,Positive,12,1,13
994680,True,0,No user reviews,0,0,0
994710,True,0,No user reviews,0,0,0
994730,True,8,Very Positive,173,17,190
994740,True,0,No user reviews,0,0,0
994750,True,0,No user reviews,0,0,0
994760,True,0,No user reviews,0,0,0
994790,True,0,2 user reviews,2,0,2
994800,True,0,No user reviews,0,0,0
994840,True,0,No user reviews,0,0,0
994860,True,0,4 user reviews,4,0,4
994870,True,0,9 user reviews,6,3,9
994880,True,0,1 user reviews,1,0,1
994890,True,5,Mixed,24,12,36
994900,True,0,3 user reviews,3,0,3
994910,True,0,No user reviews,0,0,0
994930,True,0,No user reviews,0,0,0
994950,True,0,No user reviews,0,0,0
994970,True,0,No user reviews,0,0,0
994980,True,0,No user reviews,0,0,0
995000,True,0,8 user reviews,5,3,8
995020,True,0,No user reviews,0,0,0
995021,True,0,No user reviews,0,0,0
995030,True,0,No user reviews,0,0,0
995040,True,0,1 user reviews,1,0,1
995050,True,8,Very Positive,124,22,146
995060,True,0,No user reviews,0,0,0
995070,True,0,No user reviews,0,0,0
995140,True,5,Mixed,6,7,13
995160,True,0,6 user reviews,6,0,6
995170,True,0,1 user reviews,1,0,1
995190,True,0,No user reviews,0,0,0
995210,True,4,Mostly Negative,5,9,14
995230,True,8,Very Positive,127,22,149
995240,True,7,Positive,9,2,11
995270,True,0,No user reviews,0,0,0
995280,True,0,6 user reviews,3,3,6
995290,True,0,No user reviews,0,0,0
995300,True,0,4 user reviews,3,1,4
995310,True,0,No user reviews,0,0,0
995330,True,0,No user reviews,0,0,0
995340,True,0,No user reviews,0,0,0
995380,True,7,Positive,27,3,30
995430,True,0,8 user reviews,3,5,8
995450,True,5,Mixed,10,5,15
995460,True,8,Very Positive,61,1,62
995470,True,0,7 user reviews,6,1,7
995480,True,0,1 user reviews,0,1,1
995490,True,0,5 user reviews,5,0,5
995560,True,0,No user reviews,0,0,0
995580,True,0,No user reviews,0,0,0
995590,True,0,1 user reviews,0,1,1
995610,True,7,Positive,12,0,12
995640,True,0,2 user reviews,1,1,2
995650,True,0,5 user reviews,4,1,5
995651,True,0,4 user reviews,3,1,4
995652,True,0,5 user reviews,3,2,5
995653,True,0,5 user reviews,3,2,5
995654,True,0,7 user reviews,5,2,7
995660,True,5,Mixed,6,8,14
995670,True,5,Mixed,9,4,13
995680,True,0,No user reviews,0,0,0
995700,True,0,1 user reviews,0,1,1
995710,True,0,No user reviews,0,0,0
995720,True,0,No user reviews,0,0,0
995770,True,7,Positive,25,1,26
995780,True,6,Mostly Positive,32,10,42
995790,True,0,6 user reviews,4,2,6
995800,True,0,No user reviews,0,0,0
995810,True,0,No user reviews,0,0,0
995850,True,0,No user reviews,0,0,0
995860,True,7,Positive,33,5,38
995870,True,7,Positive,9,1,10
995890,True,0,1 user reviews,1,0,1
995900,True,0,2 user reviews,2,0,2
995910,True,0,3 user reviews,1,2,3
995920,True,0,2 user reviews,2,0,2
995930,True,0,No user reviews,0,0,0
995940,True,0,No user reviews,0,0,0
995950,True,0,2 user reviews,2,0,2
995960,True,5,Mixed,21,24,45
995970,True,5,Mixed,9,8,17
995980,True,8,Very Positive,172,28,200
996000,True,7,Positive,10,0,10
996010,True,0,No user reviews,0,0,0
996050,True,5,Mixed,9,4,13
996060,True,7,Positive,12,0,12
996080,True,7,Positive,27,3,30
996090,True,0,No user reviews,0,0,0
996140,True,0,No user reviews,0,0,0
996150,True,0,1 user reviews,1,0,1
996160,True,0,5 user reviews,3,2,5
996170,True,0,No user reviews,0,0,0
996180,True,0,4 user reviews,4,0,4
996210,True,0,No user reviews,0,0,0
996220,True,0,No user reviews,0,0,0
996230,True,0,No user reviews,0,0,0
996240,True,0,No user reviews,0,0,0
996250,True,0,No user reviews,0,0,0
996260,True,0,No user reviews,0,0,0
996280,True,0,1 user reviews,1,0,1
996300,True,0,1 user reviews,0,1,1
996310,True,0,No user reviews,0,0,0
996311,True,0,No user reviews,0,0,0
996312,True,0,No user reviews,0,0,0
996313,True,0,No user reviews,0,0,0
996314,True,0,No user reviews,0,0,0
996330,True,0,No user reviews,0,0,0
996340,True,0,No user reviews,0,0,0
996350,True,0,No user reviews,0,0,0
996360,True,0,No user reviews,0,0,0
996370,True,0,No user reviews,0,0,0
996380,True,5,Mixed,182,207,389
996410,True,0,No user reviews,0,0,0
996430,True,0,1 user reviews,0,1,1
996450,True,7,Positive,14,3,17
996470,True,5,Mixed,1224,540,1764
996480,True,0,No user reviews,0,0,0
996520,True,0,No user reviews,0,0,0
996530,True,0,No user reviews,0,0,0
996540,True,0,No user reviews,0,0,0
996541,True,0,No user reviews,0,0,0
996550,True,0,9 user reviews,9,0,9
996560,True,0,No user reviews,0,0,0
996570,True,0,No user reviews,0,0,0
996580,True,8,Very Positive,3124,190,3314
996590,True,0,No user reviews,0,0,0
996600,True,0,No user reviews,0,0,0
996620,True,0,2 user reviews,2,0,2
996630,True,0,1 user reviews,1,0,1
996640,True,0,No user reviews,0,0,0
996650,True,0,2 user reviews,2,0,2
996670,True,0,No user reviews,0,0,0
996680,True,0,No user reviews,0,0,0
996710,True,0,No user reviews,0,0,0
996720,True,7,Positive,12,0,12
996721,True,0,2 user reviews,2,0,2
996730,True,0,1 user reviews,0,1,1
996740,True,0,No user reviews,0,0,0
996741,True,0,5 user reviews,5,0,5
996742,True,0,3 user reviews,3,0,3
996760,True,0,No user reviews,0,0,0
996770,True,8,Very Positive,152,32,184
996820,True,0,No user reviews,0,0,0
996830,True,3,Negative,0,24,24
996850,True,0,No user reviews,0,0,0
996860,True,0,6 user reviews,5,1,6
996890,True,0,No user reviews,0,0,0
996900,True,0,No user reviews,0,0,0
996910,True,0,4 user reviews,3,1,4
996920,True,0,6 user reviews,6,0,6
996970,True,0,No user reviews,0,0,0
996980,True,7,Positive,11,1,12
996990,True,0,7 user reviews,4,3,7
997000,True,0,3 user reviews,1,2,3
997020,True,0,1 user reviews,0,1,1
997030,True,0,5 user reviews,5,0,5
997040,True,0,No user reviews,0,0,0
997041,True,0,2 user reviews,2,0,2
997042,True,0,No user reviews,0,0,0
997050,True,5,Mixed,5,5,10
997060,True,0,1 user reviews,1,0,1
997070,True,5,Mixed,3974,1945,5919
997100,True,0,No user reviews,0,0,0
997120,True,6,Mostly Positive,8,3,11
997150,True,0,No user reviews,0,0,0
997160,True,0,No user reviews,0,0,0
997163,True,0,No user reviews,0,0,0
997170,True,0,5 user reviews,5,0,5
997180,True,0,No user reviews,0,0,0
997210,True,0,No user reviews,0,0,0
997240,True,0,5 user reviews,3,2,5
997250,True,0,No user reviews,0,0,0
997251,True,0,No user reviews,0,0,0
997252,True,0,No user reviews,0,0,0
997253,True,0,No user reviews,0,0,0
997254,True,0,No user reviews,0,0,0
997260,True,0,8 user reviews,8,0,8
997270,True,0,No user reviews,0,0,0
997280,True,0,3 user reviews,3,0,3
997290,True,0,No user reviews,0,0,0
997310,True,0,1 user reviews,1,0,1
997330,True,7,Positive,26,0,26
997340,True,0,1 user reviews,0,1,1
997360,True,0,6 user reviews,6,0,6
997370,True,0,7 user reviews,6,1,7
997380,True,7,Positive,16,2,18
997390,True,0,No user reviews,0,0,0
997430,True,0,4 user reviews,4,0,4
997460,True,0,No user reviews,0,0,0
997470,True,0,1 user reviews,1,0,1
997480,True,0,4 user reviews,4,0,4
997500,True,0,No user reviews,0,0,0
997520,True,0,No user reviews,0,0,0
997530,True,0,No user reviews,0,0,0
997540,True,0,No user reviews,0,0,0
997560,True,0,2 user reviews,2,0,2
997620,True,0,No user reviews,0,0,0
997640,True,0,No user reviews,0,0,0
997650,True,0,No user reviews,0,0,0
997670,True,0,1 user reviews,1,0,1
997700,True,7,Positive,8,2,10
997710,True,5,Mixed,6,5,11
997720,True,7,Positive,9,1,10
997730,True,0,2 user reviews,2,0,2
997740,True,0,No user reviews,0,0,0
997750,True,0,1 user reviews,1,0,1
997760,True,0,No user reviews,0,0,0
997770,True,0,No user reviews,0,0,0
997820,True,0,No user reviews,0,0,0
997830,True,0,No user reviews,0,0,0
997840,True,0,No user reviews,0,0,0
997870,True,0,3 user reviews,0,3,3
997900,True,0,No user reviews,0,0,0
997910,True,0,No user reviews,0,0,0
997920,True,0,No user reviews,0,0,0
997950,True,0,6 user reviews,4,2,6
998000,True,0,No user reviews,0,0,0
998010,True,0,9 user reviews,2,7,9
998020,True,0,9 user reviews,4,5,9
998030,True,0,No user reviews,0,0,0
998040,True,0,No user reviews,0,0,0
998041,True,0,No user reviews,0,0,0
998050,True,0,No user reviews,0,0,0
998051,True,0,No user reviews,0,0,0
998060,True,0,No user reviews,0,0,0
998061,True,0,No user reviews,0,0,0
998062,True,0,No user reviews,0,0,0
998063,True,0,No user reviews,0,0,0
998064,True,0,No user reviews,0,0,0
998065,True,0,No user reviews,0,0,0
998066,True,0,No user reviews,0,0,0
998067,True,0,No user reviews,0,0,0
998068,True,0,No user reviews,0,0,0
998069,True,0,No user reviews,0,0,0
998070,True,0,No user reviews,0,0,0
998071,True,0,No user reviews,0,0,0
998072,True,0,No user reviews,0,0,0
998073,True,0,No user reviews,0,0,0
998080,True,0,No user reviews,0,0,0
998081,True,0,No user reviews,0,0,0
998090,True,0,No user reviews,0,0,0
998091,True,0,No user reviews,0,0,0
998100,True,0,No user reviews,0,0,0
998101,True,0,No user reviews,0,0,0
998110,True,0,No user reviews,0,0,0
998111,True,0,No user reviews,0,0,0
998120,True,0,No user reviews,0,0,0
998121,True,0,No user reviews,0,0,0
998130,True,0,No user reviews,0,0,0
998140,True,0,No user reviews,0,0,0
998141,True,0,No user reviews,0,0,0
998142,True,0,No user reviews,0,0,0
998150,True,0,No user reviews,0,0,0
998160,True,0,No user reviews,0,0,0
998170,True,0,No user reviews,0,0,0
998180,True,0,No user reviews,0,0,0
998181,True,0,No user reviews,0,0,0
998190,True,0,No user reviews,0,0,0
998191,True,0,No user reviews,0,0,0
998200,True,0,No user reviews,0,0,0
998201,True,0,No user reviews,0,0,0
998202,True,0,No user reviews,0,0,0
998210,True,0,No user reviews,0,0,0
998211,True,0,No user reviews,0,0,0
998212,True,0,No user reviews,0,0,0
998213,True,0,No user reviews,0,0,0
998214,True,0,No user reviews,0,0,0
998220,True,7,Positive,12,1,13
998230,True,0,No user reviews,0,0,0
998231,True,0,No user reviews,0,0,0
998232,True,0,No user reviews,0,0,0
998233,True,0,No user reviews,0,0,0
998234,True,0,No user reviews,0,0,0
998240,True,0,No user reviews,0,0,0
998241,True,0,No user reviews,0,0,0
998242,True,0,No user reviews,0,0,0
998243,True,0,No user reviews,0,0,0
998244,True,0,No user reviews,0,0,0
998245,True,0,No user reviews,0,0,0
998246,True,0,No user reviews,0,0,0
998247,True,0,No user reviews,0,0,0
998248,True,0,No user reviews,0,0,0
998249,True,0,No user reviews,0,0,0
998250,True,0,No user reviews,0,0,0
998251,True,0,No user reviews,0,0,0
998252,True,0,No user reviews,0,0,0
998253,True,0,No user reviews,0,0,0
998254,True,0,No user reviews,0,0,0
998255,True,0,No user reviews,0,0,0
998256,True,0,No user reviews,0,0,0
998257,True,0,No user reviews,0,0,0
998258,True,0,No user reviews,0,0,0
998259,True,0,No user reviews,0,0,0
998260,True,0,No user reviews,0,0,0
998261,True,0,No user reviews,0,0,0
998270,True,0,1 user reviews,1,0,1
998280,True,0,No user reviews,0,0,0
998281,True,0,No user reviews,0,0,0
998282,True,0,No user reviews,0,0,0
998283,True,0,No user reviews,0,0,0
998284,True,0,No user reviews,0,0,0
998285,True,0,No user reviews,0,0,0
998286,True,0,No user reviews,0,0,0
998287,True,0,No user reviews,0,0,0
998288,True,0,No user reviews,0,0,0
998289,True,0,No user reviews,0,0,0
998290,True,0,No user reviews,0,0,0
998291,True,0,No user reviews,0,0,0
998292,True,0,No user reviews,0,0,0
998293,True,0,No user reviews,0,0,0
998294,True,0,No user reviews,0,0,0
998295,True,0,No user reviews,0,0,0
998296,True,0,No user reviews,0,0,0
998297,True,0,No user reviews,0,0,0
998298,True,0,No user reviews,0,0,0
998299,True,0,No user reviews,0,0,0
998300,True,0,No user reviews,0,0,0
998310,True,0,No user reviews,0,0,0
998311,True,0,No user reviews,0,0,0
998312,True,0,No user reviews,0,0,0
998320,True,0,No user reviews,0,0,0
998321,True,0,No user reviews,0,0,0
998330,True,5,Mixed,9,5,14
998340,True,0,No user reviews,0,0,0
998380,True,0,No user reviews,0,0,0
998390,True,0,No user reviews,0,0,0
998400,True,0,No user reviews,0,0,0
998470,True,5,Mixed,6,4,10
998480,True,0,2 user reviews,1,1,2
998490,True,7,Positive,21,0,21
998500,True,0,No user reviews,0,0,0
998530,True,0,1 user reviews,0,1,1
998540,True,0,No user reviews,0,0,0
998550,True,0,6 user reviews,5,1,6
998560,True,0,No user reviews,0,0,0
998570,True,6,Mostly Positive,13,5,18
998580,True,0,1 user reviews,1,0,1
998590,True,0,1 user reviews,1,0,1
998600,True,0,No user reviews,0,0,0
998620,True,0,No user reviews,0,0,0
998630,True,0,5 user reviews,5,0,5
998660,True,0,No user reviews,0,0,0
998680,True,0,1 user reviews,1,0,1
998690,True,0,No user reviews,0,0,0
998730,True,0,2 user reviews,2,0,2
998740,True,8,Very Positive,212,28,240
998760,True,0,No user reviews,0,0,0
998780,True,0,No user reviews,0,0,0
998790,True,0,6 user reviews,3,3,6
998800,True,0,No user reviews,0,0,0
998801,True,0,No user reviews,0,0,0
998802,True,0,No user reviews,0,0,0
998803,True,0,No user reviews,0,0,0
998804,True,0,No user reviews,0,0,0
998805,True,0,No user reviews,0,0,0
998806,True,0,No user reviews,0,0,0
998810,True,7,Positive,27,1,28
998820,True,0,No user reviews,0,0,0
998830,True,0,4 user reviews,3,1,4
998850,True,5,Mixed,11,5,16
998870,True,0,No user reviews,0,0,0
998890,True,0,1 user reviews,0,1,1
998900,True,0,No user reviews,0,0,0
998930,True,6,Mostly Positive,200,53,253
998940,True,8,Very Positive,182,22,204
998950,True,0,No user reviews,0,0,0
998960,True,0,4 user reviews,4,0,4
998961,True,0,1 user reviews,1,0,1
998970,True,0,5 user reviews,2,3,5
998990,True,6,Mostly Positive,8,3,11
999020,True,8,Very Positive,300,50,350
999030,True,0,1 user reviews,1,0,1
999040,True,0,2 user reviews,1,1,2
999050,True,0,2 user reviews,1,1,2
999070,True,0,No user reviews,0,0,0
999150,True,0,3 user reviews,1,2,3
999180,True,0,No user reviews,0,0,0
999190,True,0,3 user reviews,0,3,3
999200,True,0,No user reviews,0,0,0
999220,True,6,Mostly Positive,1159,406,1565
999250,True,0,2 user reviews,2,0,2
999260,True,6,Mostly Positive,34,12,46
999270,True,0,No user reviews,0,0,0
999280,True,0,No user reviews,0,0,0
999290,True,0,4 user reviews,3,1,4
999300,True,0,2 user reviews,1,1,2
999301,True,0,No user reviews,0,0,0
999302,True,0,2 user reviews,1,1,2
999310,True,0,2 user reviews,2,0,2
999330,True,0,No user reviews,0,0,0
999340,True,0,No user reviews,0,0,0
999350,True,0,6 user reviews,6,0,6
999360,True,0,No user reviews,0,0,0
999370,True,0,No user reviews,0,0,0
999380,True,0,No user reviews,0,0,0
999410,True,7,Positive,31,1,32
999420,True,0,No user reviews,0,0,0
999421,True,0,No user reviews,0,0,0
999430,True,0,2 user reviews,2,0,2
999440,True,0,No user reviews,0,0,0
999450,True,0,No user reviews,0,0,0
999470,True,0,No user reviews,0,0,0
999480,True,0,3 user reviews,0,3,3
999490,True,0,3 user reviews,3,0,3
999520,True,0,No user reviews,0,0,0
999530,True,0,No user reviews,0,0,0
999550,True,7,Positive,10,1,11
999560,True,0,No user reviews,0,0,0
999570,True,0,No user reviews,0,0,0
999580,True,0,No user reviews,0,0,0
999640,True,5,Mixed,17,13,30
999660,True,5,Mixed,6,4,10
999670,True,0,No user reviews,0,0,0
999680,True,0,No user reviews,0,0,0
999700,True,0,No user reviews,0,0,0
999720,True,0,2 user reviews,2,0,2
999730,True,0,No user reviews,0,0,0
999750,True,0,No user reviews,0,0,0
999760,True,0,No user reviews,0,0,0
999780,True,0,No user reviews,0,0,0
999790,True,0,No user reviews,0,0,0
999820,True,0,No user reviews,0,0,0
999830,True,0,No user reviews,0,0,0
999840,True,0,4 user reviews,4,0,4
999860,True,6,Mostly Positive,46,12,58
999870,True,0,No user reviews,0,0,0
999880,True,0,No user reviews,0,0,0
999890,True,0,No user reviews,0,0,0
999900,True,0,No user reviews,0,0,0
999910,True,0,No user reviews,0,0,0
999930,True,0,No user reviews,0,0,0
999940,True,0,No user reviews,0,0,0
999950,True,0,No user reviews,0,0,0
999960,True,0,No user reviews,0,0,0
999970,True,0,No user reviews,0,0,0
999980,True,0,No user reviews,0,0,0
999990,True,0,1 user reviews,1,0,1
1000000,True,0,No user reviews,0,0,0
1000010,True,8,Very Positive,159,22,181
1000030,True,9,Overwhelmingly Positive,616,16,632
1000040,True,0,No user reviews,0,0,0
1000060,True,0,No user reviews,0,0,0
1000080,True,8,Very Positive,79,18,97
1000100,True,0,No user reviews,0,0,0
1000110,True,0,No user reviews,0,0,0
1000120,True,0,1 user reviews,0,1,1
1000130,True,0,5 user reviews,5,0,5
1000140,True,0,3 user reviews,1,2,3
1000150,True,0,1 user reviews,0,1,1
1000160,True,0,1 user reviews,1,0,1
1000170,True,0,1 user reviews,0,1,1
1000180,True,0,1 user reviews,0,1,1
1000190,True,0,No user reviews,0,0,0
1000200,True,0,2 user reviews,2,0,2
1000210,True,0,1 user reviews,1,0,1
1000220,True,0,No user reviews,0,0,0
1000230,True,0,No user reviews,0,0,0
1000240,True,0,No user reviews,0,0,0
1000250,True,0,No user reviews,0,0,0
1000290,True,0,No user reviews,0,0,0
1000310,True,0,2 user reviews,0,2,2
1000360,True,0,No user reviews,0,0,0
1000370,True,0,1 user reviews,0,1,1
1000380,True,0,No user reviews,0,0,0
1000400,True,0,9 user reviews,9,0,9
1000410,True,8,Very Positive,534,54,588
1000420,True,0,No user reviews,0,0,0
1000460,True,0,No user reviews,0,0,0
1000470,True,6,Mostly Positive,23,7,30
1000480,True,5,Mixed,7,4,11
1000490,True,0,No user reviews,0,0,0
1000510,True,5,Mixed,12,7,19
1000540,True,0,No user reviews,0,0,0
1000550,True,0,6 user reviews,4,2,6
1000560,True,0,No user reviews,0,0,0
1000570,True,0,No user reviews,0,0,0
1000600,True,0,No user reviews,0,0,0
1000620,True,0,No user reviews,0,0,0
1000621,True,0,No user reviews,0,0,0
1000630,True,0,No user reviews,0,0,0
1000640,True,7,Positive,47,2,49
1000650,True,0,No user reviews,0,0,0
1000680,True,0,No user reviews,0,0,0
1000690,True,0,No user reviews,0,0,0
1000700,True,0,No user reviews,0,0,0
1000710,True,0,2 user reviews,2,0,2
1000711,True,0,3 user reviews,3,0,3
1000712,True,0,1 user reviews,1,0,1
1000713,True,0,2 user reviews,2,0,2
1000714,True,0,1 user reviews,0,1,1
1000715,True,0,1 user reviews,1,0,1
1000716,True,0,No user reviews,0,0,0
1000717,True,0,3 user reviews,3,0,3
1000718,True,0,3 user reviews,3,0,3
1000719,True,0,No user reviews,0,0,0
1000730,True,0,No user reviews,0,0,0
1000750,True,0,No user reviews,0,0,0
1000760,True,0,No user reviews,0,0,0
1000770,True,0,9 user reviews,8,1,9
1000780,True,0,1 user reviews,1,0,1
1000781,True,0,1 user reviews,1,0,1
1000782,True,0,5 user reviews,5,0,5
1000783,True,0,1 user reviews,1,0,1
1000790,True,0,1 user reviews,0,1,1
1000800,True,0,No user reviews,0,0,0
1000810,True,0,No user reviews,0,0,0
1000830,True,8,Very Positive,55,2,57
1000840,True,0,No user reviews,0,0,0
1000860,True,0,4 user reviews,3,1,4
1000870,True,0,1 user reviews,0,1,1
1000880,True,0,No user reviews,0,0,0
1000890,True,0,No user reviews,0,0,0
1000900,True,0,No user reviews,0,0,0
1000910,True,0,No user reviews,0,0,0
1000920,True,0,No user reviews,0,0,0
1000940,True,0,No user reviews,0,0,0
1000970,True,0,No user reviews,0,0,0
1000980,True,0,No user reviews,0,0,0
1000990,True,0,9 user reviews,7,2,9
1001010,True,0,1 user reviews,1,0,1
1001040,True,5,Mixed,36,20,56
1001050,True,0,1 user reviews,0,1,1
1001060,True,5,Mixed,21,18,39
1001070,True,7,Positive,25,4,29
1001090,True,0,No user reviews,0,0,0
1001100,True,0,1 user reviews,1,0,1
1001110,True,0,1 user reviews,1,0,1
1001120,True,0,No user reviews,0,0,0
1001140,True,8,Very Positive,93,15,108
1001150,True,7,Positive,15,3,18
1001160,True,0,No user reviews,0,0,0
1001170,True,0,5 user reviews,0,5,5
1001180,True,0,No user reviews,0,0,0
1001200,True,0,8 user reviews,7,1,8
1001210,True,0,No user reviews,0,0,0
1001220,True,8,Very Positive,84,21,105
1001230,True,0,5 user reviews,5,0,5
1001240,True,5,Mixed,7,10,17
1001260,True,0,No user reviews,0,0,0
1001270,True,0,No user reviews,0,0,0
1001280,True,0,2 user reviews,2,0,2
1001290,True,0,No user reviews,0,0,0
1001291,True,0,1 user reviews,0,1,1
1001320,True,0,No user reviews,0,0,0
1001321,True,0,1 user reviews,1,0,1
1001370,True,0,4 user reviews,4,0,4
1001371,True,0,7 user reviews,7,0,7
1001380,True,0,5 user reviews,3,2,5
1001390,True,0,3 user reviews,0,3,3
1001410,True,0,No user reviews,0,0,0
1001420,True,0,No user reviews,0,0,0
1001430,True,0,5 user reviews,5,0,5
1001440,True,0,No user reviews,0,0,0
1001450,True,0,No user reviews,0,0,0
1001470,True,0,No user reviews,0,0,0
1001490,True,5,Mixed,7,5,12
1001500,True,0,7 user reviews,5,2,7
1001510,True,0,No user reviews,0,0,0
1001520,True,0,No user reviews,0,0,0
1001530,True,0,No user reviews,0,0,0
1001550,True,0,No user reviews,0,0,0
1001570,True,0,2 user reviews,2,0,2
1001580,True,0,No user reviews,0,0,0
1001590,True,0,2 user reviews,2,0,2
1001600,True,0,6 user reviews,5,1,6
1001610,True,0,No user reviews,0,0,0
1001620,True,0,3 user reviews,3,0,3
1001630,True,0,No user reviews,0,0,0
1001640,True,4,Mostly Negative,3,9,12
1001660,True,0,2 user reviews,2,0,2
1001690,True,0,3 user reviews,1,2,3
1001720,True,0,No user reviews,0,0,0
1001730,True,0,No user reviews,0,0,0
1001740,True,0,4 user reviews,4,0,4
1001760,True,0,1 user reviews,0,1,1
1001780,True,0,No user reviews,0,0,0
1001783,True,0,No user reviews,0,0,0
1001784,True,0,No user reviews,0,0,0
1001800,True,8,Very Positive,58,13,71
1001810,True,0,1 user reviews,0,1,1
1001850,True,0,No user reviews,0,0,0
1001860,True,0,No user reviews,0,0,0
1001870,True,0,No user reviews,0,0,0
1001880,True,0,8 user reviews,7,1,8
1001910,True,0,6 user reviews,5,1,6
1001920,True,0,No user reviews,0,0,0
1001930,True,0,No user reviews,0,0,0
1001950,True,0,4 user reviews,3,1,4
1001960,True,0,1 user reviews,0,1,1
1001970,True,0,1 user reviews,0,1,1
1001980,True,5,Mixed,25,11,36
1001990,True,0,3 user reviews,1,2,3
1002000,True,0,3 user reviews,3,0,3
1002010,True,0,No user reviews,0,0,0
1002020,True,5,Mixed,7,5,12
1002030,True,6,Mostly Positive,15,6,21
1002040,True,0,No user reviews,0,0,0
1002060,True,0,2 user reviews,2,0,2
1002090,True,0,No user reviews,0,0,0
1002100,True,0,3 user reviews,3,0,3
1002130,True,7,Positive,12,3,15
1002150,True,0,No user reviews,0,0,0
1002170,True,0,No user reviews,0,0,0
1002180,True,0,3 user reviews,1,2,3
1002200,True,0,2 user reviews,2,0,2
1002210,True,0,1 user reviews,1,0,1
1002230,True,0,2 user reviews,1,1,2
1002250,True,0,No user reviews,0,0,0
1002270,True,7,Positive,12,2,14
1002280,True,0,4 user reviews,2,2,4
1002290,True,0,No user reviews,0,0,0
1002300,True,8,Very Positive,143,17,160
1002310,True,0,1 user reviews,1,0,1
1002360,True,0,No user reviews,0,0,0
1002400,True,0,No user reviews,0,0,0
1002410,True,0,4 user reviews,3,1,4
1002420,True,0,3 user reviews,2,1,3
1002430,True,8,Very Positive,102,6,108
1002440,True,0,4 user reviews,2,2,4
1002450,True,0,No user reviews,0,0,0
1002480,True,0,No user reviews,0,0,0
1002490,True,5,Mixed,4,6,10
1002500,True,0,1 user reviews,1,0,1
1002510,True,7,Positive,12,0,12
1002520,True,0,4 user reviews,4,0,4
1002540,True,0,7 user reviews,4,3,7
1002560,True,8,Very Positive,94,3,97
1002570,True,0,No user reviews,0,0,0
1002571,True,0,No user reviews,0,0,0
1002580,True,0,1 user reviews,1,0,1
1002600,True,0,No user reviews,0,0,0
1002610,True,6,Mostly Positive,14,4,18
1002620,True,0,2 user reviews,2,0,2
1002630,True,7,Positive,8,2,10
1002650,True,0,3 user reviews,1,2,3
1002670,True,0,4 user reviews,3,1,4
1002690,True,0,No user reviews,0,0,0
1002710,True,0,No user reviews,0,0,0
1002740,True,0,No user reviews,0,0,0
1002750,True,0,3 user reviews,0,3,3
1002760,True,0,No user reviews,0,0,0
1002790,True,0,No user reviews,0,0,0
1002800,True,0,3 user reviews,2,1,3
1002810,True,0,1 user reviews,1,0,1
1002820,True,0,No user reviews,0,0,0
1002830,True,5,Mixed,8,4,12
1002850,True,0,No user reviews,0,0,0
1002860,True,0,No user reviews,0,0,0
1002870,True,0,No user reviews,0,0,0
1002871,True,0,No user reviews,0,0,0
1002872,True,0,No user reviews,0,0,0
1002873,True,0,No user reviews,0,0,0
1002890,True,0,No user reviews,0,0,0
1002900,True,0,No user reviews,0,0,0
1002910,True,0,2 user reviews,2,0,2
1002920,True,0,No user reviews,0,0,0
1002930,True,0,No user reviews,0,0,0
1002940,True,0,1 user reviews,1,0,1
1002950,True,0,No user reviews,0,0,0
1002960,True,6,Mostly Positive,13,4,17
1002970,True,7,Positive,13,2,15
1002980,True,0,No user reviews,0,0,0
1003000,True,0,2 user reviews,1,1,2
1003010,True,0,No user reviews,0,0,0
1003020,True,7,Positive,17,1,18
1003030,True,0,No user reviews,0,0,0
1003070,True,0,7 user reviews,5,2,7
1003090,True,8,Very Positive,105,14,119
1003110,True,0,No user reviews,0,0,0
1003120,True,0,No user reviews,0,0,0
1003150,True,0,1 user reviews,0,1,1
1003160,True,0,No user reviews,0,0,0
1003170,True,0,1 user reviews,0,1,1
1003190,True,0,3 user reviews,3,0,3
1003200,True,0,6 user reviews,4,2,6
1003220,True,0,No user reviews,0,0,0
1003230,True,0,2 user reviews,2,0,2
1003250,True,0,No user reviews,0,0,0
1003260,True,0,No user reviews,0,0,0
1003280,True,0,No user reviews,0,0,0
1003310,True,5,Mixed,16,7,23
1003320,True,7,Positive,15,2,17
1003360,True,6,Mostly Positive,72,21,93
1003370,True,0,8 user reviews,7,1,8
1003390,True,0,No user reviews,0,0,0
1003400,True,0,2 user reviews,2,0,2
1003410,True,0,No user reviews,0,0,0
1003430,True,0,No user reviews,0,0,0
1003450,True,0,3 user reviews,2,1,3
1003460,True,0,No user reviews,0,0,0
1003480,True,6,Mostly Positive,11,4,15
1003490,True,7,Positive,17,2,19
1003500,True,0,No user reviews,0,0,0
1003520,True,8,Very Positive,805,119,924
1003530,True,0,No user reviews,0,0,0
1003540,True,0,No user reviews,0,0,0
1003550,True,0,No user reviews,0,0,0
1003560,True,0,8 user reviews,7,1,8
1003570,True,0,2 user reviews,2,0,2
1003600,True,7,Positive,12,1,13
1003650,True,0,1 user reviews,0,1,1
1003670,True,0,3 user reviews,1,2,3
1003680,True,0,No user reviews,0,0,0
1003681,True,0,No user reviews,0,0,0
1003682,True,0,No user reviews,0,0,0
1003690,True,0,1 user reviews,1,0,1
1003700,True,0,No user reviews,0,0,0
1003720,True,0,No user reviews,0,0,0
1003730,True,7,Positive,30,1,31
1003740,True,0,No user reviews,0,0,0
1003750,True,0,2 user reviews,2,0,2
1003760,True,0,1 user reviews,1,0,1
1003780,True,0,7 user reviews,7,0,7
1003790,True,0,No user reviews,0,0,0
1003800,True,7,Positive,10,2,12
1003830,True,0,1 user reviews,0,1,1
1003840,True,0,No user reviews,0,0,0
1003850,True,0,1 user reviews,1,0,1
1003860,True,7,Positive,10,0,10
1003870,True,0,No user reviews,0,0,0
1003880,True,6,Mostly Positive,7,3,10
1003890,True,8,Very Positive,427,93,520
1003900,True,0,No user reviews,0,0,0
1003920,True,0,No user reviews,0,0,0
1003930,True,0,No user reviews,0,0,0
1003940,True,0,No user reviews,0,0,0
1003950,True,0,No user reviews,0,0,0
1003960,True,0,No user reviews,0,0,0
1003980,True,0,No user reviews,0,0,0
1003990,True,0,No user reviews,0,0,0
1004000,True,5,Mixed,9,8,17
1004030,True,0,4 user reviews,3,1,4
1004040,True,0,4 user reviews,3,1,4
1004050,True,0,4 user reviews,0,4,4
1004060,True,0,No user reviews,0,0,0
1004090,True,0,No user reviews,0,0,0
1004100,True,0,2 user reviews,1,1,2
1004120,True,0,No user reviews,0,0,0
1004130,True,0,No user reviews,0,0,0
1004150,True,0,3 user reviews,3,0,3
1004160,True,0,No user reviews,0,0,0
1004170,True,0,No user reviews,0,0,0
1004180,True,0,1 user reviews,0,1,1
1004190,True,0,No user reviews,0,0,0
1004200,True,0,2 user reviews,2,0,2
1004210,True,7,Positive,30,2,32
1004220,True,0,4 user reviews,4,0,4
1004230,True,0,1 user reviews,1,0,1
1004240,True,9,Overwhelmingly Positive,499,23,522
1004260,True,0,9 user reviews,9,0,9
1004270,True,6,Mostly Positive,182,73,255
1004280,True,0,No user reviews,0,0,0
1004290,True,0,No user reviews,0,0,0
1004300,True,0,No user reviews,0,0,0
1004301,True,0,No user reviews,0,0,0
1004310,True,0,3 user reviews,3,0,3
1004320,True,0,3 user reviews,1,2,3
1004330,True,8,Very Positive,57,3,60
1004340,True,0,1 user reviews,1,0,1
1004350,True,0,No user reviews,0,0,0
1004370,True,0,No user reviews,0,0,0
1004390,True,0,No user reviews,0,0,0
1004410,True,0,No user reviews,0,0,0
1004440,True,0,No user reviews,0,0,0
1004450,True,0,No user reviews,0,0,0
1004470,True,0,No user reviews,0,0,0
1004480,True,0,No user reviews,0,0,0
1004490,True,6,Mostly Positive,73,22,95
1004500,True,0,3 user reviews,3,0,3
1004510,True,7,Positive,18,1,19
1004530,True,0,No user reviews,0,0,0
1004540,True,0,No user reviews,0,0,0
1004550,True,0,2 user reviews,0,2,2
1004560,True,5,Mixed,26,16,42
1004570,True,0,No user reviews,0,0,0
1004590,True,0,1 user reviews,0,1,1
1004600,True,0,1 user reviews,1,0,1
1004610,True,8,Very Positive,83,6,89
1004650,True,0,6 user reviews,4,2,6
1004680,True,0,No user reviews,0,0,0
1004710,True,0,No user reviews,0,0,0
1004720,True,0,No user reviews,0,0,0
1004740,True,7,Positive,36,5,41
1004750,True,5,Mixed,23,12,35
1004770,True,8,Very Positive,208,1,209
1004780,True,0,2 user reviews,1,1,2
1004790,True,0,No user reviews,0,0,0
1004800,True,0,No user reviews,0,0,0
1004820,True,0,No user reviews,0,0,0
1004860,True,7,Positive,26,4,30
1004890,True,6,Mostly Positive,13,4,17
1004891,True,7,Positive,15,0,15
1004892,True,0,7 user reviews,6,1,7
1004893,True,0,4 user reviews,3,1,4
1004894,True,0,9 user reviews,6,3,9
1004900,True,0,3 user reviews,2,1,3
1004910,True,0,No user reviews,0,0,0
1004911,True,0,1 user reviews,1,0,1
1004912,True,0,1 user reviews,0,1,1
1004913,True,0,No user reviews,0,0,0
1004914,True,0,No user reviews,0,0,0
1004915,True,0,1 user reviews,1,0,1
1004916,True,0,No user reviews,0,0,0
1004917,True,0,1 user reviews,1,0,1
1004918,True,0,1 user reviews,1,0,1
1004919,True,0,7 user reviews,4,3,7
1004920,True,0,9 user reviews,7,2,9
1004921,True,0,7 user reviews,7,0,7
1004930,True,0,4 user reviews,4,0,4
1004940,True,7,Positive,9,1,10
1004950,True,7,Positive,10,0,10
1004960,True,0,4 user reviews,4,0,4
1004970,True,0,3 user reviews,1,2,3
1004980,True,0,4 user reviews,2,2,4
1004990,True,0,4 user reviews,2,2,4
1005000,True,0,3 user reviews,3,0,3
1005010,True,0,3 user reviews,2,1,3
1005020,True,0,2 user reviews,1,1,2
1005030,True,0,2 user reviews,1,1,2
1005040,True,0,No user reviews,0,0,0
1005050,True,0,7 user reviews,6,1,7
1005060,True,0,4 user reviews,4,0,4
1005080,True,0,No user reviews,0,0,0
1005090,True,0,No user reviews,0,0,0
1005100,True,0,No user reviews,0,0,0
1005130,True,6,Mostly Positive,10,4,14
1005150,True,0,No user reviews,0,0,0
1005160,True,0,No user reviews,0,0,0
1005180,True,0,No user reviews,0,0,0
1005250,True,0,No user reviews,0,0,0
1005270,True,0,No user reviews,0,0,0
1005280,True,0,No user reviews,0,0,0
1005300,True,9,Overwhelmingly Positive,990,44,1034
1005310,True,0,4 user reviews,4,0,4
1005320,True,0,No user reviews,0,0,0
1005330,True,0,No user reviews,0,0,0
1005340,True,0,No user reviews,0,0,0
1005350,True,0,No user reviews,0,0,0
1005390,True,0,No user reviews,0,0,0
1005400,True,0,No user reviews,0,0,0
1005410,True,8,Very Positive,55,2,57
1005420,True,0,3 user reviews,0,3,3
1005450,True,7,Positive,23,0,23
1005460,True,0,3 user reviews,2,1,3
1005470,True,0,No user reviews,0,0,0
1005480,True,0,No user reviews,0,0,0
1005520,True,0,2 user reviews,2,0,2
1005530,True,0,9 user reviews,2,7,9
1005541,True,0,1 user reviews,0,1,1
1005550,True,0,7 user reviews,5,2,7
1005560,True,0,No user reviews,0,0,0
1005580,True,4,Mostly Negative,14,25,39
1005630,True,0,9 user reviews,6,3,9
1005730,True,7,Positive,10,0,10
1005750,True,0,No user reviews,0,0,0
1005770,True,0,No user reviews,0,0,0
1005780,True,0,1 user reviews,0,1,1
1005790,True,5,Mixed,18,8,26
1005810,True,0,No user reviews,0,0,0
1005811,True,0,No user reviews,0,0,0
1005812,True,0,No user reviews,0,0,0
1005813,True,0,No user reviews,0,0,0
1005814,True,0,No user reviews,0,0,0
1005815,True,0,No user reviews,0,0,0
1005816,True,0,No user reviews,0,0,0
1005820,True,0,No user reviews,0,0,0
1005870,True,0,No user reviews,0,0,0
1005880,True,0,No user reviews,0,0,0
1005890,True,0,4 user reviews,4,0,4
1005900,True,0,6 user reviews,5,1,6
1005910,True,0,No user reviews,0,0,0
1005920,True,0,1 user reviews,1,0,1
1005930,True,8,Very Positive,47,7,54
1005940,True,0,No user reviews,0,0,0
1005950,True,0,2 user reviews,1,1,2
1005960,True,0,No user reviews,0,0,0
1005970,True,0,No user reviews,0,0,0
1005971,True,6,Mostly Positive,10,4,14
1005972,True,0,7 user reviews,5,2,7
1005990,True,0,8 user reviews,6,2,8
1006000,True,0,No user reviews,0,0,0
1006030,True,0,No user reviews,0,0,0
1006090,True,0,No user reviews,0,0,0
1006120,True,0,3 user reviews,3,0,3
1006130,True,0,No user reviews,0,0,0
1006140,True,0,7 user reviews,7,0,7
1006150,True,5,Mixed,8,5,13
1006160,True,0,5 user reviews,5,0,5
1006170,True,0,No user reviews,0,0,0
1006190,True,0,1 user reviews,1,0,1
1006210,True,0,No user reviews,0,0,0
1006220,True,8,Very Positive,50,0,50
1006230,True,0,No user reviews,0,0,0
1006250,True,7,Positive,19,1,20
1006270,True,7,Positive,12,1,13
1006280,True,0,1 user reviews,1,0,1
1006290,True,0,No user reviews,0,0,0
1006300,True,0,No user reviews,0,0,0
1006340,True,0,No user reviews,0,0,0
1006350,True,0,No user reviews,0,0,0
1006360,True,0,No user reviews,0,0,0
1006370,True,0,No user reviews,0,0,0
1006380,True,0,No user reviews,0,0,0
1006390,True,0,No user reviews,0,0,0
1006400,True,0,2 user reviews,2,0,2
1006410,True,0,No user reviews,0,0,0
1006430,True,0,3 user reviews,3,0,3
1006440,True,0,9 user reviews,7,2,9
1006450,True,0,4 user reviews,3,1,4
1006460,True,0,5 user reviews,5,0,5
1006470,True,0,1 user reviews,0,1,1
1006480,True,0,No user reviews,0,0,0
1006510,True,6,Mostly Positive,461,134,595
1006540,True,0,No user reviews,0,0,0
1006590,True,0,No user reviews,0,0,0
1006600,True,0,7 user reviews,5,2,7
1006620,True,0,No user reviews,0,0,0
1006650,True,0,No user reviews,0,0,0
1006680,True,0,No user reviews,0,0,0
1006700,True,5,Mixed,8,6,14
1006710,True,7,Positive,10,0,10
1006720,True,0,3 user reviews,3,0,3
1006730,True,0,No user reviews,0,0,0
1006760,True,0,3 user reviews,3,0,3
1006770,True,0,1 user reviews,0,1,1
1006800,True,0,1 user reviews,1,0,1
1006820,True,0,No user reviews,0,0,0
1006821,True,0,No user reviews,0,0,0
1006822,True,0,No user reviews,0,0,0
1006830,True,0,No user reviews,0,0,0
1006840,True,0,No user reviews,0,0,0
1006850,True,5,Mixed,6,4,10
1006870,True,0,No user reviews,0,0,0
1006880,True,0,No user reviews,0,0,0
1006890,True,0,No user reviews,0,0,0
1006900,True,0,5 user reviews,2,3,5
1006910,True,0,No user reviews,0,0,0
1006920,True,0,4 user reviews,3,1,4
1006930,True,6,Mostly Positive,21,6,27
1006950,True,0,No user reviews,0,0,0
1006960,True,0,No user reviews,0,0,0
1006961,True,0,No user reviews,0,0,0
1006962,True,0,No user reviews,0,0,0
1006963,True,0,No user reviews,0,0,0
1006964,True,0,No user reviews,0,0,0
1006970,True,0,No user reviews,0,0,0
1006971,True,0,1 user reviews,0,1,1
1006972,True,0,No user reviews,0,0,0
1006973,True,0,No user reviews,0,0,0
1006974,True,0,No user reviews,0,0,0
1006980,True,0,No user reviews,0,0,0
1006981,True,0,3 user reviews,3,0,3
1006982,True,0,1 user reviews,0,1,1
1006990,True,0,No user reviews,0,0,0
1007020,True,0,No user reviews,0,0,0
1007040,True,9,Overwhelmingly Positive,1962,86,2048
1007050,True,7,Positive,17,1,18
1007060,True,0,1 user reviews,1,0,1
1007070,True,0,3 user reviews,2,1,3
1007080,True,0,1 user reviews,0,1,1
1007110,True,0,No user reviews,0,0,0
1007111,True,0,No user reviews,0,0,0
1007112,True,0,No user reviews,0,0,0
1007113,True,0,No user reviews,0,0,0
1007140,True,0,5 user reviews,4,1,5
1007170,True,0,No user reviews,0,0,0
1007180,True,0,2 user reviews,2,0,2
1007190,True,0,No user reviews,0,0,0
1007200,True,0,2 user reviews,1,1,2
1007210,True,0,1 user reviews,1,0,1
1007230,True,0,1 user reviews,1,0,1
1007240,True,0,2 user reviews,0,2,2
1007250,True,0,3 user reviews,3,0,3
1007251,True,0,1 user reviews,1,0,1
1007260,True,0,No user reviews,0,0,0
1007280,True,0,4 user reviews,2,2,4
1007310,True,0,No user reviews,0,0,0
1007340,True,0,No user reviews,0,0,0
1007341,True,0,No user reviews,0,0,0
1007350,True,5,Mixed,21,10,31
1007360,True,0,No user reviews,0,0,0
1007380,True,0,No user reviews,0,0,0
1007390,True,0,4 user reviews,3,1,4
1007400,True,5,Mixed,29,37,66
1007410,True,0,No user reviews,0,0,0
1007420,True,0,No user reviews,0,0,0
1007421,True,0,No user reviews,0,0,0
1007430,True,0,4 user reviews,4,0,4
1007440,True,0,2 user reviews,1,1,2
1007470,True,0,No user reviews,0,0,0
1007490,True,0,3 user reviews,0,3,3
1007500,True,0,No user reviews,0,0,0
1007510,True,0,No user reviews,0,0,0
1007520,True,7,Positive,9,1,10
1007540,True,0,No user reviews,0,0,0
1007550,True,0,No user reviews,0,0,0
1007560,True,0,5 user reviews,2,3,5
1007570,True,0,No user reviews,0,0,0
1007580,True,7,Positive,11,0,11
1007590,True,0,No user reviews,0,0,0
1007600,True,0,No user reviews,0,0,0
1007620,True,0,No user reviews,0,0,0
1007630,True,8,Very Positive,48,2,50
1007640,True,0,No user reviews,0,0,0
1007660,True,0,No user reviews,0,0,0
1007670,True,0,No user reviews,0,0,0
1007730,True,0,7 user reviews,4,3,7
1007740,True,0,No user reviews,0,0,0
1007760,True,0,No user reviews,0,0,0
1007780,True,6,Mostly Positive,17,6,23
1007800,True,0,4 user reviews,4,0,4
1007810,True,0,7 user reviews,7,0,7
1007820,True,0,No user reviews,0,0,0
1007830,True,0,5 user reviews,4,1,5
1007840,True,6,Mostly Positive,30,8,38
1007870,True,0,No user reviews,0,0,0
1007880,True,0,2 user reviews,2,0,2
1007890,True,0,No user reviews,0,0,0
1007910,True,0,5 user reviews,4,1,5
1007920,True,0,No user reviews,0,0,0
1007930,True,0,1 user reviews,1,0,1
1007940,True,0,8 user reviews,6,2,8
1007950,True,0,No user reviews,0,0,0
1007970,True,0,5 user reviews,0,5,5
1007980,True,0,1 user reviews,1,0,1
1007990,True,0,3 user reviews,1,2,3
1008000,True,0,No user reviews,0,0,0
1008010,True,0,7 user reviews,7,0,7
1008020,True,8,Very Positive,248,32,280
1008040,True,0,No user reviews,0,0,0
1008060,True,0,2 user reviews,2,0,2
1008070,True,0,No user reviews,0,0,0
1008080,True,0,No user reviews,0,0,0
1008140,True,0,4 user reviews,2,2,4
1008160,True,0,1 user reviews,0,1,1
1008170,True,0,No user reviews,0,0,0
1008180,True,0,No user reviews,0,0,0
1008210,True,0,2 user reviews,2,0,2
1008230,True,0,No user reviews,0,0,0
1008240,True,0,No user reviews,0,0,0
1008250,True,0,1 user reviews,1,0,1
1008260,True,0,2 user reviews,1,1,2
1008280,True,0,3 user reviews,3,0,3
1008290,True,5,Mixed,7,5,12
1008300,True,0,1 user reviews,1,0,1
1008320,True,0,7 user reviews,4,3,7
1008350,True,0,No user reviews,0,0,0
1008360,True,0,No user reviews,0,0,0
1008370,True,0,1 user reviews,1,0,1
1008390,True,0,1 user reviews,0,1,1
1008400,True,0,No user reviews,0,0,0
1008410,True,0,4 user reviews,1,3,4
1008420,True,0,No user reviews,0,0,0
1008430,True,0,1 user reviews,1,0,1
1008450,True,0,1 user reviews,1,0,1
1008460,True,7,Positive,23,3,26
1008470,True,0,No user reviews,0,0,0
1008510,True,5,Mixed,32,17,49
1008520,True,6,Mostly Positive,18,6,24
1008540,True,0,No user reviews,0,0,0
1008580,True,0,No user reviews,0,0,0
1008590,True,0,No user reviews,0,0,0
1008600,True,0,No user reviews,0,0,0
1008610,True,0,2 user reviews,0,2,2
1008650,True,0,No user reviews,0,0,0
1008670,True,0,No user reviews,0,0,0
1008680,True,0,4 user reviews,4,0,4
1008690,True,0,No user reviews,0,0,0
1008700,True,0,7 user reviews,6,1,7
1008710,True,6,Mostly Positive,245,72,317
1008730,True,0,2 user reviews,2,0,2
1008740,True,0,7 user reviews,6,1,7
1008750,True,0,No user reviews,0,0,0
1008760,True,0,No user reviews,0,0,0
1008770,True,0,No user reviews,0,0,0
1008800,True,8,Very Positive,55,4,59
1008810,True,0,No user reviews,0,0,0
1008820,True,0,No user reviews,0,0,0
1008830,True,7,Positive,12,1,13
1008840,True,0,No user reviews,0,0,0
1008850,True,0,1 user reviews,0,1,1
1008870,True,0,9 user reviews,6,3,9
1008890,True,0,No user reviews,0,0,0
1008900,True,0,No user reviews,0,0,0
1008910,True,0,1 user reviews,1,0,1
1008920,True,6,Mostly Positive,43,14,57
1008950,True,0,No user reviews,0,0,0
1008970,True,0,1 user reviews,1,0,1
1008990,True,0,No user reviews,0,0,0
1009030,True,0,No user reviews,0,0,0
1009040,True,0,No user reviews,0,0,0
1009080,True,0,No user reviews,0,0,0
1009100,True,0,2 user reviews,1,1,2
1009130,True,0,No user reviews,0,0,0
1009140,True,0,1 user reviews,1,0,1
1009150,True,0,2 user reviews,0,2,2
1009180,True,0,9 user reviews,6,3,9
1009190,True,0,No user reviews,0,0,0
1009200,True,0,No user reviews,0,0,0
1009210,True,0,2 user reviews,2,0,2
1009220,True,0,No user reviews,0,0,0
1009230,True,0,1 user reviews,0,1,1
1009240,True,0,No user reviews,0,0,0
1009250,True,0,No user reviews,0,0,0
1009280,True,0,No user reviews,0,0,0
1009290,True,5,Mixed,757,352,1109
1009300,True,0,1 user reviews,1,0,1
1009310,True,0,No user reviews,0,0,0
1009320,True,0,No user reviews,0,0,0
1009321,True,0,No user reviews,0,0,0
1009322,True,0,No user reviews,0,0,0
1009330,True,0,3 user reviews,3,0,3
1009350,True,0,5 user reviews,4,1,5
1009370,True,0,1 user reviews,1,0,1
1009390,True,0,2 user reviews,2,0,2
1009400,True,0,1 user reviews,1,0,1
1009410,True,0,No user reviews,0,0,0
1009420,True,0,No user reviews,0,0,0
1009430,True,0,No user reviews,0,0,0
1009450,True,8,Very Positive,107,4,111
1009460,True,7,Positive,14,1,15
1009480,True,0,No user reviews,0,0,0
1009510,True,0,No user reviews,0,0,0
1009530,True,0,No user reviews,0,0,0
1009540,True,0,No user reviews,0,0,0
1009560,True,0,No user reviews,0,0,0
1009570,True,0,No user reviews,0,0,0
1009580,True,0,No user reviews,0,0,0
1009590,True,0,2 user reviews,2,0,2
1009620,True,0,No user reviews,0,0,0
1009640,True,0,No user reviews,0,0,0
1009670,True,0,No user reviews,0,0,0
1009680,True,0,No user reviews,0,0,0
1009690,True,0,No user reviews,0,0,0
1009700,True,7,Positive,15,1,16
1009710,True,0,No user reviews,0,0,0
1009711,True,0,No user reviews,0,0,0
1009740,True,0,No user reviews,0,0,0
1009750,True,8,Very Positive,73,1,74
1009760,True,0,No user reviews,0,0,0
1009770,True,0,No user reviews,0,0,0
1009780,True,0,2 user reviews,2,0,2
1009810,True,0,1 user reviews,1,0,1
1009820,True,8,Very Positive,140,34,174
1009821,True,8,Very Positive,241,50,291
1009830,True,0,No user reviews,0,0,0
1009840,True,0,No user reviews,0,0,0
1009850,True,0,No user reviews,0,0,0
1009870,True,0,No user reviews,0,0,0
1009890,True,0,No user reviews,0,0,0
1009900,True,0,1 user reviews,0,1,1
1009910,True,0,No user reviews,0,0,0
1009920,True,0,7 user reviews,6,1,7
1009940,True,0,3 user reviews,1,2,3
1009950,True,0,No user reviews,0,0,0
1009960,True,0,6 user reviews,6,0,6
1009970,True,0,No user reviews,0,0,0
1009980,True,0,No user reviews,0,0,0
1009990,True,0,No user reviews,0,0,0
1010000,True,0,1 user reviews,1,0,1
1010070,True,0,1 user reviews,1,0,1
1010080,True,0,No user reviews,0,0,0
1010100,True,8,Very Positive,59,2,61
1010110,True,0,2 user reviews,2,0,2
1010120,True,0,1 user reviews,0,1,1
1010130,True,7,Positive,18,4,22
1010131,True,7,Positive,15,3,18
1010132,True,0,9 user reviews,9,0,9
1010133,True,5,Mixed,7,4,11
1010134,True,7,Positive,24,4,28
1010135,True,5,Mixed,18,17,35
1010136,True,7,Positive,37,8,45
1010137,True,5,Mixed,14,7,21
1010138,True,6,Mostly Positive,9,3,12
1010139,True,7,Positive,39,6,45
1010150,True,0,2 user reviews,2,0,2
1010170,True,5,Mixed,29,14,43
1010190,True,0,1 user reviews,1,0,1
1010210,True,0,5 user reviews,5,0,5
1010220,True,7,Positive,26,2,28
1010230,True,7,Positive,18,1,19
1010240,True,8,Very Positive,69,2,71
1010260,True,0,8 user reviews,3,5,8
1010270,True,5,Mixed,80,45,125
1010290,True,0,2 user reviews,2,0,2
1010300,True,0,No user reviews,0,0,0
1010320,True,0,No user reviews,0,0,0
1010330,True,0,1 user reviews,1,0,1
1010340,True,0,No user reviews,0,0,0
1010350,True,0,1 user reviews,1,0,1
1010380,True,0,3 user reviews,1,2,3
1010410,True,0,5 user reviews,3,2,5
1010420,True,0,1 user reviews,1,0,1
1010430,True,0,No user reviews,0,0,0
1010440,True,0,No user reviews,0,0,0
1010450,True,5,Mixed,13,9,22
1010460,True,0,5 user reviews,0,5,5
1010480,True,0,No user reviews,0,0,0
1010490,True,0,5 user reviews,3,2,5
1010510,True,0,No user reviews,0,0,0
1010520,True,0,1 user reviews,0,1,1
1010530,True,0,No user reviews,0,0,0
1010531,True,0,No user reviews,0,0,0
1010532,True,0,No user reviews,0,0,0
1010540,True,0,5 user reviews,4,1,5
1010560,True,0,No user reviews,0,0,0
1010590,True,0,2 user reviews,0,2,2
1010600,True,6,Mostly Positive,34,9,43
1010630,True,0,No user reviews,0,0,0
1010650,True,0,6 user reviews,5,1,6
1010660,True,6,Mostly Positive,12,5,17
1010670,True,8,Very Positive,108,9,117
1010680,True,0,No user reviews,0,0,0
1010710,True,0,No user reviews,0,0,0
1010720,True,0,No user reviews,0,0,0
1010730,True,0,No user reviews,0,0,0
1010740,True,0,1 user reviews,0,1,1
1010750,True,8,Very Positive,1865,113,1978
1010780,True,7,Positive,21,0,21
1010800,True,0,No user reviews,0,0,0
1010820,True,7,Positive,46,0,46
1010821,True,7,Positive,19,0,19
1010830,True,7,Positive,18,1,19
1010840,True,0,5 user reviews,4,1,5
1010850,True,0,No user reviews,0,0,0
1010860,True,5,Mixed,39,30,69
1010870,True,0,2 user reviews,2,0,2
1010890,True,0,No user reviews,0,0,0
1010910,True,0,No user reviews,0,0,0
1010920,True,0,1 user reviews,1,0,1
1010930,True,0,3 user reviews,2,1,3
1010940,True,0,No user reviews,0,0,0
1010950,True,0,2 user reviews,2,0,2
1010970,True,7,Positive,29,3,32
1010990,True,0,No user reviews,0,0,0
1011000,True,0,No user reviews,0,0,0
1011010,True,0,No user reviews,0,0,0
1011020,True,0,No user reviews,0,0,0
1011030,True,5,Mixed,14,7,21
1011040,True,0,No user reviews,0,0,0
1011060,True,0,No user reviews,0,0,0
1011070,True,6,Mostly Positive,24,7,31
1011090,True,7,Positive,21,5,26
1011100,True,0,No user reviews,0,0,0
1011110,True,0,No user reviews,0,0,0
1011120,True,0,2 user reviews,2,0,2
1011130,True,8,Very Positive,44,8,52
1011140,True,0,2 user reviews,0,2,2
1011170,True,0,No user reviews,0,0,0
1011171,True,0,1 user reviews,1,0,1
1011172,True,0,1 user reviews,1,0,1
1011173,True,0,1 user reviews,0,1,1
1011174,True,0,3 user reviews,0,3,3
1011175,True,0,No user reviews,0,0,0
1011176,True,0,No user reviews,0,0,0
1011177,True,0,No user reviews,0,0,0
1011178,True,0,No user reviews,0,0,0
1011179,True,0,No user reviews,0,0,0
1011180,True,0,No user reviews,0,0,0
1011190,True,8,Very Positive,156,32,188
1011200,True,0,No user reviews,0,0,0
1011210,True,0,No user reviews,0,0,0
1011211,True,0,No user reviews,0,0,0
1011212,True,0,No user reviews,0,0,0
1011213,True,0,No user reviews,0,0,0
1011214,True,0,No user reviews,0,0,0
1011215,True,0,No user reviews,0,0,0
1011216,True,0,No user reviews,0,0,0
1011217,True,0,No user reviews,0,0,0
1011218,True,0,No user reviews,0,0,0
1011240,True,0,3 user reviews,3,0,3
1011260,True,0,2 user reviews,2,0,2
1011270,True,5,Mixed,19,11,30
1011280,True,0,8 user reviews,8,0,8
1011290,True,8,Very Positive,50,6,56
1011300,True,0,3 user reviews,3,0,3
1011310,True,0,No user reviews,0,0,0
1011320,True,0,No user reviews,0,0,0
1011350,True,0,No user reviews,0,0,0
1011360,True,0,No user reviews,0,0,0
1011370,True,0,1 user reviews,0,1,1
1011390,True,8,Very Positive,291,56,347
1011400,True,0,6 user reviews,5,1,6
1011420,True,5,Mixed,13,8,21
1011440,True,0,No user reviews,0,0,0
1011460,True,0,1 user reviews,1,0,1
1011470,True,0,8 user reviews,7,1,8
1011510,True,0,No user reviews,0,0,0
1011520,True,0,No user reviews,0,0,0
1011521,True,0,No user reviews,0,0,0
1011522,True,0,No user reviews,0,0,0
1011523,True,0,No user reviews,0,0,0
1011524,True,0,1 user reviews,1,0,1
1011530,True,0,No user reviews,0,0,0
1011540,True,0,No user reviews,0,0,0
1011550,True,5,Mixed,7,4,11
1011590,True,0,No user reviews,0,0,0
1011600,True,0,No user reviews,0,0,0
1011610,True,8,Very Positive,169,21,190
1011620,True,0,4 user reviews,4,0,4
1011630,True,6,Mostly Positive,11,4,15
1011640,True,0,No user reviews,0,0,0
1011650,True,0,No user reviews,0,0,0
1011670,True,0,No user reviews,0,0,0
1011690,True,0,No user reviews,0,0,0
1011700,True,7,Positive,27,2,29
1011720,True,0,No user reviews,0,0,0
1011730,True,0,No user reviews,0,0,0
1011740,True,0,1 user reviews,0,1,1
1011760,True,0,1 user reviews,0,1,1
1011770,True,0,No user reviews,0,0,0
1011780,True,0,No user reviews,0,0,0
1011800,True,0,No user reviews,0,0,0
1011810,True,0,No user reviews,0,0,0
1011820,True,0,No user reviews,0,0,0
1011830,True,7,Positive,39,5,44
1011850,True,0,No user reviews,0,0,0
1011860,True,0,No user reviews,0,0,0
1011870,True,0,1 user reviews,1,0,1
1011890,True,7,Positive,12,1,13
1011900,True,7,Positive,16,2,18
1011920,True,0,No user reviews,0,0,0
1011940,True,8,Very Positive,111,10,121
1011950,True,0,2 user reviews,2,0,2
1011960,True,0,No user reviews,0,0,0
1011970,True,0,No user reviews,0,0,0
1011980,True,0,No user reviews,0,0,0
1011990,True,7,Positive,32,0,32
1012010,True,0,1 user reviews,1,0,1
1012030,True,8,Very Positive,72,6,78
1012070,True,0,2 user reviews,1,1,2
1012080,True,0,3 user reviews,3,0,3
1012081,True,5,Mixed,4,6,10
1012100,True,0,8 user reviews,3,5,8
1012101,True,0,3 user reviews,1,2,3
1012102,True,7,Positive,22,1,23
1012120,True,0,No user reviews,0,0,0
1012130,True,0,No user reviews,0,0,0
1012150,True,0,No user reviews,0,0,0
1012160,True,0,2 user reviews,1,1,2
1012180,True,0,No user reviews,0,0,0
1012190,True,0,No user reviews,0,0,0
1012200,True,0,No user reviews,0,0,0
1012201,True,0,No user reviews,0,0,0
1012202,True,0,No user reviews,0,0,0
1012203,True,0,No user reviews,0,0,0
1012210,True,0,4 user reviews,1,3,4
1012220,True,0,7 user reviews,6,1,7
1012230,True,0,No user reviews,0,0,0
1012240,True,0,No user reviews,0,0,0
1012270,True,0,1 user reviews,1,0,1
1012280,True,0,2 user reviews,2,0,2
1012290,True,0,No user reviews,0,0,0
1012360,True,0,1 user reviews,1,0,1
1012370,True,0,3 user reviews,1,2,3
1012380,True,0,1 user reviews,0,1,1
1012381,True,0,No user reviews,0,0,0
1012390,True,0,No user reviews,0,0,0
1012400,True,0,1 user reviews,0,1,1
1012401,True,0,1 user reviews,1,0,1
1012402,True,0,4 user reviews,3,1,4
1012403,True,0,2 user reviews,2,0,2
1012404,True,0,1 user reviews,0,1,1
1012405,True,0,5 user reviews,5,0,5
1012406,True,0,No user reviews,0,0,0
1012410,True,7,Positive,26,5,31
1012420,True,0,No user reviews,0,0,0
1012430,True,0,1 user reviews,1,0,1
1012450,True,0,5 user reviews,5,0,5
1012460,True,5,Mixed,8,7,15
1012470,True,0,No user reviews,0,0,0
1012490,True,0,1 user reviews,1,0,1
1012510,True,0,No user reviews,0,0,0
1012530,True,0,3 user reviews,3,0,3
1012560,True,8,Very Positive,889,69,958
1012570,True,0,No user reviews,0,0,0
1012580,True,0,9 user reviews,6,3,9
1012600,True,0,No user reviews,0,0,0
1012610,True,8,Very Positive,233,57,290
1012630,True,8,Very Positive,113,3,116
1012640,True,0,No user reviews,0,0,0
1012650,True,0,No user reviews,0,0,0
1012670,True,0,1 user reviews,1,0,1
1012710,True,0,1 user reviews,0,1,1
1012720,True,0,3 user reviews,2,1,3
1012730,True,0,No user reviews,0,0,0
1012740,True,0,No user reviews,0,0,0
1012760,True,0,No user reviews,0,0,0
1012790,True,6,Mostly Positive,241,71,312
1012800,True,0,1 user reviews,1,0,1
1012810,True,0,1 user reviews,1,0,1
1012830,True,6,Mostly Positive,8,3,11
1012840,True,6,Mostly Positive,466,127,593
1012850,True,0,9 user reviews,9,0,9
1012860,True,0,No user reviews,0,0,0
1012880,True,8,Very Positive,791,70,861
1012890,True,0,No user reviews,0,0,0
1012900,True,5,Mixed,21,15,36
1012930,True,0,No user reviews,0,0,0
1012940,True,0,No user reviews,0,0,0
1012960,True,0,7 user reviews,6,1,7
1012970,True,6,Mostly Positive,19,5,24
1012980,True,7,Positive,16,4,20
1012990,True,7,Positive,9,1,10
1013000,True,0,1 user reviews,0,1,1
1013010,True,0,No user reviews,0,0,0
1013040,True,6,Mostly Positive,21,8,29
1013070,True,0,7 user reviews,4,3,7
1013080,True,0,No user reviews,0,0,0
1013090,True,0,2 user reviews,2,0,2
1013100,True,0,4 user reviews,4,0,4
1013110,True,0,No user reviews,0,0,0
1013120,True,0,3 user reviews,2,1,3
1013130,True,5,Mixed,7,6,13
1013150,True,0,No user reviews,0,0,0
1013180,True,7,Positive,42,3,45
1013190,True,7,Positive,12,0,12
1013200,True,0,No user reviews,0,0,0
1013210,True,0,No user reviews,0,0,0
1013211,True,0,No user reviews,0,0,0
1013212,True,0,No user reviews,0,0,0
1013213,True,0,No user reviews,0,0,0
1013230,True,0,1 user reviews,1,0,1
1013280,True,7,Positive,19,0,19
1013290,True,0,1 user reviews,1,0,1
1013300,True,5,Mixed,31,16,47
1013310,True,5,Mixed,33,18,51
1013320,True,0,No user reviews,0,0,0
1013330,True,0,No user reviews,0,0,0
1013340,True,0,No user reviews,0,0,0
1013350,True,0,3 user reviews,1,2,3
1013400,True,0,No user reviews,0,0,0
1013410,True,0,8 user reviews,1,7,8
1013420,True,0,No user reviews,0,0,0
1013430,True,0,No user reviews,0,0,0
1013450,True,0,4 user reviews,3,1,4
1013500,True,0,No user reviews,0,0,0
1013540,True,8,Very Positive,54,12,66
1013550,True,0,No user reviews,0,0,0
1013560,True,0,No user reviews,0,0,0
1013580,True,0,6 user reviews,5,1,6
1013600,True,0,6 user reviews,6,0,6
1013630,True,0,1 user reviews,1,0,1
1013650,True,7,Positive,42,2,44
1013660,True,0,No user reviews,0,0,0
1013670,True,0,2 user reviews,2,0,2
1013680,True,0,No user reviews,0,0,0
1013700,True,5,Mixed,7,5,12
1013710,True,5,Mixed,8,4,12
1013740,True,0,No user reviews,0,0,0
1013750,True,6,Mostly Positive,11,3,14
1013780,True,0,No user reviews,0,0,0
1013790,True,0,No user reviews,0,0,0
1013810,True,0,No user reviews,0,0,0
1013820,True,0,5 user reviews,4,1,5
1013830,True,0,No user reviews,0,0,0
1013850,True,0,No user reviews,0,0,0
1013870,True,7,Positive,42,4,46
1013890,True,0,2 user reviews,1,1,2
1013910,True,0,No user reviews,0,0,0
1013940,True,0,No user reviews,0,0,0
1013950,True,0,3 user reviews,3,0,3
1013960,True,7,Positive,10,2,12
1013970,True,0,No user reviews,0,0,0
1013980,True,0,No user reviews,0,0,0
1014000,True,0,No user reviews,0,0,0
1014010,True,5,Mixed,6,5,11
1014030,True,0,1 user reviews,0,1,1
1014040,True,5,Mixed,11,7,18
1014050,True,0,3 user reviews,1,2,3
1014100,True,6,Mostly Positive,11,4,15
1014110,True,5,Mixed,8,4,12
1014120,True,0,No user reviews,0,0,0
1014130,True,6,Mostly Positive,45,16,61
1014140,True,8,Very Positive,73,3,76
1014180,True,0,No user reviews,0,0,0
1014240,True,0,No user reviews,0,0,0
1014270,True,0,5 user reviews,5,0,5
1014280,True,7,Positive,31,2,33
1014290,True,0,2 user reviews,2,0,2
1014300,True,0,7 user reviews,6,1,7
1014310,True,0,1 user reviews,1,0,1
1014350,True,0,No user reviews,0,0,0
1014360,True,0,2 user reviews,2,0,2
1014370,True,0,No user reviews,0,0,0
1014400,True,0,No user reviews,0,0,0
1014420,True,7,Positive,9,1,10
1014450,True,0,1 user reviews,1,0,1
1014460,True,6,Mostly Positive,13,4,17
1014470,True,0,No user reviews,0,0,0
1014540,True,0,No user reviews,0,0,0
1014550,True,0,No user reviews,0,0,0
1014560,True,6,Mostly Positive,7,3,10
1014570,True,7,Positive,14,2,16
1014580,True,0,7 user reviews,7,0,7
1014590,True,0,9 user reviews,3,6,9
1014600,True,0,No user reviews,0,0,0
1014610,True,0,No user reviews,0,0,0
1014620,True,0,4 user reviews,3,1,4
1014640,True,0,No user reviews,0,0,0
1014660,True,0,1 user reviews,1,0,1
1014700,True,0,No user reviews,0,0,0
1014710,True,0,7 user reviews,5,2,7
1014720,True,0,No user reviews,0,0,0
1014730,True,6,Mostly Positive,61,26,87
1014740,True,0,No user reviews,0,0,0
1014750,True,0,3 user reviews,3,0,3
1014780,True,0,No user reviews,0,0,0
1014790,True,0,1 user reviews,1,0,1
1014810,True,5,Mixed,22,17,39
1014820,True,0,3 user reviews,2,1,3
1014840,True,0,1 user reviews,1,0,1
1014850,True,0,3 user reviews,3,0,3
1014870,True,0,No user reviews,0,0,0
1014880,True,0,No user reviews,0,0,0
1014890,True,0,5 user reviews,2,3,5
1014900,True,5,Mixed,6,5,11
1014910,True,0,No user reviews,0,0,0
1014920,True,0,No user reviews,0,0,0
1014930,True,0,No user reviews,0,0,0
1014940,True,0,No user reviews,0,0,0
1014960,True,0,No user reviews,0,0,0
1014970,True,0,No user reviews,0,0,0
1014980,True,0,No user reviews,0,0,0
1014990,True,0,6 user reviews,5,1,6
1015020,True,0,9 user reviews,7,2,9
1015030,True,7,Positive,43,5,48
1015050,True,7,Positive,12,1,13
1015080,True,7,Positive,16,4,20
1015090,True,5,Mixed,30,35,65
1015100,True,0,3 user reviews,2,1,3
1015110,True,0,3 user reviews,3,0,3
1015120,True,0,No user reviews,0,0,0
1015130,True,5,Mixed,36,17,53
1015140,True,6,Mostly Positive,163,44,207
1015150,True,0,No user reviews,0,0,0
1015160,True,8,Very Positive,250,12,262
1015170,True,0,No user reviews,0,0,0
1015180,True,0,1 user reviews,0,1,1
1015220,True,0,No user reviews,0,0,0
1015221,True,0,No user reviews,0,0,0
1015222,True,0,No user reviews,0,0,0
1015240,True,0,4 user reviews,2,2,4
1015250,True,0,1 user reviews,1,0,1
1015290,True,0,No user reviews,0,0,0
1015350,True,4,Mostly Negative,4,8,12
1015370,True,0,No user reviews,0,0,0
1015430,True,6,Mostly Positive,17,6,23
1015460,True,0,No user reviews,0,0,0
1015470,True,0,2 user reviews,0,2,2
1015480,True,6,Mostly Positive,24,9,33
1015490,True,0,No user reviews,0,0,0
1015500,True,4,Mostly Negative,330,584,914
1015530,True,0,3 user reviews,2,1,3
1015540,True,0,2 user reviews,0,2,2
1015550,True,0,1 user reviews,1,0,1
1015560,True,0,No user reviews,0,0,0
1015580,True,0,No user reviews,0,0,0
1015590,True,0,No user reviews,0,0,0
1015600,True,0,No user reviews,0,0,0
1015610,True,5,Mixed,60,33,93
1015650,True,0,No user reviews,0,0,0
1015660,True,7,Positive,17,3,20
1015680,True,0,No user reviews,0,0,0
1015690,True,0,No user reviews,0,0,0
1015700,True,0,No user reviews,0,0,0
1015710,True,4,Mostly Negative,5,10,15
1015720,True,7,Positive,44,5,49
1015730,True,7,Positive,32,7,39
1015750,True,0,8 user reviews,6,2,8
1015770,True,7,Positive,31,7,38
1015790,True,5,Mixed,16,9,25
1015800,True,5,Mixed,10,6,16
1015810,True,0,No user reviews,0,0,0
1015820,True,0,No user reviews,0,0,0
1015830,True,5,Mixed,13,18,31
1015840,True,0,No user reviews,0,0,0
1015850,True,0,No user reviews,0,0,0
1015860,True,0,No user reviews,0,0,0
1015880,True,6,Mostly Positive,20,7,27
1015890,True,0,No user reviews,0,0,0
1015900,True,0,6 user reviews,6,0,6
1015920,True,0,No user reviews,0,0,0
1015930,True,4,Mostly Negative,79,121,200
1015940,True,7,Positive,40,0,40
1015960,True,0,No user reviews,0,0,0
1015970,True,0,No user reviews,0,0,0
1015980,True,5,Mixed,7,4,11
1015990,True,0,No user reviews,0,0,0
1016000,True,0,No user reviews,0,0,0
1016010,True,0,4 user reviews,2,2,4
1016030,True,0,No user reviews,0,0,0
1016050,True,0,No user reviews,0,0,0
1016070,True,2,Very Negative,12,65,77
1016080,True,5,Mixed,13,14,27
1016100,True,0,1 user reviews,1,0,1
1016110,True,0,No user reviews,0,0,0
1016120,True,8,Very Positive,931,228,1159
1016130,True,0,3 user reviews,3,0,3
1016150,True,0,3 user reviews,0,3,3
1016180,True,0,No user reviews,0,0,0
1016220,True,0,No user reviews,0,0,0
1016250,True,5,Mixed,9,6,15
1016260,True,0,No user reviews,0,0,0
1016300,True,0,4 user reviews,4,0,4
1016330,True,0,2 user reviews,2,0,2
1016360,True,0,No user reviews,0,0,0
1016390,True,0,No user reviews,0,0,0
1016420,True,0,7 user reviews,5,2,7
1016430,True,0,8 user reviews,8,0,8
1016480,True,0,No user reviews,0,0,0
1016500,True,0,No user reviews,0,0,0
1016510,True,0,No user reviews,0,0,0
1016520,True,0,5 user reviews,5,0,5
1016530,True,0,No user reviews,0,0,0
1016540,True,0,No user reviews,0,0,0
1016550,True,0,No user reviews,0,0,0
1016560,True,0,No user reviews,0,0,0
1016580,True,0,No user reviews,0,0,0
1016590,True,0,No user reviews,0,0,0
1016600,True,8,Very Positive,95,11,106
1016610,True,0,4 user reviews,2,2,4
1016620,True,0,No user reviews,0,0,0
1016630,True,7,Positive,15,0,15
1016640,True,0,No user reviews,0,0,0
1016650,True,0,1 user reviews,1,0,1
1016660,True,0,5 user reviews,4,1,5
1016690,True,0,2 user reviews,1,1,2
1016700,True,0,No user reviews,0,0,0
1016710,True,3,Negative,2,11,13
1016720,True,5,Mixed,16,13,29
1016730,True,5,Mixed,138,65,203
1016740,True,0,2 user reviews,0,2,2
1016750,True,0,No user reviews,0,0,0
1016760,True,6,Mostly Positive,13,5,18
1016770,True,8,Very Positive,82,10,92
1016780,True,0,No user reviews,0,0,0
1016790,True,6,Mostly Positive,81,31,112
1016800,True,6,Mostly Positive,580,177,757
1016810,True,5,Mixed,14,12,26
1016830,True,0,No user reviews,0,0,0
1016840,True,5,Mixed,41,26,67
1016850,True,0,1 user reviews,1,0,1
1016860,True,8,Very Positive,61,14,75
1016890,True,0,No user reviews,0,0,0
1016920,True,8,Very Positive,1036,59,1095
1016930,True,5,Mixed,39,24,63
1016940,True,7,Positive,10,2,12
1016950,True,0,No user reviews,0,0,0
1016960,True,8,Very Positive,223,45,268
1016970,True,0,No user reviews,0,0,0
1016980,True,0,6 user reviews,4,2,6
1017030,True,8,Very Positive,55,7,62
1017060,True,5,Mixed,41,25,66
1017070,True,0,No user reviews,0,0,0
1017100,True,0,No user reviews,0,0,0
1017130,True,0,6 user reviews,5,1,6
1017170,True,0,No user reviews,0,0,0
1017180,True,8,Very Positive,895,128,1023
1017220,True,0,No user reviews,0,0,0
1017230,True,0,No user reviews,0,0,0
1017240,True,0,1 user reviews,1,0,1
1017270,True,0,1 user reviews,1,0,1
1017280,True,0,No user reviews,0,0,0
1017310,True,0,No user reviews,0,0,0
1017330,True,0,No user reviews,0,0,0
1017350,True,0,5 user reviews,3,2,5
1017360,True,0,No user reviews,0,0,0
1017370,True,0,No user reviews,0,0,0
1017380,True,0,No user reviews,0,0,0
1017390,True,0,No user reviews,0,0,0
1017391,True,0,No user reviews,0,0,0
1017410,True,0,1 user reviews,1,0,1
1017440,True,0,1 user reviews,1,0,1
1017470,True,0,No user reviews,0,0,0
1017480,True,0,No user reviews,0,0,0
1017490,True,0,No user reviews,0,0,0
1017510,True,7,Positive,16,1,17
1017520,True,7,Positive,34,7,41
1017530,True,0,No user reviews,0,0,0
1017540,True,0,No user reviews,0,0,0
1017560,True,0,8 user reviews,7,1,8
1017570,True,0,No user reviews,0,0,0
1017580,True,5,Mixed,7,4,11
1017600,True,0,1 user reviews,0,1,1
1017610,True,0,2 user reviews,2,0,2
1017620,True,0,2 user reviews,1,1,2
1017630,True,0,4 user reviews,4,0,4
1017650,True,0,No user reviews,0,0,0
1017660,True,0,No user reviews,0,0,0
1017670,True,0,9 user reviews,8,1,9
1017680,True,0,No user reviews,0,0,0
1017690,True,0,No user reviews,0,0,0
1017700,True,0,No user reviews,0,0,0
1017710,True,0,No user reviews,0,0,0
1017720,True,0,No user reviews,0,0,0
1017730,True,0,No user reviews,0,0,0
1017750,True,0,1 user reviews,0,1,1
1017760,True,0,No user reviews,0,0,0
1017770,True,0,No user reviews,0,0,0
1017780,True,6,Mostly Positive,23,9,32
1017790,True,0,No user reviews,0,0,0
1017800,True,0,No user reviews,0,0,0
1017810,True,0,2 user reviews,2,0,2
1017820,True,0,No user reviews,0,0,0
1017830,True,0,No user reviews,0,0,0
1017840,True,0,No user reviews,0,0,0
1017850,True,0,No user reviews,0,0,0
1017870,True,0,No user reviews,0,0,0
1017880,True,0,5 user reviews,3,2,5
1017890,True,0,No user reviews,0,0,0
1017900,True,6,Mostly Positive,1548,393,1941
1017910,True,0,4 user reviews,3,1,4
1017920,True,0,No user reviews,0,0,0
1017940,True,6,Mostly Positive,12,4,16
1017990,True,0,No user reviews,0,0,0
1018000,True,5,Mixed,21,15,36
1018010,True,8,Very Positive,221,50,271
1018020,True,6,Mostly Positive,80,22,102
1018030,True,0,No user reviews,0,0,0
1018040,True,5,Mixed,9,4,13
1018050,True,0,No user reviews,0,0,0
1018060,True,0,No user reviews,0,0,0
1018080,True,0,3 user reviews,2,1,3
1018090,True,0,4 user reviews,1,3,4
1018100,True,0,No user reviews,0,0,0
1018110,True,0,No user reviews,0,0,0
1018120,True,0,No user reviews,0,0,0
1018130,True,7,Positive,24,2,26
1018140,True,0,No user reviews,0,0,0
1018150,True,0,No user reviews,0,0,0
1018151,True,0,No user reviews,0,0,0
1018160,True,8,Very Positive,135,32,167
1018170,True,0,No user reviews,0,0,0
1018180,True,0,No user reviews,0,0,0
1018190,True,0,No user reviews,0,0,0
1018210,True,0,No user reviews,0,0,0
1018220,True,0,No user reviews,0,0,0
1018240,True,0,5 user reviews,5,0,5
1018270,True,5,Mixed,11,11,22
1018320,True,0,1 user reviews,1,0,1
1018350,True,0,No user reviews,0,0,0
1018360,True,0,No user reviews,0,0,0
1018361,True,0,No user reviews,0,0,0
1018362,True,0,No user reviews,0,0,0
1018363,True,0,No user reviews,0,0,0
1018364,True,0,No user reviews,0,0,0
1018370,True,0,No user reviews,0,0,0
1018380,True,0,No user reviews,0,0,0
1018420,True,0,7 user reviews,6,1,7
1018440,True,0,No user reviews,0,0,0
1018460,True,0,No user reviews,0,0,0
1018470,True,0,No user reviews,0,0,0
1018480,True,0,1 user reviews,1,0,1
1018530,True,8,Very Positive,58,8,66
1018560,True,0,2 user reviews,2,0,2
1018590,True,0,3 user reviews,2,1,3
1018610,True,0,7 user reviews,4,3,7
1018640,True,0,No user reviews,0,0,0
1018650,True,0,No user reviews,0,0,0
1018670,True,0,1 user reviews,1,0,1
1018680,True,7,Positive,38,9,47
1018700,True,0,No user reviews,0,0,0
1018720,True,0,3 user reviews,2,1,3
1018730,True,0,No user reviews,0,0,0
1018740,True,0,No user reviews,0,0,0
1018750,True,0,No user reviews,0,0,0
1018760,True,0,4 user reviews,4,0,4
1018761,True,0,6 user reviews,6,0,6
1018770,True,0,1 user reviews,0,1,1
1018800,True,8,Very Positive,279,18,297
1018810,True,0,1 user reviews,1,0,1
1018820,True,0,4 user reviews,2,2,4
1018830,True,8,Very Positive,113,8,121
1018850,True,9,Overwhelmingly Positive,649,4,653
1018860,True,0,2 user reviews,2,0,2
1018870,True,5,Mixed,12,8,20
1018880,True,7,Positive,25,1,26
1018890,True,0,No user reviews,0,0,0
1018900,True,0,2 user reviews,2,0,2
1018930,True,0,No user reviews,0,0,0
1018940,True,0,No user reviews,0,0,0
1018950,True,0,No user reviews,0,0,0
1018960,True,0,2 user reviews,0,2,2
1018990,True,7,Positive,15,0,15
1019000,True,0,No user reviews,0,0,0
1019010,True,0,No user reviews,0,0,0
1019020,True,0,2 user reviews,2,0,2
1019030,True,0,No user reviews,0,0,0
1019040,True,0,5 user reviews,3,2,5
1019060,True,0,2 user reviews,1,1,2
1019070,True,0,4 user reviews,4,0,4
1019080,True,0,1 user reviews,0,1,1
1019090,True,0,No user reviews,0,0,0
1019100,True,0,No user reviews,0,0,0
1019110,True,0,No user reviews,0,0,0
1019120,True,0,No user reviews,0,0,0
1019130,True,0,No user reviews,0,0,0
1019132,True,0,No user reviews,0,0,0
1019133,True,0,3 user reviews,2,1,3
1019140,True,0,No user reviews,0,0,0
1019150,True,0,No user reviews,0,0,0
1019170,True,0,1 user reviews,0,1,1
1019180,True,0,No user reviews,0,0,0
1019210,True,0,No user reviews,0,0,0
1019211,True,0,No user reviews,0,0,0
1019213,True,0,No user reviews,0,0,0
1019230,True,7,Positive,14,1,15
1019240,True,0,No user reviews,0,0,0
1019250,True,0,No user reviews,0,0,0
1019260,True,0,No user reviews,0,0,0
1019270,True,0,2 user reviews,2,0,2
1019280,True,0,No user reviews,0,0,0
1019290,True,0,No user reviews,0,0,0
1019300,True,0,No user reviews,0,0,0
1019310,True,8,Very Positive,222,47,269
1019320,True,0,No user reviews,0,0,0
1019340,True,0,No user reviews,0,0,0
1019360,True,0,1 user reviews,0,1,1
1019370,True,0,No user reviews,0,0,0
1019380,True,0,No user reviews,0,0,0
1019400,True,0,3 user reviews,3,0,3
1019420,True,8,Very Positive,59,12,71
1019450,True,5,Mixed,24,17,41
1019470,True,0,No user reviews,0,0,0
1019500,True,0,No user reviews,0,0,0
1019510,True,0,4 user reviews,1,3,4
1019511,True,0,4 user reviews,3,1,4
1019512,True,0,2 user reviews,0,2,2
1019513,True,0,2 user reviews,1,1,2
1019530,True,0,No user reviews,0,0,0
1019540,True,7,Positive,9,1,10
1019550,True,6,Mostly Positive,229,89,318
1019580,True,0,No user reviews,0,0,0
1019590,True,7,Positive,43,1,44
1019630,True,0,8 user reviews,5,3,8
1019640,True,0,1 user reviews,1,0,1
1019660,True,0,No user reviews,0,0,0
1019690,True,0,No user reviews,0,0,0
1019700,True,0,No user reviews,0,0,0
1019710,True,0,1 user reviews,0,1,1
1019720,True,0,No user reviews,0,0,0
1019730,True,0,2 user reviews,2,0,2
1019740,True,0,No user reviews,0,0,0
1019770,True,0,No user reviews,0,0,0
1019790,True,0,2 user reviews,1,1,2
1019800,True,0,No user reviews,0,0,0
1019820,True,0,2 user reviews,2,0,2
1019830,True,0,No user reviews,0,0,0
1019840,True,0,No user reviews,0,0,0
1019870,True,0,No user reviews,0,0,0
1019910,True,0,No user reviews,0,0,0
1019920,True,7,Positive,14,0,14
1019930,True,7,Positive,30,3,33
1019931,True,0,No user reviews,0,0,0
1019940,True,5,Mixed,79,36,115
1019960,True,0,1 user reviews,1,0,1
1019961,True,0,No user reviews,0,0,0
1019962,True,0,No user reviews,0,0,0
1019963,True,0,No user reviews,0,0,0
1019964,True,0,1 user reviews,1,0,1
1019965,True,0,1 user reviews,1,0,1
1019966,True,0,2 user reviews,0,2,2
1019967,True,0,No user reviews,0,0,0
1019968,True,0,No user reviews,0,0,0
1019969,True,0,No user reviews,0,0,0
1019970,True,0,No user reviews,0,0,0
1019971,True,0,No user reviews,0,0,0
1019980,True,0,No user reviews,0,0,0
1019981,True,0,No user reviews,0,0,0
1019982,True,0,No user reviews,0,0,0
1019983,True,0,No user reviews,0,0,0
1019984,True,0,1 user reviews,1,0,1
1019985,True,0,1 user reviews,1,0,1
1019986,True,0,No user reviews,0,0,0
1019987,True,0,No user reviews,0,0,0
1019988,True,0,No user reviews,0,0,0
1019989,True,0,1 user reviews,1,0,1
1019990,True,0,No user reviews,0,0,0
1019991,True,0,No user reviews,0,0,0
1019992,True,0,No user reviews,0,0,0
1019993,True,0,1 user reviews,1,0,1
1019994,True,0,1 user reviews,1,0,1
1020010,True,0,No user reviews,0,0,0
1020020,True,0,1 user reviews,1,0,1
1020030,True,6,Mostly Positive,30,11,41
1020040,True,0,1 user reviews,1,0,1
1020050,True,5,Mixed,11,5,16
1020070,True,0,No user reviews,0,0,0
1020080,True,0,No user reviews,0,0,0
1020090,True,0,7 user reviews,7,0,7
1020100,True,7,Positive,11,1,12
1020120,True,0,2 user reviews,2,0,2
1020140,True,0,No user reviews,0,0,0
1020210,True,6,Mostly Positive,11,4,15
1020230,True,0,No user reviews,0,0,0
1020250,True,0,2 user reviews,1,1,2
1020270,True,7,Positive,28,4,32
1020290,True,0,4 user reviews,3,1,4
1020310,True,0,No user reviews,0,0,0
1020320,True,0,No user reviews,0,0,0
1020330,True,0,2 user reviews,2,0,2
1020340,True,8,Very Positive,256,45,301
1020350,True,0,No user reviews,0,0,0
1020360,True,0,No user reviews,0,0,0
1020370,True,0,No user reviews,0,0,0
1020380,True,0,No user reviews,0,0,0
1020390,True,0,4 user reviews,3,1,4
1020400,True,0,No user reviews,0,0,0
1020410,True,0,No user reviews,0,0,0
1020420,True,0,No user reviews,0,0,0
1020430,True,0,No user reviews,0,0,0
1020440,True,0,2 user reviews,1,1,2
1020450,True,0,6 user reviews,6,0,6
1020460,True,0,No user reviews,0,0,0
1020470,True,8,Very Positive,207,47,254
1020480,True,0,2 user reviews,1,1,2
1020490,True,0,2 user reviews,2,0,2
1020520,True,0,No user reviews,0,0,0
1020540,True,5,Mixed,10,10,20
1020560,True,0,3 user reviews,2,1,3
1020570,True,0,No user reviews,0,0,0
1020571,True,0,No user reviews,0,0,0
1020572,True,0,No user reviews,0,0,0
1020580,True,0,No user reviews,0,0,0
1020590,True,7,Positive,34,0,34
1020600,True,0,9 user reviews,5,4,9
1020610,True,0,No user reviews,0,0,0
1020630,True,0,1 user reviews,1,0,1
1020631,True,0,1 user reviews,1,0,1
1020640,True,0,No user reviews,0,0,0
1020650,True,0,1 user reviews,1,0,1
1020660,True,4,Mostly Negative,3,10,13
1020670,True,0,No user reviews,0,0,0
1020700,True,0,No user reviews,0,0,0
1020710,True,0,No user reviews,0,0,0
1020730,True,8,Very Positive,132,13,145
1020780,True,0,No user reviews,0,0,0
1020800,True,5,Mixed,24,12,36
1020820,True,6,Mostly Positive,84,31,115
1020830,True,0,No user reviews,0,0,0
1020840,True,0,1 user reviews,1,0,1
1020880,True,0,No user reviews,0,0,0
1020910,True,0,No user reviews,0,0,0
1020930,True,0,No user reviews,0,0,0
1020940,True,7,Positive,34,0,34
1020980,True,0,1 user reviews,0,1,1
1021010,True,0,No user reviews,0,0,0
1021011,True,0,No user reviews,0,0,0
1021030,True,0,No user reviews,0,0,0
1021060,True,0,1 user reviews,1,0,1
1021070,True,6,Mostly Positive,74,31,105
1021080,True,0,No user reviews,0,0,0
1021090,True,0,No user reviews,0,0,0
1021100,True,0,No user reviews,0,0,0
1021110,True,0,No user reviews,0,0,0
1021120,True,0,6 user reviews,2,4,6
1021130,True,0,3 user reviews,3,0,3
1021150,True,0,No user reviews,0,0,0
1021160,True,0,No user reviews,0,0,0
1021170,True,0,No user reviews,0,0,0
1021180,True,0,No user reviews,0,0,0
1021190,True,0,7 user reviews,5,2,7
1021200,True,0,No user reviews,0,0,0
1021210,True,0,No user reviews,0,0,0
1021220,True,0,No user reviews,0,0,0
1021240,True,0,No user reviews,0,0,0
1021250,True,0,No user reviews,0,0,0
1021260,True,0,No user reviews,0,0,0
1021280,True,7,Positive,25,0,25
1021290,True,0,No user reviews,0,0,0
1021370,True,0,3 user reviews,3,0,3
1021580,True,0,No user reviews,0,0,0
1021640,True,0,3 user reviews,3,0,3
1021650,True,0,No user reviews,0,0,0
1021670,True,0,2 user reviews,0,2,2
1021680,True,0,6 user reviews,5,1,6
1021690,True,0,3 user reviews,1,2,3
1021730,True,0,No user reviews,0,0,0
1021740,True,0,1 user reviews,0,1,1
1021741,True,0,No user reviews,0,0,0
1021742,True,0,No user reviews,0,0,0
1021770,True,8,Very Positive,64,2,66
1021780,True,3,Negative,1,23,24
1021790,True,5,Mixed,487,256,743
1021800,True,0,2 user reviews,1,1,2
1021820,True,0,2 user reviews,2,0,2
1021830,True,0,No user reviews,0,0,0
1021840,True,0,No user reviews,0,0,0
1021850,True,0,No user reviews,0,0,0
1021860,True,0,4 user reviews,4,0,4
1021880,True,0,1 user reviews,1,0,1
1021890,True,0,No user reviews,0,0,0
1021900,True,0,1 user reviews,1,0,1
1021901,True,0,No user reviews,0,0,0
1021910,True,0,No user reviews,0,0,0
1021940,True,0,No user reviews,0,0,0
1021950,True,0,No user reviews,0,0,0
1021960,True,0,No user reviews,0,0,0
1021980,True,0,No user reviews,0,0,0
1021990,True,0,No user reviews,0,0,0
1022000,True,0,No user reviews,0,0,0
1022010,True,6,Mostly Positive,12,4,16
1022040,True,0,3 user reviews,1,2,3
1022060,True,0,No user reviews,0,0,0
1022120,True,0,1 user reviews,1,0,1
1022130,True,0,7 user reviews,6,1,7
1022150,True,0,No user reviews,0,0,0
1022160,True,0,1 user reviews,1,0,1
1022170,True,0,1 user reviews,0,1,1
1022180,True,0,No user reviews,0,0,0
1022190,True,0,No user reviews,0,0,0
1022200,True,0,No user reviews,0,0,0
1022230,True,5,Mixed,57,26,83
1022270,True,0,2 user reviews,2,0,2
1022280,True,0,2 user reviews,1,1,2
1022310,True,6,Mostly Positive,346,112,458
1022320,True,0,No user reviews,0,0,0
1022330,True,0,No user reviews,0,0,0
1022340,True,0,No user reviews,0,0,0
1022343,True,0,No user reviews,0,0,0
1022344,True,0,No user reviews,0,0,0
1022345,True,0,No user reviews,0,0,0
1022350,True,0,No user reviews,0,0,0
1022360,True,0,No user reviews,0,0,0
1022361,True,0,No user reviews,0,0,0
1022362,True,0,No user reviews,0,0,0
1022365,True,0,No user reviews,0,0,0
1022366,True,0,No user reviews,0,0,0
1022367,True,0,No user reviews,0,0,0
1022380,True,0,1 user reviews,0,1,1
1022391,True,0,No user reviews,0,0,0
1022392,True,0,1 user reviews,1,0,1
1022393,True,0,No user reviews,0,0,0
1022394,True,0,No user reviews,0,0,0
1022395,True,0,No user reviews,0,0,0
1022396,True,0,No user reviews,0,0,0
1022397,True,0,No user reviews,0,0,0
1022400,True,0,No user reviews,0,0,0
1022401,True,0,No user reviews,0,0,0
1022402,True,0,No user reviews,0,0,0
1022410,True,0,No user reviews,0,0,0
1022411,True,0,No user reviews,0,0,0
1022412,True,0,No user reviews,0,0,0
1022413,True,0,No user reviews,0,0,0
1022414,True,0,No user reviews,0,0,0
1022415,True,0,No user reviews,0,0,0
1022416,True,0,No user reviews,0,0,0
1022417,True,0,No user reviews,0,0,0
1022418,True,0,1 user reviews,1,0,1
1022419,True,0,No user reviews,0,0,0
1022420,True,0,No user reviews,0,0,0
1022421,True,0,No user reviews,0,0,0
1022422,True,0,No user reviews,0,0,0
1022423,True,0,No user reviews,0,0,0
1022424,True,0,1 user reviews,1,0,1
1022425,True,0,No user reviews,0,0,0
1022426,True,0,No user reviews,0,0,0
1022427,True,0,No user reviews,0,0,0
1022428,True,0,No user reviews,0,0,0
1022429,True,0,No user reviews,0,0,0
1022430,True,0,No user reviews,0,0,0
1022431,True,0,No user reviews,0,0,0
1022432,True,0,No user reviews,0,0,0
1022433,True,0,No user reviews,0,0,0
1022435,True,0,No user reviews,0,0,0
1022436,True,0,No user reviews,0,0,0
1022437,True,0,No user reviews,0,0,0
1022438,True,0,1 user reviews,1,0,1
1022439,True,0,No user reviews,0,0,0
1022440,True,0,No user reviews,0,0,0
1022441,True,0,No user reviews,0,0,0
1022442,True,0,No user reviews,0,0,0
1022443,True,0,1 user reviews,1,0,1
1022444,True,0,No user reviews,0,0,0
1022445,True,0,No user reviews,0,0,0
1022446,True,0,No user reviews,0,0,0
1022447,True,0,No user reviews,0,0,0
1022448,True,0,2 user reviews,2,0,2
1022449,True,0,1 user reviews,1,0,1
1022450,True,0,No user reviews,0,0,0
1022460,True,0,2 user reviews,2,0,2
1022461,True,0,No user reviews,0,0,0
1022462,True,0,No user reviews,0,0,0
1022463,True,0,No user reviews,0,0,0
1022464,True,0,No user reviews,0,0,0
1022465,True,0,No user reviews,0,0,0
1022466,True,0,No user reviews,0,0,0
1022467,True,0,No user reviews,0,0,0
1022468,True,0,1 user reviews,1,0,1
1022469,True,0,No user reviews,0,0,0
1022470,True,0,No user reviews,0,0,0
1022471,True,0,No user reviews,0,0,0
1022472,True,0,No user reviews,0,0,0
1022473,True,0,No user reviews,0,0,0
1022474,True,0,No user reviews,0,0,0
1022475,True,0,No user reviews,0,0,0
1022476,True,0,No user reviews,0,0,0
1022477,True,0,No user reviews,0,0,0
1022478,True,0,1 user reviews,1,0,1
1022479,True,0,No user reviews,0,0,0
1022480,True,7,Positive,24,5,29
1022490,True,0,No user reviews,0,0,0
1022491,True,0,No user reviews,0,0,0
1022492,True,0,No user reviews,0,0,0
1022493,True,0,No user reviews,0,0,0
1022494,True,0,No user reviews,0,0,0
1022495,True,0,No user reviews,0,0,0
1022496,True,0,No user reviews,0,0,0
1022497,True,0,1 user reviews,1,0,1
1022498,True,0,No user reviews,0,0,0
1022499,True,0,No user reviews,0,0,0
1022500,True,0,No user reviews,0,0,0
1022501,True,0,No user reviews,0,0,0
1022502,True,0,No user reviews,0,0,0
1022503,True,0,No user reviews,0,0,0
1022504,True,0,No user reviews,0,0,0
1022505,True,0,No user reviews,0,0,0
1022506,True,0,No user reviews,0,0,0
1022507,True,0,No user reviews,0,0,0
1022508,True,0,No user reviews,0,0,0
1022509,True,0,No user reviews,0,0,0
1022510,True,0,1 user reviews,1,0,1
1022511,True,0,No user reviews,0,0,0
1022512,True,0,No user reviews,0,0,0
1022513,True,0,No user reviews,0,0,0
1022514,True,0,No user reviews,0,0,0
1022530,True,0,2 user reviews,1,1,2
1022540,True,0,No user reviews,0,0,0
1022550,True,0,3 user reviews,3,0,3
1022570,True,0,5 user reviews,4,1,5
1022590,True,0,No user reviews,0,0,0
1022600,True,0,No user reviews,0,0,0
1022610,True,0,7 user reviews,7,0,7
1022630,True,0,No user reviews,0,0,0
1022640,True,0,1 user reviews,1,0,1
1022650,True,0,4 user reviews,3,1,4
1022700,True,0,5 user reviews,3,2,5
1022710,True,5,Mixed,47,23,70
1022720,True,0,No user reviews,0,0,0
1022770,True,0,6 user reviews,4,2,6
1022780,True,6,Mostly Positive,40,12,52
1022790,True,0,No user reviews,0,0,0
1022820,True,0,No user reviews,0,0,0
1022830,True,5,Mixed,8,9,17
1022840,True,0,No user reviews,0,0,0
1022850,True,8,Very Positive,94,4,98
1022860,True,0,No user reviews,0,0,0
1022870,True,7,Positive,14,0,14
1022910,True,0,5 user reviews,4,1,5
1022920,True,0,No user reviews,0,0,0
1022950,True,0,No user reviews,0,0,0
1022980,True,5,Mixed,135,70,205
1022990,True,7,Positive,11,1,12
1023010,True,0,1 user reviews,1,0,1
1023030,True,0,1 user reviews,1,0,1
1023040,True,0,No user reviews,0,0,0
1023060,True,0,2 user reviews,1,1,2
1023080,True,0,No user reviews,0,0,0
1023090,True,0,No user reviews,0,0,0
1023100,True,0,No user reviews,0,0,0
1023110,True,0,1 user reviews,1,0,1
1023130,True,0,1 user reviews,1,0,1
1023140,True,0,No user reviews,0,0,0
1023150,True,0,2 user reviews,2,0,2
1023160,True,0,1 user reviews,1,0,1
1023170,True,0,No user reviews,0,0,0
1023180,True,0,No user reviews,0,0,0
1023260,True,0,5 user reviews,4,1,5
1023270,True,0,No user reviews,0,0,0
1023280,True,0,No user reviews,0,0,0
1023310,True,0,1 user reviews,1,0,1
1023320,True,0,No user reviews,0,0,0
1023330,True,0,No user reviews,0,0,0
1023340,True,0,No user reviews,0,0,0
1023370,True,0,No user reviews,0,0,0
1023390,True,0,6 user reviews,3,3,6
1023400,True,0,No user reviews,0,0,0
1023410,True,0,2 user reviews,2,0,2
1023420,True,0,No user reviews,0,0,0
1023430,True,0,No user reviews,0,0,0
1023510,True,0,7 user reviews,3,4,7
1023540,True,0,No user reviews,0,0,0
1023550,True,7,Positive,27,0,27
1023560,True,0,2 user reviews,2,0,2
1023570,True,0,No user reviews,0,0,0
1023580,True,0,No user reviews,0,0,0
1023610,True,0,No user reviews,0,0,0
1023620,True,0,No user reviews,0,0,0
1023640,True,0,6 user reviews,4,2,6
1023650,True,0,1 user reviews,1,0,1
1023660,True,0,No user reviews,0,0,0
1023670,True,0,No user reviews,0,0,0
1023680,True,0,5 user reviews,2,3,5
1023690,True,7,Positive,17,1,18
1023700,True,7,Positive,18,3,21
1023710,True,0,4 user reviews,4,0,4
1023720,True,0,3 user reviews,3,0,3
1023740,True,8,Very Positive,79,16,95
1023750,True,0,4 user reviews,3,1,4
1023760,True,0,No user reviews,0,0,0
1023770,True,0,No user reviews,0,0,0
1023780,True,0,2 user reviews,2,0,2
1023790,True,0,No user reviews,0,0,0
1023801,True,0,No user reviews,0,0,0
1023802,True,7,Positive,11,1,12
1023810,True,0,No user reviews,0,0,0
1023820,True,0,No user reviews,0,0,0
1023830,True,0,No user reviews,0,0,0
1023860,True,0,3 user reviews,3,0,3
1023870,True,5,Mixed,12,14,26
1023920,True,0,No user reviews,0,0,0
1023930,True,6,Mostly Positive,9,3,12
1023940,True,0,No user reviews,0,0,0
1023960,True,0,1 user reviews,0,1,1
1023970,True,6,Mostly Positive,23,6,29
1023980,True,5,Mixed,12,18,30
1023990,True,0,No user reviews,0,0,0
1024010,True,8,Very Positive,106,18,124
1024040,True,0,No user reviews,0,0,0
1024050,True,0,No user reviews,0,0,0
1024070,True,0,No user reviews,0,0,0
1024080,True,0,6 user reviews,4,2,6
1024090,True,0,No user reviews,0,0,0
1024100,True,0,4 user reviews,4,0,4
1024110,True,6,Mostly Positive,31,12,43
1024150,True,0,2 user reviews,0,2,2
1024160,True,0,No user reviews,0,0,0
1024210,True,0,5 user reviews,4,1,5
1024220,True,0,2 user reviews,0,2,2
1024240,True,0,No user reviews,0,0,0
1024250,True,0,1 user reviews,0,1,1
1024330,True,0,No user reviews,0,0,0
1024380,True,6,Mostly Positive,558,158,716
1024400,True,0,9 user reviews,7,2,9
1024410,True,0,No user reviews,0,0,0
1024420,True,0,No user reviews,0,0,0
1024430,True,4,Mostly Negative,5,8,13
1024450,True,0,No user reviews,0,0,0
1024460,True,7,Positive,31,4,35
1024470,True,0,No user reviews,0,0,0
1024480,True,5,Mixed,60,45,105
1024490,True,0,2 user reviews,2,0,2
1024520,True,0,No user reviews,0,0,0
1024530,True,0,1 user reviews,1,0,1
1024540,True,0,3 user reviews,2,1,3
1024550,True,0,No user reviews,0,0,0
1024551,True,0,2 user reviews,2,0,2
1024570,True,0,3 user reviews,3,0,3
1024590,True,0,4 user reviews,3,1,4
1024600,True,0,5 user reviews,1,4,5
1024610,True,0,No user reviews,0,0,0
1024620,True,0,No user reviews,0,0,0
1024630,True,6,Mostly Positive,14,5,19
1024640,True,6,Mostly Positive,10,3,13
1024650,True,5,Mixed,100,73,173
1024660,True,7,Positive,34,6,40
1024670,True,6,Mostly Positive,11,3,14
1024690,True,0,1 user reviews,0,1,1
1024700,True,0,3 user reviews,1,2,3
1024701,True,6,Mostly Positive,7,3,10
1024702,True,7,Positive,15,2,17
1024703,True,0,9 user reviews,6,3,9
1024704,True,0,7 user reviews,1,6,7
1024710,True,0,No user reviews,0,0,0
1024720,True,0,No user reviews,0,0,0
1024730,True,0,2 user reviews,2,0,2
1024740,True,0,No user reviews,0,0,0
1024760,True,0,No user reviews,0,0,0
1024770,True,7,Positive,29,6,35
1024780,True,0,1 user reviews,0,1,1
1024790,True,0,No user reviews,0,0,0
1024800,True,0,3 user reviews,3,0,3
1024810,True,0,3 user reviews,3,0,3
1024840,True,0,No user reviews,0,0,0
1024860,True,0,2 user reviews,2,0,2
1024870,True,0,No user reviews,0,0,0
1024890,True,0,No user reviews,0,0,0
1024910,True,0,No user reviews,0,0,0
1024912,True,0,No user reviews,0,0,0
1024913,True,0,No user reviews,0,0,0
1024914,True,0,No user reviews,0,0,0
1024915,True,0,No user reviews,0,0,0
1024920,True,0,No user reviews,0,0,0
1024950,True,0,3 user reviews,2,1,3
1024960,True,0,No user reviews,0,0,0
1024970,True,0,No user reviews,0,0,0
1024980,True,0,No user reviews,0,0,0
1024990,True,0,No user reviews,0,0,0
1025000,True,0,4 user reviews,3,1,4
1025010,True,0,No user reviews,0,0,0
1025020,True,0,1 user reviews,1,0,1
1025040,True,0,No user reviews,0,0,0
1025060,True,0,No user reviews,0,0,0
1025061,True,0,No user reviews,0,0,0
1025070,True,0,3 user reviews,3,0,3
1025080,True,0,No user reviews,0,0,0
1025090,True,0,No user reviews,0,0,0
1025100,True,0,No user reviews,0,0,0
1025130,True,0,9 user reviews,9,0,9
1025140,True,8,Very Positive,82,7,89
1025160,True,0,2 user reviews,2,0,2
1025170,True,0,No user reviews,0,0,0
1025171,True,0,No user reviews,0,0,0
1025172,True,0,No user reviews,0,0,0
1025173,True,0,No user reviews,0,0,0
1025180,True,0,No user reviews,0,0,0
1025200,True,0,No user reviews,0,0,0
1025220,True,0,No user reviews,0,0,0
1025230,True,0,No user reviews,0,0,0
1025240,True,0,2 user reviews,2,0,2
1025250,True,7,Positive,18,3,21
1025260,True,0,No user reviews,0,0,0
1025270,True,0,1 user reviews,0,1,1
1025280,True,0,1 user reviews,1,0,1
1025290,True,0,1 user reviews,1,0,1
1025320,True,0,No user reviews,0,0,0
1025330,True,0,No user reviews,0,0,0
1025340,True,5,Mixed,17,8,25
1025360,True,0,1 user reviews,1,0,1
1025370,True,0,No user reviews,0,0,0
1025380,True,0,No user reviews,0,0,0
1025390,True,0,No user reviews,0,0,0
1025400,True,0,No user reviews,0,0,0
1025410,True,6,Mostly Positive,47,12,59
1025420,True,0,1 user reviews,1,0,1
1025430,True,0,1 user reviews,0,1,1
1025440,True,8,Very Positive,260,48,308
1025450,True,0,1 user reviews,0,1,1
1025460,True,0,7 user reviews,7,0,7
1025480,True,0,4 user reviews,4,0,4
1025490,True,0,No user reviews,0,0,0
1025510,True,0,2 user reviews,1,1,2
1025520,True,0,1 user reviews,1,0,1
1025530,True,0,4 user reviews,2,2,4
1025540,True,0,3 user reviews,2,1,3
1025550,True,0,2 user reviews,1,1,2
1025560,True,0,No user reviews,0,0,0
1025570,True,0,No user reviews,0,0,0
1025590,True,0,9 user reviews,8,1,9
1025600,True,8,Very Positive,595,116,711
1025620,True,0,No user reviews,0,0,0
1025640,True,0,No user reviews,0,0,0
1025650,True,0,1 user reviews,0,1,1
1025660,True,0,No user reviews,0,0,0
1025680,True,0,No user reviews,0,0,0
1025690,True,0,No user reviews,0,0,0
1025700,True,0,No user reviews,0,0,0
1025710,True,0,No user reviews,0,0,0
1025720,True,0,No user reviews,0,0,0
1025730,True,0,No user reviews,0,0,0
1025740,True,4,Mostly Negative,4,7,11
1025780,True,0,No user reviews,0,0,0
1025820,True,0,No user reviews,0,0,0
1025870,True,0,4 user reviews,0,4,4
1025890,True,0,1 user reviews,1,0,1
1025900,True,0,No user reviews,0,0,0
1025910,True,0,No user reviews,0,0,0
1025990,True,0,1 user reviews,1,0,1
1026000,True,0,No user reviews,0,0,0
1026010,True,0,3 user reviews,3,0,3
1026020,True,0,2 user reviews,2,0,2
1026050,True,0,No user reviews,0,0,0
1026060,True,0,1 user reviews,0,1,1
1026070,True,0,6 user reviews,5,1,6
1026080,True,0,4 user reviews,2,2,4
1026090,True,0,1 user reviews,1,0,1
1026110,True,0,No user reviews,0,0,0
1026130,True,7,Positive,27,2,29
1026140,True,0,No user reviews,0,0,0
1026150,True,0,No user reviews,0,0,0
1026160,True,8,Very Positive,47,8,55
1026170,True,0,No user reviews,0,0,0
1026171,True,0,2 user reviews,2,0,2
1026180,True,0,No user reviews,0,0,0
1026200,True,5,Mixed,16,9,25
1026210,True,0,1 user reviews,0,1,1
1026220,True,0,No user reviews,0,0,0
1026240,True,0,No user reviews,0,0,0
1026340,True,0,No user reviews,0,0,0
1026370,True,0,8 user reviews,8,0,8
1026380,True,7,Positive,10,2,12
1026390,True,0,6 user reviews,5,1,6
1026400,True,8,Very Positive,64,1,65
1026420,True,6,Mostly Positive,136,40,176
1026430,True,0,3 user reviews,3,0,3
1026450,True,0,No user reviews,0,0,0
1026460,True,0,No user reviews,0,0,0
1026520,True,0,No user reviews,0,0,0
1026560,True,0,2 user reviews,2,0,2
1026570,True,0,No user reviews,0,0,0
1026610,True,0,7 user reviews,7,0,7
1026630,True,0,No user reviews,0,0,0
1026631,True,0,No user reviews,0,0,0
1026640,True,0,No user reviews,0,0,0
1026650,True,0,No user reviews,0,0,0
1026651,True,0,No user reviews,0,0,0
1026660,True,0,No user reviews,0,0,0
1026670,True,0,3 user reviews,3,0,3
1026680,True,5,Mixed,580,343,923
1026700,True,0,No user reviews,0,0,0
1026720,True,0,No user reviews,0,0,0
1026740,True,0,3 user reviews,2,1,3
1026750,True,0,1 user reviews,1,0,1
1026760,True,0,No user reviews,0,0,0
1026770,True,0,4 user reviews,1,3,4
1026800,True,0,1 user reviews,1,0,1
1026810,True,0,No user reviews,0,0,0
1026820,True,0,4 user reviews,4,0,4
1026840,True,0,No user reviews,0,0,0
1026880,True,0,4 user reviews,4,0,4
1026910,True,0,1 user reviews,1,0,1
1026930,True,0,No user reviews,0,0,0
1026940,True,0,3 user reviews,3,0,3
1026960,True,0,8 user reviews,4,4,8
1026970,True,5,Mixed,11,5,16
1026990,True,0,No user reviews,0,0,0
1027040,True,0,No user reviews,0,0,0
1027060,True,0,No user reviews,0,0,0
1027120,True,0,No user reviews,0,0,0
1027130,True,5,Mixed,8,4,12
1027140,True,0,5 user reviews,3,2,5
1027150,True,0,No user reviews,0,0,0
1027190,True,7,Positive,14,1,15
1027230,True,0,4 user reviews,4,0,4
1027250,True,7,Positive,28,5,33
1027280,True,0,No user reviews,0,0,0
1027290,True,0,No user reviews,0,0,0
1027480,True,0,No user reviews,0,0,0
1027520,True,0,4 user reviews,2,2,4
1027530,True,0,1 user reviews,0,1,1
1027550,True,0,No user reviews,0,0,0
1027570,True,0,No user reviews,0,0,0
1027580,True,0,No user reviews,0,0,0
1027590,True,0,No user reviews,0,0,0
1027600,True,5,Mixed,7,4,11
1027610,True,0,1 user reviews,1,0,1
1027620,True,7,Positive,42,1,43
1027630,True,0,No user reviews,0,0,0
1027640,True,0,No user reviews,0,0,0
1027650,True,0,No user reviews,0,0,0
1027660,True,0,No user reviews,0,0,0
1027670,True,0,No user reviews,0,0,0
1027690,True,0,1 user reviews,0,1,1
1027700,True,0,No user reviews,0,0,0
1027710,True,0,No user reviews,0,0,0
1027720,True,0,4 user reviews,4,0,4
1027740,True,0,No user reviews,0,0,0
1027760,True,0,No user reviews,0,0,0
1027780,True,0,No user reviews,0,0,0
1027790,True,0,1 user reviews,1,0,1
1027800,True,0,3 user reviews,2,1,3
1027810,True,0,No user reviews,0,0,0
1027830,True,0,1 user reviews,1,0,1
1027880,True,0,4 user reviews,4,0,4
1027900,True,0,5 user reviews,5,0,5
1027910,True,0,No user reviews,0,0,0
1027920,True,0,No user reviews,0,0,0
1027930,True,0,1 user reviews,1,0,1
1027940,True,0,No user reviews,0,0,0
1027950,True,0,No user reviews,0,0,0
1027960,True,0,2 user reviews,1,1,2
1027970,True,6,Mostly Positive,9,3,12
1027990,True,0,2 user reviews,2,0,2
1028010,True,0,1 user reviews,1,0,1
1028030,True,0,1 user reviews,1,0,1
1028070,True,0,No user reviews,0,0,0
1028110,True,0,2 user reviews,0,2,2
1028120,True,0,2 user reviews,2,0,2
1028130,True,5,Mixed,12,7,19
1028160,True,0,2 user reviews,0,2,2
1028170,True,0,No user reviews,0,0,0
1028190,True,0,No user reviews,0,0,0
1028210,True,8,Very Positive,55,5,60
1028240,True,0,1 user reviews,0,1,1
1028250,True,0,2 user reviews,2,0,2
1028260,True,0,No user reviews,0,0,0
1028270,True,8,Very Positive,50,6,56
1028280,True,0,No user reviews,0,0,0
1028290,True,0,2 user reviews,2,0,2
1028300,True,7,Positive,11,0,11
1028310,True,0,No user reviews,0,0,0
1028320,True,0,No user reviews,0,0,0
1028330,True,0,No user reviews,0,0,0
1028340,True,0,6 user reviews,5,1,6
1028350,True,0,No user reviews,0,0,0
1028360,True,0,1 user reviews,0,1,1
1028380,True,0,No user reviews,0,0,0
1028400,True,0,No user reviews,0,0,0
1028410,True,0,1 user reviews,0,1,1
1028420,True,7,Positive,19,0,19
1028430,True,5,Mixed,81,75,156
1028440,True,5,Mixed,21,10,31
1028450,True,0,No user reviews,0,0,0
1028460,True,0,2 user reviews,2,0,2
1028470,True,0,No user reviews,0,0,0
1028480,True,0,2 user reviews,2,0,2
1028490,True,0,5 user reviews,4,1,5
1028500,True,0,7 user reviews,7,0,7
1028510,True,0,No user reviews,0,0,0
1028520,True,0,8 user reviews,6,2,8
1028530,True,7,Positive,27,0,27
1028540,True,0,No user reviews,0,0,0
1028550,True,0,2 user reviews,2,0,2
1028570,True,8,Very Positive,109,13,122
1028580,True,0,No user reviews,0,0,0
1028610,True,0,1 user reviews,0,1,1
1028630,True,8,Very Positive,804,89,893
1028650,True,0,No user reviews,0,0,0
1028660,True,0,1 user reviews,1,0,1
1028670,True,0,No user reviews,0,0,0
1028680,True,0,No user reviews,0,0,0
1028700,True,0,No user reviews,0,0,0
1028701,True,0,No user reviews,0,0,0
1028702,True,7,Positive,11,0,11
1028703,True,0,9 user reviews,9,0,9
1028704,True,0,5 user reviews,5,0,5
1028710,True,0,1 user reviews,1,0,1
1028711,True,0,2 user reviews,2,0,2
1028712,True,0,1 user reviews,1,0,1
1028720,True,0,1 user reviews,1,0,1
1028721,True,0,No user reviews,0,0,0
1028730,True,6,Mostly Positive,11,4,15
1028740,True,5,Mixed,6,7,13
1028750,True,0,No user reviews,0,0,0
1028760,True,0,2 user reviews,1,1,2
1028770,True,0,4 user reviews,1,3,4
1028780,True,0,1 user reviews,0,1,1
1028790,True,0,No user reviews,0,0,0
1028791,True,0,No user reviews,0,0,0
1028792,True,0,No user reviews,0,0,0
1028793,True,0,No user reviews,0,0,0
1028794,True,0,No user reviews,0,0,0
1028795,True,0,No user reviews,0,0,0
1028800,True,5,Mixed,9,5,14
1028820,True,0,2 user reviews,1,1,2
1028830,True,0,No user reviews,0,0,0
1028840,True,0,4 user reviews,2,2,4
1028850,True,0,4 user reviews,4,0,4
1028860,True,0,No user reviews,0,0,0
1028880,True,0,No user reviews,0,0,0
1028890,True,0,9 user reviews,7,2,9
1028891,True,0,3 user reviews,3,0,3
1028892,True,0,6 user reviews,1,5,6
1028893,True,0,1 user reviews,0,1,1
1028894,True,0,5 user reviews,3,2,5
1028895,True,0,9 user reviews,6,3,9
1028900,True,0,1 user reviews,1,0,1
1028910,True,0,No user reviews,0,0,0
1028920,True,7,Positive,9,1,10
1028930,True,0,No user reviews,0,0,0
1028960,True,0,No user reviews,0,0,0
1028970,True,0,No user reviews,0,0,0
1028990,True,0,1 user reviews,0,1,1
1029000,True,7,Positive,13,1,14
1029020,True,0,1 user reviews,1,0,1
1029030,True,0,No user reviews,0,0,0
1029040,True,7,Positive,8,2,10
1029050,True,0,3 user reviews,2,1,3
1029070,True,0,6 user reviews,4,2,6
1029080,True,0,5 user reviews,5,0,5
1029090,True,0,6 user reviews,3,3,6
1029100,True,6,Mostly Positive,13,5,18
1029110,True,0,No user reviews,0,0,0
1029120,True,0,No user reviews,0,0,0
1029130,True,7,Positive,15,0,15
1029150,True,0,6 user reviews,5,1,6
1029160,True,0,6 user reviews,5,1,6
1029170,True,7,Positive,21,1,22
1029190,True,0,No user reviews,0,0,0
1029200,True,0,No user reviews,0,0,0
1029210,True,0,No user reviews,0,0,0
1029220,True,0,4 user reviews,4,0,4
1029230,True,0,No user reviews,0,0,0
1029240,True,5,Mixed,53,23,76
1029280,True,0,No user reviews,0,0,0
1029290,True,0,No user reviews,0,0,0
1029300,True,0,1 user reviews,1,0,1
1029301,True,0,No user reviews,0,0,0
1029310,True,0,No user reviews,0,0,0
1029311,True,0,1 user reviews,1,0,1
1029312,True,0,No user reviews,0,0,0
1029320,True,7,Positive,25,0,25
1029321,True,0,1 user reviews,1,0,1
1029322,True,0,1 user reviews,1,0,1
1029323,True,0,2 user reviews,2,0,2
1029330,True,0,6 user reviews,6,0,6
1029331,True,7,Positive,17,1,18
1029340,True,0,6 user reviews,6,0,6
1029350,True,0,1 user reviews,1,0,1
1029351,True,0,No user reviews,0,0,0
1029352,True,0,No user reviews,0,0,0
1029360,True,0,3 user reviews,3,0,3
1029361,True,0,No user reviews,0,0,0
1029362,True,0,No user reviews,0,0,0
1029370,True,0,No user reviews,0,0,0
1029371,True,0,2 user reviews,2,0,2
1029372,True,0,2 user reviews,2,0,2
1029380,True,7,Positive,16,0,16
1029390,True,0,1 user reviews,1,0,1
1029391,True,0,2 user reviews,1,1,2
1029392,True,0,1 user reviews,1,0,1
1029400,True,0,1 user reviews,1,0,1
1029401,True,0,No user reviews,0,0,0
1029402,True,0,No user reviews,0,0,0
1029410,True,0,No user reviews,0,0,0
1029411,True,0,No user reviews,0,0,0
1029412,True,0,4 user reviews,4,0,4
1029430,True,0,No user reviews,0,0,0
1029431,True,0,2 user reviews,2,0,2
1029432,True,0,No user reviews,0,0,0
1029440,True,0,No user reviews,0,0,0
1029441,True,0,No user reviews,0,0,0
1029450,True,0,4 user reviews,4,0,4
1029451,True,0,No user reviews,0,0,0
1029470,True,0,No user reviews,0,0,0
1029480,True,0,No user reviews,0,0,0
1029481,True,0,No user reviews,0,0,0
1029500,True,0,No user reviews,0,0,0
1029530,True,0,2 user reviews,1,1,2
1029540,True,0,No user reviews,0,0,0
1029550,True,6,Mostly Positive,113,35,148
1029560,True,0,1 user reviews,1,0,1
1029570,True,7,Positive,28,4,32
1029590,True,0,No user reviews,0,0,0
1029630,True,5,Mixed,203,145,348
1029640,True,0,No user reviews,0,0,0
1029650,True,0,No user reviews,0,0,0
1029660,True,0,4 user reviews,1,3,4
1029680,True,0,No user reviews,0,0,0
1029720,True,0,5 user reviews,4,1,5
1029730,True,5,Mixed,9,7,16
1029750,True,0,No user reviews,0,0,0
1029760,True,7,Positive,28,2,30
1029770,True,0,No user reviews,0,0,0
1029780,True,0,No user reviews,0,0,0
1029790,True,0,2 user reviews,2,0,2
1029810,True,0,2 user reviews,2,0,2
1029820,True,0,No user reviews,0,0,0
1029830,True,0,No user reviews,0,0,0
1029840,True,0,No user reviews,0,0,0
1029860,True,7,Positive,12,1,13
1029870,True,7,Positive,9,2,11
1029880,True,0,No user reviews,0,0,0
1029890,True,6,Mostly Positive,332,132,464
1029900,True,6,Mostly Positive,14,4,18
1029920,True,0,3 user reviews,2,1,3
1029930,True,0,No user reviews,0,0,0
1029940,True,0,No user reviews,0,0,0
1029950,True,0,No user reviews,0,0,0
1029960,True,0,No user reviews,0,0,0
1029970,True,0,No user reviews,0,0,0
1029980,True,8,Very Positive,66,8,74
1029990,True,6,Mostly Positive,23,9,32
1030050,True,0,1 user reviews,0,1,1
1030060,True,0,No user reviews,0,0,0
1030070,True,0,No user reviews,0,0,0
1030090,True,0,1 user reviews,0,1,1
1030100,True,0,No user reviews,0,0,0
1030130,True,0,No user reviews,0,0,0
1030160,True,0,No user reviews,0,0,0
1030170,True,0,2 user reviews,2,0,2
1030180,True,0,3 user reviews,1,2,3
1030190,True,0,4 user reviews,3,1,4
1030210,True,5,Mixed,1548,1298,2846
1030220,True,0,No user reviews,0,0,0
1030221,True,0,No user reviews,0,0,0
1030222,True,0,No user reviews,0,0,0
1030223,True,0,3 user reviews,2,1,3
1030230,True,0,2 user reviews,1,1,2
1030240,True,0,No user reviews,0,0,0
1030270,True,7,Positive,10,0,10
1030300,True,0,No user reviews,0,0,0
1030330,True,0,1 user reviews,0,1,1
1030360,True,0,6 user reviews,5,1,6
1030370,True,0,No user reviews,0,0,0
1030380,True,0,5 user reviews,1,4,5
1030400,True,0,No user reviews,0,0,0
1030401,True,0,No user reviews,0,0,0
1030402,True,0,No user reviews,0,0,0
1030410,True,5,Mixed,8,6,14
1030430,True,0,8 user reviews,8,0,8
1030460,True,0,No user reviews,0,0,0
1030470,True,7,Positive,15,1,16
1030490,True,0,3 user reviews,3,0,3
1030500,True,6,Mostly Positive,19,6,25
1030520,True,0,No user reviews,0,0,0
1030530,True,0,2 user reviews,2,0,2
1030560,True,0,No user reviews,0,0,0
1030563,True,0,1 user reviews,1,0,1
1030570,True,0,No user reviews,0,0,0
1030580,True,8,Very Positive,47,11,58
1030590,True,0,1 user reviews,1,0,1
1030730,True,0,No user reviews,0,0,0
1030740,True,0,No user reviews,0,0,0
1030760,True,0,1 user reviews,0,1,1
1030770,True,0,No user reviews,0,0,0
1030780,True,0,No user reviews,0,0,0
1030800,True,0,No user reviews,0,0,0
1030810,True,0,No user reviews,0,0,0
1030830,True,5,Mixed,893,486,1379
1030840,True,8,Very Positive,4250,606,4856
1030950,True,4,Mostly Negative,4,7,11
1030960,True,0,7 user reviews,7,0,7
1030970,True,0,1 user reviews,1,0,1
1030980,True,0,1 user reviews,1,0,1
1031020,True,7,Positive,25,4,29
1031030,True,0,No user reviews,0,0,0
1031060,True,0,No user reviews,0,0,0
1031090,True,0,No user reviews,0,0,0
1031110,True,0,No user reviews,0,0,0
1031120,True,0,No user reviews,0,0,0
1031130,True,0,2 user reviews,1,1,2
1031140,True,0,No user reviews,0,0,0
1031150,True,0,No user reviews,0,0,0
1031160,True,0,No user reviews,0,0,0
1031170,True,6,Mostly Positive,29,10,39
1031190,True,0,No user reviews,0,0,0
1031200,True,0,2 user reviews,0,2,2
1031210,True,0,3 user reviews,3,0,3
1031220,True,0,2 user reviews,1,1,2
1031230,True,0,1 user reviews,0,1,1
1031260,True,0,3 user reviews,2,1,3
1031270,True,0,No user reviews,0,0,0
1031290,True,0,No user reviews,0,0,0
1031300,True,0,1 user reviews,1,0,1
1031310,True,0,3 user reviews,1,2,3
1031320,True,0,1 user reviews,1,0,1
1031330,True,0,1 user reviews,1,0,1
1031340,True,0,No user reviews,0,0,0
1031370,True,0,No user reviews,0,0,0
1031380,True,0,No user reviews,0,0,0
1031410,True,0,No user reviews,0,0,0
1031420,True,0,3 user reviews,3,0,3
1031421,True,0,2 user reviews,2,0,2
1031430,True,0,No user reviews,0,0,0
1031440,True,7,Positive,44,4,48
1031450,True,0,No user reviews,0,0,0
1031460,True,0,No user reviews,0,0,0
1031470,True,0,1 user reviews,0,1,1
1031480,True,8,Very Positive,122,1,123
1031500,True,8,Very Positive,163,3,166
1031510,True,8,Very Positive,51,1,52
1031520,True,0,No user reviews,0,0,0
1031530,True,0,No user reviews,0,0,0
1031540,True,0,9 user reviews,5,4,9
1031550,True,0,5 user reviews,5,0,5
1031560,True,0,No user reviews,0,0,0
1031570,True,0,5 user reviews,3,2,5
1031580,True,0,2 user reviews,2,0,2
1031590,True,0,1 user reviews,0,1,1
1031600,True,0,No user reviews,0,0,0
1031620,True,0,No user reviews,0,0,0
1031630,True,0,1 user reviews,1,0,1
1031640,True,0,4 user reviews,3,1,4
1031650,True,0,4 user reviews,3,1,4
1031660,True,0,2 user reviews,0,2,2
1031670,True,0,No user reviews,0,0,0
1031680,True,0,No user reviews,0,0,0
1031690,True,0,No user reviews,0,0,0
1031700,True,0,No user reviews,0,0,0
1031720,True,0,No user reviews,0,0,0
1031740,True,0,No user reviews,0,0,0
1031750,True,0,No user reviews,0,0,0
1031770,True,0,1 user reviews,1,0,1
1031790,True,7,Positive,28,4,32
1031800,True,0,1 user reviews,0,1,1
1031810,True,0,4 user reviews,2,2,4
1031830,True,0,2 user reviews,2,0,2
1031840,True,0,4 user reviews,3,1,4
1031850,True,0,No user reviews,0,0,0
1031910,True,0,1 user reviews,1,0,1
1031920,True,5,Mixed,11,5,16
1031940,True,0,No user reviews,0,0,0
1031950,True,0,No user reviews,0,0,0
1031980,True,0,No user reviews,0,0,0
1032030,True,0,No user reviews,0,0,0
1032040,True,0,1 user reviews,1,0,1
1032050,True,0,9 user reviews,9,0,9
1032060,True,0,No user reviews,0,0,0
1032070,True,0,4 user reviews,4,0,4
1032080,True,0,No user reviews,0,0,0
1032090,True,0,No user reviews,0,0,0
1032120,True,0,No user reviews,0,0,0
1032140,True,0,No user reviews,0,0,0
1032170,True,7,Positive,24,3,27
1032190,True,0,No user reviews,0,0,0
1032200,True,0,No user reviews,0,0,0
1032210,True,0,No user reviews,0,0,0
1032220,True,0,No user reviews,0,0,0
1032230,True,0,2 user reviews,2,0,2
1032240,True,0,3 user reviews,2,1,3
1032260,True,0,1 user reviews,0,1,1
1032270,True,0,1 user reviews,0,1,1
1032280,True,0,No user reviews,0,0,0
1032290,True,0,2 user reviews,2,0,2
1032300,True,0,No user reviews,0,0,0
1032330,True,0,3 user reviews,3,0,3
1032340,True,0,9 user reviews,7,2,9
1032360,True,0,No user reviews,0,0,0
1032370,True,5,Mixed,29,13,42
1032390,True,0,8 user reviews,8,0,8
1032410,True,0,4 user reviews,3,1,4
1032420,True,0,No user reviews,0,0,0
1032430,True,5,Mixed,328,190,518
1032440,True,0,1 user reviews,1,0,1
1032450,True,0,4 user reviews,4,0,4
1032460,True,0,No user reviews,0,0,0
1032490,True,0,No user reviews,0,0,0
1032510,True,0,No user reviews,0,0,0
1032520,True,0,No user reviews,0,0,0
1032530,True,0,No user reviews,0,0,0
1032550,True,0,No user reviews,0,0,0
1032560,True,0,2 user reviews,2,0,2
1032570,True,0,3 user reviews,1,2,3
1032580,True,0,3 user reviews,3,0,3
1032590,True,7,Positive,23,1,24
1032600,True,0,No user reviews,0,0,0
1032650,True,0,No user reviews,0,0,0
1032660,True,0,No user reviews,0,0,0
1032670,True,7,Positive,42,7,49
1032730,True,8,Very Positive,69,7,76
1032740,True,0,No user reviews,0,0,0
1032750,True,0,No user reviews,0,0,0
1032760,True,0,7 user reviews,4,3,7
1032770,True,0,No user reviews,0,0,0
1032790,True,8,Very Positive,43,8,51
1032800,True,0,No user reviews,0,0,0
1032801,True,0,No user reviews,0,0,0
1032830,True,7,Positive,23,1,24
1032990,True,0,No user reviews,0,0,0
1033000,True,0,No user reviews,0,0,0
1033030,True,0,No user reviews,0,0,0
1033040,True,0,No user reviews,0,0,0
1033060,True,4,Mostly Negative,305,602,907
1033070,True,0,3 user reviews,3,0,3
1033080,True,0,No user reviews,0,0,0
1033090,True,0,1 user reviews,1,0,1
1033100,True,0,No user reviews,0,0,0
1033110,True,0,2 user reviews,0,2,2
1033120,True,5,Mixed,7,10,17
1033130,True,0,No user reviews,0,0,0
1033140,True,0,No user reviews,0,0,0
1033150,True,0,No user reviews,0,0,0
1033170,True,8,Very Positive,53,13,66
1033180,True,0,No user reviews,0,0,0
1033190,True,0,No user reviews,0,0,0
1033200,True,0,No user reviews,0,0,0
1033210,True,0,9 user reviews,8,1,9
1033220,True,6,Mostly Positive,18,6,24
1033230,True,0,1 user reviews,1,0,1
1033240,True,0,5 user reviews,3,2,5
1033250,True,0,1 user reviews,0,1,1
1033330,True,0,3 user reviews,1,2,3
1033340,True,0,4 user reviews,4,0,4
1033360,True,0,1 user reviews,1,0,1
1033370,True,0,No user reviews,0,0,0
1033380,True,0,No user reviews,0,0,0
1033410,True,7,Positive,34,3,37
1033420,True,8,Very Positive,50,1,51
1033450,True,0,7 user reviews,4,3,7
1033460,True,0,4 user reviews,3,1,4
1033470,True,0,1 user reviews,1,0,1
1033471,True,0,1 user reviews,1,0,1
1033472,True,0,2 user reviews,2,0,2
1033473,True,0,1 user reviews,1,0,1
1033474,True,0,2 user reviews,2,0,2
1033475,True,0,2 user reviews,1,1,2
1033476,True,0,2 user reviews,2,0,2
1033477,True,0,3 user reviews,2,1,3
1033478,True,0,3 user reviews,2,1,3
1033479,True,0,2 user reviews,1,1,2
1033480,True,0,No user reviews,0,0,0
1033481,True,0,No user reviews,0,0,0
1033482,True,0,1 user reviews,0,1,1
1033483,True,0,1 user reviews,1,0,1
1033484,True,0,1 user reviews,1,0,1
1033485,True,0,1 user reviews,0,1,1
1033486,True,0,1 user reviews,1,0,1
1033487,True,0,1 user reviews,1,0,1
1033488,True,0,1 user reviews,1,0,1
1033489,True,0,1 user reviews,0,1,1
1033490,True,7,Positive,25,2,27
1033500,True,0,No user reviews,0,0,0
1033501,True,0,No user reviews,0,0,0
1033502,True,0,No user reviews,0,0,0
1033503,True,0,1 user reviews,1,0,1
1033510,True,0,4 user reviews,2,2,4
1033520,True,0,No user reviews,0,0,0
1033521,True,0,No user reviews,0,0,0
1033522,True,0,No user reviews,0,0,0
1033530,True,7,Positive,16,4,20
1033540,True,0,No user reviews,0,0,0
1033550,True,0,No user reviews,0,0,0
1033580,True,0,5 user reviews,5,0,5
1033590,True,0,No user reviews,0,0,0
1033600,True,0,No user reviews,0,0,0
1033620,True,0,No user reviews,0,0,0
1033621,True,0,No user reviews,0,0,0
1033630,True,0,No user reviews,0,0,0
1033640,True,4,Mostly Negative,4,11,15
1033660,True,0,No user reviews,0,0,0
1033670,True,0,No user reviews,0,0,0
1033700,True,0,No user reviews,0,0,0
1033710,True,0,2 user reviews,1,1,2
1033720,True,0,5 user reviews,0,5,5
1033760,True,0,No user reviews,0,0,0
1033780,True,7,Positive,16,1,17
1033790,True,0,3 user reviews,3,0,3
1033800,True,0,No user reviews,0,0,0
1033810,True,0,No user reviews,0,0,0
1033820,True,0,No user reviews,0,0,0
1033840,True,0,No user reviews,0,0,0
1033860,True,0,3 user reviews,0,3,3
1033870,True,0,No user reviews,0,0,0
1033880,True,8,Very Positive,82,12,94
1033890,True,5,Mixed,180,130,310
1033900,True,0,No user reviews,0,0,0
1033910,True,0,7 user reviews,3,4,7
1033920,True,0,1 user reviews,1,0,1
1033930,True,0,No user reviews,0,0,0
1033950,True,0,No user reviews,0,0,0
1033960,True,0,No user reviews,0,0,0
1034000,True,0,No user reviews,0,0,0
1034010,True,0,No user reviews,0,0,0
1034030,True,0,3 user reviews,3,0,3
1034040,True,0,No user reviews,0,0,0
1034060,True,5,Mixed,6,4,10
1034070,True,0,No user reviews,0,0,0
1034080,True,0,No user reviews,0,0,0
1034090,True,0,No user reviews,0,0,0
1034100,True,0,No user reviews,0,0,0
1034120,True,0,4 user reviews,2,2,4
1034130,True,0,2 user reviews,1,1,2
1034140,True,0,No user reviews,0,0,0
1034160,True,5,Mixed,6,4,10
1034180,True,0,No user reviews,0,0,0
1034200,True,0,No user reviews,0,0,0
1034230,True,0,3 user reviews,2,1,3
1034240,True,0,5 user reviews,4,1,5
1034250,True,0,4 user reviews,2,2,4
1034260,True,0,2 user reviews,1,1,2
1034270,True,0,2 user reviews,2,0,2
1034280,True,0,5 user reviews,4,1,5
1034290,True,0,No user reviews,0,0,0
1034291,True,0,3 user reviews,3,0,3
1034292,True,0,No user reviews,0,0,0
1034370,True,0,3 user reviews,2,1,3
1034380,True,0,2 user reviews,1,1,2
1034390,True,0,1 user reviews,1,0,1
1034400,True,0,5 user reviews,4,1,5
1034410,True,0,5 user reviews,3,2,5
1034430,True,0,No user reviews,0,0,0
1034440,True,0,No user reviews,0,0,0
1034450,True,0,3 user reviews,3,0,3
1034460,True,0,No user reviews,0,0,0
1034471,True,0,4 user reviews,3,1,4
1034480,True,0,3 user reviews,3,0,3
1034490,True,0,No user reviews,0,0,0
1034500,True,0,No user reviews,0,0,0
1034510,True,0,3 user reviews,3,0,3
1034511,True,0,3 user reviews,3,0,3
1034540,True,0,9 user reviews,7,2,9
1034550,True,0,2 user reviews,2,0,2
1034560,True,0,6 user reviews,5,1,6
1034580,True,0,No user reviews,0,0,0
1034590,True,0,No user reviews,0,0,0
1034610,True,0,No user reviews,0,0,0
1034630,True,0,No user reviews,0,0,0
1034640,True,0,No user reviews,0,0,0
1034680,True,0,No user reviews,0,0,0
1034700,True,6,Mostly Positive,139,36,175
1034740,True,0,No user reviews,0,0,0
1034750,True,7,Positive,22,5,27
1034760,True,0,No user reviews,0,0,0
1034770,True,0,No user reviews,0,0,0
1034780,True,0,No user reviews,0,0,0
1034810,True,5,Mixed,10,5,15
1034820,True,0,1 user reviews,0,1,1
1034850,True,6,Mostly Positive,44,16,60
1034860,True,8,Very Positive,209,13,222
1034870,True,0,6 user reviews,5,1,6
1034880,True,0,No user reviews,0,0,0
1034890,True,7,Positive,21,2,23
1034900,True,8,Very Positive,225,11,236
1034910,True,8,Very Positive,72,11,83
1034920,True,0,9 user reviews,7,2,9
1034930,True,0,No user reviews,0,0,0
1034940,True,8,Very Positive,98,3,101
1034950,True,0,8 user reviews,8,0,8
1034970,True,6,Mostly Positive,7,3,10
1035000,True,0,No user reviews,0,0,0
1035010,True,7,Positive,15,3,18
1035020,True,0,9 user reviews,8,1,9
1035030,True,7,Positive,10,0,10
1035040,True,0,No user reviews,0,0,0
1035050,True,7,Positive,21,4,25
1035110,True,7,Positive,10,2,12
1035120,True,0,No user reviews,0,0,0
1035150,True,0,1 user reviews,0,1,1
1035180,True,0,No user reviews,0,0,0
1035190,True,0,4 user reviews,2,2,4
1035210,True,0,No user reviews,0,0,0
1035220,True,0,No user reviews,0,0,0
1035230,True,0,8 user reviews,8,0,8
1035240,True,0,No user reviews,0,0,0
1035260,True,0,1 user reviews,1,0,1
1035270,True,0,3 user reviews,1,2,3
1035280,True,0,No user reviews,0,0,0
1035300,True,0,No user reviews,0,0,0
1035310,True,0,9 user reviews,5,4,9
1035320,True,0,No user reviews,0,0,0
1035340,True,0,No user reviews,0,0,0
1035410,True,0,No user reviews,0,0,0
1035430,True,0,No user reviews,0,0,0
1035470,True,0,2 user reviews,2,0,2
1035480,True,0,No user reviews,0,0,0
1035490,True,0,1 user reviews,1,0,1
1035500,True,0,1 user reviews,0,1,1
1035510,True,7,Positive,32,2,34
1035520,True,0,No user reviews,0,0,0
1035530,True,0,6 user reviews,5,1,6
1035540,True,0,No user reviews,0,0,0
1035550,True,0,No user reviews,0,0,0
1035560,True,8,Very Positive,65,4,69
1035570,True,0,No user reviews,0,0,0
1035580,True,0,No user reviews,0,0,0
1035610,True,8,Very Positive,52,8,60
1035620,True,0,No user reviews,0,0,0
1035660,True,0,No user reviews,0,0,0
1035690,True,0,1 user reviews,1,0,1
1035700,True,0,4 user reviews,4,0,4
1035720,True,0,No user reviews,0,0,0
1035740,True,0,No user reviews,0,0,0
1035750,True,0,No user reviews,0,0,0
1035760,True,0,No user reviews,0,0,0
1035770,True,0,9 user reviews,8,1,9
1035790,True,0,1 user reviews,1,0,1
1035800,True,0,No user reviews,0,0,0
1035810,True,0,No user reviews,0,0,0
1035830,True,0,1 user reviews,0,1,1
1035840,True,0,No user reviews,0,0,0
1035850,True,7,Positive,22,0,22
1035860,True,0,1 user reviews,0,1,1
1035870,True,0,No user reviews,0,0,0
1035880,True,0,No user reviews,0,0,0
1035890,True,0,No user reviews,0,0,0
1035900,True,0,No user reviews,0,0,0
1035910,True,0,No user reviews,0,0,0
1035920,True,0,1 user reviews,1,0,1
1035930,True,7,Positive,14,1,15
1035950,True,7,Positive,31,2,33
1035960,True,0,No user reviews,0,0,0
1035990,True,0,No user reviews,0,0,0
1036000,True,0,1 user reviews,1,0,1
1036010,True,0,No user reviews,0,0,0
1036020,True,0,1 user reviews,1,0,1
1036030,True,0,No user reviews,0,0,0
1036080,True,0,No user reviews,0,0,0
1036112,True,0,No user reviews,0,0,0
1036114,True,0,No user reviews,0,0,0
1036116,True,0,No user reviews,0,0,0
1036117,True,0,No user reviews,0,0,0
1036120,True,0,2 user reviews,2,0,2
1036160,True,0,No user reviews,0,0,0
1036180,True,0,No user reviews,0,0,0
1036181,True,0,No user reviews,0,0,0
1036190,True,0,No user reviews,0,0,0
1036200,True,0,No user reviews,0,0,0
1036210,True,0,No user reviews,0,0,0
1036220,True,0,1 user reviews,1,0,1
1036260,True,7,Positive,13,3,16
1036270,True,0,No user reviews,0,0,0
1036310,True,0,No user reviews,0,0,0
1036320,True,0,1 user reviews,0,1,1
1036330,True,0,No user reviews,0,0,0
1036370,True,7,Positive,16,0,16
1036380,True,0,No user reviews,0,0,0
1036390,True,0,No user reviews,0,0,0
1036400,True,0,1 user reviews,0,1,1
1036410,True,0,No user reviews,0,0,0
1036420,True,0,6 user reviews,4,2,6
1036430,True,0,No user reviews,0,0,0
1036440,True,6,Mostly Positive,84,33,117
1036450,True,0,No user reviews,0,0,0
1036460,True,0,No user reviews,0,0,0
1036470,True,0,8 user reviews,6,2,8
1036480,True,7,Positive,9,2,11
1036490,True,7,Positive,19,0,19
1036510,True,0,No user reviews,0,0,0
1036530,True,0,No user reviews,0,0,0
1036550,True,0,2 user reviews,1,1,2
1036570,True,0,No user reviews,0,0,0
1036580,True,8,Very Positive,75,5,80
1036600,True,5,Mixed,6,4,10
1036620,True,0,No user reviews,0,0,0
1036650,True,0,No user reviews,0,0,0
1036660,True,7,Positive,16,3,19
1036700,True,7,Positive,41,2,43
1036750,True,7,Positive,21,4,25
1036760,True,7,Positive,32,7,39
1036770,True,0,1 user reviews,1,0,1
1036771,True,0,1 user reviews,1,0,1
1036780,True,0,2 user reviews,1,1,2
1036790,True,0,No user reviews,0,0,0
1036791,True,0,No user reviews,0,0,0
1036792,True,0,No user reviews,0,0,0
1036793,True,0,No user reviews,0,0,0
1036794,True,0,No user reviews,0,0,0
1036795,True,0,No user reviews,0,0,0
1036796,True,0,No user reviews,0,0,0
1036797,True,0,1 user reviews,1,0,1
1036798,True,0,1 user reviews,1,0,1
1036799,True,0,2 user reviews,2,0,2
1036800,True,0,3 user reviews,1,2,3
1036810,True,0,No user reviews,0,0,0
1036820,True,0,7 user reviews,4,3,7
1036840,True,0,4 user reviews,2,2,4
1036850,True,0,No user reviews,0,0,0
1036870,True,0,3 user reviews,2,1,3
1036890,True,0,No user reviews,0,0,0
1036900,True,0,2 user reviews,2,0,2
1036910,True,5,Mixed,9,5,14
1036920,True,0,3 user reviews,1,2,3
1036930,True,0,No user reviews,0,0,0
1036940,True,0,No user reviews,0,0,0
1036950,True,0,8 user reviews,8,0,8
1036960,True,0,No user reviews,0,0,0
1036970,True,7,Positive,8,2,10
1036980,True,6,Mostly Positive,20,8,28
1036990,True,0,6 user reviews,5,1,6
1037000,True,0,No user reviews,0,0,0
1037010,True,0,4 user reviews,3,1,4
1037020,True,8,Very Positive,452,32,484
1037040,True,0,No user reviews,0,0,0
1037050,True,0,5 user reviews,4,1,5
1037060,True,0,No user reviews,0,0,0
1037080,True,0,No user reviews,0,0,0
1037090,True,0,2 user reviews,2,0,2
1037100,True,7,Positive,8,2,10
1037120,True,0,No user reviews,0,0,0
1037130,True,0,No user reviews,0,0,0
1037140,True,0,2 user reviews,1,1,2
1037150,True,0,No user reviews,0,0,0
1037190,True,8,Very Positive,50,0,50
1037200,True,7,Positive,11,2,13
1037220,True,0,No user reviews,0,0,0
1037240,True,0,No user reviews,0,0,0
1037260,True,0,1 user reviews,0,1,1
1037270,True,0,No user reviews,0,0,0
1037300,True,0,No user reviews,0,0,0
1037330,True,0,2 user reviews,0,2,2
1037340,True,0,1 user reviews,0,1,1
1037350,True,0,4 user reviews,1,3,4
1037360,True,0,No user reviews,0,0,0
1037370,True,0,No user reviews,0,0,0
1037380,True,0,No user reviews,0,0,0
1037390,True,0,No user reviews,0,0,0
1037410,True,0,No user reviews,0,0,0
1037420,True,0,2 user reviews,2,0,2
1037430,True,0,1 user reviews,1,0,1
1037450,True,0,No user reviews,0,0,0
1037451,True,0,No user reviews,0,0,0
1037460,True,0,No user reviews,0,0,0
1037470,True,0,No user reviews,0,0,0
1037480,True,7,Positive,42,2,44
1037490,True,0,No user reviews,0,0,0
1037510,True,0,No user reviews,0,0,0
1037560,True,6,Mostly Positive,62,19,81
1037570,True,6,Mostly Positive,27,11,38
1037580,True,0,No user reviews,0,0,0
1037590,True,8,Very Positive,194,29,223
1037600,True,0,No user reviews,0,0,0
1037620,True,0,No user reviews,0,0,0
1037690,True,0,9 user reviews,9,0,9
1037750,True,6,Mostly Positive,27,7,34
1037760,True,6,Mostly Positive,15,5,20
1037810,True,0,No user reviews,0,0,0
1037820,True,5,Mixed,7,4,11
1037830,True,0,1 user reviews,1,0,1
1037840,True,0,3 user reviews,1,2,3
1037850,True,0,1 user reviews,1,0,1
1037860,True,0,No user reviews,0,0,0
1037870,True,0,No user reviews,0,0,0
1037890,True,7,Positive,9,2,11
1037900,True,0,No user reviews,0,0,0
1037910,True,0,No user reviews,0,0,0
1037930,True,0,1 user reviews,0,1,1
1037940,True,7,Positive,24,6,30
1037950,True,0,No user reviews,0,0,0
1037960,True,5,Mixed,21,19,40
1037970,True,0,3 user reviews,2,1,3
1037980,True,0,No user reviews,0,0,0
1037990,True,8,Very Positive,46,8,54
1038000,True,7,Positive,17,1,18
1038030,True,0,No user reviews,0,0,0
1038040,True,0,No user reviews,0,0,0
1038060,True,0,No user reviews,0,0,0
1038070,True,0,No user reviews,0,0,0
1038090,True,0,No user reviews,0,0,0
1038100,True,0,8 user reviews,7,1,8
1038110,True,0,No user reviews,0,0,0
1038120,True,0,1 user reviews,1,0,1
1038240,True,5,Mixed,7,8,15
1038250,True,0,No user reviews,0,0,0
1038260,True,0,1 user reviews,1,0,1
1038270,True,0,No user reviews,0,0,0
1038280,True,8,Very Positive,47,4,51
1038300,True,7,Positive,19,1,20
1038370,True,8,Very Positive,307,17,324
1038380,True,0,4 user reviews,4,0,4
1038400,True,0,2 user reviews,2,0,2
1038410,True,0,No user reviews,0,0,0
1038420,True,0,No user reviews,0,0,0
1038430,True,0,1 user reviews,1,0,1
1038440,True,0,No user reviews,0,0,0
1038450,True,5,Mixed,306,242,548
1038500,True,7,Positive,13,2,15
1038510,True,0,1 user reviews,1,0,1
1038530,True,0,No user reviews,0,0,0
1038550,True,0,No user reviews,0,0,0
1038560,True,0,No user reviews,0,0,0
1038620,True,5,Mixed,11,10,21
1038630,True,0,8 user reviews,7,1,8
1038640,True,0,2 user reviews,1,1,2
1038650,True,0,4 user reviews,2,2,4
1038670,True,0,1 user reviews,0,1,1
1038680,True,0,No user reviews,0,0,0
1038710,True,7,Positive,10,1,11
1038740,True,8,Very Positive,209,10,219
1038810,True,6,Mostly Positive,22,8,30
1038820,True,0,1 user reviews,1,0,1
1038830,True,0,2 user reviews,1,1,2
1038840,True,0,1 user reviews,1,0,1
1038850,True,0,No user reviews,0,0,0
1038950,True,0,1 user reviews,1,0,1
1039030,True,0,1 user reviews,1,0,1
1039031,True,0,No user reviews,0,0,0
1039040,True,0,5 user reviews,4,1,5
1039050,True,0,No user reviews,0,0,0
1039060,True,0,1 user reviews,0,1,1
1039080,True,7,Positive,10,2,12
1039100,True,0,No user reviews,0,0,0
1039110,True,0,No user reviews,0,0,0
1039130,True,0,No user reviews,0,0,0
1039170,True,0,No user reviews,0,0,0
1039180,True,0,No user reviews,0,0,0
1039200,True,7,Positive,20,1,21
1039210,True,0,1 user reviews,1,0,1
1039230,True,0,No user reviews,0,0,0
1039250,True,0,No user reviews,0,0,0
1039280,True,0,No user reviews,0,0,0
1039290,True,0,7 user reviews,7,0,7
1039310,True,0,5 user reviews,3,2,5
1039320,True,0,2 user reviews,1,1,2
1039330,True,0,1 user reviews,1,0,1
1039350,True,7,Positive,21,4,25
1039360,True,0,No user reviews,0,0,0
1039370,True,5,Mixed,21,17,38
1039380,True,0,7 user reviews,6,1,7
1039390,True,0,No user reviews,0,0,0
1039400,True,0,No user reviews,0,0,0
1039420,True,0,No user reviews,0,0,0
1039430,True,0,1 user reviews,1,0,1
1039440,True,0,No user reviews,0,0,0
1039450,True,0,No user reviews,0,0,0
1039470,True,0,1 user reviews,1,0,1
1039480,True,6,Mostly Positive,53,15,68
1039550,True,0,No user reviews,0,0,0
1039560,True,0,No user reviews,0,0,0
1039570,True,0,5 user reviews,3,2,5
1039580,True,0,1 user reviews,1,0,1
1039590,True,0,No user reviews,0,0,0
1039630,True,0,No user reviews,0,0,0
1039640,True,0,No user reviews,0,0,0
1039650,True,0,No user reviews,0,0,0
1039660,True,0,No user reviews,0,0,0
1039670,True,0,No user reviews,0,0,0
1039680,True,0,No user reviews,0,0,0
1039700,True,0,No user reviews,0,0,0
1039720,True,0,No user reviews,0,0,0
1039730,True,0,No user reviews,0,0,0
1039740,True,0,No user reviews,0,0,0
1039760,True,0,No user reviews,0,0,0
1039800,True,0,No user reviews,0,0,0
1039811,True,0,No user reviews,0,0,0
1039820,True,0,No user reviews,0,0,0
1039830,True,0,5 user reviews,1,4,5
1039860,True,0,1 user reviews,1,0,1
1039880,True,8,Very Positive,535,117,652
1039890,True,5,Mixed,164,101,265
1039910,True,0,3 user reviews,3,0,3
1039940,True,8,Very Positive,60,1,61
1039960,True,0,9 user reviews,9,0,9
1039970,True,7,Positive,11,2,13
1040000,True,0,1 user reviews,1,0,1
1040030,True,0,1 user reviews,1,0,1
1040042,True,0,No user reviews,0,0,0
1040070,True,8,Very Positive,426,55,481
1040080,True,6,Mostly Positive,15,4,19
1040090,True,0,No user reviews,0,0,0
1040100,True,0,No user reviews,0,0,0
1040110,True,0,No user reviews,0,0,0
1040150,True,0,1 user reviews,1,0,1
1040190,True,0,No user reviews,0,0,0
1040200,True,0,No user reviews,0,0,0
1040220,True,0,No user reviews,0,0,0
1040230,True,6,Mostly Positive,73,19,92
1040240,True,0,No user reviews,0,0,0
1040300,True,0,No user reviews,0,0,0
1040310,True,0,5 user reviews,3,2,5
1040320,True,0,No user reviews,0,0,0
1040330,True,0,No user reviews,0,0,0
1040350,True,0,No user reviews,0,0,0
1040360,True,0,No user reviews,0,0,0
1040370,True,0,2 user reviews,2,0,2
1040390,True,7,Positive,25,2,27
1040420,True,8,Very Positive,232,9,241
1040430,True,0,No user reviews,0,0,0
1040460,True,6,Mostly Positive,10,4,14
1040480,True,0,No user reviews,0,0,0
1040490,True,0,No user reviews,0,0,0
1040500,True,0,No user reviews,0,0,0
1040501,True,0,2 user reviews,0,2,2
1040510,True,0,No user reviews,0,0,0
1040550,True,8,Very Positive,157,3,160
1040590,True,7,Positive,11,2,13
1040610,True,0,No user reviews,0,0,0
1040620,True,0,2 user reviews,2,0,2
1040630,True,8,Very Positive,71,9,80
1040640,True,0,No user reviews,0,0,0
1040660,True,0,No user reviews,0,0,0
1040690,True,0,3 user reviews,1,2,3
1040700,True,0,1 user reviews,1,0,1
1040720,True,0,1 user reviews,0,1,1
1040730,True,7,Positive,18,2,20
1040740,True,0,3 user reviews,2,1,3
1040750,True,0,1 user reviews,1,0,1
1040790,True,0,No user reviews,0,0,0
1040810,True,0,No user reviews,0,0,0
1040820,True,0,No user reviews,0,0,0
1040860,True,0,2 user reviews,0,2,2
1040880,True,0,1 user reviews,0,1,1
1040890,True,0,No user reviews,0,0,0
1040900,True,0,No user reviews,0,0,0
1040910,True,0,No user reviews,0,0,0
1040920,True,0,No user reviews,0,0,0
1040930,True,7,Positive,22,4,26
1040940,True,5,Mixed,4,6,10
1041000,True,7,Positive,15,0,15
1041010,True,0,6 user reviews,6,0,6
1041020,True,0,No user reviews,0,0,0
1041050,True,0,No user reviews,0,0,0
1041060,True,0,No user reviews,0,0,0
1041070,True,0,No user reviews,0,0,0
1041090,True,0,No user reviews,0,0,0
1041100,True,0,No user reviews,0,0,0
1041120,True,0,No user reviews,0,0,0
1041130,True,0,7 user reviews,5,2,7
1041140,True,0,4 user reviews,0,4,4
1041160,True,0,No user reviews,0,0,0
1041171,True,0,No user reviews,0,0,0
1041172,True,0,No user reviews,0,0,0
1041173,True,0,No user reviews,0,0,0
1041180,True,0,No user reviews,0,0,0
1041210,True,0,No user reviews,0,0,0
1041240,True,0,No user reviews,0,0,0
1041270,True,0,7 user reviews,4,3,7
1041290,True,0,No user reviews,0,0,0
1041300,True,0,No user reviews,0,0,0
1041320,True,0,No user reviews,0,0,0
1041330,True,0,No user reviews,0,0,0
1041390,True,0,3 user reviews,2,1,3
1041400,True,8,Very Positive,85,18,103
1041410,True,0,No user reviews,0,0,0
1041420,True,0,No user reviews,0,0,0
1041450,True,0,3 user reviews,3,0,3
1041460,True,8,Very Positive,50,2,52
1041470,True,0,No user reviews,0,0,0
1041500,True,0,4 user reviews,4,0,4
1041630,True,0,No user reviews,0,0,0
1041650,True,0,1 user reviews,1,0,1
1041660,True,0,No user reviews,0,0,0
1041670,True,0,9 user reviews,6,3,9
1041680,True,5,Mixed,24,13,37
1041690,True,6,Mostly Positive,14,4,18
1041710,True,0,2 user reviews,2,0,2
1041720,True,6,Mostly Positive,1219,426,1645
1041760,True,0,No user reviews,0,0,0
1041780,True,0,8 user reviews,5,3,8
1041790,True,0,No user reviews,0,0,0
1041820,True,0,No user reviews,0,0,0
1041830,True,0,No user reviews,0,0,0
1041831,True,0,No user reviews,0,0,0
1041840,True,5,Mixed,50,25,75
1041880,True,0,No user reviews,0,0,0
1041890,True,0,No user reviews,0,0,0
1041910,True,0,No user reviews,0,0,0
1041920,True,8,Very Positive,112,5,117
1041940,True,7,Positive,35,5,40
1042000,True,0,No user reviews,0,0,0
1042010,True,0,No user reviews,0,0,0
1042020,True,4,Mostly Negative,7,12,19
1042030,True,0,5 user reviews,5,0,5
1042040,True,0,1 user reviews,0,1,1
1042050,True,0,1 user reviews,0,1,1
1042080,True,0,5 user reviews,4,1,5
1042090,True,0,5 user reviews,4,1,5
1042100,True,0,No user reviews,0,0,0
1042110,True,0,No user reviews,0,0,0
1042120,True,0,No user reviews,0,0,0
1042130,True,0,3 user reviews,2,1,3
1042150,True,0,1 user reviews,1,0,1
1042160,True,6,Mostly Positive,17,7,24
1042170,True,0,5 user reviews,4,1,5
1042210,True,0,No user reviews,0,0,0
1042220,True,5,Mixed,363,325,688
1042230,True,0,No user reviews,0,0,0
1042270,True,8,Very Positive,60,6,66
1042290,True,0,2 user reviews,0,2,2
1042310,True,0,4 user reviews,2,2,4
1042330,True,7,Positive,10,0,10
1042340,True,0,No user reviews,0,0,0
1042350,True,0,No user reviews,0,0,0
1042360,True,6,Mostly Positive,23,9,32
1042370,True,0,No user reviews,0,0,0
1042380,True,0,No user reviews,0,0,0
1042390,True,7,Positive,24,0,24
1042400,True,0,No user reviews,0,0,0
1042440,True,0,No user reviews,0,0,0
1042450,True,0,No user reviews,0,0,0
1042460,True,0,No user reviews,0,0,0
1042480,True,0,No user reviews,0,0,0
1042490,True,0,No user reviews,0,0,0
1042500,True,0,No user reviews,0,0,0
1042530,True,0,No user reviews,0,0,0
1042540,True,0,No user reviews,0,0,0
1042550,True,8,Very Positive,1061,60,1121
1042560,True,0,No user reviews,0,0,0
1042570,True,0,No user reviews,0,0,0
1042580,True,0,1 user reviews,1,0,1
1042590,True,0,No user reviews,0,0,0
1042600,True,0,No user reviews,0,0,0
1042620,True,0,No user reviews,0,0,0
1042640,True,0,No user reviews,0,0,0
1042660,True,0,No user reviews,0,0,0
1042670,True,5,Mixed,18,10,28
1042710,True,0,No user reviews,0,0,0
1042730,True,0,6 user reviews,5,1,6
1042731,True,0,9 user reviews,6,3,9
1042740,True,0,No user reviews,0,0,0
1042741,True,0,No user reviews,0,0,0
1042750,True,0,No user reviews,0,0,0
1042780,True,6,Mostly Positive,337,129,466
1042790,True,0,No user reviews,0,0,0
1042800,True,8,Very Positive,452,108,560
1042813,True,0,No user reviews,0,0,0
1042820,True,0,6 user reviews,3,3,6
1042850,True,0,6 user reviews,6,0,6
1042851,True,0,3 user reviews,3,0,3
1042860,True,0,No user reviews,0,0,0
1042880,True,0,1 user reviews,0,1,1
1042920,True,0,No user reviews,0,0,0
1042950,True,0,1 user reviews,0,1,1
1042960,True,0,No user reviews,0,0,0
1042980,True,6,Mostly Positive,12,4,16
1042990,True,5,Mixed,7,4,11
1043000,True,6,Mostly Positive,9,3,12
1043020,True,0,2 user reviews,0,2,2
1043030,True,0,3 user reviews,3,0,3
1043040,True,0,4 user reviews,1,3,4
1043060,True,0,1 user reviews,1,0,1
1043110,True,0,No user reviews,0,0,0
1043120,True,0,4 user reviews,4,0,4
1043140,True,0,1 user reviews,1,0,1
1043150,True,7,Positive,24,2,26
1043160,True,0,2 user reviews,2,0,2
1043180,True,0,No user reviews,0,0,0
1043200,True,0,4 user reviews,4,0,4
1043230,True,7,Positive,35,0,35
1043240,True,7,Positive,40,0,40
1043250,True,0,6 user reviews,6,0,6
1043260,True,0,No user reviews,0,0,0
1043340,True,8,Very Positive,431,13,444
1043350,True,5,Mixed,9,9,18
1043360,True,0,4 user reviews,1,3,4
1043370,True,0,No user reviews,0,0,0
1043380,True,0,No user reviews,0,0,0
1043390,True,8,Very Positive,294,31,325
1043420,True,0,7 user reviews,5,2,7
1043430,True,7,Positive,35,5,40
1043440,True,0,No user reviews,0,0,0
1043450,True,0,No user reviews,0,0,0
1043470,True,0,No user reviews,0,0,0
1043480,True,0,No user reviews,0,0,0
1043500,True,8,Very Positive,99,6,105
1043510,True,0,1 user reviews,1,0,1
1043550,True,0,1 user reviews,1,0,1
1043560,True,0,3 user reviews,3,0,3
1043580,True,0,2 user reviews,2,0,2
1043590,True,0,No user reviews,0,0,0
1043610,True,0,6 user reviews,3,3,6
1043650,True,0,No user reviews,0,0,0
1043660,True,0,No user reviews,0,0,0
1043670,True,0,No user reviews,0,0,0
1043690,True,7,Positive,11,0,11
1043710,True,0,2 user reviews,2,0,2
1043760,True,0,No user reviews,0,0,0
1043770,True,0,No user reviews,0,0,0
1043790,True,0,No user reviews,0,0,0
1043800,True,0,No user reviews,0,0,0
1043810,True,0,No user reviews,0,0,0
1043820,True,0,No user reviews,0,0,0
1043860,True,0,1 user reviews,1,0,1
1043870,True,0,7 user reviews,7,0,7
1043880,True,0,7 user reviews,4,3,7
1043890,True,0,5 user reviews,4,1,5
1044020,True,0,9 user reviews,8,1,9
1044030,True,0,No user reviews,0,0,0
1044040,True,5,Mixed,20,17,37
1044050,True,0,No user reviews,0,0,0
1044070,True,0,No user reviews,0,0,0
1044080,True,0,No user reviews,0,0,0
1044090,True,0,No user reviews,0,0,0
1044110,True,0,No user reviews,0,0,0
1044120,True,0,No user reviews,0,0,0
1044130,True,0,2 user reviews,2,0,2
1044140,True,0,2 user reviews,2,0,2
1044141,True,0,1 user reviews,1,0,1
1044160,True,0,No user reviews,0,0,0
1044170,True,3,Negative,2,14,16
1044180,True,0,No user reviews,0,0,0
1044190,True,0,2 user reviews,2,0,2
1044200,True,0,No user reviews,0,0,0
1044210,True,0,1 user reviews,1,0,1
1044220,True,0,7 user reviews,6,1,7
1044230,True,0,No user reviews,0,0,0
1044231,True,0,No user reviews,0,0,0
1044232,True,0,No user reviews,0,0,0
1044233,True,0,No user reviews,0,0,0
1044234,True,0,No user reviews,0,0,0
1044260,True,0,2 user reviews,2,0,2
1044300,True,0,No user reviews,0,0,0
1044310,True,0,9 user reviews,8,1,9
1044320,True,0,No user reviews,0,0,0
1044330,True,0,No user reviews,0,0,0
1044340,True,6,Mostly Positive,39,15,54
1044350,True,0,4 user reviews,3,1,4
1044410,True,0,No user reviews,0,0,0
1044430,True,0,No user reviews,0,0,0
1044440,True,7,Positive,23,5,28
1044450,True,7,Positive,29,2,31
1044460,True,0,2 user reviews,0,2,2
1044470,True,0,No user reviews,0,0,0
1044480,True,0,No user reviews,0,0,0
1044490,True,8,Very Positive,60,5,65
1044500,True,7,Positive,23,4,27
1044510,True,0,No user reviews,0,0,0
1044520,True,0,6 user reviews,5,1,6
1044620,True,8,Very Positive,307,6,313
1044630,True,4,Mostly Negative,2,8,10
1044640,True,0,2 user reviews,1,1,2
1044650,True,0,No user reviews,0,0,0
1044660,True,0,No user reviews,0,0,0
1044661,True,0,No user reviews,0,0,0
1044662,True,0,No user reviews,0,0,0
1044680,True,0,No user reviews,0,0,0
1044690,True,0,No user reviews,0,0,0
1044700,True,0,No user reviews,0,0,0
1044710,True,0,No user reviews,0,0,0
1044730,True,7,Positive,10,0,10
1044740,True,0,No user reviews,0,0,0
1044750,True,0,No user reviews,0,0,0
1044760,True,6,Mostly Positive,11,4,15
1044770,True,0,6 user reviews,6,0,6
1044790,True,0,2 user reviews,2,0,2
1044800,True,0,3 user reviews,3,0,3
1044820,True,0,No user reviews,0,0,0
1044830,True,0,1 user reviews,0,1,1
1044840,True,0,3 user reviews,3,0,3
1044870,True,0,5 user reviews,5,0,5
1044900,True,0,No user reviews,0,0,0
1044920,True,0,2 user reviews,1,1,2
1044930,True,0,1 user reviews,1,0,1
1044950,True,5,Mixed,5,6,11
1044980,True,0,No user reviews,0,0,0
1044990,True,0,No user reviews,0,0,0
1045010,True,0,7 user reviews,7,0,7
1045020,True,0,No user reviews,0,0,0
1045031,True,0,No user reviews,0,0,0
1045060,True,0,1 user reviews,1,0,1
1045070,True,0,1 user reviews,1,0,1
1045080,True,6,Mostly Positive,58,21,79
1045100,True,3,Negative,2,19,21
1045110,True,5,Mixed,8,4,12
1045120,True,7,Positive,13,0,13
1045130,True,0,No user reviews,0,0,0
1045140,True,0,No user reviews,0,0,0
1045150,True,0,No user reviews,0,0,0
1045170,True,6,Mostly Positive,24,8,32
1045180,True,6,Mostly Positive,52,17,69
1045190,True,5,Mixed,7,6,13
1045200,True,0,No user reviews,0,0,0
1045220,True,0,1 user reviews,0,1,1
1045280,True,0,No user reviews,0,0,0
1045290,True,0,3 user reviews,2,1,3
1045291,True,0,1 user reviews,0,1,1
1045300,True,0,3 user reviews,2,1,3
1045310,True,0,No user reviews,0,0,0
1045320,True,0,No user reviews,0,0,0
1045340,True,7,Positive,31,6,37
1045350,True,7,Positive,29,7,36
1045360,True,0,No user reviews,0,0,0
1045390,True,0,5 user reviews,5,0,5
1045400,True,0,1 user reviews,1,0,1
1045410,True,0,No user reviews,0,0,0
1045420,True,0,No user reviews,0,0,0
1045430,True,7,Positive,34,5,39
1045460,True,0,No user reviews,0,0,0
1045470,True,0,No user reviews,0,0,0
1045490,True,0,1 user reviews,1,0,1
1045500,True,0,No user reviews,0,0,0
1045510,True,0,7 user reviews,5,2,7
1045520,True,9,Overwhelmingly Positive,1633,41,1674
1045540,True,0,No user reviews,0,0,0
1045550,True,0,No user reviews,0,0,0
1045560,True,0,No user reviews,0,0,0
1045570,True,0,No user reviews,0,0,0
1045580,True,7,Positive,24,0,24
1045590,True,0,No user reviews,0,0,0
1045600,True,0,No user reviews,0,0,0
1045620,True,8,Very Positive,66,7,73
1045630,True,0,No user reviews,0,0,0
1045650,True,8,Very Positive,42,8,50
1045670,True,0,No user reviews,0,0,0
1045680,True,5,Mixed,14,10,24
1045710,True,0,No user reviews,0,0,0
1045720,True,8,Very Positive,117,4,121
1045730,True,0,No user reviews,0,0,0
1045740,True,0,4 user reviews,1,3,4
1045750,True,0,No user reviews,0,0,0
1045810,True,0,2 user reviews,2,0,2
1045820,True,0,No user reviews,0,0,0
1045840,True,7,Positive,30,7,37
1045850,True,0,No user reviews,0,0,0
1045880,True,0,No user reviews,0,0,0
1045890,True,0,No user reviews,0,0,0
1045900,True,0,2 user reviews,2,0,2
1045920,True,0,7 user reviews,4,3,7
1045930,True,0,3 user reviews,3,0,3
1045940,True,0,No user reviews,0,0,0
1045980,True,6,Mostly Positive,139,47,186
1046020,True,0,No user reviews,0,0,0
1046030,True,9,Overwhelmingly Positive,6309,272,6581
1046050,True,5,Mixed,12,8,20
1046060,True,0,3 user reviews,3,0,3
1046070,True,0,3 user reviews,2,1,3
1046080,True,0,No user reviews,0,0,0
1046081,True,0,No user reviews,0,0,0
1046083,True,0,No user reviews,0,0,0
1046084,True,0,No user reviews,0,0,0
1046085,True,0,No user reviews,0,0,0
1046086,True,0,No user reviews,0,0,0
1046087,True,0,No user reviews,0,0,0
1046088,True,0,No user reviews,0,0,0
1046089,True,0,No user reviews,0,0,0
1046090,True,0,No user reviews,0,0,0
1046091,True,0,No user reviews,0,0,0
1046092,True,0,No user reviews,0,0,0
1046100,True,0,No user reviews,0,0,0
1046110,True,0,No user reviews,0,0,0
1046130,True,7,Positive,10,0,10
1046140,True,0,1 user reviews,0,1,1
1046160,True,0,No user reviews,0,0,0
1046180,True,6,Mostly Positive,70,24,94
1046190,True,0,2 user reviews,2,0,2
1046210,True,0,7 user reviews,7,0,7
1046220,True,0,No user reviews,0,0,0
1046230,True,6,Mostly Positive,28,10,38
1046240,True,3,Negative,1,9,10
1046260,True,0,No user reviews,0,0,0
1046300,True,8,Very Positive,78,15,93
1046310,True,0,No user reviews,0,0,0
1046311,True,0,No user reviews,0,0,0
1046312,True,0,No user reviews,0,0,0
1046320,True,0,No user reviews,0,0,0
1046321,True,0,No user reviews,0,0,0
1046322,True,0,No user reviews,0,0,0
1046330,True,0,1 user reviews,1,0,1
1046340,True,0,No user reviews,0,0,0
1046341,True,0,No user reviews,0,0,0
1046342,True,0,No user reviews,0,0,0
1046350,True,0,1 user reviews,0,1,1
1046370,True,0,No user reviews,0,0,0
1046400,True,0,No user reviews,0,0,0
1046410,True,0,No user reviews,0,0,0
1046420,True,0,No user reviews,0,0,0
1046440,True,0,No user reviews,0,0,0
1046450,True,0,No user reviews,0,0,0
1046460,True,0,No user reviews,0,0,0
1046470,True,0,No user reviews,0,0,0
1046490,True,0,No user reviews,0,0,0
1046500,True,0,No user reviews,0,0,0
1046530,True,0,4 user reviews,3,1,4
1046540,True,0,No user reviews,0,0,0
1046550,True,0,No user reviews,0,0,0
1046560,True,0,2 user reviews,0,2,2
1046570,True,0,6 user reviews,4,2,6
1046600,True,0,3 user reviews,2,1,3
1046610,True,0,1 user reviews,1,0,1
1046630,True,0,5 user reviews,5,0,5
1046640,True,0,No user reviews,0,0,0
1046650,True,0,No user reviews,0,0,0
1046660,True,6,Mostly Positive,98,37,135
1046670,True,0,3 user reviews,2,1,3
1046690,True,0,No user reviews,0,0,0
1046700,True,0,No user reviews,0,0,0
1046740,True,0,4 user reviews,2,2,4
1046750,True,0,4 user reviews,3,1,4
1046760,True,0,No user reviews,0,0,0
1046770,True,7,Positive,16,3,19
1046780,True,0,No user reviews,0,0,0
1046790,True,0,No user reviews,0,0,0
1046800,True,0,1 user reviews,1,0,1
1046801,True,0,1 user reviews,1,0,1
1046810,True,0,No user reviews,0,0,0
1046820,True,7,Positive,23,5,28
1046880,True,0,2 user reviews,2,0,2
1046900,True,0,No user reviews,0,0,0
1046910,True,0,1 user reviews,1,0,1
1046920,True,0,No user reviews,0,0,0
1046930,True,0,No user reviews,0,0,0
1046970,True,0,No user reviews,0,0,0
1046980,True,0,5 user reviews,3,2,5
1047000,True,0,No user reviews,0,0,0
1047010,True,8,Very Positive,79,7,86
1047020,True,0,1 user reviews,0,1,1
1047040,True,0,No user reviews,0,0,0
1047080,True,0,No user reviews,0,0,0
1047090,True,0,No user reviews,0,0,0
1047110,True,0,6 user reviews,6,0,6
1047120,True,0,8 user reviews,8,0,8
1047140,True,0,4 user reviews,0,4,4
1047150,True,0,5 user reviews,5,0,5
1047160,True,0,2 user reviews,0,2,2
1047180,True,5,Mixed,46,33,79
1047190,True,0,No user reviews,0,0,0
1047220,True,8,Very Positive,250,5,255
1047230,True,0,1 user reviews,1,0,1
1047240,True,5,Mixed,5,5,10
1047330,True,0,No user reviews,0,0,0
1047340,True,0,No user reviews,0,0,0
1047350,True,0,No user reviews,0,0,0
1047380,True,6,Mostly Positive,26,11,37
1047400,True,0,No user reviews,0,0,0
1047410,True,0,No user reviews,0,0,0
1047430,True,0,No user reviews,0,0,0
1047440,True,8,Very Positive,324,16,340
1047460,True,0,No user reviews,0,0,0
1047480,True,0,No user reviews,0,0,0
1047490,True,0,No user reviews,0,0,0
1047500,True,0,No user reviews,0,0,0
1047560,True,0,No user reviews,0,0,0
1047580,True,7,Positive,14,0,14
1047590,True,0,No user reviews,0,0,0
1047600,True,0,No user reviews,0,0,0
1047610,True,0,No user reviews,0,0,0
1047620,True,0,No user reviews,0,0,0
1047640,True,0,No user reviews,0,0,0
1047650,True,0,No user reviews,0,0,0
1047660,True,0,No user reviews,0,0,0
1047670,True,5,Mixed,9,4,13
1047680,True,0,No user reviews,0,0,0
1047690,True,0,No user reviews,0,0,0
1047710,True,0,No user reviews,0,0,0
1047720,True,0,No user reviews,0,0,0
1047730,True,0,No user reviews,0,0,0
1047750,True,0,No user reviews,0,0,0
1047770,True,0,No user reviews,0,0,0
1047780,True,0,2 user reviews,1,1,2
1047800,True,0,3 user reviews,3,0,3
1047810,True,0,3 user reviews,2,1,3
1047830,True,5,Mixed,19,11,30
1047840,True,0,No user reviews,0,0,0
1047850,True,0,5 user reviews,5,0,5
1047860,True,0,5 user reviews,3,2,5
1047870,True,7,Positive,25,2,27
1047880,True,0,No user reviews,0,0,0
1047900,True,0,No user reviews,0,0,0
1047910,True,0,No user reviews,0,0,0
1047920,True,0,No user reviews,0,0,0
1047930,True,0,4 user reviews,4,0,4
1047940,True,0,1 user reviews,1,0,1
1047950,True,0,No user reviews,0,0,0
1047960,True,6,Mostly Positive,19,5,24
1047970,True,0,No user reviews,0,0,0
1047980,True,0,No user reviews,0,0,0
1048000,True,7,Positive,14,3,17
1048010,True,0,No user reviews,0,0,0
1048020,True,0,4 user reviews,2,2,4
1048030,True,0,No user reviews,0,0,0
1048040,True,0,No user reviews,0,0,0
1048050,True,0,6 user reviews,2,4,6
1048080,True,0,3 user reviews,2,1,3
1048090,True,0,5 user reviews,4,1,5
1048100,True,6,Mostly Positive,225,71,296
1048110,True,0,1 user reviews,1,0,1
1048140,True,0,No user reviews,0,0,0
1048150,True,0,No user reviews,0,0,0
1048160,True,0,No user reviews,0,0,0
1048180,True,0,No user reviews,0,0,0
1048190,True,0,No user reviews,0,0,0
1048250,True,0,No user reviews,0,0,0
1048260,True,0,1 user reviews,0,1,1
1048270,True,5,Mixed,7,4,11
1048280,True,0,9 user reviews,4,5,9
1048290,True,0,No user reviews,0,0,0
1048300,True,0,7 user reviews,7,0,7
1048320,True,0,No user reviews,0,0,0
1048340,True,0,No user reviews,0,0,0
1048350,True,0,No user reviews,0,0,0
1048360,True,0,No user reviews,0,0,0
1048380,True,0,1 user reviews,1,0,1
1048381,True,0,1 user reviews,1,0,1
1048390,True,0,No user reviews,0,0,0
1048410,True,0,No user reviews,0,0,0
1048420,True,0,2 user reviews,2,0,2
1048430,True,0,No user reviews,0,0,0
1048460,True,0,5 user reviews,3,2,5
1048470,True,0,No user reviews,0,0,0
1048480,True,0,No user reviews,0,0,0
1048530,True,0,No user reviews,0,0,0
1048540,True,8,Very Positive,289,22,311
1048550,True,0,No user reviews,0,0,0
1048560,True,7,Positive,13,1,14
1048570,True,0,No user reviews,0,0,0
1048580,True,0,No user reviews,0,0,0
1048600,True,6,Mostly Positive,93,24,117
1048610,True,0,No user reviews,0,0,0
1048630,True,0,No user reviews,0,0,0
1048640,True,4,Mostly Negative,4,10,14
1048670,True,0,No user reviews,0,0,0
1048690,True,0,1 user reviews,1,0,1
1048710,True,5,Mixed,6,4,10
1048740,True,8,Very Positive,54,5,59
1048770,True,0,No user reviews,0,0,0
1048780,True,0,No user reviews,0,0,0
1048790,True,0,No user reviews,0,0,0
1048830,True,0,No user reviews,0,0,0
1048840,True,0,No user reviews,0,0,0
1048850,True,0,No user reviews,0,0,0
1048860,True,0,No user reviews,0,0,0
1048870,True,5,Mixed,9,10,19
1048871,True,5,Mixed,6,7,13
1048872,True,5,Mixed,9,6,15
1048873,True,0,9 user reviews,3,6,9
1048874,True,4,Mostly Negative,12,20,32
1048875,True,0,9 user reviews,2,7,9
1048876,True,5,Mixed,9,5,14
1048877,True,0,5 user reviews,1,4,5
1048878,True,4,Mostly Negative,3,9,12
1048879,True,5,Mixed,5,5,10
1048880,True,0,5 user reviews,2,3,5
1048890,True,0,No user reviews,0,0,0
1048900,True,0,7 user reviews,5,2,7
1048910,True,0,No user reviews,0,0,0
1048920,True,0,2 user reviews,1,1,2
1048930,True,0,No user reviews,0,0,0
1048931,True,0,No user reviews,0,0,0
1048950,True,6,Mostly Positive,92,26,118
1048960,True,0,4 user reviews,3,1,4
1048970,True,0,No user reviews,0,0,0
1049000,True,0,No user reviews,0,0,0
1049010,True,0,No user reviews,0,0,0
1049020,True,8,Very Positive,147,20,167
1049030,True,0,1 user reviews,1,0,1
1049040,True,0,No user reviews,0,0,0
1049050,True,0,No user reviews,0,0,0
1049070,True,7,Positive,11,2,13
1049080,True,0,No user reviews,0,0,0
1049090,True,0,5 user reviews,4,1,5
1049100,True,7,Positive,25,2,27
1049120,True,0,1 user reviews,1,0,1
1049121,True,0,No user reviews,0,0,0
1049130,True,5,Mixed,13,8,21
1049140,True,0,3 user reviews,2,1,3
1049150,True,0,No user reviews,0,0,0
1049170,True,0,No user reviews,0,0,0
1049220,True,7,Positive,34,8,42
1049230,True,0,No user reviews,0,0,0
1049240,True,5,Mixed,85,50,135
1049270,True,0,3 user reviews,2,1,3
1049280,True,8,Very Positive,278,16,294
1049290,True,5,Mixed,37,16,53
1049310,True,0,2 user reviews,2,0,2
1049320,True,8,Very Positive,504,106,610
1049330,True,0,No user reviews,0,0,0
1049340,True,0,No user reviews,0,0,0
1049350,True,0,No user reviews,0,0,0
1049360,True,0,No user reviews,0,0,0
1049370,True,0,3 user reviews,2,1,3
1049380,True,0,No user reviews,0,0,0
1049400,True,0,No user reviews,0,0,0
1049410,True,0,No user reviews,0,0,0
1049420,True,0,No user reviews,0,0,0
1049430,True,0,3 user reviews,3,0,3
1049440,True,6,Mostly Positive,20,7,27
1049490,True,0,4 user reviews,3,1,4
1049500,True,0,No user reviews,0,0,0
1049510,True,0,5 user reviews,4,1,5
1049530,True,0,9 user reviews,8,1,9
1049560,True,0,4 user reviews,4,0,4
1049570,True,6,Mostly Positive,7,3,10
1049590,True,0,5 user reviews,4,1,5
1049630,True,0,No user reviews,0,0,0
1049640,True,0,No user reviews,0,0,0
1049650,True,0,6 user reviews,4,2,6
1049660,True,0,No user reviews,0,0,0
1049670,True,7,Positive,10,0,10
1049680,True,0,1 user reviews,0,1,1
1049690,True,0,4 user reviews,4,0,4
1049710,True,0,No user reviews,0,0,0
1049720,True,0,1 user reviews,1,0,1
1049730,True,0,2 user reviews,1,1,2
1049740,True,0,No user reviews,0,0,0
1049770,True,0,No user reviews,0,0,0
1049790,True,8,Very Positive,271,43,314
1049800,True,0,No user reviews,0,0,0
1049810,True,7,Positive,25,4,29
1049820,True,7,Positive,11,1,12
1049840,True,0,1 user reviews,1,0,1
1049870,True,0,No user reviews,0,0,0
1049880,True,0,No user reviews,0,0,0
1049890,True,9,Overwhelmingly Positive,1122,19,1141
1049900,True,7,Positive,15,1,16
1049910,True,0,2 user reviews,1,1,2
1049920,True,0,No user reviews,0,0,0
1049930,True,0,1 user reviews,0,1,1
1049940,True,5,Mixed,9,6,15
1049950,True,0,No user reviews,0,0,0
1049980,True,0,No user reviews,0,0,0
1049990,True,0,No user reviews,0,0,0
1050000,True,7,Positive,20,1,21
1050010,True,0,5 user reviews,5,0,5
1050030,True,0,No user reviews,0,0,0
1050040,True,0,4 user reviews,1,3,4
1050050,True,0,2 user reviews,0,2,2
1050060,True,0,No user reviews,0,0,0
1050070,True,0,No user reviews,0,0,0
1050080,True,0,1 user reviews,0,1,1
1050090,True,0,2 user reviews,1,1,2
1050120,True,0,1 user reviews,0,1,1
1050121,True,0,No user reviews,0,0,0
1050122,True,5,Mixed,5,5,10
1050150,True,5,Mixed,5,5,10
1050160,True,0,2 user reviews,2,0,2
1050170,True,0,1 user reviews,0,1,1
1050180,True,0,2 user reviews,1,1,2
1050190,True,0,No user reviews,0,0,0
1050210,True,0,4 user reviews,2,2,4
1050220,True,0,No user reviews,0,0,0
1050230,True,0,6 user reviews,6,0,6
1050240,True,0,7 user reviews,4,3,7
1050260,True,0,No user reviews,0,0,0
1050270,True,0,No user reviews,0,0,0
1050280,True,0,No user reviews,0,0,0
1050330,True,0,7 user reviews,5,2,7
1050340,True,0,7 user reviews,2,5,7
1050350,True,0,3 user reviews,1,2,3
1050360,True,0,1 user reviews,1,0,1
1050370,True,0,No user reviews,0,0,0
1050410,True,0,No user reviews,0,0,0
1050430,True,0,1 user reviews,1,0,1
1050440,True,6,Mostly Positive,15,4,19
1050450,True,0,5 user reviews,5,0,5
1050460,True,7,Positive,19,0,19
1050480,True,0,1 user reviews,0,1,1
1050500,True,0,5 user reviews,5,0,5
1050510,True,7,Positive,22,4,26
1050520,True,0,5 user reviews,5,0,5
1050530,True,0,No user reviews,0,0,0
1050540,True,0,4 user reviews,1,3,4
1050550,True,0,No user reviews,0,0,0
1050560,True,0,1 user reviews,1,0,1
1050580,True,0,7 user reviews,4,3,7
1050600,True,0,No user reviews,0,0,0
1050610,True,0,No user reviews,0,0,0
1050611,True,0,No user reviews,0,0,0
1050620,True,0,No user reviews,0,0,0
1050660,True,0,No user reviews,0,0,0
1050670,True,0,No user reviews,0,0,0
1050680,True,0,No user reviews,0,0,0
1050690,True,0,No user reviews,0,0,0
1050700,True,0,No user reviews,0,0,0
1050710,True,0,9 user reviews,8,1,9
1050711,True,0,No user reviews,0,0,0
1050712,True,0,5 user reviews,5,0,5
1050713,True,0,No user reviews,0,0,0
1050714,True,0,3 user reviews,3,0,3
1050715,True,0,No user reviews,0,0,0
1050716,True,0,2 user reviews,1,1,2
1050717,True,0,No user reviews,0,0,0
1050720,True,6,Mostly Positive,12,4,16
1050730,True,0,5 user reviews,5,0,5
1050780,True,0,3 user reviews,1,2,3
1050790,True,0,No user reviews,0,0,0
1050810,True,0,6 user reviews,1,5,6
1050850,True,0,No user reviews,0,0,0
1050880,True,7,Positive,11,1,12
1050890,True,0,No user reviews,0,0,0
1050900,True,0,No user reviews,0,0,0
1050910,True,0,No user reviews,0,0,0
1051060,True,0,No user reviews,0,0,0
1051130,True,0,No user reviews,0,0,0
1051140,True,0,No user reviews,0,0,0
1051150,True,0,No user reviews,0,0,0
1051160,True,0,1 user reviews,1,0,1
1051170,True,0,4 user reviews,3,1,4
1051180,True,0,No user reviews,0,0,0
1051190,True,0,1 user reviews,1,0,1
1051200,True,8,Very Positive,1537,143,1680
1051210,True,0,No user reviews,0,0,0
1051220,True,0,1 user reviews,1,0,1
1051250,True,4,Mostly Negative,12,21,33
1051260,True,0,2 user reviews,1,1,2
1051270,True,0,1 user reviews,0,1,1
1051280,True,0,No user reviews,0,0,0
1051290,True,0,6 user reviews,3,3,6
1051300,True,0,3 user reviews,2,1,3
1051310,True,7,Positive,31,4,35
1051320,True,0,1 user reviews,0,1,1
1051330,True,0,No user reviews,0,0,0
1051350,True,0,No user reviews,0,0,0
1051370,True,0,No user reviews,0,0,0
1051380,True,0,5 user reviews,5,0,5
1051390,True,0,No user reviews,0,0,0
1051391,True,0,No user reviews,0,0,0
1051392,True,0,No user reviews,0,0,0
1051410,True,7,Positive,29,3,32
1051420,True,0,3 user reviews,2,1,3
1051430,True,0,No user reviews,0,0,0
1051431,True,0,2 user reviews,1,1,2
1051432,True,0,No user reviews,0,0,0
1051433,True,0,No user reviews,0,0,0
1051434,True,0,No user reviews,0,0,0
1051440,True,0,No user reviews,0,0,0
1051450,True,0,No user reviews,0,0,0
1051460,True,0,No user reviews,0,0,0
1051470,True,0,3 user reviews,3,0,3
1051480,True,0,No user reviews,0,0,0
1051500,True,7,Positive,12,1,13
1051510,True,0,No user reviews,0,0,0
1051520,True,0,No user reviews,0,0,0
1051530,True,0,2 user reviews,2,0,2
1051550,True,0,No user reviews,0,0,0
1051570,True,5,Mixed,18,9,27
1051580,True,0,No user reviews,0,0,0
1051590,True,0,8 user reviews,5,3,8
1051600,True,0,No user reviews,0,0,0
1051620,True,7,Positive,32,8,40
1051621,True,3,Negative,1,13,14
1051630,True,0,2 user reviews,0,2,2
1051650,True,0,No user reviews,0,0,0
1051660,True,0,No user reviews,0,0,0
1051670,True,5,Mixed,16,14,30
1051680,True,0,No user reviews,0,0,0
1051690,True,8,Very Positive,346,12,358
1051700,True,7,Positive,18,1,19
1051710,True,0,No user reviews,0,0,0
1051720,True,0,No user reviews,0,0,0
1051750,True,0,No user reviews,0,0,0
1051760,True,0,No user reviews,0,0,0
1051770,True,0,1 user reviews,1,0,1
1051771,True,0,1 user reviews,1,0,1
1051780,True,0,No user reviews,0,0,0
1051781,True,0,4 user reviews,3,1,4
1051790,True,0,1 user reviews,1,0,1
1051791,True,0,1 user reviews,1,0,1
1051810,True,8,Very Positive,82,8,90
1051830,True,0,5 user reviews,2,3,5
1051840,True,7,Positive,14,0,14
1051850,True,5,Mixed,12,7,19
1051870,True,0,No user reviews,0,0,0
1051890,True,0,7 user reviews,5,2,7
1051900,True,0,No user reviews,0,0,0
1051910,True,0,No user reviews,0,0,0
1051920,True,0,5 user reviews,5,0,5
1051940,True,0,No user reviews,0,0,0
1051950,True,0,No user reviews,0,0,0
1051960,True,7,Positive,24,2,26
1051990,True,0,2 user reviews,2,0,2
1052000,True,0,No user reviews,0,0,0
1052010,True,0,2 user reviews,0,2,2
1052030,True,0,5 user reviews,5,0,5
1052040,True,0,No user reviews,0,0,0
1052060,True,0,No user reviews,0,0,0
1052070,True,0,No user reviews,0,0,0
1052080,True,0,3 user reviews,3,0,3
1052090,True,0,5 user reviews,4,1,5
1052100,True,0,2 user reviews,2,0,2
1052120,True,0,No user reviews,0,0,0
1052140,True,0,No user reviews,0,0,0
1052150,True,0,No user reviews,0,0,0
1052210,True,6,Mostly Positive,7,3,10
1052220,True,7,Positive,11,1,12
1052230,True,0,No user reviews,0,0,0
1052250,True,0,No user reviews,0,0,0
1052270,True,0,No user reviews,0,0,0
1052271,True,0,No user reviews,0,0,0
1052272,True,0,No user reviews,0,0,0
1052273,True,0,No user reviews,0,0,0
1052274,True,0,No user reviews,0,0,0
1052275,True,0,No user reviews,0,0,0
1052310,True,0,3 user reviews,0,3,3
1052320,True,0,No user reviews,0,0,0
1052330,True,0,1 user reviews,0,1,1
1052360,True,0,1 user reviews,0,1,1
1052370,True,0,6 user reviews,4,2,6
1052380,True,0,2 user reviews,2,0,2
1052390,True,0,No user reviews,0,0,0
1052420,True,0,3 user reviews,1,2,3
1052440,True,7,Positive,14,3,17
1052450,True,0,No user reviews,0,0,0
1052470,True,0,1 user reviews,0,1,1
1052480,True,0,2 user reviews,2,0,2
1052490,True,0,No user reviews,0,0,0
1052500,True,0,No user reviews,0,0,0
1052510,True,0,No user reviews,0,0,0
1052520,True,0,No user reviews,0,0,0
1052530,True,0,9 user reviews,9,0,9
1052540,True,0,No user reviews,0,0,0
1052550,True,0,6 user reviews,3,3,6
1052560,True,0,1 user reviews,0,1,1
1052570,True,0,No user reviews,0,0,0
1052580,True,0,3 user reviews,3,0,3
1052590,True,0,No user reviews,0,0,0
1052600,True,0,4 user reviews,1,3,4
1052610,True,0,No user reviews,0,0,0
1052620,True,0,No user reviews,0,0,0
1052630,True,0,1 user reviews,1,0,1
1052640,True,7,Positive,10,0,10
1052650,True,0,No user reviews,0,0,0
1052660,True,0,No user reviews,0,0,0
1052670,True,0,3 user reviews,3,0,3
1052680,True,0,No user reviews,0,0,0
1052690,True,5,Mixed,46,24,70
1052700,True,0,1 user reviews,1,0,1
1052701,True,0,No user reviews,0,0,0
1052730,True,0,1 user reviews,1,0,1
1052731,True,0,No user reviews,0,0,0
1052740,True,0,No user reviews,0,0,0
1052750,True,0,No user reviews,0,0,0
1052760,True,0,5 user reviews,5,0,5
1052780,True,0,No user reviews,0,0,0
1052820,True,0,No user reviews,0,0,0
1052850,True,0,No user reviews,0,0,0
1052860,True,0,No user reviews,0,0,0
1052870,True,0,3 user reviews,3,0,3
1052890,True,0,No user reviews,0,0,0
1052900,True,0,2 user reviews,1,1,2
1052910,True,0,No user reviews,0,0,0
1052920,True,0,No user reviews,0,0,0
1052960,True,0,2 user reviews,2,0,2
1052990,True,8,Very Positive,231,5,236
1053000,True,0,No user reviews,0,0,0
1053020,True,0,No user reviews,0,0,0
1053040,True,0,1 user reviews,1,0,1
1053050,True,0,No user reviews,0,0,0
1053060,True,0,1 user reviews,1,0,1
1053080,True,0,No user reviews,0,0,0
1053090,True,0,2 user reviews,2,0,2
1053160,True,0,2 user reviews,1,1,2
1053170,True,0,No user reviews,0,0,0
1053180,True,0,No user reviews,0,0,0
1053190,True,7,Positive,12,0,12
1053250,True,7,Positive,20,1,21
1053260,True,7,Positive,13,2,15
1053270,True,0,2 user reviews,2,0,2
1053300,True,0,No user reviews,0,0,0
1053330,True,0,2 user reviews,1,1,2
1053340,True,0,No user reviews,0,0,0
1053550,True,0,3 user reviews,3,0,3
1053560,True,0,7 user reviews,7,0,7
1053570,True,0,No user reviews,0,0,0
1053580,True,0,No user reviews,0,0,0
1053590,True,0,5 user reviews,0,5,5
1053600,True,0,No user reviews,0,0,0
1053620,True,0,6 user reviews,6,0,6
1053640,True,0,No user reviews,0,0,0
1053650,True,7,Positive,14,2,16
1053660,True,5,Mixed,7,6,13
1053670,True,0,No user reviews,0,0,0
1053680,True,8,Very Positive,616,61,677
1053700,True,0,No user reviews,0,0,0
1053720,True,0,No user reviews,0,0,0
1053730,True,0,9 user reviews,5,4,9
1053750,True,0,4 user reviews,3,1,4
1053780,True,0,8 user reviews,7,1,8
1053800,True,0,3 user reviews,3,0,3
1053810,True,0,No user reviews,0,0,0
1053820,True,0,1 user reviews,0,1,1
1053830,True,7,Positive,24,2,26
1053850,True,0,7 user reviews,3,4,7
1053860,True,0,No user reviews,0,0,0
1053870,True,0,1 user reviews,0,1,1
1053900,True,0,No user reviews,0,0,0
1053920,True,0,3 user reviews,3,0,3
1053940,True,0,4 user reviews,2,2,4
1053960,True,0,No user reviews,0,0,0
1053970,True,0,2 user reviews,1,1,2
1053980,True,0,No user reviews,0,0,0
1053990,True,0,No user reviews,0,0,0
1054000,True,0,No user reviews,0,0,0
1054010,True,0,No user reviews,0,0,0
1054020,True,0,No user reviews,0,0,0
1054030,True,0,5 user reviews,2,3,5
1054050,True,0,4 user reviews,2,2,4
1054070,True,0,No user reviews,0,0,0
1054071,True,7,Positive,13,3,16
1054080,True,0,No user reviews,0,0,0
1054090,True,0,6 user reviews,4,2,6
1054110,True,6,Mostly Positive,35,12,47
1054120,True,4,Mostly Negative,4,7,11
1054150,True,0,1 user reviews,1,0,1
1054180,True,0,2 user reviews,2,0,2
1054190,True,0,No user reviews,0,0,0
1054240,True,0,2 user reviews,2,0,2
1054250,True,0,1 user reviews,0,1,1
1054260,True,0,No user reviews,0,0,0
1054270,True,7,Positive,19,0,19
1054280,True,0,No user reviews,0,0,0
1054290,True,0,9 user reviews,3,6,9
1054300,True,0,No user reviews,0,0,0
1054310,True,0,5 user reviews,2,3,5
1054340,True,0,No user reviews,0,0,0
1054350,True,0,No user reviews,0,0,0
1054370,True,0,1 user reviews,1,0,1
1054390,True,7,Positive,37,7,44
1054430,True,0,No user reviews,0,0,0
1054440,True,0,No user reviews,0,0,0
1054450,True,0,No user reviews,0,0,0
1054460,True,0,No user reviews,0,0,0
1054470,True,0,8 user reviews,6,2,8
1054480,True,5,Mixed,58,41,99
1054490,True,8,Very Positive,462,35,497
1054500,True,0,No user reviews,0,0,0
1054510,True,8,Very Positive,447,64,511
1054520,True,0,1 user reviews,0,1,1
1054530,True,0,No user reviews,0,0,0
1054550,True,6,Mostly Positive,89,24,113
1054560,True,0,No user reviews,0,0,0
1054570,True,0,1 user reviews,0,1,1
1054580,True,0,No user reviews,0,0,0
1054590,True,0,No user reviews,0,0,0
1054600,True,0,No user reviews,0,0,0
1054610,True,0,1 user reviews,1,0,1
1054620,True,0,2 user reviews,2,0,2
1054630,True,0,No user reviews,0,0,0
1054640,True,0,1 user reviews,1,0,1
1054650,True,0,4 user reviews,2,2,4
1054660,True,7,Positive,36,1,37
1054670,True,0,1 user reviews,1,0,1
1054680,True,0,No user reviews,0,0,0
1054690,True,6,Mostly Positive,20,7,27
1054700,True,7,Positive,31,7,38
1054710,True,6,Mostly Positive,19,5,24
1054720,True,0,2 user reviews,1,1,2
1054730,True,0,7 user reviews,5,2,7
1054750,True,0,No user reviews,0,0,0
1054770,True,0,2 user reviews,1,1,2
1054780,True,0,No user reviews,0,0,0
1054790,True,0,5 user reviews,5,0,5
1054800,True,6,Mostly Positive,12,4,16
1054810,True,0,No user reviews,0,0,0
1054820,True,0,No user reviews,0,0,0
1054840,True,0,No user reviews,0,0,0
1054850,True,0,1 user reviews,0,1,1
1054870,True,0,No user reviews,0,0,0
1054871,True,0,No user reviews,0,0,0
1054872,True,0,No user reviews,0,0,0
1054873,True,0,4 user reviews,4,0,4
1054900,True,0,1 user reviews,0,1,1
1054920,True,0,No user reviews,0,0,0
1054921,True,0,No user reviews,0,0,0
1054930,True,0,4 user reviews,1,3,4
1054950,True,0,No user reviews,0,0,0
1054960,True,0,No user reviews,0,0,0
1054980,True,0,4 user reviews,3,1,4
1054990,True,0,6 user reviews,4,2,6
1055000,True,0,2 user reviews,0,2,2
1055010,True,5,Mixed,59,36,95
1055020,True,0,No user reviews,0,0,0
1055030,True,0,1 user reviews,1,0,1
1055060,True,0,No user reviews,0,0,0
1055061,True,0,No user reviews,0,0,0
1055062,True,0,No user reviews,0,0,0
1055063,True,0,No user reviews,0,0,0
1055064,True,0,No user reviews,0,0,0
1055065,True,0,No user reviews,0,0,0
1055066,True,0,No user reviews,0,0,0
1055067,True,0,No user reviews,0,0,0
1055070,True,0,No user reviews,0,0,0
1055071,True,0,No user reviews,0,0,0
1055072,True,0,No user reviews,0,0,0
1055073,True,0,No user reviews,0,0,0
1055090,True,5,Mixed,143,70,213
1055140,True,0,1 user reviews,1,0,1
1055150,True,0,3 user reviews,3,0,3
1055160,True,0,No user reviews,0,0,0
1055170,True,0,No user reviews,0,0,0
1055180,True,0,3 user reviews,2,1,3
1055210,True,0,3 user reviews,3,0,3
1055220,True,0,3 user reviews,3,0,3
1055240,True,0,No user reviews,0,0,0
1055250,True,0,No user reviews,0,0,0
1055260,True,0,No user reviews,0,0,0
1055270,True,0,No user reviews,0,0,0
1055280,True,0,1 user reviews,1,0,1
1055290,True,7,Positive,20,2,22
1055310,True,5,Mixed,6,6,12
1055331,True,0,3 user reviews,3,0,3
1055332,True,0,5 user reviews,1,4,5
1055333,True,6,Mostly Positive,20,8,28
1055334,True,0,1 user reviews,1,0,1
1055335,True,0,2 user reviews,1,1,2
1055336,True,0,2 user reviews,2,0,2
1055338,True,7,Positive,12,0,12
1055339,True,0,3 user reviews,2,1,3
1055340,True,0,No user reviews,0,0,0
1055360,True,0,No user reviews,0,0,0
1055380,True,0,No user reviews,0,0,0
1055410,True,0,1 user reviews,1,0,1
1055420,True,0,No user reviews,0,0,0
1055430,True,8,Very Positive,302,29,331
1055440,True,0,No user reviews,0,0,0
1055460,True,0,No user reviews,0,0,0
1055490,True,6,Mostly Positive,37,14,51
1055540,True,9,Overwhelmingly Positive,2772,22,2794
1055550,True,0,No user reviews,0,0,0
1055580,True,0,6 user reviews,6,0,6
1055590,True,0,5 user reviews,3,2,5
1055610,True,8,Very Positive,90,9,99
1055620,True,7,Positive,18,3,21
1055630,True,0,No user reviews,0,0,0
1055640,True,0,No user reviews,0,0,0
1055650,True,0,No user reviews,0,0,0
1055660,True,0,No user reviews,0,0,0
1055670,True,0,6 user reviews,4,2,6
1055680,True,0,2 user reviews,2,0,2
1055690,True,0,8 user reviews,8,0,8
1055700,True,0,No user reviews,0,0,0
1055710,True,0,No user reviews,0,0,0
1055720,True,0,No user reviews,0,0,0
1055760,True,0,No user reviews,0,0,0
1055770,True,0,No user reviews,0,0,0
1055780,True,0,2 user reviews,2,0,2
1055790,True,0,No user reviews,0,0,0
1055810,True,8,Very Positive,181,2,183
1055840,True,0,No user reviews,0,0,0
1055850,True,0,No user reviews,0,0,0
1055860,True,0,No user reviews,0,0,0
1055861,True,0,No user reviews,0,0,0
1055870,True,0,No user reviews,0,0,0
1055880,True,0,9 user reviews,9,0,9
1055890,True,0,8 user reviews,8,0,8
1055900,True,0,No user reviews,0,0,0
1055910,True,0,2 user reviews,2,0,2
1055930,True,0,1 user reviews,0,1,1
1055940,True,0,No user reviews,0,0,0
1055950,True,0,1 user reviews,1,0,1
1055960,True,0,No user reviews,0,0,0
1055970,True,0,No user reviews,0,0,0
1055990,True,8,Very Positive,159,21,180
1056000,True,0,No user reviews,0,0,0
1056010,True,0,1 user reviews,1,0,1
1056040,True,0,3 user reviews,3,0,3
1056050,True,4,Mostly Negative,3,7,10
1056060,True,0,No user reviews,0,0,0
1056070,True,0,1 user reviews,1,0,1
1056080,True,0,4 user reviews,0,4,4
1056100,True,0,No user reviews,0,0,0
1056140,True,0,No user reviews,0,0,0
1056170,True,6,Mostly Positive,17,5,22
1056180,True,8,Very Positive,54,9,63
1056190,True,0,No user reviews,0,0,0
1056210,True,0,No user reviews,0,0,0
1056220,True,0,No user reviews,0,0,0
1056230,True,0,5 user reviews,4,1,5
1056240,True,0,No user reviews,0,0,0
1056241,True,0,No user reviews,0,0,0
1056242,True,0,No user reviews,0,0,0
1056243,True,0,No user reviews,0,0,0
1056250,True,0,No user reviews,0,0,0
1056270,True,0,No user reviews,0,0,0
1056280,True,7,Positive,17,1,18
1056300,True,0,No user reviews,0,0,0
1056310,True,0,No user reviews,0,0,0
1056320,True,0,No user reviews,0,0,0
1056330,True,0,No user reviews,0,0,0
1056340,True,0,No user reviews,0,0,0
1056350,True,7,Positive,21,0,21
1056360,True,0,1 user reviews,1,0,1
1056370,True,0,No user reviews,0,0,0
1056380,True,0,No user reviews,0,0,0
1056390,True,8,Very Positive,54,7,61
1056400,True,0,2 user reviews,2,0,2
1056420,True,0,9 user reviews,3,6,9
1056450,True,0,No user reviews,0,0,0
1056470,True,0,9 user reviews,4,5,9
1056480,True,0,6 user reviews,4,2,6
1056490,True,7,Positive,29,2,31
1056510,True,6,Mostly Positive,8,3,11
1056520,True,0,3 user reviews,2,1,3
1056530,True,0,No user reviews,0,0,0
1056540,True,0,No user reviews,0,0,0
1056570,True,8,Very Positive,108,5,113
1056580,True,0,No user reviews,0,0,0
1056590,True,0,8 user reviews,6,2,8
1056610,True,7,Positive,20,2,22
1056620,True,0,No user reviews,0,0,0
1056621,True,0,No user reviews,0,0,0
1056622,True,0,1 user reviews,1,0,1
1056623,True,0,1 user reviews,0,1,1
1056624,True,0,No user reviews,0,0,0
1056625,True,0,No user reviews,0,0,0
1056626,True,0,No user reviews,0,0,0
1056627,True,0,No user reviews,0,0,0
1056628,True,0,No user reviews,0,0,0
1056629,True,0,No user reviews,0,0,0
1056630,True,0,No user reviews,0,0,0
1056640,True,0,1 user reviews,1,0,1
1056650,True,0,2 user reviews,1,1,2
1056660,True,0,4 user reviews,1,3,4
1056670,True,0,No user reviews,0,0,0
1056680,True,0,No user reviews,0,0,0
1056690,True,7,Positive,21,1,22
1056700,True,7,Positive,18,1,19
1056710,True,0,No user reviews,0,0,0
1056720,True,7,Positive,27,0,27
1056730,True,0,1 user reviews,1,0,1
1056750,True,7,Positive,21,5,26
1056760,True,8,Very Positive,232,37,269
1056761,True,8,Very Positive,55,12,67
1056770,True,0,No user reviews,0,0,0
1056780,True,7,Positive,14,1,15
1056840,True,0,No user reviews,0,0,0
1056860,True,0,No user reviews,0,0,0
1056870,True,0,3 user reviews,2,1,3
1056880,True,0,2 user reviews,1,1,2
1056890,True,0,4 user reviews,1,3,4
1056900,True,0,1 user reviews,1,0,1
1056910,True,0,No user reviews,0,0,0
1056920,True,0,No user reviews,0,0,0
1056930,True,0,No user reviews,0,0,0
1056940,True,0,3 user reviews,1,2,3
1056960,True,5,Mixed,1329,1418,2747
1056970,True,4,Mostly Negative,30,54,84
1057020,True,0,No user reviews,0,0,0
1057030,True,0,No user reviews,0,0,0
1057040,True,0,No user reviews,0,0,0
1057060,True,0,2 user reviews,2,0,2
1057070,True,0,2 user reviews,2,0,2
1057090,True,9,Overwhelmingly Positive,9528,347,9875
1057120,True,0,1 user reviews,1,0,1
1057130,True,0,No user reviews,0,0,0
1057150,True,0,No user reviews,0,0,0
1057160,True,0,3 user reviews,3,0,3
1057180,True,5,Mixed,83,52,135
1057190,True,0,No user reviews,0,0,0
1057220,True,0,No user reviews,0,0,0
1057240,True,5,Mixed,36,17,53
1057250,True,0,1 user reviews,1,0,1
1057260,True,0,No user reviews,0,0,0
1057261,True,0,No user reviews,0,0,0
1057262,True,0,No user reviews,0,0,0
1057263,True,0,No user reviews,0,0,0
1057264,True,0,No user reviews,0,0,0
1057265,True,0,No user reviews,0,0,0
1057270,True,7,Positive,12,2,14
1057271,True,7,Positive,9,1,10
1057272,True,0,4 user reviews,4,0,4
1057273,True,0,5 user reviews,5,0,5
1057274,True,0,1 user reviews,1,0,1
1057275,True,0,1 user reviews,1,0,1
1057276,True,0,3 user reviews,2,1,3
1057277,True,0,No user reviews,0,0,0
1057278,True,0,4 user reviews,3,1,4
1057279,True,0,3 user reviews,2,1,3
1057280,True,0,1 user reviews,1,0,1
1057281,True,0,3 user reviews,2,1,3
1057282,True,0,1 user reviews,1,0,1
1057283,True,0,3 user reviews,3,0,3
1057310,True,0,4 user reviews,2,2,4
1057390,True,0,3 user reviews,3,0,3
1057420,True,0,No user reviews,0,0,0
1057430,True,0,3 user reviews,3,0,3
1057450,True,0,No user reviews,0,0,0
1057460,True,0,No user reviews,0,0,0
1057470,True,0,No user reviews,0,0,0
1057490,True,6,Mostly Positive,15,4,19
1057500,True,0,4 user reviews,3,1,4
1057540,True,8,Very Positive,76,12,88
1057560,True,0,1 user reviews,1,0,1
1057570,True,0,No user reviews,0,0,0
1057580,True,0,No user reviews,0,0,0
1057590,True,0,No user reviews,0,0,0
1057600,True,0,No user reviews,0,0,0
1057610,True,0,No user reviews,0,0,0
1057630,True,0,No user reviews,0,0,0
1057640,True,7,Positive,34,8,42
1057670,True,0,No user reviews,0,0,0
1057680,True,0,3 user reviews,2,1,3
1057690,True,0,No user reviews,0,0,0
1057700,True,0,No user reviews,0,0,0
1057710,True,0,No user reviews,0,0,0
1057720,True,0,No user reviews,0,0,0
1057730,True,0,2 user reviews,0,2,2
1057740,True,0,No user reviews,0,0,0
1057750,True,5,Mixed,374,168,542
1057760,True,0,No user reviews,0,0,0
1057770,True,5,Mixed,5,6,11
1057780,True,7,Positive,26,2,28
1057790,True,0,No user reviews,0,0,0
1057800,True,0,No user reviews,0,0,0
1057810,True,5,Mixed,7,7,14
1057820,True,0,3 user reviews,1,2,3
1057850,True,0,No user reviews,0,0,0
1057880,True,0,No user reviews,0,0,0
1057900,True,0,No user reviews,0,0,0
1057910,True,0,No user reviews,0,0,0
1057920,True,0,No user reviews,0,0,0
1057970,True,0,No user reviews,0,0,0
1057980,True,7,Positive,12,0,12
1057990,True,0,No user reviews,0,0,0
1058000,True,0,No user reviews,0,0,0
1058020,True,9,Overwhelmingly Positive,1357,44,1401
1058030,True,0,No user reviews,0,0,0
1058040,True,0,No user reviews,0,0,0
1058050,True,0,No user reviews,0,0,0
1058060,True,6,Mostly Positive,17,6,23
1058110,True,5,Mixed,8,6,14
1058120,True,0,1 user reviews,1,0,1
1058121,True,0,1 user reviews,1,0,1
1058130,True,6,Mostly Positive,127,33,160
1058140,True,7,Positive,27,2,29
1058150,True,0,4 user reviews,1,3,4
1058170,True,0,No user reviews,0,0,0
1058180,True,8,Very Positive,93,2,95
1058190,True,5,Mixed,16,13,29
1058200,True,7,Positive,12,0,12
1058210,True,0,7 user reviews,4,3,7
1058220,True,0,4 user reviews,4,0,4
1058250,True,0,No user reviews,0,0,0
1058260,True,0,No user reviews,0,0,0
1058270,True,0,1 user reviews,1,0,1
1058280,True,0,No user reviews,0,0,0
1058290,True,0,No user reviews,0,0,0
1058300,True,0,9 user reviews,4,5,9
1058320,True,6,Mostly Positive,26,11,37
1058330,True,0,3 user reviews,2,1,3
1058340,True,0,No user reviews,0,0,0
1058350,True,7,Positive,11,1,12
1058360,True,4,Mostly Negative,3,7,10
1058370,True,0,No user reviews,0,0,0
1058380,True,6,Mostly Positive,37,12,49
1058390,True,0,2 user reviews,1,1,2
1058400,True,0,No user reviews,0,0,0
1058410,True,0,No user reviews,0,0,0
1058420,True,0,No user reviews,0,0,0
1058430,True,8,Very Positive,858,156,1014
1058440,True,0,No user reviews,0,0,0
1058450,True,8,Very Positive,379,54,433
1058460,True,0,No user reviews,0,0,0
1058461,True,0,No user reviews,0,0,0
1058462,True,0,No user reviews,0,0,0
1058463,True,0,1 user reviews,1,0,1
1058470,True,0,9 user reviews,9,0,9
1058490,True,0,7 user reviews,1,6,7
1058500,True,0,4 user reviews,2,2,4
1058510,True,0,1 user reviews,1,0,1
1058530,True,7,Positive,36,7,43
1058550,True,0,No user reviews,0,0,0
1058560,True,7,Positive,32,2,34
1058570,True,0,No user reviews,0,0,0
1058590,True,0,2 user reviews,2,0,2
1058600,True,0,No user reviews,0,0,0
1058620,True,0,No user reviews,0,0,0
1058630,True,0,2 user reviews,1,1,2
1058640,True,0,No user reviews,0,0,0
1058650,True,6,Mostly Positive,541,138,679
1058660,True,0,5 user reviews,1,4,5
1058680,True,0,3 user reviews,2,1,3
1058690,True,7,Positive,45,4,49
1058700,True,0,No user reviews,0,0,0
1058710,True,0,2 user reviews,2,0,2
1058730,True,0,No user reviews,0,0,0
1058740,True,7,Positive,22,3,25
1058750,True,0,2 user reviews,1,1,2
1058760,True,0,No user reviews,0,0,0
1058770,True,0,7 user reviews,7,0,7
1058800,True,7,Positive,23,5,28
1058830,True,9,Overwhelmingly Positive,870,21,891
1058840,True,0,4 user reviews,4,0,4
1058860,True,0,No user reviews,0,0,0
1058930,True,0,3 user reviews,2,1,3
1058940,True,0,1 user reviews,0,1,1
1058960,True,0,No user reviews,0,0,0
1058970,True,0,No user reviews,0,0,0
1058980,True,0,9 user reviews,6,3,9
1058990,True,0,No user reviews,0,0,0
1059000,True,0,No user reviews,0,0,0
1059040,True,7,Positive,9,2,11
1059050,True,0,No user reviews,0,0,0
1059080,True,0,2 user reviews,1,1,2
1059090,True,0,2 user reviews,2,0,2
1059110,True,0,No user reviews,0,0,0
1059120,True,0,No user reviews,0,0,0
1059140,True,0,No user reviews,0,0,0
1059150,True,6,Mostly Positive,9,3,12
1059160,True,0,7 user reviews,6,1,7
1059170,True,0,1 user reviews,1,0,1
1059190,True,0,8 user reviews,2,6,8
1059210,True,0,No user reviews,0,0,0
1059220,True,0,No user reviews,0,0,0
1059230,True,6,Mostly Positive,17,5,22
1059240,True,0,6 user reviews,3,3,6
1059250,True,0,No user reviews,0,0,0
1059260,True,0,No user reviews,0,0,0
1059280,True,5,Mixed,14,11,25
1059290,True,0,7 user reviews,5,2,7
1059291,True,0,4 user reviews,3,1,4
1059300,True,0,2 user reviews,2,0,2
1059310,True,0,3 user reviews,2,1,3
1059320,True,0,No user reviews,0,0,0
1059340,True,0,No user reviews,0,0,0
1059360,True,0,1 user reviews,1,0,1
1059370,True,0,3 user reviews,3,0,3
1059380,True,0,No user reviews,0,0,0
1059390,True,0,No user reviews,0,0,0
1059420,True,0,4 user reviews,4,0,4
1059430,True,6,Mostly Positive,41,11,52
1059440,True,0,3 user reviews,2,1,3
1059450,True,0,No user reviews,0,0,0
1059460,True,7,Positive,13,3,16
1059470,True,0,1 user reviews,1,0,1
1059480,True,0,No user reviews,0,0,0
1059500,True,0,2 user reviews,1,1,2
1059510,True,0,No user reviews,0,0,0
1059520,True,0,No user reviews,0,0,0
1059570,True,0,No user reviews,0,0,0
1059590,True,0,No user reviews,0,0,0
1059600,True,0,No user reviews,0,0,0
1059610,True,0,No user reviews,0,0,0
1059620,True,0,2 user reviews,0,2,2
1059630,True,0,No user reviews,0,0,0
1059640,True,0,2 user reviews,2,0,2
1059650,True,0,No user reviews,0,0,0
1059660,True,0,No user reviews,0,0,0
1059670,True,0,No user reviews,0,0,0
1059690,True,0,No user reviews,0,0,0
1059700,True,0,No user reviews,0,0,0
1059710,True,0,1 user reviews,1,0,1
1059720,True,0,No user reviews,0,0,0
1059740,True,0,No user reviews,0,0,0
1059760,True,0,1 user reviews,1,0,1
1059810,True,0,No user reviews,0,0,0
1059820,True,5,Mixed,24,18,42
1059830,True,0,2 user reviews,0,2,2
1059840,True,0,4 user reviews,3,1,4
1059860,True,0,No user reviews,0,0,0
1059870,True,0,No user reviews,0,0,0
1059880,True,8,Very Positive,55,10,65
1059890,True,0,9 user reviews,9,0,9
1059900,True,0,No user reviews,0,0,0
1059910,True,0,No user reviews,0,0,0
1059940,True,0,No user reviews,0,0,0
1059950,True,0,No user reviews,0,0,0
1059990,True,0,No user reviews,0,0,0
1060000,True,0,3 user reviews,2,1,3
1060020,True,0,No user reviews,0,0,0
1060040,True,0,No user reviews,0,0,0
1060060,True,0,4 user reviews,2,2,4
1060100,True,0,No user reviews,0,0,0
1060110,True,0,1 user reviews,0,1,1
1060120,True,0,No user reviews,0,0,0
1060140,True,0,No user reviews,0,0,0
1060160,True,0,No user reviews,0,0,0
1060170,True,0,5 user reviews,4,1,5
1060180,True,6,Mostly Positive,15,4,19
1060200,True,0,No user reviews,0,0,0
1060210,True,6,Mostly Positive,75,20,95
1060220,True,8,Very Positive,106,24,130
1060230,True,0,No user reviews,0,0,0
1060240,True,0,7 user reviews,7,0,7
1060270,True,0,No user reviews,0,0,0
1060280,True,0,No user reviews,0,0,0
1060300,True,5,Mixed,33,29,62
1060310,True,6,Mostly Positive,44,16,60
1060320,True,0,No user reviews,0,0,0
1060340,True,0,No user reviews,0,0,0
1060350,True,0,No user reviews,0,0,0
1060360,True,0,No user reviews,0,0,0
1060370,True,0,No user reviews,0,0,0
1060380,True,0,No user reviews,0,0,0
1060390,True,0,No user reviews,0,0,0
1060391,True,0,No user reviews,0,0,0
1060400,True,0,No user reviews,0,0,0
1060410,True,0,No user reviews,0,0,0
1060420,True,0,No user reviews,0,0,0
1060430,True,0,No user reviews,0,0,0
1060450,True,0,No user reviews,0,0,0
1060460,True,0,6 user reviews,5,1,6
1060470,True,0,3 user reviews,1,2,3
1060510,True,0,No user reviews,0,0,0
1060520,True,0,No user reviews,0,0,0
1060550,True,0,1 user reviews,1,0,1
1060560,True,0,No user reviews,0,0,0
1060570,True,0,8 user reviews,6,2,8
1060590,True,0,2 user reviews,2,0,2
1060600,True,8,Very Positive,397,3,400
1060610,True,0,No user reviews,0,0,0
1060620,True,0,7 user reviews,6,1,7
1060630,True,0,No user reviews,0,0,0
1060642,True,0,No user reviews,0,0,0
1060650,True,0,No user reviews,0,0,0
1060660,True,0,No user reviews,0,0,0
1060670,True,6,Mostly Positive,69,24,93
1060690,True,0,3 user reviews,1,2,3
1060700,True,0,No user reviews,0,0,0
1060730,True,0,No user reviews,0,0,0
1060740,True,0,No user reviews,0,0,0
1060770,True,0,3 user reviews,3,0,3
1060780,True,0,1 user reviews,1,0,1
1060810,True,0,2 user reviews,1,1,2
1060820,True,0,4 user reviews,3,1,4
1060830,True,0,No user reviews,0,0,0
1060840,True,0,1 user reviews,1,0,1
1060850,True,0,No user reviews,0,0,0
1060860,True,0,No user reviews,0,0,0
1060870,True,0,1 user reviews,1,0,1
1060880,True,0,No user reviews,0,0,0
1060890,True,0,No user reviews,0,0,0
1060900,True,0,No user reviews,0,0,0
1060910,True,0,1 user reviews,1,0,1
1060980,True,0,2 user reviews,2,0,2
1060990,True,0,No user reviews,0,0,0
1061010,True,0,4 user reviews,2,2,4
1061020,True,0,No user reviews,0,0,0
1061030,True,0,No user reviews,0,0,0
1061040,True,0,No user reviews,0,0,0
1061050,True,0,No user reviews,0,0,0
1061060,True,0,No user reviews,0,0,0
1061070,True,0,No user reviews,0,0,0
1061080,True,0,No user reviews,0,0,0
1061081,True,0,No user reviews,0,0,0
1061082,True,0,No user reviews,0,0,0
1061083,True,0,No user reviews,0,0,0
1061084,True,0,No user reviews,0,0,0
1061090,True,8,Very Positive,1282,108,1390
1061100,True,6,Mostly Positive,186,74,260
1061120,True,0,1 user reviews,1,0,1
1061140,True,0,No user reviews,0,0,0
1061150,True,0,No user reviews,0,0,0
1061160,True,0,5 user reviews,4,1,5
1061180,True,0,No user reviews,0,0,0
1061190,True,0,No user reviews,0,0,0
1061200,True,0,1 user reviews,1,0,1
1061210,True,0,No user reviews,0,0,0
1061220,True,0,1 user reviews,1,0,1
1061240,True,0,6 user reviews,2,4,6
1061250,True,0,No user reviews,0,0,0
1061260,True,0,1 user reviews,0,1,1
1061270,True,7,Positive,9,1,10
1061290,True,0,No user reviews,0,0,0
1061300,True,6,Mostly Positive,8,3,11
1061310,True,5,Mixed,11,5,16
1061350,True,5,Mixed,15,8,23
1061360,True,0,No user reviews,0,0,0
1061390,True,0,No user reviews,0,0,0
1061420,True,0,1 user reviews,1,0,1
1061430,True,0,No user reviews,0,0,0
1061440,True,0,No user reviews,0,0,0
1061441,True,0,No user reviews,0,0,0
1061442,True,0,No user reviews,0,0,0
1061443,True,0,No user reviews,0,0,0
1061460,True,0,No user reviews,0,0,0
1061470,True,7,Positive,11,1,12
1061490,True,5,Mixed,40,26,66
1061530,True,0,No user reviews,0,0,0
1061540,True,0,5 user reviews,5,0,5
1061550,True,0,No user reviews,0,0,0
1061560,True,0,No user reviews,0,0,0
1061600,True,0,No user reviews,0,0,0
1061610,True,7,Positive,42,0,42
1061620,True,0,3 user reviews,2,1,3
1061640,True,5,Mixed,10,12,22
1061650,True,0,4 user reviews,1,3,4
1061670,True,0,No user reviews,0,0,0
1061680,True,0,No user reviews,0,0,0
1061690,True,0,2 user reviews,2,0,2
1061700,True,0,4 user reviews,3,1,4
1061720,True,0,No user reviews,0,0,0
1061730,True,5,Mixed,71,62,133
1061740,True,0,4 user reviews,3,1,4
1061750,True,0,No user reviews,0,0,0
1061751,True,0,No user reviews,0,0,0
1061752,True,0,No user reviews,0,0,0
1061753,True,0,No user reviews,0,0,0
1061754,True,0,No user reviews,0,0,0
1061755,True,0,No user reviews,0,0,0
1061756,True,0,No user reviews,0,0,0
1061757,True,0,1 user reviews,0,1,1
1061760,True,0,No user reviews,0,0,0
1061770,True,0,No user reviews,0,0,0
1061790,True,0,No user reviews,0,0,0
1061800,True,0,No user reviews,0,0,0
1061810,True,0,No user reviews,0,0,0
1061820,True,5,Mixed,9,10,19
1061830,True,0,No user reviews,0,0,0
1061850,True,0,2 user reviews,2,0,2
1061880,True,0,No user reviews,0,0,0
1061900,True,0,5 user reviews,3,2,5
1061910,True,0,No user reviews,0,0,0
1061920,True,7,Positive,19,2,21
1061930,True,2,Very Negative,11,65,76
1061960,True,0,No user reviews,0,0,0
1061970,True,0,No user reviews,0,0,0
1061990,True,0,No user reviews,0,0,0
1062000,True,0,No user reviews,0,0,0
1062020,True,0,4 user reviews,2,2,4
1062030,True,0,No user reviews,0,0,0
1062040,True,8,Very Positive,67,15,82
1062050,True,0,No user reviews,0,0,0
1062060,True,7,Positive,13,2,15
1062070,True,0,No user reviews,0,0,0
1062080,True,0,3 user reviews,3,0,3
1062090,True,0,No user reviews,0,0,0
1062100,True,0,No user reviews,0,0,0
1062110,True,0,No user reviews,0,0,0
1062120,True,0,1 user reviews,1,0,1
1062130,True,0,No user reviews,0,0,0
1062140,True,0,No user reviews,0,0,0
1062160,True,9,Overwhelmingly Positive,1116,32,1148
1062180,True,0,No user reviews,0,0,0
1062190,True,0,No user reviews,0,0,0
1062200,True,0,1 user reviews,0,1,1
1062210,True,0,No user reviews,0,0,0
1062220,True,7,Positive,9,2,11
1062240,True,0,No user reviews,0,0,0
1062260,True,0,No user reviews,0,0,0
1062300,True,0,1 user reviews,1,0,1
1062330,True,0,No user reviews,0,0,0
1062340,True,8,Very Positive,53,13,66
1062390,True,0,No user reviews,0,0,0
1062400,True,0,No user reviews,0,0,0
1062410,True,0,No user reviews,0,0,0
1062420,True,0,5 user reviews,5,0,5
1062430,True,0,No user reviews,0,0,0
1062440,True,0,No user reviews,0,0,0
1062470,True,0,1 user reviews,0,1,1
1062480,True,0,3 user reviews,2,1,3
1062490,True,0,No user reviews,0,0,0
1062491,True,0,No user reviews,0,0,0
1062492,True,0,No user reviews,0,0,0
1062510,True,0,No user reviews,0,0,0
1062511,True,0,No user reviews,0,0,0
1062512,True,0,No user reviews,0,0,0
1062513,True,0,No user reviews,0,0,0
1062514,True,0,No user reviews,0,0,0
1062515,True,0,No user reviews,0,0,0
1062520,True,0,No user reviews,0,0,0
1062530,True,0,No user reviews,0,0,0
1062540,True,0,3 user reviews,2,1,3
1062570,True,0,No user reviews,0,0,0
1062590,True,5,Mixed,41,38,79
1062600,True,0,No user reviews,0,0,0
1062620,True,0,No user reviews,0,0,0
1062640,True,0,No user reviews,0,0,0
1062660,True,0,2 user reviews,1,1,2
1062670,True,0,1 user reviews,1,0,1
1062680,True,0,1 user reviews,1,0,1
1062690,True,0,No user reviews,0,0,0
1062830,True,8,Very Positive,140,5,145
1062850,True,0,No user reviews,0,0,0
1062860,True,0,No user reviews,0,0,0
1062930,True,0,No user reviews,0,0,0
1062960,True,6,Mostly Positive,164,70,234
1063040,True,6,Mostly Positive,10,4,14
1063050,True,5,Mixed,7,4,11
1063060,True,0,2 user reviews,2,0,2
1063070,True,0,2 user reviews,2,0,2
1063080,True,0,6 user reviews,6,0,6
1063100,True,0,No user reviews,0,0,0
1063110,True,0,5 user reviews,5,0,5
1063120,True,7,Positive,10,0,10
1063130,True,7,Positive,26,6,32
1063140,True,0,No user reviews,0,0,0
1063160,True,0,No user reviews,0,0,0
1063170,True,0,No user reviews,0,0,0
1063180,True,0,No user reviews,0,0,0
1063190,True,0,No user reviews,0,0,0
1063200,True,0,No user reviews,0,0,0
1063210,True,0,No user reviews,0,0,0
1063220,True,0,1 user reviews,1,0,1
1063230,True,0,6 user reviews,1,5,6
1063240,True,5,Mixed,9,4,13
1063270,True,0,1 user reviews,1,0,1
1063280,True,0,2 user reviews,0,2,2
1063300,True,0,2 user reviews,2,0,2
1063310,True,8,Very Positive,46,11,57
1063330,True,0,No user reviews,0,0,0
1063340,True,0,No user reviews,0,0,0
1063350,True,0,3 user reviews,3,0,3
1063360,True,0,1 user reviews,1,0,1
1063380,True,5,Mixed,6,4,10
1063400,True,0,No user reviews,0,0,0
1063430,True,0,2 user reviews,1,1,2
1063440,True,4,Mostly Negative,5,14,19
1063450,True,4,Mostly Negative,10,21,31
1063470,True,0,4 user reviews,2,2,4
1063480,True,0,No user reviews,0,0,0
1063490,True,8,Very Positive,161,23,184
1063500,True,0,1 user reviews,0,1,1
1063510,True,0,No user reviews,0,0,0
1063520,True,0,3 user reviews,2,1,3
1063530,True,0,No user reviews,0,0,0
1063540,True,0,No user reviews,0,0,0
1063560,True,5,Mixed,7,6,13
1063570,True,0,No user reviews,0,0,0
1063580,True,8,Very Positive,72,10,82
1063700,True,0,No user reviews,0,0,0
1063710,True,0,2 user reviews,2,0,2
1063730,True,0,No user reviews,0,0,0
1063740,True,0,No user reviews,0,0,0
1063770,True,0,No user reviews,0,0,0
1063780,True,0,No user reviews,0,0,0
1063781,True,0,No user reviews,0,0,0
1063790,True,8,Very Positive,69,13,82
1063800,True,0,2 user reviews,1,1,2
1063820,True,0,No user reviews,0,0,0
1063830,True,7,Positive,20,3,23
1063850,True,0,8 user reviews,6,2,8
1063860,True,0,9 user reviews,7,2,9
1063870,True,0,2 user reviews,2,0,2
1063880,True,0,No user reviews,0,0,0
1063890,True,6,Mostly Positive,19,8,27
1063910,True,0,No user reviews,0,0,0
1063920,True,0,No user reviews,0,0,0
1063921,True,0,No user reviews,0,0,0
1063922,True,0,No user reviews,0,0,0
1063923,True,0,No user reviews,0,0,0
1063930,True,5,Mixed,9,12,21
1063940,True,0,No user reviews,0,0,0
1063950,True,0,No user reviews,0,0,0
1063960,True,0,4 user reviews,4,0,4
1063970,True,0,No user reviews,0,0,0
1063980,True,0,No user reviews,0,0,0
1063990,True,0,No user reviews,0,0,0
1064000,True,0,No user reviews,0,0,0
1064010,True,7,Positive,19,3,22
1064020,True,0,No user reviews,0,0,0
1064030,True,0,No user reviews,0,0,0
1064040,True,0,No user reviews,0,0,0
1064050,True,0,2 user reviews,2,0,2
1064060,True,5,Mixed,16,13,29
1064070,True,0,No user reviews,0,0,0
1064080,True,0,9 user reviews,8,1,9
1064090,True,7,Positive,8,2,10
1064100,True,0,No user reviews,0,0,0
1064120,True,0,No user reviews,0,0,0
1064130,True,7,Positive,21,1,22
1064140,True,0,No user reviews,0,0,0
1064150,True,0,No user reviews,0,0,0
1064160,True,5,Mixed,19,12,31
1064170,True,0,No user reviews,0,0,0
1064190,True,0,No user reviews,0,0,0
1064191,True,0,1 user reviews,0,1,1
1064192,True,0,No user reviews,0,0,0
1064200,True,7,Positive,18,1,19
1064210,True,0,No user reviews,0,0,0
1064211,True,0,No user reviews,0,0,0
1064212,True,0,No user reviews,0,0,0
1064213,True,0,No user reviews,0,0,0
1064214,True,0,No user reviews,0,0,0
1064215,True,0,No user reviews,0,0,0
1064216,True,0,No user reviews,0,0,0
1064217,True,0,No user reviews,0,0,0
1064218,True,0,No user reviews,0,0,0
1064219,True,0,No user reviews,0,0,0
1064220,True,6,Mostly Positive,2356,757,3113
1064221,True,5,Mixed,580,275,855
1064230,True,0,No user reviews,0,0,0
1064240,True,0,No user reviews,0,0,0
1064260,True,0,No user reviews,0,0,0
1064270,True,6,Mostly Positive,506,184,690
1064271,True,8,Very Positive,1068,134,1202
1064272,True,8,Very Positive,274,41,315
1064273,True,0,No user reviews,0,0,0
1064310,True,5,Mixed,20,10,30
1064320,True,0,8 user reviews,8,0,8
1064360,True,0,No user reviews,0,0,0
1064420,True,0,No user reviews,0,0,0
1064440,True,0,1 user reviews,1,0,1
1064450,True,0,1 user reviews,1,0,1
1064460,True,8,Very Positive,161,13,174
1064470,True,0,No user reviews,0,0,0
1064480,True,0,1 user reviews,1,0,1
1064490,True,0,No user reviews,0,0,0
1064500,True,0,No user reviews,0,0,0
1064520,True,0,No user reviews,0,0,0
1064540,True,0,6 user reviews,5,1,6
1064550,True,0,No user reviews,0,0,0
1064560,True,0,No user reviews,0,0,0
1064570,True,0,No user reviews,0,0,0
1064580,True,0,9 user reviews,9,0,9
1064590,True,0,9 user reviews,9,0,9
1064600,True,0,No user reviews,0,0,0
1064610,True,8,Very Positive,59,1,60
1064620,True,0,1 user reviews,1,0,1
1064630,True,0,No user reviews,0,0,0
1064650,True,0,2 user reviews,1,1,2
1064660,True,6,Mostly Positive,59,17,76
1064670,True,0,No user reviews,0,0,0
1064690,True,7,Positive,20,0,20
1064710,True,0,1 user reviews,1,0,1
1064720,True,0,3 user reviews,3,0,3
1064730,True,8,Very Positive,160,30,190
1064740,True,0,No user reviews,0,0,0
1064750,True,0,No user reviews,0,0,0
1064760,True,0,No user reviews,0,0,0
1064780,True,0,No user reviews,0,0,0
1064800,True,0,8 user reviews,6,2,8
1064810,True,0,1 user reviews,1,0,1
1064820,True,5,Mixed,9,4,13
1064830,True,0,No user reviews,0,0,0
1064840,True,6,Mostly Positive,19,6,25
1064860,True,0,7 user reviews,3,4,7
1064900,True,0,8 user reviews,8,0,8
1064910,True,0,5 user reviews,5,0,5
1064920,True,0,No user reviews,0,0,0
1064950,True,0,No user reviews,0,0,0
1064960,True,0,No user reviews,0,0,0
1064970,True,0,7 user reviews,6,1,7
1064980,True,0,No user reviews,0,0,0
1064981,True,0,No user reviews,0,0,0
1064990,True,0,4 user reviews,1,3,4
1065020,True,8,Very Positive,102,5,107
1065030,True,0,No user reviews,0,0,0
1065050,True,0,No user reviews,0,0,0
1065070,True,0,No user reviews,0,0,0
1065100,True,8,Very Positive,234,8,242
1065110,True,0,No user reviews,0,0,0
1065140,True,0,3 user reviews,3,0,3
1065150,True,0,No user reviews,0,0,0
1065160,True,0,3 user reviews,1,2,3
1065180,True,7,Positive,41,3,44
1065200,True,0,1 user reviews,1,0,1
1065210,True,5,Mixed,5,7,12
1065220,True,0,3 user reviews,3,0,3
1065221,True,0,1 user reviews,0,1,1
1065230,True,0,2 user reviews,2,0,2
1065240,True,0,No user reviews,0,0,0
1065250,True,0,1 user reviews,1,0,1
1065260,True,8,Very Positive,73,7,80
1065280,True,0,No user reviews,0,0,0
1065290,True,0,No user reviews,0,0,0
1065300,True,0,No user reviews,0,0,0
1065320,True,0,No user reviews,0,0,0
1065330,True,0,No user reviews,0,0,0
1065350,True,0,No user reviews,0,0,0
1065370,True,0,No user reviews,0,0,0
1065380,True,5,Mixed,23,12,35
1065390,True,0,No user reviews,0,0,0
1065410,True,0,5 user reviews,5,0,5
1065460,True,7,Positive,13,0,13
1065490,True,6,Mostly Positive,12,4,16
1065491,True,5,Mixed,9,4,13
1065510,True,0,No user reviews,0,0,0
1065520,True,0,No user reviews,0,0,0
1065540,True,0,No user reviews,0,0,0
1065550,True,0,No user reviews,0,0,0
1065560,True,0,No user reviews,0,0,0
1065570,True,5,Mixed,11,8,19
1065580,True,5,Mixed,19,9,28
1065600,True,0,No user reviews,0,0,0
1065620,True,0,No user reviews,0,0,0
1065621,True,0,No user reviews,0,0,0
1065622,True,0,No user reviews,0,0,0
1065623,True,0,No user reviews,0,0,0
1065624,True,0,No user reviews,0,0,0
1065625,True,0,No user reviews,0,0,0
1065630,True,0,No user reviews,0,0,0
1065650,True,0,No user reviews,0,0,0
1065660,True,0,No user reviews,0,0,0
1065670,True,0,No user reviews,0,0,0
1065680,True,0,No user reviews,0,0,0
1065690,True,0,No user reviews,0,0,0
1065710,True,7,Positive,41,3,44
1065730,True,0,4 user reviews,4,0,4
1065740,True,0,No user reviews,0,0,0
1065750,True,0,No user reviews,0,0,0
1065770,True,0,1 user reviews,0,1,1
1065780,True,0,No user reviews,0,0,0
1065790,True,0,No user reviews,0,0,0
1065800,True,0,No user reviews,0,0,0
1065810,True,0,1 user reviews,1,0,1
1065820,True,0,No user reviews,0,0,0
1065830,True,0,4 user reviews,2,2,4
1065850,True,7,Positive,17,0,17
1065860,True,0,No user reviews,0,0,0
1065870,True,0,1 user reviews,1,0,1
1065880,True,8,Very Positive,68,0,68
1065890,True,0,4 user reviews,3,1,4
1065900,True,0,No user reviews,0,0,0
1065910,True,0,No user reviews,0,0,0
1065920,True,0,1 user reviews,1,0,1
1065930,True,0,No user reviews,0,0,0
1065940,True,5,Mixed,9,7,16
1065950,True,0,9 user reviews,6,3,9
1065960,True,0,3 user reviews,2,1,3
1065970,True,8,Very Positive,170,30,200
1065990,True,0,No user reviews,0,0,0
1066010,True,0,2 user reviews,2,0,2
1066030,True,0,5 user reviews,5,0,5
1066040,True,7,Positive,13,0,13
1066050,True,0,No user reviews,0,0,0
1066060,True,0,No user reviews,0,0,0
1066090,True,0,2 user reviews,2,0,2
1066100,True,0,No user reviews,0,0,0
1066101,True,0,No user reviews,0,0,0
1066110,True,0,8 user reviews,5,3,8
1066120,True,0,No user reviews,0,0,0
1066121,True,0,No user reviews,0,0,0
1066122,True,0,No user reviews,0,0,0
1066130,True,0,9 user reviews,4,5,9
1066140,True,6,Mostly Positive,30,10,40
1066150,True,0,7 user reviews,4,3,7
1066160,True,0,6 user reviews,3,3,6
1066180,True,8,Very Positive,63,11,74
1066190,True,5,Mixed,22,16,38
1066200,True,0,No user reviews,0,0,0
1066210,True,0,4 user reviews,2,2,4
1066220,True,0,6 user reviews,3,3,6
1066230,True,0,No user reviews,0,0,0
1066240,True,7,Positive,12,3,15
1066250,True,0,No user reviews,0,0,0
1066260,True,8,Very Positive,574,43,617
1066270,True,0,No user reviews,0,0,0
1066280,True,0,1 user reviews,1,0,1
1066290,True,0,1 user reviews,1,0,1
1066300,True,7,Positive,16,0,16
1066310,True,0,No user reviews,0,0,0
1066320,True,0,1 user reviews,1,0,1
1066330,True,0,No user reviews,0,0,0
1066340,True,0,No user reviews,0,0,0
1066350,True,0,No user reviews,0,0,0
1066370,True,0,No user reviews,0,0,0
1066380,True,0,No user reviews,0,0,0
1066390,True,0,No user reviews,0,0,0
1066400,True,0,No user reviews,0,0,0
1066420,True,0,No user reviews,0,0,0
1066430,True,0,6 user reviews,6,0,6
1066440,True,0,1 user reviews,0,1,1
1066460,True,0,No user reviews,0,0,0
1066490,True,0,No user reviews,0,0,0
1066530,True,0,No user reviews,0,0,0
1066540,True,0,No user reviews,0,0,0
1066560,True,0,No user reviews,0,0,0
1066570,True,0,No user reviews,0,0,0
1066580,True,0,No user reviews,0,0,0
1066590,True,0,No user reviews,0,0,0
1066600,True,5,Mixed,7,8,15
1066610,True,0,No user reviews,0,0,0
1066620,True,0,No user reviews,0,0,0
1066630,True,7,Positive,12,1,13
1066640,True,0,No user reviews,0,0,0
1066660,True,0,No user reviews,0,0,0
1066670,True,0,5 user reviews,4,1,5
1066700,True,0,1 user reviews,1,0,1
1066710,True,0,No user reviews,0,0,0
1066730,True,0,1 user reviews,0,1,1
1066740,True,0,No user reviews,0,0,0
1066760,True,0,No user reviews,0,0,0
1066780,True,8,Very Positive,2513,462,2975
1066810,True,0,7 user reviews,7,0,7
1066830,True,0,1 user reviews,1,0,1
1066840,True,0,1 user reviews,0,1,1
1066851,True,0,No user reviews,0,0,0
1066853,True,0,No user reviews,0,0,0
1066860,True,0,2 user reviews,1,1,2
1066890,True,8,Very Positive,692,119,811
1066900,True,0,No user reviews,0,0,0
1066920,True,0,1 user reviews,0,1,1
1066930,True,0,No user reviews,0,0,0
1066940,True,7,Positive,14,1,15
1066950,True,0,6 user reviews,6,0,6
1067010,True,0,2 user reviews,2,0,2
1067020,True,8,Very Positive,64,4,68
1067030,True,0,No user reviews,0,0,0
1067040,True,0,1 user reviews,0,1,1
1067050,True,0,1 user reviews,1,0,1
1067060,True,0,2 user reviews,1,1,2
1067080,True,0,6 user reviews,6,0,6
1067100,True,0,1 user reviews,1,0,1
1067110,True,0,No user reviews,0,0,0
1067120,True,0,No user reviews,0,0,0
1067130,True,0,No user reviews,0,0,0
1067150,True,0,4 user reviews,4,0,4
1067160,True,0,No user reviews,0,0,0
1067170,True,0,No user reviews,0,0,0
1067200,True,0,No user reviews,0,0,0
1067210,True,0,No user reviews,0,0,0
1067220,True,0,No user reviews,0,0,0
1067230,True,0,No user reviews,0,0,0
1067240,True,0,No user reviews,0,0,0
1067250,True,0,1 user reviews,0,1,1
1067270,True,0,No user reviews,0,0,0
1067280,True,0,No user reviews,0,0,0
1067310,True,0,No user reviews,0,0,0
1067320,True,0,No user reviews,0,0,0
1067340,True,0,1 user reviews,1,0,1
1067350,True,7,Positive,26,1,27
1067360,True,0,No user reviews,0,0,0
1067370,True,0,1 user reviews,1,0,1
1067380,True,0,No user reviews,0,0,0
1067390,True,0,4 user reviews,4,0,4
1067400,True,0,8 user reviews,7,1,8
1067410,True,0,No user reviews,0,0,0
1067430,True,7,Positive,11,1,12
1067440,True,0,1 user reviews,1,0,1
1067450,True,0,2 user reviews,1,1,2
1067460,True,0,2 user reviews,0,2,2
1067471,True,0,No user reviews,0,0,0
1067476,True,0,1 user reviews,1,0,1
1067520,True,0,2 user reviews,1,1,2
1067530,True,0,No user reviews,0,0,0
1067540,True,8,Very Positive,127,5,132
1067560,True,0,5 user reviews,1,4,5
1067580,True,6,Mostly Positive,10,3,13
1067590,True,6,Mostly Positive,17,5,22
1067600,True,0,No user reviews,0,0,0
1067630,True,0,5 user reviews,4,1,5
1067650,True,0,4 user reviews,2,2,4
1067660,True,0,No user reviews,0,0,0
1067680,True,0,No user reviews,0,0,0
1067690,True,8,Very Positive,175,7,182
1067710,True,0,No user reviews,0,0,0
1067720,True,7,Positive,32,2,34
1067730,True,0,1 user reviews,0,1,1
1067750,True,7,Positive,19,0,19
1067760,True,0,No user reviews,0,0,0
1067770,True,0,8 user reviews,8,0,8
1067780,True,0,No user reviews,0,0,0
1067800,True,0,No user reviews,0,0,0
1067810,True,0,4 user reviews,3,1,4
1067830,True,0,1 user reviews,1,0,1
1067850,True,9,Overwhelmingly Positive,905,29,934
1067860,True,8,Very Positive,97,16,113
1067900,True,0,No user reviews,0,0,0
1067910,True,0,No user reviews,0,0,0
1067920,True,0,No user reviews,0,0,0
1067921,True,0,No user reviews,0,0,0
1067930,True,0,No user reviews,0,0,0
1067980,True,0,No user reviews,0,0,0
1067990,True,0,No user reviews,0,0,0
1068000,True,0,No user reviews,0,0,0
1068020,True,0,No user reviews,0,0,0
1068050,True,0,No user reviews,0,0,0
1068070,True,0,No user reviews,0,0,0
1068100,True,0,1 user reviews,0,1,1
1068110,True,0,1 user reviews,1,0,1
1068120,True,0,No user reviews,0,0,0
1068130,True,0,1 user reviews,0,1,1
1068150,True,5,Mixed,33,34,67
1068160,True,0,No user reviews,0,0,0
1068190,True,0,No user reviews,0,0,0
1068210,True,0,5 user reviews,3,2,5
1068220,True,0,No user reviews,0,0,0
1068230,True,0,2 user reviews,0,2,2
1068260,True,6,Mostly Positive,12,4,16
1068290,True,8,Very Positive,121,0,121
1068300,True,0,No user reviews,0,0,0
1068310,True,0,No user reviews,0,0,0
1068320,True,0,No user reviews,0,0,0
1068330,True,0,No user reviews,0,0,0
1068340,True,0,2 user reviews,1,1,2
1068360,True,0,No user reviews,0,0,0
1068400,True,0,8 user reviews,8,0,8
1068420,True,0,No user reviews,0,0,0
1068480,True,0,8 user reviews,7,1,8
1068490,True,0,2 user reviews,1,1,2
1068510,True,0,No user reviews,0,0,0
1068520,True,0,No user reviews,0,0,0
1068530,True,5,Mixed,21,23,44
1068540,True,0,1 user reviews,1,0,1
1068550,True,0,No user reviews,0,0,0
1068560,True,0,No user reviews,0,0,0
1068570,True,0,No user reviews,0,0,0
1068580,True,0,No user reviews,0,0,0
1068600,True,0,7 user reviews,5,2,7
1068610,True,0,No user reviews,0,0,0
1068620,True,0,No user reviews,0,0,0
1068640,True,6,Mostly Positive,106,42,148
1068650,True,0,No user reviews,0,0,0
1068680,True,0,5 user reviews,5,0,5
1068700,True,0,3 user reviews,2,1,3
1068710,True,0,1 user reviews,1,0,1
1068760,True,0,No user reviews,0,0,0
1068770,True,0,2 user reviews,1,1,2
1068800,True,0,5 user reviews,4,1,5
1068810,True,0,1 user reviews,1,0,1
1068820,True,8,Very Positive,502,42,544
1068830,True,0,No user reviews,0,0,0
1068840,True,0,No user reviews,0,0,0
1068860,True,0,No user reviews,0,0,0
1068890,True,0,No user reviews,0,0,0
1068900,True,0,No user reviews,0,0,0
1068910,True,0,2 user reviews,2,0,2
1068970,True,0,No user reviews,0,0,0
1068980,True,0,No user reviews,0,0,0
1068990,True,0,2 user reviews,2,0,2
1069000,True,0,No user reviews,0,0,0
1069030,True,8,Very Positive,112,8,120
1069050,True,5,Mixed,9,6,15
1069070,True,0,No user reviews,0,0,0
1069080,True,0,No user reviews,0,0,0
1069090,True,0,No user reviews,0,0,0
1069100,True,0,No user reviews,0,0,0
1069120,True,0,No user reviews,0,0,0
1069130,True,0,No user reviews,0,0,0
1069140,True,0,8 user reviews,7,1,8
1069180,True,0,No user reviews,0,0,0
1069190,True,0,No user reviews,0,0,0
1069200,True,0,No user reviews,0,0,0
1069210,True,7,Positive,22,5,27
1069220,True,0,No user reviews,0,0,0
1069230,True,0,7 user reviews,7,0,7
1069250,True,0,3 user reviews,1,2,3
1069270,True,7,Positive,9,1,10
1069290,True,0,No user reviews,0,0,0
1069300,True,0,No user reviews,0,0,0
1069310,True,0,No user reviews,0,0,0
1069330,True,0,No user reviews,0,0,0
1069340,True,0,No user reviews,0,0,0
1069360,True,0,No user reviews,0,0,0
1069380,True,0,No user reviews,0,0,0
1069390,True,7,Positive,39,7,46
1069410,True,0,No user reviews,0,0,0
1069430,True,0,1 user reviews,0,1,1
1069450,True,0,1 user reviews,1,0,1
1069460,True,0,5 user reviews,4,1,5
1069470,True,0,9 user reviews,7,2,9
1069480,True,7,Positive,10,1,11
1069490,True,0,3 user reviews,3,0,3
1069500,True,0,1 user reviews,0,1,1
1069520,True,0,No user reviews,0,0,0
1069540,True,0,4 user reviews,2,2,4
1069550,True,0,No user reviews,0,0,0
1069552,True,0,No user reviews,0,0,0
1069580,True,5,Mixed,42,26,68
1069581,True,0,1 user reviews,1,0,1
1069590,True,0,No user reviews,0,0,0
1069600,True,0,3 user reviews,2,1,3
1069610,True,0,7 user reviews,6,1,7
1069620,True,0,No user reviews,0,0,0
1069630,True,0,No user reviews,0,0,0
1069640,True,6,Mostly Positive,619,198,817
1069650,True,6,Mostly Positive,255,89,344
1069660,True,0,No user reviews,0,0,0
1069670,True,0,No user reviews,0,0,0
1069690,True,0,No user reviews,0,0,0
1069710,True,0,No user reviews,0,0,0
1069720,True,0,No user reviews,0,0,0
1069730,True,0,5 user reviews,4,1,5
1069740,True,8,Very Positive,318,29,347
1069750,True,0,7 user reviews,7,0,7
1069760,True,8,Very Positive,213,12,225
1069770,True,0,No user reviews,0,0,0
1069790,True,0,No user reviews,0,0,0
1069810,True,0,No user reviews,0,0,0
1069820,True,0,9 user reviews,6,3,9
1069830,True,0,No user reviews,0,0,0
1069840,True,0,1 user reviews,1,0,1
1069850,True,7,Positive,17,2,19
1069900,True,5,Mixed,6,8,14
1069910,True,5,Mixed,8,5,13
1069920,True,0,1 user reviews,1,0,1
1069940,True,0,No user reviews,0,0,0
1069950,True,0,No user reviews,0,0,0
1069960,True,0,No user reviews,0,0,0
1069970,True,0,3 user reviews,3,0,3
1069980,True,0,No user reviews,0,0,0
1069990,True,0,4 user reviews,4,0,4
1070000,True,0,No user reviews,0,0,0
1070020,True,0,No user reviews,0,0,0
1070030,True,0,1 user reviews,1,0,1
1070040,True,0,No user reviews,0,0,0
1070050,True,0,No user reviews,0,0,0
1070051,True,0,No user reviews,0,0,0
1070052,True,0,1 user reviews,1,0,1
1070053,True,0,1 user reviews,1,0,1
1070054,True,0,No user reviews,0,0,0
1070055,True,0,No user reviews,0,0,0
1070056,True,0,No user reviews,0,0,0
1070057,True,0,No user reviews,0,0,0
1070058,True,0,No user reviews,0,0,0
1070059,True,0,No user reviews,0,0,0
1070060,True,0,No user reviews,0,0,0
1070100,True,0,No user reviews,0,0,0
1070110,True,0,4 user reviews,4,0,4
1070120,True,0,No user reviews,0,0,0
1070121,True,0,1 user reviews,1,0,1
1070122,True,0,No user reviews,0,0,0
1070123,True,0,No user reviews,0,0,0
1070130,True,0,No user reviews,0,0,0
1070131,True,0,No user reviews,0,0,0
1070132,True,0,No user reviews,0,0,0
1070140,True,0,No user reviews,0,0,0
1070141,True,0,No user reviews,0,0,0
1070142,True,0,No user reviews,0,0,0
1070150,True,8,Very Positive,63,3,66
1070160,True,0,1 user reviews,1,0,1
1070170,True,0,No user reviews,0,0,0
1070180,True,0,No user reviews,0,0,0
1070190,True,6,Mostly Positive,14,6,20
1070220,True,0,8 user reviews,6,2,8
1070230,True,0,4 user reviews,3,1,4
1070240,True,0,6 user reviews,1,5,6
1070250,True,0,9 user reviews,9,0,9
1070260,True,0,No user reviews,0,0,0
1070270,True,0,No user reviews,0,0,0
1070280,True,0,5 user reviews,2,3,5
1070300,True,0,3 user reviews,2,1,3
1070320,True,0,8 user reviews,6,2,8
1070330,True,8,Very Positive,528,44,572
1070350,True,0,2 user reviews,2,0,2
1070370,True,0,No user reviews,0,0,0
1070390,True,0,No user reviews,0,0,0
1070400,True,0,No user reviews,0,0,0
1070410,True,7,Positive,11,2,13
1070420,True,0,No user reviews,0,0,0
1070430,True,0,No user reviews,0,0,0
1070440,True,0,4 user reviews,4,0,4
1070450,True,0,1 user reviews,0,1,1
1070460,True,0,1 user reviews,1,0,1
1070510,True,7,Positive,15,0,15
1070520,True,0,No user reviews,0,0,0
1070550,True,8,Very Positive,60,0,60
1070580,True,8,Very Positive,869,76,945
1070590,True,0,No user reviews,0,0,0
1070600,True,0,1 user reviews,1,0,1
1070601,True,0,1 user reviews,1,0,1
1070602,True,0,2 user reviews,2,0,2
1070603,True,0,1 user reviews,1,0,1
1070604,True,0,No user reviews,0,0,0
1070605,True,0,No user reviews,0,0,0
1070606,True,0,No user reviews,0,0,0
1070660,True,0,No user reviews,0,0,0
1070661,True,0,No user reviews,0,0,0
1070662,True,0,No user reviews,0,0,0
1070663,True,0,No user reviews,0,0,0
1070664,True,0,No user reviews,0,0,0
1070690,True,6,Mostly Positive,21,8,29
1070700,True,0,No user reviews,0,0,0
1070701,True,0,No user reviews,0,0,0
1070702,True,0,No user reviews,0,0,0
1070703,True,0,No user reviews,0,0,0
1070704,True,0,No user reviews,0,0,0
1070705,True,0,No user reviews,0,0,0
1070706,True,0,No user reviews,0,0,0
1070707,True,0,No user reviews,0,0,0
1070710,True,9,Overwhelmingly Positive,3298,45,3343
1070720,True,0,No user reviews,0,0,0
1070770,True,0,2 user reviews,1,1,2
1070780,True,7,Positive,33,2,35
1070790,True,0,No user reviews,0,0,0
1070800,True,0,No user reviews,0,0,0
1070820,True,6,Mostly Positive,60,20,80
1070840,True,0,No user reviews,0,0,0
1070850,True,0,No user reviews,0,0,0
1070860,True,8,Very Positive,87,13,100
1070890,True,0,4 user reviews,3,1,4
1070910,True,0,No user reviews,0,0,0
1070940,True,6,Mostly Positive,58,18,76
1070950,True,0,No user reviews,0,0,0
1070960,True,0,1 user reviews,0,1,1
1070980,True,0,1 user reviews,1,0,1
1070990,True,0,3 user reviews,3,0,3
1071030,True,0,1 user reviews,0,1,1
1071050,True,0,No user reviews,0,0,0
1071051,True,0,No user reviews,0,0,0
1071060,True,0,5 user reviews,4,1,5
1071070,True,0,No user reviews,0,0,0
1071080,True,0,No user reviews,0,0,0
1071090,True,0,No user reviews,0,0,0
1071100,True,8,Very Positive,90,7,97
1071110,True,0,No user reviews,0,0,0
1071120,True,0,No user reviews,0,0,0
1071130,True,8,Very Positive,163,2,165
1071140,True,0,No user reviews,0,0,0
1071170,True,0,3 user reviews,2,1,3
1071180,True,0,No user reviews,0,0,0
1071190,True,7,Positive,12,0,12
1071200,True,5,Mixed,77,39,116
1071210,True,0,1 user reviews,1,0,1
1071220,True,0,No user reviews,0,0,0
1071230,True,0,No user reviews,0,0,0
1071240,True,0,No user reviews,0,0,0
1071260,True,0,5 user reviews,5,0,5
1071280,True,7,Positive,19,0,19
1071290,True,8,Very Positive,131,29,160
1071310,True,0,No user reviews,0,0,0
1071320,True,0,No user reviews,0,0,0
1071330,True,7,Positive,40,4,44
1071340,True,0,No user reviews,0,0,0
1071350,True,0,4 user reviews,3,1,4
1071371,True,0,No user reviews,0,0,0
1071372,True,0,No user reviews,0,0,0
1071373,True,0,2 user reviews,2,0,2
1071374,True,0,No user reviews,0,0,0
1071375,True,0,No user reviews,0,0,0
1071376,True,0,No user reviews,0,0,0
1071377,True,0,1 user reviews,1,0,1
1071378,True,0,No user reviews,0,0,0
1071379,True,0,1 user reviews,1,0,1
1071380,True,0,No user reviews,0,0,0
1071390,True,0,No user reviews,0,0,0
1071391,True,0,1 user reviews,1,0,1
1071392,True,0,1 user reviews,0,1,1
1071393,True,0,No user reviews,0,0,0
1071394,True,0,No user reviews,0,0,0
1071395,True,0,No user reviews,0,0,0
1071396,True,0,No user reviews,0,0,0
1071420,True,0,No user reviews,0,0,0
1071430,True,0,No user reviews,0,0,0
1071440,True,0,No user reviews,0,0,0
1071450,True,0,No user reviews,0,0,0
1071460,True,0,3 user reviews,3,0,3
1071470,True,0,No user reviews,0,0,0
1071480,True,0,No user reviews,0,0,0
1071490,True,0,8 user reviews,6,2,8
1071500,True,0,2 user reviews,1,1,2
1071510,True,7,Positive,28,3,31
1071540,True,0,No user reviews,0,0,0
1071550,True,0,No user reviews,0,0,0
1071560,True,0,No user reviews,0,0,0
1071580,True,0,1 user reviews,1,0,1
1071600,True,0,No user reviews,0,0,0
1071610,True,0,No user reviews,0,0,0
1071630,True,0,No user reviews,0,0,0
1071640,True,0,No user reviews,0,0,0
1071650,True,0,No user reviews,0,0,0
1071660,True,7,Positive,10,0,10
1071670,True,0,5 user reviews,1,4,5
1071680,True,8,Very Positive,51,10,61
1071690,True,0,No user reviews,0,0,0
1071700,True,0,No user reviews,0,0,0
1071740,True,0,No user reviews,0,0,0
1071750,True,0,No user reviews,0,0,0
1071760,True,0,1 user reviews,1,0,1
1071770,True,0,6 user reviews,4,2,6
1071780,True,0,No user reviews,0,0,0
1071800,True,0,No user reviews,0,0,0
1071810,True,0,7 user reviews,4,3,7
1071820,True,0,No user reviews,0,0,0
1071830,True,0,No user reviews,0,0,0
1071860,True,0,2 user reviews,2,0,2
1071870,True,8,Very Positive,349,30,379
1071880,True,0,No user reviews,0,0,0
1071890,True,0,No user reviews,0,0,0
1071900,True,0,No user reviews,0,0,0
1071920,True,0,3 user reviews,3,0,3
1071930,True,0,No user reviews,0,0,0
1071940,True,5,Mixed,24,15,39
1071950,True,0,No user reviews,0,0,0
1071960,True,0,No user reviews,0,0,0
1071970,True,0,1 user reviews,1,0,1
1071980,True,0,No user reviews,0,0,0
1071990,True,0,No user reviews,0,0,0
1072000,True,0,No user reviews,0,0,0
1072020,True,7,Positive,11,1,12
1072030,True,0,1 user reviews,1,0,1
1072040,True,6,Mostly Positive,545,145,690
1072050,True,0,1 user reviews,0,1,1
1072070,True,0,No user reviews,0,0,0
1072080,True,0,No user reviews,0,0,0
1072100,True,6,Mostly Positive,44,12,56
1072110,True,0,No user reviews,0,0,0
1072120,True,8,Very Positive,58,6,64
1072130,True,0,No user reviews,0,0,0
1072140,True,0,No user reviews,0,0,0
1072150,True,8,Very Positive,491,30,521
1072170,True,0,No user reviews,0,0,0
1072180,True,0,2 user reviews,2,0,2
1072200,True,0,No user reviews,0,0,0
1072210,True,0,No user reviews,0,0,0
1072220,True,0,No user reviews,0,0,0
1072221,True,0,No user reviews,0,0,0
1072222,True,0,No user reviews,0,0,0
1072230,True,0,No user reviews,0,0,0
1072250,True,0,No user reviews,0,0,0
1072260,True,0,No user reviews,0,0,0
1072270,True,6,Mostly Positive,8,3,11
1072280,True,0,2 user reviews,2,0,2
1072300,True,0,No user reviews,0,0,0
1072310,True,0,7 user reviews,5,2,7
1072340,True,0,No user reviews,0,0,0
1072350,True,0,5 user reviews,5,0,5
1072360,True,0,No user reviews,0,0,0
1072390,True,0,No user reviews,0,0,0
1072400,True,0,No user reviews,0,0,0
1072420,True,8,Very Positive,621,56,677
1072450,True,0,6 user reviews,4,2,6
1072460,True,0,No user reviews,0,0,0
1072480,True,5,Mixed,93,66,159
1072490,True,0,No user reviews,0,0,0
1072500,True,5,Mixed,91,42,133
1072520,True,0,No user reviews,0,0,0
1072530,True,0,No user reviews,0,0,0
1072550,True,0,No user reviews,0,0,0
1072560,True,0,No user reviews,0,0,0
1072561,True,7,Positive,12,0,12
1072562,True,8,Very Positive,152,17,169
1072590,True,7,Positive,13,2,15
1072600,True,0,No user reviews,0,0,0
1072610,True,7,Positive,11,1,12
1072620,True,5,Mixed,6,7,13
1072630,True,0,No user reviews,0,0,0
1072640,True,8,Very Positive,55,1,56
1072660,True,0,6 user reviews,0,6,6
1072670,True,0,No user reviews,0,0,0
1072680,True,0,4 user reviews,4,0,4
1072681,True,0,2 user reviews,2,0,2
1072690,True,0,No user reviews,0,0,0
1072710,True,8,Very Positive,108,5,113
1072720,True,0,1 user reviews,1,0,1
1072750,True,0,No user reviews,0,0,0
1072760,True,0,2 user reviews,2,0,2
1072790,True,0,No user reviews,0,0,0
1072800,True,0,6 user reviews,6,0,6
1072810,True,0,No user reviews,0,0,0
1072840,True,0,No user reviews,0,0,0
1072850,True,0,1 user reviews,0,1,1
1072860,True,7,Positive,13,1,14
1072870,True,0,7 user reviews,7,0,7
1072890,True,0,No user reviews,0,0,0
1072910,True,0,No user reviews,0,0,0
1072920,True,0,5 user reviews,2,3,5
1072930,True,0,No user reviews,0,0,0
1072950,True,6,Mostly Positive,10,3,13
1072970,True,0,No user reviews,0,0,0
1072980,True,0,No user reviews,0,0,0
1073000,True,0,No user reviews,0,0,0
1073020,True,0,No user reviews,0,0,0
1073040,True,0,1 user reviews,0,1,1
1073050,True,0,2 user reviews,1,1,2
1073060,True,0,No user reviews,0,0,0
1073070,True,0,No user reviews,0,0,0
1073080,True,0,2 user reviews,1,1,2
1073090,True,0,No user reviews,0,0,0
1073100,True,0,4 user reviews,4,0,4
1073110,True,0,No user reviews,0,0,0
1073130,True,0,1 user reviews,0,1,1
1073140,True,0,2 user reviews,1,1,2
1073160,True,0,No user reviews,0,0,0
1073180,True,0,No user reviews,0,0,0
1073210,True,5,Mixed,6,7,13
1073220,True,7,Positive,39,3,42
1073230,True,0,3 user reviews,2,1,3
1073260,True,0,No user reviews,0,0,0
1073280,True,0,8 user reviews,6,2,8
1073290,True,0,No user reviews,0,0,0
1073310,True,7,Positive,18,1,19
1073320,True,8,Very Positive,176,3,179
1073350,True,0,No user reviews,0,0,0
1073370,True,0,3 user reviews,2,1,3
1073380,True,0,No user reviews,0,0,0
1073390,True,0,No user reviews,0,0,0
1073400,True,0,No user reviews,0,0,0
1073410,True,0,9 user reviews,6,3,9
1073420,True,0,No user reviews,0,0,0
1073440,True,9,Overwhelmingly Positive,1290,66,1356
1073450,True,0,No user reviews,0,0,0
1073490,True,7,Positive,14,3,17
1073600,True,0,No user reviews,0,0,0
1073610,True,0,4 user reviews,4,0,4
1073620,True,0,No user reviews,0,0,0
1073630,True,0,2 user reviews,2,0,2
1073640,True,0,No user reviews,0,0,0
1073650,True,0,No user reviews,0,0,0
1073660,True,0,1 user reviews,1,0,1
1073680,True,0,No user reviews,0,0,0
1073681,True,0,No user reviews,0,0,0
1073710,True,0,1 user reviews,1,0,1
1073720,True,0,4 user reviews,3,1,4
1073730,True,0,No user reviews,0,0,0
1073740,True,0,No user reviews,0,0,0
1073750,True,0,No user reviews,0,0,0
1073770,True,7,Positive,14,2,16
1073780,True,0,No user reviews,0,0,0
1073790,True,0,No user reviews,0,0,0
1073810,True,7,Positive,26,0,26
1073820,True,8,Very Positive,79,9,88
1073830,True,0,No user reviews,0,0,0
1073840,True,7,Positive,34,3,37
1073850,True,0,No user reviews,0,0,0
1073860,True,0,No user reviews,0,0,0
1073870,True,7,Positive,19,1,20
1073880,True,0,No user reviews,0,0,0
1073890,True,0,No user reviews,0,0,0
1073900,True,7,Positive,29,1,30
1073930,True,0,No user reviews,0,0,0
1073940,True,0,No user reviews,0,0,0
1073960,True,0,1 user reviews,0,1,1
1073980,True,0,No user reviews,0,0,0
1073990,True,0,No user reviews,0,0,0
1074020,True,0,No user reviews,0,0,0
1074030,True,0,No user reviews,0,0,0
1074040,True,0,No user reviews,0,0,0
1074050,True,0,No user reviews,0,0,0
1074060,True,0,No user reviews,0,0,0
1074070,True,0,8 user reviews,5,3,8
1074080,True,8,Very Positive,98,16,114
1074090,True,0,No user reviews,0,0,0
1074100,True,0,No user reviews,0,0,0
1074110,True,0,No user reviews,0,0,0
1074150,True,0,2 user reviews,1,1,2
1074170,True,7,Positive,10,1,11
1074180,True,5,Mixed,30,13,43
1074190,True,0,No user reviews,0,0,0
1074200,True,0,No user reviews,0,0,0
1074201,True,0,No user reviews,0,0,0
1074202,True,0,1 user reviews,1,0,1
1074203,True,0,No user reviews,0,0,0
1074204,True,0,No user reviews,0,0,0
1074205,True,0,No user reviews,0,0,0
1074206,True,0,No user reviews,0,0,0
1074207,True,0,No user reviews,0,0,0
1074208,True,0,No user reviews,0,0,0
1074209,True,0,No user reviews,0,0,0
1074210,True,0,1 user reviews,1,0,1
1074211,True,0,2 user reviews,2,0,2
1074212,True,0,No user reviews,0,0,0
1074213,True,0,No user reviews,0,0,0
1074214,True,0,No user reviews,0,0,0
1074215,True,0,No user reviews,0,0,0
1074216,True,0,No user reviews,0,0,0
1074217,True,0,No user reviews,0,0,0
1074218,True,0,No user reviews,0,0,0
1074219,True,0,No user reviews,0,0,0
1074220,True,0,9 user reviews,8,1,9
1074250,True,0,No user reviews,0,0,0
1074260,True,0,6 user reviews,6,0,6
1074261,True,0,No user reviews,0,0,0
1074262,True,0,No user reviews,0,0,0
1074263,True,0,No user reviews,0,0,0
1074264,True,0,No user reviews,0,0,0
1074265,True,0,1 user reviews,0,1,1
1074266,True,0,No user reviews,0,0,0
1074267,True,0,No user reviews,0,0,0
1074270,True,0,8 user reviews,6,2,8
1074271,True,0,No user reviews,0,0,0
1074272,True,0,No user reviews,0,0,0
1074273,True,0,No user reviews,0,0,0
1074274,True,0,No user reviews,0,0,0
1074275,True,0,No user reviews,0,0,0
1074276,True,0,1 user reviews,0,1,1
1074277,True,0,No user reviews,0,0,0
1074280,True,0,No user reviews,0,0,0
1074300,True,0,8 user reviews,8,0,8
1074310,True,0,8 user reviews,8,0,8
1074320,True,6,Mostly Positive,455,149,604
1074321,True,0,No user reviews,0,0,0
1074330,True,0,3 user reviews,3,0,3
1074340,True,0,2 user reviews,2,0,2
1074350,True,0,No user reviews,0,0,0
1074360,True,0,No user reviews,0,0,0
1074370,True,0,5 user reviews,2,3,5
1074390,True,0,No user reviews,0,0,0
1074400,True,0,No user reviews,0,0,0
1074420,True,5,Mixed,38,20,58
1074450,True,0,No user reviews,0,0,0
1074490,True,0,No user reviews,0,0,0
1074500,True,0,1 user reviews,1,0,1
1074510,True,5,Mixed,10,6,16
1074520,True,7,Positive,18,1,19
1074530,True,0,2 user reviews,0,2,2
1074550,True,6,Mostly Positive,8,3,11
1074560,True,0,No user reviews,0,0,0
1074570,True,0,No user reviews,0,0,0
1074580,True,0,No user reviews,0,0,0
1074590,True,0,No user reviews,0,0,0
1074600,True,0,No user reviews,0,0,0
1074610,True,5,Mixed,22,10,32
1074620,True,8,Very Positive,57,12,69
1074630,True,6,Mostly Positive,48,18,66
1074640,True,0,6 user reviews,6,0,6
1074650,True,7,Positive,15,1,16
1074660,True,0,3 user reviews,1,2,3
1074670,True,0,No user reviews,0,0,0
1074680,True,0,No user reviews,0,0,0
1074690,True,0,No user reviews,0,0,0
1074700,True,0,5 user reviews,5,0,5
1074760,True,0,No user reviews,0,0,0
1074770,True,6,Mostly Positive,16,5,21
1074820,True,0,No user reviews,0,0,0
1074830,True,0,No user reviews,0,0,0
1074840,True,0,6 user reviews,2,4,6
1074860,True,0,No user reviews,0,0,0
1074870,True,0,1 user reviews,0,1,1
1074880,True,0,2 user reviews,2,0,2
1074900,True,0,3 user reviews,2,1,3
1074910,True,0,1 user reviews,1,0,1
1074920,True,0,1 user reviews,1,0,1
1074930,True,0,1 user reviews,1,0,1
1074960,True,0,No user reviews,0,0,0
1074980,True,0,7 user reviews,6,1,7
1074990,True,0,No user reviews,0,0,0
1075000,True,0,No user reviews,0,0,0
1075010,True,0,No user reviews,0,0,0
1075040,True,7,Positive,13,1,14
1075041,True,7,Positive,11,0,11
1075050,True,0,1 user reviews,1,0,1
1075060,True,0,No user reviews,0,0,0
1075080,True,6,Mostly Positive,30,12,42
1075100,True,0,No user reviews,0,0,0
1075101,True,0,1 user reviews,0,1,1
1075102,True,0,1 user reviews,0,1,1
1075103,True,0,1 user reviews,1,0,1
1075104,True,0,1 user reviews,0,1,1
1075105,True,0,No user reviews,0,0,0
1075120,True,0,No user reviews,0,0,0
1075140,True,0,No user reviews,0,0,0
1075150,True,0,No user reviews,0,0,0
1075170,True,0,No user reviews,0,0,0
1075180,True,0,No user reviews,0,0,0
1075190,True,6,Mostly Positive,286,82,368
1075200,True,0,No user reviews,0,0,0
1075210,True,0,No user reviews,0,0,0
1075350,True,0,No user reviews,0,0,0
1075370,True,0,4 user reviews,3,1,4
1075380,True,0,No user reviews,0,0,0
1075381,True,0,No user reviews,0,0,0
1075382,True,0,No user reviews,0,0,0
1075390,True,6,Mostly Positive,12,5,17
1075400,True,5,Mixed,69,39,108
1075410,True,0,No user reviews,0,0,0
1075430,True,0,No user reviews,0,0,0
1075440,True,0,No user reviews,0,0,0
1075450,True,0,No user reviews,0,0,0
1075451,True,0,No user reviews,0,0,0
1075452,True,0,No user reviews,0,0,0
1075453,True,0,No user reviews,0,0,0
1075460,True,0,No user reviews,0,0,0
1075480,True,0,1 user reviews,1,0,1
1075490,True,0,No user reviews,0,0,0
1075520,True,0,No user reviews,0,0,0
1075521,True,0,No user reviews,0,0,0
1075550,True,6,Mostly Positive,14,5,19
1075570,True,0,No user reviews,0,0,0
1075580,True,0,No user reviews,0,0,0
1075720,True,0,No user reviews,0,0,0
1075740,True,6,Mostly Positive,139,39,178
1075750,True,0,6 user reviews,5,1,6
1075770,True,0,1 user reviews,1,0,1
1075790,True,0,4 user reviews,1,3,4
1075820,True,0,No user reviews,0,0,0
1075830,True,0,No user reviews,0,0,0
1075840,True,0,No user reviews,0,0,0
1075850,True,0,1 user reviews,1,0,1
1075860,True,0,1 user reviews,1,0,1
1075870,True,0,No user reviews,0,0,0
1075890,True,0,No user reviews,0,0,0
1075900,True,0,No user reviews,0,0,0
1075910,True,0,No user reviews,0,0,0
1075920,True,0,No user reviews,0,0,0
1075950,True,0,No user reviews,0,0,0
1075960,True,0,No user reviews,0,0,0
1075970,True,0,No user reviews,0,0,0
1075980,True,8,Very Positive,75,6,81
1075990,True,0,1 user reviews,1,0,1
1075991,True,0,No user reviews,0,0,0
1075993,True,7,Positive,10,0,10
1075994,True,0,No user reviews,0,0,0
1075995,True,0,No user reviews,0,0,0
1075996,True,0,No user reviews,0,0,0
1075997,True,0,No user reviews,0,0,0
1075998,True,0,No user reviews,0,0,0
1075999,True,0,No user reviews,0,0,0
1076000,True,0,No user reviews,0,0,0
1076010,True,0,No user reviews,0,0,0
1076011,True,0,2 user reviews,1,1,2
1076012,True,0,2 user reviews,1,1,2
1076013,True,0,No user reviews,0,0,0
1076014,True,0,4 user reviews,3,1,4
1076015,True,7,Positive,10,0,10
1076020,True,0,No user reviews,0,0,0
1076030,True,0,No user reviews,0,0,0
1076040,True,0,1 user reviews,1,0,1
1076050,True,0,No user reviews,0,0,0
1076060,True,0,No user reviews,0,0,0
1076080,True,8,Very Positive,74,3,77
1076090,True,0,No user reviews,0,0,0
1076091,True,0,No user reviews,0,0,0
1076092,True,0,No user reviews,0,0,0
1076100,True,0,1 user reviews,0,1,1
1076110,True,0,1 user reviews,1,0,1
1076120,True,0,No user reviews,0,0,0
1076130,True,0,No user reviews,0,0,0
1076140,True,0,3 user reviews,2,1,3
1076150,True,6,Mostly Positive,19,6,25
1076160,True,8,Very Positive,230,52,282
1076170,True,0,No user reviews,0,0,0
1076180,True,0,No user reviews,0,0,0
1076190,True,0,No user reviews,0,0,0
1076200,True,0,No user reviews,0,0,0
1076210,True,8,Very Positive,47,11,58
1076230,True,7,Positive,37,9,46
1076290,True,0,7 user reviews,3,4,7
1076300,True,0,No user reviews,0,0,0
1076350,True,0,No user reviews,0,0,0
1076360,True,0,No user reviews,0,0,0
1076380,True,0,No user reviews,0,0,0
1076390,True,0,No user reviews,0,0,0
1076400,True,0,No user reviews,0,0,0
1076410,True,0,4 user reviews,0,4,4
1076420,True,0,No user reviews,0,0,0
1076430,True,0,No user reviews,0,0,0
1076450,True,0,1 user reviews,1,0,1
1076480,True,0,8 user reviews,8,0,8
1076490,True,0,No user reviews,0,0,0
1076500,True,0,No user reviews,0,0,0
1076530,True,0,2 user reviews,2,0,2
1076550,True,8,Very Positive,157,11,168
1076580,True,0,No user reviews,0,0,0
1076600,True,0,No user reviews,0,0,0
1076610,True,0,No user reviews,0,0,0
1076620,True,0,No user reviews,0,0,0
1076630,True,0,9 user reviews,6,3,9
1076640,True,5,Mixed,35,26,61
1076720,True,0,No user reviews,0,0,0
1076730,True,0,No user reviews,0,0,0
1076740,True,0,No user reviews,0,0,0
1076741,True,0,No user reviews,0,0,0
1076750,True,0,No user reviews,0,0,0
1076760,True,0,No user reviews,0,0,0
1076761,True,0,No user reviews,0,0,0
1076770,True,0,3 user reviews,3,0,3
1076780,True,0,2 user reviews,1,1,2
1076790,True,0,No user reviews,0,0,0
1076820,True,0,No user reviews,0,0,0
1076830,True,0,1 user reviews,1,0,1
1076840,True,0,No user reviews,0,0,0
1076850,True,6,Mostly Positive,34,9,43
1076860,True,0,No user reviews,0,0,0
1076870,True,0,No user reviews,0,0,0
1076880,True,8,Very Positive,127,6,133
1076890,True,0,No user reviews,0,0,0
1076920,True,5,Mixed,76,54,130
1076930,True,0,No user reviews,0,0,0
1076940,True,0,No user reviews,0,0,0
1076950,True,0,1 user reviews,0,1,1
1076960,True,0,No user reviews,0,0,0
1076970,True,0,No user reviews,0,0,0
1076980,True,0,No user reviews,0,0,0
1077010,True,0,No user reviews,0,0,0
1077030,True,0,No user reviews,0,0,0
1077060,True,0,No user reviews,0,0,0
1077080,True,0,No user reviews,0,0,0
1077090,True,0,4 user reviews,3,1,4
1077110,True,0,1 user reviews,1,0,1
1077150,True,0,No user reviews,0,0,0
1077160,True,0,No user reviews,0,0,0
1077170,True,0,1 user reviews,1,0,1
1077180,True,0,No user reviews,0,0,0
1077200,True,0,4 user reviews,3,1,4
1077210,True,0,5 user reviews,3,2,5
1077220,True,0,No user reviews,0,0,0
1077230,True,0,No user reviews,0,0,0
1077240,True,0,No user reviews,0,0,0
1077250,True,0,1 user reviews,1,0,1
1077270,True,0,No user reviews,0,0,0
1077280,True,0,No user reviews,0,0,0
1077290,True,8,Very Positive,143,12,155
1077300,True,0,No user reviews,0,0,0
1077320,True,0,3 user reviews,1,2,3
1077340,True,7,Positive,9,2,11
1077360,True,0,No user reviews,0,0,0
1077370,True,0,No user reviews,0,0,0
1077371,True,0,No user reviews,0,0,0
1077372,True,0,No user reviews,0,0,0
1077373,True,0,No user reviews,0,0,0
1077380,True,0,No user reviews,0,0,0
1077390,True,0,No user reviews,0,0,0
1077410,True,6,Mostly Positive,21,6,27
1077420,True,0,8 user reviews,8,0,8
1077430,True,8,Very Positive,85,15,100
1077440,True,0,No user reviews,0,0,0
1077450,True,7,Positive,39,0,39
1077470,True,0,4 user reviews,3,1,4
1077490,True,0,5 user reviews,4,1,5
1077500,True,0,No user reviews,0,0,0
1077510,True,0,No user reviews,0,0,0
1077520,True,8,Very Positive,71,14,85
1077530,True,8,Very Positive,70,14,84
1077540,True,0,No user reviews,0,0,0
1077550,True,4,Mostly Negative,5,9,14
1077560,True,0,No user reviews,0,0,0
1077570,True,0,1 user reviews,0,1,1
1077580,True,5,Mixed,25,19,44
1077590,True,0,No user reviews,0,0,0
1077600,True,7,Positive,23,1,24
1077610,True,0,2 user reviews,2,0,2
1077630,True,5,Mixed,12,8,20
1077680,True,0,No user reviews,0,0,0
1077690,True,6,Mostly Positive,46,15,61
1077700,True,0,No user reviews,0,0,0
1077710,True,0,No user reviews,0,0,0
1077730,True,0,No user reviews,0,0,0
1077740,True,0,No user reviews,0,0,0
1077760,True,0,1 user reviews,1,0,1
1077850,True,0,No user reviews,0,0,0
1077860,True,0,No user reviews,0,0,0
1077880,True,0,No user reviews,0,0,0
1077890,True,6,Mostly Positive,12,4,16
1077970,True,7,Positive,29,6,35
1077980,True,0,1 user reviews,1,0,1
1077990,True,0,6 user reviews,2,4,6
1078000,True,7,Positive,14,3,17
1078020,True,0,1 user reviews,1,0,1
1078030,True,0,No user reviews,0,0,0
1078040,True,0,2 user reviews,2,0,2
1078060,True,0,2 user reviews,1,1,2
1078080,True,0,No user reviews,0,0,0
1078100,True,0,No user reviews,0,0,0
1078120,True,0,No user reviews,0,0,0
1078130,True,0,No user reviews,0,0,0
1078140,True,0,No user reviews,0,0,0
1078150,True,0,1 user reviews,1,0,1
1078160,True,0,No user reviews,0,0,0
1078190,True,0,No user reviews,0,0,0
1078200,True,8,Very Positive,132,3,135
1078210,True,0,No user reviews,0,0,0
1078220,True,0,No user reviews,0,0,0
1078230,True,0,No user reviews,0,0,0
1078240,True,0,No user reviews,0,0,0
1078270,True,0,No user reviews,0,0,0
1078280,True,7,Positive,43,3,46
1078300,True,0,No user reviews,0,0,0
1078320,True,0,No user reviews,0,0,0
1078330,True,6,Mostly Positive,25,8,33
1078340,True,0,No user reviews,0,0,0
1078350,True,0,No user reviews,0,0,0
1078360,True,0,No user reviews,0,0,0
1078370,True,0,No user reviews,0,0,0
1078380,True,0,9 user reviews,6,3,9
1078390,True,0,No user reviews,0,0,0
1078400,True,0,No user reviews,0,0,0
1078420,True,0,No user reviews,0,0,0
1078450,True,0,1 user reviews,1,0,1
1078460,True,0,No user reviews,0,0,0
1078490,True,0,8 user reviews,5,3,8
1078500,True,0,No user reviews,0,0,0
1078510,True,8,Very Positive,97,9,106
1078520,True,0,8 user reviews,5,3,8
1078540,True,0,No user reviews,0,0,0
1078550,True,7,Positive,15,0,15
1078560,True,5,Mixed,10,10,20
1078570,True,0,No user reviews,0,0,0
1078590,True,0,No user reviews,0,0,0
1078610,True,0,No user reviews,0,0,0
1078620,True,0,No user reviews,0,0,0
1078640,True,5,Mixed,8,6,14
1078650,True,0,No user reviews,0,0,0
1078670,True,0,2 user reviews,1,1,2
1078690,True,0,No user reviews,0,0,0
1078700,True,0,No user reviews,0,0,0
1078710,True,0,No user reviews,0,0,0
1078730,True,0,No user reviews,0,0,0
1078740,True,0,No user reviews,0,0,0
1078741,True,0,No user reviews,0,0,0
1078750,True,0,4 user reviews,3,1,4
1078760,True,0,No user reviews,0,0,0
1078770,True,0,No user reviews,0,0,0
1078780,True,0,2 user reviews,1,1,2
1078790,True,0,No user reviews,0,0,0
1078800,True,0,No user reviews,0,0,0
1078810,True,0,3 user reviews,2,1,3
1078820,True,0,1 user reviews,1,0,1
1078840,True,0,7 user reviews,6,1,7
1078870,True,0,6 user reviews,5,1,6
1078880,True,0,No user reviews,0,0,0
1078890,True,0,No user reviews,0,0,0
1078900,True,0,No user reviews,0,0,0
1078920,True,8,Very Positive,89,4,93
1078930,True,0,2 user reviews,2,0,2
1078940,True,0,No user reviews,0,0,0
1078950,True,0,No user reviews,0,0,0
1078960,True,0,No user reviews,0,0,0
1078970,True,0,No user reviews,0,0,0
1078980,True,0,No user reviews,0,0,0
1078990,True,0,No user reviews,0,0,0
1079000,True,8,Very Positive,103,8,111
1079020,True,0,No user reviews,0,0,0
1079050,True,0,No user reviews,0,0,0
1079070,True,0,No user reviews,0,0,0
1079090,True,0,No user reviews,0,0,0
1079100,True,0,3 user reviews,1,2,3
1079110,True,0,4 user reviews,4,0,4
1079120,True,0,No user reviews,0,0,0
1079130,True,6,Mostly Positive,23,6,29
1079150,True,0,No user reviews,0,0,0
1079160,True,8,Very Positive,122,3,125
1079170,True,0,No user reviews,0,0,0
1079180,True,8,Very Positive,81,1,82
1079190,True,0,No user reviews,0,0,0
1079200,True,6,Mostly Positive,11,4,15
1079210,True,8,Very Positive,128,18,146
1079220,True,0,No user reviews,0,0,0
1079221,True,0,No user reviews,0,0,0
1079230,True,0,No user reviews,0,0,0
1079240,True,0,No user reviews,0,0,0
1079260,True,0,No user reviews,0,0,0
1079290,True,0,No user reviews,0,0,0
1079310,True,0,9 user reviews,8,1,9
1079320,True,7,Positive,18,3,21
1079330,True,0,1 user reviews,0,1,1
1079340,True,0,No user reviews,0,0,0
1079350,True,0,No user reviews,0,0,0
1079360,True,0,2 user reviews,2,0,2
1079420,True,0,1 user reviews,0,1,1
1079430,True,0,No user reviews,0,0,0
1079440,True,0,2 user reviews,1,1,2
1079450,True,8,Very Positive,53,0,53
1079460,True,0,4 user reviews,3,1,4
1079470,True,0,1 user reviews,1,0,1
1079480,True,0,No user reviews,0,0,0
1079490,True,0,No user reviews,0,0,0
1079510,True,0,No user reviews,0,0,0
1079520,True,0,5 user reviews,3,2,5
1079550,True,0,No user reviews,0,0,0
1079560,True,0,5 user reviews,5,0,5
1079570,True,0,No user reviews,0,0,0
1079600,True,0,2 user reviews,1,1,2
1079610,True,0,3 user reviews,3,0,3
1079620,True,8,Very Positive,220,44,264
1079630,True,6,Mostly Positive,11,3,14
1079650,True,0,No user reviews,0,0,0
1079680,True,0,No user reviews,0,0,0
1079690,True,0,No user reviews,0,0,0
1079700,True,0,No user reviews,0,0,0
1079710,True,0,3 user reviews,3,0,3
1079720,True,0,1 user reviews,1,0,1
1079730,True,0,2 user reviews,2,0,2
1079740,True,0,No user reviews,0,0,0
1079750,True,0,No user reviews,0,0,0
1079760,True,0,No user reviews,0,0,0
1079790,True,5,Mixed,9,9,18
1079800,True,8,Very Positive,1130,104,1234
1079810,True,0,No user reviews,0,0,0
1079830,True,0,No user reviews,0,0,0
1079870,True,0,No user reviews,0,0,0
1079880,True,0,No user reviews,0,0,0
1079890,True,0,No user reviews,0,0,0
1079910,True,0,1 user reviews,1,0,1
1079920,True,0,No user reviews,0,0,0
1079930,True,0,No user reviews,0,0,0
1079940,True,0,3 user reviews,1,2,3
1079970,True,0,3 user reviews,3,0,3
1079990,True,0,1 user reviews,1,0,1
1080000,True,0,No user reviews,0,0,0
1080001,True,0,1 user reviews,1,0,1
1080002,True,0,No user reviews,0,0,0
1080010,True,7,Positive,11,0,11
1080020,True,0,No user reviews,0,0,0
1080030,True,0,No user reviews,0,0,0
1080031,True,0,No user reviews,0,0,0
1080032,True,0,No user reviews,0,0,0
1080040,True,0,No user reviews,0,0,0
1080060,True,0,No user reviews,0,0,0
1080090,True,0,No user reviews,0,0,0
1080100,True,0,No user reviews,0,0,0
1080110,True,8,Very Positive,2994,225,3219
1080120,True,0,No user reviews,0,0,0
1080130,True,0,9 user reviews,6,3,9
1080140,True,0,No user reviews,0,0,0
1080150,True,0,No user reviews,0,0,0
1080180,True,0,No user reviews,0,0,0
1080190,True,0,No user reviews,0,0,0
1080200,True,0,No user reviews,0,0,0
1080210,True,0,No user reviews,0,0,0
1080240,True,0,1 user reviews,1,0,1
1080250,True,7,Positive,15,2,17
1080260,True,0,No user reviews,0,0,0
1080270,True,0,No user reviews,0,0,0
1080280,True,0,1 user reviews,1,0,1
1080290,True,0,No user reviews,0,0,0
1080300,True,0,No user reviews,0,0,0
1080320,True,0,2 user reviews,2,0,2
1080330,True,7,Positive,14,0,14
1080360,True,0,1 user reviews,0,1,1
1080370,True,0,2 user reviews,1,1,2
1080410,True,7,Positive,14,2,16
1080420,True,0,No user reviews,0,0,0
1080430,True,0,No user reviews,0,0,0
1080440,True,0,6 user reviews,0,6,6
1080450,True,0,No user reviews,0,0,0
1080460,True,0,No user reviews,0,0,0
1080470,True,0,1 user reviews,0,1,1
1080480,True,0,No user reviews,0,0,0
1080490,True,0,No user reviews,0,0,0
1080500,True,0,No user reviews,0,0,0
1080510,True,0,No user reviews,0,0,0
1080550,True,7,Positive,25,1,26
1080570,True,0,No user reviews,0,0,0
1080580,True,0,No user reviews,0,0,0
1080590,True,0,No user reviews,0,0,0
1080591,True,0,No user reviews,0,0,0
1080600,True,0,No user reviews,0,0,0
1080610,True,0,No user reviews,0,0,0
1080620,True,0,No user reviews,0,0,0
1080630,True,0,2 user reviews,1,1,2
1080650,True,0,No user reviews,0,0,0
1080680,True,0,No user reviews,0,0,0
1080690,True,0,No user reviews,0,0,0
1080700,True,0,No user reviews,0,0,0
1080710,True,0,No user reviews,0,0,0
1080720,True,0,No user reviews,0,0,0
1080750,True,8,Very Positive,174,4,178
1080770,True,7,Positive,23,3,26
1080780,True,0,9 user reviews,7,2,9
1080790,True,7,Positive,15,0,15
1080810,True,0,No user reviews,0,0,0
1080840,True,0,No user reviews,0,0,0
1080880,True,0,No user reviews,0,0,0
1080900,True,0,2 user reviews,2,0,2
1080910,True,0,No user reviews,0,0,0
1080911,True,0,No user reviews,0,0,0
1080930,True,0,No user reviews,0,0,0
1080940,True,0,No user reviews,0,0,0
1080950,True,0,1 user reviews,1,0,1
1080960,True,0,No user reviews,0,0,0
1080970,True,0,No user reviews,0,0,0
1080980,True,0,No user reviews,0,0,0
1080990,True,0,No user reviews,0,0,0
1081000,True,0,8 user reviews,5,3,8
1081020,True,0,1 user reviews,1,0,1
1081030,True,0,No user reviews,0,0,0
1081040,True,6,Mostly Positive,16,5,21
1081070,True,0,2 user reviews,2,0,2
1081090,True,0,5 user reviews,4,1,5
1081100,True,7,Positive,12,0,12
1081110,True,0,1 user reviews,0,1,1
1081120,True,7,Positive,18,1,19
1081140,True,0,2 user reviews,0,2,2
1081160,True,0,No user reviews,0,0,0
1081170,True,0,1 user reviews,1,0,1
1081190,True,0,1 user reviews,1,0,1
1081200,True,0,1 user reviews,1,0,1
1081240,True,0,1 user reviews,0,1,1
1081250,True,0,6 user reviews,4,2,6
1081260,True,0,2 user reviews,2,0,2
1081270,True,0,No user reviews,0,0,0
1081300,True,0,No user reviews,0,0,0
1081320,True,0,1 user reviews,1,0,1
1081340,True,0,No user reviews,0,0,0
1081350,True,0,No user reviews,0,0,0
1081370,True,0,1 user reviews,1,0,1
1081390,True,0,No user reviews,0,0,0
1081410,True,0,3 user reviews,2,1,3
1081420,True,0,No user reviews,0,0,0
1081430,True,0,1 user reviews,1,0,1
1081460,True,0,No user reviews,0,0,0
1081470,True,0,No user reviews,0,0,0
1081490,True,0,No user reviews,0,0,0
1081500,True,0,No user reviews,0,0,0
1081510,True,8,Very Positive,189,37,226
1081520,True,0,No user reviews,0,0,0
1081540,True,0,No user reviews,0,0,0
1081550,True,0,6 user reviews,6,0,6
1081560,True,6,Mostly Positive,60,23,83
1081570,True,0,No user reviews,0,0,0
1081590,True,0,No user reviews,0,0,0
1081600,True,0,1 user reviews,0,1,1
1081610,True,6,Mostly Positive,86,28,114
1081630,True,0,2 user reviews,2,0,2
1081640,True,0,No user reviews,0,0,0
1081650,True,8,Very Positive,55,6,61
1081660,True,0,No user reviews,0,0,0
1081670,True,0,1 user reviews,0,1,1
1081690,True,0,No user reviews,0,0,0
1081700,True,0,No user reviews,0,0,0
1081710,True,0,6 user reviews,4,2,6
1081720,True,0,1 user reviews,0,1,1
1081730,True,0,No user reviews,0,0,0
1081740,True,0,No user reviews,0,0,0
1081750,True,0,No user reviews,0,0,0
1081760,True,0,8 user reviews,4,4,8
1081780,True,7,Positive,8,2,10
1081800,True,0,No user reviews,0,0,0
1081810,True,0,No user reviews,0,0,0
1081820,True,0,No user reviews,0,0,0
1081830,True,0,No user reviews,0,0,0
1081840,True,0,7 user reviews,7,0,7
1081850,True,0,8 user reviews,8,0,8
1081870,True,7,Positive,13,0,13
1081880,True,0,No user reviews,0,0,0
1081890,True,7,Positive,11,1,12
1081900,True,0,3 user reviews,1,2,3
1081910,True,0,1 user reviews,0,1,1
1081920,True,0,1 user reviews,1,0,1
1081940,True,0,No user reviews,0,0,0
1081960,True,0,No user reviews,0,0,0
1081980,True,0,No user reviews,0,0,0
1081990,True,0,2 user reviews,2,0,2
1082000,True,7,Positive,11,0,11
1082020,True,0,No user reviews,0,0,0
1082030,True,0,No user reviews,0,0,0
1082031,True,0,No user reviews,0,0,0
1082032,True,0,No user reviews,0,0,0
1082040,True,0,No user reviews,0,0,0
1082050,True,0,No user reviews,0,0,0
1082060,True,0,No user reviews,0,0,0
1082070,True,0,No user reviews,0,0,0
1082080,True,0,No user reviews,0,0,0
1082110,True,7,Positive,10,1,11
1082120,True,0,No user reviews,0,0,0
1082150,True,0,No user reviews,0,0,0
1082160,True,0,No user reviews,0,0,0
1082161,True,0,1 user reviews,1,0,1
1082170,True,0,No user reviews,0,0,0
1082171,True,0,No user reviews,0,0,0
1082172,True,0,No user reviews,0,0,0
1082180,True,6,Mostly Positive,96,37,133
1082200,True,0,No user reviews,0,0,0
1082220,True,0,4 user reviews,4,0,4
1082230,True,0,No user reviews,0,0,0
1082240,True,0,No user reviews,0,0,0
1082250,True,7,Positive,20,1,21
1082300,True,0,No user reviews,0,0,0
1082310,True,0,No user reviews,0,0,0
1082320,True,0,No user reviews,0,0,0
1082330,True,0,No user reviews,0,0,0
1082350,True,6,Mostly Positive,22,7,29
1082351,True,0,3 user reviews,3,0,3
1082352,True,5,Mixed,11,5,16
1082353,True,8,Very Positive,160,28,188
1082370,True,0,3 user reviews,2,1,3
1082380,True,0,No user reviews,0,0,0
1082390,True,0,No user reviews,0,0,0
1082410,True,0,No user reviews,0,0,0
1082420,True,0,No user reviews,0,0,0
1082430,True,0,No user reviews,0,0,0
1082440,True,7,Positive,15,0,15
1082450,True,0,No user reviews,0,0,0
1082460,True,0,5 user reviews,5,0,5
1082470,True,0,7 user reviews,7,0,7
1082480,True,0,1 user reviews,1,0,1
1082490,True,0,1 user reviews,0,1,1
1082500,True,0,2 user reviews,2,0,2
1082520,True,0,No user reviews,0,0,0
1082550,True,0,1 user reviews,1,0,1
1082571,True,0,1 user reviews,0,1,1
1082572,True,0,1 user reviews,0,1,1
1082573,True,0,1 user reviews,0,1,1
1082574,True,0,2 user reviews,0,2,2
1082575,True,0,1 user reviews,0,1,1
1082576,True,0,2 user reviews,0,2,2
1082577,True,0,1 user reviews,0,1,1
1082578,True,0,1 user reviews,0,1,1
1082579,True,0,3 user reviews,2,1,3
1082580,True,0,4 user reviews,3,1,4
1082581,True,0,3 user reviews,2,1,3
1082582,True,0,2 user reviews,1,1,2
1082610,True,0,1 user reviews,1,0,1
1082620,True,0,No user reviews,0,0,0
1082650,True,0,1 user reviews,1,0,1
1082660,True,0,No user reviews,0,0,0
1082661,True,0,No user reviews,0,0,0
1082662,True,0,No user reviews,0,0,0
1082680,True,4,Mostly Negative,155,292,447
1082690,True,0,No user reviews,0,0,0
1082700,True,0,No user reviews,0,0,0
1082710,True,9,Overwhelmingly Positive,1228,18,1246
1082720,True,6,Mostly Positive,10,4,14
1082730,True,0,No user reviews,0,0,0
1082750,True,0,No user reviews,0,0,0
1082760,True,0,No user reviews,0,0,0
1082770,True,0,8 user reviews,4,4,8
1082780,True,0,No user reviews,0,0,0
1082790,True,0,No user reviews,0,0,0
1082800,True,0,No user reviews,0,0,0
1082810,True,0,No user reviews,0,0,0
1082820,True,0,No user reviews,0,0,0
1082830,True,0,No user reviews,0,0,0
1082840,True,0,No user reviews,0,0,0
1082860,True,0,2 user reviews,2,0,2
1082890,True,0,No user reviews,0,0,0
1082900,True,0,No user reviews,0,0,0
1082920,True,8,Very Positive,74,0,74
1082930,True,7,Positive,12,3,15
1082940,True,0,5 user reviews,3,2,5
1082950,True,0,No user reviews,0,0,0
1082970,True,0,No user reviews,0,0,0
1082990,True,0,No user reviews,0,0,0
1083000,True,0,No user reviews,0,0,0
1083020,True,0,No user reviews,0,0,0
1083060,True,0,No user reviews,0,0,0
1083070,True,0,No user reviews,0,0,0
1083090,True,0,3 user reviews,3,0,3
1083100,True,0,3 user reviews,1,2,3
1083150,True,0,No user reviews,0,0,0
1083190,True,8,Very Positive,55,3,58
1083210,True,5,Mixed,35,17,52
1083230,True,0,No user reviews,0,0,0
1083240,True,0,6 user reviews,6,0,6
1083250,True,0,No user reviews,0,0,0
1083260,True,0,2 user reviews,0,2,2
1083270,True,0,1 user reviews,1,0,1
1083280,True,0,1 user reviews,1,0,1
1083281,True,0,1 user reviews,1,0,1
1083282,True,7,Positive,16,2,18
1083283,True,0,4 user reviews,3,1,4
1083290,True,0,7 user reviews,2,5,7
1083300,True,0,No user reviews,0,0,0
1083310,True,6,Mostly Positive,37,10,47
1083340,True,0,No user reviews,0,0,0
1083350,True,0,1 user reviews,1,0,1
1083370,True,0,No user reviews,0,0,0
1083380,True,0,No user reviews,0,0,0
1083390,True,0,No user reviews,0,0,0
1083410,True,0,1 user reviews,0,1,1
1083420,True,7,Positive,17,4,21
1083430,True,0,1 user reviews,0,1,1
1083450,True,0,2 user reviews,2,0,2
1083460,True,0,3 user reviews,3,0,3
1083480,True,0,No user reviews,0,0,0
1083490,True,0,4 user reviews,2,2,4
1083500,True,0,No user reviews,0,0,0
1083530,True,0,No user reviews,0,0,0
1083540,True,0,No user reviews,0,0,0
1083580,True,0,No user reviews,0,0,0
1083590,True,0,2 user reviews,1,1,2
1083600,True,0,No user reviews,0,0,0
1083610,True,0,No user reviews,0,0,0
1083650,True,5,Mixed,38,17,55
1083660,True,0,No user reviews,0,0,0
1083670,True,0,9 user reviews,8,1,9
1083680,True,0,No user reviews,0,0,0
1083700,True,0,2 user reviews,2,0,2
1083750,True,0,1 user reviews,1,0,1
1083760,True,7,Positive,44,3,47
1083780,True,0,No user reviews,0,0,0
1083790,True,0,No user reviews,0,0,0
1083800,True,0,1 user reviews,1,0,1
1083810,True,7,Positive,21,2,23
1083820,True,7,Positive,17,4,21
1083830,True,0,No user reviews,0,0,0
1083831,True,0,No user reviews,0,0,0
1083832,True,0,No user reviews,0,0,0
1083833,True,0,No user reviews,0,0,0
1083850,True,5,Mixed,8,11,19
1083870,True,0,No user reviews,0,0,0
1083880,True,8,Very Positive,558,57,615
1083890,True,6,Mostly Positive,14,4,18
1083900,True,0,2 user reviews,2,0,2
1083910,True,0,6 user reviews,6,0,6
1083970,True,0,2 user reviews,0,2,2
1083971,True,0,No user reviews,0,0,0
1083980,True,0,No user reviews,0,0,0
1083990,True,0,3 user reviews,2,1,3
1084000,True,0,No user reviews,0,0,0
1084010,True,0,1 user reviews,0,1,1
1084020,True,8,Very Positive,175,26,201
1084050,True,0,No user reviews,0,0,0
1084060,True,0,4 user reviews,2,2,4
1084070,True,0,4 user reviews,4,0,4
1084071,True,0,1 user reviews,1,0,1
1084072,True,0,2 user reviews,1,1,2
1084073,True,0,4 user reviews,3,1,4
1084080,True,7,Positive,28,7,35
1084090,True,0,1 user reviews,1,0,1
1084100,True,4,Mostly Negative,7,14,21
1084110,True,5,Mixed,11,8,19
1084120,True,0,No user reviews,0,0,0
1084130,True,0,No user reviews,0,0,0
1084210,True,0,7 user reviews,7,0,7
1084220,True,7,Positive,15,0,15
1084230,True,0,No user reviews,0,0,0
1084350,True,7,Positive,11,2,13
1084360,True,0,No user reviews,0,0,0
1084380,True,0,No user reviews,0,0,0
1084390,True,0,No user reviews,0,0,0
1084400,True,6,Mostly Positive,311,87,398
1084410,True,0,No user reviews,0,0,0
1084420,True,0,1 user reviews,1,0,1
1084430,True,0,6 user reviews,5,1,6
1084460,True,0,1 user reviews,1,0,1
1084470,True,0,3 user reviews,1,2,3
1084480,True,7,Positive,16,3,19
1084500,True,0,No user reviews,0,0,0
1084510,True,0,No user reviews,0,0,0
1084520,True,0,No user reviews,0,0,0
1084530,True,0,1 user reviews,1,0,1
1084560,True,0,No user reviews,0,0,0
1084570,True,0,No user reviews,0,0,0
1084580,True,0,No user reviews,0,0,0
1084630,True,0,No user reviews,0,0,0
1084640,True,0,No user reviews,0,0,0
1084650,True,0,No user reviews,0,0,0
1084651,True,0,No user reviews,0,0,0
1084660,True,0,No user reviews,0,0,0
1084680,True,6,Mostly Positive,87,34,121
1084700,True,0,No user reviews,0,0,0
1084701,True,0,No user reviews,0,0,0
1084710,True,0,6 user reviews,5,1,6
1084730,True,0,No user reviews,0,0,0
1084770,True,0,2 user reviews,2,0,2
1084780,True,0,No user reviews,0,0,0
1084790,True,7,Positive,28,6,34
1084810,True,0,1 user reviews,1,0,1
1084820,True,7,Positive,25,2,27
1084830,True,0,No user reviews,0,0,0
1084840,True,0,5 user reviews,5,0,5
1084860,True,0,1 user reviews,1,0,1
1084870,True,5,Mixed,13,8,21
1084880,True,0,1 user reviews,1,0,1
1084890,True,0,No user reviews,0,0,0
1084900,True,0,No user reviews,0,0,0
1084910,True,0,1 user reviews,1,0,1
1084920,True,0,4 user reviews,4,0,4
1084930,True,0,9 user reviews,8,1,9
1084940,True,0,No user reviews,0,0,0
1084950,True,0,No user reviews,0,0,0
1084960,True,0,No user reviews,0,0,0
1084970,True,0,6 user reviews,5,1,6
1084980,True,0,No user reviews,0,0,0
1084990,True,6,Mostly Positive,41,13,54
1085010,True,0,4 user reviews,4,0,4
1085020,True,0,No user reviews,0,0,0
1085030,True,0,No user reviews,0,0,0
1085040,True,0,No user reviews,0,0,0
1085060,True,0,No user reviews,0,0,0
1085070,True,0,No user reviews,0,0,0
1085080,True,0,No user reviews,0,0,0
1085090,True,0,No user reviews,0,0,0
1085100,True,0,No user reviews,0,0,0
1085110,True,0,7 user reviews,2,5,7
1085150,True,0,1 user reviews,0,1,1
1085160,True,8,Very Positive,76,13,89
1085180,True,8,Very Positive,100,8,108
1085190,True,5,Mixed,9,4,13
1085200,True,0,No user reviews,0,0,0
1085210,True,0,No user reviews,0,0,0
1085220,True,0,No user reviews,0,0,0
1085230,True,0,No user reviews,0,0,0
1085240,True,0,4 user reviews,3,1,4
1085260,True,0,9 user reviews,9,0,9
1085270,True,5,Mixed,12,7,19
1085280,True,0,No user reviews,0,0,0
1085310,True,4,Mostly Negative,4,10,14
1085320,True,0,No user reviews,0,0,0
1085340,True,0,3 user reviews,2,1,3
1085360,True,0,No user reviews,0,0,0
1085390,True,0,2 user reviews,1,1,2
1085400,True,0,No user reviews,0,0,0
1085410,True,0,No user reviews,0,0,0
1085510,True,8,Very Positive,663,83,746
1085520,True,0,8 user reviews,5,3,8
1085540,True,0,No user reviews,0,0,0
1085550,True,0,No user reviews,0,0,0
1085560,True,7,Positive,26,2,28
1085570,True,0,No user reviews,0,0,0
1085580,True,0,No user reviews,0,0,0
1085590,True,0,No user reviews,0,0,0
1085600,True,0,No user reviews,0,0,0
1085610,True,0,8 user reviews,5,3,8
1085620,True,0,No user reviews,0,0,0
1085630,True,7,Positive,18,4,22
1085640,True,6,Mostly Positive,12,4,16
1085650,True,0,No user reviews,0,0,0
1085660,True,8,Very Positive,40563,4012,44575
1085700,True,0,No user reviews,0,0,0
1085710,True,0,No user reviews,0,0,0
1085730,True,0,1 user reviews,0,1,1
1085740,True,0,No user reviews,0,0,0
1085750,True,5,Mixed,86,41,127
1085780,True,0,No user reviews,0,0,0
1085800,True,0,No user reviews,0,0,0
1085810,True,0,No user reviews,0,0,0
1085820,True,0,2 user reviews,1,1,2
1085840,True,0,No user reviews,0,0,0
1085850,True,0,No user reviews,0,0,0
1085880,True,0,No user reviews,0,0,0
1085900,True,0,1 user reviews,1,0,1
1085930,True,0,3 user reviews,3,0,3
1085940,True,0,2 user reviews,0,2,2
1085950,True,0,1 user reviews,1,0,1
1085960,True,0,No user reviews,0,0,0
1085980,True,0,No user reviews,0,0,0
1085990,True,0,3 user reviews,3,0,3
1086010,True,8,Very Positive,221,40,261
1086020,True,0,No user reviews,0,0,0
1086030,True,7,Positive,13,3,16
1086040,True,0,No user reviews,0,0,0
1086050,True,0,No user reviews,0,0,0
1086060,True,0,1 user reviews,1,0,1
1086070,True,0,2 user reviews,2,0,2
1086140,True,0,1 user reviews,1,0,1
1086160,True,7,Positive,18,1,19
1086170,True,0,No user reviews,0,0,0
1086180,True,0,3 user reviews,2,1,3
1086190,True,0,No user reviews,0,0,0
1086200,True,0,No user reviews,0,0,0
1086240,True,0,No user reviews,0,0,0
1086250,True,0,1 user reviews,0,1,1
1086260,True,0,No user reviews,0,0,0
1086270,True,0,1 user reviews,1,0,1
1086310,True,0,9 user reviews,2,7,9
1086320,True,0,2 user reviews,0,2,2
1086350,True,0,No user reviews,0,0,0
1086380,True,0,No user reviews,0,0,0
1086410,True,8,Very Positive,56,3,59
1086450,True,7,Positive,13,0,13
1086460,True,0,1 user reviews,1,0,1
1086470,True,0,No user reviews,0,0,0
1086480,True,5,Mixed,68,60,128
1086481,True,6,Mostly Positive,53,21,74
1086490,True,0,3 user reviews,1,2,3
1086530,True,0,No user reviews,0,0,0
1086570,True,0,No user reviews,0,0,0
1086600,True,0,1 user reviews,0,1,1
1086610,True,0,No user reviews,0,0,0
1086620,True,0,No user reviews,0,0,0
1086630,True,0,No user reviews,0,0,0
1086640,True,5,Mixed,153,92,245
1086650,True,0,No user reviews,0,0,0
1086670,True,0,1 user reviews,1,0,1
1086680,True,0,1 user reviews,0,1,1
1086690,True,0,1 user reviews,0,1,1
1086730,True,0,1 user reviews,1,0,1
1086740,True,0,No user reviews,0,0,0
1086750,True,7,Positive,16,2,18
1086760,True,7,Positive,12,3,15
1086810,True,0,5 user reviews,4,1,5
1086820,True,0,3 user reviews,1,2,3
1086840,True,7,Positive,13,1,14
1086850,True,8,Very Positive,138,22,160
1086860,True,7,Positive,15,0,15
1086870,True,7,Positive,23,5,28
1086880,True,0,No user reviews,0,0,0
1086890,True,0,No user reviews,0,0,0
1086900,True,0,2 user reviews,2,0,2
1086920,True,0,3 user reviews,3,0,3
1086930,True,0,No user reviews,0,0,0
1086940,True,8,Very Positive,13388,1707,15095
1086970,True,0,8 user reviews,7,1,8
1086980,True,0,No user reviews,0,0,0
1086990,True,0,6 user reviews,0,6,6
1087000,True,0,No user reviews,0,0,0
1087010,True,0,No user reviews,0,0,0
1087011,True,0,No user reviews,0,0,0
1087020,True,0,No user reviews,0,0,0
1087040,True,0,1 user reviews,0,1,1
1087050,True,0,No user reviews,0,0,0
1087060,True,0,No user reviews,0,0,0
1087070,True,0,1 user reviews,0,1,1
1087080,True,0,No user reviews,0,0,0
1087100,True,0,3 user reviews,1,2,3
1087110,True,6,Mostly Positive,19,5,24
1087120,True,7,Positive,9,2,11
1087121,True,7,Positive,10,0,10
1087122,True,0,9 user reviews,7,2,9
1087123,True,7,Positive,10,0,10
1087130,True,7,Positive,13,2,15
1087131,True,0,6 user reviews,6,0,6
1087180,True,0,No user reviews,0,0,0
1087190,True,0,No user reviews,0,0,0
1087260,True,0,No user reviews,0,0,0
1087270,True,6,Mostly Positive,154,51,205
1087280,True,8,Very Positive,836,76,912
1087290,True,0,1 user reviews,1,0,1
1087300,True,0,No user reviews,0,0,0
1087310,True,0,2 user reviews,2,0,2
1087320,True,0,No user reviews,0,0,0
1087330,True,0,9 user reviews,4,5,9
1087340,True,0,No user reviews,0,0,0
1087350,True,7,Positive,24,5,29
1087390,True,0,No user reviews,0,0,0
1087420,True,0,6 user reviews,4,2,6
1087421,True,0,4 user reviews,4,0,4
1087422,True,0,1 user reviews,1,0,1
1087423,True,0,3 user reviews,3,0,3
1087424,True,5,Mixed,9,6,15
1087425,True,0,2 user reviews,1,1,2
1087426,True,0,2 user reviews,2,0,2
1087427,True,0,4 user reviews,4,0,4
1087428,True,0,9 user reviews,7,2,9
1087429,True,0,3 user reviews,3,0,3
1087430,True,0,No user reviews,0,0,0
1087440,True,7,Positive,16,2,18
1087450,True,0,2 user reviews,2,0,2
1087451,True,0,No user reviews,0,0,0
1087460,True,8,Very Positive,207,28,235
1087480,True,0,No user reviews,0,0,0
1087500,True,6,Mostly Positive,29,9,38
1087540,True,0,No user reviews,0,0,0
1087590,True,0,5 user reviews,5,0,5
1087600,True,5,Mixed,9,4,13
1087610,True,0,No user reviews,0,0,0
1087630,True,0,No user reviews,0,0,0
1087640,True,0,No user reviews,0,0,0
1087650,True,0,No user reviews,0,0,0
1087680,True,0,1 user reviews,1,0,1
1087700,True,7,Positive,17,3,20
1087720,True,7,Positive,21,3,24
1087730,True,0,No user reviews,0,0,0
1087740,True,7,Positive,28,1,29
1087770,True,0,1 user reviews,0,1,1
1087780,True,6,Mostly Positive,11,3,14
1087800,True,0,7 user reviews,5,2,7
1087810,True,7,Positive,29,3,32
1087820,True,0,No user reviews,0,0,0
1087830,True,0,3 user reviews,3,0,3
1087840,True,0,No user reviews,0,0,0
1087850,True,0,No user reviews,0,0,0
1087860,True,0,No user reviews,0,0,0
1087870,True,0,No user reviews,0,0,0
1087880,True,0,No user reviews,0,0,0
1087890,True,0,No user reviews,0,0,0
1087910,True,0,2 user reviews,1,1,2
1087930,True,0,No user reviews,0,0,0
1087940,True,0,3 user reviews,3,0,3
1087950,True,0,2 user reviews,1,1,2
1087960,True,0,No user reviews,0,0,0
1087970,True,6,Mostly Positive,13,4,17
1087980,True,0,No user reviews,0,0,0
1088000,True,6,Mostly Positive,56,20,76
1088010,True,0,2 user reviews,0,2,2
1088030,True,0,No user reviews,0,0,0
1088040,True,0,5 user reviews,4,1,5
1088060,True,0,2 user reviews,2,0,2
1088070,True,0,2 user reviews,0,2,2
1088080,True,0,No user reviews,0,0,0
1088081,True,0,No user reviews,0,0,0
1088090,True,5,Mixed,292,226,518
1088110,True,0,No user reviews,0,0,0
1088120,True,0,2 user reviews,1,1,2
1088130,True,0,8 user reviews,1,7,8
1088150,True,0,3 user reviews,2,1,3
1088160,True,0,No user reviews,0,0,0
1088190,True,0,No user reviews,0,0,0
1088270,True,0,No user reviews,0,0,0
1088280,True,0,No user reviews,0,0,0
1088290,True,8,Very Positive,77,3,80
1088300,True,0,No user reviews,0,0,0
1088310,True,0,2 user reviews,1,1,2
1088320,True,0,No user reviews,0,0,0
1088330,True,0,3 user reviews,3,0,3
1088340,True,0,3 user reviews,3,0,3
1088350,True,0,2 user reviews,2,0,2
1088400,True,0,7 user reviews,7,0,7
1088410,True,0,No user reviews,0,0,0
1088420,True,7,Positive,10,0,10
1088440,True,0,4 user reviews,3,1,4
1088450,True,0,No user reviews,0,0,0
1088481,True,0,1 user reviews,0,1,1
1088482,True,0,1 user reviews,1,0,1
1088487,True,0,No user reviews,0,0,0
1088488,True,0,No user reviews,0,0,0
1088489,True,0,No user reviews,0,0,0
1088490,True,0,No user reviews,0,0,0
1088491,True,0,1 user reviews,1,0,1
1088493,True,0,No user reviews,0,0,0
1088494,True,0,1 user reviews,1,0,1
1088495,True,0,1 user reviews,1,0,1
1088496,True,0,No user reviews,0,0,0
1088498,True,0,No user reviews,0,0,0
1088499,True,0,No user reviews,0,0,0
1088500,True,0,No user reviews,0,0,0
1088530,True,0,No user reviews,0,0,0
1088540,True,0,3 user reviews,2,1,3
1088570,True,0,No user reviews,0,0,0
1088580,True,0,No user reviews,0,0,0
1088590,True,5,Mixed,12,7,19
1088600,True,7,Positive,30,7,37
1088610,True,0,No user reviews,0,0,0
1088630,True,0,1 user reviews,1,0,1
1088640,True,5,Mixed,30,24,54
1088680,True,0,No user reviews,0,0,0
1088690,True,0,No user reviews,0,0,0
1088700,True,0,No user reviews,0,0,0
1088720,True,0,1 user reviews,1,0,1
1088740,True,0,4 user reviews,1,3,4
1088750,True,0,No user reviews,0,0,0
1088760,True,0,No user reviews,0,0,0
1088770,True,0,No user reviews,0,0,0
1088790,True,8,Very Positive,654,149,803
1088800,True,0,No user reviews,0,0,0
1088820,True,0,No user reviews,0,0,0
1088830,True,0,No user reviews,0,0,0
1088870,True,0,No user reviews,0,0,0
1088880,True,5,Mixed,6,4,10
1088900,True,0,No user reviews,0,0,0
1088910,True,0,1 user reviews,1,0,1
1088930,True,7,Positive,10,1,11
1088950,True,8,Very Positive,42,10,52
1088960,True,0,1 user reviews,1,0,1
1088970,True,0,No user reviews,0,0,0
1088980,True,0,No user reviews,0,0,0
1089000,True,0,3 user reviews,3,0,3
1089020,True,0,No user reviews,0,0,0
1089030,True,0,6 user reviews,6,0,6
1089040,True,0,No user reviews,0,0,0
1089050,True,0,6 user reviews,5,1,6
1089080,True,0,No user reviews,0,0,0
1089090,True,8,Very Positive,651,54,705
1089100,True,0,No user reviews,0,0,0
1089110,True,0,9 user reviews,8,1,9
1089130,True,0,No user reviews,0,0,0
1089140,True,0,1 user reviews,1,0,1
1089150,True,0,No user reviews,0,0,0
1089160,True,0,2 user reviews,2,0,2
1089161,True,0,1 user reviews,1,0,1
1089162,True,0,No user reviews,0,0,0
1089163,True,0,No user reviews,0,0,0
1089164,True,0,No user reviews,0,0,0
1089165,True,0,1 user reviews,1,0,1
1089166,True,0,1 user reviews,1,0,1
1089167,True,0,No user reviews,0,0,0
1089168,True,0,No user reviews,0,0,0
1089169,True,0,No user reviews,0,0,0
1089170,True,0,No user reviews,0,0,0
1089171,True,0,No user reviews,0,0,0
1089172,True,0,2 user reviews,2,0,2
1089183,True,0,No user reviews,0,0,0
1089184,True,0,No user reviews,0,0,0
1089185,True,0,No user reviews,0,0,0
1089186,True,0,No user reviews,0,0,0
1089187,True,0,No user reviews,0,0,0
1089188,True,0,No user reviews,0,0,0
1089189,True,0,No user reviews,0,0,0
1089190,True,0,1 user reviews,1,0,1
1089191,True,0,No user reviews,0,0,0
1089192,True,0,No user reviews,0,0,0
1089193,True,0,No user reviews,0,0,0
1089194,True,0,No user reviews,0,0,0
1089195,True,0,1 user reviews,0,1,1
1089196,True,0,1 user reviews,0,1,1
1089197,True,0,No user reviews,0,0,0
1089198,True,0,No user reviews,0,0,0
1089199,True,0,No user reviews,0,0,0
1089210,True,0,No user reviews,0,0,0
1089211,True,0,No user reviews,0,0,0
1089212,True,0,No user reviews,0,0,0
1089213,True,0,No user reviews,0,0,0
1089214,True,0,3 user reviews,1,2,3
1089215,True,0,No user reviews,0,0,0
1089216,True,0,No user reviews,0,0,0
1089218,True,0,No user reviews,0,0,0
1089219,True,0,No user reviews,0,0,0
1089220,True,0,No user reviews,0,0,0
1089221,True,0,No user reviews,0,0,0
1089222,True,0,No user reviews,0,0,0
1089223,True,0,No user reviews,0,0,0
1089225,True,0,No user reviews,0,0,0
1089226,True,0,No user reviews,0,0,0
1089227,True,0,No user reviews,0,0,0
1089228,True,0,No user reviews,0,0,0
1089229,True,0,No user reviews,0,0,0
1089230,True,0,No user reviews,0,0,0
1089231,True,0,No user reviews,0,0,0
1089232,True,0,No user reviews,0,0,0
1089233,True,0,No user reviews,0,0,0
1089234,True,0,No user reviews,0,0,0
1089235,True,0,No user reviews,0,0,0
1089236,True,0,No user reviews,0,0,0
1089237,True,0,No user reviews,0,0,0
1089238,True,0,5 user reviews,5,0,5
1089239,True,0,No user reviews,0,0,0
1089240,True,0,No user reviews,0,0,0
1089241,True,0,2 user reviews,2,0,2
1089242,True,0,No user reviews,0,0,0
1089243,True,0,No user reviews,0,0,0
1089244,True,0,No user reviews,0,0,0
1089245,True,0,No user reviews,0,0,0
1089250,True,0,No user reviews,0,0,0
1089270,True,8,Very Positive,312,63,375
1089280,True,0,No user reviews,0,0,0
1089281,True,0,No user reviews,0,0,0
1089290,True,0,No user reviews,0,0,0
1089310,True,6,Mostly Positive,15,5,20
1089320,True,0,1 user reviews,1,0,1
1089330,True,0,6 user reviews,1,5,6
1089350,True,5,Mixed,5536,3437,8973
1089410,True,0,No user reviews,0,0,0
1089430,True,0,No user reviews,0,0,0
1089520,True,0,1 user reviews,1,0,1
1089540,True,0,No user reviews,0,0,0
1089560,True,0,No user reviews,0,0,0
1089570,True,0,No user reviews,0,0,0
1089580,True,0,No user reviews,0,0,0
1089581,True,0,No user reviews,0,0,0
1089590,True,0,2 user reviews,1,1,2
1089600,True,7,Positive,15,3,18
1089610,True,0,No user reviews,0,0,0
1089620,True,7,Positive,10,1,11
1089630,True,0,5 user reviews,5,0,5
1089650,True,0,No user reviews,0,0,0
1089660,True,6,Mostly Positive,14,4,18
1089670,True,0,4 user reviews,4,0,4
1089671,True,0,6 user reviews,4,2,6
1089672,True,0,4 user reviews,2,2,4
1089680,True,0,No user reviews,0,0,0
1089690,True,0,No user reviews,0,0,0
1089710,True,0,No user reviews,0,0,0
1089730,True,0,No user reviews,0,0,0
1089740,True,0,No user reviews,0,0,0
1089750,True,0,No user reviews,0,0,0
1089760,True,0,4 user reviews,2,2,4
1089770,True,0,7 user reviews,7,0,7
1089790,True,6,Mostly Positive,54,21,75
1089800,True,0,1 user reviews,0,1,1
1089810,True,0,1 user reviews,1,0,1
1089820,True,5,Mixed,9,4,13
1089830,True,6,Mostly Positive,217,56,273
1089840,True,8,Very Positive,56,10,66
1089860,True,0,No user reviews,0,0,0
1089880,True,0,2 user reviews,1,1,2
1089900,True,0,No user reviews,0,0,0
1089910,True,0,No user reviews,0,0,0
1089920,True,0,No user reviews,0,0,0
1089930,True,0,No user reviews,0,0,0
1089940,True,0,No user reviews,0,0,0
1089980,True,9,Overwhelmingly Positive,9510,78,9588
1090020,True,0,No user reviews,0,0,0
1090030,True,7,Positive,16,2,18
1090040,True,0,No user reviews,0,0,0
1090060,True,0,5 user reviews,5,0,5
1090070,True,0,No user reviews,0,0,0
1090090,True,0,No user reviews,0,0,0
1090091,True,0,No user reviews,0,0,0
1090092,True,0,No user reviews,0,0,0
1090093,True,0,No user reviews,0,0,0
1090094,True,0,No user reviews,0,0,0
1090095,True,0,No user reviews,0,0,0
1090096,True,0,No user reviews,0,0,0
1090110,True,0,3 user reviews,3,0,3
1090120,True,0,No user reviews,0,0,0
1090150,True,8,Very Positive,461,69,530
1090151,True,0,No user reviews,0,0,0
1090152,True,0,No user reviews,0,0,0
1090160,True,0,No user reviews,0,0,0
1090161,True,0,No user reviews,0,0,0
1090162,True,0,3 user reviews,0,3,3
1090163,True,0,8 user reviews,1,7,8
1090164,True,0,9 user reviews,7,2,9
1090170,True,0,No user reviews,0,0,0
1090171,True,0,No user reviews,0,0,0
1090190,True,0,No user reviews,0,0,0
1090200,True,5,Mixed,709,628,1337
1090201,True,0,No user reviews,0,0,0
1090202,True,6,Mostly Positive,99,34,133
1090210,True,6,Mostly Positive,12,4,16
1090250,True,0,No user reviews,0,0,0
1090300,True,0,No user reviews,0,0,0
1090320,True,0,No user reviews,0,0,0
1090340,True,0,No user reviews,0,0,0
1090370,True,0,No user reviews,0,0,0
1090380,True,0,1 user reviews,1,0,1
1090390,True,7,Positive,9,2,11
1090400,True,0,No user reviews,0,0,0
1090420,True,0,No user reviews,0,0,0
1090430,True,0,No user reviews,0,0,0
1090440,True,7,Positive,32,5,37
1090470,True,6,Mostly Positive,8,3,11
1090480,True,0,No user reviews,0,0,0
1090490,True,0,No user reviews,0,0,0
1090520,True,0,1 user reviews,0,1,1
1090530,True,0,No user reviews,0,0,0
1090540,True,0,1 user reviews,0,1,1
1090550,True,0,No user reviews,0,0,0
1090560,True,0,No user reviews,0,0,0
1090570,True,0,No user reviews,0,0,0
1090580,True,0,1 user reviews,1,0,1
1090630,True,8,Very Positive,1146,170,1316
1090640,True,0,No user reviews,0,0,0
1090650,True,0,1 user reviews,1,0,1
1090660,True,0,1 user reviews,1,0,1
1090670,True,7,Positive,17,3,20
1090690,True,0,1 user reviews,1,0,1
1090730,True,5,Mixed,8,5,13
1090750,True,0,No user reviews,0,0,0
1090760,True,0,No user reviews,0,0,0
1090790,True,7,Positive,27,1,28
1090800,True,0,No user reviews,0,0,0
1090830,True,0,No user reviews,0,0,0
1090850,True,6,Mostly Positive,134,40,174
1090860,True,0,7 user reviews,7,0,7
1090880,True,0,No user reviews,0,0,0
1090890,True,0,No user reviews,0,0,0
1090900,True,0,No user reviews,0,0,0
1090910,True,0,1 user reviews,0,1,1
1090920,True,0,2 user reviews,2,0,2
1090930,True,6,Mostly Positive,18,5,23
1090940,True,0,3 user reviews,3,0,3
1090950,True,0,No user reviews,0,0,0
1090960,True,0,3 user reviews,3,0,3
1091000,True,0,No user reviews,0,0,0
1091010,True,0,No user reviews,0,0,0
1091020,True,0,No user reviews,0,0,0
1091030,True,0,No user reviews,0,0,0
1091040,True,0,1 user reviews,1,0,1
1091050,True,0,3 user reviews,0,3,3
1091070,True,0,No user reviews,0,0,0
1091090,True,0,6 user reviews,5,1,6
1091100,True,0,No user reviews,0,0,0
1091110,True,0,7 user reviews,5,2,7
1091140,True,0,No user reviews,0,0,0
1091150,True,0,7 user reviews,6,1,7
1091160,True,0,2 user reviews,2,0,2
1091170,True,0,9 user reviews,5,4,9
1091180,True,0,1 user reviews,1,0,1
1091190,True,0,1 user reviews,0,1,1
1091200,True,6,Mostly Positive,13,5,18
1091210,True,5,Mixed,10,5,15
1091220,True,0,1 user reviews,0,1,1
1091240,True,0,6 user reviews,5,1,6
1091250,True,8,Very Positive,52,4,56
1091260,True,0,No user reviews,0,0,0
1091270,True,0,7 user reviews,5,2,7
1091290,True,0,No user reviews,0,0,0
1091291,True,0,No user reviews,0,0,0
1091300,True,0,No user reviews,0,0,0
1091310,True,0,No user reviews,0,0,0
1091320,True,0,No user reviews,0,0,0
1091350,True,0,No user reviews,0,0,0
1091370,True,0,No user reviews,0,0,0
1091380,True,0,No user reviews,0,0,0
1091390,True,0,No user reviews,0,0,0
1091400,True,7,Positive,26,5,31
1091410,True,0,No user reviews,0,0,0
1091420,True,0,No user reviews,0,0,0
1091430,True,0,No user reviews,0,0,0
1091450,True,0,No user reviews,0,0,0
1091460,True,0,7 user reviews,5,2,7
1091470,True,7,Positive,11,2,13
1091480,True,0,No user reviews,0,0,0
1091490,True,0,No user reviews,0,0,0
1091510,True,0,No user reviews,0,0,0
1091520,True,0,No user reviews,0,0,0
1091540,True,0,No user reviews,0,0,0
1091550,True,0,No user reviews,0,0,0
1091560,True,0,8 user reviews,5,3,8
1091570,True,0,3 user reviews,2,1,3
1091580,True,0,4 user reviews,3,1,4
1091590,True,0,6 user reviews,3,3,6
1091600,True,0,No user reviews,0,0,0
1091610,True,0,No user reviews,0,0,0
1091620,True,0,No user reviews,0,0,0
1091630,True,0,No user reviews,0,0,0
1091640,True,0,No user reviews,0,0,0
1091650,True,5,Mixed,8,12,20
1091670,True,0,No user reviews,0,0,0
1091680,True,6,Mostly Positive,12,4,16
1091690,True,0,No user reviews,0,0,0
1091720,True,0,1 user reviews,1,0,1
1091730,True,0,No user reviews,0,0,0
1091760,True,0,No user reviews,0,0,0
1091840,True,0,No user reviews,0,0,0
1091860,True,0,No user reviews,0,0,0
1091870,True,0,No user reviews,0,0,0
1091890,True,0,No user reviews,0,0,0
1091910,True,0,1 user reviews,1,0,1
1091920,True,0,No user reviews,0,0,0
1091940,True,6,Mostly Positive,19,8,27
1091950,True,7,Positive,19,2,21
1091960,True,0,No user reviews,0,0,0
1091970,True,0,No user reviews,0,0,0
1091980,True,6,Mostly Positive,156,59,215
1092000,True,7,Positive,27,4,31
1092010,True,0,No user reviews,0,0,0
1092030,True,0,No user reviews,0,0,0
1092040,True,0,No user reviews,0,0,0
1092060,True,0,No user reviews,0,0,0
1092070,True,0,No user reviews,0,0,0
1092080,True,0,No user reviews,0,0,0
1092140,True,5,Mixed,13,8,21
1092150,True,0,No user reviews,0,0,0
1092160,True,0,No user reviews,0,0,0
1092170,True,0,No user reviews,0,0,0
1092180,True,0,1 user reviews,0,1,1
1092190,True,0,2 user reviews,0,2,2
1092200,True,0,No user reviews,0,0,0
1092210,True,5,Mixed,11,9,20
1092260,True,0,4 user reviews,3,1,4
1092270,True,0,No user reviews,0,0,0
1092291,True,0,3 user reviews,3,0,3
1092300,True,0,2 user reviews,0,2,2
1092310,True,0,No user reviews,0,0,0
1092330,True,7,Positive,8,2,10
1092400,True,0,No user reviews,0,0,0
1092430,True,6,Mostly Positive,134,34,168
1092490,True,0,No user reviews,0,0,0
1092500,True,0,No user reviews,0,0,0
1092510,True,0,3 user reviews,3,0,3
1092520,True,0,No user reviews,0,0,0
1092530,True,0,No user reviews,0,0,0
1092560,True,0,No user reviews,0,0,0
1092580,True,0,No user reviews,0,0,0
1092590,True,0,9 user reviews,9,0,9
1092630,True,7,Positive,31,1,32
1092640,True,0,1 user reviews,0,1,1
1092650,True,0,2 user reviews,1,1,2
1092660,True,6,Mostly Positive,1140,367,1507
1092680,True,0,No user reviews,0,0,0
1092690,True,0,1 user reviews,1,0,1
1092691,True,0,No user reviews,0,0,0
1092692,True,0,No user reviews,0,0,0
1092693,True,0,1 user reviews,1,0,1
1092694,True,0,No user reviews,0,0,0
1092695,True,0,2 user reviews,2,0,2
1092700,True,0,No user reviews,0,0,0
1092710,True,0,No user reviews,0,0,0
1092720,True,0,No user reviews,0,0,0
1092730,True,0,No user reviews,0,0,0
1092750,True,0,No user reviews,0,0,0
1092760,True,0,No user reviews,0,0,0
1092770,True,0,7 user reviews,6,1,7
1092780,True,7,Positive,17,2,19
1092790,True,0,No user reviews,0,0,0
1092800,True,7,Positive,14,0,14
1092810,True,0,No user reviews,0,0,0
1092820,True,0,No user reviews,0,0,0
1092830,True,0,1 user reviews,1,0,1
1092840,True,7,Positive,26,1,27
1092850,True,0,1 user reviews,1,0,1
1092870,True,0,No user reviews,0,0,0
1092880,True,7,Positive,27,2,29
1092890,True,0,No user reviews,0,0,0
1092900,True,0,No user reviews,0,0,0
1092940,True,0,No user reviews,0,0,0
1092950,True,0,No user reviews,0,0,0
1092960,True,0,No user reviews,0,0,0
1092980,True,6,Mostly Positive,13,4,17
1093020,True,0,No user reviews,0,0,0
1093040,True,0,1 user reviews,1,0,1
1093060,True,0,No user reviews,0,0,0
1093090,True,0,No user reviews,0,0,0
1093100,True,0,No user reviews,0,0,0
1093120,True,0,2 user reviews,2,0,2
1093130,True,0,5 user reviews,5,0,5
1093150,True,0,8 user reviews,7,1,8
1093170,True,0,No user reviews,0,0,0
1093180,True,0,No user reviews,0,0,0
1093190,True,0,No user reviews,0,0,0
1093200,True,0,No user reviews,0,0,0
1093210,True,0,No user reviews,0,0,0
1093220,True,0,No user reviews,0,0,0
1093250,True,0,No user reviews,0,0,0
1093260,True,0,2 user reviews,2,0,2
1093270,True,0,2 user reviews,0,2,2
1093280,True,0,1 user reviews,1,0,1
1093290,True,0,No user reviews,0,0,0
1093300,True,0,6 user reviews,5,1,6
1093310,True,0,4 user reviews,1,3,4
1093320,True,5,Mixed,17,10,27
1093330,True,8,Very Positive,213,18,231
1093340,True,0,No user reviews,0,0,0
1093360,True,7,Positive,16,1,17
1093370,True,0,8 user reviews,7,1,8
1093400,True,7,Positive,28,0,28
1093410,True,0,No user reviews,0,0,0
1093430,True,0,1 user reviews,1,0,1
1093431,True,0,No user reviews,0,0,0
1093460,True,0,No user reviews,0,0,0
1093500,True,0,No user reviews,0,0,0
1093520,True,7,Positive,26,1,27
1093540,True,0,No user reviews,0,0,0
1093670,True,0,9 user reviews,8,1,9
1093690,True,0,No user reviews,0,0,0
1093700,True,8,Very Positive,108,18,126
1093720,True,0,No user reviews,0,0,0
1093730,True,6,Mostly Positive,83,27,110
1093740,True,0,No user reviews,0,0,0
1093750,True,0,No user reviews,0,0,0
1093760,True,6,Mostly Positive,11,4,15
1093770,True,0,No user reviews,0,0,0
1093790,True,7,Positive,14,3,17
1093800,True,0,7 user reviews,7,0,7
1093810,True,0,No user reviews,0,0,0
1093820,True,0,No user reviews,0,0,0
1093830,True,0,No user reviews,0,0,0
1093840,True,0,No user reviews,0,0,0
1093850,True,0,No user reviews,0,0,0
1093860,True,0,No user reviews,0,0,0
1093870,True,0,No user reviews,0,0,0
1093880,True,5,Mixed,6,5,11
1093900,True,0,No user reviews,0,0,0
1093910,True,8,Very Positive,113,2,115
1093920,True,7,Positive,13,0,13
1093940,True,0,No user reviews,0,0,0
1093941,True,0,No user reviews,0,0,0
1093950,True,0,3 user reviews,3,0,3
1093980,True,0,No user reviews,0,0,0
1093990,True,0,1 user reviews,0,1,1
1094000,True,5,Mixed,50,37,87
1094010,True,0,No user reviews,0,0,0
1094020,True,0,No user reviews,0,0,0
1094030,True,0,1 user reviews,0,1,1
1094040,True,0,No user reviews,0,0,0
1094050,True,6,Mostly Positive,12,4,16
1094060,True,5,Mixed,37,25,62
1094070,True,0,6 user reviews,5,1,6
1094080,True,0,No user reviews,0,0,0
1094090,True,0,No user reviews,0,0,0
1094100,True,0,2 user reviews,1,1,2
1094110,True,0,7 user reviews,5,2,7
1094120,True,0,No user reviews,0,0,0
1094130,True,0,2 user reviews,2,0,2
1094160,True,0,No user reviews,0,0,0
1094170,True,0,No user reviews,0,0,0
1094180,True,0,No user reviews,0,0,0
1094181,True,0,No user reviews,0,0,0
1094182,True,0,No user reviews,0,0,0
1094183,True,0,No user reviews,0,0,0
1094184,True,0,No user reviews,0,0,0
1094185,True,0,No user reviews,0,0,0
1094186,True,0,No user reviews,0,0,0
1094187,True,0,No user reviews,0,0,0
1094190,True,0,1 user reviews,0,1,1
1094200,True,0,1 user reviews,1,0,1
1094210,True,0,No user reviews,0,0,0
1094220,True,0,No user reviews,0,0,0
1094240,True,0,No user reviews,0,0,0
1094250,True,7,Positive,31,3,34
1094280,True,0,No user reviews,0,0,0
1094281,True,0,1 user reviews,1,0,1
1094283,True,0,No user reviews,0,0,0
1094290,True,0,No user reviews,0,0,0
1094300,True,0,No user reviews,0,0,0
1094320,True,0,4 user reviews,2,2,4
1094330,True,0,No user reviews,0,0,0
1094340,True,0,6 user reviews,5,1,6
1094350,True,0,No user reviews,0,0,0
1094390,True,8,Very Positive,63,7,70
1094400,True,0,No user reviews,0,0,0
1094420,True,8,Very Positive,66,3,69
1094430,True,0,No user reviews,0,0,0
1094440,True,0,4 user reviews,3,1,4
1094450,True,0,No user reviews,0,0,0
1094460,True,0,No user reviews,0,0,0
1094480,True,0,No user reviews,0,0,0
1094490,True,0,1 user reviews,1,0,1
1094500,True,0,No user reviews,0,0,0
1094520,True,8,Very Positive,360,48,408
1094530,True,0,4 user reviews,4,0,4
1094540,True,0,No user reviews,0,0,0
1094550,True,0,No user reviews,0,0,0
1094560,True,0,No user reviews,0,0,0
1094580,True,0,No user reviews,0,0,0
1094590,True,0,No user reviews,0,0,0
1094600,True,0,No user reviews,0,0,0
1094620,True,0,No user reviews,0,0,0
1094630,True,0,No user reviews,0,0,0
1094640,True,0,8 user reviews,5,3,8
1094650,True,0,No user reviews,0,0,0
1094660,True,4,Mostly Negative,3,9,12
1094670,True,0,No user reviews,0,0,0
1094690,True,0,2 user reviews,2,0,2
1094700,True,0,No user reviews,0,0,0
1094710,True,0,No user reviews,0,0,0
1094720,True,0,No user reviews,0,0,0
1094730,True,0,No user reviews,0,0,0
1094740,True,0,1 user reviews,1,0,1
1094760,True,5,Mixed,12,10,22
1094780,True,8,Very Positive,185,25,210
1094800,True,0,No user reviews,0,0,0
1094810,True,0,No user reviews,0,0,0
1094820,True,7,Positive,16,0,16
1094840,True,0,1 user reviews,1,0,1
1094860,True,0,No user reviews,0,0,0
1094870,True,7,Positive,27,3,30
1094880,True,5,Mixed,10,6,16
1094900,True,0,No user reviews,0,0,0
1094920,True,0,No user reviews,0,0,0
1094930,True,0,5 user reviews,5,0,5
1094940,True,0,No user reviews,0,0,0
1094960,True,7,Positive,16,0,16
1095030,True,7,Positive,20,2,22
1095031,True,5,Mixed,10,5,15
1095040,True,0,No user reviews,0,0,0
1095050,True,0,No user reviews,0,0,0
1095060,True,0,No user reviews,0,0,0
1095070,True,0,3 user reviews,0,3,3
1095080,True,0,No user reviews,0,0,0
1095090,True,0,No user reviews,0,0,0
1095120,True,7,Positive,32,1,33
1095140,True,0,2 user reviews,2,0,2
1095200,True,0,No user reviews,0,0,0
1095230,True,0,1 user reviews,1,0,1
1095250,True,0,1 user reviews,1,0,1
1095260,True,0,No user reviews,0,0,0
1095270,True,0,No user reviews,0,0,0
1095280,True,0,2 user reviews,0,2,2
1095290,True,0,No user reviews,0,0,0
1095300,True,0,No user reviews,0,0,0
1095310,True,0,No user reviews,0,0,0
1095320,True,0,5 user reviews,5,0,5
1095360,True,0,1 user reviews,1,0,1
1095370,True,0,4 user reviews,4,0,4
1095380,True,0,3 user reviews,2,1,3
1095390,True,0,No user reviews,0,0,0
1095400,True,0,No user reviews,0,0,0
1095450,True,0,No user reviews,0,0,0
1095470,True,0,No user reviews,0,0,0
1095480,True,0,No user reviews,0,0,0
1095500,True,0,5 user reviews,4,1,5
1095520,True,0,No user reviews,0,0,0
1095540,True,0,2 user reviews,1,1,2
1095550,True,0,1 user reviews,1,0,1
1095560,True,0,No user reviews,0,0,0
1095580,True,0,No user reviews,0,0,0
1095590,True,0,No user reviews,0,0,0
1095610,True,0,No user reviews,0,0,0
1095621,True,0,No user reviews,0,0,0
1095622,True,0,No user reviews,0,0,0
1095624,True,0,No user reviews,0,0,0
1095626,True,0,No user reviews,0,0,0
1095650,True,0,3 user reviews,0,3,3
1095680,True,0,No user reviews,0,0,0
1095690,True,0,No user reviews,0,0,0
1095700,True,0,7 user reviews,4,3,7
1095710,True,6,Mostly Positive,7,3,10
1095720,True,0,No user reviews,0,0,0
1095721,True,0,No user reviews,0,0,0
1095730,True,0,No user reviews,0,0,0
1095740,True,0,No user reviews,0,0,0
1095750,True,0,6 user reviews,5,1,6
1095760,True,0,No user reviews,0,0,0
1095770,True,0,1 user reviews,1,0,1
1095780,True,0,3 user reviews,3,0,3
1095790,True,0,1 user reviews,1,0,1
1095810,True,0,No user reviews,0,0,0
1095820,True,0,2 user reviews,2,0,2
1095830,True,0,No user reviews,0,0,0
1095840,True,0,5 user reviews,5,0,5
1095850,True,0,1 user reviews,1,0,1
1095860,True,0,1 user reviews,1,0,1
1095870,True,0,No user reviews,0,0,0
1095880,True,0,No user reviews,0,0,0
1095910,True,0,No user reviews,0,0,0
1095960,True,0,No user reviews,0,0,0
1095980,True,0,No user reviews,0,0,0
1095990,True,0,No user reviews,0,0,0
1096000,True,0,6 user reviews,5,1,6
1096010,True,5,Mixed,14,10,24
1096020,True,0,2 user reviews,2,0,2
1096030,True,0,No user reviews,0,0,0
1096040,True,0,No user reviews,0,0,0
1096060,True,7,Positive,23,0,23
1096080,True,0,No user reviews,0,0,0
1096081,True,0,No user reviews,0,0,0
1096090,True,0,No user reviews,0,0,0
1096100,True,0,No user reviews,0,0,0
1096120,True,0,1 user reviews,0,1,1
1096130,True,0,1 user reviews,0,1,1
1096140,True,0,No user reviews,0,0,0
1096180,True,7,Positive,12,0,12
1096200,True,0,No user reviews,0,0,0
1096210,True,7,Positive,15,3,18
1096220,True,0,No user reviews,0,0,0
1096230,True,0,5 user reviews,4,1,5
1096240,True,0,3 user reviews,2,1,3
1096250,True,0,No user reviews,0,0,0
1096270,True,0,No user reviews,0,0,0
1096290,True,0,No user reviews,0,0,0
1096300,True,0,5 user reviews,2,3,5
1096310,True,0,No user reviews,0,0,0
1096320,True,0,No user reviews,0,0,0
1096321,True,0,No user reviews,0,0,0
1096330,True,0,No user reviews,0,0,0
1096340,True,0,1 user reviews,1,0,1
1096350,True,0,No user reviews,0,0,0
1096360,True,0,No user reviews,0,0,0
1096410,True,5,Mixed,434,197,631
1096420,True,0,2 user reviews,2,0,2
1096430,True,0,2 user reviews,0,2,2
1096450,True,0,No user reviews,0,0,0
1096451,True,0,No user reviews,0,0,0
1096460,True,0,No user reviews,0,0,0
1096510,True,0,7 user reviews,4,3,7
1096520,True,8,Very Positive,212,45,257
1096530,True,8,Very Positive,754,46,800
1096540,True,4,Mostly Negative,3,7,10
1096550,True,8,Very Positive,79,14,93
1096560,True,5,Mixed,16,7,23
1096570,True,8,Very Positive,342,66,408
1096580,True,5,Mixed,10,13,23
1096590,True,0,No user reviews,0,0,0
1096600,True,0,2 user reviews,2,0,2
1096610,True,6,Mostly Positive,32,10,42
1096630,True,0,6 user reviews,3,3,6
1096640,True,0,No user reviews,0,0,0
1096650,True,0,No user reviews,0,0,0
1096660,True,0,No user reviews,0,0,0
1096680,True,0,No user reviews,0,0,0
1096690,True,0,8 user reviews,7,1,8
1096710,True,0,No user reviews,0,0,0
1096720,True,8,Very Positive,121,28,149
1096730,True,5,Mixed,24,15,39
1096750,True,0,5 user reviews,4,1,5
1096820,True,0,No user reviews,0,0,0
1096830,True,0,1 user reviews,0,1,1
1096890,True,0,1 user reviews,1,0,1
1096900,True,5,Mixed,88,43,131
1096910,True,0,4 user reviews,1,3,4
1096930,True,8,Very Positive,58,6,64
1096940,True,0,2 user reviews,2,0,2
1096950,True,0,4 user reviews,2,2,4
1096960,True,0,1 user reviews,1,0,1
1096970,True,0,4 user reviews,1,3,4
1096980,True,0,6 user reviews,5,1,6
1097000,True,0,No user reviews,0,0,0
1097080,True,0,No user reviews,0,0,0
1097090,True,0,4 user reviews,1,3,4
1097100,True,0,No user reviews,0,0,0
1097110,True,7,Positive,34,3,37
1097120,True,0,4 user reviews,3,1,4
1097130,True,0,No user reviews,0,0,0
1097140,True,0,No user reviews,0,0,0
1097150,True,8,Very Positive,79879,13994,93873
1097160,True,0,2 user reviews,2,0,2
1097170,True,7,Positive,23,2,25
1097180,True,5,Mixed,6,4,10
1097190,True,0,No user reviews,0,0,0
1097200,True,0,No user reviews,0,0,0
1097210,True,6,Mostly Positive,11,3,14
1097223,True,0,No user reviews,0,0,0
1097240,True,6,Mostly Positive,23,9,32
1097260,True,0,No user reviews,0,0,0
1097270,True,0,3 user reviews,3,0,3
1097290,True,0,No user reviews,0,0,0
1097300,True,0,No user reviews,0,0,0
1097310,True,0,4 user reviews,1,3,4
1097320,True,0,No user reviews,0,0,0
1097330,True,0,5 user reviews,5,0,5
1097340,True,0,No user reviews,0,0,0
1097350,True,0,No user reviews,0,0,0
1097360,True,0,No user reviews,0,0,0
1097370,True,7,Positive,20,4,24
1097390,True,0,No user reviews,0,0,0
1097391,True,0,No user reviews,0,0,0
1097400,True,0,No user reviews,0,0,0
1097420,True,5,Mixed,15,8,23
1097430,True,0,No user reviews,0,0,0
1097440,True,0,No user reviews,0,0,0
1097450,True,0,No user reviews,0,0,0
1097470,True,0,No user reviews,0,0,0
1097480,True,0,No user reviews,0,0,0
1097500,True,0,No user reviews,0,0,0
1097510,True,0,No user reviews,0,0,0
1097520,True,6,Mostly Positive,9,3,12
1097530,True,8,Very Positive,175,19,194
1097550,True,0,2 user reviews,2,0,2
1097560,True,0,No user reviews,0,0,0
1097570,True,0,2 user reviews,2,0,2
1097580,True,8,Very Positive,270,52,322
1097590,True,0,1 user reviews,0,1,1
1097600,True,0,3 user reviews,0,3,3
1097620,True,8,Very Positive,109,24,133
1097630,True,0,No user reviews,0,0,0
1097640,True,0,No user reviews,0,0,0
1097650,True,0,No user reviews,0,0,0
1097670,True,7,Positive,8,2,10
1097680,True,0,No user reviews,0,0,0
1097690,True,0,4 user reviews,0,4,4
1097700,True,0,No user reviews,0,0,0
1097710,True,0,8 user reviews,7,1,8
1097720,True,0,No user reviews,0,0,0
1097750,True,7,Positive,23,0,23
1097760,True,0,4 user reviews,4,0,4
1097770,True,0,8 user reviews,8,0,8
1097780,True,7,Positive,20,0,20
1097790,True,6,Mostly Positive,38,10,48
1097800,True,8,Very Positive,162,29,191
1097810,True,7,Positive,14,1,15
1097820,True,0,No user reviews,0,0,0
1097830,True,0,No user reviews,0,0,0
1097840,True,5,Mixed,2437,1157,3594
1097860,True,0,No user reviews,0,0,0
1097870,True,0,4 user reviews,4,0,4
1097880,True,8,Very Positive,213,48,261
1097890,True,0,No user reviews,0,0,0
1097891,True,0,No user reviews,0,0,0
1097892,True,0,No user reviews,0,0,0
1097893,True,0,No user reviews,0,0,0
1097894,True,0,No user reviews,0,0,0
1097895,True,0,No user reviews,0,0,0
1097896,True,0,2 user reviews,0,2,2
1097900,True,0,2 user reviews,2,0,2
1097910,True,0,No user reviews,0,0,0
1097960,True,5,Mixed,49,23,72
1097970,True,0,No user reviews,0,0,0
1097980,True,0,No user reviews,0,0,0
1097990,True,0,No user reviews,0,0,0
1098000,True,0,No user reviews,0,0,0
1098020,True,0,No user reviews,0,0,0
1098040,True,0,No user reviews,0,0,0
1098050,True,0,No user reviews,0,0,0
1098060,True,0,No user reviews,0,0,0
1098080,True,8,Very Positive,53,8,61
1098090,True,0,7 user reviews,6,1,7
1098100,True,6,Mostly Positive,44,17,61
1098120,True,5,Mixed,52,24,76
1098140,True,0,2 user reviews,1,1,2
1098150,True,0,No user reviews,0,0,0
1098160,True,0,No user reviews,0,0,0
1098161,True,0,2 user reviews,2,0,2
1098162,True,0,3 user reviews,3,0,3
1098163,True,0,7 user reviews,2,5,7
1098165,True,0,2 user reviews,2,0,2
1098166,True,0,5 user reviews,1,4,5
1098167,True,0,6 user reviews,6,0,6
1098170,True,8,Very Positive,88,11,99
1098180,True,0,No user reviews,0,0,0
1098190,True,0,No user reviews,0,0,0
1098200,True,5,Mixed,6,7,13
1098210,True,6,Mostly Positive,73,31,104
1098220,True,0,2 user reviews,2,0,2
1098230,True,0,No user reviews,0,0,0
1098240,True,0,No user reviews,0,0,0
1098250,True,0,3 user reviews,3,0,3
1098270,True,0,No user reviews,0,0,0
1098280,True,0,No user reviews,0,0,0
1098290,True,0,No user reviews,0,0,0
1098291,True,7,Positive,11,1,12
1098292,True,8,Very Positive,849,174,1023
1098300,True,6,Mostly Positive,39,11,50
1098301,True,0,No user reviews,0,0,0
1098310,True,0,No user reviews,0,0,0
1098320,True,0,No user reviews,0,0,0
1098340,True,8,Very Positive,173,9,182
1098350,True,0,No user reviews,0,0,0
1098360,True,0,1 user reviews,1,0,1
1098370,True,8,Very Positive,50,2,52
1098390,True,0,No user reviews,0,0,0
1098420,True,7,Positive,24,1,25
1098430,True,0,2 user reviews,0,2,2
1098440,True,0,1 user reviews,1,0,1
1098480,True,0,No user reviews,0,0,0
1098490,True,0,4 user reviews,3,1,4
1098500,True,0,No user reviews,0,0,0
1098510,True,5,Mixed,9,4,13
1098520,True,5,Mixed,7,9,16
1098530,True,0,2 user reviews,0,2,2
1098540,True,0,4 user reviews,2,2,4
1098560,True,0,1 user reviews,1,0,1
1098570,True,0,No user reviews,0,0,0
1098580,True,0,No user reviews,0,0,0
1098590,True,0,No user reviews,0,0,0
1098620,True,0,No user reviews,0,0,0
1098640,True,0,3 user reviews,1,2,3
1098650,True,0,1 user reviews,0,1,1
1098660,True,0,No user reviews,0,0,0
1098670,True,0,3 user reviews,1,2,3
1098680,True,0,2 user reviews,2,0,2
1098700,True,0,6 user reviews,6,0,6
1098720,True,0,7 user reviews,6,1,7
1098730,True,0,3 user reviews,2,1,3
1098750,True,0,No user reviews,0,0,0
1098760,True,0,5 user reviews,2,3,5
1098770,True,0,No user reviews,0,0,0
1098780,True,0,No user reviews,0,0,0
1098790,True,5,Mixed,8,9,17
1098810,True,0,No user reviews,0,0,0
1098820,True,0,1 user reviews,1,0,1
1098840,True,0,No user reviews,0,0,0
1098870,True,0,4 user reviews,1,3,4
1098880,True,0,No user reviews,0,0,0
1098910,True,0,No user reviews,0,0,0
1098920,True,0,No user reviews,0,0,0
1098930,True,0,No user reviews,0,0,0
1098940,True,5,Mixed,81,39,120
1098950,True,0,No user reviews,0,0,0
1098970,True,0,No user reviews,0,0,0
1098980,True,0,1 user reviews,0,1,1
1099000,True,0,No user reviews,0,0,0
1099010,True,0,4 user reviews,3,1,4
1099070,True,0,1 user reviews,0,1,1
1099090,True,0,4 user reviews,3,1,4
1099100,True,0,No user reviews,0,0,0
1099110,True,0,No user reviews,0,0,0
1099120,True,0,1 user reviews,1,0,1
1099121,True,0,No user reviews,0,0,0
1099122,True,0,2 user reviews,0,2,2
1099130,True,0,No user reviews,0,0,0
1099140,True,0,2 user reviews,1,1,2
1099170,True,7,Positive,15,1,16
1099190,True,0,No user reviews,0,0,0
1099191,True,0,No user reviews,0,0,0
1099200,True,0,No user reviews,0,0,0
1099201,True,0,No user reviews,0,0,0
1099202,True,0,1 user reviews,1,0,1
1099203,True,0,No user reviews,0,0,0
1099210,True,0,1 user reviews,1,0,1
1099211,True,0,1 user reviews,1,0,1
1099212,True,0,No user reviews,0,0,0
1099213,True,0,1 user reviews,1,0,1
1099214,True,0,No user reviews,0,0,0
1099215,True,0,No user reviews,0,0,0
1099216,True,0,No user reviews,0,0,0
1099220,True,0,No user reviews,0,0,0
1099230,True,0,No user reviews,0,0,0
1099231,True,0,No user reviews,0,0,0
1099232,True,0,No user reviews,0,0,0
1099233,True,0,No user reviews,0,0,0
1099240,True,0,No user reviews,0,0,0
1099241,True,0,No user reviews,0,0,0
1099260,True,0,No user reviews,0,0,0
1099261,True,0,No user reviews,0,0,0
1099262,True,0,No user reviews,0,0,0
1099263,True,0,No user reviews,0,0,0
1099264,True,0,No user reviews,0,0,0
1099270,True,0,No user reviews,0,0,0
1099271,True,0,No user reviews,0,0,0
1099272,True,0,No user reviews,0,0,0
1099273,True,0,No user reviews,0,0,0
1099280,True,0,No user reviews,0,0,0
1099281,True,0,No user reviews,0,0,0
1099282,True,0,No user reviews,0,0,0
1099283,True,0,No user reviews,0,0,0
1099290,True,0,No user reviews,0,0,0
1099291,True,0,No user reviews,0,0,0
1099292,True,0,No user reviews,0,0,0
1099293,True,0,No user reviews,0,0,0
1099294,True,0,No user reviews,0,0,0
1099300,True,0,No user reviews,0,0,0
1099301,True,0,No user reviews,0,0,0
1099302,True,0,No user reviews,0,0,0
1099303,True,0,No user reviews,0,0,0
1099304,True,0,No user reviews,0,0,0
1099305,True,0,No user reviews,0,0,0
1099310,True,0,No user reviews,0,0,0
1099311,True,0,No user reviews,0,0,0
1099312,True,0,No user reviews,0,0,0
1099313,True,0,No user reviews,0,0,0
1099314,True,0,No user reviews,0,0,0
1099315,True,0,No user reviews,0,0,0
1099316,True,0,No user reviews,0,0,0
1099320,True,0,No user reviews,0,0,0
1099330,True,0,No user reviews,0,0,0
1099340,True,0,No user reviews,0,0,0
1099341,True,0,No user reviews,0,0,0
1099342,True,0,No user reviews,0,0,0
1099343,True,0,No user reviews,0,0,0
1099344,True,0,No user reviews,0,0,0
1099345,True,0,1 user reviews,1,0,1
1099350,True,0,No user reviews,0,0,0
1099351,True,0,No user reviews,0,0,0
1099352,True,0,No user reviews,0,0,0
1099360,True,0,No user reviews,0,0,0
1099361,True,0,No user reviews,0,0,0
1099362,True,0,No user reviews,0,0,0
1099363,True,0,No user reviews,0,0,0
1099364,True,0,No user reviews,0,0,0
1099365,True,0,No user reviews,0,0,0
1099370,True,0,No user reviews,0,0,0
1099371,True,0,No user reviews,0,0,0
1099372,True,0,No user reviews,0,0,0
1099373,True,0,No user reviews,0,0,0
1099380,True,0,No user reviews,0,0,0
1099390,True,0,No user reviews,0,0,0
1099391,True,0,2 user reviews,2,0,2
1099392,True,0,No user reviews,0,0,0
1099393,True,0,No user reviews,0,0,0
1099400,True,0,No user reviews,0,0,0
1099420,True,0,No user reviews,0,0,0
1099421,True,0,No user reviews,0,0,0
1099422,True,0,No user reviews,0,0,0
1099440,True,7,Positive,20,5,25
1099450,True,0,9 user reviews,5,4,9
1099460,True,0,7 user reviews,5,2,7
1099470,True,0,No user reviews,0,0,0
1099490,True,0,No user reviews,0,0,0
1099500,True,7,Positive,46,2,48
1099510,True,0,No user reviews,0,0,0
1099520,True,0,No user reviews,0,0,0
1099530,True,7,Positive,10,2,12
1099540,True,0,No user reviews,0,0,0
1099550,True,0,No user reviews,0,0,0
1099560,True,0,9 user reviews,7,2,9
1099561,True,7,Positive,11,2,13
1099562,True,0,6 user reviews,2,4,6
1099563,True,7,Positive,8,2,10
1099570,True,0,No user reviews,0,0,0
1099580,True,0,2 user reviews,0,2,2
1099581,True,0,8 user reviews,4,4,8
1099582,True,0,7 user reviews,3,4,7
1099583,True,0,3 user reviews,1,2,3
1099584,True,5,Mixed,8,5,13
1099585,True,0,6 user reviews,2,4,6
1099590,True,0,3 user reviews,3,0,3
1099591,True,0,No user reviews,0,0,0
1099592,True,7,Positive,10,0,10
1099593,True,0,No user reviews,0,0,0
1099594,True,0,6 user reviews,6,0,6
1099595,True,0,No user reviews,0,0,0
1099597,True,0,No user reviews,0,0,0
1099600,True,0,No user reviews,0,0,0
1099610,True,0,No user reviews,0,0,0
1099620,True,0,1 user reviews,1,0,1
1099630,True,0,7 user reviews,4,3,7
1099640,True,0,No user reviews,0,0,0
1099650,True,0,No user reviews,0,0,0
1099660,True,0,3 user reviews,3,0,3
1099760,True,0,No user reviews,0,0,0
1099780,True,0,No user reviews,0,0,0
1099790,True,0,No user reviews,0,0,0
1099830,True,4,Mostly Negative,4,10,14
1099840,True,0,7 user reviews,5,2,7
1099850,True,0,No user reviews,0,0,0
1099900,True,0,No user reviews,0,0,0
1099910,True,0,No user reviews,0,0,0
1099920,True,6,Mostly Positive,23,7,30
1099930,True,0,No user reviews,0,0,0
1099960,True,7,Positive,17,4,21
1099980,True,0,No user reviews,0,0,0
1099990,True,0,No user reviews,0,0,0
1100020,True,0,No user reviews,0,0,0
1100030,True,0,No user reviews,0,0,0
1100040,True,0,No user reviews,0,0,0
1100050,True,0,1 user reviews,1,0,1
1100070,True,0,2 user reviews,1,1,2
1100080,True,0,No user reviews,0,0,0
1100090,True,0,No user reviews,0,0,0
1100100,True,0,No user reviews,0,0,0
1100110,True,8,Very Positive,111,17,128
1100120,True,0,No user reviews,0,0,0
1100130,True,0,1 user reviews,1,0,1
1100140,True,7,Positive,35,0,35
1100150,True,7,Positive,33,0,33
1100160,True,7,Positive,10,1,11
1100170,True,0,7 user reviews,7,0,7
1100180,True,7,Positive,10,0,10
1100200,True,7,Positive,10,0,10
1100210,True,0,1 user reviews,1,0,1
1100220,True,0,No user reviews,0,0,0
1100250,True,4,Mostly Negative,11,19,30
1100260,True,8,Very Positive,145,19,164
1100270,True,0,No user reviews,0,0,0
1100280,True,0,No user reviews,0,0,0
1100290,True,0,No user reviews,0,0,0
1100300,True,0,5 user reviews,5,0,5
1100310,True,0,No user reviews,0,0,0
1100320,True,0,No user reviews,0,0,0
1100330,True,0,No user reviews,0,0,0
1100340,True,0,No user reviews,0,0,0
1100350,True,0,5 user reviews,5,0,5
1100380,True,0,No user reviews,0,0,0
1100410,True,5,Mixed,105,110,215
1100420,True,8,Very Positive,82,10,92
1100430,True,7,Positive,26,1,27
1100480,True,0,No user reviews,0,0,0
1100510,True,0,No user reviews,0,0,0
1100550,True,0,3 user reviews,2,1,3
1100560,True,0,2 user reviews,2,0,2
1100580,True,0,No user reviews,0,0,0
1100600,True,8,Very Positive,5553,608,6161
1100620,True,8,Very Positive,223,40,263
1100720,True,0,No user reviews,0,0,0
1100730,True,0,No user reviews,0,0,0
1100750,True,5,Mixed,64,78,142
1100760,True,0,No user reviews,0,0,0
1100770,True,0,No user reviews,0,0,0
1100780,True,0,No user reviews,0,0,0
1100781,True,0,2 user reviews,0,2,2
1100782,True,0,No user reviews,0,0,0
1100783,True,0,No user reviews,0,0,0
1100784,True,0,1 user reviews,0,1,1
1100785,True,0,No user reviews,0,0,0
1100787,True,0,No user reviews,0,0,0
1100788,True,0,No user reviews,0,0,0
1100789,True,0,No user reviews,0,0,0
1100790,True,0,No user reviews,0,0,0
1100791,True,0,No user reviews,0,0,0
1100792,True,0,No user reviews,0,0,0
1100793,True,0,2 user reviews,0,2,2
1100794,True,0,No user reviews,0,0,0
1100795,True,0,No user reviews,0,0,0
1100796,True,0,No user reviews,0,0,0
1100797,True,0,No user reviews,0,0,0
1100800,True,7,Positive,30,0,30
1100810,True,0,No user reviews,0,0,0
1100830,True,0,8 user reviews,4,4,8
1100840,True,0,No user reviews,0,0,0
1100880,True,0,No user reviews,0,0,0
1100900,True,0,4 user reviews,3,1,4
1100910,True,0,No user reviews,0,0,0
1100920,True,0,4 user reviews,2,2,4
1100930,True,6,Mostly Positive,12,5,17
1100960,True,7,Positive,9,1,10
1100970,True,6,Mostly Positive,19,5,24
1100990,True,8,Very Positive,491,34,525
1101000,True,0,3 user reviews,1,2,3
1101050,True,0,No user reviews,0,0,0
1101060,True,0,No user reviews,0,0,0
1101080,True,0,4 user reviews,3,1,4
1101100,True,0,2 user reviews,1,1,2
1101110,True,0,No user reviews,0,0,0
1101120,True,0,No user reviews,0,0,0
1101130,True,6,Mostly Positive,18,5,23
1101140,True,8,Very Positive,151,12,163
1101150,True,0,No user reviews,0,0,0
1101160,True,0,No user reviews,0,0,0
1101170,True,0,No user reviews,0,0,0
1101180,True,0,9 user reviews,9,0,9
1101190,True,6,Mostly Positive,851,319,1170
1101200,True,0,1 user reviews,1,0,1
1101220,True,0,2 user reviews,2,0,2
1101260,True,8,Very Positive,82,13,95
1101270,True,7,Positive,14,3,17
1101290,True,0,No user reviews,0,0,0
1101300,True,7,Positive,26,0,26
1101310,True,0,1 user reviews,1,0,1
1101330,True,0,No user reviews,0,0,0
1101340,True,0,No user reviews,0,0,0
1101350,True,7,Positive,32,1,33
1101351,True,7,Positive,39,0,39
1101360,True,5,Mixed,38,20,58
1101370,True,0,No user reviews,0,0,0
1101380,True,0,No user reviews,0,0,0
1101390,True,0,No user reviews,0,0,0
1101400,True,0,No user reviews,0,0,0
1101410,True,0,No user reviews,0,0,0
1101420,True,7,Positive,8,2,10
1101450,True,8,Very Positive,216,19,235
1101480,True,0,No user reviews,0,0,0
1101530,True,0,No user reviews,0,0,0
1101560,True,0,No user reviews,0,0,0
1101570,True,0,2 user reviews,0,2,2
1101580,True,0,No user reviews,0,0,0
1101590,True,0,No user reviews,0,0,0
1101630,True,0,No user reviews,0,0,0
1101660,True,0,4 user reviews,3,1,4
1101670,True,0,No user reviews,0,0,0
1101710,True,0,3 user reviews,2,1,3
1101711,True,0,4 user reviews,4,0,4
1101720,True,7,Positive,15,2,17
1101740,True,0,No user reviews,0,0,0
1101750,True,0,4 user reviews,1,3,4
1101760,True,5,Mixed,15,7,22
1101770,True,0,3 user reviews,3,0,3
1101780,True,0,6 user reviews,2,4,6
1101790,True,0,No user reviews,0,0,0
1101800,True,0,7 user reviews,7,0,7
1101810,True,0,No user reviews,0,0,0
1101830,True,0,No user reviews,0,0,0
1101840,True,0,1 user reviews,1,0,1
1101850,True,0,1 user reviews,1,0,1
1101860,True,0,No user reviews,0,0,0
1101870,True,0,No user reviews,0,0,0
1101880,True,0,No user reviews,0,0,0
1101890,True,0,No user reviews,0,0,0
1101910,True,0,No user reviews,0,0,0
1101930,True,7,Positive,13,3,16
1101940,True,0,4 user reviews,2,2,4
1101960,True,0,1 user reviews,1,0,1
1101970,True,5,Mixed,9,6,15
1101980,True,0,No user reviews,0,0,0
1102000,True,0,1 user reviews,1,0,1
1102010,True,0,No user reviews,0,0,0
1102030,True,0,No user reviews,0,0,0
1102040,True,0,6 user reviews,5,1,6
1102060,True,0,3 user reviews,2,1,3
1102080,True,0,7 user reviews,7,0,7
1102090,True,0,No user reviews,0,0,0
1102100,True,6,Mostly Positive,50,17,67
1102110,True,0,No user reviews,0,0,0
1102120,True,0,No user reviews,0,0,0
1102130,True,8,Very Positive,583,58,641
1102150,True,0,2 user reviews,1,1,2
1102160,True,0,No user reviews,0,0,0
1102170,True,0,No user reviews,0,0,0
1102180,True,0,No user reviews,0,0,0
1102190,True,9,Overwhelmingly Positive,5710,136,5846
1102200,True,0,3 user reviews,2,1,3
1102210,True,0,No user reviews,0,0,0
1102230,True,0,1 user reviews,1,0,1
1102250,True,0,7 user reviews,4,3,7
1102260,True,0,7 user reviews,5,2,7
1102280,True,0,No user reviews,0,0,0
1102300,True,0,No user reviews,0,0,0
1102310,True,5,Mixed,142,146,288
1102320,True,0,1 user reviews,1,0,1
1102321,True,0,No user reviews,0,0,0
1102322,True,0,No user reviews,0,0,0
1102323,True,0,No user reviews,0,0,0
1102340,True,7,Positive,16,0,16
1102360,True,0,4 user reviews,2,2,4
1102370,True,7,Positive,10,1,11
1102380,True,7,Positive,14,2,16
1102390,True,0,3 user reviews,3,0,3
1102410,True,0,No user reviews,0,0,0
1102420,True,0,1 user reviews,1,0,1
1102430,True,0,1 user reviews,1,0,1
1102440,True,0,No user reviews,0,0,0
1102450,True,0,No user reviews,0,0,0
1102480,True,0,1 user reviews,1,0,1
1102500,True,6,Mostly Positive,10,4,14
1102510,True,0,1 user reviews,1,0,1
1102520,True,0,No user reviews,0,0,0
1102530,True,0,No user reviews,0,0,0
1102540,True,0,No user reviews,0,0,0
1102560,True,0,No user reviews,0,0,0
1102570,True,0,No user reviews,0,0,0
1102580,True,7,Positive,13,3,16
1102590,True,0,1 user reviews,1,0,1
1102600,True,0,No user reviews,0,0,0
1102610,True,0,1 user reviews,1,0,1
1102620,True,0,No user reviews,0,0,0
1102630,True,0,1 user reviews,1,0,1
1102640,True,0,1 user reviews,1,0,1
1102650,True,0,8 user reviews,8,0,8
1102670,True,0,1 user reviews,1,0,1
1102671,True,0,2 user reviews,2,0,2
1102680,True,0,6 user reviews,4,2,6
1102700,True,0,8 user reviews,7,1,8
1102710,True,0,No user reviews,0,0,0
1102720,True,0,9 user reviews,7,2,9
1102740,True,0,1 user reviews,1,0,1
1102750,True,0,7 user reviews,5,2,7
1102770,True,0,No user reviews,0,0,0
1102780,True,5,Mixed,18,12,30
1102880,True,5,Mixed,10,6,16
1102890,True,0,No user reviews,0,0,0
1102900,True,0,No user reviews,0,0,0
1102901,True,0,No user reviews,0,0,0
1102910,True,0,No user reviews,0,0,0
1102920,True,0,No user reviews,0,0,0
1102921,True,0,No user reviews,0,0,0
1102922,True,0,No user reviews,0,0,0
1102930,True,7,Positive,31,7,38
1102940,True,0,No user reviews,0,0,0
1102980,True,0,5 user reviews,4,1,5
1103000,True,0,No user reviews,0,0,0
1103040,True,0,No user reviews,0,0,0
1103050,True,0,1 user reviews,0,1,1
1103060,True,0,No user reviews,0,0,0
1103070,True,0,No user reviews,0,0,0
1103080,True,0,No user reviews,0,0,0
1103100,True,8,Very Positive,76,18,94
1103120,True,0,3 user reviews,2,1,3
1103130,True,7,Positive,13,0,13
1103140,True,0,9 user reviews,6,3,9
1103160,True,0,No user reviews,0,0,0
1103170,True,0,No user reviews,0,0,0
1103190,True,0,No user reviews,0,0,0
1103210,True,0,5 user reviews,3,2,5
1103220,True,0,No user reviews,0,0,0
1103230,True,0,No user reviews,0,0,0
1103240,True,0,1 user reviews,1,0,1
1103250,True,0,3 user reviews,2,1,3
1103260,True,0,No user reviews,0,0,0
1103270,True,0,No user reviews,0,0,0
1103290,True,0,1 user reviews,1,0,1
1103300,True,0,1 user reviews,0,1,1
1103310,True,0,8 user reviews,8,0,8
1103320,True,0,2 user reviews,1,1,2
1103330,True,0,No user reviews,0,0,0
1103340,True,0,1 user reviews,1,0,1
1103370,True,0,1 user reviews,1,0,1
1103380,True,0,No user reviews,0,0,0
1103390,True,0,1 user reviews,1,0,1
1103400,True,0,No user reviews,0,0,0
1103410,True,0,1 user reviews,1,0,1
1103420,True,0,1 user reviews,1,0,1
1103430,True,0,1 user reviews,1,0,1
1103440,True,0,No user reviews,0,0,0
1103441,True,0,No user reviews,0,0,0
1103460,True,0,No user reviews,0,0,0
1103490,True,6,Mostly Positive,51,17,68
1103510,True,0,No user reviews,0,0,0
1103520,True,0,1 user reviews,1,0,1
1103530,True,0,No user reviews,0,0,0
1103540,True,0,1 user reviews,1,0,1
1103550,True,0,1 user reviews,1,0,1
1103560,True,0,No user reviews,0,0,0
1103570,True,0,No user reviews,0,0,0
1103590,True,0,No user reviews,0,0,0
1103610,True,0,No user reviews,0,0,0
1103620,True,0,No user reviews,0,0,0
1103630,True,0,4 user reviews,0,4,4
1103640,True,0,2 user reviews,2,0,2
1103650,True,0,1 user reviews,0,1,1
1103670,True,0,2 user reviews,2,0,2
1103680,True,0,No user reviews,0,0,0
1103690,True,0,No user reviews,0,0,0
1103700,True,0,No user reviews,0,0,0
1103710,True,0,1 user reviews,1,0,1
1103711,True,0,1 user reviews,1,0,1
1103730,True,0,8 user reviews,6,2,8
1103740,True,7,Positive,13,0,13
1103741,True,0,3 user reviews,2,1,3
1103742,True,0,No user reviews,0,0,0
1103750,True,0,No user reviews,0,0,0
1103751,True,0,No user reviews,0,0,0
1103752,True,0,No user reviews,0,0,0
1103770,True,7,Positive,28,1,29
1103780,True,0,No user reviews,0,0,0
1103790,True,0,1 user reviews,1,0,1
1103800,True,7,Positive,14,2,16
1103810,True,0,4 user reviews,2,2,4
1103820,True,0,No user reviews,0,0,0
1103830,True,0,No user reviews,0,0,0
1103840,True,7,Positive,13,2,15
1103860,True,8,Very Positive,79,18,97
1103870,True,0,1 user reviews,1,0,1
1103880,True,8,Very Positive,100,13,113
1103890,True,0,5 user reviews,4,1,5
1103910,True,0,No user reviews,0,0,0
1103920,True,0,2 user reviews,0,2,2
1103930,True,7,Positive,17,0,17
1103940,True,0,No user reviews,0,0,0
1103950,True,5,Mixed,235,165,400
1103960,True,0,No user reviews,0,0,0
1103970,True,0,No user reviews,0,0,0
1103980,True,0,No user reviews,0,0,0
1104010,True,0,No user reviews,0,0,0
1104030,True,0,1 user reviews,0,1,1
1104040,True,0,No user reviews,0,0,0
1104050,True,0,5 user reviews,1,4,5
1104100,True,0,1 user reviews,1,0,1
1104150,True,0,No user reviews,0,0,0
1104170,True,0,No user reviews,0,0,0
1104200,True,0,No user reviews,0,0,0
1104210,True,0,No user reviews,0,0,0
1104220,True,8,Very Positive,56,10,66
1104230,True,0,2 user reviews,1,1,2
1104240,True,0,No user reviews,0,0,0
1104250,True,0,1 user reviews,0,1,1
1104260,True,7,Positive,20,3,23
1104270,True,0,No user reviews,0,0,0
1104280,True,0,No user reviews,0,0,0
1104290,True,0,No user reviews,0,0,0
1104300,True,0,No user reviews,0,0,0
1104320,True,0,No user reviews,0,0,0
1104330,True,8,Very Positive,190,13,203
1104340,True,0,5 user reviews,4,1,5
1104360,True,0,No user reviews,0,0,0
1104380,True,9,Overwhelmingly Positive,613,23,636
1104390,True,0,No user reviews,0,0,0
1104400,True,0,No user reviews,0,0,0
1104410,True,0,7 user reviews,3,4,7
1104420,True,0,No user reviews,0,0,0
1104450,True,0,No user reviews,0,0,0
1104460,True,0,2 user reviews,1,1,2
1104470,True,0,1 user reviews,1,0,1
1104480,True,0,2 user reviews,0,2,2
1104490,True,0,3 user reviews,2,1,3
1104510,True,0,No user reviews,0,0,0
1104540,True,0,No user reviews,0,0,0
1104560,True,0,No user reviews,0,0,0
1104570,True,0,No user reviews,0,0,0
1104600,True,0,No user reviews,0,0,0
1104610,True,0,No user reviews,0,0,0
1104620,True,0,7 user reviews,6,1,7
1104630,True,0,No user reviews,0,0,0
1104640,True,0,No user reviews,0,0,0
1104660,True,8,Very Positive,610,49,659
1104670,True,0,No user reviews,0,0,0
1104680,True,7,Positive,14,3,17
1104690,True,0,No user reviews,0,0,0
1104710,True,0,No user reviews,0,0,0
1104750,True,0,No user reviews,0,0,0
1104760,True,0,No user reviews,0,0,0
1104790,True,0,No user reviews,0,0,0
1104800,True,0,No user reviews,0,0,0
1104810,True,0,No user reviews,0,0,0
1104820,True,0,No user reviews,0,0,0
1104830,True,0,3 user reviews,3,0,3
1104840,True,0,No user reviews,0,0,0
1104860,True,0,1 user reviews,0,1,1
1104870,True,0,No user reviews,0,0,0
1104880,True,8,Very Positive,134,26,160
1104890,True,0,No user reviews,0,0,0
1104910,True,0,No user reviews,0,0,0
1104920,True,0,No user reviews,0,0,0
1104930,True,0,No user reviews,0,0,0
1104950,True,0,No user reviews,0,0,0
1104960,True,0,1 user reviews,1,0,1
1105010,True,0,2 user reviews,1,1,2
1105030,True,0,No user reviews,0,0,0
1105040,True,7,Positive,23,4,27
1105060,True,0,No user reviews,0,0,0
1105110,True,7,Positive,39,4,43
1105140,True,0,1 user reviews,1,0,1
1105160,True,0,No user reviews,0,0,0
1105180,True,0,No user reviews,0,0,0
1105190,True,0,1 user reviews,1,0,1
1105210,True,0,No user reviews,0,0,0
1105220,True,0,No user reviews,0,0,0
1105230,True,0,No user reviews,0,0,0
1105240,True,0,No user reviews,0,0,0
1105290,True,0,No user reviews,0,0,0
1105300,True,0,5 user reviews,5,0,5
1105320,True,0,No user reviews,0,0,0
1105321,True,0,No user reviews,0,0,0
1105322,True,0,2 user reviews,0,2,2
1105323,True,0,No user reviews,0,0,0
1105330,True,0,No user reviews,0,0,0
1105350,True,0,1 user reviews,1,0,1
1105360,True,5,Mixed,14,12,26
1105370,True,5,Mixed,14,10,24
1105371,True,0,No user reviews,0,0,0
1105380,True,0,2 user reviews,2,0,2
1105400,True,0,No user reviews,0,0,0
1105410,True,7,Positive,10,1,11
1105420,True,0,No user reviews,0,0,0
1105430,True,0,9 user reviews,8,1,9
1105450,True,0,4 user reviews,3,1,4
1105470,True,0,No user reviews,0,0,0
1105480,True,0,No user reviews,0,0,0
1105490,True,0,1 user reviews,1,0,1
1105530,True,0,No user reviews,0,0,0
1105542,True,0,8 user reviews,7,1,8
1105550,True,0,No user reviews,0,0,0
1105560,True,0,No user reviews,0,0,0
1105570,True,0,No user reviews,0,0,0
1105600,True,0,1 user reviews,1,0,1
1105620,True,7,Positive,40,7,47
1105630,True,7,Positive,10,0,10
1105640,True,0,No user reviews,0,0,0
1105660,True,6,Mostly Positive,16,6,22
1105670,True,0,No user reviews,0,0,0
1105680,True,0,No user reviews,0,0,0
1105730,True,0,9 user reviews,7,2,9
1105740,True,7,Positive,14,1,15
1105750,True,0,No user reviews,0,0,0
1105760,True,0,No user reviews,0,0,0
1105770,True,0,4 user reviews,3,1,4
1105780,True,0,No user reviews,0,0,0
1105790,True,0,No user reviews,0,0,0
1105800,True,0,No user reviews,0,0,0
1105810,True,5,Mixed,86,45,131
1105820,True,0,No user reviews,0,0,0
1105830,True,0,No user reviews,0,0,0
1105840,True,0,No user reviews,0,0,0
1105870,True,0,1 user reviews,1,0,1
1105880,True,0,3 user reviews,3,0,3
1105890,True,7,Positive,28,3,31
1105950,True,7,Positive,16,4,20
1105951,True,5,Mixed,9,4,13
1105960,True,0,No user reviews,0,0,0
1105970,True,0,No user reviews,0,0,0
1105990,True,0,No user reviews,0,0,0
1106000,True,0,No user reviews,0,0,0
1106010,True,0,No user reviews,0,0,0
1106011,True,0,No user reviews,0,0,0
1106012,True,0,No user reviews,0,0,0
1106013,True,0,No user reviews,0,0,0
1106020,True,0,No user reviews,0,0,0
1106021,True,0,No user reviews,0,0,0
1106022,True,0,No user reviews,0,0,0
1106023,True,0,No user reviews,0,0,0
1106030,True,0,No user reviews,0,0,0
1106060,True,6,Mostly Positive,10,4,14
1106070,True,7,Positive,13,1,14
1106080,True,7,Positive,31,6,37
1106100,True,0,2 user reviews,2,0,2
1106120,True,0,No user reviews,0,0,0
1106130,True,0,5 user reviews,5,0,5
1106150,True,7,Positive,18,1,19
1106170,True,7,Positive,9,2,11
1106180,True,5,Mixed,18,8,26
1106190,True,0,No user reviews,0,0,0
1106200,True,0,4 user reviews,4,0,4
1106220,True,0,3 user reviews,1,2,3
1106221,True,0,1 user reviews,1,0,1
1106222,True,0,1 user reviews,0,1,1
1106223,True,0,1 user reviews,1,0,1
1106224,True,0,1 user reviews,0,1,1
1106225,True,0,1 user reviews,1,0,1
1106226,True,0,1 user reviews,1,0,1
1106227,True,0,1 user reviews,1,0,1
1106228,True,0,1 user reviews,1,0,1
1106231,True,0,1 user reviews,1,0,1
1106233,True,0,1 user reviews,0,1,1
1106234,True,0,1 user reviews,1,0,1
1106243,True,0,No user reviews,0,0,0
1106250,True,0,1 user reviews,1,0,1
1106251,True,0,No user reviews,0,0,0
1106260,True,0,No user reviews,0,0,0
1106270,True,0,No user reviews,0,0,0
1106290,True,0,1 user reviews,1,0,1
1106300,True,0,2 user reviews,2,0,2
1106310,True,0,1 user reviews,1,0,1
1106320,True,0,2 user reviews,2,0,2
1106321,True,0,1 user reviews,0,1,1
1106340,True,0,No user reviews,0,0,0
1106350,True,0,4 user reviews,2,2,4
1106360,True,0,1 user reviews,0,1,1
1106361,True,0,2 user reviews,2,0,2
1106362,True,0,1 user reviews,1,0,1
1106363,True,0,No user reviews,0,0,0
1106370,True,0,1 user reviews,1,0,1
1106371,True,0,1 user reviews,1,0,1
1106380,True,0,1 user reviews,1,0,1
1106381,True,0,No user reviews,0,0,0
1106391,True,0,1 user reviews,1,0,1
1106450,True,0,1 user reviews,1,0,1
1106451,True,0,2 user reviews,2,0,2
1106452,True,0,1 user reviews,1,0,1
1106530,True,8,Very Positive,926,160,1086
1106660,True,0,No user reviews,0,0,0
1106670,True,0,5 user reviews,3,2,5
1106680,True,0,No user reviews,0,0,0
1106690,True,0,2 user reviews,0,2,2
1106700,True,0,No user reviews,0,0,0
1106710,True,0,2 user reviews,1,1,2
1106720,True,0,No user reviews,0,0,0
1106730,True,0,No user reviews,0,0,0
1106740,True,0,No user reviews,0,0,0
1106750,True,6,Mostly Positive,1041,442,1483
1106760,True,0,No user reviews,0,0,0
1106770,True,0,No user reviews,0,0,0
1106780,True,0,3 user reviews,3,0,3
1106790,True,0,4 user reviews,3,1,4
1106810,True,0,No user reviews,0,0,0
1106820,True,0,1 user reviews,1,0,1
1106830,True,0,No user reviews,0,0,0
1106840,True,8,Very Positive,1986,347,2333
1106850,True,0,No user reviews,0,0,0
1106860,True,8,Very Positive,70,3,73
1106870,True,0,No user reviews,0,0,0
1106880,True,0,No user reviews,0,0,0
1106910,True,0,No user reviews,0,0,0
1106920,True,7,Positive,18,2,20
1106930,True,0,No user reviews,0,0,0
1106940,True,8,Very Positive,72,6,78
1106950,True,0,No user reviews,0,0,0
1106960,True,0,No user reviews,0,0,0
1106970,True,0,2 user reviews,0,2,2
1106980,True,0,2 user reviews,2,0,2
1107040,True,5,Mixed,10,6,16
1107050,True,0,1 user reviews,1,0,1
1107060,True,0,7 user reviews,7,0,7
1107080,True,0,No user reviews,0,0,0
1107090,True,0,1 user reviews,1,0,1
1107100,True,0,No user reviews,0,0,0
1107120,True,0,No user reviews,0,0,0
1107130,True,0,No user reviews,0,0,0
1107150,True,0,No user reviews,0,0,0
1107160,True,0,1 user reviews,0,1,1
1107180,True,6,Mostly Positive,35,10,45
1107190,True,0,1 user reviews,0,1,1
1107210,True,0,1 user reviews,1,0,1
1107220,True,0,No user reviews,0,0,0
1107230,True,7,Positive,44,3,47
1107260,True,0,2 user reviews,2,0,2
1107280,True,0,No user reviews,0,0,0
1107290,True,7,Positive,15,0,15
1107300,True,0,No user reviews,0,0,0
1107320,True,0,No user reviews,0,0,0
1107350,True,0,1 user reviews,0,1,1
1107370,True,5,Mixed,37,16,53
1107380,True,0,No user reviews,0,0,0
1107390,True,0,No user reviews,0,0,0
1107400,True,0,No user reviews,0,0,0
1107410,True,0,No user reviews,0,0,0
1107430,True,0,No user reviews,0,0,0
1107440,True,0,4 user reviews,2,2,4
1107450,True,0,No user reviews,0,0,0
1107460,True,0,No user reviews,0,0,0
1107470,True,0,9 user reviews,9,0,9
1107480,True,0,No user reviews,0,0,0
1107490,True,0,No user reviews,0,0,0
1107500,True,0,No user reviews,0,0,0
1107510,True,0,2 user reviews,1,1,2
1107520,True,0,No user reviews,0,0,0
1107580,True,0,No user reviews,0,0,0
1107590,True,0,No user reviews,0,0,0
1107620,True,0,No user reviews,0,0,0
1107640,True,0,No user reviews,0,0,0
1107660,True,0,No user reviews,0,0,0
1107700,True,0,No user reviews,0,0,0
1107720,True,0,2 user reviews,0,2,2
1107730,True,0,No user reviews,0,0,0
1107760,True,7,Positive,37,0,37
1107770,True,0,No user reviews,0,0,0
1107790,True,6,Mostly Positive,208,61,269
1107810,True,0,1 user reviews,0,1,1
1107811,True,0,2 user reviews,1,1,2
1107812,True,5,Mixed,7,9,16
1107813,True,0,9 user reviews,2,7,9
1107814,True,0,1 user reviews,1,0,1
1107820,True,0,7 user reviews,7,0,7
1107840,True,5,Mixed,43,33,76
1107860,True,0,No user reviews,0,0,0
1107880,True,0,No user reviews,0,0,0
1107881,True,0,No user reviews,0,0,0
1107890,True,0,No user reviews,0,0,0
1107920,True,0,1 user reviews,1,0,1
1107940,True,0,No user reviews,0,0,0
1107960,True,0,No user reviews,0,0,0
1107990,True,0,No user reviews,0,0,0
1108000,True,0,No user reviews,0,0,0
1108020,True,0,No user reviews,0,0,0
1108030,True,0,No user reviews,0,0,0
1108040,True,0,No user reviews,0,0,0
1108070,True,0,No user reviews,0,0,0
1108090,True,7,Positive,40,7,47
1108110,True,0,No user reviews,0,0,0
1108130,True,0,No user reviews,0,0,0
1108170,True,0,No user reviews,0,0,0
1108180,True,0,No user reviews,0,0,0
1108190,True,0,7 user reviews,5,2,7
1108240,True,0,No user reviews,0,0,0
1108250,True,0,2 user reviews,2,0,2
1108260,True,0,No user reviews,0,0,0
1108280,True,7,Positive,11,0,11
1108290,True,0,No user reviews,0,0,0
1108310,True,0,2 user reviews,2,0,2
1108320,True,7,Positive,9,2,11
1108330,True,0,No user reviews,0,0,0
1108340,True,0,No user reviews,0,0,0
1108350,True,8,Very Positive,96,11,107
1108370,True,8,Very Positive,582,70,652
1108380,True,0,5 user reviews,5,0,5
1108390,True,0,No user reviews,0,0,0
1108410,True,7,Positive,25,6,31
1108420,True,0,No user reviews,0,0,0
1108450,True,5,Mixed,23,27,50
1108460,True,7,Positive,12,3,15
1108530,True,0,No user reviews,0,0,0
1108540,True,7,Positive,9,1,10
1108550,True,0,7 user reviews,7,0,7
1108560,True,0,No user reviews,0,0,0
1108580,True,0,1 user reviews,1,0,1
1108590,True,0,No user reviews,0,0,0
1108600,True,0,No user reviews,0,0,0
1108620,True,5,Mixed,10,5,15
1108630,True,0,No user reviews,0,0,0
1108640,True,0,7 user reviews,6,1,7
1108650,True,0,2 user reviews,0,2,2
1108660,True,0,1 user reviews,1,0,1
1108670,True,0,No user reviews,0,0,0
1108680,True,0,No user reviews,0,0,0
1108740,True,5,Mixed,27,15,42
1108760,True,0,No user reviews,0,0,0
1108761,True,0,No user reviews,0,0,0
1108763,True,0,No user reviews,0,0,0
1108770,True,0,No user reviews,0,0,0
1108780,True,0,No user reviews,0,0,0
1108790,True,0,No user reviews,0,0,0
1108791,True,0,No user reviews,0,0,0
1108792,True,0,No user reviews,0,0,0
1108793,True,0,No user reviews,0,0,0
1108794,True,0,No user reviews,0,0,0
1108800,True,0,No user reviews,0,0,0
1108820,True,0,3 user reviews,2,1,3
1108830,True,0,No user reviews,0,0,0
1108860,True,0,2 user reviews,1,1,2
1108870,True,0,4 user reviews,4,0,4
1108900,True,5,Mixed,4,6,10
1108910,True,7,Positive,9,1,10
1108920,True,5,Mixed,9,7,16
1108930,True,0,2 user reviews,2,0,2
1108940,True,0,No user reviews,0,0,0
1108950,True,0,No user reviews,0,0,0
1109070,True,0,No user reviews,0,0,0
1109080,True,0,1 user reviews,1,0,1
1109100,True,0,No user reviews,0,0,0
1109110,True,0,2 user reviews,1,1,2
1109130,True,0,No user reviews,0,0,0
1109160,True,0,No user reviews,0,0,0
1109170,True,0,1 user reviews,1,0,1
1109180,True,0,No user reviews,0,0,0
1109190,True,0,No user reviews,0,0,0
1109200,True,0,2 user reviews,1,1,2
1109202,True,0,1 user reviews,0,1,1
1109203,True,0,4 user reviews,2,2,4
1109204,True,0,1 user reviews,1,0,1
1109205,True,0,9 user reviews,8,1,9
1109206,True,0,4 user reviews,3,1,4
1109207,True,0,2 user reviews,1,1,2
1109208,True,0,3 user reviews,2,1,3
1109209,True,5,Mixed,6,8,14
1109240,True,0,No user reviews,0,0,0
1109270,True,0,No user reviews,0,0,0
1109280,True,0,1 user reviews,1,0,1
1109300,True,0,No user reviews,0,0,0
1109310,True,0,8 user reviews,3,5,8
1109330,True,0,No user reviews,0,0,0
1109331,True,0,No user reviews,0,0,0
1109340,True,0,No user reviews,0,0,0
1109350,True,0,2 user reviews,2,0,2
1109360,True,8,Very Positive,48,3,51
1109380,True,0,2 user reviews,1,1,2
1109390,True,0,No user reviews,0,0,0
1109400,True,0,No user reviews,0,0,0
1109410,True,0,No user reviews,0,0,0
1109420,True,0,No user reviews,0,0,0
1109430,True,0,No user reviews,0,0,0
1109460,True,0,No user reviews,0,0,0
1109470,True,0,No user reviews,0,0,0
1109490,True,0,No user reviews,0,0,0
1109530,True,0,No user reviews,0,0,0
1109550,True,0,2 user reviews,1,1,2
1109560,True,0,No user reviews,0,0,0
1109561,True,0,No user reviews,0,0,0
1109562,True,0,1 user reviews,1,0,1
1109563,True,0,1 user reviews,1,0,1
1109564,True,0,No user reviews,0,0,0
1109565,True,0,No user reviews,0,0,0
1109570,True,0,No user reviews,0,0,0
1109630,True,0,No user reviews,0,0,0
1109650,True,0,1 user reviews,1,0,1
1109670,True,0,9 user reviews,1,8,9
1109680,True,0,No user reviews,0,0,0
1109690,True,5,Mixed,14,8,22
1109700,True,0,No user reviews,0,0,0
1109720,True,0,1 user reviews,1,0,1
1109740,True,0,8 user reviews,2,6,8
1109750,True,0,1 user reviews,1,0,1
1109770,True,0,No user reviews,0,0,0
1109780,True,0,No user reviews,0,0,0
1109800,True,0,1 user reviews,1,0,1
1109820,True,0,No user reviews,0,0,0
1109840,True,0,3 user reviews,3,0,3
1109850,True,0,No user reviews,0,0,0
1109880,True,0,No user reviews,0,0,0
1109890,True,0,No user reviews,0,0,0
1109920,True,0,No user reviews,0,0,0
1109930,True,0,No user reviews,0,0,0
1109940,True,0,2 user reviews,2,0,2
1109950,True,0,No user reviews,0,0,0
1109960,True,0,1 user reviews,1,0,1
1109970,True,0,No user reviews,0,0,0
1109980,True,0,3 user reviews,0,3,3
1110010,True,0,No user reviews,0,0,0
1110020,True,0,No user reviews,0,0,0
1110030,True,7,Positive,32,7,39
1110040,True,0,No user reviews,0,0,0
1110050,True,8,Very Positive,127,21,148
1110090,True,0,No user reviews,0,0,0
1110100,True,8,Very Positive,337,36,373
1110110,True,0,No user reviews,0,0,0
1110111,True,0,No user reviews,0,0,0
1110112,True,0,No user reviews,0,0,0
1110113,True,0,No user reviews,0,0,0
1110120,True,0,No user reviews,0,0,0
1110121,True,0,No user reviews,0,0,0
1110122,True,0,No user reviews,0,0,0
1110123,True,0,No user reviews,0,0,0
1110124,True,0,No user reviews,0,0,0
1110125,True,0,No user reviews,0,0,0
1110130,True,0,No user reviews,0,0,0
1110131,True,0,No user reviews,0,0,0
1110140,True,0,No user reviews,0,0,0
1110141,True,0,No user reviews,0,0,0
1110142,True,0,No user reviews,0,0,0
1110143,True,0,No user reviews,0,0,0
1110150,True,0,No user reviews,0,0,0
1110160,True,0,No user reviews,0,0,0
1110170,True,0,No user reviews,0,0,0
1110180,True,0,No user reviews,0,0,0
1110200,True,0,2 user reviews,1,1,2
1110210,True,0,No user reviews,0,0,0
1110220,True,0,3 user reviews,3,0,3
1110230,True,0,No user reviews,0,0,0
1110260,True,0,No user reviews,0,0,0
1110280,True,0,1 user reviews,1,0,1
1110300,True,0,No user reviews,0,0,0
1110320,True,0,No user reviews,0,0,0
1110340,True,0,3 user reviews,2,1,3
1110350,True,0,3 user reviews,3,0,3
1110380,True,7,Positive,21,2,23
1110390,True,0,No user reviews,0,0,0
1110410,True,6,Mostly Positive,34,14,48
1110430,True,0,No user reviews,0,0,0
1110440,True,0,No user reviews,0,0,0
1110450,True,0,No user reviews,0,0,0
1110460,True,0,No user reviews,0,0,0
1110470,True,0,No user reviews,0,0,0
1110480,True,0,No user reviews,0,0,0
1110490,True,0,1 user reviews,0,1,1
1110500,True,0,No user reviews,0,0,0
1110560,True,0,No user reviews,0,0,0
1110580,True,7,Positive,18,4,22
1110590,True,0,No user reviews,0,0,0
1110600,True,0,No user reviews,0,0,0
1110620,True,0,No user reviews,0,0,0
1110630,True,0,No user reviews,0,0,0
1110631,True,0,No user reviews,0,0,0
1110632,True,0,No user reviews,0,0,0
1110640,True,0,5 user reviews,1,4,5
1110650,True,0,1 user reviews,1,0,1
1110660,True,0,1 user reviews,1,0,1
1110670,True,0,No user reviews,0,0,0
1110690,True,0,No user reviews,0,0,0
1110700,True,0,1 user reviews,1,0,1
1110710,True,0,No user reviews,0,0,0
1110720,True,0,1 user reviews,1,0,1
1110730,True,0,No user reviews,0,0,0
1110750,True,0,No user reviews,0,0,0
1110770,True,0,4 user reviews,3,1,4
1110780,True,0,No user reviews,0,0,0
1110810,True,0,No user reviews,0,0,0
1110820,True,0,No user reviews,0,0,0
1110830,True,0,3 user reviews,2,1,3
1110840,True,0,3 user reviews,1,2,3
1110870,True,0,No user reviews,0,0,0
1110880,True,0,No user reviews,0,0,0
1110890,True,7,Positive,24,1,25
1110910,True,0,No user reviews,0,0,0
1110920,True,0,No user reviews,0,0,0
1110930,True,0,2 user reviews,2,0,2
1110960,True,0,No user reviews,0,0,0
1110970,True,0,No user reviews,0,0,0
1110980,True,7,Positive,17,2,19
1111000,True,0,No user reviews,0,0,0
1111030,True,7,Positive,22,4,26
1111040,True,0,No user reviews,0,0,0
1111060,True,0,No user reviews,0,0,0
1111070,True,0,No user reviews,0,0,0
1111090,True,0,1 user reviews,1,0,1
1111100,True,0,1 user reviews,1,0,1
1111110,True,0,1 user reviews,0,1,1
1111120,True,0,4 user reviews,4,0,4
1111130,True,0,No user reviews,0,0,0
1111140,True,0,3 user reviews,3,0,3
1111150,True,0,No user reviews,0,0,0
1111170,True,0,1 user reviews,1,0,1
1111180,True,0,No user reviews,0,0,0
1111200,True,0,1 user reviews,0,1,1
1111210,True,0,4 user reviews,3,1,4
1111220,True,0,2 user reviews,2,0,2
1111230,True,0,No user reviews,0,0,0
1111240,True,0,No user reviews,0,0,0
1111250,True,0,No user reviews,0,0,0
1111260,True,0,No user reviews,0,0,0
1111270,True,0,No user reviews,0,0,0
1111290,True,0,No user reviews,0,0,0
1111300,True,0,No user reviews,0,0,0
1111310,True,0,3 user reviews,2,1,3
1111330,True,0,No user reviews,0,0,0
1111340,True,0,No user reviews,0,0,0
1111350,True,0,No user reviews,0,0,0
1111351,True,0,No user reviews,0,0,0
1111352,True,0,No user reviews,0,0,0
1111360,True,0,No user reviews,0,0,0
1111370,True,8,Very Positive,287,0,287
1111380,True,6,Mostly Positive,26,9,35
1111390,True,0,9 user reviews,7,2,9
1111410,True,0,No user reviews,0,0,0
1111420,True,0,No user reviews,0,0,0
1111440,True,7,Positive,9,1,10
1111441,True,0,No user reviews,0,0,0
1111442,True,0,No user reviews,0,0,0
1111443,True,0,No user reviews,0,0,0
1111444,True,0,1 user reviews,1,0,1
1111445,True,0,No user reviews,0,0,0
1111446,True,0,No user reviews,0,0,0
1111447,True,0,4 user reviews,4,0,4
1111448,True,0,No user reviews,0,0,0
1111450,True,0,1 user reviews,1,0,1
1111470,True,0,No user reviews,0,0,0
1111471,True,0,1 user reviews,1,0,1
1111472,True,0,No user reviews,0,0,0
1111473,True,0,No user reviews,0,0,0
1111474,True,0,2 user reviews,1,1,2
1111475,True,0,No user reviews,0,0,0
1111476,True,0,No user reviews,0,0,0
1111477,True,0,No user reviews,0,0,0
1111480,True,0,No user reviews,0,0,0
1111481,True,0,No user reviews,0,0,0
1111482,True,0,No user reviews,0,0,0
1111490,True,0,No user reviews,0,0,0
1111500,True,0,3 user reviews,1,2,3
1111510,True,0,No user reviews,0,0,0
1111511,True,0,1 user reviews,1,0,1
1111512,True,0,No user reviews,0,0,0
1111513,True,0,No user reviews,0,0,0
1111514,True,0,No user reviews,0,0,0
1111515,True,0,No user reviews,0,0,0
1111516,True,0,1 user reviews,1,0,1
1111517,True,0,1 user reviews,1,0,1
1111518,True,0,2 user reviews,2,0,2
1111530,True,0,1 user reviews,1,0,1
1111540,True,0,No user reviews,0,0,0
1111550,True,0,No user reviews,0,0,0
1111560,True,0,No user reviews,0,0,0
1111590,True,0,No user reviews,0,0,0
1111600,True,0,No user reviews,0,0,0
1111610,True,0,4 user reviews,1,3,4
1111620,True,7,Positive,20,3,23
1111640,True,0,No user reviews,0,0,0
1111650,True,0,No user reviews,0,0,0
1111660,True,0,No user reviews,0,0,0
1111670,True,0,No user reviews,0,0,0
1111671,True,0,No user reviews,0,0,0
1111700,True,0,No user reviews,0,0,0
1111720,True,0,No user reviews,0,0,0
1111730,True,0,No user reviews,0,0,0
1111760,True,0,No user reviews,0,0,0
1111790,True,0,3 user reviews,2,1,3
1111810,True,6,Mostly Positive,25,7,32
1111830,True,0,No user reviews,0,0,0
1111840,True,0,No user reviews,0,0,0
1111870,True,0,No user reviews,0,0,0
1111880,True,0,No user reviews,0,0,0
1111910,True,0,No user reviews,0,0,0
1111920,True,0,No user reviews,0,0,0
1111930,True,0,No user reviews,0,0,0
1111940,True,6,Mostly Positive,22,7,29
1111950,True,0,No user reviews,0,0,0
1111960,True,0,No user reviews,0,0,0
1111970,True,0,7 user reviews,6,1,7
1111990,True,0,5 user reviews,1,4,5
1112010,True,0,2 user reviews,1,1,2
1112050,True,0,4 user reviews,4,0,4
1112080,True,0,No user reviews,0,0,0
1112081,True,0,1 user reviews,1,0,1
1112082,True,0,1 user reviews,1,0,1
1112083,True,0,1 user reviews,1,0,1
1112100,True,0,No user reviews,0,0,0
1112120,True,0,2 user reviews,0,2,2
1112130,True,0,No user reviews,0,0,0
1112140,True,0,No user reviews,0,0,0
1112150,True,0,8 user reviews,8,0,8
1112200,True,0,2 user reviews,1,1,2
1112230,True,0,No user reviews,0,0,0
1112240,True,5,Mixed,9,5,14
1112250,True,0,No user reviews,0,0,0
1112290,True,0,No user reviews,0,0,0
1112300,True,0,No user reviews,0,0,0
1112310,True,0,No user reviews,0,0,0
1112330,True,0,No user reviews,0,0,0
1112340,True,8,Very Positive,111,12,123
1112350,True,0,No user reviews,0,0,0
1112360,True,0,2 user reviews,2,0,2
1112370,True,7,Positive,18,3,21
1112380,True,0,No user reviews,0,0,0
1112390,True,0,No user reviews,0,0,0
1112400,True,0,No user reviews,0,0,0
1112420,True,0,3 user reviews,2,1,3
1112430,True,0,No user reviews,0,0,0
1112440,True,0,No user reviews,0,0,0
1112450,True,0,No user reviews,0,0,0
1112460,True,0,No user reviews,0,0,0
1112470,True,0,7 user reviews,7,0,7
1112480,True,0,No user reviews,0,0,0
1112481,True,0,1 user reviews,1,0,1
1112482,True,0,1 user reviews,1,0,1
1112483,True,0,6 user reviews,3,3,6
1112484,True,0,1 user reviews,1,0,1
1112485,True,0,No user reviews,0,0,0
1112510,True,0,No user reviews,0,0,0
1112520,True,7,Positive,14,1,15
1112521,True,0,7 user reviews,5,2,7
1112570,True,0,3 user reviews,2,1,3
1112580,True,0,5 user reviews,4,1,5
1112590,True,7,Positive,11,0,11
1112591,True,0,3 user reviews,2,1,3
1112620,True,7,Positive,32,8,40
1112640,True,6,Mostly Positive,11,3,14
1112650,True,0,No user reviews,0,0,0
1112660,True,0,No user reviews,0,0,0
1112670,True,0,No user reviews,0,0,0
1112680,True,0,No user reviews,0,0,0
1112690,True,7,Positive,11,2,13
1112700,True,0,5 user reviews,5,0,5
1112710,True,0,No user reviews,0,0,0
1112720,True,0,No user reviews,0,0,0
1112760,True,0,2 user reviews,2,0,2
1112790,True,5,Mixed,772,346,1118
1112830,True,5,Mixed,28,15,43
1112840,True,0,No user reviews,0,0,0
1112850,True,0,No user reviews,0,0,0
1112860,True,0,No user reviews,0,0,0
1112870,True,0,No user reviews,0,0,0
1112880,True,0,No user reviews,0,0,0
1112890,True,0,No user reviews,0,0,0
1112900,True,0,No user reviews,0,0,0
1112930,True,8,Very Positive,115,11,126
1112940,True,0,No user reviews,0,0,0
1112950,True,0,No user reviews,0,0,0
1112960,True,0,4 user reviews,2,2,4
1112970,True,0,No user reviews,0,0,0
1112971,True,0,No user reviews,0,0,0
1112980,True,0,No user reviews,0,0,0
1113000,True,9,Overwhelmingly Positive,18746,421,19167
1113010,True,0,No user reviews,0,0,0
1113030,True,0,No user reviews,0,0,0
1113040,True,0,2 user reviews,2,0,2
1113060,True,0,3 user reviews,3,0,3
1113080,True,0,No user reviews,0,0,0
1113090,True,0,1 user reviews,1,0,1
1113110,True,0,2 user reviews,1,1,2
1113140,True,0,2 user reviews,2,0,2
1113150,True,0,No user reviews,0,0,0
1113180,True,0,No user reviews,0,0,0
1113210,True,0,No user reviews,0,0,0
1113220,True,0,3 user reviews,3,0,3
1113230,True,0,1 user reviews,1,0,1
1113240,True,0,2 user reviews,2,0,2
1113250,True,0,No user reviews,0,0,0
1113260,True,0,No user reviews,0,0,0
1113290,True,0,No user reviews,0,0,0
1113300,True,6,Mostly Positive,21,7,28
1113310,True,7,Positive,21,1,22
1113340,True,0,No user reviews,0,0,0
1113360,True,0,1 user reviews,1,0,1
1113370,True,0,No user reviews,0,0,0
1113380,True,0,No user reviews,0,0,0
1113390,True,0,4 user reviews,4,0,4
1113400,True,0,No user reviews,0,0,0
1113410,True,5,Mixed,534,569,1103
1113430,True,0,1 user reviews,1,0,1
1113490,True,0,2 user reviews,2,0,2
1113510,True,0,No user reviews,0,0,0
1113530,True,0,No user reviews,0,0,0
1113550,True,7,Positive,14,0,14
1113580,True,0,No user reviews,0,0,0
1113590,True,0,No user reviews,0,0,0
1113620,True,0,8 user reviews,3,5,8
1113630,True,0,No user reviews,0,0,0
1113640,True,0,1 user reviews,0,1,1
1113650,True,0,1 user reviews,0,1,1
1113670,True,0,No user reviews,0,0,0
1113680,True,8,Very Positive,164,36,200
1113690,True,7,Positive,10,0,10
1113700,True,0,No user reviews,0,0,0
1113710,True,0,No user reviews,0,0,0
1113730,True,0,No user reviews,0,0,0
1113740,True,0,2 user reviews,1,1,2
1113750,True,0,8 user reviews,4,4,8
1113760,True,0,3 user reviews,3,0,3
1113770,True,7,Positive,10,0,10
1113780,True,7,Positive,15,3,18
1113810,True,0,No user reviews,0,0,0
1113820,True,5,Mixed,29,23,52
1113821,True,7,Positive,27,3,30
1113822,True,7,Positive,18,4,22
1113823,True,6,Mostly Positive,16,5,21
1113824,True,5,Mixed,11,6,17
1113840,True,0,No user reviews,0,0,0
1113850,True,0,No user reviews,0,0,0
1113860,True,0,No user reviews,0,0,0
1113870,True,0,No user reviews,0,0,0
1113880,True,0,No user reviews,0,0,0
1113910,True,8,Very Positive,94,20,114
1113930,True,0,4 user reviews,3,1,4
1113940,True,7,Positive,13,1,14
1113950,True,0,No user reviews,0,0,0
1113960,True,0,3 user reviews,3,0,3
1113970,True,7,Positive,14,0,14
1114000,True,0,7 user reviews,2,5,7
1114010,True,0,3 user reviews,3,0,3
1114020,True,0,1 user reviews,1,0,1
1114030,True,0,No user reviews,0,0,0
1114040,True,0,No user reviews,0,0,0
1114050,True,0,No user reviews,0,0,0
1114070,True,0,1 user reviews,1,0,1
1114090,True,0,No user reviews,0,0,0
1114100,True,0,No user reviews,0,0,0
1114110,True,0,1 user reviews,0,1,1
1114130,True,8,Very Positive,109,4,113
1114140,True,0,No user reviews,0,0,0
1114150,True,0,No user reviews,0,0,0
1114170,True,0,No user reviews,0,0,0
1114180,True,0,No user reviews,0,0,0
1114190,True,0,No user reviews,0,0,0
1114200,True,0,No user reviews,0,0,0
1114210,True,0,2 user reviews,2,0,2
1114220,True,8,Very Positive,186,25,211
1114230,True,0,3 user reviews,2,1,3
1114250,True,0,No user reviews,0,0,0
1114260,True,0,No user reviews,0,0,0
1114270,True,0,3 user reviews,2,1,3
1114290,True,0,No user reviews,0,0,0
1114310,True,0,No user reviews,0,0,0
1114320,True,0,No user reviews,0,0,0
1114330,True,0,No user reviews,0,0,0
1114340,True,0,No user reviews,0,0,0
1114360,True,0,8 user reviews,5,3,8
1114390,True,0,No user reviews,0,0,0
1114420,True,0,No user reviews,0,0,0
1114430,True,7,Positive,24,1,25
1114440,True,0,No user reviews,0,0,0
1114441,True,0,No user reviews,0,0,0
1114450,True,0,No user reviews,0,0,0
1114460,True,0,7 user reviews,7,0,7
1114470,True,0,No user reviews,0,0,0
1114480,True,0,No user reviews,0,0,0
1114530,True,7,Positive,30,4,34
1114540,True,0,No user reviews,0,0,0
1114550,True,6,Mostly Positive,46,12,58
1114560,True,0,No user reviews,0,0,0
1114561,True,7,Positive,26,0,26
1114580,True,0,No user reviews,0,0,0
1114590,True,0,No user reviews,0,0,0
1114591,True,0,No user reviews,0,0,0
1114600,True,0,No user reviews,0,0,0
1114610,True,0,No user reviews,0,0,0
1114620,True,0,8 user reviews,8,0,8
1114630,True,0,4 user reviews,3,1,4
1114640,True,0,No user reviews,0,0,0
1114650,True,0,No user reviews,0,0,0
1114660,True,0,No user reviews,0,0,0
1114690,True,0,No user reviews,0,0,0
1114700,True,0,2 user reviews,1,1,2
1114710,True,0,3 user reviews,0,3,3
1114720,True,0,No user reviews,0,0,0
1114730,True,7,Positive,17,3,20
1114740,True,0,No user reviews,0,0,0
1114750,True,0,2 user reviews,2,0,2
1114760,True,0,No user reviews,0,0,0
1114780,True,0,No user reviews,0,0,0
1114800,True,0,1 user reviews,1,0,1
1114830,True,5,Mixed,28,19,47
1114840,True,0,No user reviews,0,0,0
1114860,True,0,No user reviews,0,0,0
1114870,True,8,Very Positive,82,11,93
1114880,True,0,No user reviews,0,0,0
1114900,True,0,No user reviews,0,0,0
1114910,True,0,1 user reviews,1,0,1
1114940,True,0,No user reviews,0,0,0
1114970,True,0,No user reviews,0,0,0
1114990,True,0,No user reviews,0,0,0
1115010,True,0,No user reviews,0,0,0
1115020,True,0,No user reviews,0,0,0
1115030,True,0,No user reviews,0,0,0
1115040,True,0,2 user reviews,0,2,2
1115050,True,0,No user reviews,0,0,0
1115060,True,0,1 user reviews,0,1,1
1115090,True,0,No user reviews,0,0,0
1115110,True,0,No user reviews,0,0,0
1115120,True,0,No user reviews,0,0,0
1115130,True,0,No user reviews,0,0,0
1115140,True,0,No user reviews,0,0,0
1115150,True,0,No user reviews,0,0,0
1115160,True,0,No user reviews,0,0,0
1115170,True,0,No user reviews,0,0,0
1115190,True,0,No user reviews,0,0,0
1115200,True,0,No user reviews,0,0,0
1115210,True,0,No user reviews,0,0,0
1115220,True,0,No user reviews,0,0,0
1115230,True,0,No user reviews,0,0,0
1115240,True,0,No user reviews,0,0,0
1115250,True,0,No user reviews,0,0,0
1115260,True,0,No user reviews,0,0,0
1115270,True,0,No user reviews,0,0,0
1115280,True,0,No user reviews,0,0,0
1115290,True,0,No user reviews,0,0,0
1115300,True,0,No user reviews,0,0,0
1115310,True,0,No user reviews,0,0,0
1115320,True,0,No user reviews,0,0,0
1115330,True,0,No user reviews,0,0,0
1115340,True,0,No user reviews,0,0,0
1115350,True,0,No user reviews,0,0,0
1115360,True,0,No user reviews,0,0,0
1115370,True,0,No user reviews,0,0,0
1115380,True,0,No user reviews,0,0,0
1115390,True,0,No user reviews,0,0,0
1115410,True,0,No user reviews,0,0,0
1115420,True,0,5 user reviews,3,2,5
1115440,True,0,No user reviews,0,0,0
1115450,True,6,Mostly Positive,24,7,31
1115460,True,0,No user reviews,0,0,0
1115470,True,0,No user reviews,0,0,0
1115480,True,0,No user reviews,0,0,0
1115490,True,0,No user reviews,0,0,0
1115540,True,0,No user reviews,0,0,0
1115570,True,0,1 user reviews,0,1,1
1115580,True,7,Positive,26,0,26
1115600,True,0,3 user reviews,3,0,3
1115610,True,0,No user reviews,0,0,0
1115620,True,0,2 user reviews,2,0,2
1115630,True,0,1 user reviews,1,0,1
1115640,True,7,Positive,34,5,39
1115650,True,5,Mixed,7,8,15
1115660,True,0,No user reviews,0,0,0
1115670,True,0,No user reviews,0,0,0
1115680,True,0,No user reviews,0,0,0
1115690,True,8,Very Positive,1297,238,1535
1115710,True,0,No user reviews,0,0,0
1115720,True,0,No user reviews,0,0,0
1115730,True,0,No user reviews,0,0,0
1115740,True,0,No user reviews,0,0,0
1115760,True,0,3 user reviews,3,0,3
1115780,True,6,Mostly Positive,23,6,29
1115790,True,0,No user reviews,0,0,0
1115791,True,0,No user reviews,0,0,0
1115820,True,0,2 user reviews,2,0,2
1115830,True,0,No user reviews,0,0,0
1115840,True,0,2 user reviews,0,2,2
1115860,True,0,No user reviews,0,0,0
1115870,True,0,No user reviews,0,0,0
1115900,True,0,No user reviews,0,0,0
1115940,True,0,No user reviews,0,0,0
1115960,True,0,No user reviews,0,0,0
1115970,True,0,1 user reviews,1,0,1
1115980,True,0,No user reviews,0,0,0
1116000,True,0,No user reviews,0,0,0
1116010,True,0,No user reviews,0,0,0
1116020,True,0,4 user reviews,2,2,4
1116030,True,0,No user reviews,0,0,0
1116050,True,0,No user reviews,0,0,0
1116060,True,5,Mixed,8,6,14
1116080,True,0,No user reviews,0,0,0
1116100,True,0,No user reviews,0,0,0
1116110,True,7,Positive,14,1,15
1116160,True,0,2 user reviews,2,0,2
1116170,True,0,No user reviews,0,0,0
1116180,True,0,3 user reviews,3,0,3
1116190,True,0,No user reviews,0,0,0
1116200,True,0,1 user reviews,1,0,1
1116210,True,5,Mixed,8,5,13
1116230,True,8,Very Positive,59,9,68
1116240,True,0,3 user reviews,2,1,3
1116260,True,0,No user reviews,0,0,0
1116270,True,0,No user reviews,0,0,0
1116280,True,0,No user reviews,0,0,0
1116290,True,7,Positive,11,2,13
1116300,True,0,1 user reviews,1,0,1
1116310,True,7,Positive,29,1,30
1116330,True,0,No user reviews,0,0,0
1116340,True,6,Mostly Positive,22,9,31
1116350,True,0,1 user reviews,0,1,1
1116360,True,0,1 user reviews,1,0,1
1116410,True,0,No user reviews,0,0,0
1116430,True,7,Positive,14,1,15
1116450,True,0,2 user reviews,2,0,2
1116470,True,4,Mostly Negative,4,11,15
1116480,True,0,No user reviews,0,0,0
1116490,True,7,Positive,12,3,15
1116500,True,0,No user reviews,0,0,0
1116520,True,4,Mostly Negative,3,7,10
1116530,True,0,No user reviews,0,0,0
1116540,True,0,No user reviews,0,0,0
1116550,True,0,No user reviews,0,0,0
1116560,True,0,No user reviews,0,0,0
1116570,True,0,No user reviews,0,0,0
1116580,True,0,No user reviews,0,0,0
1116590,True,0,5 user reviews,3,2,5
1116600,True,0,2 user reviews,0,2,2
1116630,True,0,No user reviews,0,0,0
1116640,True,0,No user reviews,0,0,0
1116650,True,0,2 user reviews,2,0,2
1116660,True,0,No user reviews,0,0,0
1116670,True,0,2 user reviews,2,0,2
1116700,True,0,4 user reviews,4,0,4
1116750,True,0,No user reviews,0,0,0
1116770,True,7,Positive,12,2,14
1116780,True,7,Positive,32,2,34
1116800,True,0,1 user reviews,1,0,1
1116810,True,0,No user reviews,0,0,0
1116860,True,0,No user reviews,0,0,0
1116870,True,0,4 user reviews,3,1,4
1116880,True,7,Positive,14,1,15
1116890,True,0,3 user reviews,3,0,3
1116910,True,0,2 user reviews,1,1,2
1116940,True,0,2 user reviews,2,0,2
1116960,True,0,No user reviews,0,0,0
1116970,True,0,No user reviews,0,0,0
1116990,True,7,Positive,24,2,26
1117000,True,0,No user reviews,0,0,0
1117020,True,0,No user reviews,0,0,0
1117030,True,0,No user reviews,0,0,0
1117040,True,0,3 user reviews,2,1,3
1117050,True,0,No user reviews,0,0,0
1117060,True,0,No user reviews,0,0,0
1117120,True,0,2 user reviews,1,1,2
1117140,True,7,Positive,20,2,22
1117150,True,0,No user reviews,0,0,0
1117160,True,0,No user reviews,0,0,0
1117200,True,0,No user reviews,0,0,0
1117210,True,0,No user reviews,0,0,0
1117220,True,0,1 user reviews,1,0,1
1117230,True,0,No user reviews,0,0,0
1117250,True,7,Positive,22,4,26
1117270,True,0,No user reviews,0,0,0
1117300,True,0,No user reviews,0,0,0
1117310,True,8,Very Positive,88,2,90
1117330,True,0,1 user reviews,0,1,1
1117340,True,0,2 user reviews,2,0,2
1117360,True,0,3 user reviews,3,0,3
1117370,True,0,No user reviews,0,0,0
1117380,True,7,Positive,16,1,17
1117390,True,0,No user reviews,0,0,0
1117420,True,0,No user reviews,0,0,0
1117450,True,0,No user reviews,0,0,0
1117470,True,0,No user reviews,0,0,0
1117480,True,7,Positive,9,1,10
1117490,True,0,3 user reviews,1,2,3
1117500,True,0,No user reviews,0,0,0
1117520,True,0,3 user reviews,1,2,3
1117540,True,0,No user reviews,0,0,0
1117541,True,0,No user reviews,0,0,0
1117550,True,0,5 user reviews,4,1,5
1117560,True,0,No user reviews,0,0,0
1117590,True,0,No user reviews,0,0,0
1117600,True,0,No user reviews,0,0,0
1117610,True,0,No user reviews,0,0,0
1117630,True,6,Mostly Positive,136,36,172
1117640,True,0,No user reviews,0,0,0
1117641,True,0,2 user reviews,2,0,2
1117660,True,0,9 user reviews,4,5,9
1117670,True,7,Positive,13,2,15
1117680,True,0,6 user reviews,1,5,6
1117690,True,0,No user reviews,0,0,0
1117710,True,0,1 user reviews,0,1,1
1117720,True,0,No user reviews,0,0,0
1117721,True,0,No user reviews,0,0,0
1117730,True,0,No user reviews,0,0,0
1117760,True,0,2 user reviews,2,0,2
1117770,True,7,Positive,13,2,15
1117800,True,0,No user reviews,0,0,0
1117810,True,0,No user reviews,0,0,0
1117840,True,0,No user reviews,0,0,0
1117850,True,0,No user reviews,0,0,0
1117860,True,5,Mixed,12,6,18
1117880,True,7,Positive,19,1,20
1117890,True,0,4 user reviews,4,0,4
1117900,True,0,3 user reviews,2,1,3
1117930,True,0,1 user reviews,1,0,1
1117940,True,0,1 user reviews,1,0,1
1117950,True,0,2 user reviews,2,0,2
1117970,True,0,1 user reviews,1,0,1
1117980,True,0,1 user reviews,1,0,1
1117990,True,0,2 user reviews,2,0,2
1118000,True,0,6 user reviews,6,0,6
1118010,True,6,Mostly Positive,2696,997,3693
1118012,True,7,Positive,21,5,26
1118013,True,0,No user reviews,0,0,0
1118014,True,0,No user reviews,0,0,0
1118015,True,0,No user reviews,0,0,0
1118017,True,0,No user reviews,0,0,0
1118018,True,0,No user reviews,0,0,0
1118019,True,0,1 user reviews,1,0,1
1118021,True,7,Positive,13,0,13
1118022,True,0,2 user reviews,2,0,2
1118023,True,0,2 user reviews,2,0,2
1118024,True,0,9 user reviews,8,1,9
1118025,True,0,5 user reviews,5,0,5
1118026,True,7,Positive,22,0,22
1118029,True,0,8 user reviews,8,0,8
1118030,True,0,No user reviews,0,0,0
1118050,True,0,5 user reviews,4,1,5
1118100,True,0,No user reviews,0,0,0
1118110,True,0,No user reviews,0,0,0
1118120,True,0,No user reviews,0,0,0
1118130,True,0,1 user reviews,1,0,1
1118140,True,0,No user reviews,0,0,0
1118150,True,0,No user reviews,0,0,0
1118160,True,0,No user reviews,0,0,0
1118170,True,0,No user reviews,0,0,0
1118180,True,0,No user reviews,0,0,0
1118200,True,9,Overwhelmingly Positive,9222,108,9330
1118210,True,0,No user reviews,0,0,0
1118220,True,0,No user reviews,0,0,0
1118230,True,0,No user reviews,0,0,0
1118240,True,0,No user reviews,0,0,0
1118263,True,0,1 user reviews,1,0,1
1118265,True,0,No user reviews,0,0,0
1118270,True,7,Positive,14,0,14
1118271,True,0,1 user reviews,1,0,1
1118272,True,0,1 user reviews,1,0,1
1118273,True,0,No user reviews,0,0,0
1118274,True,0,2 user reviews,2,0,2
1118275,True,0,2 user reviews,2,0,2
1118280,True,0,1 user reviews,0,1,1
1118281,True,0,1 user reviews,0,1,1
1118282,True,0,1 user reviews,0,1,1
1118283,True,0,2 user reviews,1,1,2
1118284,True,0,4 user reviews,2,2,4
1118285,True,0,1 user reviews,0,1,1
1118286,True,0,1 user reviews,0,1,1
1118287,True,0,1 user reviews,0,1,1
1118288,True,0,2 user reviews,1,1,2
1118290,True,5,Mixed,7,5,12
1118291,True,0,1 user reviews,0,1,1
1118292,True,5,Mixed,9,5,14
1118293,True,0,1 user reviews,0,1,1
1118294,True,0,3 user reviews,2,1,3
1118310,True,0,No user reviews,0,0,0
1118320,True,0,1 user reviews,1,0,1
1118350,True,7,Positive,10,2,12
1118370,True,0,No user reviews,0,0,0
1118380,True,7,Positive,37,9,46
1118390,True,0,No user reviews,0,0,0
1118400,True,0,No user reviews,0,0,0
1118410,True,7,Positive,13,1,14
1118430,True,0,No user reviews,0,0,0
1118440,True,0,No user reviews,0,0,0
1118470,True,0,No user reviews,0,0,0
1118500,True,0,No user reviews,0,0,0
1118510,True,0,No user reviews,0,0,0
1118520,True,0,No user reviews,0,0,0
1118540,True,0,No user reviews,0,0,0
1118550,True,0,No user reviews,0,0,0
1118570,True,0,No user reviews,0,0,0
1118580,True,0,No user reviews,0,0,0
1118590,True,0,4 user reviews,1,3,4
1118600,True,0,No user reviews,0,0,0
1118630,True,0,No user reviews,0,0,0
1118640,True,0,No user reviews,0,0,0
1118650,True,0,No user reviews,0,0,0
1118660,True,0,No user reviews,0,0,0
1118670,True,0,No user reviews,0,0,0
1118680,True,0,No user reviews,0,0,0
1118690,True,0,1 user reviews,0,1,1
1118700,True,0,7 user reviews,5,2,7
1118710,True,0,No user reviews,0,0,0
1118730,True,0,2 user reviews,0,2,2
1118740,True,0,7 user reviews,7,0,7
1118790,True,0,No user reviews,0,0,0
1118800,True,0,No user reviews,0,0,0
1118820,True,0,3 user reviews,2,1,3
1118840,True,6,Mostly Positive,9,3,12
1118870,True,0,1 user reviews,0,1,1
1118880,True,7,Positive,28,1,29
1118910,True,0,4 user reviews,1,3,4
1118920,True,0,No user reviews,0,0,0
1118930,True,0,1 user reviews,0,1,1
1118940,True,0,3 user reviews,2,1,3
1118950,True,0,1 user reviews,1,0,1
1118970,True,0,No user reviews,0,0,0
1118980,True,0,No user reviews,0,0,0
1119010,True,0,No user reviews,0,0,0
1119030,True,0,5 user reviews,5,0,5
1119040,True,0,No user reviews,0,0,0
1119050,True,0,No user reviews,0,0,0
1119060,True,0,No user reviews,0,0,0
1119070,True,0,No user reviews,0,0,0
1119100,True,0,4 user reviews,4,0,4
1119110,True,0,1 user reviews,1,0,1
1119370,True,0,No user reviews,0,0,0
1119380,True,0,1 user reviews,1,0,1
1119390,True,0,No user reviews,0,0,0
1119400,True,0,No user reviews,0,0,0
1119410,True,0,No user reviews,0,0,0
1119420,True,0,No user reviews,0,0,0
1119430,True,0,5 user reviews,5,0,5
1119500,True,0,1 user reviews,0,1,1
1119510,True,0,No user reviews,0,0,0
1119520,True,0,1 user reviews,1,0,1
1119530,True,0,4 user reviews,3,1,4
1119540,True,0,No user reviews,0,0,0
1119550,True,0,No user reviews,0,0,0
1119560,True,0,No user reviews,0,0,0
1119570,True,5,Mixed,10,7,17
1119580,True,0,No user reviews,0,0,0
1119590,True,0,No user reviews,0,0,0
1119600,True,6,Mostly Positive,75,30,105
1119620,True,0,No user reviews,0,0,0
1119630,True,0,2 user reviews,1,1,2
1119640,True,0,1 user reviews,0,1,1
1119670,True,0,3 user reviews,3,0,3
1119680,True,0,No user reviews,0,0,0
1119690,True,0,No user reviews,0,0,0
1119700,True,6,Mostly Positive,114,42,156
1119710,True,6,Mostly Positive,14,4,18
1119730,True,0,No user reviews,0,0,0
1119740,True,0,1 user reviews,1,0,1
1119750,True,0,3 user reviews,2,1,3
1119760,True,0,4 user reviews,4,0,4
1119770,True,0,1 user reviews,0,1,1
1119790,True,0,6 user reviews,6,0,6
1119800,True,7,Positive,33,4,37
1119820,True,0,No user reviews,0,0,0
1119840,True,0,No user reviews,0,0,0
1119850,True,0,No user reviews,0,0,0
1119860,True,7,Positive,10,1,11
1119880,True,0,No user reviews,0,0,0
1119890,True,0,1 user reviews,1,0,1
1119900,True,0,No user reviews,0,0,0
1119910,True,0,No user reviews,0,0,0
1119940,True,7,Positive,15,1,16
1119950,True,0,No user reviews,0,0,0
1119960,True,0,7 user reviews,7,0,7
1119970,True,0,2 user reviews,1,1,2
1119980,True,0,No user reviews,0,0,0
1119990,True,0,No user reviews,0,0,0
1119991,True,0,No user reviews,0,0,0
1119992,True,0,No user reviews,0,0,0
1119993,True,0,No user reviews,0,0,0
1119994,True,0,No user reviews,0,0,0
1119995,True,0,No user reviews,0,0,0
1119996,True,0,No user reviews,0,0,0
1119997,True,0,No user reviews,0,0,0
1119998,True,0,No user reviews,0,0,0
1119999,True,0,No user reviews,0,0,0
1120020,True,0,1 user reviews,1,0,1
1120021,True,0,No user reviews,0,0,0
1120022,True,0,No user reviews,0,0,0
1120023,True,0,No user reviews,0,0,0
1120024,True,0,No user reviews,0,0,0
1120025,True,0,1 user reviews,1,0,1
1120050,True,0,No user reviews,0,0,0
1120060,True,0,No user reviews,0,0,0
1120070,True,0,No user reviews,0,0,0
1120090,True,0,No user reviews,0,0,0
1120160,True,0,2 user reviews,2,0,2
1120180,True,0,No user reviews,0,0,0
1120200,True,0,5 user reviews,5,0,5
1120210,True,6,Mostly Positive,7,3,10
1120220,True,0,No user reviews,0,0,0
1120240,True,0,3 user reviews,2,1,3
1120250,True,0,No user reviews,0,0,0
1120260,True,0,3 user reviews,1,2,3
1120280,True,0,7 user reviews,5,2,7
1120290,True,0,2 user reviews,1,1,2
1120300,True,5,Mixed,31,14,45
1120301,True,0,5 user reviews,3,2,5
1120302,True,5,Mixed,9,11,20
1120304,True,6,Mostly Positive,12,4,16
1120305,True,5,Mixed,38,24,62
1120310,True,0,4 user reviews,4,0,4
1120320,True,0,No user reviews,0,0,0
1120330,True,0,No user reviews,0,0,0
1120340,True,0,No user reviews,0,0,0
1120360,True,7,Positive,34,3,37
1120370,True,0,2 user reviews,2,0,2
1120390,True,0,1 user reviews,1,0,1
1120400,True,0,No user reviews,0,0,0
1120410,True,0,No user reviews,0,0,0
1120420,True,7,Positive,13,0,13
1120440,True,0,No user reviews,0,0,0
1120450,True,0,No user reviews,0,0,0
1120460,True,0,No user reviews,0,0,0
1120461,True,0,2 user reviews,2,0,2
1120470,True,0,No user reviews,0,0,0
1120490,True,0,No user reviews,0,0,0
1120510,True,0,No user reviews,0,0,0
1120540,True,0,No user reviews,0,0,0
1120550,True,5,Mixed,6,7,13
1120560,True,6,Mostly Positive,30,10,40
1120570,True,0,1 user reviews,1,0,1
1120580,True,0,5 user reviews,1,4,5
1120600,True,0,2 user reviews,2,0,2
1120620,True,0,No user reviews,0,0,0
1120630,True,0,No user reviews,0,0,0
1120640,True,0,1 user reviews,1,0,1
1120670,True,0,6 user reviews,5,1,6
1120680,True,0,2 user reviews,1,1,2
1120690,True,0,No user reviews,0,0,0
1120700,True,0,No user reviews,0,0,0
1120710,True,0,2 user reviews,2,0,2
1120711,True,0,No user reviews,0,0,0
1120720,True,0,No user reviews,0,0,0
1120730,True,0,No user reviews,0,0,0
1120770,True,0,No user reviews,0,0,0
1120790,True,0,No user reviews,0,0,0
1120800,True,0,3 user reviews,3,0,3
1120810,True,8,Very Positive,76,2,78
1120820,True,0,No user reviews,0,0,0
1120840,True,0,No user reviews,0,0,0
1120841,True,0,No user reviews,0,0,0
1120842,True,0,No user reviews,0,0,0
1120843,True,0,No user reviews,0,0,0
1120844,True,0,No user reviews,0,0,0
1120850,True,0,No user reviews,0,0,0
1120860,True,0,No user reviews,0,0,0
1120880,True,0,No user reviews,0,0,0
1120890,True,0,No user reviews,0,0,0
1120900,True,0,1 user reviews,0,1,1
1120920,True,0,5 user reviews,5,0,5
1120940,True,0,9 user reviews,8,1,9
1120950,True,7,Positive,10,0,10
1120960,True,0,2 user reviews,1,1,2
1120970,True,0,3 user reviews,3,0,3
1120980,True,7,Positive,19,0,19
1120990,True,0,8 user reviews,6,2,8
1121000,True,0,No user reviews,0,0,0
1121010,True,0,No user reviews,0,0,0
1121020,True,0,No user reviews,0,0,0
1121030,True,0,No user reviews,0,0,0
1121090,True,0,No user reviews,0,0,0
1121100,True,0,1 user reviews,1,0,1
1121120,True,0,No user reviews,0,0,0
1121130,True,0,No user reviews,0,0,0
1121140,True,0,No user reviews,0,0,0
1121160,True,0,No user reviews,0,0,0
1121190,True,0,No user reviews,0,0,0
1121200,True,0,No user reviews,0,0,0
1121220,True,0,No user reviews,0,0,0
1121230,True,0,2 user reviews,1,1,2
1121260,True,0,No user reviews,0,0,0
1121270,True,7,Positive,8,2,10
1121290,True,0,No user reviews,0,0,0
1121300,True,7,Positive,21,0,21
1121310,True,0,No user reviews,0,0,0
1121320,True,0,No user reviews,0,0,0
1121330,True,0,No user reviews,0,0,0
1121340,True,0,1 user reviews,1,0,1
1121370,True,0,No user reviews,0,0,0
1121380,True,0,No user reviews,0,0,0
1121390,True,0,No user reviews,0,0,0
1121400,True,0,2 user reviews,2,0,2
1121420,True,8,Very Positive,426,25,451
1121430,True,5,Mixed,11,7,18
1121460,True,0,No user reviews,0,0,0
1121490,True,0,2 user reviews,1,1,2
1121510,True,0,No user reviews,0,0,0
1121530,True,7,Positive,32,3,35
1121550,True,0,7 user reviews,6,1,7
1121560,True,8,Very Positive,722,89,811
1121570,True,0,No user reviews,0,0,0
1121580,True,4,Mostly Negative,12,20,32
1121590,True,7,Positive,36,5,41
1121600,True,0,1 user reviews,1,0,1
1121610,True,0,No user reviews,0,0,0
1121620,True,0,2 user reviews,2,0,2
1121621,True,0,4 user reviews,4,0,4
1121622,True,0,2 user reviews,1,1,2
1121630,True,0,No user reviews,0,0,0
1121640,True,0,No user reviews,0,0,0
1121650,True,0,4 user reviews,3,1,4
1121680,True,0,No user reviews,0,0,0
1121700,True,0,No user reviews,0,0,0
1121710,True,5,Mixed,26,14,40
1121720,True,7,Positive,9,1,10
1121740,True,0,No user reviews,0,0,0
1121760,True,0,No user reviews,0,0,0
1121770,True,0,2 user reviews,1,1,2
1121790,True,0,No user reviews,0,0,0
1121800,True,0,No user reviews,0,0,0
1121810,True,0,7 user reviews,6,1,7
1121820,True,0,No user reviews,0,0,0
1121830,True,0,No user reviews,0,0,0
1121840,True,0,No user reviews,0,0,0
1121860,True,0,No user reviews,0,0,0
1121870,True,0,No user reviews,0,0,0
1121900,True,0,No user reviews,0,0,0
1121910,True,0,No user reviews,0,0,0
1121930,True,0,No user reviews,0,0,0
1121940,True,0,No user reviews,0,0,0
1121960,True,0,2 user reviews,1,1,2
1121970,True,0,No user reviews,0,0,0
1121980,True,0,No user reviews,0,0,0
1122040,True,7,Positive,36,9,45
1122050,True,8,Very Positive,226,24,250
1122060,True,0,No user reviews,0,0,0
1122080,True,0,7 user reviews,7,0,7
1122090,True,0,No user reviews,0,0,0
1122100,True,7,Positive,36,2,38
1122110,True,0,5 user reviews,0,5,5
1122120,True,8,Very Positive,119,16,135
1122140,True,0,No user reviews,0,0,0
1122150,True,5,Mixed,8,9,17
1122160,True,0,No user reviews,0,0,0
1122170,True,0,No user reviews,0,0,0
1122180,True,6,Mostly Positive,21,6,27
1122200,True,0,1 user reviews,1,0,1
1122201,True,0,No user reviews,0,0,0
1122202,True,0,No user reviews,0,0,0
1122203,True,0,No user reviews,0,0,0
1122204,True,0,1 user reviews,1,0,1
1122210,True,0,1 user reviews,0,1,1
1122230,True,0,No user reviews,0,0,0
1122240,True,7,Positive,22,5,27
1122250,True,0,2 user reviews,1,1,2
1122260,True,0,3 user reviews,1,2,3
1122270,True,4,Mostly Negative,3,9,12
1122280,True,0,No user reviews,0,0,0
1122290,True,0,No user reviews,0,0,0
1122300,True,0,No user reviews,0,0,0
1122310,True,0,1 user reviews,1,0,1
1122330,True,0,No user reviews,0,0,0
1122360,True,0,No user reviews,0,0,0
1122370,True,0,No user reviews,0,0,0
1122380,True,0,No user reviews,0,0,0
1122400,True,7,Positive,10,1,11
1122440,True,0,1 user reviews,1,0,1
1122450,True,0,No user reviews,0,0,0
1122460,True,0,1 user reviews,0,1,1
1122490,True,0,7 user reviews,6,1,7
1122510,True,0,4 user reviews,3,1,4
1122530,True,0,No user reviews,0,0,0
1122540,True,0,2 user reviews,2,0,2
1122551,True,0,No user reviews,0,0,0
1122552,True,0,No user reviews,0,0,0
1122553,True,0,No user reviews,0,0,0
1122554,True,0,No user reviews,0,0,0
1122555,True,0,No user reviews,0,0,0
1122556,True,0,No user reviews,0,0,0
1122557,True,0,No user reviews,0,0,0
1122558,True,0,No user reviews,0,0,0
1122559,True,0,No user reviews,0,0,0
1122560,True,0,No user reviews,0,0,0
1122561,True,0,No user reviews,0,0,0
1122562,True,0,No user reviews,0,0,0
1122563,True,0,No user reviews,0,0,0
1122564,True,0,No user reviews,0,0,0
1122565,True,0,1 user reviews,0,1,1
1122566,True,0,No user reviews,0,0,0
1122567,True,0,No user reviews,0,0,0
1122568,True,0,No user reviews,0,0,0
1122569,True,0,No user reviews,0,0,0
1122570,True,0,No user reviews,0,0,0
1122571,True,0,No user reviews,0,0,0
1122572,True,0,No user reviews,0,0,0
1122573,True,0,No user reviews,0,0,0
1122574,True,0,No user reviews,0,0,0
1122575,True,0,No user reviews,0,0,0
1122576,True,0,No user reviews,0,0,0
1122577,True,0,No user reviews,0,0,0
1122578,True,0,No user reviews,0,0,0
1122579,True,0,No user reviews,0,0,0
1122585,True,0,No user reviews,0,0,0
1122586,True,0,No user reviews,0,0,0
1122587,True,0,No user reviews,0,0,0
1122588,True,0,No user reviews,0,0,0
1122593,True,0,No user reviews,0,0,0
1122594,True,0,No user reviews,0,0,0
1122595,True,0,No user reviews,0,0,0
1122596,True,0,No user reviews,0,0,0
1122597,True,0,No user reviews,0,0,0
1122598,True,0,No user reviews,0,0,0
1122599,True,0,No user reviews,0,0,0
1122600,True,0,No user reviews,0,0,0
1122601,True,0,No user reviews,0,0,0
1122602,True,0,No user reviews,0,0,0
1122603,True,0,No user reviews,0,0,0
1122604,True,0,No user reviews,0,0,0
1122605,True,0,No user reviews,0,0,0
1122606,True,0,No user reviews,0,0,0
1122607,True,0,No user reviews,0,0,0
1122608,True,0,No user reviews,0,0,0
1122609,True,0,No user reviews,0,0,0
1122610,True,0,No user reviews,0,0,0
1122611,True,0,1 user reviews,0,1,1
1122612,True,0,No user reviews,0,0,0
1122614,True,0,No user reviews,0,0,0
1122615,True,0,No user reviews,0,0,0
1122616,True,0,No user reviews,0,0,0
1122617,True,0,No user reviews,0,0,0
1122618,True,0,No user reviews,0,0,0
1122619,True,0,No user reviews,0,0,0
1122620,True,0,No user reviews,0,0,0
1122621,True,0,No user reviews,0,0,0
1122622,True,0,No user reviews,0,0,0
1122623,True,0,No user reviews,0,0,0
1122624,True,0,No user reviews,0,0,0
1122625,True,0,No user reviews,0,0,0
1122626,True,0,No user reviews,0,0,0
1122627,True,0,No user reviews,0,0,0
1122628,True,0,No user reviews,0,0,0
1122629,True,0,1 user reviews,1,0,1
1122630,True,0,No user reviews,0,0,0
1122631,True,0,No user reviews,0,0,0
1122632,True,0,No user reviews,0,0,0
1122633,True,0,1 user reviews,1,0,1
1122634,True,0,No user reviews,0,0,0
1122635,True,0,No user reviews,0,0,0
1122636,True,0,No user reviews,0,0,0
1122637,True,0,No user reviews,0,0,0
1122638,True,0,No user reviews,0,0,0
1122639,True,0,No user reviews,0,0,0
1122640,True,0,No user reviews,0,0,0
1122641,True,0,No user reviews,0,0,0
1122642,True,0,No user reviews,0,0,0
1122643,True,0,No user reviews,0,0,0
1122644,True,0,No user reviews,0,0,0
1122645,True,0,No user reviews,0,0,0
1122646,True,0,No user reviews,0,0,0
1122647,True,0,No user reviews,0,0,0
1122648,True,0,No user reviews,0,0,0
1122649,True,0,No user reviews,0,0,0
1122650,True,0,No user reviews,0,0,0
1122651,True,0,No user reviews,0,0,0
1122652,True,0,No user reviews,0,0,0
1122653,True,0,No user reviews,0,0,0
1122654,True,0,1 user reviews,1,0,1
1122655,True,0,No user reviews,0,0,0
1122656,True,0,No user reviews,0,0,0
1122657,True,0,No user reviews,0,0,0
1122658,True,0,No user reviews,0,0,0
1122659,True,0,No user reviews,0,0,0
1122660,True,0,1 user reviews,1,0,1
1122661,True,0,1 user reviews,1,0,1
1122662,True,0,1 user reviews,1,0,1
1122663,True,0,No user reviews,0,0,0
1122664,True,0,1 user reviews,1,0,1
1122680,True,0,No user reviews,0,0,0
1122690,True,0,No user reviews,0,0,0
1122710,True,0,2 user reviews,0,2,2
1122720,True,9,Overwhelmingly Positive,1351,47,1398
1122740,True,0,2 user reviews,2,0,2
1122750,True,0,No user reviews,0,0,0
1122760,True,0,No user reviews,0,0,0
1122770,True,0,No user reviews,0,0,0
1122780,True,0,9 user reviews,7,2,9
1122810,True,0,2 user reviews,2,0,2
1122820,True,0,No user reviews,0,0,0
1122830,True,0,5 user reviews,5,0,5
1122850,True,0,No user reviews,0,0,0
1122860,True,0,5 user reviews,2,3,5
1122870,True,0,No user reviews,0,0,0
1122880,True,0,No user reviews,0,0,0
1122890,True,0,No user reviews,0,0,0
1122900,True,0,No user reviews,0,0,0
1122920,True,0,3 user reviews,2,1,3
1122930,True,0,No user reviews,0,0,0
1122960,True,0,No user reviews,0,0,0
1122970,True,0,No user reviews,0,0,0
1122980,True,0,3 user reviews,1,2,3
1123000,True,0,3 user reviews,2,1,3
1123020,True,0,No user reviews,0,0,0
1123030,True,0,8 user reviews,8,0,8
1123050,True,0,No user reviews,0,0,0
1123060,True,0,3 user reviews,2,1,3
1123070,True,0,1 user reviews,1,0,1
1123080,True,0,1 user reviews,1,0,1
1123090,True,0,No user reviews,0,0,0
1123100,True,0,No user reviews,0,0,0
1123120,True,0,No user reviews,0,0,0
1123140,True,5,Mixed,21,11,32
1123150,True,0,No user reviews,0,0,0
1123170,True,0,No user reviews,0,0,0
1123180,True,0,No user reviews,0,0,0
1123190,True,0,1 user reviews,1,0,1
1123200,True,0,No user reviews,0,0,0
1123210,True,0,No user reviews,0,0,0
1123230,True,7,Positive,16,1,17
1123270,True,0,7 user reviews,6,1,7
1123300,True,0,No user reviews,0,0,0
1123310,True,0,2 user reviews,2,0,2
1123340,True,0,2 user reviews,2,0,2
1123360,True,0,No user reviews,0,0,0
1123390,True,0,No user reviews,0,0,0
1123400,True,0,3 user reviews,3,0,3
1123410,True,0,1 user reviews,0,1,1
1123420,True,0,No user reviews,0,0,0
1123430,True,0,No user reviews,0,0,0
1123431,True,0,No user reviews,0,0,0
1123432,True,0,No user reviews,0,0,0
1123433,True,0,No user reviews,0,0,0
1123434,True,0,No user reviews,0,0,0
1123440,True,0,No user reviews,0,0,0
1123441,True,0,1 user reviews,1,0,1
1123450,True,0,No user reviews,0,0,0
1123460,True,0,No user reviews,0,0,0
1123470,True,0,No user reviews,0,0,0
1123471,True,0,No user reviews,0,0,0
1123472,True,0,No user reviews,0,0,0
1123480,True,0,No user reviews,0,0,0
1123481,True,0,No user reviews,0,0,0
1123482,True,0,No user reviews,0,0,0
1123500,True,0,3 user reviews,1,2,3
1123510,True,0,No user reviews,0,0,0
1123520,True,0,No user reviews,0,0,0
1123540,True,0,5 user reviews,3,2,5
1123550,True,0,4 user reviews,2,2,4
1123570,True,0,No user reviews,0,0,0
1123580,True,0,No user reviews,0,0,0
1123590,True,0,No user reviews,0,0,0
1123610,True,0,4 user reviews,0,4,4
1123620,True,0,2 user reviews,2,0,2
1123630,True,0,No user reviews,0,0,0
1123631,True,0,No user reviews,0,0,0
1123632,True,0,No user reviews,0,0,0
1123633,True,0,No user reviews,0,0,0
1123634,True,0,No user reviews,0,0,0
1123640,True,0,No user reviews,0,0,0
1123650,True,0,4 user reviews,2,2,4
1123670,True,0,No user reviews,0,0,0
1123690,True,0,No user reviews,0,0,0
1123700,True,0,No user reviews,0,0,0
1123720,True,0,No user reviews,0,0,0
1123730,True,0,No user reviews,0,0,0
1123760,True,0,No user reviews,0,0,0
1123770,True,8,Very Positive,734,77,811
1123790,True,6,Mostly Positive,9,3,12
1123800,True,0,No user reviews,0,0,0
1123801,True,0,No user reviews,0,0,0
1123802,True,0,No user reviews,0,0,0
1123803,True,0,No user reviews,0,0,0
1123804,True,0,No user reviews,0,0,0
1123805,True,0,No user reviews,0,0,0
1123810,True,0,No user reviews,0,0,0
1123830,True,0,No user reviews,0,0,0
1123840,True,0,No user reviews,0,0,0
1123850,True,0,No user reviews,0,0,0
1123860,True,0,No user reviews,0,0,0
1123870,True,0,3 user reviews,1,2,3
1123880,True,0,No user reviews,0,0,0
1123890,True,0,1 user reviews,1,0,1
1123900,True,0,1 user reviews,1,0,1
1123910,True,0,1 user reviews,0,1,1
1123920,True,0,No user reviews,0,0,0
1123930,True,0,No user reviews,0,0,0
1123950,True,0,3 user reviews,2,1,3
1123960,True,0,No user reviews,0,0,0
1123980,True,0,No user reviews,0,0,0
1124000,True,0,No user reviews,0,0,0
1124010,True,0,No user reviews,0,0,0
1124030,True,0,2 user reviews,2,0,2
1124040,True,0,No user reviews,0,0,0
1124050,True,5,Mixed,10,7,17
1124060,True,7,Positive,20,1,21
1124070,True,0,No user reviews,0,0,0
1124090,True,0,No user reviews,0,0,0
1124100,True,0,No user reviews,0,0,0
1124110,True,0,No user reviews,0,0,0
1124113,True,0,No user reviews,0,0,0
1124114,True,0,1 user reviews,1,0,1
1124115,True,0,No user reviews,0,0,0
1124116,True,0,No user reviews,0,0,0
1124120,True,0,No user reviews,0,0,0
1124130,True,0,No user reviews,0,0,0
1124140,True,0,3 user reviews,3,0,3
1124151,True,0,No user reviews,0,0,0
1124152,True,0,No user reviews,0,0,0
1124153,True,0,2 user reviews,2,0,2
1124154,True,0,1 user reviews,0,1,1
1124155,True,0,1 user reviews,0,1,1
1124156,True,0,No user reviews,0,0,0
1124157,True,0,No user reviews,0,0,0
1124158,True,0,No user reviews,0,0,0
1124160,True,0,No user reviews,0,0,0
1124170,True,0,No user reviews,0,0,0
1124190,True,0,4 user reviews,3,1,4
1124200,True,0,No user reviews,0,0,0
1124210,True,0,1 user reviews,1,0,1
1124260,True,0,No user reviews,0,0,0
1124270,True,0,1 user reviews,0,1,1
1124280,True,0,No user reviews,0,0,0
1124300,True,0,No user reviews,0,0,0
1124310,True,0,1 user reviews,1,0,1
1124320,True,0,No user reviews,0,0,0
1124340,True,0,No user reviews,0,0,0
1124370,True,0,No user reviews,0,0,0
1124380,True,0,1 user reviews,1,0,1
1124390,True,0,4 user reviews,3,1,4
1124400,True,0,3 user reviews,1,2,3
1124410,True,0,2 user reviews,2,0,2
1124430,True,0,6 user reviews,5,1,6
1124440,True,0,No user reviews,0,0,0
1124441,True,0,No user reviews,0,0,0
1124460,True,0,No user reviews,0,0,0
1124470,True,0,No user reviews,0,0,0
1124480,True,0,No user reviews,0,0,0
1124510,True,0,1 user reviews,0,1,1
1124520,True,0,No user reviews,0,0,0
1124530,True,5,Mixed,7,10,17
1124540,True,0,7 user reviews,6,1,7
1124541,True,0,8 user reviews,8,0,8
1124550,True,0,1 user reviews,1,0,1
1124560,True,7,Positive,8,2,10
1124590,True,0,No user reviews,0,0,0
1124600,True,0,No user reviews,0,0,0
1124630,True,0,1 user reviews,1,0,1
1124640,True,0,No user reviews,0,0,0
1124660,True,8,Very Positive,182,24,206
1124680,True,0,No user reviews,0,0,0
1124690,True,0,No user reviews,0,0,0
1124700,True,0,No user reviews,0,0,0
1124701,True,0,No user reviews,0,0,0
1124702,True,0,No user reviews,0,0,0
1124710,True,0,5 user reviews,4,1,5
1124740,True,0,No user reviews,0,0,0
1124750,True,0,No user reviews,0,0,0
1124760,True,0,No user reviews,0,0,0
1124780,True,0,No user reviews,0,0,0
1124790,True,0,1 user reviews,0,1,1
1124800,True,0,No user reviews,0,0,0
1124810,True,0,No user reviews,0,0,0
1124820,True,0,No user reviews,0,0,0
1124830,True,7,Positive,11,0,11
1124850,True,0,No user reviews,0,0,0
1124860,True,0,1 user reviews,1,0,1
1124910,True,0,4 user reviews,4,0,4
1124930,True,0,No user reviews,0,0,0
1124940,True,0,No user reviews,0,0,0
1124950,True,0,1 user reviews,1,0,1
1124960,True,0,1 user reviews,1,0,1
1124970,True,0,No user reviews,0,0,0
1124980,True,0,2 user reviews,2,0,2
1124990,True,0,9 user reviews,9,0,9
1125000,True,0,1 user reviews,1,0,1
1125020,True,5,Mixed,58,54,112
1125030,True,0,4 user reviews,0,4,4
1125050,True,0,1 user reviews,0,1,1
1125060,True,0,2 user reviews,2,0,2
1125090,True,7,Positive,12,0,12
1125100,True,0,4 user reviews,3,1,4
1125110,True,7,Positive,37,5,42
1125130,True,0,2 user reviews,1,1,2
1125210,True,7,Positive,17,2,19
1125220,True,0,No user reviews,0,0,0
1125240,True,0,No user reviews,0,0,0
1125250,True,0,8 user reviews,6,2,8
1125260,True,7,Positive,11,1,12
1125270,True,7,Positive,16,2,18
1125290,True,0,No user reviews,0,0,0
1125300,True,0,No user reviews,0,0,0
1125310,True,0,No user reviews,0,0,0
1125320,True,0,No user reviews,0,0,0
1125330,True,8,Very Positive,84,16,100
1125340,True,0,2 user reviews,2,0,2
1125350,True,0,3 user reviews,3,0,3
1125360,True,0,6 user reviews,6,0,6
1125370,True,0,4 user reviews,4,0,4
1125390,True,0,No user reviews,0,0,0
1125400,True,0,6 user reviews,6,0,6
1125420,True,0,6 user reviews,6,0,6
1125430,True,0,No user reviews,0,0,0
1125440,True,0,No user reviews,0,0,0
1125450,True,0,1 user reviews,1,0,1
1125480,True,0,1 user reviews,0,1,1
1125490,True,0,6 user reviews,4,2,6
1125510,True,0,No user reviews,0,0,0
1125550,True,0,No user reviews,0,0,0
1125590,True,0,No user reviews,0,0,0
1125600,True,0,1 user reviews,0,1,1
1125610,True,0,No user reviews,0,0,0
1125620,True,0,No user reviews,0,0,0
1125630,True,5,Mixed,30,19,49
1125640,True,0,No user reviews,0,0,0
1125641,True,0,No user reviews,0,0,0
1125642,True,0,1 user reviews,0,1,1
1125660,True,0,No user reviews,0,0,0
1125670,True,0,No user reviews,0,0,0
1125680,True,0,No user reviews,0,0,0
1125690,True,0,No user reviews,0,0,0
1125700,True,0,No user reviews,0,0,0
1125710,True,0,No user reviews,0,0,0
1125730,True,0,No user reviews,0,0,0
1125760,True,7,Positive,9,1,10
1125770,True,0,1 user reviews,0,1,1
1125780,True,0,No user reviews,0,0,0
1125790,True,0,2 user reviews,2,0,2
1125791,True,0,No user reviews,0,0,0
1125800,True,0,4 user reviews,4,0,4
1125810,True,0,No user reviews,0,0,0
1125820,True,0,2 user reviews,2,0,2
1125830,True,0,No user reviews,0,0,0
1125860,True,7,Positive,19,0,19
1125870,True,0,No user reviews,0,0,0
1125880,True,0,No user reviews,0,0,0
1125890,True,0,No user reviews,0,0,0
1125900,True,0,3 user reviews,2,1,3
1125910,True,0,No user reviews,0,0,0
1125930,True,7,Positive,10,0,10
1125980,True,0,No user reviews,0,0,0
1126020,True,0,No user reviews,0,0,0
1126030,True,0,No user reviews,0,0,0
1126040,True,0,No user reviews,0,0,0
1126050,True,6,Mostly Positive,96,28,124
1126060,True,0,4 user reviews,4,0,4
1126070,True,0,4 user reviews,4,0,4
1126080,True,0,No user reviews,0,0,0
1126090,True,0,1 user reviews,1,0,1
1126100,True,0,1 user reviews,0,1,1
1126120,True,0,No user reviews,0,0,0
1126130,True,0,6 user reviews,5,1,6
1126140,True,0,No user reviews,0,0,0
1126190,True,5,Mixed,20,9,29
1126200,True,8,Very Positive,62,4,66
1126210,True,0,No user reviews,0,0,0
1126220,True,0,6 user reviews,3,3,6
1126230,True,0,No user reviews,0,0,0
1126240,True,0,No user reviews,0,0,0
1126260,True,0,No user reviews,0,0,0
1126270,True,7,Positive,26,1,27
1126280,True,0,No user reviews,0,0,0
1126290,True,6,Mostly Positive,148,43,191
1126300,True,0,2 user reviews,1,1,2
1126310,True,7,Positive,11,0,11
1126320,True,9,Overwhelmingly Positive,1556,34,1590
1126340,True,0,4 user reviews,3,1,4
1126350,True,0,No user reviews,0,0,0
1126380,True,0,No user reviews,0,0,0
1126400,True,0,No user reviews,0,0,0
1126410,True,0,No user reviews,0,0,0
1126420,True,8,Very Positive,68,8,76
1126430,True,0,No user reviews,0,0,0
1126440,True,0,3 user reviews,2,1,3
1126450,True,0,No user reviews,0,0,0
1126460,True,0,No user reviews,0,0,0
1126470,True,7,Positive,11,1,12
1126480,True,0,No user reviews,0,0,0
1126510,True,0,No user reviews,0,0,0
1126520,True,0,No user reviews,0,0,0
1126530,True,0,No user reviews,0,0,0
1126540,True,0,No user reviews,0,0,0
1126550,True,0,1 user reviews,1,0,1
1126560,True,0,4 user reviews,1,3,4
1126570,True,0,2 user reviews,1,1,2
1126580,True,0,No user reviews,0,0,0
1126590,True,0,No user reviews,0,0,0
1126600,True,7,Positive,20,1,21
1126610,True,0,No user reviews,0,0,0
1126620,True,0,No user reviews,0,0,0
1126630,True,0,No user reviews,0,0,0
1126640,True,0,No user reviews,0,0,0
1126670,True,0,No user reviews,0,0,0
1126680,True,0,No user reviews,0,0,0
1126700,True,0,No user reviews,0,0,0
1126710,True,0,8 user reviews,7,1,8
1126720,True,0,No user reviews,0,0,0
1126740,True,0,No user reviews,0,0,0
1126750,True,7,Positive,22,1,23
1126760,True,0,No user reviews,0,0,0
1126770,True,4,Mostly Negative,5,9,14
1126810,True,0,No user reviews,0,0,0
1126820,True,0,1 user reviews,1,0,1
1126840,True,0,3 user reviews,2,1,3
1126850,True,0,4 user reviews,4,0,4
1126860,True,0,1 user reviews,1,0,1
1126890,True,7,Positive,35,5,40
1126900,True,0,No user reviews,0,0,0
1126910,True,0,No user reviews,0,0,0
1126930,True,0,3 user reviews,3,0,3
1126940,True,0,No user reviews,0,0,0
1126950,True,0,2 user reviews,2,0,2
1126960,True,0,No user reviews,0,0,0
1126970,True,0,No user reviews,0,0,0
1126990,True,6,Mostly Positive,59,18,77
1127000,True,0,No user reviews,0,0,0
1127010,True,0,No user reviews,0,0,0
1127030,True,0,No user reviews,0,0,0
1127070,True,7,Positive,34,8,42
1127100,True,0,1 user reviews,1,0,1
1127110,True,0,No user reviews,0,0,0
1127120,True,0,1 user reviews,1,0,1
1127130,True,0,2 user reviews,2,0,2
1127140,True,0,No user reviews,0,0,0
1127160,True,0,No user reviews,0,0,0
1127170,True,0,3 user reviews,1,2,3
1127180,True,0,2 user reviews,1,1,2
1127190,True,8,Very Positive,237,36,273
1127200,True,0,1 user reviews,1,0,1
1127210,True,0,1 user reviews,1,0,1
1127230,True,0,1 user reviews,1,0,1
1127250,True,0,No user reviews,0,0,0
1127270,True,0,1 user reviews,1,0,1
1127290,True,0,6 user reviews,3,3,6
1127300,True,0,No user reviews,0,0,0
1127310,True,5,Mixed,24,13,37
1127330,True,0,No user reviews,0,0,0
1127340,True,0,No user reviews,0,0,0
1127350,True,0,2 user reviews,1,1,2
1127360,True,0,No user reviews,0,0,0
1127390,True,7,Positive,8,2,10
1127400,True,9,Overwhelmingly Positive,2904,73,2977
1127410,True,0,1 user reviews,1,0,1
1127411,True,0,1 user reviews,1,0,1
1127412,True,0,1 user reviews,1,0,1
1127420,True,0,1 user reviews,0,1,1
1127430,True,0,No user reviews,0,0,0
1127450,True,7,Positive,35,3,38
1127460,True,5,Mixed,300,297,597
1127470,True,0,No user reviews,0,0,0
1127480,True,0,1 user reviews,1,0,1
1127490,True,0,No user reviews,0,0,0
1127500,True,0,No user reviews,0,0,0
1127510,True,0,No user reviews,0,0,0
1127520,True,0,1 user reviews,1,0,1
1127530,True,0,1 user reviews,1,0,1
1127540,True,0,8 user reviews,7,1,8
1127560,True,0,No user reviews,0,0,0
1127580,True,0,1 user reviews,1,0,1
1127590,True,0,No user reviews,0,0,0
1127600,True,0,3 user reviews,2,1,3
1127610,True,8,Very Positive,74,7,81
1127620,True,0,No user reviews,0,0,0
1127640,True,0,No user reviews,0,0,0
1127670,True,0,No user reviews,0,0,0
1127680,True,7,Positive,25,0,25
1127690,True,0,1 user reviews,0,1,1
1127700,True,0,No user reviews,0,0,0
1127730,True,0,3 user reviews,2,1,3
1127750,True,0,No user reviews,0,0,0
1127760,True,0,No user reviews,0,0,0
1127770,True,0,No user reviews,0,0,0
1127780,True,0,No user reviews,0,0,0
1127800,True,0,1 user reviews,1,0,1
1127820,True,0,3 user reviews,2,1,3
1127840,True,8,Very Positive,277,34,311
1127850,True,8,Very Positive,63,0,63
1127860,True,0,5 user reviews,4,1,5
1127870,True,0,3 user reviews,2,1,3
1127880,True,0,2 user reviews,2,0,2
1127900,True,0,9 user reviews,7,2,9
1127910,True,0,No user reviews,0,0,0
1127920,True,0,1 user reviews,0,1,1
1127930,True,0,8 user reviews,5,3,8
1127940,True,0,No user reviews,0,0,0
1127950,True,0,No user reviews,0,0,0
1127970,True,0,No user reviews,0,0,0
1127980,True,8,Very Positive,513,106,619
1128000,True,5,Mixed,1652,2273,3925
1128010,True,0,No user reviews,0,0,0
1128020,True,7,Positive,21,1,22
1128030,True,0,No user reviews,0,0,0
1128040,True,0,No user reviews,0,0,0
1128050,True,0,No user reviews,0,0,0
1128060,True,0,No user reviews,0,0,0
1128070,True,0,1 user reviews,1,0,1
1128080,True,0,2 user reviews,1,1,2
1128090,True,0,No user reviews,0,0,0
1128100,True,7,Positive,20,5,25
1128120,True,0,No user reviews,0,0,0
1128130,True,0,No user reviews,0,0,0
1128140,True,5,Mixed,18,8,26
1128150,True,0,1 user reviews,0,1,1
1128160,True,0,1 user reviews,0,1,1
1128170,True,0,4 user reviews,3,1,4
1128180,True,7,Positive,41,5,46
1128190,True,7,Positive,26,6,32
1128200,True,0,1 user reviews,1,0,1
1128210,True,0,7 user reviews,6,1,7
1128220,True,0,9 user reviews,7,2,9
1128230,True,0,No user reviews,0,0,0
1128250,True,0,No user reviews,0,0,0
1128260,True,7,Positive,12,1,13
1128270,True,0,4 user reviews,3,1,4
1128280,True,0,No user reviews,0,0,0
1128290,True,0,No user reviews,0,0,0
1128310,True,0,1 user reviews,0,1,1
1128330,True,0,No user reviews,0,0,0
1128350,True,0,1 user reviews,0,1,1
1128360,True,0,No user reviews,0,0,0
1128370,True,0,1 user reviews,1,0,1
1128380,True,0,No user reviews,0,0,0
1128400,True,0,1 user reviews,1,0,1
1128420,True,0,2 user reviews,2,0,2
1128430,True,0,1 user reviews,1,0,1
1128440,True,0,3 user reviews,3,0,3
1128450,True,0,2 user reviews,2,0,2
1128460,True,0,No user reviews,0,0,0
1128480,True,0,No user reviews,0,0,0
1128500,True,0,No user reviews,0,0,0
1128510,True,0,1 user reviews,1,0,1
1128520,True,0,6 user reviews,6,0,6
1128530,True,0,No user reviews,0,0,0
1128540,True,4,Mostly Negative,26,56,82
1128550,True,0,2 user reviews,1,1,2
1128560,True,0,No user reviews,0,0,0
1128570,True,0,6 user reviews,6,0,6
1128580,True,0,No user reviews,0,0,0
1128610,True,0,6 user reviews,6,0,6
1128630,True,0,1 user reviews,1,0,1
1128640,True,0,No user reviews,0,0,0
1128650,True,0,No user reviews,0,0,0
1128660,True,0,1 user reviews,0,1,1
1128670,True,0,No user reviews,0,0,0
1128680,True,0,No user reviews,0,0,0
1128690,True,7,Positive,44,2,46
1128740,True,0,No user reviews,0,0,0
1128750,True,0,No user reviews,0,0,0
1128760,True,0,No user reviews,0,0,0
1128770,True,0,2 user reviews,2,0,2
1128790,True,0,No user reviews,0,0,0
1128800,True,5,Mixed,11,14,25
1128810,True,7,Positive,18,0,18
1128820,True,0,No user reviews,0,0,0
1128830,True,0,2 user reviews,2,0,2
1128840,True,0,3 user reviews,2,1,3
1128850,True,0,No user reviews,0,0,0
1128880,True,7,Positive,9,1,10
1128890,True,0,No user reviews,0,0,0
1128900,True,5,Mixed,28,16,44
1128910,True,0,No user reviews,0,0,0
1128920,True,0,No user reviews,0,0,0
1128930,True,0,No user reviews,0,0,0
1128940,True,0,No user reviews,0,0,0
1128950,True,0,No user reviews,0,0,0
1128970,True,0,No user reviews,0,0,0
1129000,True,0,No user reviews,0,0,0
1129010,True,8,Very Positive,98,17,115
1129030,True,0,9 user reviews,7,2,9
1129040,True,0,4 user reviews,4,0,4
1129050,True,7,Positive,28,4,32
1129060,True,0,No user reviews,0,0,0
1129070,True,0,No user reviews,0,0,0
1129080,True,0,2 user reviews,1,1,2
1129090,True,7,Positive,17,2,19
1129100,True,0,No user reviews,0,0,0
1129110,True,0,No user reviews,0,0,0
1129120,True,0,No user reviews,0,0,0
1129180,True,0,2 user reviews,2,0,2
1129190,True,0,No user reviews,0,0,0
1129200,True,0,1 user reviews,0,1,1
1129210,True,0,No user reviews,0,0,0
1129220,True,8,Very Positive,214,22,236
1129230,True,0,No user reviews,0,0,0
1129240,True,0,2 user reviews,2,0,2
1129250,True,7,Positive,17,0,17
1129300,True,0,No user reviews,0,0,0
1129310,True,8,Very Positive,923,113,1036
1129330,True,0,6 user reviews,6,0,6
1129340,True,0,No user reviews,0,0,0
1129350,True,0,6 user reviews,6,0,6
1129360,True,0,No user reviews,0,0,0
1129370,True,0,No user reviews,0,0,0
1129410,True,0,No user reviews,0,0,0
1129430,True,0,No user reviews,0,0,0
1129470,True,0,1 user reviews,1,0,1
1129480,True,0,No user reviews,0,0,0
1129500,True,0,No user reviews,0,0,0
1129520,True,0,No user reviews,0,0,0
1129530,True,0,No user reviews,0,0,0
1129540,True,0,No user reviews,0,0,0
1129550,True,0,No user reviews,0,0,0
1129580,True,8,Very Positive,3316,308,3624
1129610,True,0,No user reviews,0,0,0
1129650,True,0,No user reviews,0,0,0
1129660,True,6,Mostly Positive,21,6,27
1129670,True,0,No user reviews,0,0,0
1129680,True,0,5 user reviews,4,1,5
1129690,True,0,5 user reviews,5,0,5
1129700,True,0,No user reviews,0,0,0
1129710,True,0,No user reviews,0,0,0
1129720,True,0,2 user reviews,2,0,2
1129730,True,7,Positive,8,2,10
1129810,True,0,No user reviews,0,0,0
1129920,True,8,Very Positive,114,1,115
1130220,True,0,No user reviews,0,0,0
1130390,True,0,No user reviews,0,0,0
1130400,True,0,7 user reviews,5,2,7
1130410,True,8,Very Positive,107,2,109
1130430,True,0,2 user reviews,2,0,2
1130440,True,0,No user reviews,0,0,0
1130510,True,0,6 user reviews,5,1,6
1130560,True,6,Mostly Positive,32,9,41
1130570,True,0,6 user reviews,6,0,6
1130590,True,0,5 user reviews,3,2,5
1130600,True,0,No user reviews,0,0,0
1130620,True,8,Very Positive,84,11,95
1130630,True,7,Positive,20,1,21
1130660,True,0,No user reviews,0,0,0
1130680,True,0,No user reviews,0,0,0
1130690,True,0,1 user reviews,1,0,1
1130700,True,0,No user reviews,0,0,0
1130710,True,0,4 user reviews,3,1,4
1130720,True,0,5 user reviews,3,2,5
1130750,True,0,1 user reviews,1,0,1
1130760,True,0,No user reviews,0,0,0
1130770,True,0,4 user reviews,3,1,4
1130780,True,0,1 user reviews,1,0,1
1130790,True,0,1 user reviews,0,1,1
1130800,True,0,2 user reviews,1,1,2
1130810,True,0,2 user reviews,1,1,2
1130820,True,0,No user reviews,0,0,0
1130840,True,0,6 user reviews,5,1,6
1130850,True,0,No user reviews,0,0,0
1130870,True,0,No user reviews,0,0,0
1130871,True,0,No user reviews,0,0,0
1130872,True,0,No user reviews,0,0,0
1130880,True,0,5 user reviews,5,0,5
1130900,True,0,No user reviews,0,0,0
1130960,True,0,No user reviews,0,0,0
1130970,True,0,No user reviews,0,0,0
1130990,True,0,5 user reviews,5,0,5
1131000,True,0,No user reviews,0,0,0
1131010,True,0,No user reviews,0,0,0
1131020,True,0,No user reviews,0,0,0
1131050,True,0,8 user reviews,6,2,8
1131090,True,0,No user reviews,0,0,0
1131110,True,0,2 user reviews,2,0,2
1131130,True,0,No user reviews,0,0,0
1131140,True,0,No user reviews,0,0,0
1131150,True,0,No user reviews,0,0,0
1131160,True,0,1 user reviews,0,1,1
1131170,True,7,Positive,29,6,35
1131210,True,0,No user reviews,0,0,0
1131230,True,0,No user reviews,0,0,0
1131240,True,6,Mostly Positive,68,18,86
1131270,True,0,4 user reviews,3,1,4
1131280,True,0,1 user reviews,0,1,1
1131290,True,0,No user reviews,0,0,0
1131320,True,0,No user reviews,0,0,0
1131330,True,0,8 user reviews,6,2,8
1131340,True,0,No user reviews,0,0,0
1131350,True,0,No user reviews,0,0,0
1131360,True,0,No user reviews,0,0,0
1131370,True,0,No user reviews,0,0,0
1131390,True,0,No user reviews,0,0,0
1131400,True,5,Mixed,34,15,49
1131410,True,7,Positive,19,0,19
1131420,True,0,5 user reviews,0,5,5
1131430,True,0,1 user reviews,1,0,1
1131440,True,0,No user reviews,0,0,0
1131450,True,5,Mixed,7,4,11
1131460,True,0,No user reviews,0,0,0
1131470,True,0,No user reviews,0,0,0
1131480,True,0,No user reviews,0,0,0
1131490,True,0,No user reviews,0,0,0
1131500,True,0,No user reviews,0,0,0
1131520,True,0,3 user reviews,3,0,3
1131530,True,7,Positive,11,0,11
1131540,True,0,4 user reviews,4,0,4
1131570,True,0,No user reviews,0,0,0
1131580,True,0,1 user reviews,1,0,1
1131590,True,0,No user reviews,0,0,0
1131640,True,0,1 user reviews,1,0,1
1131650,True,0,No user reviews,0,0,0
1131660,True,0,1 user reviews,1,0,1
1131670,True,0,No user reviews,0,0,0
1131680,True,0,3 user reviews,2,1,3
1131690,True,0,No user reviews,0,0,0
1131720,True,0,4 user reviews,3,1,4
1131740,True,0,2 user reviews,2,0,2
1131750,True,7,Positive,27,1,28
1131780,True,0,1 user reviews,1,0,1
1131790,True,0,1 user reviews,1,0,1
1131800,True,0,No user reviews,0,0,0
1131810,True,0,4 user reviews,2,2,4
1131820,True,0,No user reviews,0,0,0
1131830,True,0,No user reviews,0,0,0
1131840,True,0,No user reviews,0,0,0
1131850,True,0,No user reviews,0,0,0
1131860,True,0,No user reviews,0,0,0
1131870,True,0,No user reviews,0,0,0
1131880,True,0,No user reviews,0,0,0
1131900,True,7,Positive,24,3,27
1131910,True,0,1 user reviews,1,0,1
1131930,True,0,5 user reviews,5,0,5
1131940,True,0,1 user reviews,1,0,1
1131960,True,0,No user reviews,0,0,0
1131980,True,0,No user reviews,0,0,0
1131990,True,0,4 user reviews,1,3,4
1132010,True,0,3 user reviews,1,2,3
1132020,True,0,No user reviews,0,0,0
1132030,True,0,No user reviews,0,0,0
1132050,True,0,No user reviews,0,0,0
1132060,True,0,1 user reviews,1,0,1
1132070,True,7,Positive,11,1,12
1132080,True,0,7 user reviews,4,3,7
1132090,True,0,5 user reviews,4,1,5
1132100,True,7,Positive,29,6,35
1132110,True,0,7 user reviews,6,1,7
1132120,True,7,Positive,22,3,25
1132130,True,0,No user reviews,0,0,0
1132150,True,0,No user reviews,0,0,0
1132160,True,0,6 user reviews,6,0,6
1132180,True,0,No user reviews,0,0,0
1132190,True,0,2 user reviews,2,0,2
1132210,True,6,Mostly Positive,632,255,887
1132220,True,0,6 user reviews,6,0,6
1132230,True,0,2 user reviews,1,1,2
1132240,True,0,3 user reviews,2,1,3
1132290,True,0,3 user reviews,2,1,3
1132300,True,0,1 user reviews,0,1,1
1132310,True,0,No user reviews,0,0,0
1132330,True,0,No user reviews,0,0,0
1132350,True,0,No user reviews,0,0,0
1132390,True,0,No user reviews,0,0,0
1132410,True,4,Mostly Negative,4,8,12
1132450,True,0,No user reviews,0,0,0
1132460,True,0,3 user reviews,2,1,3
1132480,True,0,No user reviews,0,0,0
1132490,True,0,No user reviews,0,0,0
1132510,True,0,2 user reviews,2,0,2
1132530,True,0,No user reviews,0,0,0
1132540,True,0,3 user reviews,2,1,3
1132550,True,0,No user reviews,0,0,0
1132600,True,0,4 user reviews,2,2,4
1132620,True,0,3 user reviews,3,0,3
1132630,True,0,No user reviews,0,0,0
1132640,True,0,1 user reviews,1,0,1
1132650,True,0,No user reviews,0,0,0
1132670,True,0,No user reviews,0,0,0
1132690,True,0,No user reviews,0,0,0
1132700,True,0,3 user reviews,3,0,3
1132710,True,7,Positive,19,3,22
1132730,True,0,8 user reviews,7,1,8
1132750,True,0,5 user reviews,2,3,5
1132760,True,0,No user reviews,0,0,0
1132780,True,0,No user reviews,0,0,0
1132790,True,0,No user reviews,0,0,0
1132830,True,0,No user reviews,0,0,0
1132840,True,0,1 user reviews,0,1,1
1132850,True,0,1 user reviews,1,0,1
1132860,True,0,No user reviews,0,0,0
1132870,True,0,No user reviews,0,0,0
1132871,True,0,1 user reviews,1,0,1
1132872,True,0,No user reviews,0,0,0
1132873,True,0,1 user reviews,1,0,1
1132880,True,0,No user reviews,0,0,0
1132900,True,0,No user reviews,0,0,0
1132910,True,0,No user reviews,0,0,0
1132920,True,0,1 user reviews,0,1,1
1132930,True,0,2 user reviews,2,0,2
1132960,True,0,No user reviews,0,0,0
1132970,True,0,No user reviews,0,0,0
1132980,True,0,No user reviews,0,0,0
1132990,True,0,No user reviews,0,0,0
1133000,True,8,Very Positive,53,13,66
1133020,True,7,Positive,16,4,20
1133040,True,0,No user reviews,0,0,0
1133050,True,0,No user reviews,0,0,0
1133070,True,7,Positive,16,3,19
1133090,True,0,No user reviews,0,0,0
1133110,True,0,No user reviews,0,0,0
1133120,True,0,No user reviews,0,0,0
1133130,True,0,No user reviews,0,0,0
1133160,True,0,No user reviews,0,0,0
1133170,True,0,No user reviews,0,0,0
1133200,True,0,1 user reviews,1,0,1
1133210,True,0,7 user reviews,6,1,7
1133220,True,0,No user reviews,0,0,0
1133230,True,0,9 user reviews,4,5,9
1133250,True,0,1 user reviews,1,0,1
1133260,True,0,3 user reviews,3,0,3
1133290,True,0,No user reviews,0,0,0
1133300,True,0,No user reviews,0,0,0
1133310,True,0,3 user reviews,2,1,3
1133320,True,8,Very Positive,134,25,159
1133330,True,5,Mixed,28,16,44
1133340,True,0,No user reviews,0,0,0
1133350,True,0,4 user reviews,1,3,4
1133360,True,0,No user reviews,0,0,0
1133380,True,0,No user reviews,0,0,0
1133400,True,0,No user reviews,0,0,0
1133410,True,0,No user reviews,0,0,0
1133420,True,5,Mixed,13,8,21
1133450,True,7,Positive,8,2,10
1133470,True,0,No user reviews,0,0,0
1133490,True,0,No user reviews,0,0,0
1133510,True,0,No user reviews,0,0,0
1133520,True,0,1 user reviews,1,0,1
1133530,True,0,No user reviews,0,0,0
1133540,True,0,No user reviews,0,0,0
1133550,True,0,1 user reviews,1,0,1
1133551,True,0,1 user reviews,1,0,1
1133560,True,0,No user reviews,0,0,0
1133570,True,0,No user reviews,0,0,0
1133580,True,7,Positive,28,2,30
1133590,True,8,Very Positive,64,3,67
1133600,True,0,No user reviews,0,0,0
1133610,True,0,No user reviews,0,0,0
1133640,True,0,No user reviews,0,0,0
1133650,True,0,No user reviews,0,0,0
1133660,True,0,No user reviews,0,0,0
1133680,True,0,No user reviews,0,0,0
1133690,True,0,No user reviews,0,0,0
1133700,True,0,No user reviews,0,0,0
1133720,True,0,No user reviews,0,0,0
1133730,True,0,No user reviews,0,0,0
1133770,True,6,Mostly Positive,33,10,43
1133780,True,0,2 user reviews,2,0,2
1133790,True,7,Positive,17,1,18
1133800,True,0,No user reviews,0,0,0
1133820,True,0,No user reviews,0,0,0
1133840,True,0,No user reviews,0,0,0
1133850,True,0,No user reviews,0,0,0
1133860,True,0,No user reviews,0,0,0
1133880,True,0,No user reviews,0,0,0
1133890,True,0,2 user reviews,2,0,2
1133910,True,0,No user reviews,0,0,0
1133930,True,7,Positive,20,4,24
1133950,True,0,3 user reviews,3,0,3
1133960,True,0,No user reviews,0,0,0
1133970,True,0,2 user reviews,2,0,2
1133980,True,0,1 user reviews,1,0,1
1133990,True,7,Positive,14,1,15
1134010,True,5,Mixed,9,9,18
1134020,True,0,No user reviews,0,0,0
1134030,True,0,No user reviews,0,0,0
1134040,True,0,1 user reviews,1,0,1
1134050,True,0,2 user reviews,1,1,2
1134070,True,0,No user reviews,0,0,0
1134090,True,0,No user reviews,0,0,0
1134120,True,0,1 user reviews,1,0,1
1134130,True,0,No user reviews,0,0,0
1134140,True,0,1 user reviews,1,0,1
1134150,True,0,No user reviews,0,0,0
1134160,True,7,Positive,17,0,17
1134180,True,7,Positive,21,4,25
1134190,True,0,6 user reviews,6,0,6
1134200,True,6,Mostly Positive,10,3,13
1134250,True,0,5 user reviews,4,1,5
1134260,True,0,No user reviews,0,0,0
1134320,True,0,No user reviews,0,0,0
1134340,True,0,No user reviews,0,0,0
1134350,True,0,No user reviews,0,0,0
1134360,True,0,5 user reviews,2,3,5
1134370,True,0,1 user reviews,1,0,1
1134380,True,0,4 user reviews,4,0,4
1134381,True,0,No user reviews,0,0,0
1134382,True,0,No user reviews,0,0,0
1134383,True,0,No user reviews,0,0,0
1134384,True,0,1 user reviews,1,0,1
1134385,True,0,No user reviews,0,0,0
1134386,True,0,No user reviews,0,0,0
1134387,True,0,4 user reviews,4,0,4
1134390,True,0,1 user reviews,0,1,1
1134400,True,0,1 user reviews,1,0,1
1134401,True,0,No user reviews,0,0,0
1134402,True,0,No user reviews,0,0,0
1134403,True,0,No user reviews,0,0,0
1134404,True,0,No user reviews,0,0,0
1134405,True,0,No user reviews,0,0,0
1134406,True,0,No user reviews,0,0,0
1134407,True,0,No user reviews,0,0,0
1134408,True,0,1 user reviews,1,0,1
1134409,True,0,No user reviews,0,0,0
1134410,True,0,2 user reviews,2,0,2
1134411,True,0,No user reviews,0,0,0
1134412,True,0,No user reviews,0,0,0
1134413,True,0,No user reviews,0,0,0
1134414,True,0,No user reviews,0,0,0
1134415,True,0,No user reviews,0,0,0
1134416,True,0,No user reviews,0,0,0
1134417,True,0,No user reviews,0,0,0
1134418,True,0,No user reviews,0,0,0
1134419,True,0,1 user reviews,1,0,1
1134420,True,0,No user reviews,0,0,0
1134421,True,0,No user reviews,0,0,0
1134422,True,0,No user reviews,0,0,0
1134423,True,0,No user reviews,0,0,0
1134430,True,0,No user reviews,0,0,0
1134431,True,0,No user reviews,0,0,0
1134432,True,0,2 user reviews,2,0,2
1134440,True,0,No user reviews,0,0,0
1134450,True,0,No user reviews,0,0,0
1134460,True,0,No user reviews,0,0,0
1134470,True,0,2 user reviews,2,0,2
1134480,True,5,Mixed,23,15,38
1134490,True,0,No user reviews,0,0,0
1134500,True,0,1 user reviews,0,1,1
1134510,True,0,No user reviews,0,0,0
1134520,True,7,Positive,34,7,41
1134530,True,0,No user reviews,0,0,0
1134550,True,0,No user reviews,0,0,0
1134560,True,0,No user reviews,0,0,0
1134561,True,0,No user reviews,0,0,0
1134562,True,0,No user reviews,0,0,0
1134590,True,0,No user reviews,0,0,0
1134600,True,0,No user reviews,0,0,0
1134620,True,0,No user reviews,0,0,0
1134630,True,0,9 user reviews,8,1,9
1134640,True,0,No user reviews,0,0,0
1134650,True,0,No user reviews,0,0,0
1134690,True,0,No user reviews,0,0,0
1134700,True,0,No user reviews,0,0,0
1134710,True,0,No user reviews,0,0,0
1134730,True,0,No user reviews,0,0,0
1135030,True,0,3 user reviews,2,1,3
1135040,True,0,4 user reviews,3,1,4
1135050,True,0,4 user reviews,2,2,4
1135060,True,0,5 user reviews,4,1,5
1135070,True,0,3 user reviews,1,2,3
1135080,True,0,No user reviews,0,0,0
1135090,True,0,8 user reviews,8,0,8
1135100,True,0,2 user reviews,0,2,2
1135110,True,0,4 user reviews,4,0,4
1135120,True,0,1 user reviews,0,1,1
1135130,True,0,6 user reviews,3,3,6
1135140,True,0,3 user reviews,0,3,3
1135150,True,0,3 user reviews,2,1,3
1135160,True,0,1 user reviews,0,1,1
1135170,True,0,1 user reviews,1,0,1
1135180,True,0,8 user reviews,6,2,8
1135190,True,0,2 user reviews,0,2,2
1135200,True,0,1 user reviews,1,0,1
1135210,True,0,5 user reviews,2,3,5
1135220,True,0,No user reviews,0,0,0
1135230,True,0,No user reviews,0,0,0
1135240,True,4,Mostly Negative,66,236,302
1135260,True,0,No user reviews,0,0,0
1135280,True,8,Very Positive,308,36,344
1135290,True,0,No user reviews,0,0,0
1135300,True,0,No user reviews,0,0,0
1135320,True,0,No user reviews,0,0,0
1135370,True,0,6 user reviews,5,1,6
1135380,True,0,1 user reviews,0,1,1
1135400,True,5,Mixed,9,8,17
1135410,True,0,2 user reviews,1,1,2
1135420,True,0,No user reviews,0,0,0
1135430,True,7,Positive,18,2,20
1135431,True,7,Positive,12,0,12
1135432,True,5,Mixed,9,11,20
1135433,True,7,Positive,21,0,21
1135434,True,7,Positive,9,1,10
1135435,True,0,8 user reviews,8,0,8
1135436,True,7,Positive,14,0,14
1135437,True,7,Positive,10,1,11
1135438,True,7,Positive,11,2,13
1135450,True,0,7 user reviews,6,1,7
1135460,True,0,No user reviews,0,0,0
1135480,True,0,No user reviews,0,0,0
1135490,True,0,No user reviews,0,0,0
1135520,True,0,1 user reviews,1,0,1
1135540,True,0,No user reviews,0,0,0
1135550,True,0,No user reviews,0,0,0
1135570,True,0,1 user reviews,1,0,1
1135580,True,0,No user reviews,0,0,0
1135590,True,0,No user reviews,0,0,0
1135591,True,0,No user reviews,0,0,0
1135640,True,0,1 user reviews,1,0,1
1135680,True,0,No user reviews,0,0,0
1135690,True,0,No user reviews,0,0,0
1135700,True,0,No user reviews,0,0,0
1135710,True,0,No user reviews,0,0,0
1135720,True,0,No user reviews,0,0,0
1135721,True,0,No user reviews,0,0,0
1135730,True,0,1 user reviews,1,0,1
1135740,True,7,Positive,19,4,23
1135750,True,0,1 user reviews,1,0,1
1135760,True,0,No user reviews,0,0,0
1135780,True,0,No user reviews,0,0,0
1135790,True,0,No user reviews,0,0,0
1135800,True,0,No user reviews,0,0,0
1135810,True,0,No user reviews,0,0,0
1135830,True,7,Positive,45,3,48
1135850,True,0,No user reviews,0,0,0
1135860,True,0,3 user reviews,2,1,3
1135880,True,0,No user reviews,0,0,0
1135900,True,0,6 user reviews,5,1,6
1135910,True,5,Mixed,46,28,74
1135960,True,8,Very Positive,54,8,62
1135970,True,0,1 user reviews,1,0,1
1135971,True,0,4 user reviews,4,0,4
1135972,True,0,4 user reviews,4,0,4
1136000,True,0,2 user reviews,2,0,2
1136001,True,0,2 user reviews,2,0,2
1136002,True,0,2 user reviews,2,0,2
1136010,True,0,1 user reviews,0,1,1
1136020,True,7,Positive,14,3,17
1136030,True,0,No user reviews,0,0,0
1136040,True,0,4 user reviews,4,0,4
1136060,True,0,No user reviews,0,0,0
1136070,True,0,9 user reviews,7,2,9
1136080,True,0,5 user reviews,5,0,5
1136090,True,0,2 user reviews,2,0,2
1136100,True,0,1 user reviews,1,0,1
1136110,True,0,8 user reviews,1,7,8
1136130,True,0,No user reviews,0,0,0
1136150,True,0,5 user reviews,2,3,5
1136160,True,6,Mostly Positive,463,166,629
1136170,True,0,No user reviews,0,0,0
1136180,True,0,No user reviews,0,0,0
1136210,True,0,No user reviews,0,0,0
1136240,True,0,No user reviews,0,0,0
1136250,True,0,No user reviews,0,0,0
1136290,True,0,No user reviews,0,0,0
1136310,True,0,1 user reviews,1,0,1
1136311,True,0,1 user reviews,1,0,1
1136312,True,0,No user reviews,0,0,0
1136313,True,0,1 user reviews,1,0,1
1136330,True,7,Positive,43,3,46
1136370,True,0,No user reviews,0,0,0
1136380,True,0,No user reviews,0,0,0
1136390,True,0,8 user reviews,2,6,8
1136400,True,0,No user reviews,0,0,0
1136410,True,0,No user reviews,0,0,0
1136420,True,0,1 user reviews,1,0,1
1136430,True,0,No user reviews,0,0,0
1136440,True,5,Mixed,7,9,16
1136460,True,0,No user reviews,0,0,0
1136470,True,0,No user reviews,0,0,0
1136500,True,0,No user reviews,0,0,0
1136510,True,0,No user reviews,0,0,0
1136580,True,0,No user reviews,0,0,0
1136680,True,0,No user reviews,0,0,0
1136690,True,0,No user reviews,0,0,0
1136750,True,0,No user reviews,0,0,0
1136751,True,0,No user reviews,0,0,0
1136760,True,0,No user reviews,0,0,0
1136770,True,0,No user reviews,0,0,0
1136790,True,0,No user reviews,0,0,0
1136820,True,0,1 user reviews,1,0,1
1136830,True,0,2 user reviews,1,1,2
1136880,True,7,Positive,16,0,16
1136890,True,0,No user reviews,0,0,0
1136900,True,0,No user reviews,0,0,0
1136910,True,6,Mostly Positive,7,3,10
1136920,True,0,No user reviews,0,0,0
1136930,True,0,3 user reviews,2,1,3
1136950,True,0,No user reviews,0,0,0
1136960,True,0,2 user reviews,2,0,2
1136970,True,0,No user reviews,0,0,0
1136990,True,0,No user reviews,0,0,0
1137000,True,0,No user reviews,0,0,0
1137020,True,7,Positive,29,3,32
1137040,True,0,2 user reviews,2,0,2
1137050,True,0,2 user reviews,1,1,2
1137070,True,0,No user reviews,0,0,0
1137090,True,0,No user reviews,0,0,0
1137100,True,0,No user reviews,0,0,0
1137110,True,0,7 user reviews,6,1,7
1137140,True,0,No user reviews,0,0,0
1137160,True,0,No user reviews,0,0,0
1137170,True,0,No user reviews,0,0,0
1137180,True,0,No user reviews,0,0,0
1137190,True,0,No user reviews,0,0,0
1137210,True,0,1 user reviews,1,0,1
1137220,True,0,1 user reviews,0,1,1
1137230,True,0,1 user reviews,0,1,1
1137250,True,0,1 user reviews,0,1,1
1137260,True,0,4 user reviews,1,3,4
1137270,True,0,No user reviews,0,0,0
1137280,True,0,No user reviews,0,0,0
1137281,True,0,No user reviews,0,0,0
1137282,True,0,No user reviews,0,0,0
1137283,True,0,No user reviews,0,0,0
1137300,True,0,No user reviews,0,0,0
1137320,True,0,No user reviews,0,0,0
1137330,True,7,Positive,9,1,10
1137340,True,0,No user reviews,0,0,0
1137350,True,8,Very Positive,150,8,158
1137360,True,0,1 user reviews,1,0,1
1137370,True,0,No user reviews,0,0,0
1137380,True,0,No user reviews,0,0,0
1137390,True,0,No user reviews,0,0,0
1137400,True,6,Mostly Positive,24,7,31
1137410,True,8,Very Positive,163,8,171
1137430,True,0,No user reviews,0,0,0
1137440,True,0,No user reviews,0,0,0
1137450,True,0,No user reviews,0,0,0
1137470,True,8,Very Positive,56,14,70
1137480,True,0,No user reviews,0,0,0
1137490,True,5,Mixed,42,23,65
1137520,True,0,No user reviews,0,0,0
1137530,True,0,No user reviews,0,0,0
1137531,True,0,No user reviews,0,0,0
1137532,True,0,1 user reviews,1,0,1
1137533,True,0,2 user reviews,2,0,2
1137540,True,0,5 user reviews,3,2,5
1137550,True,0,No user reviews,0,0,0
1137620,True,0,6 user reviews,4,2,6
1137630,True,0,No user reviews,0,0,0
1137640,True,0,2 user reviews,2,0,2
1137641,True,5,Mixed,15,21,36
1137650,True,0,No user reviews,0,0,0
1137660,True,0,3 user reviews,3,0,3
1137670,True,0,1 user reviews,0,1,1
1137680,True,0,1 user reviews,1,0,1
1137690,True,0,No user reviews,0,0,0
1137700,True,0,No user reviews,0,0,0
1137730,True,0,7 user reviews,5,2,7
1137750,True,0,No user reviews,0,0,0
1137770,True,0,4 user reviews,1,3,4
1137800,True,7,Positive,25,4,29
1137801,True,7,Positive,25,5,30
1137802,True,0,No user reviews,0,0,0
1137810,True,0,No user reviews,0,0,0
1137820,True,0,No user reviews,0,0,0
1137860,True,0,No user reviews,0,0,0
1137870,True,0,No user reviews,0,0,0
1137880,True,0,No user reviews,0,0,0
1137890,True,0,No user reviews,0,0,0
1137900,True,0,No user reviews,0,0,0
1137910,True,0,No user reviews,0,0,0
1137930,True,0,No user reviews,0,0,0
1137940,True,7,Positive,18,2,20
1137950,True,0,No user reviews,0,0,0
1138000,True,0,No user reviews,0,0,0
1138010,True,0,No user reviews,0,0,0
1138020,True,0,No user reviews,0,0,0
1138030,True,0,No user reviews,0,0,0
1138050,True,0,No user reviews,0,0,0
1138060,True,0,5 user reviews,1,4,5
1138070,True,0,No user reviews,0,0,0
1138080,True,5,Mixed,8,7,15
1138100,True,7,Positive,34,1,35
1138110,True,0,No user reviews,0,0,0
1138130,True,0,1 user reviews,1,0,1
1138150,True,0,2 user reviews,0,2,2
1138160,True,0,No user reviews,0,0,0
1138190,True,0,No user reviews,0,0,0
1138210,True,0,No user reviews,0,0,0
1138220,True,0,No user reviews,0,0,0
1138250,True,0,No user reviews,0,0,0
1138260,True,0,6 user reviews,6,0,6
1138280,True,0,1 user reviews,0,1,1
1138290,True,0,1 user reviews,1,0,1
1138300,True,0,2 user reviews,1,1,2
1138310,True,0,1 user reviews,1,0,1
1138320,True,0,3 user reviews,0,3,3
1138330,True,0,No user reviews,0,0,0
1138340,True,0,No user reviews,0,0,0
1138350,True,0,No user reviews,0,0,0
1138360,True,0,No user reviews,0,0,0
1138370,True,0,3 user reviews,3,0,3
1138380,True,0,No user reviews,0,0,0
1138400,True,5,Mixed,8,7,15
1138410,True,7,Positive,18,1,19
1138440,True,0,No user reviews,0,0,0
1138480,True,0,No user reviews,0,0,0
1138490,True,0,8 user reviews,8,0,8
1138530,True,0,No user reviews,0,0,0
1138570,True,0,No user reviews,0,0,0
1138580,True,7,Positive,43,4,47
1138610,True,0,No user reviews,0,0,0
1138620,True,0,No user reviews,0,0,0
1138630,True,0,4 user reviews,3,1,4
1138640,True,0,No user reviews,0,0,0
1138650,True,0,No user reviews,0,0,0
1138660,True,0,No user reviews,0,0,0
1138670,True,0,No user reviews,0,0,0
1138780,True,0,No user reviews,0,0,0
1138800,True,0,No user reviews,0,0,0
1138810,True,0,2 user reviews,1,1,2
1138840,True,0,No user reviews,0,0,0
1138850,True,0,No user reviews,0,0,0
1138860,True,0,No user reviews,0,0,0
1138900,True,0,No user reviews,0,0,0
1138910,True,7,Positive,17,0,17
1138950,True,0,No user reviews,0,0,0
1138960,True,7,Positive,22,0,22
1138970,True,7,Positive,14,2,16
1138980,True,0,No user reviews,0,0,0
1138990,True,0,2 user reviews,2,0,2
1139000,True,0,No user reviews,0,0,0
1139020,True,0,4 user reviews,2,2,4
1139040,True,0,No user reviews,0,0,0
1139060,True,0,No user reviews,0,0,0
1139080,True,6,Mostly Positive,57,15,72
1139090,True,0,No user reviews,0,0,0
1139100,True,0,1 user reviews,1,0,1
1139110,True,7,Positive,34,3,37
1139130,True,0,1 user reviews,0,1,1
1139140,True,7,Positive,10,1,11
1139160,True,0,No user reviews,0,0,0
1139190,True,0,No user reviews,0,0,0
1139200,True,0,No user reviews,0,0,0
1139210,True,0,No user reviews,0,0,0
1139230,True,0,No user reviews,0,0,0
1139240,True,0,5 user reviews,5,0,5
1139250,True,0,No user reviews,0,0,0
1139260,True,0,No user reviews,0,0,0
1139270,True,0,No user reviews,0,0,0
1139280,True,0,No user reviews,0,0,0
1139290,True,0,No user reviews,0,0,0
1139310,True,0,No user reviews,0,0,0
1139470,True,0,5 user reviews,4,1,5
1139480,True,0,7 user reviews,5,2,7
1139490,True,0,No user reviews,0,0,0
1139500,True,0,No user reviews,0,0,0
1139660,True,0,No user reviews,0,0,0
1139680,True,0,3 user reviews,3,0,3
1139720,True,0,No user reviews,0,0,0
1139750,True,0,No user reviews,0,0,0
1139760,True,0,5 user reviews,5,0,5
1139770,True,0,No user reviews,0,0,0
1139780,True,0,No user reviews,0,0,0
1139790,True,0,No user reviews,0,0,0
1139800,True,7,Positive,10,0,10
1139830,True,0,2 user reviews,1,1,2
1139840,True,0,No user reviews,0,0,0
1139852,True,0,1 user reviews,1,0,1
1139860,True,0,1 user reviews,1,0,1
1139870,True,5,Mixed,23,34,57
1139880,True,0,7 user reviews,7,0,7
1139890,True,8,Very Positive,310,13,323
1139900,True,8,Very Positive,1726,248,1974
1139910,True,0,No user reviews,0,0,0
1139920,True,0,No user reviews,0,0,0
1139930,True,0,3 user reviews,3,0,3
1139940,True,8,Very Positive,115,16,131
1139950,True,0,9 user reviews,7,2,9
1139980,True,8,Very Positive,379,18,397
1139990,True,0,2 user reviews,2,0,2
1140000,True,6,Mostly Positive,113,44,157
1140001,True,6,Mostly Positive,275,86,361
1140010,True,0,No user reviews,0,0,0
1140020,True,0,2 user reviews,0,2,2
1140030,True,6,Mostly Positive,10,4,14
1140040,True,0,No user reviews,0,0,0
1140060,True,0,No user reviews,0,0,0
1140070,True,0,2 user reviews,1,1,2
1140100,True,6,Mostly Positive,19,7,26
1140110,True,0,3 user reviews,1,2,3
1140120,True,0,2 user reviews,2,0,2
1140130,True,6,Mostly Positive,24,8,32
1140140,True,0,3 user reviews,2,1,3
1140160,True,0,No user reviews,0,0,0
1140170,True,0,No user reviews,0,0,0
1140190,True,0,No user reviews,0,0,0
1140200,True,0,No user reviews,0,0,0
1140210,True,0,No user reviews,0,0,0
1140220,True,0,No user reviews,0,0,0
1140230,True,0,No user reviews,0,0,0
1140240,True,0,No user reviews,0,0,0
1140250,True,0,No user reviews,0,0,0
1140260,True,0,1 user reviews,1,0,1
1140270,True,9,Overwhelmingly Positive,861,7,868
1140290,True,8,Very Positive,257,29,286
1140320,True,0,No user reviews,0,0,0
1140350,True,0,No user reviews,0,0,0
1140360,True,0,1 user reviews,1,0,1
1140370,True,0,No user reviews,0,0,0
1140380,True,0,No user reviews,0,0,0
1140390,True,0,No user reviews,0,0,0
1140400,True,0,2 user reviews,1,1,2
1140410,True,0,2 user reviews,0,2,2
1140420,True,0,3 user reviews,2,1,3
1140430,True,0,No user reviews,0,0,0
1140440,True,5,Mixed,47,22,69
1140460,True,7,Positive,15,0,15
1140470,True,0,No user reviews,0,0,0
1140490,True,0,No user reviews,0,0,0
1140500,True,0,9 user reviews,3,6,9
1140510,True,0,No user reviews,0,0,0
1140520,True,0,2 user reviews,2,0,2
1140530,True,0,1 user reviews,1,0,1
1140540,True,0,No user reviews,0,0,0
1140550,True,0,No user reviews,0,0,0
1140551,True,0,No user reviews,0,0,0
1140552,True,0,No user reviews,0,0,0
1140553,True,0,No user reviews,0,0,0
1140560,True,0,No user reviews,0,0,0
1140570,True,7,Positive,18,1,19
1140590,True,0,2 user reviews,2,0,2
1140610,True,0,5 user reviews,5,0,5
1140630,True,0,No user reviews,0,0,0
1140640,True,0,2 user reviews,2,0,2
1140650,True,0,No user reviews,0,0,0
1140662,True,0,No user reviews,0,0,0
1140670,True,0,No user reviews,0,0,0
1140680,True,0,No user reviews,0,0,0
1140690,True,0,4 user reviews,4,0,4
1140700,True,0,No user reviews,0,0,0
1140710,True,0,No user reviews,0,0,0
1140720,True,0,1 user reviews,1,0,1
1140730,True,0,No user reviews,0,0,0
1140740,True,0,No user reviews,0,0,0
1140760,True,0,No user reviews,0,0,0
1140790,True,0,No user reviews,0,0,0
1140870,True,0,No user reviews,0,0,0
1140880,True,6,Mostly Positive,9,3,12
1140890,True,0,No user reviews,0,0,0
1140900,True,0,1 user reviews,0,1,1
1140910,True,0,No user reviews,0,0,0
1140920,True,0,No user reviews,0,0,0
1140930,True,0,No user reviews,0,0,0
1140940,True,0,No user reviews,0,0,0
1140950,True,0,No user reviews,0,0,0
1140970,True,0,3 user reviews,1,2,3
1140980,True,0,No user reviews,0,0,0
1141020,True,0,No user reviews,0,0,0
1141030,True,0,No user reviews,0,0,0
1141040,True,0,No user reviews,0,0,0
1141050,True,0,No user reviews,0,0,0
1141060,True,0,No user reviews,0,0,0
1141070,True,0,1 user reviews,1,0,1
1141100,True,7,Positive,25,3,28
1141110,True,0,No user reviews,0,0,0
1141120,True,0,No user reviews,0,0,0
1141130,True,7,Positive,16,0,16
1141150,True,0,2 user reviews,1,1,2
1141160,True,0,1 user reviews,1,0,1
1141170,True,0,1 user reviews,0,1,1
1141180,True,0,2 user reviews,2,0,2
1141190,True,0,No user reviews,0,0,0
1141200,True,0,No user reviews,0,0,0
1141220,True,8,Very Positive,398,77,475
1141250,True,0,No user reviews,0,0,0
1141270,True,0,No user reviews,0,0,0
1141280,True,0,No user reviews,0,0,0
1141290,True,7,Positive,25,1,26
1141300,True,0,2 user reviews,2,0,2
1141310,True,0,No user reviews,0,0,0
1141340,True,0,No user reviews,0,0,0
1141360,True,7,Positive,8,2,10
1141370,True,0,No user reviews,0,0,0
1141380,True,0,2 user reviews,1,1,2
1141390,True,0,1 user reviews,1,0,1
1141400,True,0,No user reviews,0,0,0
1141401,True,0,No user reviews,0,0,0
1141410,True,0,No user reviews,0,0,0
1141450,True,0,8 user reviews,7,1,8
1141500,True,0,No user reviews,0,0,0
1141510,True,0,No user reviews,0,0,0
1141520,True,0,No user reviews,0,0,0
1141530,True,0,1 user reviews,0,1,1
1141540,True,0,No user reviews,0,0,0
1141570,True,0,6 user reviews,6,0,6
1141580,True,0,No user reviews,0,0,0
1141600,True,0,3 user reviews,2,1,3
1141610,True,0,No user reviews,0,0,0
1141640,True,0,1 user reviews,0,1,1
1141650,True,7,Positive,13,2,15
1141660,True,0,No user reviews,0,0,0
1141670,True,0,No user reviews,0,0,0
1141680,True,0,No user reviews,0,0,0
1141690,True,0,No user reviews,0,0,0
1141700,True,0,No user reviews,0,0,0
1141710,True,0,4 user reviews,4,0,4
1141711,True,0,9 user reviews,8,1,9
1141740,True,0,No user reviews,0,0,0
1141750,True,0,No user reviews,0,0,0
1141770,True,0,No user reviews,0,0,0
1141790,True,0,1 user reviews,1,0,1
1141800,True,0,No user reviews,0,0,0
1141810,True,0,2 user reviews,2,0,2
1141811,True,0,2 user reviews,1,1,2
1141820,True,0,No user reviews,0,0,0
1141840,True,0,1 user reviews,1,0,1
1141850,True,0,No user reviews,0,0,0
1141860,True,0,No user reviews,0,0,0
1141870,True,0,2 user reviews,2,0,2
1141880,True,0,5 user reviews,5,0,5
1141920,True,0,No user reviews,0,0,0
1141930,True,5,Mixed,11,6,17
1141950,True,0,8 user reviews,4,4,8
1141960,True,7,Positive,33,1,34
1141970,True,0,No user reviews,0,0,0
1141980,True,5,Mixed,8,6,14
1141990,True,0,9 user reviews,6,3,9
1142000,True,0,No user reviews,0,0,0
1142050,True,0,No user reviews,0,0,0
1142070,True,0,5 user reviews,2,3,5
1142080,True,0,No user reviews,0,0,0
1142090,True,0,3 user reviews,3,0,3
1142100,True,5,Mixed,86,40,126
1142110,True,0,No user reviews,0,0,0
1142130,True,0,1 user reviews,1,0,1
1142180,True,0,No user reviews,0,0,0
1142200,True,0,No user reviews,0,0,0
1142220,True,5,Mixed,18,9,27
1142230,True,0,2 user reviews,2,0,2
1142240,True,0,1 user reviews,1,0,1
1142250,True,0,4 user reviews,4,0,4
1142260,True,0,No user reviews,0,0,0
1142270,True,7,Positive,16,4,20
1142280,True,0,No user reviews,0,0,0
1142290,True,0,1 user reviews,1,0,1
1142300,True,0,7 user reviews,7,0,7
1142320,True,0,2 user reviews,2,0,2
1142330,True,5,Mixed,19,16,35
1142340,True,0,No user reviews,0,0,0
1142350,True,0,No user reviews,0,0,0
1142360,True,0,6 user reviews,4,2,6
1142370,True,0,No user reviews,0,0,0
1142390,True,5,Mixed,53,46,99
1142400,True,0,No user reviews,0,0,0
1142410,True,6,Mostly Positive,11,3,14
1142440,True,0,No user reviews,0,0,0
1142450,True,0,No user reviews,0,0,0
1142460,True,0,No user reviews,0,0,0
1142470,True,0,7 user reviews,4,3,7
1142480,True,7,Positive,15,2,17
1142500,True,8,Very Positive,1230,96,1326
1142510,True,0,No user reviews,0,0,0
1142520,True,0,No user reviews,0,0,0
1142540,True,0,No user reviews,0,0,0
1142550,True,0,9 user reviews,8,1,9
1142560,True,0,No user reviews,0,0,0
1142570,True,0,No user reviews,0,0,0
1142590,True,0,No user reviews,0,0,0
1142600,True,0,No user reviews,0,0,0
1142610,True,0,No user reviews,0,0,0
1142630,True,0,No user reviews,0,0,0
1142640,True,0,No user reviews,0,0,0
1142650,True,0,No user reviews,0,0,0
1142670,True,0,No user reviews,0,0,0
1142680,True,0,No user reviews,0,0,0
1142690,True,0,No user reviews,0,0,0
1142700,True,0,No user reviews,0,0,0
1142730,True,0,No user reviews,0,0,0
1142740,True,0,No user reviews,0,0,0
1142750,True,0,1 user reviews,1,0,1
1142760,True,0,No user reviews,0,0,0
1142790,True,0,No user reviews,0,0,0
1142800,True,7,Positive,13,2,15
1142810,True,7,Positive,18,0,18
1142820,True,0,No user reviews,0,0,0
1142830,True,7,Positive,23,0,23
1142840,True,0,No user reviews,0,0,0
1142850,True,0,5 user reviews,4,1,5
1142860,True,0,No user reviews,0,0,0
1142870,True,0,4 user reviews,0,4,4
1142880,True,5,Mixed,31,36,67
1142890,True,0,No user reviews,0,0,0
1142900,True,0,2 user reviews,1,1,2
1142910,True,0,No user reviews,0,0,0
1142920,True,0,1 user reviews,0,1,1
1143070,True,0,No user reviews,0,0,0
1143130,True,0,No user reviews,0,0,0
1143140,True,0,No user reviews,0,0,0
1143160,True,0,No user reviews,0,0,0
1143170,True,0,4 user reviews,3,1,4
1143300,True,0,No user reviews,0,0,0
1143310,True,0,No user reviews,0,0,0
1143320,True,0,1 user reviews,1,0,1
1143330,True,0,1 user reviews,1,0,1
1143340,True,0,No user reviews,0,0,0
1143350,True,7,Positive,17,1,18
1143360,True,0,No user reviews,0,0,0
1143390,True,0,3 user reviews,3,0,3
1143400,True,7,Positive,24,6,30
1143410,True,0,No user reviews,0,0,0
1143420,True,0,No user reviews,0,0,0
1143430,True,0,6 user reviews,5,1,6
1143440,True,0,6 user reviews,6,0,6
1143450,True,0,No user reviews,0,0,0
1143460,True,0,3 user reviews,2,1,3
1143500,True,0,No user reviews,0,0,0
1143510,True,0,1 user reviews,1,0,1
1143520,True,0,2 user reviews,2,0,2
1143530,True,0,No user reviews,0,0,0
1143540,True,0,No user reviews,0,0,0
1143550,True,0,1 user reviews,1,0,1
1143560,True,0,No user reviews,0,0,0
1143570,True,0,3 user reviews,3,0,3
1143580,True,0,No user reviews,0,0,0
1143590,True,0,No user reviews,0,0,0
1143610,True,0,No user reviews,0,0,0
1143650,True,5,Mixed,55,39,94
1143660,True,0,No user reviews,0,0,0
1143670,True,0,No user reviews,0,0,0
1143680,True,0,8 user reviews,8,0,8
1143710,True,0,4 user reviews,3,1,4
1143720,True,0,3 user reviews,2,1,3
1143740,True,0,3 user reviews,3,0,3
1143750,True,7,Positive,14,1,15
1143770,True,0,No user reviews,0,0,0
1143780,True,0,2 user reviews,2,0,2
1143800,True,0,7 user reviews,6,1,7
1143810,True,0,No user reviews,0,0,0
1143820,True,0,9 user reviews,5,4,9
1143830,True,0,No user reviews,0,0,0
1143840,True,8,Very Positive,170,17,187
1143850,True,0,7 user reviews,7,0,7
1143851,True,0,6 user reviews,5,1,6
1143852,True,0,6 user reviews,6,0,6
1143853,True,7,Positive,12,2,14
1143870,True,0,No user reviews,0,0,0
1143890,True,7,Positive,13,3,16
1143900,True,0,1 user reviews,1,0,1
1143950,True,0,No user reviews,0,0,0
1143961,True,0,No user reviews,0,0,0
1143970,True,0,No user reviews,0,0,0
1143971,True,0,No user reviews,0,0,0
1143972,True,0,No user reviews,0,0,0
1143973,True,0,No user reviews,0,0,0
1143974,True,0,No user reviews,0,0,0
1143975,True,0,No user reviews,0,0,0
1143976,True,0,No user reviews,0,0,0
1143977,True,0,1 user reviews,1,0,1
1143978,True,0,1 user reviews,1,0,1
1143979,True,0,No user reviews,0,0,0
1143980,True,0,No user reviews,0,0,0
1143981,True,0,No user reviews,0,0,0
1143982,True,0,No user reviews,0,0,0
1143983,True,0,No user reviews,0,0,0
1143990,True,0,No user reviews,0,0,0
1143991,True,0,No user reviews,0,0,0
1143992,True,0,No user reviews,0,0,0
1143993,True,0,No user reviews,0,0,0
1143994,True,0,No user reviews,0,0,0
1143995,True,0,No user reviews,0,0,0
1144000,True,0,No user reviews,0,0,0
1144020,True,8,Very Positive,123,6,129
1144030,True,8,Very Positive,690,38,728
1144060,True,0,1 user reviews,0,1,1
1144070,True,0,5 user reviews,2,3,5
1144080,True,0,No user reviews,0,0,0
1144090,True,0,No user reviews,0,0,0
1144100,True,0,6 user reviews,6,0,6
1144110,True,0,4 user reviews,4,0,4
1144120,True,0,No user reviews,0,0,0
1144130,True,0,No user reviews,0,0,0
1144140,True,7,Positive,9,1,10
1144150,True,7,Positive,20,0,20
1144170,True,0,No user reviews,0,0,0
1144180,True,0,6 user reviews,6,0,6
1144190,True,0,No user reviews,0,0,0
1144200,True,0,No user reviews,0,0,0
1144230,True,0,No user reviews,0,0,0
1144231,True,0,No user reviews,0,0,0
1144250,True,8,Very Positive,154,38,192
1144260,True,0,No user reviews,0,0,0
1144270,True,0,2 user reviews,2,0,2
1144280,True,7,Positive,33,0,33
1144290,True,0,1 user reviews,1,0,1
1144300,True,0,5 user reviews,4,1,5
1144310,True,0,5 user reviews,5,0,5
1144320,True,0,No user reviews,0,0,0
1144330,True,7,Positive,9,1,10
1144350,True,0,2 user reviews,1,1,2
1144370,True,0,No user reviews,0,0,0
1144380,True,0,No user reviews,0,0,0
1144400,True,8,Very Positive,187,7,194
1144410,True,6,Mostly Positive,114,31,145
1144420,True,7,Positive,41,6,47
1144430,True,0,No user reviews,0,0,0
1144440,True,7,Positive,30,6,36
1144450,True,0,1 user reviews,1,0,1
1144460,True,7,Positive,9,2,11
1144470,True,0,No user reviews,0,0,0
1144480,True,0,4 user reviews,4,0,4
1144490,True,0,3 user reviews,3,0,3
1144500,True,0,5 user reviews,5,0,5
1144510,True,0,6 user reviews,5,1,6
1144520,True,0,2 user reviews,0,2,2
1144550,True,0,3 user reviews,1,2,3
1144560,True,0,No user reviews,0,0,0
1144580,True,0,No user reviews,0,0,0
1144590,True,0,4 user reviews,4,0,4
1144620,True,0,No user reviews,0,0,0
1144630,True,0,2 user reviews,2,0,2
1144640,True,6,Mostly Positive,13,5,18
1144641,True,0,No user reviews,0,0,0
1144642,True,0,No user reviews,0,0,0
1144643,True,0,6 user reviews,2,4,6
1144644,True,0,No user reviews,0,0,0
1144645,True,0,4 user reviews,2,2,4
1144646,True,5,Mixed,36,38,74
1144670,True,0,No user reviews,0,0,0
1144690,True,0,1 user reviews,1,0,1
1144710,True,0,No user reviews,0,0,0
1144740,True,0,No user reviews,0,0,0
1144750,True,0,2 user reviews,2,0,2
1144760,True,0,No user reviews,0,0,0
1144780,True,0,2 user reviews,1,1,2
1144800,True,0,No user reviews,0,0,0
1144810,True,0,No user reviews,0,0,0
1144820,True,0,No user reviews,0,0,0
1144830,True,0,No user reviews,0,0,0
1144850,True,0,No user reviews,0,0,0
1144860,True,7,Positive,9,1,10
1144890,True,0,No user reviews,0,0,0
1144900,True,0,No user reviews,0,0,0
1144910,True,8,Very Positive,50,0,50
1144930,True,0,No user reviews,0,0,0
1144940,True,0,No user reviews,0,0,0
1144941,True,0,No user reviews,0,0,0
1144942,True,0,No user reviews,0,0,0
1144943,True,0,1 user reviews,0,1,1
1144944,True,0,2 user reviews,1,1,2
1144970,True,6,Mostly Positive,82,28,110
1145000,True,0,No user reviews,0,0,0
1145020,True,0,No user reviews,0,0,0
1145030,True,0,3 user reviews,3,0,3
1145040,True,0,6 user reviews,1,5,6
1145050,True,0,No user reviews,0,0,0
1145060,True,0,No user reviews,0,0,0
1145080,True,0,No user reviews,0,0,0
1145100,True,0,No user reviews,0,0,0
1145120,True,0,No user reviews,0,0,0
1145170,True,0,No user reviews,0,0,0
1145180,True,0,1 user reviews,1,0,1
1145190,True,0,No user reviews,0,0,0
1145200,True,0,No user reviews,0,0,0
1145210,True,0,1 user reviews,0,1,1
1145220,True,0,No user reviews,0,0,0
1145240,True,0,No user reviews,0,0,0
1145250,True,6,Mostly Positive,43,17,60
1145270,True,0,No user reviews,0,0,0
1145280,True,0,1 user reviews,1,0,1
1145290,True,0,No user reviews,0,0,0
1145300,True,0,No user reviews,0,0,0
1145310,True,0,No user reviews,0,0,0
1145330,True,0,No user reviews,0,0,0
1145340,True,0,No user reviews,0,0,0
1145360,True,9,Overwhelmingly Positive,25853,272,26125
1145380,True,0,3 user reviews,3,0,3
1145400,True,0,No user reviews,0,0,0
1145410,True,7,Positive,27,2,29
1145430,True,0,1 user reviews,0,1,1
1145440,True,0,No user reviews,0,0,0
1145450,True,0,6 user reviews,5,1,6
1145460,True,0,3 user reviews,0,3,3
1145470,True,0,No user reviews,0,0,0
1145480,True,0,No user reviews,0,0,0
1145490,True,0,No user reviews,0,0,0
1145500,True,0,No user reviews,0,0,0
1145510,True,0,No user reviews,0,0,0
1145520,True,0,2 user reviews,2,0,2
1145530,True,0,2 user reviews,2,0,2
1145540,True,0,No user reviews,0,0,0
1145550,True,0,No user reviews,0,0,0
1145560,True,7,Positive,13,1,14
1145570,True,6,Mostly Positive,19,7,26
1145580,True,0,1 user reviews,0,1,1
1145590,True,0,1 user reviews,0,1,1
1145600,True,0,No user reviews,0,0,0
1145630,True,0,No user reviews,0,0,0
1145660,True,6,Mostly Positive,196,60,256
1145670,True,0,No user reviews,0,0,0
1145680,True,0,2 user reviews,2,0,2
1145690,True,0,No user reviews,0,0,0
1145710,True,0,No user reviews,0,0,0
1145711,True,0,No user reviews,0,0,0
1145740,True,0,9 user reviews,6,3,9
1145760,True,0,1 user reviews,1,0,1
1145770,True,0,No user reviews,0,0,0
1145780,True,7,Positive,8,2,10
1145810,True,0,5 user reviews,3,2,5
1145820,True,0,5 user reviews,2,3,5
1145840,True,0,No user reviews,0,0,0
1145850,True,0,No user reviews,0,0,0
1145851,True,0,1 user reviews,1,0,1
1145860,True,0,1 user reviews,0,1,1
1145890,True,0,No user reviews,0,0,0
1145920,True,0,No user reviews,0,0,0
1145930,True,0,No user reviews,0,0,0
1145960,True,8,Very Positive,512,66,578
1145970,True,0,5 user reviews,5,0,5
1145990,True,0,1 user reviews,0,1,1
1146000,True,0,No user reviews,0,0,0
1146010,True,5,Mixed,16,12,28
1146040,True,0,No user reviews,0,0,0
1146070,True,0,No user reviews,0,0,0
1146090,True,0,1 user reviews,1,0,1
1146100,True,6,Mostly Positive,45,15,60
1146120,True,0,No user reviews,0,0,0
1146130,True,0,No user reviews,0,0,0
1146131,True,0,No user reviews,0,0,0
1146132,True,0,No user reviews,0,0,0
1146140,True,0,No user reviews,0,0,0
1146141,True,0,No user reviews,0,0,0
1146142,True,0,No user reviews,0,0,0
1146160,True,0,1 user reviews,1,0,1
1146170,True,7,Positive,24,3,27
1146190,True,0,No user reviews,0,0,0
1146210,True,0,3 user reviews,3,0,3
1146230,True,8,Very Positive,106,9,115
1146240,True,0,No user reviews,0,0,0
1146250,True,0,2 user reviews,1,1,2
1146260,True,0,3 user reviews,3,0,3
1146280,True,0,No user reviews,0,0,0
1146300,True,0,No user reviews,0,0,0
1146310,True,8,Very Positive,247,48,295
1146320,True,0,2 user reviews,1,1,2
1146330,True,0,No user reviews,0,0,0
1146350,True,0,1 user reviews,0,1,1
1146360,True,0,No user reviews,0,0,0
1146370,True,8,Very Positive,147,4,151
1146380,True,0,No user reviews,0,0,0
1146390,True,0,1 user reviews,1,0,1
1146400,True,0,No user reviews,0,0,0
1146430,True,0,No user reviews,0,0,0
1146450,True,0,No user reviews,0,0,0
1146460,True,0,No user reviews,0,0,0
1146480,True,0,No user reviews,0,0,0
1146490,True,0,No user reviews,0,0,0
1146500,True,0,No user reviews,0,0,0
1146510,True,7,Positive,46,1,47
1146520,True,0,7 user reviews,4,3,7
1146521,True,0,1 user reviews,0,1,1
1146522,True,0,4 user reviews,2,2,4
1146523,True,0,4 user reviews,0,4,4
1146540,True,0,No user reviews,0,0,0
1146550,True,0,No user reviews,0,0,0
1146560,True,0,3 user reviews,3,0,3
1146580,True,0,No user reviews,0,0,0
1146590,True,0,No user reviews,0,0,0
1146600,True,7,Positive,35,7,42
1146620,True,0,No user reviews,0,0,0
1146630,True,8,Very Positive,264,20,284
1146650,True,0,No user reviews,0,0,0
1146660,True,0,No user reviews,0,0,0
1146670,True,0,No user reviews,0,0,0
1146680,True,0,1 user reviews,1,0,1
1146690,True,0,No user reviews,0,0,0
1146700,True,0,3 user reviews,2,1,3
1146710,True,0,No user reviews,0,0,0
1146720,True,5,Mixed,14,7,21
1146730,True,0,No user reviews,0,0,0
1146780,True,0,1 user reviews,1,0,1
1146790,True,0,2 user reviews,2,0,2
1146810,True,0,2 user reviews,1,1,2
1146830,True,5,Mixed,31,24,55
1146870,True,0,6 user reviews,0,6,6
1146880,True,0,6 user reviews,6,0,6
1146890,True,0,2 user reviews,2,0,2
1146910,True,0,4 user reviews,4,0,4
1146920,True,0,5 user reviews,3,2,5
1146930,True,5,Mixed,81,73,154
1146940,True,6,Mostly Positive,63,19,82
1146950,True,8,Very Positive,293,17,310
1146960,True,6,Mostly Positive,228,69,297
1146970,True,7,Positive,25,0,25
1147010,True,4,Mostly Negative,140,214,354
1147020,True,0,2 user reviews,1,1,2
1147030,True,0,5 user reviews,3,2,5
1147040,True,0,2 user reviews,2,0,2
1147060,True,0,No user reviews,0,0,0
1147080,True,0,No user reviews,0,0,0
1147100,True,5,Mixed,31,24,55
1147110,True,7,Positive,10,1,11
1147130,True,0,No user reviews,0,0,0
1147140,True,0,1 user reviews,0,1,1
1147150,True,0,No user reviews,0,0,0
1147151,True,0,No user reviews,0,0,0
1147152,True,0,3 user reviews,1,2,3
1147153,True,6,Mostly Positive,10,3,13
1147154,True,0,5 user reviews,5,0,5
1147155,True,0,3 user reviews,3,0,3
1147157,True,4,Mostly Negative,4,12,16
1147158,True,5,Mixed,9,4,13
1147159,True,0,2 user reviews,1,1,2
1147160,True,0,No user reviews,0,0,0
1147170,True,0,No user reviews,0,0,0
1147200,True,0,No user reviews,0,0,0
1147220,True,0,1 user reviews,1,0,1
1147230,True,0,No user reviews,0,0,0
1147240,True,0,No user reviews,0,0,0
1147250,True,0,No user reviews,0,0,0
1147270,True,0,No user reviews,0,0,0
1147280,True,0,4 user reviews,4,0,4
1147290,True,0,No user reviews,0,0,0
1147320,True,0,No user reviews,0,0,0
1147330,True,0,No user reviews,0,0,0
1147370,True,0,2 user reviews,1,1,2
1147380,True,0,No user reviews,0,0,0
1147381,True,0,2 user reviews,2,0,2
1147382,True,0,7 user reviews,7,0,7
1147383,True,0,No user reviews,0,0,0
1147390,True,0,No user reviews,0,0,0
1147410,True,0,No user reviews,0,0,0
1147420,True,0,No user reviews,0,0,0
1147430,True,0,No user reviews,0,0,0
1147450,True,5,Mixed,17,9,26
1147460,True,0,No user reviews,0,0,0
1147480,True,0,8 user reviews,7,1,8
1147490,True,7,Positive,16,3,19
1147500,True,7,Positive,20,1,21
1147510,True,8,Very Positive,325,44,369
1147520,True,0,1 user reviews,0,1,1
1147540,True,0,No user reviews,0,0,0
1147550,True,9,Overwhelmingly Positive,1881,60,1941
1147560,True,8,Very Positive,798,59,857
1147600,True,0,3 user reviews,3,0,3
1147620,True,0,1 user reviews,0,1,1
1147640,True,0,No user reviews,0,0,0
1147660,True,5,Mixed,1118,675,1793
1147670,True,5,Mixed,23,12,35
1147680,True,0,No user reviews,0,0,0
1147690,True,0,No user reviews,0,0,0
1147710,True,0,No user reviews,0,0,0
1147730,True,0,No user reviews,0,0,0
1147750,True,0,No user reviews,0,0,0
1147760,True,0,5 user reviews,4,1,5
1147770,True,6,Mostly Positive,14,4,18
1147830,True,0,No user reviews,0,0,0
1147840,True,0,1 user reviews,1,0,1
1147850,True,0,4 user reviews,4,0,4
1147860,True,0,No user reviews,0,0,0
1147870,True,0,No user reviews,0,0,0
1147880,True,0,No user reviews,0,0,0
1147890,True,0,No user reviews,0,0,0
1147900,True,0,No user reviews,0,0,0
1147910,True,0,No user reviews,0,0,0
1147940,True,8,Very Positive,148,7,155
1147950,True,0,No user reviews,0,0,0
1147960,True,6,Mostly Positive,70,19,89
1147970,True,8,Very Positive,54,12,66
1147980,True,0,2 user reviews,1,1,2
1147990,True,0,No user reviews,0,0,0
1148000,True,0,No user reviews,0,0,0
1148010,True,0,6 user reviews,3,3,6
1148020,True,5,Mixed,34,16,50
1148021,True,0,8 user reviews,6,2,8
1148022,True,5,Mixed,17,16,33
1148030,True,0,No user reviews,0,0,0
1148040,True,0,No user reviews,0,0,0
1148080,True,0,1 user reviews,1,0,1
1148090,True,0,5 user reviews,5,0,5
1148100,True,0,No user reviews,0,0,0
1148120,True,0,No user reviews,0,0,0
1148130,True,0,No user reviews,0,0,0
1148150,True,8,Very Positive,301,34,335
1148160,True,0,No user reviews,0,0,0
1148180,True,0,6 user reviews,6,0,6
1148190,True,0,No user reviews,0,0,0
1148200,True,0,No user reviews,0,0,0
1148230,True,0,No user reviews,0,0,0
1148240,True,0,No user reviews,0,0,0
1148250,True,0,No user reviews,0,0,0
1148260,True,0,2 user reviews,2,0,2
1148270,True,0,1 user reviews,1,0,1
1148280,True,0,No user reviews,0,0,0
1148290,True,0,2 user reviews,2,0,2
1148300,True,0,No user reviews,0,0,0
1148320,True,7,Positive,14,3,17
1148330,True,0,No user reviews,0,0,0
1148400,True,0,No user reviews,0,0,0
1148410,True,0,No user reviews,0,0,0
1148420,True,0,No user reviews,0,0,0
1148430,True,0,3 user reviews,2,1,3
1148450,True,7,Positive,18,2,20
1148460,True,0,1 user reviews,0,1,1
1148470,True,0,7 user reviews,6,1,7
1148480,True,0,No user reviews,0,0,0
1148490,True,0,No user reviews,0,0,0
1148500,True,0,3 user reviews,3,0,3
1148510,True,8,Very Positive,164,14,178
1148530,True,0,6 user reviews,2,4,6
1148540,True,0,1 user reviews,1,0,1
1148550,True,0,4 user reviews,3,1,4
1148560,True,0,No user reviews,0,0,0
1148570,True,0,No user reviews,0,0,0
1148580,True,0,No user reviews,0,0,0
1148590,True,8,Very Positive,1429,90,1519
1148610,True,0,No user reviews,0,0,0
1148620,True,0,5 user reviews,5,0,5
1148640,True,0,1 user reviews,1,0,1
1148650,True,6,Mostly Positive,2273,621,2894
1148670,True,0,2 user reviews,2,0,2
1148680,True,0,1 user reviews,1,0,1
1148700,True,7,Positive,24,5,29
1148710,True,0,1 user reviews,1,0,1
1148730,True,7,Positive,16,1,17
1148740,True,0,1 user reviews,1,0,1
1148750,True,0,No user reviews,0,0,0
1148760,True,0,No user reviews,0,0,0
1148790,True,0,No user reviews,0,0,0
1148800,True,0,No user reviews,0,0,0
1148810,True,8,Very Positive,74,9,83
1148820,True,0,No user reviews,0,0,0
1148830,True,0,1 user reviews,0,1,1
1148880,True,0,No user reviews,0,0,0
1148890,True,0,1 user reviews,0,1,1
1148910,True,5,Mixed,8,5,13
1148920,True,0,4 user reviews,2,2,4
1148930,True,0,5 user reviews,5,0,5
1148940,True,0,4 user reviews,3,1,4
1148950,True,0,No user reviews,0,0,0
1148960,True,0,6 user reviews,4,2,6
1148970,True,0,No user reviews,0,0,0
1148980,True,7,Positive,8,2,10
1149010,True,0,No user reviews,0,0,0
1149060,True,0,No user reviews,0,0,0
1149070,True,0,No user reviews,0,0,0
1149080,True,0,8 user reviews,5,3,8
1149090,True,0,3 user reviews,2,1,3
1149110,True,0,No user reviews,0,0,0
1149120,True,0,1 user reviews,0,1,1
1149130,True,0,No user reviews,0,0,0
1149160,True,0,No user reviews,0,0,0
1149180,True,0,No user reviews,0,0,0
1149190,True,0,1 user reviews,0,1,1
1149200,True,0,1 user reviews,0,1,1
1149210,True,0,1 user reviews,1,0,1
1149220,True,0,1 user reviews,1,0,1
1149240,True,0,No user reviews,0,0,0
1149260,True,0,No user reviews,0,0,0
1149261,True,0,No user reviews,0,0,0
1149330,True,0,No user reviews,0,0,0
1149340,True,0,No user reviews,0,0,0
1149370,True,0,2 user reviews,1,1,2
1149400,True,6,Mostly Positive,97,34,131
1149430,True,0,No user reviews,0,0,0
1149440,True,8,Very Positive,152,25,177
1149450,True,0,No user reviews,0,0,0
1149460,True,0,No user reviews,0,0,0
1149490,True,0,No user reviews,0,0,0
1149500,True,0,No user reviews,0,0,0
1149510,True,0,6 user reviews,6,0,6
1149520,True,0,No user reviews,0,0,0
1149540,True,0,2 user reviews,2,0,2
1149550,True,8,Very Positive,79,4,83
1149580,True,0,2 user reviews,2,0,2
1149590,True,0,5 user reviews,5,0,5
1149620,True,0,No user reviews,0,0,0
1149630,True,0,No user reviews,0,0,0
1149640,True,8,Very Positive,679,111,790
1149650,True,0,No user reviews,0,0,0
1149660,True,6,Mostly Positive,105,31,136
1149690,True,0,7 user reviews,7,0,7
1149700,True,0,1 user reviews,1,0,1
1149710,True,6,Mostly Positive,13,5,18
1149720,True,0,4 user reviews,4,0,4
1149740,True,0,No user reviews,0,0,0
1149760,True,0,No user reviews,0,0,0
1149770,True,0,No user reviews,0,0,0
1149780,True,0,No user reviews,0,0,0
1149781,True,0,No user reviews,0,0,0
1149800,True,0,No user reviews,0,0,0
1149830,True,0,No user reviews,0,0,0
1149840,True,0,No user reviews,0,0,0
1149860,True,7,Positive,12,0,12
1149870,True,0,No user reviews,0,0,0
1149900,True,0,1 user reviews,0,1,1
1149910,True,0,No user reviews,0,0,0
1149930,True,0,2 user reviews,2,0,2
1149940,True,8,Very Positive,112,18,130
1149990,True,0,No user reviews,0,0,0
1150010,True,0,No user reviews,0,0,0
1150020,True,0,No user reviews,0,0,0
1150030,True,5,Mixed,6,6,12
1150031,True,6,Mostly Positive,8,3,11
1150032,True,0,2 user reviews,1,1,2
1150033,True,0,3 user reviews,2,1,3
1150040,True,0,No user reviews,0,0,0
1150050,True,0,6 user reviews,5,1,6
1150060,True,0,No user reviews,0,0,0
1150070,True,0,5 user reviews,5,0,5
1150080,True,6,Mostly Positive,563,200,763
1150090,True,0,No user reviews,0,0,0
1150100,True,0,No user reviews,0,0,0
1150101,True,0,No user reviews,0,0,0
1150102,True,0,No user reviews,0,0,0
1150130,True,0,No user reviews,0,0,0
1150140,True,0,No user reviews,0,0,0
1150150,True,0,No user reviews,0,0,0
1150160,True,0,2 user reviews,1,1,2
1150180,True,0,No user reviews,0,0,0
1150190,True,6,Mostly Positive,31,11,42
1150191,True,0,No user reviews,0,0,0
1150192,True,0,No user reviews,0,0,0
1150194,True,0,No user reviews,0,0,0
1150195,True,0,2 user reviews,2,0,2
1150210,True,0,No user reviews,0,0,0
1150230,True,0,No user reviews,0,0,0
1150240,True,0,No user reviews,0,0,0
1150250,True,0,1 user reviews,1,0,1
1150260,True,0,No user reviews,0,0,0
1150270,True,0,1 user reviews,0,1,1
1150280,True,0,No user reviews,0,0,0
1150290,True,0,No user reviews,0,0,0
1150300,True,0,No user reviews,0,0,0
1150310,True,0,1 user reviews,0,1,1
1150320,True,0,1 user reviews,0,1,1
1150330,True,0,No user reviews,0,0,0
1150370,True,0,1 user reviews,1,0,1
1150380,True,0,4 user reviews,1,3,4
1150390,True,0,No user reviews,0,0,0
1150400,True,0,5 user reviews,5,0,5
1150410,True,0,No user reviews,0,0,0
1150420,True,0,No user reviews,0,0,0
1150460,True,7,Positive,45,2,47
1150480,True,0,2 user reviews,2,0,2
1150500,True,0,9 user reviews,3,6,9
1150540,True,0,1 user reviews,1,0,1
1150550,True,7,Positive,10,0,10
1150580,True,0,2 user reviews,0,2,2
1150590,True,8,Very Positive,279,56,335
1150610,True,0,2 user reviews,2,0,2
1150620,True,6,Mostly Positive,18,6,24
1150640,True,8,Very Positive,395,94,489
1150650,True,0,No user reviews,0,0,0
1150670,True,0,No user reviews,0,0,0
1150680,True,0,1 user reviews,1,0,1
1150690,True,0,No user reviews,0,0,0
1150720,True,8,Very Positive,92,4,96
1150730,True,7,Positive,38,5,43
1150750,True,0,No user reviews,0,0,0
1150760,True,0,No user reviews,0,0,0
1150790,True,0,4 user reviews,3,1,4
1150800,True,0,No user reviews,0,0,0
1150810,True,0,2 user reviews,2,0,2
1150820,True,0,No user reviews,0,0,0
1150830,True,0,No user reviews,0,0,0
1150840,True,0,No user reviews,0,0,0
1150850,True,0,No user reviews,0,0,0
1150860,True,0,No user reviews,0,0,0
1150870,True,0,No user reviews,0,0,0
1150880,True,0,No user reviews,0,0,0
1150890,True,6,Mostly Positive,43,11,54
1150900,True,0,No user reviews,0,0,0
1150910,True,0,No user reviews,0,0,0
1150930,True,0,2 user reviews,2,0,2
1150940,True,0,3 user reviews,3,0,3
1150950,True,8,Very Positive,253,12,265
1150970,True,0,No user reviews,0,0,0
1150990,True,0,No user reviews,0,0,0
1151060,True,0,No user reviews,0,0,0
1151070,True,7,Positive,13,3,16
1151080,True,0,1 user reviews,1,0,1
1151090,True,0,No user reviews,0,0,0
1151100,True,0,No user reviews,0,0,0
1151110,True,5,Mixed,23,10,33
1151120,True,7,Positive,35,8,43
1151130,True,0,No user reviews,0,0,0
1151160,True,0,3 user reviews,2,1,3
1151170,True,6,Mostly Positive,49,21,70
1151180,True,0,2 user reviews,1,1,2
1151200,True,7,Positive,8,2,10
1151250,True,7,Positive,26,3,29
1151270,True,0,No user reviews,0,0,0
1151300,True,0,No user reviews,0,0,0
1151310,True,0,No user reviews,0,0,0
1151320,True,0,No user reviews,0,0,0
1151330,True,0,No user reviews,0,0,0
1151340,True,6,Mostly Positive,4982,1299,6281
1151370,True,0,No user reviews,0,0,0
1151380,True,0,No user reviews,0,0,0
1151390,True,7,Positive,28,1,29
1151400,True,0,3 user reviews,1,2,3
1151410,True,0,No user reviews,0,0,0
1151420,True,0,No user reviews,0,0,0
1151430,True,0,2 user reviews,2,0,2
1151440,True,8,Very Positive,63,0,63
1151460,True,0,No user reviews,0,0,0
1151480,True,0,No user reviews,0,0,0
1151500,True,0,No user reviews,0,0,0
1151540,True,0,No user reviews,0,0,0
1151550,True,0,No user reviews,0,0,0
1151570,True,0,No user reviews,0,0,0
1151580,True,0,1 user reviews,1,0,1
1151590,True,0,No user reviews,0,0,0
1151600,True,0,4 user reviews,4,0,4
1151610,True,0,No user reviews,0,0,0
1151620,True,0,No user reviews,0,0,0
1151630,True,7,Positive,8,2,10
1151640,True,6,Mostly Positive,10883,3280,14163
1151650,True,0,3 user reviews,3,0,3
1151660,True,0,No user reviews,0,0,0
1151661,True,0,No user reviews,0,0,0
1151670,True,0,3 user reviews,2,1,3
1151680,True,7,Positive,12,0,12
1151700,True,5,Mixed,190,87,277
1151710,True,0,No user reviews,0,0,0
1151720,True,0,No user reviews,0,0,0
1151730,True,0,8 user reviews,6,2,8
1151740,True,7,Positive,22,1,23
1151750,True,0,9 user reviews,6,3,9
1151770,True,0,2 user reviews,1,1,2
1151790,True,0,No user reviews,0,0,0
1151820,True,0,No user reviews,0,0,0
1151840,True,0,4 user reviews,3,1,4
1151850,True,0,No user reviews,0,0,0
1151860,True,0,No user reviews,0,0,0
1151880,True,0,No user reviews,0,0,0
1151910,True,0,1 user reviews,1,0,1
1151920,True,0,No user reviews,0,0,0
1151930,True,0,No user reviews,0,0,0
1151940,True,0,1 user reviews,1,0,1
1151950,True,0,1 user reviews,0,1,1
1151960,True,0,No user reviews,0,0,0
1151970,True,0,No user reviews,0,0,0
1151980,True,0,No user reviews,0,0,0
1152000,True,0,No user reviews,0,0,0
1152010,True,0,No user reviews,0,0,0
1152011,True,0,No user reviews,0,0,0
1152012,True,0,No user reviews,0,0,0
1152020,True,7,Positive,28,6,34
1152030,True,0,No user reviews,0,0,0
1152040,True,0,2 user reviews,2,0,2
1152050,True,0,7 user reviews,4,3,7
1152060,True,0,No user reviews,0,0,0
1152090,True,8,Very Positive,87,17,104
1152100,True,0,No user reviews,0,0,0
1152130,True,0,No user reviews,0,0,0
1152160,True,6,Mostly Positive,10,4,14
1152170,True,0,No user reviews,0,0,0
1152200,True,0,No user reviews,0,0,0
1152210,True,0,No user reviews,0,0,0
1152230,True,0,No user reviews,0,0,0
1152250,True,0,No user reviews,0,0,0
1152260,True,0,No user reviews,0,0,0
1152280,True,0,No user reviews,0,0,0
1152300,True,7,Positive,31,3,34
1152310,True,7,Positive,15,2,17
1152320,True,7,Positive,10,1,11
1152330,True,0,No user reviews,0,0,0
1152340,True,0,No user reviews,0,0,0
1152350,True,0,No user reviews,0,0,0
1152360,True,0,5 user reviews,3,2,5
1152380,True,0,No user reviews,0,0,0
1152390,True,0,No user reviews,0,0,0
1152410,True,7,Positive,11,2,13
1152420,True,7,Positive,12,1,13
1152440,True,5,Mixed,8,4,12
1152450,True,0,9 user reviews,9,0,9
1152480,True,0,No user reviews,0,0,0
1152520,True,0,No user reviews,0,0,0
1152530,True,0,No user reviews,0,0,0
1152540,True,0,1 user reviews,0,1,1
1152550,True,0,1 user reviews,1,0,1
1152560,True,0,1 user reviews,0,1,1
1152570,True,0,No user reviews,0,0,0
1152580,True,7,Positive,12,0,12
1152620,True,0,No user reviews,0,0,0
1152640,True,0,1 user reviews,1,0,1
1152660,True,0,No user reviews,0,0,0
1152670,True,0,5 user reviews,5,0,5
1152680,True,0,No user reviews,0,0,0
1152700,True,0,2 user reviews,0,2,2
1152710,True,0,No user reviews,0,0,0
1152730,True,0,No user reviews,0,0,0
1152740,True,0,No user reviews,0,0,0
1152760,True,0,No user reviews,0,0,0
1152800,True,0,No user reviews,0,0,0
1152810,True,0,2 user reviews,1,1,2
1152820,True,0,3 user reviews,3,0,3
1152830,True,0,1 user reviews,1,0,1
1152840,True,0,3 user reviews,3,0,3
1152850,True,0,No user reviews,0,0,0
1152860,True,0,No user reviews,0,0,0
1152870,True,0,No user reviews,0,0,0
1152890,True,0,No user reviews,0,0,0
1152900,True,0,4 user reviews,4,0,4
1152910,True,0,No user reviews,0,0,0
1152920,True,0,1 user reviews,1,0,1
1152930,True,0,No user reviews,0,0,0
1152940,True,0,No user reviews,0,0,0
1152950,True,0,No user reviews,0,0,0
1152960,True,0,No user reviews,0,0,0
1152990,True,0,No user reviews,0,0,0
1153020,True,0,No user reviews,0,0,0
1153021,True,0,No user reviews,0,0,0
1153030,True,0,No user reviews,0,0,0
1153050,True,0,No user reviews,0,0,0
1153060,True,0,No user reviews,0,0,0
1153070,True,0,8 user reviews,6,2,8
1153100,True,0,No user reviews,0,0,0
1153110,True,0,2 user reviews,1,1,2
1153120,True,0,No user reviews,0,0,0
1153130,True,0,No user reviews,0,0,0
1153170,True,0,No user reviews,0,0,0
1153180,True,0,No user reviews,0,0,0
1153200,True,7,Positive,20,1,21
1153220,True,0,1 user reviews,1,0,1
1153230,True,0,No user reviews,0,0,0
1153240,True,0,No user reviews,0,0,0
1153250,True,0,8 user reviews,4,4,8
1153260,True,0,No user reviews,0,0,0
1153270,True,0,No user reviews,0,0,0
1153290,True,0,No user reviews,0,0,0
1153300,True,0,No user reviews,0,0,0
1153320,True,0,No user reviews,0,0,0
1153330,True,0,2 user reviews,2,0,2
1153340,True,0,No user reviews,0,0,0
1153350,True,0,No user reviews,0,0,0
1153351,True,0,1 user reviews,1,0,1
1153352,True,0,No user reviews,0,0,0
1153353,True,0,1 user reviews,1,0,1
1153360,True,0,No user reviews,0,0,0
1153370,True,0,No user reviews,0,0,0
1153420,True,0,1 user reviews,1,0,1
1153421,True,0,No user reviews,0,0,0
1153422,True,0,No user reviews,0,0,0
1153423,True,0,No user reviews,0,0,0
1153430,True,8,Very Positive,61,13,74
1153440,True,0,No user reviews,0,0,0
1153441,True,0,No user reviews,0,0,0
1153442,True,0,No user reviews,0,0,0
1153443,True,0,2 user reviews,1,1,2
1153460,True,7,Positive,10,1,11
1153470,True,0,4 user reviews,3,1,4
1153490,True,0,No user reviews,0,0,0
1153500,True,0,No user reviews,0,0,0
1153510,True,0,No user reviews,0,0,0
1153520,True,0,No user reviews,0,0,0
1153530,True,0,No user reviews,0,0,0
1153540,True,7,Positive,16,3,19
1153550,True,0,1 user reviews,0,1,1
1153560,True,0,No user reviews,0,0,0
1153570,True,0,No user reviews,0,0,0
1153580,True,0,No user reviews,0,0,0
1153600,True,0,1 user reviews,1,0,1
1153620,True,0,No user reviews,0,0,0
1153630,True,0,3 user reviews,3,0,3
1153640,True,0,No user reviews,0,0,0
1153650,True,0,No user reviews,0,0,0
1153660,True,0,No user reviews,0,0,0
1153670,True,0,8 user reviews,8,0,8
1153680,True,0,1 user reviews,0,1,1
1153690,True,0,3 user reviews,2,1,3
1153700,True,0,1 user reviews,0,1,1
1153710,True,0,No user reviews,0,0,0
1153720,True,0,No user reviews,0,0,0
1153730,True,0,2 user reviews,0,2,2
1153750,True,0,No user reviews,0,0,0
1153770,True,0,No user reviews,0,0,0
1153810,True,0,No user reviews,0,0,0
1153820,True,0,No user reviews,0,0,0
1153840,True,0,1 user reviews,1,0,1
1153860,True,0,2 user reviews,0,2,2
1153870,True,0,No user reviews,0,0,0
1153880,True,0,No user reviews,0,0,0
1153890,True,0,6 user reviews,0,6,6
1153920,True,0,No user reviews,0,0,0
1153930,True,0,2 user reviews,1,1,2
1153950,True,0,5 user reviews,3,2,5
1153960,True,0,No user reviews,0,0,0
1153970,True,0,No user reviews,0,0,0
1153980,True,7,Positive,13,0,13
1153990,True,0,2 user reviews,1,1,2
1154000,True,0,No user reviews,0,0,0
1154010,True,0,1 user reviews,0,1,1
1154040,True,0,No user reviews,0,0,0
1154060,True,0,1 user reviews,1,0,1
1154070,True,0,No user reviews,0,0,0
1154080,True,6,Mostly Positive,35,9,44
1154090,True,0,No user reviews,0,0,0
1154110,True,8,Very Positive,54,11,65
1154120,True,0,No user reviews,0,0,0
1154130,True,0,No user reviews,0,0,0
1154150,True,0,No user reviews,0,0,0
1154160,True,0,No user reviews,0,0,0
1154170,True,0,6 user reviews,4,2,6
1154190,True,0,No user reviews,0,0,0
1154200,True,0,No user reviews,0,0,0
1154210,True,0,1 user reviews,0,1,1
1154280,True,0,No user reviews,0,0,0
1154290,True,0,No user reviews,0,0,0
1154300,True,7,Positive,12,0,12
1154310,True,0,No user reviews,0,0,0
1154311,True,0,4 user reviews,2,2,4
1154320,True,6,Mostly Positive,26,7,33
1154340,True,0,4 user reviews,4,0,4
1154350,True,0,No user reviews,0,0,0
1154360,True,0,No user reviews,0,0,0
1154420,True,0,No user reviews,0,0,0
1154430,True,0,No user reviews,0,0,0
1154440,True,0,6 user reviews,6,0,6
1154470,True,0,No user reviews,0,0,0
1154480,True,0,3 user reviews,2,1,3
1154490,True,0,2 user reviews,2,0,2
1154500,True,0,No user reviews,0,0,0
1154540,True,0,No user reviews,0,0,0
1154560,True,0,1 user reviews,0,1,1
1154570,True,0,No user reviews,0,0,0
1154591,True,7,Positive,11,0,11
1154600,True,0,No user reviews,0,0,0
1154620,True,0,No user reviews,0,0,0
1154640,True,0,1 user reviews,1,0,1
1154650,True,0,6 user reviews,4,2,6
1154670,True,0,No user reviews,0,0,0
1154680,True,0,6 user reviews,5,1,6
1154700,True,0,8 user reviews,6,2,8
1154710,True,0,No user reviews,0,0,0
1154720,True,5,Mixed,9,5,14
1154730,True,5,Mixed,6,5,11
1154760,True,5,Mixed,178,81,259
1154770,True,0,5 user reviews,4,1,5
1154780,True,6,Mostly Positive,17,5,22
1154790,True,0,No user reviews,0,0,0
1154800,True,0,No user reviews,0,0,0
1154810,True,8,Very Positive,200,13,213
1154820,True,0,No user reviews,0,0,0
1154830,True,0,No user reviews,0,0,0
1154840,True,0,No user reviews,0,0,0
1154850,True,8,Very Positive,154,11,165
1154860,True,0,No user reviews,0,0,0
1154940,True,0,7 user reviews,6,1,7
1154970,True,0,No user reviews,0,0,0
1154990,True,5,Mixed,6,5,11
1155010,True,0,No user reviews,0,0,0
1155030,True,0,2 user reviews,2,0,2
1155040,True,0,No user reviews,0,0,0
1155041,True,0,No user reviews,0,0,0
1155050,True,0,No user reviews,0,0,0
1155070,True,0,4 user reviews,4,0,4
1155090,True,0,1 user reviews,1,0,1
1155100,True,0,No user reviews,0,0,0
1155120,True,0,No user reviews,0,0,0
1155130,True,0,4 user reviews,4,0,4
1155140,True,0,No user reviews,0,0,0
1155150,True,0,No user reviews,0,0,0
1155220,True,0,No user reviews,0,0,0
1155230,True,0,2 user reviews,1,1,2
1155240,True,0,No user reviews,0,0,0
1155260,True,0,No user reviews,0,0,0
1155270,True,7,Positive,13,1,14
1155280,True,0,No user reviews,0,0,0
1155290,True,0,1 user reviews,1,0,1
1155320,True,7,Positive,20,3,23
1155340,True,0,2 user reviews,2,0,2
1155370,True,0,No user reviews,0,0,0
1155380,True,0,No user reviews,0,0,0
1155381,True,0,No user reviews,0,0,0
1155390,True,0,No user reviews,0,0,0
1155400,True,0,No user reviews,0,0,0
1155410,True,0,8 user reviews,7,1,8
1155420,True,0,5 user reviews,3,2,5
1155430,True,0,4 user reviews,3,1,4
1155440,True,0,2 user reviews,1,1,2
1155460,True,5,Mixed,8,7,15
1155470,True,0,No user reviews,0,0,0
1155480,True,0,4 user reviews,1,3,4
1155490,True,0,2 user reviews,0,2,2
1155500,True,0,2 user reviews,0,2,2
1155510,True,0,No user reviews,0,0,0
1155530,True,0,No user reviews,0,0,0
1155540,True,0,No user reviews,0,0,0
1155560,True,0,2 user reviews,2,0,2
1155580,True,0,No user reviews,0,0,0
1155590,True,0,No user reviews,0,0,0
1155600,True,0,No user reviews,0,0,0
1155620,True,0,2 user reviews,1,1,2
1155650,True,0,No user reviews,0,0,0
1155660,True,7,Positive,19,1,20
1155670,True,0,3 user reviews,2,1,3
1155680,True,0,4 user reviews,1,3,4
1155700,True,7,Positive,31,7,38
1155720,True,7,Positive,29,1,30
1155730,True,0,No user reviews,0,0,0
1155740,True,0,No user reviews,0,0,0
1155760,True,0,9 user reviews,5,4,9
1155780,True,0,No user reviews,0,0,0
1155790,True,0,5 user reviews,5,0,5
1155800,True,0,3 user reviews,2,1,3
1155810,True,0,4 user reviews,2,2,4
1155830,True,7,Positive,17,4,21
1155840,True,0,No user reviews,0,0,0
1155850,True,0,No user reviews,0,0,0
1155860,True,0,No user reviews,0,0,0
1155870,True,0,No user reviews,0,0,0
1155880,True,5,Mixed,24,15,39
1155900,True,0,No user reviews,0,0,0
1155910,True,0,1 user reviews,0,1,1
1155920,True,0,2 user reviews,0,2,2
1155930,True,0,1 user reviews,1,0,1
1155940,True,0,8 user reviews,7,1,8
1155950,True,0,2 user reviews,0,2,2
1155960,True,0,4 user reviews,4,0,4
1155970,True,0,No user reviews,0,0,0
1155980,True,0,5 user reviews,4,1,5
1155990,True,0,6 user reviews,4,2,6
1156000,True,8,Very Positive,55,5,60
1156030,True,0,2 user reviews,0,2,2
1156050,True,0,9 user reviews,5,4,9
1156120,True,0,No user reviews,0,0,0
1156130,True,0,1 user reviews,0,1,1
1156140,True,0,No user reviews,0,0,0
1156150,True,0,No user reviews,0,0,0
1156160,True,0,1 user reviews,1,0,1
1156200,True,0,1 user reviews,0,1,1
1156240,True,0,No user reviews,0,0,0
1156250,True,7,Positive,30,5,35
1156260,True,0,No user reviews,0,0,0
1156270,True,0,No user reviews,0,0,0
1156271,True,0,No user reviews,0,0,0
1156272,True,0,No user reviews,0,0,0
1156273,True,0,No user reviews,0,0,0
1156280,True,0,No user reviews,0,0,0
1156290,True,0,No user reviews,0,0,0
1156310,True,0,No user reviews,0,0,0
1156320,True,0,No user reviews,0,0,0
1156330,True,0,No user reviews,0,0,0
1156340,True,0,No user reviews,0,0,0
1156350,True,0,No user reviews,0,0,0
1156360,True,7,Positive,45,2,47
1156380,True,0,No user reviews,0,0,0
1156390,True,0,No user reviews,0,0,0
1156420,True,0,1 user reviews,0,1,1
1156450,True,0,No user reviews,0,0,0
1156470,True,0,No user reviews,0,0,0
1156480,True,0,No user reviews,0,0,0
1156490,True,0,No user reviews,0,0,0
1156500,True,0,No user reviews,0,0,0
1156510,True,0,No user reviews,0,0,0
1156540,True,0,No user reviews,0,0,0
1156550,True,0,6 user reviews,5,1,6
1156560,True,0,No user reviews,0,0,0
1156570,True,0,No user reviews,0,0,0
1156590,True,7,Positive,36,7,43
1156610,True,0,No user reviews,0,0,0
1156630,True,7,Positive,10,1,11
1156640,True,0,1 user reviews,1,0,1
1156650,True,0,2 user reviews,1,1,2
1156660,True,0,No user reviews,0,0,0
1156670,True,0,6 user reviews,5,1,6
1156680,True,0,3 user reviews,2,1,3
1156700,True,0,No user reviews,0,0,0
1156710,True,0,4 user reviews,4,0,4
1156720,True,0,No user reviews,0,0,0
1156730,True,5,Mixed,12,7,19
1156740,True,0,1 user reviews,1,0,1
1156760,True,0,No user reviews,0,0,0
1156770,True,0,No user reviews,0,0,0
1156780,True,0,2 user reviews,2,0,2
1156810,True,0,1 user reviews,0,1,1
1156830,True,0,No user reviews,0,0,0
1156850,True,0,No user reviews,0,0,0
1156900,True,0,1 user reviews,1,0,1
1156910,True,0,2 user reviews,0,2,2
1156950,True,0,No user reviews,0,0,0
1156960,True,0,1 user reviews,1,0,1
1156970,True,0,No user reviews,0,0,0
1156980,True,0,4 user reviews,3,1,4
1156990,True,0,6 user reviews,6,0,6
1157010,True,0,4 user reviews,4,0,4
1157020,True,0,No user reviews,0,0,0
1157030,True,0,No user reviews,0,0,0
1157040,True,0,3 user reviews,2,1,3
1157050,True,0,No user reviews,0,0,0
1157060,True,0,No user reviews,0,0,0
1157070,True,0,No user reviews,0,0,0
1157080,True,0,2 user reviews,1,1,2
1157090,True,0,No user reviews,0,0,0
1157100,True,0,No user reviews,0,0,0
1157120,True,0,1 user reviews,0,1,1
1157130,True,0,No user reviews,0,0,0
1157140,True,0,No user reviews,0,0,0
1157160,True,0,No user reviews,0,0,0
1157161,True,0,No user reviews,0,0,0
1157162,True,0,No user reviews,0,0,0
1157163,True,0,No user reviews,0,0,0
1157170,True,0,9 user reviews,7,2,9
1157190,True,0,No user reviews,0,0,0
1157200,True,0,No user reviews,0,0,0
1157210,True,0,No user reviews,0,0,0
1157220,True,0,No user reviews,0,0,0
1157230,True,0,4 user reviews,4,0,4
1157240,True,0,No user reviews,0,0,0
1157250,True,0,No user reviews,0,0,0
1157260,True,0,7 user reviews,7,0,7
1157300,True,0,9 user reviews,9,0,9
1157310,True,0,5 user reviews,5,0,5
1157320,True,0,2 user reviews,2,0,2
1157330,True,0,No user reviews,0,0,0
1157340,True,6,Mostly Positive,201,53,254
1157350,True,0,2 user reviews,0,2,2
1157360,True,0,No user reviews,0,0,0
1157370,True,0,No user reviews,0,0,0
1157390,True,0,No user reviews,0,0,0
1157430,True,0,No user reviews,0,0,0
1157440,True,0,No user reviews,0,0,0
1157450,True,0,No user reviews,0,0,0
1157460,True,0,No user reviews,0,0,0
1157470,True,0,No user reviews,0,0,0
1157480,True,0,1 user reviews,0,1,1
1157490,True,0,No user reviews,0,0,0
1157520,True,0,No user reviews,0,0,0
1157530,True,0,No user reviews,0,0,0
1157540,True,0,No user reviews,0,0,0
1157550,True,8,Very Positive,53,7,60
1157560,True,0,No user reviews,0,0,0
1157590,True,0,No user reviews,0,0,0
1157600,True,0,No user reviews,0,0,0
1157620,True,6,Mostly Positive,14,6,20
1157640,True,6,Mostly Positive,18,5,23
1157650,True,0,3 user reviews,3,0,3
1157690,True,0,No user reviews,0,0,0
1157730,True,7,Positive,11,0,11
1157731,True,0,4 user reviews,4,0,4
1157732,True,0,4 user reviews,4,0,4
1157740,True,0,No user reviews,0,0,0
1157750,True,7,Positive,26,6,32
1157760,True,0,No user reviews,0,0,0
1157770,True,0,No user reviews,0,0,0
1157780,True,0,2 user reviews,2,0,2
1157790,True,5,Mixed,13,6,19
1157800,True,0,No user reviews,0,0,0
1157810,True,0,6 user reviews,6,0,6
1157820,True,0,1 user reviews,1,0,1
1157830,True,0,No user reviews,0,0,0
1157840,True,0,No user reviews,0,0,0
1157850,True,0,1 user reviews,1,0,1
1157860,True,0,No user reviews,0,0,0
1157870,True,0,No user reviews,0,0,0
1157880,True,0,No user reviews,0,0,0
1157890,True,0,1 user reviews,0,1,1
1157900,True,0,No user reviews,0,0,0
1157910,True,0,4 user reviews,4,0,4
1157920,True,0,No user reviews,0,0,0
1157940,True,5,Mixed,28,15,43
1157950,True,0,No user reviews,0,0,0
1157960,True,0,No user reviews,0,0,0
1157980,True,0,1 user reviews,1,0,1
1158000,True,0,No user reviews,0,0,0
1158010,True,6,Mostly Positive,16,5,21
1158040,True,0,No user reviews,0,0,0
1158080,True,0,No user reviews,0,0,0
1158100,True,4,Mostly Negative,277,429,706
1158110,True,0,No user reviews,0,0,0
1158111,True,0,1 user reviews,0,1,1
1158120,True,0,5 user reviews,4,1,5
1158130,True,0,1 user reviews,0,1,1
1158150,True,0,2 user reviews,2,0,2
1158160,True,0,No user reviews,0,0,0
1158180,True,6,Mostly Positive,158,52,210
1158181,True,0,No user reviews,0,0,0
1158190,True,0,No user reviews,0,0,0
1158200,True,0,8 user reviews,5,3,8
1158210,True,0,1 user reviews,1,0,1
1158220,True,0,No user reviews,0,0,0
1158230,True,0,1 user reviews,0,1,1
1158240,True,0,2 user reviews,2,0,2
1158241,True,0,No user reviews,0,0,0
1158260,True,7,Positive,10,0,10
1158270,True,0,4 user reviews,3,1,4
1158280,True,7,Positive,43,5,48
1158290,True,7,Positive,36,1,37
1158310,True,8,Very Positive,10448,842,11290
1158320,True,7,Positive,12,3,15
1158330,True,0,No user reviews,0,0,0
1158340,True,0,No user reviews,0,0,0
1158370,True,0,No user reviews,0,0,0
1158390,True,0,1 user reviews,0,1,1
1158410,True,7,Positive,10,0,10
1158420,True,0,No user reviews,0,0,0
1158430,True,0,2 user reviews,0,2,2
1158440,True,0,No user reviews,0,0,0
1158441,True,0,No user reviews,0,0,0
1158450,True,0,No user reviews,0,0,0
1158460,True,0,No user reviews,0,0,0
1158470,True,8,Very Positive,103,2,105
1158480,True,0,No user reviews,0,0,0
1158490,True,0,5 user reviews,4,1,5
1158500,True,5,Mixed,7,5,12
1158530,True,0,No user reviews,0,0,0
1158540,True,0,No user reviews,0,0,0
1158550,True,0,No user reviews,0,0,0
1158560,True,0,No user reviews,0,0,0
1158590,True,0,5 user reviews,0,5,5
1158600,True,0,No user reviews,0,0,0
1158620,True,0,No user reviews,0,0,0
1158640,True,0,No user reviews,0,0,0
1158650,True,0,1 user reviews,0,1,1
1158660,True,8,Very Positive,59,8,67
1158670,True,0,No user reviews,0,0,0
1158680,True,0,No user reviews,0,0,0
1158690,True,8,Very Positive,54,12,66
1158730,True,4,Mostly Negative,17,48,65
1158740,True,0,No user reviews,0,0,0
1158750,True,0,No user reviews,0,0,0
1158770,True,0,No user reviews,0,0,0
1158780,True,0,1 user reviews,1,0,1
1158790,True,0,No user reviews,0,0,0
1158800,True,0,No user reviews,0,0,0
1158820,True,0,No user reviews,0,0,0
1158830,True,0,1 user reviews,1,0,1
1158840,True,0,No user reviews,0,0,0
1158860,True,0,No user reviews,0,0,0
1158870,True,0,No user reviews,0,0,0
1158890,True,0,No user reviews,0,0,0
1158900,True,0,No user reviews,0,0,0
1158910,True,0,6 user reviews,5,1,6
1158930,True,0,No user reviews,0,0,0
1158940,True,8,Very Positive,132,30,162
1158960,True,0,No user reviews,0,0,0
1158970,True,6,Mostly Positive,14,4,18
1158980,True,0,No user reviews,0,0,0
1158990,True,0,No user reviews,0,0,0
1159000,True,0,No user reviews,0,0,0
1159010,True,0,2 user reviews,0,2,2
1159020,True,0,2 user reviews,1,1,2
1159030,True,0,8 user reviews,7,1,8
1159040,True,0,1 user reviews,0,1,1
1159050,True,0,No user reviews,0,0,0
1159060,True,4,Mostly Negative,10,25,35
1159070,True,0,No user reviews,0,0,0
1159090,True,0,No user reviews,0,0,0
1159100,True,0,No user reviews,0,0,0
1159110,True,0,No user reviews,0,0,0
1159130,True,0,1 user reviews,1,0,1
1159140,True,0,No user reviews,0,0,0
1159150,True,0,No user reviews,0,0,0
1159160,True,0,No user reviews,0,0,0
1159200,True,0,1 user reviews,1,0,1
1159240,True,0,No user reviews,0,0,0
1159260,True,0,No user reviews,0,0,0
1159270,True,0,No user reviews,0,0,0
1159280,True,0,No user reviews,0,0,0
1159290,True,0,No user reviews,0,0,0
1159310,True,0,1 user reviews,1,0,1
1159311,True,0,No user reviews,0,0,0
1159312,True,0,No user reviews,0,0,0
1159313,True,0,No user reviews,0,0,0
1159314,True,0,No user reviews,0,0,0
1159315,True,0,No user reviews,0,0,0
1159316,True,0,1 user reviews,1,0,1
1159320,True,0,No user reviews,0,0,0
1159321,True,0,No user reviews,0,0,0
1159322,True,0,No user reviews,0,0,0
1159323,True,0,2 user reviews,2,0,2
1159324,True,0,No user reviews,0,0,0
1159325,True,0,1 user reviews,1,0,1
1159326,True,0,No user reviews,0,0,0
1159327,True,0,No user reviews,0,0,0
1159328,True,0,No user reviews,0,0,0
1159329,True,0,2 user reviews,1,1,2
1159340,True,0,No user reviews,0,0,0
1159350,True,0,No user reviews,0,0,0
1159360,True,0,1 user reviews,1,0,1
1159380,True,0,No user reviews,0,0,0
1159390,True,0,No user reviews,0,0,0
1159430,True,0,No user reviews,0,0,0
1159450,True,7,Positive,14,1,15
1159480,True,0,1 user reviews,1,0,1
1159490,True,0,No user reviews,0,0,0
1159500,True,7,Positive,13,1,14
1159510,True,0,8 user reviews,5,3,8
1159520,True,6,Mostly Positive,69,22,91
1159530,True,0,1 user reviews,1,0,1
1159540,True,6,Mostly Positive,12,4,16
1159550,True,0,No user reviews,0,0,0
1159560,True,8,Very Positive,76,2,78
1159570,True,0,No user reviews,0,0,0
1159580,True,0,2 user reviews,1,1,2
1159590,True,0,3 user reviews,0,3,3
1159610,True,0,3 user reviews,3,0,3
1159620,True,0,No user reviews,0,0,0
1159640,True,8,Very Positive,371,61,432
1159660,True,0,No user reviews,0,0,0
1159670,True,0,No user reviews,0,0,0
1159680,True,0,9 user reviews,9,0,9
1159690,True,0,No user reviews,0,0,0
1159700,True,3,Negative,3,21,24
1159770,True,0,1 user reviews,1,0,1
1159830,True,0,No user reviews,0,0,0
1159850,True,0,No user reviews,0,0,0
1159860,True,0,No user reviews,0,0,0
1159870,True,0,No user reviews,0,0,0
1159880,True,0,No user reviews,0,0,0
1159890,True,0,1 user reviews,1,0,1
1159900,True,0,No user reviews,0,0,0
1159910,True,0,No user reviews,0,0,0
1159920,True,0,1 user reviews,0,1,1
1159930,True,0,No user reviews,0,0,0
1159940,True,0,No user reviews,0,0,0
1159970,True,0,No user reviews,0,0,0
1160000,True,0,No user reviews,0,0,0
1160010,True,0,No user reviews,0,0,0
1160020,True,7,Positive,13,1,14
1160040,True,0,No user reviews,0,0,0
1160050,True,0,4 user reviews,2,2,4
1160060,True,0,No user reviews,0,0,0
1160100,True,0,2 user reviews,2,0,2
1160140,True,0,1 user reviews,0,1,1
1160160,True,0,No user reviews,0,0,0
1160170,True,0,No user reviews,0,0,0
1160190,True,0,1 user reviews,1,0,1
1160220,True,8,Very Positive,288,10,298
1160230,True,0,No user reviews,0,0,0
1160243,True,7,Positive,8,2,10
1160300,True,0,No user reviews,0,0,0
1160330,True,8,Very Positive,140,3,143
1160350,True,0,No user reviews,0,0,0
1160360,True,5,Mixed,49,35,84
1160390,True,0,1 user reviews,1,0,1
1160420,True,0,No user reviews,0,0,0
1160430,True,0,No user reviews,0,0,0
1160440,True,0,7 user reviews,7,0,7
1160480,True,0,6 user reviews,1,5,6
1160490,True,8,Very Positive,196,2,198
1160500,True,0,9 user reviews,5,4,9
1160510,True,0,No user reviews,0,0,0
1160520,True,0,No user reviews,0,0,0
1160550,True,0,No user reviews,0,0,0
1160560,True,0,No user reviews,0,0,0
1160580,True,0,7 user reviews,4,3,7
1160600,True,0,No user reviews,0,0,0
1160601,True,0,No user reviews,0,0,0
1160602,True,0,No user reviews,0,0,0
1160603,True,0,No user reviews,0,0,0
1160610,True,0,1 user reviews,1,0,1
1160620,True,0,4 user reviews,4,0,4
1160660,True,0,No user reviews,0,0,0
1160661,True,0,No user reviews,0,0,0
1160662,True,0,No user reviews,0,0,0
1160663,True,0,No user reviews,0,0,0
1160670,True,0,3 user reviews,3,0,3
1160690,True,0,No user reviews,0,0,0
1160700,True,7,Positive,13,0,13
1160710,True,0,No user reviews,0,0,0
1160730,True,0,No user reviews,0,0,0
1160750,True,0,No user reviews,0,0,0
1160760,True,0,1 user reviews,1,0,1
1160770,True,0,No user reviews,0,0,0
1160780,True,0,2 user reviews,1,1,2
1160790,True,0,3 user reviews,3,0,3
1160800,True,0,1 user reviews,1,0,1
1160820,True,0,7 user reviews,7,0,7
1160830,True,0,No user reviews,0,0,0
1160850,True,0,No user reviews,0,0,0
1160870,True,0,7 user reviews,7,0,7
1160880,True,0,9 user reviews,7,2,9
1160900,True,0,2 user reviews,1,1,2
1160920,True,0,No user reviews,0,0,0
1160930,True,0,1 user reviews,0,1,1
1160950,True,5,Mixed,14,7,21
1160960,True,0,No user reviews,0,0,0
1160970,True,0,No user reviews,0,0,0
1160980,True,0,1 user reviews,1,0,1
1160990,True,0,No user reviews,0,0,0
1161000,True,0,No user reviews,0,0,0
1161020,True,0,No user reviews,0,0,0
1161110,True,0,No user reviews,0,0,0
1161120,True,0,1 user reviews,1,0,1
1161140,True,0,No user reviews,0,0,0
1161160,True,0,No user reviews,0,0,0
1161170,True,0,No user reviews,0,0,0
1161180,True,0,8 user reviews,8,0,8
1161190,True,0,3 user reviews,3,0,3
1161200,True,0,No user reviews,0,0,0
1161210,True,0,No user reviews,0,0,0
1161220,True,0,No user reviews,0,0,0
1161230,True,0,No user reviews,0,0,0
1161270,True,5,Mixed,23,11,34
1161290,True,0,No user reviews,0,0,0
1161300,True,0,1 user reviews,1,0,1
1161310,True,0,No user reviews,0,0,0
1161320,True,0,3 user reviews,0,3,3
1161330,True,0,1 user reviews,1,0,1
1161340,True,0,No user reviews,0,0,0
1161350,True,0,No user reviews,0,0,0
1161360,True,7,Positive,15,0,15
1161370,True,0,2 user reviews,2,0,2
1161380,True,0,No user reviews,0,0,0
1161390,True,0,No user reviews,0,0,0
1161410,True,0,7 user reviews,6,1,7
1161420,True,0,7 user reviews,5,2,7
1161421,True,7,Positive,13,3,16
1161430,True,0,No user reviews,0,0,0
1161440,True,0,2 user reviews,0,2,2
1161450,True,0,No user reviews,0,0,0
1161460,True,0,No user reviews,0,0,0
1161470,True,0,No user reviews,0,0,0
1161490,True,8,Very Positive,488,64,552
1161510,True,0,2 user reviews,2,0,2
1161530,True,0,No user reviews,0,0,0
1161550,True,0,No user reviews,0,0,0
1161560,True,0,No user reviews,0,0,0
1161561,True,0,No user reviews,0,0,0
1161570,True,6,Mostly Positive,10,3,13
1161580,True,8,Very Positive,4004,362,4366
1161600,True,0,1 user reviews,1,0,1
1161601,True,0,2 user reviews,1,1,2
1161602,True,0,1 user reviews,1,0,1
1161603,True,0,1 user reviews,1,0,1
1161610,True,0,No user reviews,0,0,0
1161650,True,7,Positive,16,1,17
1161660,True,0,2 user reviews,2,0,2
1161670,True,0,1 user reviews,1,0,1
1161680,True,0,1 user reviews,1,0,1
1161690,True,0,No user reviews,0,0,0
1161740,True,0,No user reviews,0,0,0
1161770,True,0,No user reviews,0,0,0
1161780,True,0,No user reviews,0,0,0
1161800,True,0,No user reviews,0,0,0
1161810,True,0,No user reviews,0,0,0
1161820,True,0,No user reviews,0,0,0
1161840,True,0,No user reviews,0,0,0
1161850,True,0,No user reviews,0,0,0
1161870,True,0,4 user reviews,4,0,4
1161880,True,7,Positive,39,2,41
1161900,True,0,8 user reviews,3,5,8
1161910,True,0,3 user reviews,3,0,3
1161920,True,0,No user reviews,0,0,0
1161930,True,0,1 user reviews,1,0,1
1161940,True,0,No user reviews,0,0,0
1161950,True,0,No user reviews,0,0,0
1161960,True,0,No user reviews,0,0,0
1161970,True,0,No user reviews,0,0,0
1161980,True,0,No user reviews,0,0,0
1161990,True,0,No user reviews,0,0,0
1162000,True,0,No user reviews,0,0,0
1162010,True,0,1 user reviews,1,0,1
1162040,True,0,No user reviews,0,0,0
1162050,True,7,Positive,8,2,10
1162060,True,0,No user reviews,0,0,0
1162070,True,7,Positive,35,2,37
1162080,True,0,No user reviews,0,0,0
1162100,True,0,No user reviews,0,0,0
1162110,True,0,6 user reviews,6,0,6
1162130,True,5,Mixed,150,101,251
1162160,True,8,Very Positive,71,0,71
1162170,True,5,Mixed,16,7,23
1162180,True,0,No user reviews,0,0,0
1162190,True,0,No user reviews,0,0,0
1162200,True,7,Positive,19,2,21
1162201,True,4,Mostly Negative,4,12,16
1162202,True,7,Positive,14,1,15
1162203,True,3,Negative,4,19,23
1162204,True,7,Positive,13,0,13
1162205,True,0,5 user reviews,4,1,5
1162208,True,7,Positive,27,3,30
1162210,True,0,No user reviews,0,0,0
1162230,True,4,Mostly Negative,3,7,10
1162260,True,0,No user reviews,0,0,0
1162270,True,0,No user reviews,0,0,0
1162280,True,7,Positive,14,0,14
1162290,True,0,3 user reviews,0,3,3
1162310,True,0,No user reviews,0,0,0
1162320,True,0,4 user reviews,4,0,4
1162330,True,0,No user reviews,0,0,0
1162340,True,7,Positive,8,2,10
1162341,True,0,3 user reviews,3,0,3
1162342,True,0,8 user reviews,5,3,8
1162350,True,7,Positive,17,2,19
1162360,True,0,No user reviews,0,0,0
1162370,True,0,No user reviews,0,0,0
1162380,True,7,Positive,48,0,48
1162390,True,0,No user reviews,0,0,0
1162400,True,0,No user reviews,0,0,0
1162430,True,0,7 user reviews,7,0,7
1162440,True,0,5 user reviews,3,2,5
1162450,True,0,No user reviews,0,0,0
1162451,True,0,No user reviews,0,0,0
1162452,True,0,No user reviews,0,0,0
1162470,True,7,Positive,34,4,38
1162480,True,0,8 user reviews,8,0,8
1162490,True,0,No user reviews,0,0,0
1162520,True,5,Mixed,85,67,152
1162550,True,0,No user reviews,0,0,0
1162560,True,8,Very Positive,132,8,140
1162570,True,0,No user reviews,0,0,0
1162580,True,0,No user reviews,0,0,0
1162590,True,6,Mostly Positive,7,3,10
1162601,True,5,Mixed,32,41,73
1162602,True,4,Mostly Negative,43,83,126
1162630,True,0,No user reviews,0,0,0
1162640,True,0,1 user reviews,1,0,1
1162650,True,0,3 user reviews,3,0,3
1162670,True,5,Mixed,8,8,16
1162680,True,8,Very Positive,150,31,181
1162690,True,0,3 user reviews,2,1,3
1162700,True,0,No user reviews,0,0,0
1162710,True,0,1 user reviews,1,0,1
1162711,True,0,No user reviews,0,0,0
1162712,True,0,No user reviews,0,0,0
1162713,True,0,No user reviews,0,0,0
1162714,True,0,No user reviews,0,0,0
1162715,True,0,No user reviews,0,0,0
1162716,True,0,No user reviews,0,0,0
1162720,True,0,No user reviews,0,0,0
1162721,True,0,No user reviews,0,0,0
1162722,True,0,No user reviews,0,0,0
1162723,True,0,3 user reviews,3,0,3
1162730,True,0,3 user reviews,0,3,3
1162740,True,0,No user reviews,0,0,0
1162750,True,8,Very Positive,127,10,137
1162760,True,0,5 user reviews,5,0,5
1162780,True,0,No user reviews,0,0,0
1162781,True,0,No user reviews,0,0,0
1162782,True,0,No user reviews,0,0,0
1162783,True,0,No user reviews,0,0,0
1162784,True,0,No user reviews,0,0,0
1162785,True,0,No user reviews,0,0,0
1162790,True,0,No user reviews,0,0,0
1162791,True,0,No user reviews,0,0,0
1162792,True,0,No user reviews,0,0,0
1162793,True,0,No user reviews,0,0,0
1162794,True,0,No user reviews,0,0,0
1162795,True,0,No user reviews,0,0,0
1162796,True,0,No user reviews,0,0,0
1162800,True,0,No user reviews,0,0,0
1162801,True,0,No user reviews,0,0,0
1162810,True,0,No user reviews,0,0,0
1162820,True,0,No user reviews,0,0,0
1162870,True,0,No user reviews,0,0,0
1162880,True,0,4 user reviews,2,2,4
1162900,True,0,3 user reviews,2,1,3
1162920,True,0,1 user reviews,1,0,1
1162930,True,0,No user reviews,0,0,0
1162940,True,0,No user reviews,0,0,0
1162950,True,0,2 user reviews,0,2,2
1162960,True,0,No user reviews,0,0,0
1162990,True,0,No user reviews,0,0,0
1163010,True,0,No user reviews,0,0,0
1163020,True,0,No user reviews,0,0,0
1163030,True,0,No user reviews,0,0,0
1163040,True,7,Positive,37,4,41
1163070,True,7,Positive,27,3,30
1163090,True,0,7 user reviews,7,0,7
1163100,True,0,No user reviews,0,0,0
1163110,True,0,No user reviews,0,0,0
1163120,True,0,No user reviews,0,0,0
1163130,True,0,No user reviews,0,0,0
1163140,True,0,1 user reviews,1,0,1
1163150,True,5,Mixed,11,6,17
1163160,True,0,No user reviews,0,0,0
1163170,True,0,3 user reviews,3,0,3
1163180,True,0,No user reviews,0,0,0
1163200,True,0,No user reviews,0,0,0
1163210,True,0,No user reviews,0,0,0
1163220,True,0,No user reviews,0,0,0
1163240,True,0,No user reviews,0,0,0
1163250,True,0,No user reviews,0,0,0
1163280,True,0,No user reviews,0,0,0
1163290,True,0,6 user reviews,4,2,6
1163300,True,0,3 user reviews,1,2,3
1163310,True,0,No user reviews,0,0,0
1163320,True,0,2 user reviews,0,2,2
1163330,True,0,No user reviews,0,0,0
1163340,True,7,Positive,39,8,47
1163350,True,0,No user reviews,0,0,0
1163360,True,0,No user reviews,0,0,0
1163370,True,0,No user reviews,0,0,0
1163390,True,0,No user reviews,0,0,0
1163400,True,0,No user reviews,0,0,0
1163401,True,0,No user reviews,0,0,0
1163402,True,0,No user reviews,0,0,0
1163410,True,0,No user reviews,0,0,0
1163420,True,0,No user reviews,0,0,0
1163450,True,0,No user reviews,0,0,0
1163460,True,5,Mixed,11,6,17
1163470,True,0,3 user reviews,3,0,3
1163480,True,0,No user reviews,0,0,0
1163490,True,0,1 user reviews,0,1,1
1163520,True,0,9 user reviews,4,5,9
1163540,True,0,No user reviews,0,0,0
1163550,True,5,Mixed,289,172,461
1163560,True,0,8 user reviews,6,2,8
1163570,True,0,3 user reviews,3,0,3
1163590,True,8,Very Positive,59,11,70
1163600,True,6,Mostly Positive,38,12,50
1163610,True,0,No user reviews,0,0,0
1163620,True,0,No user reviews,0,0,0
1163640,True,0,5 user reviews,5,0,5
1163650,True,0,No user reviews,0,0,0
1163660,True,0,4 user reviews,3,1,4
1163690,True,0,No user reviews,0,0,0
1163740,True,8,Very Positive,106,0,106
1163770,True,5,Mixed,46,21,67
1163780,True,0,2 user reviews,1,1,2
1163790,True,0,1 user reviews,1,0,1
1163810,True,0,No user reviews,0,0,0
1163811,True,0,No user reviews,0,0,0
1163812,True,0,No user reviews,0,0,0
1163830,True,0,No user reviews,0,0,0
1163840,True,0,No user reviews,0,0,0
1163870,True,0,No user reviews,0,0,0
1163900,True,0,No user reviews,0,0,0
1163910,True,8,Very Positive,136,11,147
1163920,True,0,No user reviews,0,0,0
1163930,True,0,No user reviews,0,0,0
1163950,True,0,2 user reviews,1,1,2
1163960,True,0,3 user reviews,3,0,3
1163980,True,0,No user reviews,0,0,0
1163990,True,0,2 user reviews,1,1,2
1164000,True,0,1 user reviews,1,0,1
1164010,True,6,Mostly Positive,18,5,23
1164020,True,0,No user reviews,0,0,0
1164040,True,0,No user reviews,0,0,0
1164050,True,8,Very Positive,145,6,151
1164060,True,0,No user reviews,0,0,0
1164090,True,0,No user reviews,0,0,0
1164100,True,0,No user reviews,0,0,0
1164110,True,4,Mostly Negative,13,21,34
1164130,True,0,No user reviews,0,0,0
1164150,True,0,No user reviews,0,0,0
1164160,True,0,No user reviews,0,0,0
1164170,True,0,No user reviews,0,0,0
1164180,True,0,No user reviews,0,0,0
1164190,True,0,No user reviews,0,0,0
1164200,True,0,No user reviews,0,0,0
1164210,True,0,4 user reviews,4,0,4
1164211,True,0,No user reviews,0,0,0
1164212,True,0,No user reviews,0,0,0
1164213,True,0,1 user reviews,0,1,1
1164214,True,0,No user reviews,0,0,0
1164215,True,0,No user reviews,0,0,0
1164216,True,0,No user reviews,0,0,0
1164217,True,0,1 user reviews,0,1,1
1164218,True,0,No user reviews,0,0,0
1164219,True,0,No user reviews,0,0,0
1164220,True,0,No user reviews,0,0,0
1164230,True,0,No user reviews,0,0,0
1164240,True,0,1 user reviews,1,0,1
1164250,True,0,No user reviews,0,0,0
1164290,True,0,No user reviews,0,0,0
1164300,True,0,No user reviews,0,0,0
1164310,True,0,3 user reviews,3,0,3
1164320,True,0,No user reviews,0,0,0
1164330,True,0,4 user reviews,4,0,4
1164350,True,0,No user reviews,0,0,0
1164380,True,0,No user reviews,0,0,0
1164390,True,0,No user reviews,0,0,0
1164400,True,0,No user reviews,0,0,0
1164410,True,0,4 user reviews,4,0,4
1164420,True,0,No user reviews,0,0,0
1164430,True,0,No user reviews,0,0,0
1164440,True,0,2 user reviews,0,2,2
1164460,True,0,No user reviews,0,0,0
1164470,True,0,3 user reviews,2,1,3
1164480,True,0,4 user reviews,4,0,4
1164490,True,0,No user reviews,0,0,0
1164510,True,0,No user reviews,0,0,0
1164520,True,0,1 user reviews,0,1,1
1164530,True,0,No user reviews,0,0,0
1164540,True,0,No user reviews,0,0,0
1164550,True,0,5 user reviews,4,1,5
1164570,True,0,No user reviews,0,0,0
1164660,True,0,2 user reviews,1,1,2
1164690,True,0,No user reviews,0,0,0
1164740,True,7,Positive,37,1,38
1164750,True,7,Positive,20,3,23
1164760,True,0,No user reviews,0,0,0
1164780,True,0,No user reviews,0,0,0
1164790,True,0,No user reviews,0,0,0
1164810,True,0,No user reviews,0,0,0
1164820,True,0,No user reviews,0,0,0
1164830,True,0,No user reviews,0,0,0
1164840,True,0,No user reviews,0,0,0
1164850,True,0,9 user reviews,8,1,9
1164860,True,0,No user reviews,0,0,0
1164900,True,0,No user reviews,0,0,0
1164910,True,0,5 user reviews,5,0,5
1164920,True,0,No user reviews,0,0,0
1164930,True,3,Negative,3,16,19
1164940,True,0,No user reviews,0,0,0
1164950,True,0,1 user reviews,0,1,1
1164970,True,0,6 user reviews,6,0,6
1164990,True,0,1 user reviews,0,1,1
1165000,True,0,No user reviews,0,0,0
1165010,True,0,No user reviews,0,0,0
1165020,True,0,1 user reviews,1,0,1
1165030,True,0,No user reviews,0,0,0
1165050,True,0,No user reviews,0,0,0
1165051,True,0,No user reviews,0,0,0
1165052,True,0,No user reviews,0,0,0
1165070,True,7,Positive,18,0,18
1165090,True,0,2 user reviews,2,0,2
1165100,True,0,1 user reviews,1,0,1
1165120,True,0,No user reviews,0,0,0
1165130,True,0,No user reviews,0,0,0
1165140,True,0,9 user reviews,7,2,9
1165150,True,0,No user reviews,0,0,0
1165160,True,0,No user reviews,0,0,0
1165170,True,0,No user reviews,0,0,0
1165180,True,0,7 user reviews,7,0,7
1165200,True,0,No user reviews,0,0,0
1165210,True,0,No user reviews,0,0,0
1165220,True,0,No user reviews,0,0,0
1165221,True,0,No user reviews,0,0,0
1165230,True,0,No user reviews,0,0,0
1165240,True,0,No user reviews,0,0,0
1165250,True,0,No user reviews,0,0,0
1165260,True,0,No user reviews,0,0,0
1165261,True,0,No user reviews,0,0,0
1165262,True,0,No user reviews,0,0,0
1165270,True,7,Positive,22,3,25
1165280,True,0,3 user reviews,1,2,3
1165290,True,0,No user reviews,0,0,0
1165300,True,0,1 user reviews,1,0,1
1165340,True,0,No user reviews,0,0,0
1165350,True,0,No user reviews,0,0,0
1165380,True,5,Mixed,16,10,26
1165390,True,0,No user reviews,0,0,0
1165400,True,0,9 user reviews,7,2,9
1165410,True,0,2 user reviews,1,1,2
1165420,True,0,2 user reviews,2,0,2
1165430,True,0,No user reviews,0,0,0
1165450,True,0,No user reviews,0,0,0
1165460,True,0,1 user reviews,0,1,1
1165470,True,0,No user reviews,0,0,0
1165480,True,0,No user reviews,0,0,0
1165490,True,0,No user reviews,0,0,0
1165510,True,7,Positive,19,3,22
1165520,True,0,No user reviews,0,0,0
1165530,True,0,No user reviews,0,0,0
1165540,True,0,No user reviews,0,0,0
1165570,True,0,No user reviews,0,0,0
1165590,True,0,4 user reviews,2,2,4
1165600,True,0,No user reviews,0,0,0
1165610,True,0,1 user reviews,0,1,1
1165620,True,0,No user reviews,0,0,0
1165630,True,0,No user reviews,0,0,0
1165640,True,0,No user reviews,0,0,0
1165650,True,0,No user reviews,0,0,0
1165660,True,0,No user reviews,0,0,0
1165670,True,0,No user reviews,0,0,0
1165710,True,0,No user reviews,0,0,0
1165720,True,0,No user reviews,0,0,0
1165740,True,0,2 user reviews,2,0,2
1165750,True,7,Positive,12,2,14
1165770,True,0,No user reviews,0,0,0
1165800,True,0,No user reviews,0,0,0
1165810,True,0,No user reviews,0,0,0
1165820,True,0,No user reviews,0,0,0
1165830,True,0,No user reviews,0,0,0
1165840,True,6,Mostly Positive,12,4,16
1165850,True,0,No user reviews,0,0,0
1165860,True,6,Mostly Positive,7,3,10
1165870,True,8,Very Positive,84,9,93
1165910,True,0,4 user reviews,3,1,4
1165920,True,0,5 user reviews,3,2,5
1165940,True,0,No user reviews,0,0,0
1165980,True,0,No user reviews,0,0,0
1166000,True,0,4 user reviews,4,0,4
1166020,True,0,No user reviews,0,0,0
1166040,True,0,No user reviews,0,0,0
1166050,True,0,No user reviews,0,0,0
1166070,True,0,No user reviews,0,0,0
1166090,True,0,No user reviews,0,0,0
1166100,True,0,1 user reviews,0,1,1
1166110,True,5,Mixed,9,6,15
1166120,True,0,4 user reviews,4,0,4
1166130,True,0,6 user reviews,6,0,6
1166140,True,0,No user reviews,0,0,0
1166150,True,0,No user reviews,0,0,0
1166170,True,0,No user reviews,0,0,0
1166171,True,0,No user reviews,0,0,0
1166180,True,0,No user reviews,0,0,0
1166181,True,0,No user reviews,0,0,0
1166200,True,0,No user reviews,0,0,0
1166210,True,0,No user reviews,0,0,0
1166230,True,7,Positive,9,1,10
1166240,True,0,2 user reviews,1,1,2
1166250,True,0,No user reviews,0,0,0
1166280,True,0,No user reviews,0,0,0
1166290,True,8,Very Positive,818,79,897
1166300,True,0,No user reviews,0,0,0
1166310,True,0,No user reviews,0,0,0
1166320,True,0,4 user reviews,4,0,4
1166330,True,0,No user reviews,0,0,0
1166350,True,0,1 user reviews,0,1,1
1166390,True,0,No user reviews,0,0,0
1166400,True,0,No user reviews,0,0,0
1166410,True,0,No user reviews,0,0,0
1166420,True,0,1 user reviews,1,0,1
1166430,True,0,No user reviews,0,0,0
1166470,True,7,Positive,16,2,18
1166471,True,6,Mostly Positive,31,9,40
1166472,True,6,Mostly Positive,17,5,22
1166480,True,0,No user reviews,0,0,0
1166490,True,0,4 user reviews,2,2,4
1166500,True,0,No user reviews,0,0,0
1166510,True,0,1 user reviews,0,1,1
1166540,True,0,No user reviews,0,0,0
1166550,True,0,No user reviews,0,0,0
1166560,True,0,No user reviews,0,0,0
1166580,True,7,Positive,12,2,14
1166600,True,7,Positive,27,5,32
1166610,True,0,No user reviews,0,0,0
1166620,True,0,No user reviews,0,0,0
1166660,True,0,No user reviews,0,0,0
1166670,True,0,No user reviews,0,0,0
1166680,True,0,No user reviews,0,0,0
1166710,True,0,No user reviews,0,0,0
1166720,True,0,No user reviews,0,0,0
1166721,True,0,1 user reviews,1,0,1
1166730,True,0,5 user reviews,5,0,5
1166740,True,4,Mostly Negative,4,8,12
1166760,True,0,2 user reviews,0,2,2
1166770,True,0,No user reviews,0,0,0
1166780,True,6,Mostly Positive,8,3,11
1166790,True,0,No user reviews,0,0,0
1166800,True,0,3 user reviews,3,0,3
1166810,True,0,No user reviews,0,0,0
1166820,True,0,No user reviews,0,0,0
1166821,True,0,No user reviews,0,0,0
1166822,True,0,No user reviews,0,0,0
1166823,True,0,No user reviews,0,0,0
1166824,True,0,No user reviews,0,0,0
1166825,True,0,No user reviews,0,0,0
1166826,True,0,No user reviews,0,0,0
1166827,True,0,No user reviews,0,0,0
1166830,True,0,No user reviews,0,0,0
1166840,True,7,Positive,36,1,37
1166850,True,0,No user reviews,0,0,0
1166860,True,8,Very Positive,162,31,193
1166870,True,0,No user reviews,0,0,0
1166871,True,0,No user reviews,0,0,0
1166880,True,0,No user reviews,0,0,0
1166890,True,0,No user reviews,0,0,0
1166900,True,0,No user reviews,0,0,0
1166910,True,0,No user reviews,0,0,0
1166930,True,0,No user reviews,0,0,0
1166940,True,0,No user reviews,0,0,0
1166980,True,0,5 user reviews,4,1,5
1166990,True,0,No user reviews,0,0,0
1167020,True,0,No user reviews,0,0,0
1167030,True,0,No user reviews,0,0,0
1167040,True,0,No user reviews,0,0,0
1167050,True,0,No user reviews,0,0,0
1167090,True,0,1 user reviews,0,1,1
1167100,True,0,No user reviews,0,0,0
1167110,True,0,No user reviews,0,0,0
1167140,True,0,No user reviews,0,0,0
1167160,True,0,No user reviews,0,0,0
1167170,True,0,No user reviews,0,0,0
1167180,True,0,No user reviews,0,0,0
1167190,True,0,No user reviews,0,0,0
1167200,True,0,No user reviews,0,0,0
1167230,True,0,No user reviews,0,0,0
1167231,True,0,No user reviews,0,0,0
1167232,True,0,No user reviews,0,0,0
1167233,True,0,No user reviews,0,0,0
1167240,True,0,No user reviews,0,0,0
1167270,True,0,1 user reviews,0,1,1
1167310,True,0,7 user reviews,0,7,7
1167320,True,8,Very Positive,101,21,122
1167330,True,0,4 user reviews,2,2,4
1167340,True,0,No user reviews,0,0,0
1167350,True,0,No user reviews,0,0,0
1167370,True,0,No user reviews,0,0,0
1167380,True,0,No user reviews,0,0,0
1167420,True,0,No user reviews,0,0,0
1167430,True,0,No user reviews,0,0,0
1167450,True,8,Very Positive,936,114,1050
1167460,True,0,6 user reviews,6,0,6
1167470,True,0,5 user reviews,1,4,5
1167480,True,0,No user reviews,0,0,0
1167490,True,0,No user reviews,0,0,0
1167500,True,0,1 user reviews,1,0,1
1167510,True,0,2 user reviews,2,0,2
1167520,True,0,9 user reviews,9,0,9
1167530,True,0,2 user reviews,2,0,2
1167540,True,0,1 user reviews,1,0,1
1167550,True,0,8 user reviews,7,1,8
1167570,True,0,No user reviews,0,0,0
1167590,True,0,No user reviews,0,0,0
1167610,True,0,No user reviews,0,0,0
1167630,True,9,Overwhelmingly Positive,1069,37,1106
1167640,True,7,Positive,9,2,11
1167650,True,0,No user reviews,0,0,0
1167660,True,7,Positive,12,2,14
1167661,True,0,5 user reviews,4,1,5
1167662,True,0,6 user reviews,4,2,6
1167663,True,6,Mostly Positive,7,3,10
1167670,True,0,No user reviews,0,0,0
1167680,True,0,No user reviews,0,0,0
1167700,True,0,No user reviews,0,0,0
1167710,True,0,1 user reviews,1,0,1
1167720,True,0,No user reviews,0,0,0
1167730,True,0,No user reviews,0,0,0
1167740,True,0,No user reviews,0,0,0
1167760,True,0,6 user reviews,5,1,6
1167770,True,0,3 user reviews,2,1,3
1167790,True,0,No user reviews,0,0,0
1167800,True,0,No user reviews,0,0,0
1167820,True,0,No user reviews,0,0,0
1167840,True,0,No user reviews,0,0,0
1167850,True,0,5 user reviews,5,0,5
1167860,True,0,6 user reviews,6,0,6
1167870,True,7,Positive,13,2,15
1167880,True,0,4 user reviews,4,0,4
1167900,True,0,No user reviews,0,0,0
1167910,True,6,Mostly Positive,99,28,127
1167930,True,0,No user reviews,0,0,0
1167940,True,0,No user reviews,0,0,0
1167950,True,8,Very Positive,120,28,148
1167970,True,0,6 user reviews,5,1,6
1167980,True,0,No user reviews,0,0,0
1168000,True,0,No user reviews,0,0,0
1168030,True,7,Positive,32,6,38
1168050,True,0,1 user reviews,1,0,1
1168060,True,0,4 user reviews,4,0,4
1168070,True,0,4 user reviews,4,0,4
1168080,True,0,No user reviews,0,0,0
1168130,True,0,No user reviews,0,0,0
1168131,True,0,No user reviews,0,0,0
1168160,True,0,No user reviews,0,0,0
1168170,True,5,Mixed,26,18,44
1168180,True,0,No user reviews,0,0,0
1168200,True,0,1 user reviews,0,1,1
1168210,True,0,No user reviews,0,0,0
1168250,True,0,No user reviews,0,0,0
1168260,True,0,No user reviews,0,0,0
1168280,True,0,No user reviews,0,0,0
1168290,True,0,2 user reviews,0,2,2
1168320,True,0,1 user reviews,0,1,1
1168330,True,0,No user reviews,0,0,0
1168360,True,0,2 user reviews,2,0,2
1168380,True,0,6 user reviews,6,0,6
1168420,True,0,3 user reviews,2,1,3
1168430,True,0,No user reviews,0,0,0
1168440,True,0,No user reviews,0,0,0
1168450,True,0,No user reviews,0,0,0
1168460,True,0,No user reviews,0,0,0
1168470,True,0,3 user reviews,3,0,3
1168480,True,0,1 user reviews,1,0,1
1168490,True,0,No user reviews,0,0,0
1168500,True,0,3 user reviews,0,3,3
1168510,True,0,No user reviews,0,0,0
1168511,True,0,No user reviews,0,0,0
1168512,True,0,No user reviews,0,0,0
1168513,True,0,No user reviews,0,0,0
1168514,True,0,No user reviews,0,0,0
1168515,True,0,No user reviews,0,0,0
1168516,True,0,1 user reviews,1,0,1
1168517,True,0,No user reviews,0,0,0
1168518,True,0,No user reviews,0,0,0
1168519,True,0,No user reviews,0,0,0
1168520,True,0,No user reviews,0,0,0
1168521,True,0,No user reviews,0,0,0
1168522,True,0,No user reviews,0,0,0
1168523,True,0,1 user reviews,1,0,1
1168524,True,0,No user reviews,0,0,0
1168525,True,0,No user reviews,0,0,0
1168526,True,0,1 user reviews,0,1,1
1168530,True,0,No user reviews,0,0,0
1168540,True,0,No user reviews,0,0,0
1168550,True,0,No user reviews,0,0,0
1168560,True,0,No user reviews,0,0,0
1168561,True,0,No user reviews,0,0,0
1168562,True,0,No user reviews,0,0,0
1168563,True,0,No user reviews,0,0,0
1168564,True,0,1 user reviews,1,0,1
1168565,True,0,No user reviews,0,0,0
1168566,True,0,1 user reviews,1,0,1
1168567,True,0,No user reviews,0,0,0
1168568,True,0,No user reviews,0,0,0
1168580,True,0,No user reviews,0,0,0
1168600,True,0,1 user reviews,1,0,1
1168610,True,0,No user reviews,0,0,0
1168620,True,0,No user reviews,0,0,0
1168630,True,0,8 user reviews,8,0,8
1168650,True,0,9 user reviews,5,4,9
1168660,True,6,Mostly Positive,35,10,45
1168680,True,7,Positive,11,2,13
1168690,True,0,No user reviews,0,0,0
1168700,True,0,No user reviews,0,0,0
1168710,True,0,No user reviews,0,0,0
1168720,True,0,No user reviews,0,0,0
1168730,True,0,No user reviews,0,0,0
1168740,True,0,No user reviews,0,0,0
1168780,True,0,No user reviews,0,0,0
1168790,True,0,No user reviews,0,0,0
1168800,True,0,No user reviews,0,0,0
1168810,True,0,No user reviews,0,0,0
1168820,True,0,1 user reviews,1,0,1
1168830,True,0,6 user reviews,4,2,6
1168840,True,0,No user reviews,0,0,0
1168850,True,0,No user reviews,0,0,0
1168870,True,6,Mostly Positive,59,20,79
1168880,True,8,Very Positive,226,22,248
1168890,True,0,No user reviews,0,0,0
1168910,True,0,No user reviews,0,0,0
1168930,True,0,No user reviews,0,0,0
1168940,True,0,1 user reviews,0,1,1
1168960,True,0,3 user reviews,3,0,3
1168970,True,0,1 user reviews,1,0,1
1168980,True,0,No user reviews,0,0,0
1168990,True,0,3 user reviews,1,2,3
1169000,True,0,No user reviews,0,0,0
1169010,True,0,No user reviews,0,0,0
1169020,True,8,Very Positive,57,5,62
1169030,True,0,3 user reviews,1,2,3
1169040,True,7,Positive,30,6,36
1169050,True,0,1 user reviews,1,0,1
1169060,True,0,1 user reviews,1,0,1
1169070,True,0,3 user reviews,1,2,3
1169080,True,0,No user reviews,0,0,0
1169090,True,0,No user reviews,0,0,0
1169100,True,8,Very Positive,65,4,69
1169110,True,0,No user reviews,0,0,0
1169120,True,0,No user reviews,0,0,0
1169140,True,0,No user reviews,0,0,0
1169160,True,0,7 user reviews,6,1,7
1169170,True,0,No user reviews,0,0,0
1169180,True,7,Positive,9,1,10
1169182,True,0,5 user reviews,3,2,5
1169200,True,0,No user reviews,0,0,0
1169220,True,0,No user reviews,0,0,0
1169230,True,0,No user reviews,0,0,0
1169310,True,0,2 user reviews,1,1,2
1169320,True,0,3 user reviews,2,1,3
1169330,True,0,No user reviews,0,0,0
1169340,True,0,No user reviews,0,0,0
1169350,True,0,No user reviews,0,0,0
1169370,True,0,No user reviews,0,0,0
1169420,True,0,5 user reviews,4,1,5
1169430,True,0,1 user reviews,1,0,1
1169460,True,0,No user reviews,0,0,0
1169490,True,0,No user reviews,0,0,0
1169500,True,0,No user reviews,0,0,0
1169510,True,0,2 user reviews,1,1,2
1169520,True,0,No user reviews,0,0,0
1169540,True,0,No user reviews,0,0,0
1169550,True,0,No user reviews,0,0,0
1169600,True,0,No user reviews,0,0,0
1169610,True,0,1 user reviews,1,0,1
1169630,True,0,No user reviews,0,0,0
1169640,True,0,No user reviews,0,0,0
1169660,True,0,No user reviews,0,0,0
1169670,True,0,No user reviews,0,0,0
1169680,True,0,No user reviews,0,0,0
1169690,True,0,No user reviews,0,0,0
1169700,True,0,No user reviews,0,0,0
1169720,True,0,1 user reviews,1,0,1
1169721,True,0,1 user reviews,1,0,1
1169722,True,0,No user reviews,0,0,0
1169723,True,0,No user reviews,0,0,0
1169724,True,0,No user reviews,0,0,0
1169725,True,0,No user reviews,0,0,0
1169726,True,0,3 user reviews,2,1,3
1169740,True,7,Positive,15,3,18
1169760,True,0,No user reviews,0,0,0
1169770,True,0,2 user reviews,1,1,2
1169780,True,0,No user reviews,0,0,0
1169790,True,0,No user reviews,0,0,0
1169800,True,0,No user reviews,0,0,0
1169801,True,0,No user reviews,0,0,0
1169810,True,0,1 user reviews,1,0,1
1169811,True,0,4 user reviews,2,2,4
1169870,True,0,No user reviews,0,0,0
1169880,True,0,4 user reviews,4,0,4
1169910,True,0,No user reviews,0,0,0
1169920,True,0,No user reviews,0,0,0
1169930,True,0,1 user reviews,1,0,1
1169931,True,0,No user reviews,0,0,0
1169940,True,0,No user reviews,0,0,0
1169950,True,0,No user reviews,0,0,0
1169951,True,0,No user reviews,0,0,0
1169960,True,0,2 user reviews,1,1,2
1169970,True,0,No user reviews,0,0,0
1169980,True,0,No user reviews,0,0,0
1169990,True,0,2 user reviews,2,0,2
1170010,True,6,Mostly Positive,10,4,14
1170030,True,0,No user reviews,0,0,0
1170050,True,0,7 user reviews,6,1,7
1170060,True,0,No user reviews,0,0,0
1170100,True,0,No user reviews,0,0,0
1170110,True,0,1 user reviews,1,0,1
1170120,True,7,Positive,25,0,25
1170130,True,0,No user reviews,0,0,0
1170160,True,0,1 user reviews,1,0,1
1170170,True,0,1 user reviews,1,0,1
1170180,True,5,Mixed,7,7,14
1170190,True,7,Positive,9,1,10
1170200,True,0,No user reviews,0,0,0
1170210,True,0,6 user reviews,5,1,6
1170230,True,0,No user reviews,0,0,0
1170240,True,0,No user reviews,0,0,0
1170250,True,0,No user reviews,0,0,0
1170270,True,0,No user reviews,0,0,0
1170290,True,0,5 user reviews,2,3,5
1170300,True,0,No user reviews,0,0,0
1170320,True,7,Positive,12,1,13
1170330,True,0,6 user reviews,5,1,6
1170340,True,7,Positive,10,0,10
1170370,True,0,No user reviews,0,0,0
1170390,True,0,No user reviews,0,0,0
1170400,True,0,1 user reviews,0,1,1
1170410,True,0,No user reviews,0,0,0
1170420,True,0,No user reviews,0,0,0
1170430,True,0,No user reviews,0,0,0
1170440,True,0,No user reviews,0,0,0
1170450,True,0,No user reviews,0,0,0
1170451,True,0,No user reviews,0,0,0
1170452,True,0,No user reviews,0,0,0
1170453,True,0,No user reviews,0,0,0
1170454,True,0,No user reviews,0,0,0
1170455,True,0,No user reviews,0,0,0
1170456,True,0,No user reviews,0,0,0
1170457,True,0,No user reviews,0,0,0
1170458,True,0,No user reviews,0,0,0
1170459,True,0,No user reviews,0,0,0
1170460,True,0,No user reviews,0,0,0
1170461,True,0,No user reviews,0,0,0
1170462,True,0,No user reviews,0,0,0
1170463,True,0,No user reviews,0,0,0
1170470,True,0,No user reviews,0,0,0
1170480,True,0,No user reviews,0,0,0
1170490,True,0,No user reviews,0,0,0
1170491,True,0,No user reviews,0,0,0
1170492,True,0,No user reviews,0,0,0
1170500,True,0,No user reviews,0,0,0
1170520,True,0,No user reviews,0,0,0
1170521,True,0,No user reviews,0,0,0
1170522,True,0,1 user reviews,1,0,1
1170523,True,0,No user reviews,0,0,0
1170524,True,0,No user reviews,0,0,0
1170525,True,0,No user reviews,0,0,0
1170526,True,0,1 user reviews,1,0,1
1170530,True,0,No user reviews,0,0,0
1170531,True,0,No user reviews,0,0,0
1170532,True,0,No user reviews,0,0,0
1170540,True,0,No user reviews,0,0,0
1170541,True,0,No user reviews,0,0,0
1170542,True,0,No user reviews,0,0,0
1170543,True,0,No user reviews,0,0,0
1170544,True,0,No user reviews,0,0,0
1170545,True,0,No user reviews,0,0,0
1170546,True,0,No user reviews,0,0,0
1170547,True,0,No user reviews,0,0,0
1170548,True,0,No user reviews,0,0,0
1170549,True,0,No user reviews,0,0,0
1170570,True,0,No user reviews,0,0,0
1170580,True,0,No user reviews,0,0,0
1170610,True,5,Mixed,9,4,13
1170620,True,0,No user reviews,0,0,0
1170630,True,0,3 user reviews,0,3,3
1170640,True,0,No user reviews,0,0,0
1170660,True,0,No user reviews,0,0,0
1170670,True,0,No user reviews,0,0,0
1170680,True,0,No user reviews,0,0,0
1170690,True,0,No user reviews,0,0,0
1170710,True,0,5 user reviews,5,0,5
1170711,True,0,No user reviews,0,0,0
1170712,True,0,1 user reviews,0,1,1
1170713,True,0,No user reviews,0,0,0
1170714,True,0,No user reviews,0,0,0
1170715,True,0,No user reviews,0,0,0
1170720,True,7,Positive,13,0,13
1170730,True,0,1 user reviews,1,0,1
1170731,True,0,No user reviews,0,0,0
1170732,True,0,No user reviews,0,0,0
1170733,True,0,No user reviews,0,0,0
1170750,True,0,3 user reviews,3,0,3
1170760,True,8,Very Positive,105,9,114
1170784,True,0,No user reviews,0,0,0
1170785,True,0,No user reviews,0,0,0
1170786,True,0,No user reviews,0,0,0
1170787,True,0,No user reviews,0,0,0
1170789,True,0,No user reviews,0,0,0
1170803,True,0,3 user reviews,0,3,3
1170807,True,0,4 user reviews,3,1,4
1170814,True,5,Mixed,6,7,13
1170820,True,0,No user reviews,0,0,0
1170830,True,0,1 user reviews,0,1,1
1170840,True,0,2 user reviews,2,0,2
1170870,True,0,No user reviews,0,0,0
1170880,True,0,No user reviews,0,0,0
1170890,True,0,No user reviews,0,0,0
1170910,True,0,No user reviews,0,0,0
1170920,True,0,No user reviews,0,0,0
1170950,True,0,No user reviews,0,0,0
1170960,True,0,8 user reviews,8,0,8
1170970,True,0,No user reviews,0,0,0
1170980,True,0,7 user reviews,5,2,7
1171000,True,0,No user reviews,0,0,0
1171020,True,0,No user reviews,0,0,0
1171030,True,0,1 user reviews,1,0,1
1171040,True,0,No user reviews,0,0,0
1171070,True,0,4 user reviews,3,1,4
1171080,True,0,1 user reviews,1,0,1
1171110,True,0,No user reviews,0,0,0
1171120,True,7,Positive,15,1,16
1171130,True,7,Positive,14,0,14
1171140,True,0,No user reviews,0,0,0
1171160,True,0,5 user reviews,5,0,5
1171170,True,0,No user reviews,0,0,0
1171180,True,0,No user reviews,0,0,0
1171190,True,6,Mostly Positive,14,4,18
1171200,True,0,No user reviews,0,0,0
1171201,True,0,No user reviews,0,0,0
1171202,True,0,No user reviews,0,0,0
1171220,True,0,No user reviews,0,0,0
1171230,True,0,No user reviews,0,0,0
1171240,True,6,Mostly Positive,55,14,69
1171250,True,0,No user reviews,0,0,0
1171260,True,6,Mostly Positive,8,3,11
1171270,True,7,Positive,40,4,44
1171310,True,5,Mixed,36,18,54
1171330,True,0,No user reviews,0,0,0
1171340,True,0,No user reviews,0,0,0
1171370,True,0,6 user reviews,6,0,6
1171380,True,0,3 user reviews,2,1,3
1171410,True,0,No user reviews,0,0,0
1171420,True,0,4 user reviews,4,0,4
1171430,True,0,1 user reviews,0,1,1
1171440,True,0,9 user reviews,9,0,9
1171460,True,0,1 user reviews,1,0,1
1171470,True,0,2 user reviews,2,0,2
1171500,True,0,No user reviews,0,0,0
1171520,True,0,No user reviews,0,0,0
1171540,True,0,No user reviews,0,0,0
1171560,True,0,4 user reviews,4,0,4
1171570,True,0,1 user reviews,1,0,1
1171590,True,0,No user reviews,0,0,0
1171591,True,0,No user reviews,0,0,0
1171600,True,0,No user reviews,0,0,0
1171610,True,0,No user reviews,0,0,0
1171620,True,0,1 user reviews,1,0,1
1171640,True,0,5 user reviews,2,3,5
1171660,True,7,Positive,16,0,16
1171680,True,0,No user reviews,0,0,0
1171700,True,0,No user reviews,0,0,0
1171710,True,0,No user reviews,0,0,0
1171750,True,0,No user reviews,0,0,0
1171770,True,0,1 user reviews,1,0,1
1171780,True,0,No user reviews,0,0,0
1171790,True,0,No user reviews,0,0,0
1171800,True,0,No user reviews,0,0,0
1171810,True,0,1 user reviews,0,1,1
1171820,True,7,Positive,24,3,27
1171830,True,0,No user reviews,0,0,0
1171840,True,7,Positive,14,2,16
1171850,True,0,No user reviews,0,0,0
1171870,True,0,No user reviews,0,0,0
1171880,True,0,1 user reviews,1,0,1
1171890,True,5,Mixed,6,6,12
1171950,True,0,1 user reviews,0,1,1
1171970,True,0,No user reviews,0,0,0
1171980,True,0,No user reviews,0,0,0
1171990,True,0,No user reviews,0,0,0
1172000,True,0,1 user reviews,0,1,1
1172040,True,0,No user reviews,0,0,0
1172050,True,6,Mostly Positive,75,22,97
1172060,True,6,Mostly Positive,12,4,16
1172080,True,0,1 user reviews,0,1,1
1172090,True,0,No user reviews,0,0,0
1172110,True,0,7 user reviews,7,0,7
1172130,True,0,6 user reviews,6,0,6
1172140,True,0,No user reviews,0,0,0
1172150,True,0,4 user reviews,4,0,4
1172160,True,0,No user reviews,0,0,0
1172170,True,7,Positive,19,2,21
1172190,True,0,No user reviews,0,0,0
1172200,True,0,No user reviews,0,0,0
1172210,True,0,No user reviews,0,0,0
1172220,True,0,1 user reviews,1,0,1
1172270,True,0,1 user reviews,1,0,1
1172280,True,0,No user reviews,0,0,0
1172290,True,0,1 user reviews,1,0,1
1172310,True,0,No user reviews,0,0,0
1172320,True,0,No user reviews,0,0,0
1172330,True,0,No user reviews,0,0,0
1172340,True,0,1 user reviews,0,1,1
1172350,True,0,No user reviews,0,0,0
1172370,True,0,No user reviews,0,0,0
1172380,True,8,Very Positive,31538,2969,34507
1172390,True,5,Mixed,8,4,12
1172400,True,0,No user reviews,0,0,0
1172410,True,0,7 user reviews,7,0,7
1172420,True,0,3 user reviews,3,0,3
1172430,True,5,Mixed,22,16,38
1172450,True,7,Positive,13,0,13
1172460,True,0,No user reviews,0,0,0
1172470,True,0,No user reviews,0,0,0
1172480,True,0,2 user reviews,2,0,2
1172490,True,0,4 user reviews,4,0,4
1172500,True,7,Positive,14,0,14
1172510,True,8,Very Positive,71,1,72
1172520,True,7,Positive,36,1,37
1172530,True,7,Positive,21,2,23
1172540,True,0,8 user reviews,5,3,8
1172550,True,0,2 user reviews,1,1,2
1172551,True,0,No user reviews,0,0,0
1172552,True,0,No user reviews,0,0,0
1172553,True,0,No user reviews,0,0,0
1172600,True,0,No user reviews,0,0,0
1172610,True,0,2 user reviews,2,0,2
1172620,True,8,Very Positive,12045,1226,13271
1172640,True,0,1 user reviews,1,0,1
1172650,True,0,No user reviews,0,0,0
1172660,True,0,2 user reviews,1,1,2
1172670,True,0,No user reviews,0,0,0
1172680,True,0,No user reviews,0,0,0
1172700,True,0,1 user reviews,1,0,1
1172720,True,0,1 user reviews,1,0,1
1172730,True,0,No user reviews,0,0,0
1172740,True,0,No user reviews,0,0,0
1172760,True,0,1 user reviews,0,1,1
1172790,True,0,No user reviews,0,0,0
1172810,True,0,No user reviews,0,0,0
1172820,True,0,No user reviews,0,0,0
1172830,True,0,No user reviews,0,0,0
1172850,True,0,No user reviews,0,0,0
1172860,True,7,Positive,17,3,20
1172870,True,0,No user reviews,0,0,0
1172890,True,0,2 user reviews,2,0,2
1172900,True,0,No user reviews,0,0,0
1172920,True,0,No user reviews,0,0,0
1172930,True,0,No user reviews,0,0,0
1172940,True,6,Mostly Positive,199,54,253
1172950,True,0,No user reviews,0,0,0
1172970,True,0,No user reviews,0,0,0
1172980,True,0,No user reviews,0,0,0
1173010,True,0,No user reviews,0,0,0
1173030,True,0,4 user reviews,4,0,4
1173031,True,0,1 user reviews,1,0,1
1173050,True,0,5 user reviews,5,0,5
1173070,True,0,No user reviews,0,0,0
1173080,True,0,No user reviews,0,0,0
1173100,True,0,No user reviews,0,0,0
1173110,True,0,No user reviews,0,0,0
1173120,True,0,6 user reviews,6,0,6
1173130,True,0,No user reviews,0,0,0
1173140,True,7,Positive,23,3,26
1173150,True,0,6 user reviews,4,2,6
1173160,True,0,No user reviews,0,0,0
1173170,True,0,No user reviews,0,0,0
1173200,True,8,Very Positive,60,3,63
1173210,True,0,3 user reviews,3,0,3
1173230,True,0,9 user reviews,7,2,9
1173240,True,0,1 user reviews,0,1,1
1173250,True,0,3 user reviews,3,0,3
1173260,True,0,1 user reviews,0,1,1
1173270,True,5,Mixed,5,7,12
1173280,True,0,No user reviews,0,0,0
1173290,True,0,No user reviews,0,0,0
1173300,True,0,No user reviews,0,0,0
1173310,True,7,Positive,9,1,10
1173330,True,0,No user reviews,0,0,0
1173340,True,0,4 user reviews,0,4,4
1173350,True,5,Mixed,20,9,29
1173360,True,0,No user reviews,0,0,0
1173370,True,0,No user reviews,0,0,0
1173380,True,8,Very Positive,128,13,141
1173400,True,0,No user reviews,0,0,0
1173410,True,5,Mixed,57,30,87
1173420,True,0,No user reviews,0,0,0
1173500,True,0,3 user reviews,1,2,3
1173510,True,8,Very Positive,49,9,58
1173520,True,0,No user reviews,0,0,0
1173540,True,0,No user reviews,0,0,0
1173550,True,0,No user reviews,0,0,0
1173560,True,0,No user reviews,0,0,0
1173570,True,0,No user reviews,0,0,0
1173580,True,0,No user reviews,0,0,0
1173590,True,0,No user reviews,0,0,0
1173610,True,0,1 user reviews,1,0,1
1173630,True,0,No user reviews,0,0,0
1173640,True,0,No user reviews,0,0,0
1173650,True,0,1 user reviews,0,1,1
1173670,True,0,No user reviews,0,0,0
1173740,True,7,Positive,10,1,11
1173750,True,0,No user reviews,0,0,0
1173751,True,0,1 user reviews,0,1,1
1173752,True,0,No user reviews,0,0,0
1173760,True,0,1 user reviews,1,0,1
1173830,True,7,Positive,30,1,31
1173850,True,0,3 user reviews,3,0,3
1173860,True,0,2 user reviews,2,0,2
1173870,True,7,Positive,10,1,11
1173880,True,0,No user reviews,0,0,0
1173890,True,0,No user reviews,0,0,0
1173900,True,6,Mostly Positive,17,5,22
1173910,True,0,No user reviews,0,0,0
1173920,True,0,No user reviews,0,0,0
1173930,True,0,No user reviews,0,0,0
1173940,True,7,Positive,11,0,11
1173950,True,0,No user reviews,0,0,0
1173960,True,0,No user reviews,0,0,0
1173980,True,0,No user reviews,0,0,0
1173990,True,0,No user reviews,0,0,0
1174000,True,0,No user reviews,0,0,0
1174050,True,0,No user reviews,0,0,0
1174080,True,0,No user reviews,0,0,0
1174090,True,7,Positive,9,2,11
1174100,True,0,No user reviews,0,0,0
1174120,True,0,2 user reviews,2,0,2
1174160,True,0,No user reviews,0,0,0
1174170,True,0,3 user reviews,3,0,3
1174180,True,8,Very Positive,28609,6495,35104
1174200,True,0,No user reviews,0,0,0
1174230,True,0,No user reviews,0,0,0
1174260,True,0,2 user reviews,1,1,2
1174270,True,0,No user reviews,0,0,0
1174280,True,0,No user reviews,0,0,0
1174290,True,0,4 user reviews,1,3,4
1174300,True,0,No user reviews,0,0,0
1174310,True,0,No user reviews,0,0,0
1174311,True,0,No user reviews,0,0,0
1174312,True,0,No user reviews,0,0,0
1174313,True,0,No user reviews,0,0,0
1174320,True,0,5 user reviews,5,0,5
1174360,True,0,1 user reviews,1,0,1
1174370,True,8,Very Positive,289,19,308
1174390,True,7,Positive,34,5,39
1174400,True,7,Positive,45,2,47
1174410,True,0,5 user reviews,5,0,5
1174420,True,0,5 user reviews,3,2,5
1174430,True,0,1 user reviews,1,0,1
1174440,True,0,2 user reviews,2,0,2
1174450,True,0,No user reviews,0,0,0
1174460,True,0,No user reviews,0,0,0
1174470,True,5,Mixed,10,5,15
1174490,True,0,No user reviews,0,0,0
1174500,True,0,6 user reviews,5,1,6
1174550,True,5,Mixed,8,6,14
1174560,True,0,No user reviews,0,0,0
1174570,True,0,No user reviews,0,0,0
1174580,True,0,9 user reviews,9,0,9
1174581,True,0,2 user reviews,2,0,2
1174620,True,0,1 user reviews,1,0,1
1174630,True,0,5 user reviews,5,0,5
1174631,True,0,6 user reviews,4,2,6
1174632,True,0,2 user reviews,2,0,2
1174640,True,0,No user reviews,0,0,0
1174670,True,7,Positive,14,0,14
1174680,True,0,No user reviews,0,0,0
1174690,True,8,Very Positive,53,6,59
1174720,True,5,Mixed,59,37,96
1174730,True,0,4 user reviews,4,0,4
1174780,True,0,4 user reviews,4,0,4
1174810,True,0,No user reviews,0,0,0
1174820,True,0,No user reviews,0,0,0
1174830,True,0,7 user reviews,5,2,7
1174840,True,0,No user reviews,0,0,0
1174850,True,0,No user reviews,0,0,0
1174860,True,0,7 user reviews,6,1,7
1174870,True,0,No user reviews,0,0,0
1174880,True,0,No user reviews,0,0,0
1174890,True,0,1 user reviews,0,1,1
1174900,True,0,2 user reviews,1,1,2
1174920,True,0,No user reviews,0,0,0
1174930,True,0,No user reviews,0,0,0
1174940,True,0,No user reviews,0,0,0
1174960,True,0,No user reviews,0,0,0
1174970,True,0,No user reviews,0,0,0
1174980,True,0,2 user reviews,2,0,2
1174990,True,0,1 user reviews,1,0,1
1175010,True,0,No user reviews,0,0,0
1175020,True,0,No user reviews,0,0,0
1175030,True,0,No user reviews,0,0,0
1175040,True,0,No user reviews,0,0,0
1175050,True,0,No user reviews,0,0,0
1175060,True,7,Positive,12,2,14
1175070,True,0,2 user reviews,2,0,2
1175080,True,0,No user reviews,0,0,0
1175090,True,7,Positive,35,0,35
1175100,True,0,No user reviews,0,0,0
1175110,True,0,No user reviews,0,0,0
1175120,True,0,No user reviews,0,0,0
1175130,True,0,1 user reviews,1,0,1
1175140,True,0,2 user reviews,2,0,2
1175150,True,0,No user reviews,0,0,0
1175160,True,0,2 user reviews,2,0,2
1175170,True,0,1 user reviews,1,0,1
1175180,True,0,No user reviews,0,0,0
1175190,True,0,No user reviews,0,0,0
1175200,True,6,Mostly Positive,39,15,54
1175220,True,0,No user reviews,0,0,0
1175221,True,0,No user reviews,0,0,0
1175222,True,0,1 user reviews,1,0,1
1175223,True,0,No user reviews,0,0,0
1175240,True,0,No user reviews,0,0,0
1175250,True,0,4 user reviews,4,0,4
1175270,True,0,No user reviews,0,0,0
1175310,True,0,No user reviews,0,0,0
1175320,True,0,No user reviews,0,0,0
1175330,True,0,No user reviews,0,0,0
1175350,True,0,No user reviews,0,0,0
1175360,True,8,Very Positive,121,8,129
1175370,True,0,No user reviews,0,0,0
1175390,True,4,Mostly Negative,12,21,33
1175400,True,0,No user reviews,0,0,0
1175410,True,0,No user reviews,0,0,0
1175420,True,0,8 user reviews,7,1,8
1175430,True,7,Positive,22,0,22
1175440,True,0,No user reviews,0,0,0
1175450,True,0,No user reviews,0,0,0
1175460,True,0,No user reviews,0,0,0
1175470,True,0,3 user reviews,1,2,3
1175480,True,5,Mixed,8,4,12
1175500,True,0,1 user reviews,0,1,1
1175510,True,0,2 user reviews,1,1,2
1175530,True,0,No user reviews,0,0,0
1175540,True,0,No user reviews,0,0,0
1175550,True,0,1 user reviews,0,1,1
1175560,True,0,No user reviews,0,0,0
1175570,True,0,No user reviews,0,0,0
1175581,True,0,2 user reviews,2,0,2
1175590,True,0,4 user reviews,3,1,4
1175600,True,0,No user reviews,0,0,0
1175640,True,7,Positive,12,3,15
1175650,True,0,1 user reviews,1,0,1
1175660,True,0,No user reviews,0,0,0
1175680,True,0,No user reviews,0,0,0
1175690,True,0,No user reviews,0,0,0
1175720,True,0,No user reviews,0,0,0
1175730,True,0,No user reviews,0,0,0
1175770,True,0,No user reviews,0,0,0
1175800,True,0,No user reviews,0,0,0
1175820,True,0,No user reviews,0,0,0
1175840,True,0,No user reviews,0,0,0
1175870,True,0,No user reviews,0,0,0
1175880,True,0,No user reviews,0,0,0
1175890,True,0,No user reviews,0,0,0
1175900,True,0,3 user reviews,1,2,3
1175930,True,0,5 user reviews,4,1,5
1175950,True,5,Mixed,5,6,11
1175960,True,0,No user reviews,0,0,0
1175970,True,0,No user reviews,0,0,0
1175980,True,0,1 user reviews,1,0,1
1175990,True,0,No user reviews,0,0,0
1176000,True,0,No user reviews,0,0,0
1176020,True,7,Positive,33,6,39
1176040,True,0,2 user reviews,1,1,2
1176050,True,0,2 user reviews,2,0,2
1176060,True,0,No user reviews,0,0,0
1176080,True,0,No user reviews,0,0,0
1176090,True,0,No user reviews,0,0,0
1176110,True,6,Mostly Positive,14,4,18
1176130,True,0,6 user reviews,3,3,6
1176140,True,0,No user reviews,0,0,0
1176150,True,0,No user reviews,0,0,0
1176151,True,0,No user reviews,0,0,0
1176152,True,0,No user reviews,0,0,0
1176154,True,0,No user reviews,0,0,0
1176156,True,0,No user reviews,0,0,0
1176157,True,0,No user reviews,0,0,0
1176158,True,0,No user reviews,0,0,0
1176159,True,0,No user reviews,0,0,0
1176160,True,0,5 user reviews,4,1,5
1176170,True,6,Mostly Positive,13,5,18
1176181,True,0,No user reviews,0,0,0
1176182,True,0,No user reviews,0,0,0
1176183,True,0,No user reviews,0,0,0
1176184,True,0,No user reviews,0,0,0
1176190,True,0,9 user reviews,4,5,9
1176330,True,0,No user reviews,0,0,0
1176350,True,0,No user reviews,0,0,0
1176360,True,0,3 user reviews,0,3,3
1176370,True,0,No user reviews,0,0,0
1176371,True,0,No user reviews,0,0,0
1176372,True,0,No user reviews,0,0,0
1176373,True,0,1 user reviews,1,0,1
1176378,True,0,1 user reviews,1,0,1
1176379,True,0,No user reviews,0,0,0
1176440,True,0,1 user reviews,1,0,1
1176450,True,0,No user reviews,0,0,0
1176460,True,7,Positive,12,2,14
1176470,True,0,No user reviews,0,0,0
1176480,True,0,2 user reviews,1,1,2
1176490,True,0,No user reviews,0,0,0
1176510,True,0,No user reviews,0,0,0
1176550,True,0,No user reviews,0,0,0
1176560,True,0,8 user reviews,1,7,8
1176570,True,0,No user reviews,0,0,0
1176580,True,5,Mixed,6,5,11
1176590,True,0,1 user reviews,1,0,1
1176610,True,0,1 user reviews,0,1,1
1176611,True,0,1 user reviews,0,1,1
1176612,True,0,No user reviews,0,0,0
1176613,True,0,1 user reviews,0,1,1
1176614,True,0,3 user reviews,3,0,3
1176615,True,0,No user reviews,0,0,0
1176616,True,0,2 user reviews,2,0,2
1176617,True,0,No user reviews,0,0,0
1176618,True,0,1 user reviews,1,0,1
1176619,True,0,No user reviews,0,0,0
1176620,True,0,No user reviews,0,0,0
1176621,True,0,No user reviews,0,0,0
1176622,True,0,No user reviews,0,0,0
1176623,True,0,No user reviews,0,0,0
1176640,True,0,No user reviews,0,0,0
1176660,True,0,2 user reviews,2,0,2
1176670,True,0,No user reviews,0,0,0
1176680,True,0,No user reviews,0,0,0
1176681,True,0,1 user reviews,1,0,1
1176682,True,0,No user reviews,0,0,0
1176700,True,0,7 user reviews,7,0,7
1176710,True,6,Mostly Positive,280,79,359
1176720,True,0,No user reviews,0,0,0
1176740,True,0,7 user reviews,2,5,7
1176750,True,0,1 user reviews,1,0,1
1176760,True,0,1 user reviews,1,0,1
1176780,True,0,No user reviews,0,0,0
1176800,True,0,No user reviews,0,0,0
1176820,True,0,No user reviews,0,0,0
1176830,True,0,No user reviews,0,0,0
1176840,True,0,No user reviews,0,0,0
1176850,True,0,2 user reviews,2,0,2
1176860,True,0,No user reviews,0,0,0
1176870,True,7,Positive,16,0,16
1176890,True,0,No user reviews,0,0,0
1176900,True,0,No user reviews,0,0,0
1176918,True,0,No user reviews,0,0,0
1176920,True,0,3 user reviews,3,0,3
1176923,True,0,1 user reviews,1,0,1
1176970,True,0,3 user reviews,2,1,3
1176980,True,0,No user reviews,0,0,0
1176990,True,0,6 user reviews,6,0,6
1177000,True,0,3 user reviews,2,1,3
1177010,True,0,No user reviews,0,0,0
1177020,True,0,1 user reviews,1,0,1
1177030,True,0,9 user reviews,7,2,9
1177050,True,0,6 user reviews,5,1,6
1177060,True,0,1 user reviews,0,1,1
1177070,True,0,No user reviews,0,0,0
1177080,True,0,1 user reviews,1,0,1
1177090,True,0,No user reviews,0,0,0
1177100,True,0,No user reviews,0,0,0
1177110,True,7,Positive,10,2,12
1177120,True,0,No user reviews,0,0,0
1177130,True,8,Very Positive,66,2,68
1177170,True,0,1 user reviews,1,0,1
1177190,True,0,No user reviews,0,0,0
1177200,True,0,No user reviews,0,0,0
1177210,True,0,No user reviews,0,0,0
1177230,True,0,No user reviews,0,0,0
1177250,True,0,No user reviews,0,0,0
1177270,True,0,No user reviews,0,0,0
1177300,True,0,No user reviews,0,0,0
1177310,True,0,No user reviews,0,0,0
1177320,True,0,No user reviews,0,0,0
1177330,True,0,No user reviews,0,0,0
1177340,True,0,No user reviews,0,0,0
1177350,True,0,1 user reviews,0,1,1
1177360,True,0,No user reviews,0,0,0
1177370,True,0,No user reviews,0,0,0
1177380,True,0,No user reviews,0,0,0
1177390,True,0,No user reviews,0,0,0
1177400,True,0,No user reviews,0,0,0
1177410,True,0,No user reviews,0,0,0
1177420,True,8,Very Positive,136,5,141
1177430,True,0,No user reviews,0,0,0
1177440,True,0,No user reviews,0,0,0
1177460,True,0,1 user reviews,1,0,1
1177480,True,0,No user reviews,0,0,0
1177490,True,0,No user reviews,0,0,0
1177510,True,0,1 user reviews,1,0,1
1177520,True,0,No user reviews,0,0,0
1177530,True,0,No user reviews,0,0,0
1177550,True,0,No user reviews,0,0,0
1177560,True,0,No user reviews,0,0,0
1177580,True,0,No user reviews,0,0,0
1177610,True,7,Positive,15,3,18
1177640,True,0,8 user reviews,8,0,8
1177650,True,0,No user reviews,0,0,0
1177660,True,6,Mostly Positive,41,11,52
1177690,True,7,Positive,24,5,29
1177720,True,0,8 user reviews,7,1,8
1177730,True,0,No user reviews,0,0,0
1177760,True,0,No user reviews,0,0,0
1177761,True,0,No user reviews,0,0,0
1177762,True,0,No user reviews,0,0,0
1177763,True,0,No user reviews,0,0,0
1177764,True,0,No user reviews,0,0,0
1177765,True,0,No user reviews,0,0,0
1177770,True,0,No user reviews,0,0,0
1177771,True,0,No user reviews,0,0,0
1177772,True,0,No user reviews,0,0,0
1177773,True,0,No user reviews,0,0,0
1177774,True,0,No user reviews,0,0,0
1177775,True,0,No user reviews,0,0,0
1177776,True,0,1 user reviews,1,0,1
1177777,True,0,1 user reviews,1,0,1
1177780,True,0,No user reviews,0,0,0
1177781,True,0,No user reviews,0,0,0
1177782,True,0,No user reviews,0,0,0
1177783,True,0,No user reviews,0,0,0
1177784,True,0,No user reviews,0,0,0
1177785,True,0,No user reviews,0,0,0
1177786,True,0,No user reviews,0,0,0
1177787,True,0,No user reviews,0,0,0
1177800,True,0,No user reviews,0,0,0
1177801,True,0,No user reviews,0,0,0
1177802,True,0,No user reviews,0,0,0
1177803,True,0,No user reviews,0,0,0
1177804,True,0,No user reviews,0,0,0
1177805,True,0,No user reviews,0,0,0
1177806,True,0,No user reviews,0,0,0
1177807,True,0,No user reviews,0,0,0
1177810,True,0,2 user reviews,1,1,2
1177820,True,0,1 user reviews,1,0,1
1177830,True,0,2 user reviews,2,0,2
1177850,True,0,1 user reviews,1,0,1
1177880,True,7,Positive,43,1,44
1177890,True,6,Mostly Positive,12,4,16
1177900,True,0,No user reviews,0,0,0
1177910,True,0,No user reviews,0,0,0
1177940,True,0,No user reviews,0,0,0
1177950,True,0,1 user reviews,0,1,1
1177960,True,0,No user reviews,0,0,0
1177980,True,0,No user reviews,0,0,0
1177990,True,0,9 user reviews,7,2,9
1178000,True,0,8 user reviews,8,0,8
1178010,True,0,No user reviews,0,0,0
1178020,True,0,2 user reviews,0,2,2
1178030,True,0,No user reviews,0,0,0
1178050,True,0,No user reviews,0,0,0
1178060,True,0,1 user reviews,0,1,1
1178070,True,0,No user reviews,0,0,0
1178080,True,0,No user reviews,0,0,0
1178120,True,7,Positive,22,5,27
1178140,True,8,Very Positive,52,1,53
1178150,True,0,6 user reviews,6,0,6
1178160,True,0,No user reviews,0,0,0
1178180,True,0,2 user reviews,1,1,2
1178200,True,6,Mostly Positive,12,4,16
1178210,True,0,5 user reviews,5,0,5
1178220,True,0,No user reviews,0,0,0
1178230,True,0,No user reviews,0,0,0
1178250,True,0,No user reviews,0,0,0
1178260,True,0,No user reviews,0,0,0
1178280,True,4,Mostly Negative,4,16,20
1178290,True,7,Positive,11,0,11
1178300,True,0,No user reviews,0,0,0
1178310,True,0,3 user reviews,1,2,3
1178320,True,0,1 user reviews,1,0,1
1178321,True,0,6 user reviews,6,0,6
1178330,True,0,2 user reviews,2,0,2
1178350,True,0,No user reviews,0,0,0
1178370,True,0,No user reviews,0,0,0
1178380,True,0,2 user reviews,1,1,2
1178390,True,0,No user reviews,0,0,0
1178400,True,6,Mostly Positive,44,16,60
1178410,True,0,No user reviews,0,0,0
1178420,True,0,No user reviews,0,0,0
1178430,True,0,No user reviews,0,0,0
1178460,True,7,Positive,33,5,38
1178480,True,0,No user reviews,0,0,0
1178490,True,8,Very Positive,98,24,122
1178500,True,0,3 user reviews,2,1,3
1178510,True,0,No user reviews,0,0,0
1178570,True,0,1 user reviews,0,1,1
1178600,True,0,No user reviews,0,0,0
1178610,True,5,Mixed,8,8,16
1178620,True,0,No user reviews,0,0,0
1178630,True,0,1 user reviews,1,0,1
1178640,True,0,6 user reviews,3,3,6
1178660,True,0,1 user reviews,1,0,1
1178670,True,0,4 user reviews,3,1,4
1178680,True,0,9 user reviews,9,0,9
1178690,True,0,No user reviews,0,0,0
1178710,True,0,3 user reviews,0,3,3
1178730,True,0,No user reviews,0,0,0
1178770,True,0,No user reviews,0,0,0
1178780,True,8,Very Positive,143,6,149
1178790,True,0,No user reviews,0,0,0
1178800,True,0,No user reviews,0,0,0
1178810,True,0,No user reviews,0,0,0
1178830,True,0,No user reviews,0,0,0
1178870,True,0,3 user reviews,1,2,3
1178871,True,0,1 user reviews,0,1,1
1178872,True,0,No user reviews,0,0,0
1178873,True,0,2 user reviews,0,2,2
1178874,True,0,No user reviews,0,0,0
1178875,True,0,No user reviews,0,0,0
1178876,True,0,No user reviews,0,0,0
1178877,True,0,No user reviews,0,0,0
1178878,True,0,No user reviews,0,0,0
1178879,True,0,1 user reviews,0,1,1
1178880,True,8,Very Positive,70,9,79
1178890,True,0,No user reviews,0,0,0
1178910,True,0,No user reviews,0,0,0
1178920,True,0,1 user reviews,0,1,1
1178921,True,0,No user reviews,0,0,0
1178922,True,0,No user reviews,0,0,0
1178930,True,0,No user reviews,0,0,0
1178931,True,0,No user reviews,0,0,0
1178932,True,0,No user reviews,0,0,0
1178933,True,0,No user reviews,0,0,0
1178934,True,0,No user reviews,0,0,0
1178935,True,0,No user reviews,0,0,0
1178936,True,0,No user reviews,0,0,0
1178940,True,0,No user reviews,0,0,0
1178950,True,0,1 user reviews,1,0,1
1178960,True,0,No user reviews,0,0,0
1178970,True,0,No user reviews,0,0,0
1178980,True,0,No user reviews,0,0,0
1178990,True,0,No user reviews,0,0,0
1179010,True,0,No user reviews,0,0,0
1179020,True,0,No user reviews,0,0,0
1179060,True,0,No user reviews,0,0,0
1179080,True,0,No user reviews,0,0,0
1179090,True,0,No user reviews,0,0,0
1179100,True,0,No user reviews,0,0,0
1179110,True,0,No user reviews,0,0,0
1179130,True,0,No user reviews,0,0,0
1179140,True,0,No user reviews,0,0,0
1179141,True,0,No user reviews,0,0,0
1179142,True,0,No user reviews,0,0,0
1179150,True,0,No user reviews,0,0,0
1179170,True,0,1 user reviews,1,0,1
1179190,True,0,1 user reviews,1,0,1
1179200,True,0,No user reviews,0,0,0
1179210,True,8,Very Positive,268,9,277
1179220,True,0,7 user reviews,6,1,7
1179230,True,0,No user reviews,0,0,0
1179260,True,0,No user reviews,0,0,0
1179280,True,0,No user reviews,0,0,0
1179290,True,7,Positive,38,1,39
1179300,True,0,2 user reviews,2,0,2
1179310,True,0,No user reviews,0,0,0
1179340,True,0,1 user reviews,1,0,1
1179350,True,0,No user reviews,0,0,0
1179360,True,0,No user reviews,0,0,0
1179380,True,0,No user reviews,0,0,0
1179390,True,0,1 user reviews,0,1,1
1179400,True,0,No user reviews,0,0,0
1179410,True,0,8 user reviews,5,3,8
1179420,True,0,1 user reviews,0,1,1
1179430,True,0,No user reviews,0,0,0
1179440,True,0,1 user reviews,1,0,1
1179450,True,7,Positive,9,1,10
1179451,True,0,2 user reviews,2,0,2
1179452,True,0,2 user reviews,2,0,2
1179453,True,0,2 user reviews,2,0,2
1179454,True,0,1 user reviews,1,0,1
1179455,True,0,No user reviews,0,0,0
1179456,True,0,No user reviews,0,0,0
1179457,True,0,1 user reviews,1,0,1
1179458,True,0,No user reviews,0,0,0
1179460,True,0,9 user reviews,9,0,9
1179470,True,0,No user reviews,0,0,0
1179490,True,0,No user reviews,0,0,0
1179491,True,0,No user reviews,0,0,0
1179492,True,0,1 user reviews,1,0,1
1179493,True,0,1 user reviews,1,0,1
1179494,True,0,No user reviews,0,0,0
1179500,True,0,3 user reviews,3,0,3
1179510,True,0,No user reviews,0,0,0
1179520,True,0,No user reviews,0,0,0
1179530,True,0,No user reviews,0,0,0
1179540,True,0,4 user reviews,4,0,4
1179550,True,0,No user reviews,0,0,0
1179560,True,7,Positive,19,3,22
1179570,True,0,3 user reviews,3,0,3
1179580,True,0,No user reviews,0,0,0
1179590,True,0,No user reviews,0,0,0
1179620,True,0,3 user reviews,3,0,3
1179630,True,0,No user reviews,0,0,0
1179631,True,0,No user reviews,0,0,0
1179632,True,0,No user reviews,0,0,0
1179633,True,0,No user reviews,0,0,0
1179634,True,0,No user reviews,0,0,0
1179635,True,0,1 user reviews,1,0,1
1179636,True,0,No user reviews,0,0,0
1179637,True,0,No user reviews,0,0,0
1179638,True,0,No user reviews,0,0,0
1179639,True,0,No user reviews,0,0,0
1179650,True,0,No user reviews,0,0,0
1179651,True,0,No user reviews,0,0,0
1179652,True,0,No user reviews,0,0,0
1179653,True,0,1 user reviews,1,0,1
1179654,True,0,No user reviews,0,0,0
1179655,True,0,No user reviews,0,0,0
1179656,True,0,1 user reviews,1,0,1
1179660,True,0,No user reviews,0,0,0
1179680,True,0,No user reviews,0,0,0
1179690,True,0,No user reviews,0,0,0
1179710,True,5,Mixed,43,35,78
1179720,True,4,Mostly Negative,16,31,47
1179750,True,0,No user reviews,0,0,0
1179760,True,0,No user reviews,0,0,0
1179780,True,0,No user reviews,0,0,0
1179790,True,0,No user reviews,0,0,0
1179800,True,0,No user reviews,0,0,0
1179830,True,7,Positive,18,0,18
1179840,True,0,2 user reviews,0,2,2
1179880,True,0,1 user reviews,1,0,1
1179890,True,0,No user reviews,0,0,0
1179900,True,0,No user reviews,0,0,0
1179910,True,0,No user reviews,0,0,0
1179920,True,0,No user reviews,0,0,0
1179930,True,0,5 user reviews,4,1,5
1179950,True,0,4 user reviews,2,2,4
1179960,True,0,No user reviews,0,0,0
1180000,True,0,1 user reviews,1,0,1
1180010,True,7,Positive,13,1,14
1180020,True,0,No user reviews,0,0,0
1180030,True,0,No user reviews,0,0,0
1180050,True,0,No user reviews,0,0,0
1180070,True,0,1 user reviews,1,0,1
1180110,True,0,No user reviews,0,0,0
1180120,True,8,Very Positive,51,1,52
1180130,True,0,No user reviews,0,0,0
1180140,True,0,No user reviews,0,0,0
1180150,True,0,No user reviews,0,0,0
1180160,True,0,No user reviews,0,0,0
1180170,True,0,No user reviews,0,0,0
1180180,True,0,No user reviews,0,0,0
1180190,True,0,2 user reviews,2,0,2
1180210,True,0,No user reviews,0,0,0
1180230,True,0,No user reviews,0,0,0
1180240,True,0,No user reviews,0,0,0
1180250,True,7,Positive,30,3,33
1180260,True,0,No user reviews,0,0,0
1180270,True,6,Mostly Positive,11,3,14
1180310,True,0,No user reviews,0,0,0
1180330,True,6,Mostly Positive,25,7,32
1180350,True,0,No user reviews,0,0,0
1180360,True,0,No user reviews,0,0,0
1180370,True,0,3 user reviews,2,1,3
1180380,True,0,No user reviews,0,0,0
1180390,True,0,No user reviews,0,0,0
1180410,True,0,No user reviews,0,0,0
1180420,True,0,3 user reviews,2,1,3
1180450,True,0,3 user reviews,2,1,3
1180460,True,0,No user reviews,0,0,0
1180490,True,7,Positive,18,0,18
1180491,True,7,Positive,18,1,19
1180510,True,7,Positive,12,0,12
1180520,True,0,No user reviews,0,0,0
1180530,True,0,No user reviews,0,0,0
1180540,True,7,Positive,40,0,40
1180550,True,0,1 user reviews,0,1,1
1180560,True,0,2 user reviews,2,0,2
1180570,True,0,1 user reviews,1,0,1
1180590,True,0,No user reviews,0,0,0
1180600,True,0,No user reviews,0,0,0
1180610,True,0,9 user reviews,9,0,9
1180620,True,0,6 user reviews,4,2,6
1180630,True,0,No user reviews,0,0,0
1180640,True,0,No user reviews,0,0,0
1180650,True,0,2 user reviews,1,1,2
1180660,True,8,Very Positive,481,48,529
1180670,True,0,No user reviews,0,0,0
1180690,True,0,1 user reviews,1,0,1
1180700,True,0,2 user reviews,2,0,2
1180730,True,0,2 user reviews,1,1,2
1180750,True,0,No user reviews,0,0,0
1180760,True,0,No user reviews,0,0,0
1180770,True,0,No user reviews,0,0,0
1180780,True,0,No user reviews,0,0,0
1180790,True,0,No user reviews,0,0,0
1180800,True,0,No user reviews,0,0,0
1180820,True,0,1 user reviews,0,1,1
1180840,True,0,No user reviews,0,0,0
1180890,True,0,No user reviews,0,0,0
1180900,True,7,Positive,15,0,15
1180910,True,0,2 user reviews,0,2,2
1180940,True,0,3 user reviews,2,1,3
1180950,True,0,2 user reviews,1,1,2
1180960,True,0,No user reviews,0,0,0
1180970,True,0,6 user reviews,5,1,6
1180980,True,0,No user reviews,0,0,0
1181000,True,8,Very Positive,51,1,52
1181010,True,0,No user reviews,0,0,0
1181020,True,0,1 user reviews,0,1,1
1181030,True,7,Positive,13,2,15
1181040,True,0,No user reviews,0,0,0
1181050,True,0,No user reviews,0,0,0
1181070,True,0,No user reviews,0,0,0
1181120,True,0,6 user reviews,4,2,6
1181130,True,5,Mixed,7,4,11
1181140,True,6,Mostly Positive,72,21,93
1181150,True,0,No user reviews,0,0,0
1181160,True,0,No user reviews,0,0,0
1181170,True,0,1 user reviews,0,1,1
1181220,True,0,3 user reviews,3,0,3
1181230,True,0,No user reviews,0,0,0
1181250,True,0,No user reviews,0,0,0
1181260,True,0,No user reviews,0,0,0
1181270,True,0,7 user reviews,4,3,7
1181280,True,0,3 user reviews,1,2,3
1181290,True,0,2 user reviews,1,1,2
1181320,True,0,No user reviews,0,0,0
1181330,True,0,5 user reviews,4,1,5
1181350,True,0,No user reviews,0,0,0
1181360,True,0,No user reviews,0,0,0
1181390,True,0,No user reviews,0,0,0
1181400,True,7,Positive,39,0,39
1181430,True,0,No user reviews,0,0,0
1181440,True,7,Positive,31,7,38
1181470,True,0,3 user reviews,2,1,3
1181490,True,0,No user reviews,0,0,0
1181500,True,0,No user reviews,0,0,0
1181510,True,0,1 user reviews,1,0,1
1181520,True,7,Positive,9,2,11
1181530,True,0,5 user reviews,4,1,5
1181540,True,0,No user reviews,0,0,0
1181541,True,0,No user reviews,0,0,0
1181542,True,0,No user reviews,0,0,0
1181550,True,0,No user reviews,0,0,0
1181570,True,7,Positive,32,1,33
1181600,True,0,5 user reviews,5,0,5
1181630,True,0,2 user reviews,2,0,2
1181640,True,0,No user reviews,0,0,0
1181650,True,0,No user reviews,0,0,0
1181680,True,0,No user reviews,0,0,0
1181700,True,0,No user reviews,0,0,0
1181720,True,0,No user reviews,0,0,0
1181740,True,0,No user reviews,0,0,0
1181750,True,0,1 user reviews,1,0,1
1181760,True,0,No user reviews,0,0,0
1181770,True,0,4 user reviews,4,0,4
1181771,True,7,Positive,9,1,10
1181772,True,0,2 user reviews,2,0,2
1181773,True,0,1 user reviews,1,0,1
1181774,True,0,2 user reviews,2,0,2
1181775,True,0,No user reviews,0,0,0
1181790,True,0,2 user reviews,2,0,2
1181800,True,0,No user reviews,0,0,0
1181820,True,0,1 user reviews,0,1,1
1181830,True,8,Very Positive,363,21,384
1181840,True,0,No user reviews,0,0,0
1181860,True,0,No user reviews,0,0,0
1181870,True,0,No user reviews,0,0,0
1181880,True,0,1 user reviews,1,0,1
1181890,True,0,No user reviews,0,0,0
1181900,True,0,No user reviews,0,0,0
1181910,True,0,5 user reviews,5,0,5
1181930,True,0,No user reviews,0,0,0
1181940,True,0,No user reviews,0,0,0
1181950,True,0,No user reviews,0,0,0
1181970,True,0,No user reviews,0,0,0
1181990,True,5,Mixed,8,4,12
1182000,True,7,Positive,15,3,18
1182020,True,0,3 user reviews,3,0,3
1182040,True,0,No user reviews,0,0,0
1182050,True,0,No user reviews,0,0,0
1182060,True,5,Mixed,11,7,18
1182070,True,0,No user reviews,0,0,0
1182080,True,0,No user reviews,0,0,0
1182090,True,0,8 user reviews,8,0,8
1182100,True,0,No user reviews,0,0,0
1182110,True,0,No user reviews,0,0,0
1182120,True,0,No user reviews,0,0,0
1182150,True,0,No user reviews,0,0,0
1182160,True,0,No user reviews,0,0,0
1182180,True,0,No user reviews,0,0,0
1182190,True,0,6 user reviews,4,2,6
1182200,True,0,6 user reviews,5,1,6
1182210,True,0,No user reviews,0,0,0
1182220,True,0,No user reviews,0,0,0
1182230,True,0,No user reviews,0,0,0
1182260,True,0,No user reviews,0,0,0
1182270,True,0,No user reviews,0,0,0
1182280,True,0,No user reviews,0,0,0
1182290,True,0,No user reviews,0,0,0
1182291,True,0,2 user reviews,2,0,2
1182292,True,0,1 user reviews,1,0,1
1182293,True,0,1 user reviews,1,0,1
1182294,True,0,1 user reviews,1,0,1
1182300,True,0,1 user reviews,1,0,1
1182301,True,0,1 user reviews,1,0,1
1182302,True,0,No user reviews,0,0,0
1182303,True,0,1 user reviews,1,0,1
1182304,True,0,1 user reviews,1,0,1
1182305,True,0,1 user reviews,1,0,1
1182306,True,0,1 user reviews,1,0,1
1182307,True,0,No user reviews,0,0,0
1182308,True,0,1 user reviews,1,0,1
1182309,True,0,No user reviews,0,0,0
1182310,True,0,No user reviews,0,0,0
1182320,True,0,No user reviews,0,0,0
1182330,True,0,1 user reviews,0,1,1
1182340,True,0,2 user reviews,2,0,2
1182360,True,0,1 user reviews,0,1,1
1182370,True,0,No user reviews,0,0,0
1182380,True,0,No user reviews,0,0,0
1182390,True,0,1 user reviews,0,1,1
1182400,True,0,No user reviews,0,0,0
1182410,True,0,No user reviews,0,0,0
1182420,True,0,No user reviews,0,0,0
1182450,True,0,No user reviews,0,0,0
1182470,True,7,Positive,9,1,10
1182510,True,0,No user reviews,0,0,0
1182520,True,0,No user reviews,0,0,0
1182540,True,0,No user reviews,0,0,0
1182550,True,0,No user reviews,0,0,0
1182560,True,0,No user reviews,0,0,0
1182590,True,0,No user reviews,0,0,0
1182620,True,0,No user reviews,0,0,0
1182640,True,0,No user reviews,0,0,0
1182670,True,0,4 user reviews,3,1,4
1182690,True,0,1 user reviews,0,1,1
1182720,True,0,2 user reviews,2,0,2
1182730,True,0,No user reviews,0,0,0
1182760,True,5,Mixed,8,8,16
1182770,True,0,2 user reviews,2,0,2
1182790,True,0,No user reviews,0,0,0
1182820,True,0,No user reviews,0,0,0
1182830,True,8,Very Positive,49,3,52
1182840,True,0,No user reviews,0,0,0
1182870,True,0,No user reviews,0,0,0
1182880,True,0,No user reviews,0,0,0
1182890,True,0,1 user reviews,1,0,1
1182920,True,8,Very Positive,86,6,92
1182930,True,5,Mixed,10,5,15
1182940,True,6,Mostly Positive,12,5,17
1182950,True,0,No user reviews,0,0,0
1182970,True,5,Mixed,7,10,17
1183010,True,0,No user reviews,0,0,0
1183030,True,5,Mixed,44,20,64
1183050,True,0,9 user reviews,6,3,9
1183051,True,0,4 user reviews,2,2,4
1183052,True,0,3 user reviews,3,0,3
1183080,True,0,8 user reviews,6,2,8
1183100,True,0,5 user reviews,5,0,5
1183101,True,0,4 user reviews,4,0,4
1183102,True,0,3 user reviews,3,0,3
1183110,True,0,No user reviews,0,0,0
1183140,True,0,4 user reviews,4,0,4
1183170,True,0,8 user reviews,7,1,8
1183180,True,0,No user reviews,0,0,0
1183190,True,0,No user reviews,0,0,0
1183200,True,0,1 user reviews,1,0,1
1183210,True,0,2 user reviews,2,0,2
1183220,True,0,No user reviews,0,0,0
1183230,True,0,4 user reviews,4,0,4
1183240,True,0,6 user reviews,5,1,6
1183250,True,0,No user reviews,0,0,0
1183260,True,0,5 user reviews,5,0,5
1183270,True,0,No user reviews,0,0,0
1183280,True,0,3 user reviews,2,1,3
1183290,True,0,No user reviews,0,0,0
1183300,True,0,5 user reviews,3,2,5
1183310,True,0,No user reviews,0,0,0
1183320,True,0,No user reviews,0,0,0
1183340,True,0,No user reviews,0,0,0
1183350,True,0,No user reviews,0,0,0
1183370,True,0,No user reviews,0,0,0
1183410,True,0,1 user reviews,1,0,1
1183420,True,0,No user reviews,0,0,0
1183440,True,0,No user reviews,0,0,0
1183460,True,0,No user reviews,0,0,0
1183470,True,7,Positive,37,6,43
1183480,True,0,3 user reviews,3,0,3
1183500,True,7,Positive,22,2,24
1183510,True,0,6 user reviews,2,4,6
1183520,True,0,No user reviews,0,0,0
1183530,True,0,No user reviews,0,0,0
1183540,True,0,5 user reviews,4,1,5
1183560,True,0,No user reviews,0,0,0
1183580,True,0,2 user reviews,2,0,2
1183590,True,7,Positive,11,1,12
1183600,True,0,No user reviews,0,0,0
1183610,True,0,No user reviews,0,0,0
1183620,True,0,No user reviews,0,0,0
1183621,True,0,No user reviews,0,0,0
1183630,True,0,No user reviews,0,0,0
1183650,True,0,No user reviews,0,0,0
1183670,True,0,5 user reviews,4,1,5
1183720,True,7,Positive,30,7,37
1183730,True,0,No user reviews,0,0,0
1183740,True,0,No user reviews,0,0,0
1183750,True,0,No user reviews,0,0,0
1183800,True,0,No user reviews,0,0,0
1183820,True,0,No user reviews,0,0,0
1183840,True,0,4 user reviews,4,0,4
1183860,True,0,No user reviews,0,0,0
1183960,True,0,No user reviews,0,0,0
1183970,True,8,Very Positive,1465,109,1574
1183980,True,0,No user reviews,0,0,0
1183990,True,0,No user reviews,0,0,0
1184010,True,0,No user reviews,0,0,0
1184040,True,0,6 user reviews,5,1,6
1184050,True,8,Very Positive,1157,266,1423
1184070,True,0,1 user reviews,0,1,1
1184080,True,0,No user reviews,0,0,0
1184090,True,0,7 user reviews,4,3,7
1184100,True,0,1 user reviews,1,0,1
1184101,True,0,1 user reviews,1,0,1
1184110,True,0,No user reviews,0,0,0
1184130,True,0,No user reviews,0,0,0
1184140,True,0,No user reviews,0,0,0
1184160,True,0,No user reviews,0,0,0
1184190,True,0,No user reviews,0,0,0
1184200,True,0,No user reviews,0,0,0
1184210,True,0,No user reviews,0,0,0
1184230,True,0,3 user reviews,1,2,3
1184240,True,0,3 user reviews,2,1,3
1184250,True,0,No user reviews,0,0,0
1184260,True,0,No user reviews,0,0,0
1184270,True,0,No user reviews,0,0,0
1184290,True,0,3 user reviews,3,0,3
1184310,True,0,1 user reviews,1,0,1
1184320,True,0,No user reviews,0,0,0
1184330,True,0,No user reviews,0,0,0
1184350,True,7,Positive,13,0,13
1184351,True,0,No user reviews,0,0,0
1184360,True,0,No user reviews,0,0,0
1184380,True,0,No user reviews,0,0,0
1184400,True,5,Mixed,9,8,17
1184410,True,8,Very Positive,137,11,148
1184411,True,5,Mixed,140,98,238
1184412,True,5,Mixed,44,44,88
1184420,True,0,2 user reviews,2,0,2
1184450,True,7,Positive,13,0,13
1184460,True,0,No user reviews,0,0,0
1184470,True,0,1 user reviews,1,0,1
1184480,True,8,Very Positive,178,10,188
1184520,True,0,No user reviews,0,0,0
1184530,True,0,No user reviews,0,0,0
1184550,True,6,Mostly Positive,9,3,12
1184560,True,0,No user reviews,0,0,0
1184570,True,0,4 user reviews,2,2,4
1184580,True,0,No user reviews,0,0,0
1184590,True,0,No user reviews,0,0,0
1184600,True,0,No user reviews,0,0,0
1184630,True,0,No user reviews,0,0,0
1184640,True,0,No user reviews,0,0,0
1184650,True,0,No user reviews,0,0,0
1184651,True,0,No user reviews,0,0,0
1184660,True,0,No user reviews,0,0,0
1184661,True,0,No user reviews,0,0,0
1184680,True,0,No user reviews,0,0,0
1184690,True,0,No user reviews,0,0,0
1184700,True,0,1 user reviews,1,0,1
1184710,True,0,No user reviews,0,0,0
1184720,True,0,No user reviews,0,0,0
1184750,True,0,No user reviews,0,0,0
1184770,True,9,Overwhelmingly Positive,695,27,722
1184780,True,0,2 user reviews,2,0,2
1184790,True,0,No user reviews,0,0,0
1184810,True,8,Very Positive,55,1,56
1184820,True,0,No user reviews,0,0,0
1184830,True,0,No user reviews,0,0,0
1184840,True,7,Positive,41,2,43
1184870,True,0,No user reviews,0,0,0
1184880,True,0,3 user reviews,2,1,3
1184890,True,0,No user reviews,0,0,0
1184900,True,7,Positive,17,0,17
1184910,True,0,No user reviews,0,0,0
1184920,True,0,No user reviews,0,0,0
1184960,True,0,9 user reviews,9,0,9
1184980,True,0,1 user reviews,0,1,1
1184990,True,7,Positive,45,4,49
1185000,True,0,3 user reviews,2,1,3
1185030,True,0,No user reviews,0,0,0
1185040,True,0,No user reviews,0,0,0
1185050,True,0,No user reviews,0,0,0
1185070,True,0,No user reviews,0,0,0
1185130,True,0,No user reviews,0,0,0
1185160,True,8,Very Positive,52,12,64
1185190,True,0,No user reviews,0,0,0
1185200,True,0,No user reviews,0,0,0
1185210,True,0,No user reviews,0,0,0
1185230,True,0,No user reviews,0,0,0
1185260,True,0,No user reviews,0,0,0
1185270,True,0,1 user reviews,0,1,1
1185280,True,0,3 user reviews,3,0,3
1185290,True,0,No user reviews,0,0,0
1185310,True,0,No user reviews,0,0,0
1185330,True,0,6 user reviews,4,2,6
1185340,True,0,No user reviews,0,0,0
1185360,True,0,No user reviews,0,0,0
1185370,True,0,No user reviews,0,0,0
1185390,True,0,1 user reviews,1,0,1
1185400,True,0,No user reviews,0,0,0
1185410,True,0,No user reviews,0,0,0
1185440,True,0,3 user reviews,3,0,3
1185470,True,0,7 user reviews,7,0,7
1185480,True,0,3 user reviews,3,0,3
1185490,True,0,No user reviews,0,0,0
1185500,True,0,No user reviews,0,0,0
1185520,True,8,Very Positive,82,18,100
1185530,True,0,No user reviews,0,0,0
1185550,True,0,No user reviews,0,0,0
1185560,True,5,Mixed,327,160,487
1185570,True,0,No user reviews,0,0,0
1185580,True,0,No user reviews,0,0,0
1185600,True,0,1 user reviews,0,1,1
1185620,True,0,No user reviews,0,0,0
1185630,True,0,2 user reviews,2,0,2
1185640,True,0,No user reviews,0,0,0
1185650,True,0,No user reviews,0,0,0
1185660,True,0,4 user reviews,3,1,4
1185680,True,0,6 user reviews,1,5,6
1185690,True,0,No user reviews,0,0,0
1185700,True,7,Positive,14,2,16
1185710,True,0,No user reviews,0,0,0
1185720,True,0,No user reviews,0,0,0
1185730,True,0,5 user reviews,5,0,5
1185740,True,0,5 user reviews,4,1,5
1185760,True,0,1 user reviews,0,1,1
1185771,True,0,No user reviews,0,0,0
1185780,True,0,No user reviews,0,0,0
1185790,True,0,No user reviews,0,0,0
1185810,True,0,No user reviews,0,0,0
1185820,True,7,Positive,36,2,38
1185850,True,0,No user reviews,0,0,0
1185870,True,7,Positive,8,2,10
1185890,True,0,No user reviews,0,0,0
1185910,True,0,6 user reviews,5,1,6
1185920,True,0,No user reviews,0,0,0
1185930,True,0,No user reviews,0,0,0
1185950,True,0,4 user reviews,3,1,4
1185960,True,0,2 user reviews,1,1,2
1185970,True,0,No user reviews,0,0,0
1185980,True,0,No user reviews,0,0,0
1185990,True,0,1 user reviews,0,1,1
1186000,True,0,No user reviews,0,0,0
1186010,True,0,1 user reviews,0,1,1
1186030,True,0,5 user reviews,4,1,5
1186040,True,0,No user reviews,0,0,0
1186050,True,0,No user reviews,0,0,0
1186060,True,0,No user reviews,0,0,0
1186080,True,0,No user reviews,0,0,0
1186100,True,0,5 user reviews,4,1,5
1186120,True,0,No user reviews,0,0,0
1186130,True,0,No user reviews,0,0,0
1186140,True,0,No user reviews,0,0,0
1186160,True,7,Positive,14,2,16
1186170,True,0,No user reviews,0,0,0
1186200,True,0,No user reviews,0,0,0
1186220,True,7,Positive,16,1,17
1186260,True,5,Mixed,7,7,14
1186270,True,0,1 user reviews,1,0,1
1186280,True,0,2 user reviews,2,0,2
1186290,True,0,8 user reviews,2,6,8
1186300,True,0,No user reviews,0,0,0
1186310,True,0,1 user reviews,1,0,1
1186320,True,0,No user reviews,0,0,0
1186340,True,0,4 user reviews,4,0,4
1186350,True,0,2 user reviews,2,0,2
1186390,True,0,No user reviews,0,0,0
1186400,True,6,Mostly Positive,69,19,88
1186410,True,0,No user reviews,0,0,0
1186420,True,0,No user reviews,0,0,0
1186430,True,0,No user reviews,0,0,0
1186460,True,0,4 user reviews,4,0,4
1186510,True,0,2 user reviews,1,1,2
1186520,True,0,No user reviews,0,0,0
1186530,True,0,3 user reviews,2,1,3
1186540,True,0,No user reviews,0,0,0
1186560,True,5,Mixed,11,6,17
1186561,True,5,Mixed,8,5,13
1186570,True,0,2 user reviews,2,0,2
1186580,True,0,9 user reviews,8,1,9
1186590,True,0,No user reviews,0,0,0
1186600,True,5,Mixed,4,6,10
1186610,True,0,No user reviews,0,0,0
1186620,True,0,No user reviews,0,0,0
1186630,True,0,3 user reviews,1,2,3
1186640,True,8,Very Positive,392,17,409
1186650,True,0,2 user reviews,0,2,2
1186670,True,0,No user reviews,0,0,0
1186680,True,0,No user reviews,0,0,0
1186690,True,0,1 user reviews,1,0,1
1186720,True,0,1 user reviews,1,0,1
1186730,True,0,No user reviews,0,0,0
1186740,True,0,1 user reviews,1,0,1
1186750,True,0,No user reviews,0,0,0
1186760,True,0,No user reviews,0,0,0
1186770,True,0,1 user reviews,0,1,1
1186860,True,0,No user reviews,0,0,0
1186870,True,0,2 user reviews,2,0,2
1186871,True,0,1 user reviews,1,0,1
1186872,True,0,2 user reviews,2,0,2
1186873,True,0,1 user reviews,1,0,1
1186874,True,0,3 user reviews,3,0,3
1186875,True,0,1 user reviews,1,0,1
1186876,True,0,2 user reviews,2,0,2
1186877,True,0,4 user reviews,4,0,4
1186880,True,7,Positive,24,4,28
1186940,True,0,1 user reviews,0,1,1
1186960,True,0,No user reviews,0,0,0
1186970,True,0,No user reviews,0,0,0
1186980,True,0,No user reviews,0,0,0
1187020,True,0,No user reviews,0,0,0
1187030,True,0,1 user reviews,0,1,1
1187040,True,0,No user reviews,0,0,0
1187050,True,0,No user reviews,0,0,0
1187060,True,0,No user reviews,0,0,0
1187100,True,0,No user reviews,0,0,0
1187110,True,0,2 user reviews,1,1,2
1187130,True,0,No user reviews,0,0,0
1187150,True,0,No user reviews,0,0,0
1187151,True,0,No user reviews,0,0,0
1187152,True,0,No user reviews,0,0,0
1187153,True,0,1 user reviews,1,0,1
1187154,True,0,No user reviews,0,0,0
1187155,True,0,No user reviews,0,0,0
1187160,True,0,No user reviews,0,0,0
1187170,True,0,3 user reviews,3,0,3
1187190,True,0,2 user reviews,2,0,2
1187210,True,0,No user reviews,0,0,0
1187230,True,0,1 user reviews,1,0,1
1187240,True,0,2 user reviews,2,0,2
1187250,True,0,No user reviews,0,0,0
1187260,True,0,No user reviews,0,0,0
1187300,True,0,No user reviews,0,0,0
1187301,True,0,No user reviews,0,0,0
1187302,True,0,No user reviews,0,0,0
1187303,True,0,No user reviews,0,0,0
1187304,True,0,No user reviews,0,0,0
1187305,True,0,No user reviews,0,0,0
1187306,True,0,No user reviews,0,0,0
1187307,True,0,No user reviews,0,0,0
1187308,True,0,No user reviews,0,0,0
1187309,True,0,No user reviews,0,0,0
1187310,True,0,No user reviews,0,0,0
1187311,True,0,No user reviews,0,0,0
1187312,True,0,No user reviews,0,0,0
1187313,True,0,No user reviews,0,0,0
1187314,True,0,No user reviews,0,0,0
1187315,True,0,No user reviews,0,0,0
1187316,True,0,No user reviews,0,0,0
1187317,True,0,No user reviews,0,0,0
1187318,True,0,No user reviews,0,0,0
1187319,True,0,No user reviews,0,0,0
1187320,True,0,No user reviews,0,0,0
1187321,True,0,No user reviews,0,0,0
1187322,True,0,No user reviews,0,0,0
1187323,True,0,No user reviews,0,0,0
1187324,True,0,No user reviews,0,0,0
1187325,True,0,No user reviews,0,0,0
1187326,True,0,No user reviews,0,0,0
1187327,True,0,No user reviews,0,0,0
1187328,True,0,No user reviews,0,0,0
1187330,True,8,Very Positive,77,14,91
1187360,True,0,No user reviews,0,0,0
1187370,True,0,No user reviews,0,0,0
1187410,True,0,No user reviews,0,0,0
1187420,True,0,7 user reviews,3,4,7
1187430,True,0,No user reviews,0,0,0
1187450,True,0,No user reviews,0,0,0
1187490,True,0,4 user reviews,3,1,4
1187500,True,0,No user reviews,0,0,0
1187510,True,8,Very Positive,86,5,91
1187520,True,0,No user reviews,0,0,0
1187530,True,0,No user reviews,0,0,0
1187540,True,0,No user reviews,0,0,0
1187541,True,0,No user reviews,0,0,0
1187550,True,0,No user reviews,0,0,0
1187560,True,0,No user reviews,0,0,0
1187600,True,7,Positive,14,2,16
1187620,True,0,6 user reviews,3,3,6
1187630,True,0,3 user reviews,2,1,3
1187631,True,0,5 user reviews,4,1,5
1187640,True,0,No user reviews,0,0,0
1187650,True,0,4 user reviews,3,1,4
1187670,True,0,No user reviews,0,0,0
1187680,True,0,1 user reviews,1,0,1
1187700,True,0,No user reviews,0,0,0
1187740,True,0,3 user reviews,1,2,3
1187750,True,0,No user reviews,0,0,0
1187760,True,0,No user reviews,0,0,0
1187780,True,0,No user reviews,0,0,0
1187790,True,0,5 user reviews,3,2,5
1187810,True,0,No user reviews,0,0,0
1187820,True,0,No user reviews,0,0,0
1187821,True,0,No user reviews,0,0,0
1187830,True,0,1 user reviews,1,0,1
1187840,True,0,No user reviews,0,0,0
1187850,True,0,No user reviews,0,0,0
1187870,True,0,No user reviews,0,0,0
1187880,True,0,No user reviews,0,0,0
1187881,True,0,No user reviews,0,0,0
1187900,True,0,1 user reviews,1,0,1
1187910,True,0,No user reviews,0,0,0
1187920,True,0,No user reviews,0,0,0
1187940,True,5,Mixed,24,28,52
1187950,True,0,1 user reviews,1,0,1
1187990,True,0,No user reviews,0,0,0
1188000,True,7,Positive,15,0,15
1188020,True,0,No user reviews,0,0,0
1188040,True,0,2 user reviews,2,0,2
1188060,True,0,2 user reviews,1,1,2
1188070,True,0,No user reviews,0,0,0
1188080,True,7,Positive,40,3,43
1188090,True,0,2 user reviews,1,1,2
1188100,True,0,No user reviews,0,0,0
1188110,True,0,No user reviews,0,0,0
1188120,True,0,1 user reviews,1,0,1
1188140,True,0,5 user reviews,4,1,5
1188210,True,0,No user reviews,0,0,0
1188230,True,0,No user reviews,0,0,0
1188250,True,7,Positive,39,5,44
1188260,True,5,Mixed,29,16,45
1188280,True,0,1 user reviews,1,0,1
1188290,True,0,No user reviews,0,0,0
1188310,True,0,5 user reviews,5,0,5
1188320,True,0,No user reviews,0,0,0
1188330,True,8,Very Positive,151,8,159
1188360,True,0,No user reviews,0,0,0
1188400,True,0,No user reviews,0,0,0
1188420,True,0,No user reviews,0,0,0
1188430,True,0,5 user reviews,2,3,5
1188460,True,0,No user reviews,0,0,0
1188490,True,0,No user reviews,0,0,0
1188500,True,0,No user reviews,0,0,0
1188520,True,0,No user reviews,0,0,0
1188530,True,0,No user reviews,0,0,0
1188540,True,7,Positive,22,4,26
1188570,True,0,No user reviews,0,0,0
1188580,True,0,2 user reviews,2,0,2
1188590,True,0,No user reviews,0,0,0
1188600,True,0,6 user reviews,4,2,6
1188601,True,0,No user reviews,0,0,0
1188602,True,0,No user reviews,0,0,0
1188603,True,0,No user reviews,0,0,0
1188604,True,0,No user reviews,0,0,0
1188605,True,0,No user reviews,0,0,0
1188606,True,0,No user reviews,0,0,0
1188607,True,0,No user reviews,0,0,0
1188608,True,0,1 user reviews,1,0,1
1188609,True,0,2 user reviews,0,2,2
1188610,True,0,2 user reviews,2,0,2
1188611,True,0,2 user reviews,2,0,2
1188612,True,0,No user reviews,0,0,0
1188613,True,0,No user reviews,0,0,0
1188614,True,0,No user reviews,0,0,0
1188615,True,0,4 user reviews,4,0,4
1188616,True,0,1 user reviews,0,1,1
1188617,True,0,2 user reviews,0,2,2
1188618,True,0,2 user reviews,1,1,2
1188619,True,0,2 user reviews,2,0,2
1188620,True,0,1 user reviews,1,0,1
1188630,True,0,No user reviews,0,0,0
1188640,True,0,No user reviews,0,0,0
1188660,True,0,3 user reviews,3,0,3
1188670,True,0,1 user reviews,1,0,1
1188680,True,6,Mostly Positive,190,67,257
1188690,True,0,No user reviews,0,0,0
1188710,True,0,No user reviews,0,0,0
1188720,True,0,No user reviews,0,0,0
1188730,True,0,No user reviews,0,0,0
1188760,True,7,Positive,17,2,19
1188770,True,0,No user reviews,0,0,0
1188780,True,0,No user reviews,0,0,0
1188800,True,0,2 user reviews,2,0,2
1188810,True,0,No user reviews,0,0,0
1188830,True,0,No user reviews,0,0,0
1188840,True,0,No user reviews,0,0,0
1188850,True,0,No user reviews,0,0,0
1188860,True,0,No user reviews,0,0,0
1188870,True,0,No user reviews,0,0,0
1188900,True,0,No user reviews,0,0,0
1188910,True,0,No user reviews,0,0,0
1188920,True,0,No user reviews,0,0,0
1188930,True,8,Very Positive,128,8,136
1188940,True,0,No user reviews,0,0,0
1188950,True,0,No user reviews,0,0,0
1188970,True,8,Very Positive,79,17,96
1188990,True,0,6 user reviews,5,1,6
1189000,True,0,No user reviews,0,0,0
1189020,True,0,2 user reviews,0,2,2
1189030,True,0,No user reviews,0,0,0
1189040,True,0,1 user reviews,0,1,1
1189050,True,5,Mixed,7,6,13
1189060,True,0,No user reviews,0,0,0
1189080,True,0,4 user reviews,2,2,4
1189090,True,0,No user reviews,0,0,0
1189110,True,0,No user reviews,0,0,0
1189120,True,0,1 user reviews,0,1,1
1189150,True,0,No user reviews,0,0,0
1189160,True,0,No user reviews,0,0,0
1189200,True,0,1 user reviews,1,0,1
1189210,True,0,No user reviews,0,0,0
1189220,True,0,No user reviews,0,0,0
1189230,True,6,Mostly Positive,98,33,131
1189250,True,0,No user reviews,0,0,0
1189260,True,0,No user reviews,0,0,0
1189261,True,0,No user reviews,0,0,0
1189290,True,0,No user reviews,0,0,0
1189300,True,0,No user reviews,0,0,0
1189310,True,0,No user reviews,0,0,0
1189350,True,0,No user reviews,0,0,0
1189360,True,0,5 user reviews,5,0,5
1189380,True,0,No user reviews,0,0,0
1189390,True,0,No user reviews,0,0,0
1189400,True,0,No user reviews,0,0,0
1189430,True,0,No user reviews,0,0,0
1189440,True,7,Positive,19,4,23
1189460,True,6,Mostly Positive,10,3,13
1189470,True,0,No user reviews,0,0,0
1189480,True,5,Mixed,22,19,41
1189490,True,7,Positive,14,0,14
1189520,True,0,2 user reviews,2,0,2
1189530,True,0,No user reviews,0,0,0
1189570,True,0,No user reviews,0,0,0
1189590,True,0,No user reviews,0,0,0
1189600,True,0,1 user reviews,1,0,1
1189620,True,0,No user reviews,0,0,0
1189630,True,8,Very Positive,364,16,380
1189650,True,0,2 user reviews,1,1,2
1189660,True,0,No user reviews,0,0,0
1189670,True,0,No user reviews,0,0,0
1189671,True,0,No user reviews,0,0,0
1189680,True,0,No user reviews,0,0,0
1189690,True,0,No user reviews,0,0,0
1189700,True,0,3 user reviews,1,2,3
1189720,True,0,No user reviews,0,0,0
1189730,True,0,No user reviews,0,0,0
1189740,True,6,Mostly Positive,11,4,15
1189750,True,0,4 user reviews,3,1,4
1189760,True,0,No user reviews,0,0,0
1189770,True,0,1 user reviews,1,0,1
1189780,True,7,Positive,26,6,32
1189800,True,6,Mostly Positive,525,199,724
1189820,True,0,No user reviews,0,0,0
1189850,True,0,No user reviews,0,0,0
1189870,True,0,No user reviews,0,0,0
1189871,True,0,1 user reviews,1,0,1
1189890,True,0,7 user reviews,4,3,7
1189900,True,0,6 user reviews,2,4,6
1189910,True,5,Mixed,5,5,10
1189940,True,0,No user reviews,0,0,0
1189950,True,0,No user reviews,0,0,0
1189990,True,0,No user reviews,0,0,0
1190010,True,0,1 user reviews,1,0,1
1190011,True,0,No user reviews,0,0,0
1190012,True,0,No user reviews,0,0,0
1190013,True,0,No user reviews,0,0,0
1190060,True,0,4 user reviews,4,0,4
1190110,True,8,Very Positive,240,21,261
1190120,True,0,4 user reviews,1,3,4
1190130,True,0,3 user reviews,1,2,3
1190140,True,0,No user reviews,0,0,0
1190150,True,0,5 user reviews,3,2,5
1190160,True,8,Very Positive,63,5,68
1190180,True,0,1 user reviews,1,0,1
1190190,True,0,No user reviews,0,0,0
1190210,True,0,1 user reviews,1,0,1
1190230,True,0,No user reviews,0,0,0
1190240,True,0,No user reviews,0,0,0
1190260,True,0,No user reviews,0,0,0
1190270,True,0,No user reviews,0,0,0
1190310,True,0,2 user reviews,2,0,2
1190320,True,0,No user reviews,0,0,0
1190330,True,0,No user reviews,0,0,0
1190331,True,0,No user reviews,0,0,0
1190350,True,0,No user reviews,0,0,0
1190360,True,0,No user reviews,0,0,0
1190370,True,0,No user reviews,0,0,0
1190380,True,6,Mostly Positive,8,3,11
1190400,True,8,Very Positive,117,22,139
1190410,True,0,3 user reviews,2,1,3
1190440,True,0,No user reviews,0,0,0
1190450,True,0,No user reviews,0,0,0
1190460,True,8,Very Positive,6427,532,6959
1190480,True,0,2 user reviews,1,1,2
1190490,True,0,1 user reviews,1,0,1
1190500,True,0,No user reviews,0,0,0
1190510,True,0,No user reviews,0,0,0
1190520,True,0,No user reviews,0,0,0
1190530,True,0,No user reviews,0,0,0
1190540,True,0,No user reviews,0,0,0
1190560,True,0,No user reviews,0,0,0
1190570,True,0,3 user reviews,2,1,3
1190580,True,0,No user reviews,0,0,0
1190590,True,0,1 user reviews,1,0,1
1190610,True,0,No user reviews,0,0,0
1190620,True,0,6 user reviews,1,5,6
1190630,True,0,No user reviews,0,0,0
1190640,True,0,1 user reviews,1,0,1
1190680,True,0,No user reviews,0,0,0
1190690,True,0,No user reviews,0,0,0
1190720,True,0,No user reviews,0,0,0
1190730,True,0,No user reviews,0,0,0
1190750,True,0,No user reviews,0,0,0
1190760,True,0,3 user reviews,0,3,3
1190770,True,0,1 user reviews,1,0,1
1190780,True,0,2 user reviews,0,2,2
1190800,True,0,No user reviews,0,0,0
1190810,True,0,7 user reviews,7,0,7
1190820,True,0,5 user reviews,5,0,5
1190840,True,0,7 user reviews,7,0,7
1190900,True,0,No user reviews,0,0,0
1190910,True,0,1 user reviews,1,0,1
1190920,True,0,No user reviews,0,0,0
1190930,True,0,7 user reviews,7,0,7
1190940,True,0,No user reviews,0,0,0
1190950,True,0,2 user reviews,2,0,2
1190960,True,0,No user reviews,0,0,0
1190980,True,0,1 user reviews,0,1,1
1190990,True,0,4 user reviews,4,0,4
1191000,True,0,No user reviews,0,0,0
1191010,True,0,7 user reviews,7,0,7
1191060,True,0,No user reviews,0,0,0
1191070,True,6,Mostly Positive,24,8,32
1191090,True,0,No user reviews,0,0,0
1191100,True,7,Positive,11,2,13
1191130,True,0,No user reviews,0,0,0
1191150,True,0,No user reviews,0,0,0
1191160,True,0,6 user reviews,4,2,6
1191161,True,7,Positive,13,1,14
1191162,True,0,8 user reviews,6,2,8
1191170,True,0,No user reviews,0,0,0
1191190,True,0,2 user reviews,2,0,2
1191210,True,8,Very Positive,138,33,171
1191230,True,0,No user reviews,0,0,0
1191250,True,0,No user reviews,0,0,0
1191270,True,0,No user reviews,0,0,0
1191280,True,0,4 user reviews,2,2,4
1191290,True,0,No user reviews,0,0,0
1191330,True,0,No user reviews,0,0,0
1191360,True,0,No user reviews,0,0,0
1191420,True,0,No user reviews,0,0,0
1191430,True,0,No user reviews,0,0,0
1191440,True,0,1 user reviews,0,1,1
1191450,True,0,No user reviews,0,0,0
1191490,True,7,Positive,16,0,16
1191500,True,5,Mixed,6,6,12
1191510,True,0,1 user reviews,0,1,1
1191530,True,0,No user reviews,0,0,0
1191540,True,0,No user reviews,0,0,0
1191550,True,0,No user reviews,0,0,0
1191570,True,0,No user reviews,0,0,0
1191580,True,8,Very Positive,222,20,242
1191590,True,0,9 user reviews,9,0,9
1191610,True,0,1 user reviews,1,0,1
1191630,True,8,Very Positive,333,32,365
1191650,True,0,No user reviews,0,0,0
1191660,True,0,No user reviews,0,0,0
1191680,True,0,No user reviews,0,0,0
1191690,True,0,No user reviews,0,0,0
1191700,True,0,No user reviews,0,0,0
1191790,True,0,5 user reviews,2,3,5
1191800,True,0,No user reviews,0,0,0
1191810,True,0,1 user reviews,1,0,1
1191820,True,0,2 user reviews,2,0,2
1191830,True,0,No user reviews,0,0,0
1191840,True,7,Positive,15,1,16
1191850,True,0,No user reviews,0,0,0
1191860,True,7,Positive,13,1,14
1191870,True,0,No user reviews,0,0,0
1191900,True,0,No user reviews,0,0,0
1191930,True,0,No user reviews,0,0,0
1191940,True,8,Very Positive,68,7,75
1191960,True,0,No user reviews,0,0,0
1191970,True,0,No user reviews,0,0,0
1191980,True,0,No user reviews,0,0,0
1192020,True,0,8 user reviews,4,4,8
1192060,True,0,3 user reviews,0,3,3
1192070,True,0,1 user reviews,1,0,1
1192080,True,0,No user reviews,0,0,0
1192110,True,0,No user reviews,0,0,0
1192160,True,0,1 user reviews,1,0,1
1192180,True,0,No user reviews,0,0,0
1192220,True,0,No user reviews,0,0,0
1192230,True,0,No user reviews,0,0,0
1192260,True,0,1 user reviews,1,0,1
1192270,True,0,1 user reviews,1,0,1
1192300,True,0,No user reviews,0,0,0
1192310,True,0,6 user reviews,4,2,6
1192320,True,0,No user reviews,0,0,0
1192340,True,0,3 user reviews,2,1,3
1192350,True,0,4 user reviews,3,1,4
1192360,True,0,No user reviews,0,0,0
1192370,True,0,No user reviews,0,0,0
1192371,True,0,No user reviews,0,0,0
1192380,True,7,Positive,11,1,12
1192390,True,0,2 user reviews,0,2,2
1192400,True,0,No user reviews,0,0,0
1192410,True,0,No user reviews,0,0,0
1192440,True,0,No user reviews,0,0,0
1192450,True,0,7 user reviews,6,1,7
1192490,True,0,No user reviews,0,0,0
1192500,True,0,1 user reviews,0,1,1
1192520,True,0,No user reviews,0,0,0
1192540,True,0,No user reviews,0,0,0
1192550,True,0,No user reviews,0,0,0
1192561,True,0,2 user reviews,0,2,2
1192580,True,5,Mixed,9,4,13
1192600,True,0,No user reviews,0,0,0
1192610,True,6,Mostly Positive,74,20,94
1192640,True,8,Very Positive,58,7,65
1192650,True,0,2 user reviews,2,0,2
1192670,True,0,No user reviews,0,0,0
1192680,True,0,2 user reviews,2,0,2
1192690,True,0,No user reviews,0,0,0
1192700,True,0,No user reviews,0,0,0
1192710,True,0,No user reviews,0,0,0
1192730,True,5,Mixed,21,12,33
1192740,True,0,3 user reviews,3,0,3
1192750,True,5,Mixed,11,5,16
1192770,True,0,No user reviews,0,0,0
1192790,True,0,No user reviews,0,0,0
1192820,True,5,Mixed,29,25,54
1192840,True,0,1 user reviews,1,0,1
1192860,True,0,2 user reviews,2,0,2
1192880,True,0,No user reviews,0,0,0
1192890,True,6,Mostly Positive,11,4,15
1192900,True,0,No user reviews,0,0,0
1192910,True,0,1 user reviews,1,0,1
1192920,True,0,No user reviews,0,0,0
1192940,True,0,No user reviews,0,0,0
1192950,True,0,No user reviews,0,0,0
1192960,True,0,No user reviews,0,0,0
1192990,True,0,No user reviews,0,0,0
1193040,True,0,No user reviews,0,0,0
1193060,True,0,No user reviews,0,0,0
1193070,True,0,No user reviews,0,0,0
1193080,True,0,No user reviews,0,0,0
1193090,True,0,No user reviews,0,0,0
1193110,True,0,2 user reviews,1,1,2
1193120,True,0,No user reviews,0,0,0
1193130,True,0,No user reviews,0,0,0
1193160,True,0,1 user reviews,0,1,1
1193190,True,0,No user reviews,0,0,0
1193200,True,0,3 user reviews,3,0,3
1193210,True,0,2 user reviews,2,0,2
1193220,True,0,No user reviews,0,0,0
1193240,True,0,No user reviews,0,0,0
1193280,True,0,No user reviews,0,0,0
1193290,True,0,No user reviews,0,0,0
1193300,True,0,No user reviews,0,0,0
1193320,True,0,No user reviews,0,0,0
1193330,True,0,3 user reviews,3,0,3
1193340,True,8,Very Positive,119,26,145
1193350,True,0,No user reviews,0,0,0
1193360,True,0,No user reviews,0,0,0
1193370,True,0,2 user reviews,2,0,2
1193380,True,0,No user reviews,0,0,0
1193390,True,0,1 user reviews,1,0,1
1193400,True,0,No user reviews,0,0,0
1193410,True,0,No user reviews,0,0,0
1193420,True,0,1 user reviews,1,0,1
1193430,True,0,2 user reviews,2,0,2
1193440,True,0,No user reviews,0,0,0
1193450,True,0,1 user reviews,0,1,1
1193460,True,0,1 user reviews,1,0,1
1193470,True,0,No user reviews,0,0,0
1193480,True,0,No user reviews,0,0,0
1193510,True,0,No user reviews,0,0,0
1193520,True,0,2 user reviews,1,1,2
1193530,True,0,2 user reviews,1,1,2
1193550,True,0,No user reviews,0,0,0
1193560,True,0,6 user reviews,6,0,6
1193570,True,0,No user reviews,0,0,0
1193590,True,0,No user reviews,0,0,0
1193600,True,0,No user reviews,0,0,0
1193610,True,0,No user reviews,0,0,0
1193611,True,0,No user reviews,0,0,0
1193612,True,0,No user reviews,0,0,0
1193613,True,0,No user reviews,0,0,0
1193620,True,0,No user reviews,0,0,0
1193630,True,0,No user reviews,0,0,0
1193640,True,0,No user reviews,0,0,0
1193660,True,0,No user reviews,0,0,0
1193680,True,0,No user reviews,0,0,0
1193690,True,0,No user reviews,0,0,0
1193730,True,0,No user reviews,0,0,0
1193750,True,0,No user reviews,0,0,0
1193760,True,0,No user reviews,0,0,0
1193780,True,0,1 user reviews,1,0,1
1193790,True,0,No user reviews,0,0,0
1193830,True,0,No user reviews,0,0,0
1193840,True,0,No user reviews,0,0,0
1193860,True,0,No user reviews,0,0,0
1193870,True,0,1 user reviews,1,0,1
1193871,True,7,Positive,12,3,15
1193890,True,0,1 user reviews,0,1,1
1193900,True,0,No user reviews,0,0,0
1193930,True,0,2 user reviews,2,0,2
1193950,True,0,1 user reviews,1,0,1
1193990,True,0,8 user reviews,7,1,8
1194000,True,0,2 user reviews,1,1,2
1194010,True,6,Mostly Positive,39,13,52
1194020,True,0,No user reviews,0,0,0
1194021,True,0,2 user reviews,2,0,2
1194050,True,0,No user reviews,0,0,0
1194060,True,0,No user reviews,0,0,0
1194070,True,0,No user reviews,0,0,0
1194080,True,0,No user reviews,0,0,0
1194100,True,0,1 user reviews,0,1,1
1194110,True,8,Very Positive,97,17,114
1194120,True,7,Positive,16,2,18
1194130,True,0,No user reviews,0,0,0
1194140,True,5,Mixed,12,10,22
1194160,True,0,2 user reviews,2,0,2
1194170,True,0,1 user reviews,1,0,1
1194190,True,0,No user reviews,0,0,0
1194200,True,0,No user reviews,0,0,0
1194220,True,0,2 user reviews,2,0,2
1194230,True,0,No user reviews,0,0,0
1194250,True,0,No user reviews,0,0,0
1194270,True,0,No user reviews,0,0,0
1194290,True,0,No user reviews,0,0,0
1194330,True,0,No user reviews,0,0,0
1194360,True,0,No user reviews,0,0,0
1194361,True,0,No user reviews,0,0,0
1194380,True,0,1 user reviews,1,0,1
1194390,True,0,4 user reviews,4,0,4
1194430,True,0,No user reviews,0,0,0
1194440,True,0,2 user reviews,2,0,2
1194470,True,0,2 user reviews,2,0,2
1194480,True,7,Positive,10,0,10
1194490,True,0,No user reviews,0,0,0
1194520,True,0,No user reviews,0,0,0
1194540,True,0,1 user reviews,1,0,1
1194560,True,0,No user reviews,0,0,0
1194570,True,7,Positive,14,3,17
1194590,True,0,No user reviews,0,0,0
1194600,True,0,1 user reviews,1,0,1
1194610,True,0,8 user reviews,7,1,8
1194620,True,0,No user reviews,0,0,0
1194630,True,6,Mostly Positive,21,9,30
1194640,True,0,No user reviews,0,0,0
1194650,True,0,No user reviews,0,0,0
1194661,True,0,No user reviews,0,0,0
1194670,True,0,No user reviews,0,0,0
1194680,True,8,Very Positive,48,7,55
1194690,True,0,4 user reviews,1,3,4
1194700,True,0,No user reviews,0,0,0
1194710,True,0,No user reviews,0,0,0
1194730,True,0,No user reviews,0,0,0
1194740,True,0,No user reviews,0,0,0
1194750,True,0,No user reviews,0,0,0
1194770,True,5,Mixed,13,9,22
1194780,True,0,1 user reviews,1,0,1
1194781,True,0,1 user reviews,1,0,1
1194790,True,0,8 user reviews,4,4,8
1194800,True,0,No user reviews,0,0,0
1194820,True,0,No user reviews,0,0,0
1194830,True,8,Very Positive,63,5,68
1194840,True,8,Very Positive,52,0,52
1194850,True,0,No user reviews,0,0,0
1194851,True,0,No user reviews,0,0,0
1194852,True,0,No user reviews,0,0,0
1194853,True,0,No user reviews,0,0,0
1194854,True,0,No user reviews,0,0,0
1194855,True,0,No user reviews,0,0,0
1194856,True,0,No user reviews,0,0,0
1194857,True,0,No user reviews,0,0,0
1194858,True,0,No user reviews,0,0,0
1194859,True,0,No user reviews,0,0,0
1194870,True,0,No user reviews,0,0,0
1194890,True,0,No user reviews,0,0,0
1194910,True,0,3 user reviews,3,0,3
1194930,True,5,Mixed,214,98,312
1194940,True,7,Positive,12,3,15
1194970,True,0,No user reviews,0,0,0
1194980,True,0,No user reviews,0,0,0
1195020,True,8,Very Positive,68,17,85
1195030,True,0,No user reviews,0,0,0
1195040,True,0,No user reviews,0,0,0
1195050,True,0,No user reviews,0,0,0
1195060,True,0,No user reviews,0,0,0
1195080,True,0,No user reviews,0,0,0
1195090,True,0,1 user reviews,1,0,1
1195130,True,0,No user reviews,0,0,0
1195140,True,0,No user reviews,0,0,0
1195150,True,0,3 user reviews,2,1,3
1195160,True,0,2 user reviews,2,0,2
1195161,True,0,No user reviews,0,0,0
1195162,True,0,No user reviews,0,0,0
1195163,True,0,No user reviews,0,0,0
1195164,True,0,No user reviews,0,0,0
1195165,True,0,No user reviews,0,0,0
1195166,True,0,No user reviews,0,0,0
1195167,True,0,No user reviews,0,0,0
1195170,True,0,4 user reviews,2,2,4
1195200,True,0,No user reviews,0,0,0
1195201,True,0,No user reviews,0,0,0
1195202,True,0,No user reviews,0,0,0
1195203,True,0,No user reviews,0,0,0
1195204,True,0,No user reviews,0,0,0
1195205,True,0,No user reviews,0,0,0
1195206,True,0,No user reviews,0,0,0
1195207,True,0,No user reviews,0,0,0
1195208,True,0,No user reviews,0,0,0
1195209,True,0,No user reviews,0,0,0
1195210,True,0,No user reviews,0,0,0
1195211,True,0,No user reviews,0,0,0
1195212,True,0,No user reviews,0,0,0
1195213,True,0,No user reviews,0,0,0
1195214,True,0,No user reviews,0,0,0
1195215,True,0,No user reviews,0,0,0
1195216,True,0,1 user reviews,0,1,1
1195220,True,0,No user reviews,0,0,0
1195230,True,7,Positive,12,0,12
1195240,True,5,Mixed,8,4,12
1195250,True,0,No user reviews,0,0,0
1195260,True,0,No user reviews,0,0,0
1195270,True,7,Positive,10,1,11
1195290,True,0,No user reviews,0,0,0
1195300,True,0,No user reviews,0,0,0
1195301,True,0,No user reviews,0,0,0
1195320,True,7,Positive,29,0,29
1195330,True,0,No user reviews,0,0,0
1195331,True,0,No user reviews,0,0,0
1195332,True,0,No user reviews,0,0,0
1195340,True,0,No user reviews,0,0,0
1195350,True,0,2 user reviews,1,1,2
1195360,True,5,Mixed,11,5,16
1195410,True,7,Positive,18,1,19
1195430,True,0,4 user reviews,4,0,4
1195440,True,0,No user reviews,0,0,0
1195450,True,0,No user reviews,0,0,0
1195460,True,5,Mixed,1009,523,1532
1195480,True,7,Positive,23,5,28
1195530,True,0,4 user reviews,4,0,4
1195540,True,0,1 user reviews,1,0,1
1195550,True,0,1 user reviews,0,1,1
1195570,True,0,2 user reviews,2,0,2
1195590,True,0,No user reviews,0,0,0
1195600,True,0,2 user reviews,2,0,2
1195610,True,0,No user reviews,0,0,0
1195620,True,0,2 user reviews,2,0,2
1195630,True,0,No user reviews,0,0,0
1195690,True,0,No user reviews,0,0,0
1195710,True,0,2 user reviews,2,0,2
1195740,True,0,No user reviews,0,0,0
1195750,True,0,1 user reviews,1,0,1
1195790,True,0,No user reviews,0,0,0
1195820,True,0,2 user reviews,0,2,2
1195830,True,0,No user reviews,0,0,0
1195840,True,0,No user reviews,0,0,0
1195870,True,0,No user reviews,0,0,0
1195880,True,0,No user reviews,0,0,0
1195881,True,0,No user reviews,0,0,0
1195882,True,0,No user reviews,0,0,0
1195883,True,0,No user reviews,0,0,0
1195884,True,0,No user reviews,0,0,0
1195885,True,0,No user reviews,0,0,0
1195886,True,0,No user reviews,0,0,0
1195900,True,0,No user reviews,0,0,0
1195901,True,0,No user reviews,0,0,0
1195902,True,0,No user reviews,0,0,0
1195903,True,0,No user reviews,0,0,0
1195904,True,0,No user reviews,0,0,0
1195905,True,0,No user reviews,0,0,0
1195906,True,0,1 user reviews,1,0,1
1195907,True,0,1 user reviews,1,0,1
1195910,True,7,Positive,15,1,16
1195920,True,7,Positive,10,2,12
1195930,True,0,No user reviews,0,0,0
1195940,True,0,No user reviews,0,0,0
1195950,True,0,No user reviews,0,0,0
1195960,True,0,No user reviews,0,0,0
1195970,True,0,No user reviews,0,0,0
1195980,True,0,No user reviews,0,0,0
1195990,True,0,No user reviews,0,0,0
1196010,True,0,No user reviews,0,0,0
1196020,True,0,No user reviews,0,0,0
1196030,True,0,No user reviews,0,0,0
1196040,True,0,1 user reviews,0,1,1
1196041,True,0,3 user reviews,2,1,3
1196070,True,0,No user reviews,0,0,0
1196080,True,6,Mostly Positive,13,4,17
1196100,True,0,7 user reviews,7,0,7
1196130,True,0,2 user reviews,2,0,2
1196141,True,0,No user reviews,0,0,0
1196150,True,7,Positive,12,3,15
1196160,True,0,2 user reviews,0,2,2
1196170,True,0,4 user reviews,4,0,4
1196180,True,0,No user reviews,0,0,0
1196190,True,0,2 user reviews,1,1,2
1196210,True,0,No user reviews,0,0,0
1196220,True,0,No user reviews,0,0,0
1196230,True,0,No user reviews,0,0,0
1196240,True,0,No user reviews,0,0,0
1196260,True,0,5 user reviews,2,3,5
1196280,True,0,1 user reviews,1,0,1
1196290,True,0,No user reviews,0,0,0
1196310,True,7,Positive,25,3,28
1196320,True,0,1 user reviews,1,0,1
1196330,True,0,No user reviews,0,0,0
1196340,True,0,No user reviews,0,0,0
1196350,True,0,1 user reviews,0,1,1
1196380,True,0,2 user reviews,2,0,2
1196390,True,0,4 user reviews,4,0,4
1196400,True,7,Positive,13,1,14
1196420,True,7,Positive,16,0,16
1196440,True,0,No user reviews,0,0,0
1196450,True,7,Positive,10,0,10
1196490,True,0,No user reviews,0,0,0
1196500,True,7,Positive,15,3,18
1196510,True,0,No user reviews,0,0,0
1196520,True,0,3 user reviews,1,2,3
1196550,True,0,No user reviews,0,0,0
1196560,True,0,No user reviews,0,0,0
1196561,True,0,No user reviews,0,0,0
1196570,True,0,3 user reviews,2,1,3
1196580,True,0,5 user reviews,5,0,5
1196620,True,0,No user reviews,0,0,0
1196630,True,8,Very Positive,356,44,400
1196651,True,0,6 user reviews,5,1,6
1196660,True,0,No user reviews,0,0,0
1196670,True,5,Mixed,6,6,12
1196680,True,0,No user reviews,0,0,0
1196690,True,0,1 user reviews,1,0,1
1196700,True,0,No user reviews,0,0,0
1196710,True,0,7 user reviews,5,2,7
1196720,True,0,No user reviews,0,0,0
1196730,True,0,No user reviews,0,0,0
1196750,True,0,5 user reviews,3,2,5
1196760,True,0,No user reviews,0,0,0
1196770,True,5,Mixed,84,47,131
1196780,True,0,7 user reviews,6,1,7
1196781,True,0,5 user reviews,4,1,5
1196782,True,0,3 user reviews,3,0,3
1196783,True,0,5 user reviews,5,0,5
1196784,True,0,8 user reviews,8,0,8
1196785,True,0,3 user reviews,2,1,3
1196786,True,0,2 user reviews,2,0,2
1196787,True,0,7 user reviews,7,0,7
1196788,True,7,Positive,10,1,11
1196789,True,0,2 user reviews,2,0,2
1196790,True,0,5 user reviews,5,0,5
1196791,True,7,Positive,46,1,47
1196792,True,0,4 user reviews,4,0,4
1196793,True,0,7 user reviews,7,0,7
1196794,True,7,Positive,9,1,10
1196800,True,0,9 user reviews,9,0,9
1196840,True,0,No user reviews,0,0,0
1196850,True,0,1 user reviews,0,1,1
1196870,True,0,No user reviews,0,0,0
1196880,True,0,No user reviews,0,0,0
1196890,True,0,7 user reviews,6,1,7
1196910,True,0,No user reviews,0,0,0
1196920,True,0,No user reviews,0,0,0
1196930,True,7,Positive,31,7,38
1196940,True,0,2 user reviews,2,0,2
1196960,True,0,No user reviews,0,0,0
1196970,True,0,2 user reviews,2,0,2
1197010,True,0,3 user reviews,2,1,3
1197020,True,0,1 user reviews,1,0,1
1197030,True,7,Positive,20,0,20
1197040,True,0,No user reviews,0,0,0
1197050,True,0,No user reviews,0,0,0
1197060,True,0,2 user reviews,2,0,2
1197070,True,0,No user reviews,0,0,0
1197080,True,0,No user reviews,0,0,0
1197100,True,0,5 user reviews,3,2,5
1197110,True,0,5 user reviews,1,4,5
1197130,True,0,No user reviews,0,0,0
1197150,True,0,5 user reviews,4,1,5
1197170,True,0,No user reviews,0,0,0
1197180,True,0,No user reviews,0,0,0
1197210,True,0,3 user reviews,2,1,3
1197220,True,6,Mostly Positive,47,15,62
1197230,True,0,7 user reviews,7,0,7
1197250,True,0,No user reviews,0,0,0
1197260,True,0,No user reviews,0,0,0
1197280,True,0,6 user reviews,4,2,6
1197300,True,0,No user reviews,0,0,0
1197310,True,0,No user reviews,0,0,0
1197320,True,0,No user reviews,0,0,0
1197340,True,0,1 user reviews,0,1,1
1197350,True,0,7 user reviews,7,0,7
1197360,True,0,1 user reviews,1,0,1
1197370,True,8,Very Positive,145,12,157
1197380,True,0,1 user reviews,1,0,1
1197390,True,7,Positive,13,0,13
1197410,True,0,No user reviews,0,0,0
1197440,True,0,4 user reviews,1,3,4
1197460,True,0,No user reviews,0,0,0
1197470,True,0,No user reviews,0,0,0
1197480,True,0,No user reviews,0,0,0
1197490,True,0,No user reviews,0,0,0
1197500,True,0,1 user reviews,1,0,1
1197520,True,7,Positive,13,0,13
1197530,True,0,3 user reviews,3,0,3
1197550,True,0,9 user reviews,1,8,9
1197570,True,0,No user reviews,0,0,0
1197580,True,0,No user reviews,0,0,0
1197590,True,6,Mostly Positive,23,6,29
1197620,True,0,5 user reviews,4,1,5
1197650,True,7,Positive,16,1,17
1197651,True,0,2 user reviews,2,0,2
1197670,True,0,No user reviews,0,0,0
1197690,True,0,No user reviews,0,0,0
1197700,True,0,No user reviews,0,0,0
1197710,True,0,2 user reviews,2,0,2
1197730,True,0,No user reviews,0,0,0
1197740,True,0,No user reviews,0,0,0
1197750,True,0,No user reviews,0,0,0
1197770,True,6,Mostly Positive,60,23,83
1197790,True,0,No user reviews,0,0,0
1197800,True,0,1 user reviews,1,0,1
1197810,True,0,4 user reviews,4,0,4
1197820,True,7,Positive,25,5,30
1197840,True,0,1 user reviews,0,1,1
1197860,True,0,3 user reviews,3,0,3
1197870,True,0,No user reviews,0,0,0
1197890,True,0,No user reviews,0,0,0
1197891,True,0,No user reviews,0,0,0
1197892,True,0,No user reviews,0,0,0
1197893,True,0,No user reviews,0,0,0
1197894,True,0,No user reviews,0,0,0
1197895,True,0,No user reviews,0,0,0
1197900,True,0,No user reviews,0,0,0
1197901,True,0,No user reviews,0,0,0
1197902,True,0,No user reviews,0,0,0
1197903,True,0,No user reviews,0,0,0
1197904,True,0,No user reviews,0,0,0
1197905,True,0,No user reviews,0,0,0
1197906,True,0,No user reviews,0,0,0
1197907,True,0,No user reviews,0,0,0
1197910,True,0,No user reviews,0,0,0
1197911,True,0,No user reviews,0,0,0
1197912,True,0,No user reviews,0,0,0
1197913,True,0,No user reviews,0,0,0
1197914,True,0,No user reviews,0,0,0
1197915,True,0,No user reviews,0,0,0
1197960,True,0,No user reviews,0,0,0
1197970,True,0,No user reviews,0,0,0
1197980,True,0,2 user reviews,2,0,2
1197990,True,0,6 user reviews,6,0,6
1198010,True,0,No user reviews,0,0,0
1198020,True,0,1 user reviews,0,1,1
1198040,True,8,Very Positive,68,1,69
1198050,True,6,Mostly Positive,39,14,53
1198060,True,0,3 user reviews,1,2,3
1198070,True,0,2 user reviews,2,0,2
1198080,True,0,No user reviews,0,0,0
1198090,True,0,No user reviews,0,0,0
1198110,True,0,3 user reviews,2,1,3
1198140,True,0,No user reviews,0,0,0
1198141,True,0,No user reviews,0,0,0
1198142,True,0,No user reviews,0,0,0
1198143,True,0,No user reviews,0,0,0
1198144,True,0,No user reviews,0,0,0
1198145,True,0,No user reviews,0,0,0
1198146,True,0,1 user reviews,1,0,1
1198147,True,0,No user reviews,0,0,0
1198148,True,0,No user reviews,0,0,0
1198149,True,0,No user reviews,0,0,0
1198160,True,0,No user reviews,0,0,0
1198161,True,0,No user reviews,0,0,0
1198162,True,0,No user reviews,0,0,0
1198163,True,0,1 user reviews,1,0,1
1198164,True,0,No user reviews,0,0,0
1198165,True,0,1 user reviews,0,1,1
1198166,True,0,No user reviews,0,0,0
1198180,True,0,No user reviews,0,0,0
1198181,True,0,No user reviews,0,0,0
1198182,True,0,No user reviews,0,0,0
1198183,True,0,No user reviews,0,0,0
1198184,True,0,No user reviews,0,0,0
1198185,True,0,No user reviews,0,0,0
1198186,True,0,1 user reviews,0,1,1
1198187,True,0,No user reviews,0,0,0
1198188,True,0,No user reviews,0,0,0
1198189,True,0,No user reviews,0,0,0
1198190,True,0,No user reviews,0,0,0
1198191,True,0,No user reviews,0,0,0
1198192,True,0,No user reviews,0,0,0
1198210,True,0,No user reviews,0,0,0
1198220,True,0,3 user reviews,1,2,3
1198240,True,0,3 user reviews,2,1,3
1198250,True,0,No user reviews,0,0,0
1198260,True,0,No user reviews,0,0,0
1198270,True,0,No user reviews,0,0,0
1198280,True,0,2 user reviews,1,1,2
1198290,True,7,Positive,10,0,10
1198310,True,0,1 user reviews,1,0,1
1198320,True,0,No user reviews,0,0,0
1198340,True,0,No user reviews,0,0,0
1198350,True,0,No user reviews,0,0,0
1198360,True,5,Mixed,13,7,20
1198361,True,0,6 user reviews,6,0,6
1198362,True,0,No user reviews,0,0,0
1198363,True,0,No user reviews,0,0,0
1198364,True,0,No user reviews,0,0,0
1198370,True,0,No user reviews,0,0,0
1198380,True,0,3 user reviews,2,1,3
1198390,True,0,5 user reviews,3,2,5
1198400,True,7,Positive,12,0,12
1198410,True,0,1 user reviews,0,1,1
1198440,True,0,2 user reviews,2,0,2
1198450,True,7,Positive,13,3,16
1198460,True,7,Positive,22,1,23
1198461,True,0,4 user reviews,4,0,4
1198462,True,7,Positive,10,0,10
1198470,True,5,Mixed,25,16,41
1198480,True,0,2 user reviews,2,0,2
1198481,True,0,2 user reviews,2,0,2
1198490,True,0,No user reviews,0,0,0
1198500,True,0,No user reviews,0,0,0
1198510,True,8,Very Positive,94,2,96
1198550,True,0,1 user reviews,1,0,1
1198560,True,0,No user reviews,0,0,0
1198570,True,0,No user reviews,0,0,0
1198600,True,7,Positive,15,1,16
1198620,True,0,2 user reviews,0,2,2
1198630,True,0,7 user reviews,5,2,7
1198680,True,0,No user reviews,0,0,0
1198690,True,0,No user reviews,0,0,0
1198700,True,7,Positive,9,1,10
1198710,True,0,No user reviews,0,0,0
1198730,True,8,Very Positive,48,10,58
1198740,True,7,Positive,37,1,38
1198760,True,0,No user reviews,0,0,0
1198770,True,0,No user reviews,0,0,0
1198780,True,0,6 user reviews,6,0,6
1198800,True,0,No user reviews,0,0,0
1198810,True,0,3 user reviews,3,0,3
1198820,True,0,9 user reviews,7,2,9
1198830,True,0,No user reviews,0,0,0
1198831,True,0,No user reviews,0,0,0
1198832,True,0,No user reviews,0,0,0
1198833,True,0,No user reviews,0,0,0
1198834,True,0,No user reviews,0,0,0
1198835,True,0,No user reviews,0,0,0
1198836,True,0,No user reviews,0,0,0
1198837,True,0,No user reviews,0,0,0
1198839,True,0,No user reviews,0,0,0
1198840,True,0,1 user reviews,1,0,1
1198841,True,0,No user reviews,0,0,0
1198843,True,0,No user reviews,0,0,0
1198844,True,0,No user reviews,0,0,0
1198845,True,0,No user reviews,0,0,0
1198846,True,0,No user reviews,0,0,0
1198847,True,0,No user reviews,0,0,0
1198848,True,0,No user reviews,0,0,0
1198849,True,0,No user reviews,0,0,0
1198850,True,0,No user reviews,0,0,0
1198860,True,0,9 user reviews,7,2,9
1198890,True,0,No user reviews,0,0,0
1198900,True,0,4 user reviews,4,0,4
1198910,True,0,No user reviews,0,0,0
1198940,True,0,4 user reviews,2,2,4
1198960,True,0,8 user reviews,8,0,8
1198970,True,0,No user reviews,0,0,0
1198990,True,0,No user reviews,0,0,0
1199000,True,0,No user reviews,0,0,0
1199001,True,0,No user reviews,0,0,0
1199010,True,0,7 user reviews,7,0,7
1199020,True,0,No user reviews,0,0,0
1199030,True,8,Very Positive,238,38,276
1199050,True,0,No user reviews,0,0,0
1199060,True,0,No user reviews,0,0,0
1199070,True,0,No user reviews,0,0,0
1199110,True,0,No user reviews,0,0,0
1199120,True,7,Positive,45,1,46
1199140,True,7,Positive,18,0,18
1199150,True,0,1 user reviews,1,0,1
1199170,True,0,4 user reviews,4,0,4
1199180,True,0,2 user reviews,2,0,2
1199190,True,0,No user reviews,0,0,0
1199200,True,0,No user reviews,0,0,0
1199210,True,0,2 user reviews,2,0,2
1199220,True,0,6 user reviews,3,3,6
1199230,True,0,No user reviews,0,0,0
1199240,True,0,1 user reviews,1,0,1
1199270,True,0,8 user reviews,8,0,8
1199310,True,0,No user reviews,0,0,0
1199324,True,0,No user reviews,0,0,0
1199360,True,0,5 user reviews,4,1,5
1199370,True,4,Mostly Negative,5,11,16
1199380,True,0,No user reviews,0,0,0
1199390,True,0,No user reviews,0,0,0
1199400,True,0,No user reviews,0,0,0
1199420,True,0,4 user reviews,3,1,4
1199440,True,0,No user reviews,0,0,0
1199450,True,5,Mixed,8,4,12
1199470,True,0,3 user reviews,3,0,3
1199500,True,0,1 user reviews,0,1,1
1199520,True,0,No user reviews,0,0,0
1199530,True,0,1 user reviews,1,0,1
1199531,True,0,8 user reviews,5,3,8
1199532,True,0,1 user reviews,1,0,1
1199540,True,0,No user reviews,0,0,0
1199550,True,7,Positive,14,0,14
1199560,True,0,2 user reviews,2,0,2
1199570,True,0,No user reviews,0,0,0
1199580,True,0,No user reviews,0,0,0
1199590,True,0,No user reviews,0,0,0
1199600,True,0,No user reviews,0,0,0
1199601,True,0,1 user reviews,1,0,1
1199602,True,0,No user reviews,0,0,0
1199610,True,0,1 user reviews,0,1,1
1199630,True,6,Mostly Positive,8,3,11
1199640,True,0,No user reviews,0,0,0
1199650,True,0,1 user reviews,1,0,1
1199660,True,7,Positive,31,1,32
1199670,True,0,No user reviews,0,0,0
1199690,True,0,No user reviews,0,0,0
1199720,True,0,No user reviews,0,0,0
1199740,True,0,2 user reviews,2,0,2
1199750,True,0,No user reviews,0,0,0
1199760,True,0,No user reviews,0,0,0
1199770,True,0,No user reviews,0,0,0
1199780,True,0,2 user reviews,2,0,2
1199790,True,5,Mixed,9,5,14
1199800,True,0,No user reviews,0,0,0
1199810,True,0,No user reviews,0,0,0
1199830,True,0,No user reviews,0,0,0
1199880,True,5,Mixed,109,58,167
1199890,True,0,No user reviews,0,0,0
1199900,True,0,4 user reviews,3,1,4
1199910,True,0,No user reviews,0,0,0
1199920,True,0,No user reviews,0,0,0
1199930,True,0,No user reviews,0,0,0
1199940,True,0,No user reviews,0,0,0
1199950,True,0,No user reviews,0,0,0
1199960,True,0,No user reviews,0,0,0
1199980,True,0,No user reviews,0,0,0
1200060,True,0,No user reviews,0,0,0
1200090,True,0,No user reviews,0,0,0
1200110,True,0,3 user reviews,3,0,3
1200120,True,0,No user reviews,0,0,0
1200140,True,0,3 user reviews,2,1,3
1200150,True,0,3 user reviews,3,0,3
1200160,True,0,1 user reviews,1,0,1
1200170,True,0,1 user reviews,1,0,1
1200171,True,0,1 user reviews,1,0,1
1200180,True,0,1 user reviews,1,0,1
1200200,True,0,1 user reviews,0,1,1
1200220,True,0,No user reviews,0,0,0
1200230,True,5,Mixed,16,17,33
1200250,True,0,No user reviews,0,0,0
1200270,True,0,9 user reviews,5,4,9
1200280,True,0,No user reviews,0,0,0
1200290,True,0,2 user reviews,2,0,2
1200300,True,0,1 user reviews,1,0,1
1200310,True,0,No user reviews,0,0,0
1200330,True,8,Very Positive,50,12,62
1200340,True,0,No user reviews,0,0,0
1200341,True,0,8 user reviews,6,2,8
1200342,True,0,2 user reviews,2,0,2
1200343,True,0,1 user reviews,1,0,1
1200344,True,0,2 user reviews,2,0,2
1200345,True,0,1 user reviews,1,0,1
1200346,True,0,1 user reviews,1,0,1
1200350,True,0,No user reviews,0,0,0
1200360,True,0,No user reviews,0,0,0
1200370,True,0,No user reviews,0,0,0
1200400,True,0,2 user reviews,0,2,2
1200420,True,0,4 user reviews,4,0,4
1200430,True,0,2 user reviews,1,1,2
1200440,True,0,No user reviews,0,0,0
1200450,True,0,No user reviews,0,0,0
1200460,True,0,No user reviews,0,0,0
1200470,True,0,No user reviews,0,0,0
1200480,True,0,No user reviews,0,0,0
1200500,True,0,No user reviews,0,0,0
1200520,True,0,1 user reviews,1,0,1
1200550,True,7,Positive,16,4,20
1200551,True,0,No user reviews,0,0,0
1200552,True,7,Positive,9,1,10
1200570,True,0,No user reviews,0,0,0
1200580,True,0,No user reviews,0,0,0
1200590,True,0,2 user reviews,1,1,2
1200600,True,0,1 user reviews,1,0,1
1200610,True,0,4 user reviews,3,1,4
1200620,True,0,No user reviews,0,0,0
1200621,True,0,No user reviews,0,0,0
1200622,True,0,No user reviews,0,0,0
1200623,True,0,No user reviews,0,0,0
1200630,True,0,1 user reviews,0,1,1
1200640,True,0,No user reviews,0,0,0
1200650,True,0,2 user reviews,1,1,2
1200660,True,0,No user reviews,0,0,0
1200700,True,0,No user reviews,0,0,0
1200710,True,6,Mostly Positive,69,20,89
1200720,True,8,Very Positive,172,1,173
1200730,True,8,Very Positive,60,6,66
1200740,True,0,No user reviews,0,0,0
1200770,True,0,No user reviews,0,0,0
1200780,True,0,2 user reviews,2,0,2
1200790,True,0,No user reviews,0,0,0
1200800,True,0,No user reviews,0,0,0
1200820,True,0,No user reviews,0,0,0
1200830,True,0,No user reviews,0,0,0
1200860,True,0,No user reviews,0,0,0
1200870,True,0,No user reviews,0,0,0
1200900,True,0,No user reviews,0,0,0
1200910,True,0,5 user reviews,5,0,5
1200930,True,0,1 user reviews,0,1,1
1200940,True,0,No user reviews,0,0,0
1200960,True,0,No user reviews,0,0,0
1200990,True,0,No user reviews,0,0,0
1201000,True,0,6 user reviews,2,4,6
1201010,True,0,No user reviews,0,0,0
1201020,True,0,No user reviews,0,0,0
1201030,True,0,No user reviews,0,0,0
1201050,True,0,5 user reviews,5,0,5
1201070,True,0,No user reviews,0,0,0
1201080,True,0,No user reviews,0,0,0
1201090,True,0,No user reviews,0,0,0
1201140,True,0,No user reviews,0,0,0
1201150,True,0,No user reviews,0,0,0
1201151,True,0,No user reviews,0,0,0
1201152,True,0,No user reviews,0,0,0
1201180,True,0,No user reviews,0,0,0
1201200,True,0,No user reviews,0,0,0
1201220,True,0,2 user reviews,1,1,2
1201230,True,0,No user reviews,0,0,0
1201240,True,0,No user reviews,0,0,0
1201250,True,0,No user reviews,0,0,0
1201260,True,0,3 user reviews,2,1,3
1201270,True,0,No user reviews,0,0,0
1201280,True,0,No user reviews,0,0,0
1201300,True,0,No user reviews,0,0,0
1201310,True,0,9 user reviews,7,2,9
1201330,True,0,No user reviews,0,0,0
1201350,True,0,2 user reviews,1,1,2
1201360,True,8,Very Positive,149,4,153
1201370,True,0,8 user reviews,6,2,8
1201380,True,0,No user reviews,0,0,0
1201390,True,0,No user reviews,0,0,0
1201400,True,0,No user reviews,0,0,0
1201430,True,0,1 user reviews,1,0,1
1201440,True,0,No user reviews,0,0,0
1201450,True,0,8 user reviews,6,2,8
1201460,True,0,No user reviews,0,0,0
1201470,True,0,No user reviews,0,0,0
1201480,True,0,No user reviews,0,0,0
1201500,True,0,1 user reviews,0,1,1
1201510,True,0,No user reviews,0,0,0
1201520,True,0,No user reviews,0,0,0
1201530,True,0,No user reviews,0,0,0
1201540,True,0,No user reviews,0,0,0
1201550,True,7,Positive,46,2,48
1201600,True,0,No user reviews,0,0,0
1201620,True,0,No user reviews,0,0,0
1201630,True,6,Mostly Positive,16,6,22
1201640,True,0,No user reviews,0,0,0
1201650,True,0,No user reviews,0,0,0
1201670,True,0,No user reviews,0,0,0
1201680,True,0,No user reviews,0,0,0
1201710,True,0,No user reviews,0,0,0
1201730,True,0,No user reviews,0,0,0
1201750,True,0,3 user reviews,3,0,3
1201760,True,0,No user reviews,0,0,0
1201770,True,0,No user reviews,0,0,0
1201780,True,0,No user reviews,0,0,0
1201790,True,0,2 user reviews,2,0,2
1201800,True,0,8 user reviews,8,0,8
1201810,True,5,Mixed,11,5,16
1201820,True,0,No user reviews,0,0,0
1201821,True,0,No user reviews,0,0,0
1201830,True,8,Very Positive,59,9,68
1201840,True,8,Very Positive,101,17,118
1201850,True,0,No user reviews,0,0,0
1201870,True,0,No user reviews,0,0,0
1201880,True,0,1 user reviews,1,0,1
1201890,True,0,No user reviews,0,0,0
1201910,True,4,Mostly Negative,4,7,11
1201930,True,0,No user reviews,0,0,0
1201940,True,0,No user reviews,0,0,0
1201950,True,0,1 user reviews,1,0,1
1201960,True,0,3 user reviews,3,0,3
1201970,True,0,No user reviews,0,0,0
1201980,True,0,No user reviews,0,0,0
1202010,True,0,No user reviews,0,0,0
1202011,True,0,No user reviews,0,0,0
1202012,True,0,No user reviews,0,0,0
1202013,True,0,1 user reviews,1,0,1
1202014,True,0,No user reviews,0,0,0
1202070,True,7,Positive,35,3,38
1202080,True,0,No user reviews,0,0,0
1202090,True,0,5 user reviews,2,3,5
1202100,True,0,No user reviews,0,0,0
1202120,True,0,No user reviews,0,0,0
1202130,True,0,No user reviews,0,0,0
1202140,True,0,No user reviews,0,0,0
1202150,True,7,Positive,12,3,15
1202160,True,0,2 user reviews,1,1,2
1202170,True,0,8 user reviews,8,0,8
1202190,True,0,6 user reviews,4,2,6
1202200,True,0,No user reviews,0,0,0
1202220,True,0,1 user reviews,1,0,1
1202240,True,0,7 user reviews,7,0,7
1202250,True,0,1 user reviews,1,0,1
1202290,True,0,No user reviews,0,0,0
1202300,True,0,No user reviews,0,0,0
1202310,True,8,Very Positive,57,13,70
1202330,True,0,No user reviews,0,0,0
1202340,True,0,No user reviews,0,0,0
1202350,True,0,No user reviews,0,0,0
1202360,True,0,No user reviews,0,0,0
1202400,True,0,3 user reviews,3,0,3
1202410,True,0,No user reviews,0,0,0
1202420,True,0,7 user reviews,7,0,7
1202430,True,0,No user reviews,0,0,0
1202440,True,0,No user reviews,0,0,0
1202450,True,0,No user reviews,0,0,0
1202460,True,0,7 user reviews,6,1,7
1202480,True,0,No user reviews,0,0,0
1202510,True,0,No user reviews,0,0,0
1202520,True,5,Mixed,137,167,304
1202530,True,0,No user reviews,0,0,0
1202540,True,8,Very Positive,136,1,137
1202550,True,0,1 user reviews,0,1,1
1202560,True,0,3 user reviews,2,1,3
1202570,True,0,4 user reviews,4,0,4
1202580,True,0,No user reviews,0,0,0
1202600,True,0,No user reviews,0,0,0
1202601,True,0,No user reviews,0,0,0
1202603,True,0,2 user reviews,0,2,2
1202604,True,0,No user reviews,0,0,0
1202605,True,0,No user reviews,0,0,0
1202610,True,0,1 user reviews,1,0,1
1202630,True,0,6 user reviews,5,1,6
1202640,True,0,5 user reviews,3,2,5
1202650,True,6,Mostly Positive,15,4,19
1202660,True,0,4 user reviews,3,1,4
1202690,True,0,No user reviews,0,0,0
1202710,True,0,3 user reviews,3,0,3
1202730,True,0,3 user reviews,3,0,3
1202750,True,0,No user reviews,0,0,0
1202760,True,0,No user reviews,0,0,0
1202770,True,0,5 user reviews,5,0,5
1202780,True,0,5 user reviews,3,2,5
1202790,True,0,5 user reviews,2,3,5
1202810,True,0,No user reviews,0,0,0
1202820,True,0,1 user reviews,1,0,1
1202830,True,0,1 user reviews,0,1,1
1202850,True,0,1 user reviews,1,0,1
1202860,True,0,1 user reviews,0,1,1
1202870,True,7,Positive,12,1,13
1202880,True,0,No user reviews,0,0,0
1202900,True,8,Very Positive,600,68,668
1202910,True,0,No user reviews,0,0,0
1202920,True,0,No user reviews,0,0,0
1202930,True,0,1 user reviews,1,0,1
1202950,True,0,No user reviews,0,0,0
1202970,True,0,9 user reviews,8,1,9
1202990,True,0,4 user reviews,3,1,4
1203000,True,0,No user reviews,0,0,0
1203010,True,0,No user reviews,0,0,0
1203030,True,0,No user reviews,0,0,0
1203040,True,0,6 user reviews,6,0,6
1203042,True,0,4 user reviews,0,4,4
1203050,True,0,1 user reviews,1,0,1
1203110,True,0,No user reviews,0,0,0
1203140,True,0,4 user reviews,3,1,4
1203160,True,0,No user reviews,0,0,0
1203220,True,0,No user reviews,0,0,0
1203240,True,0,5 user reviews,5,0,5
1203250,True,0,No user reviews,0,0,0
1203280,True,0,1 user reviews,1,0,1
1203300,True,0,No user reviews,0,0,0
1203310,True,0,1 user reviews,1,0,1
1203350,True,4,Mostly Negative,14,25,39
1203360,True,8,Very Positive,85,10,95
1203370,True,5,Mixed,6,4,10
1203390,True,0,No user reviews,0,0,0
1203400,True,0,1 user reviews,1,0,1
1203430,True,0,1 user reviews,0,1,1
1203440,True,0,5 user reviews,3,2,5
1203450,True,0,No user reviews,0,0,0
1203460,True,7,Positive,9,1,10
1203470,True,0,No user reviews,0,0,0
1203490,True,0,No user reviews,0,0,0
1203500,True,0,3 user reviews,3,0,3
1203510,True,7,Positive,18,2,20
1203520,True,0,No user reviews,0,0,0
1203530,True,0,1 user reviews,0,1,1
1203540,True,0,1 user reviews,1,0,1
1203541,True,0,1 user reviews,1,0,1
1203542,True,0,1 user reviews,0,1,1
1203543,True,0,No user reviews,0,0,0
1203560,True,7,Positive,27,6,33
1203570,True,7,Positive,11,1,12
1203580,True,0,2 user reviews,2,0,2
1203600,True,0,No user reviews,0,0,0
1203630,True,8,Very Positive,461,21,482
1203640,True,0,2 user reviews,2,0,2
1203650,True,5,Mixed,14,12,26
1203680,True,0,No user reviews,0,0,0
1203700,True,0,No user reviews,0,0,0
1203710,True,0,No user reviews,0,0,0
1203720,True,0,4 user reviews,2,2,4
1203740,True,0,No user reviews,0,0,0
1203750,True,0,8 user reviews,8,0,8
1203760,True,0,4 user reviews,2,2,4
1203770,True,0,4 user reviews,2,2,4
1203780,True,0,No user reviews,0,0,0
1203790,True,0,5 user reviews,5,0,5
1203800,True,0,No user reviews,0,0,0
1203810,True,0,No user reviews,0,0,0
1203830,True,0,1 user reviews,1,0,1
1203850,True,0,4 user reviews,4,0,4
1203880,True,0,No user reviews,0,0,0
1203890,True,0,No user reviews,0,0,0
1203900,True,0,No user reviews,0,0,0
1203910,True,0,No user reviews,0,0,0
1203930,True,6,Mostly Positive,184,47,231
1203950,True,0,No user reviews,0,0,0
1203960,True,0,7 user reviews,5,2,7
1203970,True,7,Positive,10,0,10
1203980,True,0,No user reviews,0,0,0
1203990,True,0,6 user reviews,5,1,6
1204010,True,0,No user reviews,0,0,0
1204020,True,0,No user reviews,0,0,0
1204030,True,0,1 user reviews,1,0,1
1204040,True,0,No user reviews,0,0,0
1204050,True,0,No user reviews,0,0,0
1204070,True,0,3 user reviews,3,0,3
1204080,True,0,No user reviews,0,0,0
1204090,True,0,No user reviews,0,0,0
1204100,True,0,1 user reviews,1,0,1
1204110,True,0,No user reviews,0,0,0
1204130,True,8,Very Positive,145,4,149
1204160,True,0,No user reviews,0,0,0
1204170,True,0,No user reviews,0,0,0
1204200,True,0,2 user reviews,2,0,2
1204210,True,0,2 user reviews,2,0,2
1204220,True,7,Positive,9,2,11
1204230,True,6,Mostly Positive,23,6,29
1204240,True,0,No user reviews,0,0,0
1204250,True,0,No user reviews,0,0,0
1204260,True,0,No user reviews,0,0,0
1204270,True,0,2 user reviews,1,1,2
1204280,True,0,4 user reviews,4,0,4
1204320,True,0,9 user reviews,9,0,9
1204330,True,0,No user reviews,0,0,0
1204340,True,0,No user reviews,0,0,0
1204360,True,0,No user reviews,0,0,0
1204370,True,7,Positive,20,4,24
1204380,True,0,No user reviews,0,0,0
1204400,True,0,No user reviews,0,0,0
1204410,True,0,No user reviews,0,0,0
1204420,True,0,No user reviews,0,0,0
1204440,True,0,No user reviews,0,0,0
1204460,True,0,No user reviews,0,0,0
1204470,True,7,Positive,14,1,15
1204480,True,0,1 user reviews,1,0,1
1204490,True,0,No user reviews,0,0,0
1204500,True,0,No user reviews,0,0,0
1204530,True,0,1 user reviews,1,0,1
1204540,True,0,No user reviews,0,0,0
1204550,True,0,No user reviews,0,0,0
1204560,True,0,5 user reviews,4,1,5
1204570,True,0,No user reviews,0,0,0
1204580,True,0,3 user reviews,3,0,3
1204590,True,0,No user reviews,0,0,0
1204610,True,0,No user reviews,0,0,0
1204630,True,0,2 user reviews,2,0,2
1204640,True,0,No user reviews,0,0,0
1204650,True,0,No user reviews,0,0,0
1204660,True,0,3 user reviews,1,2,3
1204670,True,0,No user reviews,0,0,0
1204700,True,0,2 user reviews,1,1,2
1204710,True,7,Positive,13,0,13
1204720,True,8,Very Positive,104,13,117
1204740,True,0,No user reviews,0,0,0
1204760,True,0,8 user reviews,7,1,8
1204770,True,0,No user reviews,0,0,0
1204780,True,0,No user reviews,0,0,0
1204790,True,0,No user reviews,0,0,0
1204820,True,0,No user reviews,0,0,0
1204830,True,0,No user reviews,0,0,0
1204840,True,0,No user reviews,0,0,0
1204850,True,4,Mostly Negative,4,12,16
1204860,True,0,1 user reviews,0,1,1
1204870,True,0,No user reviews,0,0,0
1204880,True,0,3 user reviews,2,1,3
1204900,True,0,No user reviews,0,0,0
1204920,True,5,Mixed,12,16,28
1204930,True,0,7 user reviews,7,0,7
1204940,True,0,No user reviews,0,0,0
1204950,True,0,No user reviews,0,0,0
1204970,True,0,No user reviews,0,0,0
1205000,True,0,No user reviews,0,0,0
1205010,True,0,No user reviews,0,0,0
1205020,True,0,1 user reviews,0,1,1
1205040,True,8,Very Positive,94,3,97
1205050,True,0,No user reviews,0,0,0
1205060,True,0,5 user reviews,4,1,5
1205070,True,0,No user reviews,0,0,0
1205080,True,0,No user reviews,0,0,0
1205090,True,0,No user reviews,0,0,0
1205100,True,0,4 user reviews,1,3,4
1205110,True,0,No user reviews,0,0,0
1205111,True,0,No user reviews,0,0,0
1205112,True,0,No user reviews,0,0,0
1205113,True,0,No user reviews,0,0,0
1205114,True,0,No user reviews,0,0,0
1205115,True,0,No user reviews,0,0,0
1205120,True,0,2 user reviews,2,0,2
1205130,True,0,No user reviews,0,0,0
1205140,True,0,No user reviews,0,0,0
1205150,True,0,No user reviews,0,0,0
1205160,True,0,No user reviews,0,0,0
1205170,True,0,No user reviews,0,0,0
1205180,True,0,2 user reviews,1,1,2
1205200,True,0,No user reviews,0,0,0
1205220,True,0,No user reviews,0,0,0
1205230,True,0,1 user reviews,1,0,1
1205240,True,8,Very Positive,47,7,54
1205250,True,0,1 user reviews,1,0,1
1205260,True,0,6 user reviews,6,0,6
1205270,True,0,No user reviews,0,0,0
1205280,True,0,No user reviews,0,0,0
1205290,True,0,No user reviews,0,0,0
1205310,True,0,No user reviews,0,0,0
1205330,True,0,No user reviews,0,0,0
1205361,True,4,Mostly Negative,4,13,17
1205364,True,0,No user reviews,0,0,0
1205370,True,0,No user reviews,0,0,0
1205380,True,0,6 user reviews,1,5,6
1205390,True,0,No user reviews,0,0,0
1205400,True,0,No user reviews,0,0,0
1205410,True,0,No user reviews,0,0,0
1205420,True,0,No user reviews,0,0,0
1205430,True,5,Mixed,91,94,185
1205450,True,0,No user reviews,0,0,0
1205470,True,0,No user reviews,0,0,0
1205500,True,0,2 user reviews,2,0,2
1205501,True,0,1 user reviews,1,0,1
1205510,True,0,2 user reviews,2,0,2
1205511,True,0,No user reviews,0,0,0
1205512,True,0,No user reviews,0,0,0
1205513,True,0,No user reviews,0,0,0
1205540,True,0,7 user reviews,7,0,7
1205560,True,0,No user reviews,0,0,0
1205580,True,0,No user reviews,0,0,0
1205590,True,0,No user reviews,0,0,0
1205600,True,0,8 user reviews,3,5,8
1205620,True,0,7 user reviews,3,4,7
1205630,True,7,Positive,13,0,13
1205670,True,0,1 user reviews,1,0,1
1205680,True,0,No user reviews,0,0,0
1205690,True,0,No user reviews,0,0,0
1205730,True,0,No user reviews,0,0,0
1205750,True,0,No user reviews,0,0,0
1205760,True,0,No user reviews,0,0,0
1205761,True,0,No user reviews,0,0,0
1205762,True,0,No user reviews,0,0,0
1205780,True,0,No user reviews,0,0,0
1205781,True,0,No user reviews,0,0,0
1205782,True,0,No user reviews,0,0,0
1205783,True,0,No user reviews,0,0,0
1205784,True,0,No user reviews,0,0,0
1205785,True,0,No user reviews,0,0,0
1205786,True,0,No user reviews,0,0,0
1205787,True,0,No user reviews,0,0,0
1205788,True,0,No user reviews,0,0,0
1205789,True,0,1 user reviews,1,0,1
1205790,True,0,1 user reviews,1,0,1
1205791,True,0,No user reviews,0,0,0
1205792,True,0,No user reviews,0,0,0
1205793,True,0,No user reviews,0,0,0
1205794,True,0,No user reviews,0,0,0
1205795,True,0,No user reviews,0,0,0
1205796,True,0,No user reviews,0,0,0
1205797,True,0,No user reviews,0,0,0
1205798,True,0,No user reviews,0,0,0
1205799,True,0,No user reviews,0,0,0
1205800,True,0,1 user reviews,1,0,1
1205810,True,0,No user reviews,0,0,0
1205860,True,0,No user reviews,0,0,0
1205861,True,0,No user reviews,0,0,0
1205862,True,0,No user reviews,0,0,0
1205863,True,0,No user reviews,0,0,0
1205864,True,0,No user reviews,0,0,0
1205865,True,0,No user reviews,0,0,0
1205866,True,0,1 user reviews,0,1,1
1205867,True,0,No user reviews,0,0,0
1205868,True,0,No user reviews,0,0,0
1205869,True,0,No user reviews,0,0,0
1205870,True,0,No user reviews,0,0,0
1205880,True,0,No user reviews,0,0,0
1205881,True,0,No user reviews,0,0,0
1205882,True,0,No user reviews,0,0,0
1205883,True,0,No user reviews,0,0,0
1205884,True,0,No user reviews,0,0,0
1205885,True,0,No user reviews,0,0,0
1205886,True,0,No user reviews,0,0,0
1205887,True,0,1 user reviews,0,1,1
1205890,True,0,No user reviews,0,0,0
1205900,True,7,Positive,46,1,47
1205930,True,7,Positive,10,0,10
1205950,True,8,Very Positive,117,17,134
1205960,True,8,Very Positive,77,8,85
1205980,True,0,No user reviews,0,0,0
1206000,True,0,7 user reviews,5,2,7
1206010,True,0,No user reviews,0,0,0
1206020,True,0,No user reviews,0,0,0
1206040,True,0,4 user reviews,3,1,4
1206050,True,0,1 user reviews,1,0,1
1206080,True,0,4 user reviews,0,4,4
1206090,True,0,No user reviews,0,0,0
1206110,True,0,7 user reviews,6,1,7
1206140,True,0,2 user reviews,1,1,2
1206150,True,0,No user reviews,0,0,0
1206160,True,0,No user reviews,0,0,0
1206170,True,0,No user reviews,0,0,0
1206180,True,0,1 user reviews,0,1,1
1206190,True,0,3 user reviews,3,0,3
1206200,True,5,Mixed,195,241,436
1206210,True,0,No user reviews,0,0,0
1206220,True,0,No user reviews,0,0,0
1206230,True,0,5 user reviews,3,2,5
1206240,True,0,No user reviews,0,0,0
1206260,True,0,4 user reviews,4,0,4
1206270,True,0,2 user reviews,2,0,2
1206280,True,0,2 user reviews,2,0,2
1206290,True,0,6 user reviews,6,0,6
1206310,True,0,1 user reviews,1,0,1
1206320,True,0,1 user reviews,0,1,1
1206330,True,0,4 user reviews,4,0,4
1206340,True,7,Positive,28,0,28
1206350,True,0,3 user reviews,3,0,3
1206380,True,0,1 user reviews,1,0,1
1206390,True,0,No user reviews,0,0,0
1206400,True,0,No user reviews,0,0,0
1206430,True,8,Very Positive,109,21,130
1206440,True,0,No user reviews,0,0,0
1206460,True,0,1 user reviews,0,1,1
1206470,True,0,4 user reviews,4,0,4
1206480,True,5,Mixed,17,13,30
1206490,True,5,Mixed,12,9,21
1206500,True,0,No user reviews,0,0,0
1206510,True,0,No user reviews,0,0,0
1206540,True,0,No user reviews,0,0,0
1206541,True,0,No user reviews,0,0,0
1206550,True,0,No user reviews,0,0,0
1206570,True,0,3 user reviews,2,1,3
1206590,True,0,No user reviews,0,0,0
1206600,True,0,No user reviews,0,0,0
1206610,True,0,No user reviews,0,0,0
1206620,True,0,5 user reviews,5,0,5
1206630,True,0,1 user reviews,1,0,1
1206640,True,0,1 user reviews,1,0,1
1206650,True,0,No user reviews,0,0,0
1206660,True,0,2 user reviews,1,1,2
1206670,True,7,Positive,33,1,34
1206681,True,0,No user reviews,0,0,0
1206682,True,0,1 user reviews,0,1,1
1206683,True,0,1 user reviews,1,0,1
1206685,True,0,No user reviews,0,0,0
1206688,True,0,No user reviews,0,0,0
1206689,True,0,No user reviews,0,0,0
1206690,True,0,No user reviews,0,0,0
1206700,True,7,Positive,10,2,12
1206710,True,0,No user reviews,0,0,0
1206720,True,0,3 user reviews,2,1,3
1206730,True,0,1 user reviews,0,1,1
1206740,True,0,No user reviews,0,0,0
1206750,True,0,No user reviews,0,0,0
1206760,True,0,No user reviews,0,0,0
1206761,True,0,No user reviews,0,0,0
1206762,True,0,No user reviews,0,0,0
1206770,True,0,4 user reviews,4,0,4
1206790,True,0,No user reviews,0,0,0
1206800,True,0,No user reviews,0,0,0
1206810,True,0,2 user reviews,2,0,2
1206820,True,0,No user reviews,0,0,0
1206821,True,0,2 user reviews,2,0,2
1206830,True,0,No user reviews,0,0,0
1206840,True,0,2 user reviews,0,2,2
1206870,True,0,No user reviews,0,0,0
1206900,True,0,3 user reviews,3,0,3
1206910,True,0,4 user reviews,4,0,4
1206920,True,0,No user reviews,0,0,0
1206930,True,0,No user reviews,0,0,0
1206940,True,7,Positive,11,1,12
1206950,True,0,No user reviews,0,0,0
1206960,True,5,Mixed,5,6,11
1206980,True,0,No user reviews,0,0,0
1206990,True,0,No user reviews,0,0,0
1207000,True,0,7 user reviews,7,0,7
1207010,True,0,No user reviews,0,0,0
1207020,True,0,No user reviews,0,0,0
1207030,True,5,Mixed,5,7,12
1207050,True,0,No user reviews,0,0,0
1207070,True,0,No user reviews,0,0,0
1207071,True,0,No user reviews,0,0,0
1207072,True,0,No user reviews,0,0,0
1207073,True,0,No user reviews,0,0,0
1207074,True,0,No user reviews,0,0,0
1207075,True,0,No user reviews,0,0,0
1207076,True,0,No user reviews,0,0,0
1207077,True,0,No user reviews,0,0,0
1207078,True,0,No user reviews,0,0,0
1207079,True,0,No user reviews,0,0,0
1207080,True,0,No user reviews,0,0,0
1207081,True,0,No user reviews,0,0,0
1207082,True,0,No user reviews,0,0,0
1207110,True,0,No user reviews,0,0,0
1207130,True,0,1 user reviews,1,0,1
1207140,True,0,No user reviews,0,0,0
1207160,True,0,No user reviews,0,0,0
1207170,True,0,No user reviews,0,0,0
1207210,True,0,1 user reviews,1,0,1
1207220,True,0,No user reviews,0,0,0
1207230,True,0,5 user reviews,5,0,5
1207240,True,0,1 user reviews,1,0,1
1207260,True,0,2 user reviews,2,0,2
1207270,True,0,No user reviews,0,0,0
1207290,True,0,No user reviews,0,0,0
1207310,True,0,8 user reviews,8,0,8
1207320,True,0,8 user reviews,7,1,8
1207330,True,0,No user reviews,0,0,0
1207350,True,0,No user reviews,0,0,0
1207351,True,0,No user reviews,0,0,0
1207360,True,0,No user reviews,0,0,0
1207370,True,0,No user reviews,0,0,0
1207380,True,0,4 user reviews,3,1,4
1207390,True,0,No user reviews,0,0,0
1207400,True,0,4 user reviews,4,0,4
1207420,True,0,3 user reviews,3,0,3
1207430,True,0,No user reviews,0,0,0
1207450,True,0,No user reviews,0,0,0
1207460,True,0,1 user reviews,1,0,1
1207480,True,0,5 user reviews,4,1,5
1207500,True,0,1 user reviews,1,0,1
1207510,True,0,No user reviews,0,0,0
1207520,True,0,1 user reviews,1,0,1
1207530,True,0,No user reviews,0,0,0
1207540,True,0,5 user reviews,5,0,5
1207550,True,0,No user reviews,0,0,0
1207560,True,0,No user reviews,0,0,0
1207590,True,0,No user reviews,0,0,0
1207600,True,0,No user reviews,0,0,0
1207610,True,0,No user reviews,0,0,0
1207650,True,0,No user reviews,0,0,0
1207660,True,0,1 user reviews,1,0,1
1207670,True,0,No user reviews,0,0,0
1207690,True,0,No user reviews,0,0,0
1207710,True,0,7 user reviews,5,2,7
1207750,True,0,No user reviews,0,0,0
1207760,True,0,No user reviews,0,0,0
1207770,True,0,No user reviews,0,0,0
1207780,True,8,Very Positive,242,25,267
1207800,True,0,No user reviews,0,0,0
1207830,True,0,No user reviews,0,0,0
1207840,True,0,5 user reviews,5,0,5
1207850,True,5,Mixed,11,15,26
1207860,True,0,3 user reviews,3,0,3
1207880,True,7,Positive,29,4,33
1207890,True,0,No user reviews,0,0,0
1207900,True,0,No user reviews,0,0,0
1207910,True,0,No user reviews,0,0,0
1207920,True,0,No user reviews,0,0,0
1207930,True,0,No user reviews,0,0,0
1207950,True,0,No user reviews,0,0,0
1207960,True,0,No user reviews,0,0,0
1207970,True,0,No user reviews,0,0,0
1207980,True,0,No user reviews,0,0,0
1208030,True,0,3 user reviews,3,0,3
1208040,True,0,No user reviews,0,0,0
1208050,True,0,1 user reviews,1,0,1
1208060,True,0,No user reviews,0,0,0
1208080,True,0,1 user reviews,1,0,1
1208090,True,0,4 user reviews,0,4,4
1208100,True,0,No user reviews,0,0,0
1208110,True,0,No user reviews,0,0,0
1208120,True,0,3 user reviews,1,2,3
1208140,True,0,No user reviews,0,0,0
1208160,True,0,No user reviews,0,0,0
1208170,True,0,No user reviews,0,0,0
1208180,True,0,No user reviews,0,0,0
1208210,True,0,No user reviews,0,0,0
1208220,True,7,Positive,9,2,11
1208240,True,0,No user reviews,0,0,0
1208250,True,0,No user reviews,0,0,0
1208260,True,8,Very Positive,124,13,137
1208270,True,0,No user reviews,0,0,0
1208280,True,0,No user reviews,0,0,0
1208290,True,0,No user reviews,0,0,0
1208291,True,0,No user reviews,0,0,0
1208292,True,0,1 user reviews,0,1,1
1208310,True,0,No user reviews,0,0,0
1208330,True,0,6 user reviews,4,2,6
1208360,True,0,No user reviews,0,0,0
1208370,True,0,No user reviews,0,0,0
1208380,True,0,No user reviews,0,0,0
1208390,True,0,No user reviews,0,0,0
1208400,True,0,1 user reviews,1,0,1
1208420,True,0,No user reviews,0,0,0
1208430,True,0,No user reviews,0,0,0
1208440,True,0,4 user reviews,4,0,4
1208460,True,0,No user reviews,0,0,0
1208470,True,0,1 user reviews,0,1,1
1208480,True,0,No user reviews,0,0,0
1208490,True,0,4 user reviews,2,2,4
1208500,True,0,No user reviews,0,0,0
1208510,True,0,No user reviews,0,0,0
1208520,True,0,No user reviews,0,0,0
1208550,True,0,2 user reviews,2,0,2
1208560,True,0,No user reviews,0,0,0
1208580,True,0,2 user reviews,2,0,2
1208590,True,0,No user reviews,0,0,0
1208600,True,8,Very Positive,90,9,99
1208620,True,0,No user reviews,0,0,0
1208650,True,0,No user reviews,0,0,0
1208660,True,0,7 user reviews,7,0,7
1208730,True,0,No user reviews,0,0,0
1208760,True,0,9 user reviews,8,1,9
1208770,True,6,Mostly Positive,64,26,90
1208810,True,7,Positive,21,0,21
1208820,True,0,No user reviews,0,0,0
1208830,True,0,No user reviews,0,0,0
1208840,True,0,No user reviews,0,0,0
1208850,True,0,3 user reviews,3,0,3
1208860,True,0,No user reviews,0,0,0
1208870,True,0,No user reviews,0,0,0
1208880,True,0,4 user reviews,3,1,4
1208890,True,0,No user reviews,0,0,0
1208900,True,0,7 user reviews,6,1,7
1208940,True,0,No user reviews,0,0,0
1208950,True,0,3 user reviews,1,2,3
1208970,True,0,No user reviews,0,0,0
1208980,True,0,No user reviews,0,0,0
1209000,True,0,2 user reviews,1,1,2
1209040,True,0,No user reviews,0,0,0
1209060,True,0,4 user reviews,0,4,4
1209080,True,0,No user reviews,0,0,0
1209110,True,6,Mostly Positive,108,32,140
1209120,True,6,Mostly Positive,386,145,531
1209121,True,0,No user reviews,0,0,0
1209130,True,4,Mostly Negative,14,24,38
1209131,True,0,1 user reviews,1,0,1
1209132,True,0,7 user reviews,3,4,7
1209133,True,0,5 user reviews,2,3,5
1209134,True,0,2 user reviews,2,0,2
1209135,True,0,2 user reviews,2,0,2
1209140,True,0,1 user reviews,1,0,1
1209150,True,5,Mixed,7,7,14
1209160,True,0,1 user reviews,1,0,1
1209170,True,0,2 user reviews,1,1,2
1209180,True,0,No user reviews,0,0,0
1209190,True,0,3 user reviews,1,2,3
1209200,True,0,4 user reviews,1,3,4
1209210,True,0,No user reviews,0,0,0
1209220,True,0,No user reviews,0,0,0
1209230,True,0,No user reviews,0,0,0
1209240,True,0,No user reviews,0,0,0
1209250,True,0,No user reviews,0,0,0
1209260,True,0,No user reviews,0,0,0
1209300,True,0,No user reviews,0,0,0
1209310,True,0,No user reviews,0,0,0
1209330,True,7,Positive,14,3,17
1209340,True,0,No user reviews,0,0,0
1209360,True,6,Mostly Positive,9,3,12
1209400,True,0,No user reviews,0,0,0
1209410,True,0,No user reviews,0,0,0
1209420,True,0,No user reviews,0,0,0
1209430,True,7,Positive,13,3,16
1209440,True,0,4 user reviews,3,1,4
1209450,True,7,Positive,22,0,22
1209460,True,0,No user reviews,0,0,0
1209461,True,5,Mixed,28,23,51
1209470,True,8,Very Positive,186,21,207
1209471,True,0,No user reviews,0,0,0
1209480,True,0,1 user reviews,0,1,1
1209490,True,8,Very Positive,526,110,636
1209500,True,0,No user reviews,0,0,0
1209510,True,0,No user reviews,0,0,0
1209520,True,0,3 user reviews,3,0,3
1209530,True,0,6 user reviews,6,0,6
1209531,True,0,8 user reviews,7,1,8
1209532,True,7,Positive,15,0,15
1209540,True,0,No user reviews,0,0,0
1209560,True,0,1 user reviews,1,0,1
1209570,True,0,6 user reviews,6,0,6
1209580,True,0,No user reviews,0,0,0
1209590,True,0,1 user reviews,1,0,1
1209600,True,0,No user reviews,0,0,0
1209610,True,0,No user reviews,0,0,0
1209620,True,0,No user reviews,0,0,0
1209621,True,0,No user reviews,0,0,0
1209630,True,0,No user reviews,0,0,0
1209640,True,0,No user reviews,0,0,0
1209641,True,0,No user reviews,0,0,0
1209650,True,0,7 user reviews,6,1,7
1209690,True,0,No user reviews,0,0,0
1209700,True,0,No user reviews,0,0,0
1209710,True,0,No user reviews,0,0,0
1209720,True,0,4 user reviews,2,2,4
1209740,True,5,Mixed,6,5,11
1209750,True,0,No user reviews,0,0,0
1209760,True,0,2 user reviews,1,1,2
1209770,True,0,No user reviews,0,0,0
1209820,True,0,No user reviews,0,0,0
1209860,True,0,No user reviews,0,0,0
1209870,True,0,No user reviews,0,0,0
1209900,True,0,3 user reviews,3,0,3
1209910,True,7,Positive,34,6,40
1209950,True,0,No user reviews,0,0,0
1209960,True,0,No user reviews,0,0,0
1209970,True,0,No user reviews,0,0,0
1209980,True,0,No user reviews,0,0,0
1209990,True,0,No user reviews,0,0,0
1210000,True,0,2 user reviews,2,0,2
1210010,True,0,9 user reviews,8,1,9
1210030,True,0,4 user reviews,4,0,4
1210041,True,0,No user reviews,0,0,0
1210060,True,0,4 user reviews,3,1,4
1210070,True,0,No user reviews,0,0,0
1210080,True,0,No user reviews,0,0,0
1210090,True,0,1 user reviews,1,0,1
1210091,True,0,No user reviews,0,0,0
1210110,True,5,Mixed,101,49,150
1210130,True,0,No user reviews,0,0,0
1210131,True,0,No user reviews,0,0,0
1210132,True,0,No user reviews,0,0,0
1210133,True,0,No user reviews,0,0,0
1210150,True,0,8 user reviews,7,1,8
1210170,True,0,8 user reviews,5,3,8
1210171,True,5,Mixed,5,6,11
1210180,True,0,No user reviews,0,0,0
1210200,True,0,No user reviews,0,0,0
1210220,True,0,No user reviews,0,0,0
1210230,True,7,Positive,31,0,31
1210250,True,0,5 user reviews,5,0,5
1210270,True,0,3 user reviews,3,0,3
1210280,True,0,No user reviews,0,0,0
1210290,True,0,No user reviews,0,0,0
1210300,True,0,1 user reviews,1,0,1
1210330,True,0,6 user reviews,6,0,6
1210340,True,0,4 user reviews,4,0,4
1210350,True,0,No user reviews,0,0,0
1210360,True,0,No user reviews,0,0,0
1210380,True,0,No user reviews,0,0,0
1210400,True,0,No user reviews,0,0,0
1210410,True,0,No user reviews,0,0,0
1210470,True,0,No user reviews,0,0,0
1210490,True,0,No user reviews,0,0,0
1210520,True,0,No user reviews,0,0,0
1210530,True,0,No user reviews,0,0,0
1210570,True,0,5 user reviews,5,0,5
1210590,True,0,No user reviews,0,0,0
1210600,True,0,No user reviews,0,0,0
1210610,True,8,Very Positive,81,6,87
1210620,True,0,7 user reviews,5,2,7
1210630,True,0,No user reviews,0,0,0
1210640,True,0,No user reviews,0,0,0
1210650,True,0,No user reviews,0,0,0
1210660,True,7,Positive,10,0,10
1210670,True,0,No user reviews,0,0,0
1210680,True,0,No user reviews,0,0,0
1210700,True,0,2 user reviews,1,1,2
1210730,True,0,No user reviews,0,0,0
1210740,True,0,No user reviews,0,0,0
1210750,True,0,No user reviews,0,0,0
1210770,True,0,6 user reviews,4,2,6
1210780,True,0,No user reviews,0,0,0
1210790,True,0,2 user reviews,2,0,2
1210800,True,7,Positive,27,0,27
1210810,True,0,No user reviews,0,0,0
1210820,True,0,4 user reviews,1,3,4
1210830,True,0,5 user reviews,4,1,5
1210840,True,0,No user reviews,0,0,0
1210850,True,0,No user reviews,0,0,0
1210870,True,7,Positive,15,1,16
1210880,True,0,2 user reviews,1,1,2
1210910,True,0,No user reviews,0,0,0
1210920,True,0,No user reviews,0,0,0
1210940,True,0,No user reviews,0,0,0
1210950,True,0,No user reviews,0,0,0
1210960,True,0,1 user reviews,1,0,1
1210970,True,0,3 user reviews,3,0,3
1210990,True,0,No user reviews,0,0,0
1211000,True,0,No user reviews,0,0,0
1211020,True,8,Very Positive,161,8,169
1211050,True,0,No user reviews,0,0,0
1211060,True,0,No user reviews,0,0,0
1211070,True,0,1 user reviews,1,0,1
1211080,True,0,No user reviews,0,0,0
1211090,True,0,No user reviews,0,0,0
1211100,True,0,2 user reviews,2,0,2
1211110,True,8,Very Positive,58,1,59
1211140,True,0,No user reviews,0,0,0
1211150,True,0,No user reviews,0,0,0
1211160,True,0,No user reviews,0,0,0
1211170,True,7,Positive,10,1,11
1211171,True,0,2 user reviews,2,0,2
1211172,True,0,No user reviews,0,0,0
1211173,True,0,8 user reviews,8,0,8
1211174,True,7,Positive,45,4,49
1211175,True,0,2 user reviews,2,0,2
1211176,True,0,6 user reviews,6,0,6
1211177,True,0,3 user reviews,3,0,3
1211178,True,7,Positive,10,0,10
1211179,True,0,3 user reviews,3,0,3
1211200,True,0,2 user reviews,2,0,2
1211201,True,0,5 user reviews,4,1,5
1211202,True,0,3 user reviews,2,1,3
1211203,True,0,2 user reviews,2,0,2
1211204,True,0,3 user reviews,3,0,3
1211205,True,0,3 user reviews,2,1,3
1211206,True,0,7 user reviews,7,0,7
1211207,True,0,5 user reviews,5,0,5
1211208,True,7,Positive,10,0,10
1211209,True,7,Positive,10,0,10
1211220,True,0,No user reviews,0,0,0
1211230,True,0,No user reviews,0,0,0
1211240,True,0,No user reviews,0,0,0
1211260,True,0,No user reviews,0,0,0
1211270,True,0,No user reviews,0,0,0
1211280,True,0,No user reviews,0,0,0
1211290,True,0,No user reviews,0,0,0
1211300,True,0,No user reviews,0,0,0
1211301,True,0,No user reviews,0,0,0
1211302,True,0,No user reviews,0,0,0
1211303,True,0,No user reviews,0,0,0
1211310,True,0,No user reviews,0,0,0
1211311,True,0,No user reviews,0,0,0
1211312,True,0,No user reviews,0,0,0
1211313,True,0,No user reviews,0,0,0
1211314,True,0,No user reviews,0,0,0
1211320,True,0,2 user reviews,0,2,2
1211340,True,0,No user reviews,0,0,0
1211350,True,0,No user reviews,0,0,0
1211360,True,6,Mostly Positive,42,15,57
1211390,True,0,No user reviews,0,0,0
1211420,True,0,3 user reviews,0,3,3
1211460,True,0,No user reviews,0,0,0
1211470,True,7,Positive,17,2,19
1211471,True,0,3 user reviews,1,2,3
1211472,True,0,2 user reviews,2,0,2
1211473,True,0,4 user reviews,4,0,4
1211474,True,0,4 user reviews,3,1,4
1211475,True,5,Mixed,4,6,10
1211476,True,0,9 user reviews,5,4,9
1211478,True,4,Mostly Negative,3,7,10
1211479,True,0,5 user reviews,4,1,5
1211480,True,6,Mostly Positive,38,10,48
1211490,True,0,3 user reviews,2,1,3
1211530,True,0,No user reviews,0,0,0
1211540,True,0,3 user reviews,3,0,3
1211590,True,0,No user reviews,0,0,0
1211610,True,0,1 user reviews,1,0,1
1211630,True,8,Very Positive,301,13,314
1211640,True,5,Mixed,6,8,14
1211650,True,0,No user reviews,0,0,0
1211671,True,0,1 user reviews,1,0,1
1211672,True,0,3 user reviews,3,0,3
1211673,True,0,5 user reviews,4,1,5
1211674,True,0,1 user reviews,1,0,1
1211675,True,0,No user reviews,0,0,0
1211676,True,0,3 user reviews,3,0,3
1211677,True,0,No user reviews,0,0,0
1211678,True,0,1 user reviews,1,0,1
1211679,True,0,No user reviews,0,0,0
1211680,True,0,3 user reviews,1,2,3
1211681,True,0,1 user reviews,1,0,1
1211682,True,0,No user reviews,0,0,0
1211683,True,0,No user reviews,0,0,0
1211690,True,0,No user reviews,0,0,0
1211700,True,0,No user reviews,0,0,0
1211710,True,0,No user reviews,0,0,0
1211730,True,0,No user reviews,0,0,0
1211740,True,0,No user reviews,0,0,0
1211770,True,0,No user reviews,0,0,0
1211780,True,0,1 user reviews,0,1,1
1211790,True,0,No user reviews,0,0,0
1211800,True,0,No user reviews,0,0,0
1211820,True,0,1 user reviews,1,0,1
1211830,True,0,No user reviews,0,0,0
1211850,True,0,No user reviews,0,0,0
1211860,True,0,No user reviews,0,0,0
1211880,True,0,No user reviews,0,0,0
1211900,True,0,3 user reviews,2,1,3
1211930,True,0,No user reviews,0,0,0
1211940,True,0,No user reviews,0,0,0
1211950,True,0,2 user reviews,2,0,2
1211960,True,5,Mixed,5,5,10
1211970,True,0,No user reviews,0,0,0
1211980,True,0,No user reviews,0,0,0
1212000,True,0,No user reviews,0,0,0
1212020,True,8,Very Positive,95,15,110
1212030,True,0,No user reviews,0,0,0
1212040,True,0,4 user reviews,2,2,4
1212060,True,0,No user reviews,0,0,0
1212080,True,0,7 user reviews,4,3,7
1212090,True,0,3 user reviews,2,1,3
1212100,True,7,Positive,23,4,27
1212110,True,7,Positive,11,0,11
1212170,True,0,8 user reviews,6,2,8
1212180,True,0,No user reviews,0,0,0
1212190,True,0,9 user reviews,8,1,9
1212220,True,0,No user reviews,0,0,0
1212290,True,0,2 user reviews,1,1,2
1212300,True,0,6 user reviews,6,0,6
1212320,True,0,1 user reviews,1,0,1
1212330,True,0,No user reviews,0,0,0
1212340,True,0,No user reviews,0,0,0
1212360,True,0,No user reviews,0,0,0
1212370,True,0,3 user reviews,3,0,3
1212380,True,0,No user reviews,0,0,0
1212400,True,7,Positive,36,3,39
1212410,True,0,No user reviews,0,0,0
1212430,True,0,No user reviews,0,0,0
1212440,True,0,2 user reviews,2,0,2
1212450,True,0,2 user reviews,0,2,2
1212460,True,0,No user reviews,0,0,0
1212470,True,0,1 user reviews,0,1,1
1212480,True,0,No user reviews,0,0,0
1212490,True,0,No user reviews,0,0,0
1212500,True,0,No user reviews,0,0,0
1212510,True,0,No user reviews,0,0,0
1212530,True,0,2 user reviews,1,1,2
1212540,True,0,No user reviews,0,0,0
1212550,True,0,No user reviews,0,0,0
1212580,True,0,No user reviews,0,0,0
1212590,True,0,2 user reviews,2,0,2
1212600,True,0,5 user reviews,0,5,5
1212610,True,0,3 user reviews,1,2,3
1212620,True,8,Very Positive,188,13,201
1212630,True,0,No user reviews,0,0,0
1212640,True,0,2 user reviews,2,0,2
1212660,True,0,No user reviews,0,0,0
1212670,True,0,No user reviews,0,0,0
1212680,True,0,No user reviews,0,0,0
1212690,True,0,No user reviews,0,0,0
1212710,True,0,1 user reviews,1,0,1
1212730,True,0,No user reviews,0,0,0
1212740,True,0,No user reviews,0,0,0
1212750,True,0,2 user reviews,0,2,2
1212760,True,0,No user reviews,0,0,0
1212780,True,0,No user reviews,0,0,0
1212800,True,0,No user reviews,0,0,0
1212801,True,0,No user reviews,0,0,0
1212802,True,0,No user reviews,0,0,0
1212803,True,0,No user reviews,0,0,0
1212804,True,0,No user reviews,0,0,0
1212805,True,0,No user reviews,0,0,0
1212806,True,0,No user reviews,0,0,0
1212807,True,0,No user reviews,0,0,0
1212808,True,0,No user reviews,0,0,0
1212809,True,0,No user reviews,0,0,0
1212810,True,0,1 user reviews,1,0,1
1212811,True,0,No user reviews,0,0,0
1212812,True,0,No user reviews,0,0,0
1212813,True,0,No user reviews,0,0,0
1212814,True,0,No user reviews,0,0,0
1212815,True,0,No user reviews,0,0,0
1212816,True,0,No user reviews,0,0,0
1212817,True,0,3 user reviews,3,0,3
1212830,True,6,Mostly Positive,61,26,87
1212840,True,0,No user reviews,0,0,0
1212850,True,0,No user reviews,0,0,0
1212860,True,0,1 user reviews,1,0,1
1212870,True,0,No user reviews,0,0,0
1212880,True,0,No user reviews,0,0,0
1212890,True,0,No user reviews,0,0,0
1212900,True,0,No user reviews,0,0,0
1212910,True,0,2 user reviews,2,0,2
1212930,True,0,3 user reviews,2,1,3
1212940,True,8,Very Positive,85,15,100
1212960,True,0,No user reviews,0,0,0
1212970,True,0,No user reviews,0,0,0
1212980,True,0,No user reviews,0,0,0
1213000,True,0,1 user reviews,1,0,1
1213010,True,0,No user reviews,0,0,0
1213020,True,0,No user reviews,0,0,0
1213070,True,0,2 user reviews,1,1,2
1213100,True,0,No user reviews,0,0,0
1213110,True,0,No user reviews,0,0,0
1213140,True,0,2 user reviews,2,0,2
1213160,True,0,No user reviews,0,0,0
1213180,True,0,8 user reviews,5,3,8
1213190,True,0,No user reviews,0,0,0
1213200,True,0,No user reviews,0,0,0
1213210,True,8,Very Positive,7754,649,8403
1213220,True,0,No user reviews,0,0,0
1213230,True,0,No user reviews,0,0,0
1213250,True,0,No user reviews,0,0,0
1213270,True,0,No user reviews,0,0,0
1213310,True,0,2 user reviews,0,2,2
1213320,True,0,No user reviews,0,0,0
1213330,True,0,3 user reviews,2,1,3
1213331,True,0,No user reviews,0,0,0
1213332,True,0,No user reviews,0,0,0
1213353,True,0,No user reviews,0,0,0
1213354,True,0,No user reviews,0,0,0
1213355,True,0,No user reviews,0,0,0
1213370,True,7,Positive,11,1,12
1213380,True,0,No user reviews,0,0,0
1213381,True,0,No user reviews,0,0,0
1213382,True,0,No user reviews,0,0,0
1213383,True,0,No user reviews,0,0,0
1213384,True,0,No user reviews,0,0,0
1213385,True,0,No user reviews,0,0,0
1213386,True,0,No user reviews,0,0,0
1213390,True,6,Mostly Positive,12,4,16
1213400,True,0,No user reviews,0,0,0
1213410,True,0,No user reviews,0,0,0
1213420,True,0,2 user reviews,1,1,2
1213440,True,6,Mostly Positive,8,3,11
1213450,True,0,No user reviews,0,0,0
1213460,True,0,No user reviews,0,0,0
1213470,True,0,No user reviews,0,0,0
1213480,True,0,1 user reviews,0,1,1
1213490,True,0,No user reviews,0,0,0
1213491,True,0,No user reviews,0,0,0
1213500,True,0,No user reviews,0,0,0
1213510,True,0,No user reviews,0,0,0
1213520,True,0,No user reviews,0,0,0
1213540,True,0,9 user reviews,6,3,9
1213550,True,7,Positive,19,0,19
1213560,True,0,No user reviews,0,0,0
1213570,True,7,Positive,11,0,11
1213590,True,0,2 user reviews,0,2,2
1213600,True,0,2 user reviews,1,1,2
1213610,True,0,No user reviews,0,0,0
1213611,True,0,No user reviews,0,0,0
1213613,True,0,No user reviews,0,0,0
1213640,True,0,3 user reviews,2,1,3
1213650,True,0,No user reviews,0,0,0
1213660,True,0,2 user reviews,2,0,2
1213670,True,0,No user reviews,0,0,0
1213680,True,6,Mostly Positive,17,5,22
1213700,True,8,Very Positive,218,26,244
1213740,True,6,Mostly Positive,105,32,137
1213750,True,8,Very Positive,208,16,224
1213760,True,0,1 user reviews,1,0,1
1213770,True,0,7 user reviews,7,0,7
1213780,True,0,2 user reviews,1,1,2
1213800,True,0,No user reviews,0,0,0
1213810,True,0,No user reviews,0,0,0
1213820,True,0,No user reviews,0,0,0
1213860,True,0,3 user reviews,2,1,3
1213870,True,0,1 user reviews,1,0,1
1213890,True,0,1 user reviews,1,0,1
1213940,True,7,Positive,14,0,14
1213950,True,0,5 user reviews,4,1,5
1213970,True,0,No user reviews,0,0,0
1213980,True,0,No user reviews,0,0,0
1214000,True,0,No user reviews,0,0,0
1214050,True,0,No user reviews,0,0,0
1214060,True,0,No user reviews,0,0,0
1214090,True,0,No user reviews,0,0,0
1214091,True,0,No user reviews,0,0,0
1214092,True,0,No user reviews,0,0,0
1214093,True,0,No user reviews,0,0,0
1214094,True,0,No user reviews,0,0,0
1214095,True,0,No user reviews,0,0,0
1214096,True,0,No user reviews,0,0,0
1214110,True,0,No user reviews,0,0,0
1214111,True,0,No user reviews,0,0,0
1214112,True,0,No user reviews,0,0,0
1214113,True,0,No user reviews,0,0,0
1214114,True,0,No user reviews,0,0,0
1214115,True,0,No user reviews,0,0,0
1214116,True,0,No user reviews,0,0,0
1214130,True,0,1 user reviews,1,0,1
1214150,True,0,2 user reviews,1,1,2
1214170,True,0,1 user reviews,1,0,1
1214180,True,0,No user reviews,0,0,0
1214200,True,0,No user reviews,0,0,0
1214210,True,0,No user reviews,0,0,0
1214230,True,0,No user reviews,0,0,0
1214250,True,0,No user reviews,0,0,0
1214280,True,0,No user reviews,0,0,0
1214290,True,0,1 user reviews,1,0,1
1214310,True,0,No user reviews,0,0,0
1214320,True,0,1 user reviews,1,0,1
1214330,True,8,Very Positive,70,7,77
1214350,True,0,No user reviews,0,0,0
1214360,True,0,No user reviews,0,0,0
1214380,True,0,No user reviews,0,0,0
1214390,True,0,No user reviews,0,0,0
1214400,True,0,2 user reviews,1,1,2
1214410,True,7,Positive,10,0,10
1214420,True,8,Very Positive,574,101,675
1214430,True,0,No user reviews,0,0,0
1214440,True,0,No user reviews,0,0,0
1214450,True,8,Very Positive,61,4,65
1214460,True,0,1 user reviews,1,0,1
1214470,True,0,No user reviews,0,0,0
1214480,True,7,Positive,17,4,21
1214490,True,0,No user reviews,0,0,0
1214500,True,0,No user reviews,0,0,0
1214520,True,7,Positive,17,0,17
1214530,True,0,1 user reviews,1,0,1
1214540,True,0,1 user reviews,1,0,1
1214550,True,0,No user reviews,0,0,0
1214551,True,0,No user reviews,0,0,0
1214552,True,0,No user reviews,0,0,0
1214553,True,0,No user reviews,0,0,0
1214554,True,0,No user reviews,0,0,0
1214555,True,0,No user reviews,0,0,0
1214556,True,0,No user reviews,0,0,0
1214557,True,0,No user reviews,0,0,0
1214570,True,7,Positive,18,1,19
1214590,True,0,2 user reviews,1,1,2
1214600,True,0,4 user reviews,1,3,4
1214610,True,0,No user reviews,0,0,0
1214620,True,0,No user reviews,0,0,0
1214630,True,0,1 user reviews,0,1,1
1214640,True,0,No user reviews,0,0,0
1214680,True,0,2 user reviews,2,0,2
1214690,True,0,No user reviews,0,0,0
1214710,True,0,No user reviews,0,0,0
1214720,True,0,No user reviews,0,0,0
1214730,True,0,No user reviews,0,0,0
1214740,True,0,No user reviews,0,0,0
1214760,True,0,2 user reviews,2,0,2
1214770,True,0,No user reviews,0,0,0
1214810,True,0,7 user reviews,5,2,7
1214850,True,7,Positive,12,0,12
1214880,True,0,No user reviews,0,0,0
1214890,True,0,No user reviews,0,0,0
1214891,True,0,No user reviews,0,0,0
1214892,True,0,No user reviews,0,0,0
1214893,True,0,No user reviews,0,0,0
1214894,True,0,No user reviews,0,0,0
1214895,True,0,No user reviews,0,0,0
1214896,True,0,No user reviews,0,0,0
1214897,True,0,No user reviews,0,0,0
1214900,True,0,No user reviews,0,0,0
1214910,True,0,No user reviews,0,0,0
1214920,True,0,2 user reviews,2,0,2
1214930,True,0,No user reviews,0,0,0
1214950,True,0,No user reviews,0,0,0
1214970,True,0,1 user reviews,0,1,1
1214980,True,0,6 user reviews,4,2,6
1214990,True,0,1 user reviews,1,0,1
1215000,True,0,8 user reviews,8,0,8
1215020,True,0,No user reviews,0,0,0
1215030,True,0,No user reviews,0,0,0
1215040,True,0,No user reviews,0,0,0
1215050,True,0,8 user reviews,8,0,8
1215080,True,0,No user reviews,0,0,0
1215090,True,0,No user reviews,0,0,0
1215100,True,0,No user reviews,0,0,0
1215110,True,7,Positive,10,1,11
1215120,True,0,No user reviews,0,0,0
1215160,True,0,2 user reviews,2,0,2
1215170,True,0,No user reviews,0,0,0
1215180,True,5,Mixed,25,27,52
1215190,True,0,No user reviews,0,0,0
1215200,True,7,Positive,24,3,27
1215220,True,0,No user reviews,0,0,0
1215230,True,0,1 user reviews,1,0,1
1215260,True,6,Mostly Positive,22,6,28
1215270,True,7,Positive,44,1,45
1215280,True,7,Positive,27,2,29
1215310,True,0,No user reviews,0,0,0
1215320,True,7,Positive,10,0,10
1215330,True,0,No user reviews,0,0,0
1215340,True,0,No user reviews,0,0,0
1215350,True,0,1 user reviews,1,0,1
1215360,True,0,1 user reviews,1,0,1
1215380,True,0,1 user reviews,1,0,1
1215390,True,8,Very Positive,120,3,123
1215400,True,0,No user reviews,0,0,0
1215410,True,0,5 user reviews,1,4,5
1215420,True,0,No user reviews,0,0,0
1215430,True,0,No user reviews,0,0,0
1215450,True,0,No user reviews,0,0,0
1215460,True,0,No user reviews,0,0,0
1215461,True,0,No user reviews,0,0,0
1215462,True,0,No user reviews,0,0,0
1215463,True,0,No user reviews,0,0,0
1215470,True,0,No user reviews,0,0,0
1215480,True,0,No user reviews,0,0,0
1215500,True,0,6 user reviews,6,0,6
1215520,True,0,1 user reviews,1,0,1
1215540,True,0,3 user reviews,2,1,3
1215550,True,5,Mixed,5,6,11
1215580,True,0,No user reviews,0,0,0
1215600,True,0,No user reviews,0,0,0
1215620,True,0,No user reviews,0,0,0
1215640,True,0,1 user reviews,1,0,1
1215650,True,0,5 user reviews,3,2,5
1215660,True,0,1 user reviews,1,0,1
1215680,True,0,No user reviews,0,0,0
1215690,True,0,2 user reviews,1,1,2
1215700,True,0,3 user reviews,3,0,3
1215710,True,0,8 user reviews,4,4,8
1215720,True,0,No user reviews,0,0,0
1215750,True,7,Positive,10,0,10
1215760,True,0,No user reviews,0,0,0
1215770,True,0,6 user reviews,6,0,6
1215830,True,0,1 user reviews,1,0,1
1215840,True,0,No user reviews,0,0,0
1215860,True,5,Mixed,6,4,10
1215870,True,4,Mostly Negative,4,7,11
1215900,True,0,2 user reviews,2,0,2
1215920,True,0,No user reviews,0,0,0
1215930,True,0,8 user reviews,5,3,8
1215940,True,0,No user reviews,0,0,0
1215950,True,0,2 user reviews,0,2,2
1215960,True,0,3 user reviews,2,1,3
1215970,True,0,No user reviews,0,0,0
1215980,True,0,No user reviews,0,0,0
1215990,True,0,No user reviews,0,0,0
1216000,True,0,No user reviews,0,0,0
1216020,True,0,No user reviews,0,0,0
1216050,True,0,6 user reviews,6,0,6
1216070,True,0,No user reviews,0,0,0
1216080,True,0,No user reviews,0,0,0
1216130,True,0,6 user reviews,5,1,6
1216150,True,0,3 user reviews,3,0,3
1216160,True,0,No user reviews,0,0,0
1216170,True,0,No user reviews,0,0,0
1216180,True,0,4 user reviews,3,1,4
1216190,True,0,No user reviews,0,0,0
1216200,True,0,3 user reviews,3,0,3
1216220,True,0,No user reviews,0,0,0
1216230,True,7,Positive,20,2,22
1216270,True,0,No user reviews,0,0,0
1216290,True,0,No user reviews,0,0,0
1216300,True,0,3 user reviews,3,0,3
1216310,True,0,No user reviews,0,0,0
1216320,True,8,Very Positive,1251,113,1364
1216350,True,0,7 user reviews,6,1,7
1216360,True,0,No user reviews,0,0,0
1216370,True,0,4 user reviews,1,3,4
1216380,True,0,No user reviews,0,0,0
1216390,True,0,No user reviews,0,0,0
1216400,True,0,No user reviews,0,0,0
1216410,True,0,No user reviews,0,0,0
1216470,True,0,No user reviews,0,0,0
1216480,True,0,1 user reviews,1,0,1
1216490,True,8,Very Positive,78,0,78
1216510,True,0,2 user reviews,1,1,2
1216530,True,0,No user reviews,0,0,0
1216540,True,7,Positive,12,2,14
1216550,True,0,2 user reviews,1,1,2
1216560,True,0,No user reviews,0,0,0
1216590,True,7,Positive,13,3,16
1216600,True,0,No user reviews,0,0,0
1216610,True,0,4 user reviews,2,2,4
1216640,True,0,2 user reviews,1,1,2
1216660,True,0,4 user reviews,2,2,4
1216680,True,0,No user reviews,0,0,0
1216681,True,0,No user reviews,0,0,0
1216690,True,0,No user reviews,0,0,0
1216700,True,0,No user reviews,0,0,0
1216710,True,8,Very Positive,103,11,114
1216720,True,0,7 user reviews,3,4,7
1216750,True,0,No user reviews,0,0,0
1216790,True,0,1 user reviews,1,0,1
1216792,True,0,1 user reviews,1,0,1
1216793,True,0,1 user reviews,1,0,1
1216794,True,0,2 user reviews,1,1,2
1216810,True,0,No user reviews,0,0,0
1216820,True,0,No user reviews,0,0,0
1216830,True,0,No user reviews,0,0,0
1216840,True,0,No user reviews,0,0,0
1216880,True,8,Very Positive,67,14,81
1216890,True,0,No user reviews,0,0,0
1216900,True,0,No user reviews,0,0,0
1216930,True,0,2 user reviews,1,1,2
1216950,True,0,4 user reviews,4,0,4
1216951,True,0,No user reviews,0,0,0
1216952,True,0,1 user reviews,1,0,1
1216953,True,0,No user reviews,0,0,0
1216954,True,0,1 user reviews,1,0,1
1216955,True,0,No user reviews,0,0,0
1216956,True,0,No user reviews,0,0,0
1216960,True,0,No user reviews,0,0,0
1216980,True,0,1 user reviews,1,0,1
1216990,True,0,No user reviews,0,0,0
1217000,True,0,No user reviews,0,0,0
1217050,True,8,Very Positive,65,7,72
1217060,True,9,Overwhelmingly Positive,8178,327,8505
1217070,True,0,2 user reviews,2,0,2
1217090,True,0,No user reviews,0,0,0
1217100,True,0,No user reviews,0,0,0
1217150,True,0,No user reviews,0,0,0
1217160,True,0,No user reviews,0,0,0
1217180,True,0,No user reviews,0,0,0
1217190,True,0,No user reviews,0,0,0
1217200,True,0,No user reviews,0,0,0
1217220,True,0,1 user reviews,0,1,1
1217230,True,0,No user reviews,0,0,0
1217240,True,0,No user reviews,0,0,0
1217260,True,0,6 user reviews,5,1,6
1217280,True,0,No user reviews,0,0,0
1217290,True,0,No user reviews,0,0,0
1217310,True,0,4 user reviews,4,0,4
1217320,True,0,No user reviews,0,0,0
1217330,True,0,6 user reviews,5,1,6
1217340,True,0,No user reviews,0,0,0
1217350,True,0,9 user reviews,9,0,9
1217370,True,0,2 user reviews,1,1,2
1217380,True,0,5 user reviews,4,1,5
1217390,True,7,Positive,35,1,36
1217400,True,0,No user reviews,0,0,0
1217401,True,0,2 user reviews,2,0,2
1217410,True,0,No user reviews,0,0,0
1217440,True,0,No user reviews,0,0,0
1217460,True,0,No user reviews,0,0,0
1217480,True,0,1 user reviews,0,1,1
1217490,True,0,No user reviews,0,0,0
1217510,True,0,No user reviews,0,0,0
1217520,True,0,No user reviews,0,0,0
1217550,True,0,No user reviews,0,0,0
1217560,True,0,1 user reviews,1,0,1
1217570,True,7,Positive,8,2,10
1217580,True,0,1 user reviews,1,0,1
1217600,True,0,No user reviews,0,0,0
1217601,True,0,No user reviews,0,0,0
1217610,True,0,3 user reviews,2,1,3
1217630,True,0,2 user reviews,0,2,2
1217640,True,0,4 user reviews,3,1,4
1217660,True,0,No user reviews,0,0,0
1217671,True,0,No user reviews,0,0,0
1217672,True,0,No user reviews,0,0,0
1217673,True,0,No user reviews,0,0,0
1217674,True,0,No user reviews,0,0,0
1217675,True,0,No user reviews,0,0,0
1217676,True,0,No user reviews,0,0,0
1217677,True,0,No user reviews,0,0,0
1217679,True,0,No user reviews,0,0,0
1217682,True,0,No user reviews,0,0,0
1217683,True,0,No user reviews,0,0,0
1217684,True,0,No user reviews,0,0,0
1217685,True,0,No user reviews,0,0,0
1217686,True,0,No user reviews,0,0,0
1217687,True,0,No user reviews,0,0,0
1217688,True,0,No user reviews,0,0,0
1217689,True,0,No user reviews,0,0,0
1217690,True,0,No user reviews,0,0,0
1217691,True,0,No user reviews,0,0,0
1217692,True,0,No user reviews,0,0,0
1217700,True,0,No user reviews,0,0,0
1217710,True,0,No user reviews,0,0,0
1217720,True,7,Positive,13,1,14
1217750,True,0,No user reviews,0,0,0
1217820,True,0,No user reviews,0,0,0
1217840,True,0,3 user reviews,3,0,3
1217850,True,0,No user reviews,0,0,0
1217860,True,0,7 user reviews,5,2,7
1217870,True,0,3 user reviews,3,0,3
1217880,True,0,No user reviews,0,0,0
1217890,True,0,No user reviews,0,0,0
1217900,True,0,4 user reviews,4,0,4
1217910,True,0,No user reviews,0,0,0
1217930,True,0,No user reviews,0,0,0
1217940,True,0,No user reviews,0,0,0
1217950,True,0,No user reviews,0,0,0
1217970,True,0,1 user reviews,1,0,1
1217980,True,0,No user reviews,0,0,0
1217990,True,0,No user reviews,0,0,0
1218010,True,0,1 user reviews,0,1,1
1218020,True,0,No user reviews,0,0,0
1218030,True,0,1 user reviews,1,0,1
1218040,True,0,No user reviews,0,0,0
1218080,True,0,No user reviews,0,0,0
1218090,True,0,2 user reviews,1,1,2
1218110,True,0,No user reviews,0,0,0
1218150,True,0,No user reviews,0,0,0
1218160,True,0,No user reviews,0,0,0
1218170,True,0,No user reviews,0,0,0
1218190,True,0,No user reviews,0,0,0
1218200,True,0,3 user reviews,2,1,3
1218210,True,0,No user reviews,0,0,0
1218220,True,0,No user reviews,0,0,0
1218230,True,7,Positive,9,1,10
1218240,True,0,No user reviews,0,0,0
1218250,True,0,No user reviews,0,0,0
1218260,True,0,No user reviews,0,0,0
1218280,True,8,Very Positive,128,22,150
1218300,True,0,No user reviews,0,0,0
1218310,True,0,3 user reviews,3,0,3
1218320,True,0,No user reviews,0,0,0
1218360,True,0,No user reviews,0,0,0
1218390,True,0,1 user reviews,0,1,1
1218400,True,0,No user reviews,0,0,0
1218420,True,0,2 user reviews,0,2,2
1218440,True,0,No user reviews,0,0,0
1218460,True,0,No user reviews,0,0,0
1218500,True,0,No user reviews,0,0,0
1218510,True,0,No user reviews,0,0,0
1218520,True,7,Positive,21,0,21
1218530,True,0,No user reviews,0,0,0
1218540,True,0,No user reviews,0,0,0
1218550,True,0,No user reviews,0,0,0
1218560,True,0,1 user reviews,1,0,1
1218570,True,7,Positive,18,3,21
1218580,True,0,2 user reviews,2,0,2
1218590,True,0,No user reviews,0,0,0
1218640,True,0,No user reviews,0,0,0
1218650,True,0,No user reviews,0,0,0
1218670,True,0,No user reviews,0,0,0
1218680,True,0,3 user reviews,2,1,3
1218690,True,0,No user reviews,0,0,0
1218710,True,0,2 user reviews,0,2,2
1218720,True,0,9 user reviews,5,4,9
1218730,True,0,No user reviews,0,0,0
1218740,True,0,No user reviews,0,0,0
1218750,True,0,No user reviews,0,0,0
1218760,True,0,2 user reviews,1,1,2
1218770,True,0,4 user reviews,1,3,4
1218780,True,0,No user reviews,0,0,0
1218790,True,0,3 user reviews,2,1,3
1218810,True,0,3 user reviews,3,0,3
1218830,True,7,Positive,14,2,16
1218850,True,0,No user reviews,0,0,0
1218860,True,0,No user reviews,0,0,0
1218880,True,0,No user reviews,0,0,0
1218890,True,0,8 user reviews,6,2,8
1218910,True,0,No user reviews,0,0,0
1218920,True,6,Mostly Positive,14,4,18
1218930,True,0,No user reviews,0,0,0
1218940,True,0,No user reviews,0,0,0
1218950,True,0,No user reviews,0,0,0
1218960,True,0,No user reviews,0,0,0
1218990,True,0,No user reviews,0,0,0
1219000,True,0,No user reviews,0,0,0
1219010,True,0,No user reviews,0,0,0
1219020,True,0,6 user reviews,5,1,6
1219040,True,0,No user reviews,0,0,0
1219060,True,0,No user reviews,0,0,0
1219080,True,0,No user reviews,0,0,0
1219110,True,0,No user reviews,0,0,0
1219120,True,0,1 user reviews,1,0,1
1219130,True,0,3 user reviews,3,0,3
1219140,True,0,1 user reviews,1,0,1
1219150,True,0,No user reviews,0,0,0
1219160,True,0,No user reviews,0,0,0
1219170,True,0,No user reviews,0,0,0
1219180,True,0,No user reviews,0,0,0
1219200,True,0,No user reviews,0,0,0
1219220,True,0,1 user reviews,0,1,1
1219230,True,0,8 user reviews,6,2,8
1219240,True,0,No user reviews,0,0,0
1219260,True,0,No user reviews,0,0,0
1219261,True,0,No user reviews,0,0,0
1219270,True,0,No user reviews,0,0,0
1219280,True,0,No user reviews,0,0,0
1219300,True,0,No user reviews,0,0,0
1219310,True,0,No user reviews,0,0,0
1219320,True,0,9 user reviews,7,2,9
1219330,True,0,No user reviews,0,0,0
1219350,True,0,No user reviews,0,0,0
1219370,True,0,No user reviews,0,0,0
1219410,True,0,No user reviews,0,0,0
1219420,True,0,4 user reviews,4,0,4
1219440,True,0,1 user reviews,1,0,1
1219450,True,0,No user reviews,0,0,0
1219470,True,0,No user reviews,0,0,0
1219480,True,0,No user reviews,0,0,0
1219500,True,0,3 user reviews,3,0,3
1219510,True,0,No user reviews,0,0,0
1219520,True,0,3 user reviews,0,3,3
1219530,True,0,No user reviews,0,0,0
1219540,True,0,No user reviews,0,0,0
1219550,True,0,No user reviews,0,0,0
1219560,True,0,No user reviews,0,0,0
1219580,True,0,9 user reviews,7,2,9
1219590,True,0,No user reviews,0,0,0
1219600,True,0,No user reviews,0,0,0
1219610,True,0,6 user reviews,4,2,6
1219620,True,0,No user reviews,0,0,0
1219630,True,0,No user reviews,0,0,0
1219640,True,0,No user reviews,0,0,0
1219650,True,0,5 user reviews,4,1,5
1219660,True,0,No user reviews,0,0,0
1219670,True,0,No user reviews,0,0,0
1219680,True,0,No user reviews,0,0,0
1219690,True,0,No user reviews,0,0,0
1219700,True,0,8 user reviews,8,0,8
1219730,True,0,4 user reviews,4,0,4
1219740,True,0,No user reviews,0,0,0
1219750,True,0,1 user reviews,1,0,1
1219790,True,0,No user reviews,0,0,0
1219810,True,0,No user reviews,0,0,0
1219820,True,0,1 user reviews,1,0,1
1219840,True,0,No user reviews,0,0,0
1219850,True,0,1 user reviews,1,0,1
1219851,True,0,No user reviews,0,0,0
1219852,True,0,1 user reviews,1,0,1
1219860,True,0,6 user reviews,5,1,6
1219870,True,0,No user reviews,0,0,0
1219890,True,0,No user reviews,0,0,0
1219910,True,0,No user reviews,0,0,0
1219920,True,0,No user reviews,0,0,0
1219930,True,0,No user reviews,0,0,0
1219940,True,5,Mixed,11,7,18
1219950,True,8,Very Positive,140,16,156
1219980,True,0,4 user reviews,4,0,4
1219990,True,0,9 user reviews,9,0,9
1220010,True,0,No user reviews,0,0,0
1220040,True,0,No user reviews,0,0,0
1220050,True,0,No user reviews,0,0,0
1220070,True,0,1 user reviews,0,1,1
1220080,True,7,Positive,8,2,10
1220110,True,0,No user reviews,0,0,0
1220120,True,5,Mixed,6,4,10
1220130,True,0,No user reviews,0,0,0
1220140,True,0,No user reviews,0,0,0
1220150,True,0,No user reviews,0,0,0
1220160,True,0,1 user reviews,1,0,1
1220170,True,0,No user reviews,0,0,0
1220180,True,0,No user reviews,0,0,0
1220190,True,0,4 user reviews,2,2,4
1220200,True,0,No user reviews,0,0,0
1220210,True,0,No user reviews,0,0,0
1220260,True,0,No user reviews,0,0,0
1220300,True,0,No user reviews,0,0,0
1220310,True,0,No user reviews,0,0,0
1220330,True,0,No user reviews,0,0,0
1220340,True,0,5 user reviews,2,3,5
1220350,True,0,No user reviews,0,0,0
1220360,True,0,1 user reviews,0,1,1
1220370,True,6,Mostly Positive,14,4,18
1220380,True,0,No user reviews,0,0,0
1220390,True,0,No user reviews,0,0,0
1220400,True,0,No user reviews,0,0,0
1220401,True,0,No user reviews,0,0,0
1220410,True,0,No user reviews,0,0,0
1220420,True,0,1 user reviews,1,0,1
1220421,True,0,1 user reviews,1,0,1
1220440,True,0,No user reviews,0,0,0
1220460,True,0,No user reviews,0,0,0
1220510,True,0,2 user reviews,2,0,2
1220520,True,0,1 user reviews,1,0,1
1220540,True,0,1 user reviews,0,1,1
1220550,True,0,No user reviews,0,0,0
1220560,True,0,No user reviews,0,0,0
1220580,True,0,1 user reviews,0,1,1
1220590,True,0,No user reviews,0,0,0
1220600,True,0,No user reviews,0,0,0
1220610,True,0,No user reviews,0,0,0
1220650,True,0,No user reviews,0,0,0
1220660,True,0,No user reviews,0,0,0
1220670,True,0,No user reviews,0,0,0
1220680,True,0,No user reviews,0,0,0
1220690,True,0,2 user reviews,2,0,2
1220710,True,0,3 user reviews,3,0,3
1220740,True,0,No user reviews,0,0,0
1220750,True,0,No user reviews,0,0,0
1220760,True,0,No user reviews,0,0,0
1220790,True,0,No user reviews,0,0,0
1220810,True,0,No user reviews,0,0,0
1220840,True,0,No user reviews,0,0,0
1220850,True,0,2 user reviews,1,1,2
1220860,True,0,No user reviews,0,0,0
1220880,True,0,No user reviews,0,0,0
1220890,True,0,2 user reviews,1,1,2
1220900,True,0,No user reviews,0,0,0
1220910,True,0,1 user reviews,1,0,1
1220920,True,0,4 user reviews,3,1,4
1220930,True,0,No user reviews,0,0,0
1220950,True,0,No user reviews,0,0,0
1220960,True,0,No user reviews,0,0,0
1220970,True,0,No user reviews,0,0,0
1220980,True,0,2 user reviews,0,2,2
1220990,True,0,No user reviews,0,0,0
1221000,True,0,No user reviews,0,0,0
1221010,True,0,No user reviews,0,0,0
1221020,True,0,No user reviews,0,0,0
1221030,True,0,5 user reviews,5,0,5
1221040,True,0,No user reviews,0,0,0
1221050,True,0,7 user reviews,4,3,7
1221070,True,0,4 user reviews,3,1,4
1221080,True,8,Very Positive,165,38,203
1221090,True,0,No user reviews,0,0,0
1221100,True,0,No user reviews,0,0,0
1221110,True,0,No user reviews,0,0,0
1221120,True,0,No user reviews,0,0,0
1221130,True,0,No user reviews,0,0,0
1221140,True,0,No user reviews,0,0,0
1221150,True,0,No user reviews,0,0,0
1221160,True,0,No user reviews,0,0,0
1221170,True,0,No user reviews,0,0,0
1221180,True,0,No user reviews,0,0,0
1221190,True,0,No user reviews,0,0,0
1221200,True,0,No user reviews,0,0,0
1221210,True,0,No user reviews,0,0,0
1221220,True,0,1 user reviews,1,0,1
1221230,True,0,4 user reviews,4,0,4
1221240,True,5,Mixed,6,5,11
1221250,True,0,No user reviews,0,0,0
1221260,True,0,No user reviews,0,0,0
1221280,True,0,1 user reviews,1,0,1
1221290,True,0,4 user reviews,3,1,4
1221300,True,0,No user reviews,0,0,0
1221320,True,0,4 user reviews,4,0,4
1221330,True,0,1 user reviews,1,0,1
1221340,True,0,No user reviews,0,0,0
1221360,True,0,1 user reviews,1,0,1
1221370,True,0,No user reviews,0,0,0
1221390,True,0,1 user reviews,1,0,1
1221400,True,0,1 user reviews,1,0,1
1221420,True,0,No user reviews,0,0,0
1221430,True,0,No user reviews,0,0,0
1221440,True,6,Mostly Positive,7,3,10
1221460,True,0,8 user reviews,3,5,8
1221500,True,0,No user reviews,0,0,0
1221510,True,0,2 user reviews,1,1,2
1221520,True,0,2 user reviews,1,1,2
1221530,True,0,No user reviews,0,0,0
1221540,True,7,Positive,24,6,30
1221560,True,0,No user reviews,0,0,0
1221590,True,7,Positive,8,2,10
1221600,True,0,1 user reviews,1,0,1
1221610,True,0,No user reviews,0,0,0
1221620,True,0,No user reviews,0,0,0
1221630,True,0,4 user reviews,4,0,4
1221640,True,7,Positive,15,0,15
1221660,True,0,1 user reviews,0,1,1
1221670,True,0,No user reviews,0,0,0
1221700,True,0,7 user reviews,5,2,7
1221740,True,0,No user reviews,0,0,0
1221750,True,0,No user reviews,0,0,0
1221780,True,0,No user reviews,0,0,0
1221790,True,0,3 user reviews,3,0,3
1221800,True,7,Positive,10,1,11
1221810,True,0,No user reviews,0,0,0
1221830,True,0,2 user reviews,2,0,2
1221850,True,0,1 user reviews,1,0,1
1221851,True,0,No user reviews,0,0,0
1221852,True,0,No user reviews,0,0,0
1221853,True,0,No user reviews,0,0,0
1221860,True,0,3 user reviews,3,0,3
1221870,True,0,No user reviews,0,0,0
1221880,True,0,4 user reviews,4,0,4
1221890,True,0,No user reviews,0,0,0
1221900,True,0,4 user reviews,3,1,4
1221940,True,0,No user reviews,0,0,0
1221950,True,0,No user reviews,0,0,0
1221980,True,0,No user reviews,0,0,0
1221990,True,7,Positive,10,0,10
1222000,True,0,2 user reviews,2,0,2
1222020,True,7,Positive,15,0,15
1222040,True,8,Very Positive,64,5,69
1222050,True,5,Mixed,20,14,34
1222060,True,0,No user reviews,0,0,0
1222080,True,0,No user reviews,0,0,0
1222090,True,0,No user reviews,0,0,0
1222100,True,0,No user reviews,0,0,0
1222101,True,0,No user reviews,0,0,0
1222110,True,0,No user reviews,0,0,0
1222120,True,0,No user reviews,0,0,0
1222130,True,0,No user reviews,0,0,0
1222140,True,8,Very Positive,3801,440,4241
1222150,True,0,No user reviews,0,0,0
1222160,True,0,8 user reviews,7,1,8
1222170,True,0,7 user reviews,6,1,7
1222180,True,0,7 user reviews,4,3,7
1222190,True,0,No user reviews,0,0,0
1222200,True,0,No user reviews,0,0,0
1222210,True,0,No user reviews,0,0,0
1222220,True,0,1 user reviews,1,0,1
1222230,True,0,1 user reviews,1,0,1
1222240,True,0,1 user reviews,1,0,1
1222250,True,0,1 user reviews,1,0,1
1222260,True,0,No user reviews,0,0,0
1222270,True,0,4 user reviews,4,0,4
1222300,True,8,Very Positive,67,5,72
1222310,True,0,No user reviews,0,0,0
1222320,True,0,No user reviews,0,0,0
1222330,True,0,No user reviews,0,0,0
1222340,True,0,No user reviews,0,0,0
1222360,True,0,No user reviews,0,0,0
1222390,True,0,No user reviews,0,0,0
1222400,True,6,Mostly Positive,31,13,44
1222410,True,0,No user reviews,0,0,0
1222420,True,0,No user reviews,0,0,0
1222440,True,0,No user reviews,0,0,0
1222470,True,0,6 user reviews,4,2,6
1222480,True,0,No user reviews,0,0,0
1222490,True,0,No user reviews,0,0,0
1222530,True,0,No user reviews,0,0,0
1222540,True,0,No user reviews,0,0,0
1222550,True,0,No user reviews,0,0,0
1222560,True,0,No user reviews,0,0,0
1222570,True,0,No user reviews,0,0,0
1222580,True,0,4 user reviews,3,1,4
1222590,True,0,No user reviews,0,0,0
1222600,True,7,Positive,25,4,29
1222610,True,0,8 user reviews,7,1,8
1222632,True,0,No user reviews,0,0,0
1222634,True,0,No user reviews,0,0,0
1222640,True,0,6 user reviews,2,4,6
1222650,True,0,No user reviews,0,0,0
1222670,True,8,Very Positive,1416,200,1616
1222680,True,8,Very Positive,2821,645,3466
1222690,True,6,Mostly Positive,634,264,898
1222700,True,8,Very Positive,1388,227,1615
1222720,True,0,No user reviews,0,0,0
1222730,True,6,Mostly Positive,7122,2492,9614
1222740,True,0,No user reviews,0,0,0
1222760,True,0,4 user reviews,3,1,4
1222780,True,0,No user reviews,0,0,0
1222800,True,0,No user reviews,0,0,0
1222820,True,0,No user reviews,0,0,0
1222840,True,0,No user reviews,0,0,0
1222860,True,0,No user reviews,0,0,0
1222870,True,0,1 user reviews,0,1,1
1222890,True,0,No user reviews,0,0,0
1222891,True,0,No user reviews,0,0,0
1222920,True,0,No user reviews,0,0,0
1222930,True,0,9 user reviews,6,3,9
1222940,True,0,No user reviews,0,0,0
1222960,True,0,No user reviews,0,0,0
1222980,True,0,2 user reviews,2,0,2
1223000,True,0,No user reviews,0,0,0
1223010,True,0,No user reviews,0,0,0
1223030,True,0,No user reviews,0,0,0
1223060,True,6,Mostly Positive,19,5,24
1223090,True,0,4 user reviews,2,2,4
1223110,True,0,7 user reviews,7,0,7
1223130,True,0,1 user reviews,1,0,1
1223140,True,0,No user reviews,0,0,0
1223160,True,0,No user reviews,0,0,0
1223170,True,0,No user reviews,0,0,0
1223200,True,0,No user reviews,0,0,0
1223210,True,0,2 user reviews,1,1,2
1223230,True,0,No user reviews,0,0,0
1223240,True,0,No user reviews,0,0,0
1223250,True,7,Positive,14,1,15
1223260,True,0,6 user reviews,6,0,6
1223270,True,0,3 user reviews,1,2,3
1223290,True,0,3 user reviews,3,0,3
1223300,True,0,1 user reviews,1,0,1
1223310,True,0,No user reviews,0,0,0
1223330,True,0,No user reviews,0,0,0
1223340,True,0,No user reviews,0,0,0
1223350,True,0,9 user reviews,5,4,9
1223360,True,0,No user reviews,0,0,0
1223370,True,0,5 user reviews,5,0,5
1223380,True,0,2 user reviews,1,1,2
1223390,True,0,3 user reviews,3,0,3
1223400,True,0,No user reviews,0,0,0
1223440,True,0,No user reviews,0,0,0
1223460,True,0,No user reviews,0,0,0
1223490,True,5,Mixed,21,10,31
1223500,True,8,Very Positive,126,7,133
1223510,True,0,No user reviews,0,0,0
1223530,True,0,No user reviews,0,0,0
1223550,True,0,No user reviews,0,0,0
1223580,True,8,Very Positive,45,6,51
1223630,True,0,No user reviews,0,0,0
1223660,True,0,No user reviews,0,0,0
1223670,True,0,No user reviews,0,0,0
1223680,True,0,No user reviews,0,0,0
1223710,True,0,No user reviews,0,0,0
1223720,True,0,No user reviews,0,0,0
1223730,True,0,No user reviews,0,0,0
1223750,True,6,Mostly Positive,279,105,384
1223760,True,0,No user reviews,0,0,0
1223780,True,0,No user reviews,0,0,0
1223800,True,0,No user reviews,0,0,0
1223810,True,8,Very Positive,115,3,118
1223820,True,0,No user reviews,0,0,0
1223830,True,0,1 user reviews,1,0,1
1223840,True,0,No user reviews,0,0,0
1223850,True,0,No user reviews,0,0,0
1223860,True,7,Positive,40,1,41
1223880,True,0,2 user reviews,2,0,2
1223910,True,5,Mixed,8,9,17
1223950,True,0,No user reviews,0,0,0
1223960,True,0,No user reviews,0,0,0
1224000,True,0,3 user reviews,3,0,3
1224010,True,0,No user reviews,0,0,0
1224020,True,8,Very Positive,106,19,125
1224050,True,0,No user reviews,0,0,0
1224060,True,0,No user reviews,0,0,0
1224070,True,0,No user reviews,0,0,0
1224100,True,0,1 user reviews,1,0,1
1224120,True,7,Positive,17,3,20
1224130,True,0,5 user reviews,3,2,5
1224140,True,0,1 user reviews,1,0,1
1224160,True,8,Very Positive,174,8,182
1224190,True,0,No user reviews,0,0,0
1224210,True,0,No user reviews,0,0,0
1224220,True,0,No user reviews,0,0,0
1224230,True,0,No user reviews,0,0,0
1224240,True,0,No user reviews,0,0,0
1224250,True,0,No user reviews,0,0,0
1224260,True,0,No user reviews,0,0,0
1224290,True,8,Very Positive,206,13,219
1224300,True,0,No user reviews,0,0,0
1224320,True,0,1 user reviews,1,0,1
1224330,True,0,No user reviews,0,0,0
1224340,True,5,Mixed,14,8,22
1224341,True,5,Mixed,12,9,21
1224350,True,0,7 user reviews,7,0,7
1224370,True,0,1 user reviews,1,0,1
1224380,True,0,9 user reviews,4,5,9
1224390,True,0,No user reviews,0,0,0
1224410,True,0,No user reviews,0,0,0
1224440,True,0,No user reviews,0,0,0
1224450,True,7,Positive,22,0,22
1224460,True,0,No user reviews,0,0,0
1224470,True,0,No user reviews,0,0,0
1224480,True,6,Mostly Positive,11,4,15
1224490,True,0,1 user reviews,1,0,1
1224530,True,6,Mostly Positive,34,13,47
1224550,True,0,1 user reviews,1,0,1
1224570,True,0,No user reviews,0,0,0
1224580,True,0,No user reviews,0,0,0
1224590,True,0,No user reviews,0,0,0
1224600,True,8,Very Positive,94,17,111
1224620,True,0,No user reviews,0,0,0
1224630,True,0,No user reviews,0,0,0
1224640,True,0,No user reviews,0,0,0
1224650,True,0,No user reviews,0,0,0
1224680,True,0,No user reviews,0,0,0
1224690,True,5,Mixed,38,24,62
1224700,True,0,No user reviews,0,0,0
1224710,True,0,No user reviews,0,0,0
1224720,True,0,3 user reviews,0,3,3
1224740,True,0,1 user reviews,1,0,1
1224760,True,0,1 user reviews,1,0,1
1224761,True,0,No user reviews,0,0,0
1224762,True,0,No user reviews,0,0,0
1224763,True,0,No user reviews,0,0,0
1224764,True,0,No user reviews,0,0,0
1224770,True,0,No user reviews,0,0,0
1224780,True,0,No user reviews,0,0,0
1224781,True,0,No user reviews,0,0,0
1224782,True,0,No user reviews,0,0,0
1224783,True,0,1 user reviews,1,0,1
1224784,True,0,No user reviews,0,0,0
1224785,True,0,No user reviews,0,0,0
1224786,True,0,No user reviews,0,0,0
1224787,True,0,No user reviews,0,0,0
1224788,True,0,No user reviews,0,0,0
1224789,True,0,No user reviews,0,0,0
1224790,True,0,No user reviews,0,0,0
1224791,True,0,No user reviews,0,0,0
1224792,True,0,No user reviews,0,0,0
1224793,True,0,No user reviews,0,0,0
1224794,True,0,No user reviews,0,0,0
1224795,True,0,No user reviews,0,0,0
1224796,True,0,1 user reviews,0,1,1
1224800,True,0,No user reviews,0,0,0
1224820,True,0,5 user reviews,5,0,5
1224821,True,0,1 user reviews,1,0,1
1224822,True,0,No user reviews,0,0,0
1224823,True,0,No user reviews,0,0,0
1224824,True,0,No user reviews,0,0,0
1224825,True,0,No user reviews,0,0,0
1224826,True,0,No user reviews,0,0,0
1224827,True,0,2 user reviews,2,0,2
1224830,True,0,No user reviews,0,0,0
1224831,True,0,No user reviews,0,0,0
1224832,True,0,1 user reviews,1,0,1
1224833,True,0,No user reviews,0,0,0
1224834,True,0,No user reviews,0,0,0
1224835,True,0,No user reviews,0,0,0
1224836,True,0,No user reviews,0,0,0
1224840,True,0,No user reviews,0,0,0
1224850,True,0,No user reviews,0,0,0
1224851,True,0,No user reviews,0,0,0
1224852,True,0,No user reviews,0,0,0
1224853,True,0,No user reviews,0,0,0
1224854,True,0,No user reviews,0,0,0
1224855,True,0,No user reviews,0,0,0
1224856,True,0,No user reviews,0,0,0
1224857,True,0,No user reviews,0,0,0
1224858,True,0,No user reviews,0,0,0
1224859,True,0,No user reviews,0,0,0
1224860,True,0,No user reviews,0,0,0
1224861,True,0,No user reviews,0,0,0
1224862,True,0,No user reviews,0,0,0
1224863,True,0,No user reviews,0,0,0
1224864,True,0,No user reviews,0,0,0
1224865,True,0,No user reviews,0,0,0
1224866,True,0,No user reviews,0,0,0
1224867,True,0,No user reviews,0,0,0
1224868,True,0,No user reviews,0,0,0
1224870,True,0,No user reviews,0,0,0
1224871,True,0,No user reviews,0,0,0
1224872,True,0,1 user reviews,1,0,1
1224873,True,0,No user reviews,0,0,0
1224874,True,0,No user reviews,0,0,0
1224875,True,0,No user reviews,0,0,0
1224876,True,0,No user reviews,0,0,0
1224877,True,0,No user reviews,0,0,0
1224878,True,0,No user reviews,0,0,0
1224879,True,0,No user reviews,0,0,0
1224890,True,0,No user reviews,0,0,0
1224891,True,0,No user reviews,0,0,0
1224892,True,0,No user reviews,0,0,0
1224893,True,0,No user reviews,0,0,0
1224894,True,0,No user reviews,0,0,0
1224895,True,0,No user reviews,0,0,0
1224896,True,0,No user reviews,0,0,0
1224897,True,0,No user reviews,0,0,0
1224898,True,0,No user reviews,0,0,0
1224900,True,0,No user reviews,0,0,0
1224940,True,0,2 user reviews,0,2,2
1224950,True,0,No user reviews,0,0,0
1225000,True,0,No user reviews,0,0,0
1225030,True,0,No user reviews,0,0,0
1225060,True,0,No user reviews,0,0,0
1225070,True,6,Mostly Positive,10,3,13
1225100,True,0,No user reviews,0,0,0
1225110,True,5,Mixed,14,12,26
1225120,True,7,Positive,11,0,11
1225130,True,0,7 user reviews,6,1,7
1225140,True,7,Positive,27,2,29
1225190,True,0,No user reviews,0,0,0
1225200,True,0,No user reviews,0,0,0
1225210,True,7,Positive,18,3,21
1225220,True,0,No user reviews,0,0,0
1225240,True,0,No user reviews,0,0,0
1225250,True,0,No user reviews,0,0,0
1225260,True,0,5 user reviews,3,2,5
1225270,True,0,No user reviews,0,0,0
1225290,True,0,No user reviews,0,0,0
1225300,True,0,1 user reviews,1,0,1
1225310,True,0,No user reviews,0,0,0
1225320,True,0,2 user reviews,1,1,2
1225330,True,5,Mixed,847,959,1806
1225340,True,0,No user reviews,0,0,0
1225350,True,0,No user reviews,0,0,0
1225360,True,0,No user reviews,0,0,0
1225370,True,0,1 user reviews,1,0,1
1225380,True,0,No user reviews,0,0,0
1225390,True,0,No user reviews,0,0,0
1225410,True,0,No user reviews,0,0,0
1225420,True,0,No user reviews,0,0,0
1225430,True,0,No user reviews,0,0,0
1225440,True,0,No user reviews,0,0,0
1225450,True,0,No user reviews,0,0,0
1225500,True,0,No user reviews,0,0,0
1225510,True,0,No user reviews,0,0,0
1225511,True,0,No user reviews,0,0,0
1225512,True,0,No user reviews,0,0,0
1225513,True,0,No user reviews,0,0,0
1225514,True,0,No user reviews,0,0,0
1225515,True,0,No user reviews,0,0,0
1225550,True,5,Mixed,6,6,12
1225560,True,8,Very Positive,120,22,142
1225570,True,8,Very Positive,86,21,107
1225580,True,7,Positive,27,4,31
1225590,True,8,Very Positive,120,18,138
1225600,True,7,Positive,9,1,10
1225610,True,0,6 user reviews,6,0,6
1225620,True,0,No user reviews,0,0,0
1225630,True,0,No user reviews,0,0,0
1225640,True,0,2 user reviews,2,0,2
1225680,True,0,No user reviews,0,0,0
1225690,True,0,No user reviews,0,0,0
1225710,True,0,2 user reviews,2,0,2
1225720,True,0,1 user reviews,1,0,1
1225740,True,0,3 user reviews,1,2,3
1225750,True,0,No user reviews,0,0,0
1225760,True,0,No user reviews,0,0,0
1225780,True,0,8 user reviews,8,0,8
1225790,True,0,No user reviews,0,0,0
1225800,True,0,No user reviews,0,0,0
1225810,True,0,No user reviews,0,0,0
1225820,True,0,No user reviews,0,0,0
1225830,True,0,No user reviews,0,0,0
1225840,True,0,2 user reviews,2,0,2
1225850,True,0,No user reviews,0,0,0
1225870,True,0,8 user reviews,6,2,8
1225890,True,0,No user reviews,0,0,0
1225900,True,0,No user reviews,0,0,0
1225910,True,0,1 user reviews,0,1,1
1225920,True,0,3 user reviews,1,2,3
1225930,True,0,No user reviews,0,0,0
1225940,True,0,No user reviews,0,0,0
1225960,True,0,2 user reviews,2,0,2
1225980,True,0,No user reviews,0,0,0
1226000,True,7,Positive,38,4,42
1226010,True,0,3 user reviews,3,0,3
1226020,True,0,No user reviews,0,0,0
1226030,True,0,No user reviews,0,0,0
1226040,True,0,No user reviews,0,0,0
1226050,True,0,No user reviews,0,0,0
1226070,True,0,No user reviews,0,0,0
1226080,True,0,2 user reviews,1,1,2
1226100,True,0,No user reviews,0,0,0
1226130,True,0,No user reviews,0,0,0
1226150,True,0,No user reviews,0,0,0
1226170,True,0,1 user reviews,1,0,1
1226190,True,0,No user reviews,0,0,0
1226210,True,0,7 user reviews,5,2,7
1226220,True,0,No user reviews,0,0,0
1226222,True,0,No user reviews,0,0,0
1226230,True,0,1 user reviews,1,0,1
1226250,True,0,No user reviews,0,0,0
1226270,True,0,No user reviews,0,0,0
1226280,True,0,No user reviews,0,0,0
1226290,True,0,No user reviews,0,0,0
1226300,True,0,No user reviews,0,0,0
1226310,True,0,No user reviews,0,0,0
1226320,True,0,No user reviews,0,0,0
1226330,True,0,No user reviews,0,0,0
1226340,True,0,No user reviews,0,0,0
1226350,True,0,No user reviews,0,0,0
1226360,True,0,No user reviews,0,0,0
1226410,True,0,No user reviews,0,0,0
1226420,True,0,1 user reviews,0,1,1
1226430,True,0,No user reviews,0,0,0
1226450,True,0,No user reviews,0,0,0
1226460,True,0,No user reviews,0,0,0
1226470,True,5,Mixed,32,32,64
1226480,True,0,No user reviews,0,0,0
1226490,True,0,2 user reviews,1,1,2
1226500,True,0,1 user reviews,1,0,1
1226510,True,0,No user reviews,0,0,0
1226530,True,8,Very Positive,64,4,68
1226540,True,5,Mixed,11,8,19
1226550,True,0,No user reviews,0,0,0
1226560,True,0,No user reviews,0,0,0
1226570,True,0,No user reviews,0,0,0
1226580,True,0,No user reviews,0,0,0
1226610,True,0,No user reviews,0,0,0
1226620,True,0,No user reviews,0,0,0
1226640,True,6,Mostly Positive,36,10,46
1226650,True,0,No user reviews,0,0,0
1226670,True,0,No user reviews,0,0,0
1226680,True,0,No user reviews,0,0,0
1226690,True,5,Mixed,8,5,13
1226710,True,0,No user reviews,0,0,0
1226720,True,0,No user reviews,0,0,0
1226730,True,0,No user reviews,0,0,0
1226740,True,0,No user reviews,0,0,0
1226750,True,0,No user reviews,0,0,0
1226760,True,0,No user reviews,0,0,0
1226770,True,0,No user reviews,0,0,0
1226780,True,0,No user reviews,0,0,0
1226800,True,0,No user reviews,0,0,0
1226820,True,0,No user reviews,0,0,0
1226840,True,0,No user reviews,0,0,0
1226850,True,0,1 user reviews,1,0,1
1226870,True,0,No user reviews,0,0,0
1226880,True,0,No user reviews,0,0,0
1226890,True,0,4 user reviews,3,1,4
1226900,True,0,No user reviews,0,0,0
1226910,True,0,5 user reviews,1,4,5
1226920,True,0,1 user reviews,1,0,1
1226930,True,0,No user reviews,0,0,0
1226940,True,0,1 user reviews,0,1,1
1226960,True,3,Negative,2,11,13
1226970,True,0,No user reviews,0,0,0
1226980,True,0,No user reviews,0,0,0
1226990,True,8,Very Positive,191,19,210
1227000,True,0,3 user reviews,0,3,3
1227010,True,0,3 user reviews,3,0,3
1227030,True,0,2 user reviews,2,0,2
1227040,True,0,No user reviews,0,0,0
1227050,True,0,No user reviews,0,0,0
1227090,True,0,1 user reviews,0,1,1
1227100,True,0,No user reviews,0,0,0
1227130,True,0,No user reviews,0,0,0
1227140,True,0,No user reviews,0,0,0
1227150,True,0,No user reviews,0,0,0
1227160,True,5,Mixed,19,13,32
1227170,True,0,No user reviews,0,0,0
1227180,True,0,No user reviews,0,0,0
1227190,True,0,1 user reviews,1,0,1
1227200,True,0,No user reviews,0,0,0
1227250,True,0,No user reviews,0,0,0
1227260,True,0,No user reviews,0,0,0
1227280,True,0,No user reviews,0,0,0
1227320,True,0,No user reviews,0,0,0
1227330,True,0,No user reviews,0,0,0
1227340,True,0,No user reviews,0,0,0
1227350,True,6,Mostly Positive,62,18,80
1227360,True,5,Mixed,12,6,18
1227390,True,0,1 user reviews,1,0,1
1227400,True,8,Very Positive,49,2,51
1227410,True,0,No user reviews,0,0,0
1227420,True,0,No user reviews,0,0,0
1227440,True,0,No user reviews,0,0,0
1227441,True,0,No user reviews,0,0,0
1227443,True,0,No user reviews,0,0,0
1227448,True,0,No user reviews,0,0,0
1227449,True,0,No user reviews,0,0,0
1227461,True,0,No user reviews,0,0,0
1227490,True,0,2 user reviews,1,1,2
1227500,True,0,No user reviews,0,0,0
1227510,True,0,1 user reviews,1,0,1
1227520,True,0,No user reviews,0,0,0
1227530,True,6,Mostly Positive,199,53,252
1227540,True,0,No user reviews,0,0,0
1227560,True,0,No user reviews,0,0,0
1227570,True,0,No user reviews,0,0,0
1227580,True,0,1 user reviews,0,1,1
1227590,True,0,8 user reviews,7,1,8
1227600,True,7,Positive,9,1,10
1227610,True,0,No user reviews,0,0,0
1227640,True,0,No user reviews,0,0,0
1227670,True,0,No user reviews,0,0,0
1227690,True,0,No user reviews,0,0,0
1227710,True,0,No user reviews,0,0,0
1227730,True,0,6 user reviews,5,1,6
1227740,True,0,4 user reviews,4,0,4
1227750,True,7,Positive,12,2,14
1227760,True,0,5 user reviews,2,3,5
1227770,True,0,No user reviews,0,0,0
1227780,True,6,Mostly Positive,337,105,442
1227820,True,0,No user reviews,0,0,0
1227830,True,0,No user reviews,0,0,0
1227860,True,0,9 user reviews,9,0,9
1227890,True,8,Very Positive,79,7,86
1227900,True,0,1 user reviews,1,0,1
1227910,True,0,8 user reviews,7,1,8
1228340,True,0,3 user reviews,3,0,3
1228360,True,0,No user reviews,0,0,0
1228390,True,0,No user reviews,0,0,0
1228400,True,0,No user reviews,0,0,0
1228410,True,0,2 user reviews,2,0,2
1228430,True,0,No user reviews,0,0,0
1228440,True,0,1 user reviews,1,0,1
1228450,True,0,No user reviews,0,0,0
1228470,True,0,No user reviews,0,0,0
1228480,True,0,No user reviews,0,0,0
1228490,True,0,1 user reviews,1,0,1
1228500,True,0,No user reviews,0,0,0
1228510,True,0,4 user reviews,2,2,4
1228520,True,8,Very Positive,303,56,359
1228530,True,8,Very Positive,76,10,86
1228560,True,7,Positive,33,6,39
1228570,True,4,Mostly Negative,6,14,20
1228580,True,0,No user reviews,0,0,0
1228600,True,7,Positive,20,1,21
1228610,True,0,No user reviews,0,0,0
1228630,True,0,No user reviews,0,0,0
1228650,True,0,No user reviews,0,0,0
1228660,True,0,5 user reviews,4,1,5
1228670,True,0,No user reviews,0,0,0
1228680,True,0,8 user reviews,7,1,8
1228700,True,0,No user reviews,0,0,0
1228720,True,0,2 user reviews,1,1,2
1228730,True,0,1 user reviews,1,0,1
1228740,True,0,6 user reviews,6,0,6
1228760,True,0,2 user reviews,2,0,2
1228790,True,0,6 user reviews,4,2,6
1228810,True,0,7 user reviews,6,1,7
1228820,True,0,No user reviews,0,0,0
1228840,True,0,1 user reviews,0,1,1
1228860,True,0,1 user reviews,1,0,1
1228870,True,0,6 user reviews,6,0,6
1228880,True,0,No user reviews,0,0,0
1228910,True,0,2 user reviews,1,1,2
1228920,True,0,2 user reviews,0,2,2
1228950,True,0,No user reviews,0,0,0
1228960,True,0,4 user reviews,4,0,4
1228970,True,0,1 user reviews,1,0,1
1228980,True,0,No user reviews,0,0,0
1229000,True,0,No user reviews,0,0,0
1229010,True,0,3 user reviews,1,2,3
1229030,True,7,Positive,19,4,23
1229040,True,0,2 user reviews,1,1,2
1229060,True,0,No user reviews,0,0,0
1229090,True,0,No user reviews,0,0,0
1229100,True,0,1 user reviews,1,0,1
1229170,True,0,1 user reviews,1,0,1
1229190,True,0,1 user reviews,1,0,1
1229200,True,0,No user reviews,0,0,0
1229240,True,0,No user reviews,0,0,0
1229250,True,0,3 user reviews,1,2,3
1229260,True,0,4 user reviews,4,0,4
1229270,True,0,No user reviews,0,0,0
1229280,True,0,5 user reviews,5,0,5
1229310,True,6,Mostly Positive,14,5,19
1229320,True,0,4 user reviews,3,1,4
1229330,True,0,No user reviews,0,0,0
1229350,True,0,No user reviews,0,0,0
1229370,True,0,2 user reviews,1,1,2
1229380,True,0,No user reviews,0,0,0
1229400,True,0,No user reviews,0,0,0
1229420,True,5,Mixed,14,18,32
1229450,True,0,No user reviews,0,0,0
1229460,True,0,No user reviews,0,0,0
1229490,True,9,Overwhelmingly Positive,2384,9,2393
1229500,True,0,6 user reviews,2,4,6
1229510,True,0,2 user reviews,1,1,2
1229520,True,0,No user reviews,0,0,0
1229530,True,0,No user reviews,0,0,0
1229570,True,0,No user reviews,0,0,0
1229580,True,8,Very Positive,86,2,88
1229590,True,0,1 user reviews,1,0,1
1229630,True,0,No user reviews,0,0,0
1229640,True,0,1 user reviews,0,1,1
1229650,True,0,3 user reviews,3,0,3
1229670,True,0,No user reviews,0,0,0
1229690,True,0,No user reviews,0,0,0
1229700,True,0,No user reviews,0,0,0
1229720,True,0,1 user reviews,0,1,1
1229730,True,5,Mixed,5,6,11
1229770,True,0,No user reviews,0,0,0
1229820,True,0,No user reviews,0,0,0
1229830,True,0,No user reviews,0,0,0
1229840,True,0,No user reviews,0,0,0
1229850,True,0,No user reviews,0,0,0
1229860,True,0,No user reviews,0,0,0
1229870,True,0,No user reviews,0,0,0
1229900,True,8,Very Positive,123,14,137
1229920,True,0,No user reviews,0,0,0
1229950,True,0,No user reviews,0,0,0
1229951,True,0,No user reviews,0,0,0
1229952,True,0,No user reviews,0,0,0
1229970,True,0,1 user reviews,1,0,1
1230000,True,0,No user reviews,0,0,0
1230010,True,0,No user reviews,0,0,0
1230020,True,0,No user reviews,0,0,0
1230040,True,0,No user reviews,0,0,0
1230100,True,0,5 user reviews,2,3,5
1230120,True,0,No user reviews,0,0,0
1230140,True,8,Very Positive,132,3,135
1230160,True,0,No user reviews,0,0,0
1230170,True,0,No user reviews,0,0,0
1230180,True,0,No user reviews,0,0,0
1230200,True,0,9 user reviews,8,1,9
1230210,True,0,No user reviews,0,0,0
1230230,True,7,Positive,22,0,22
1230260,True,0,No user reviews,0,0,0
1230270,True,0,7 user reviews,2,5,7
1230271,True,7,Positive,15,1,16
1230272,True,0,2 user reviews,2,0,2
1230273,True,0,3 user reviews,3,0,3
1230274,True,0,3 user reviews,3,0,3
1230275,True,4,Mostly Negative,5,10,15
1230276,True,0,2 user reviews,2,0,2
1230277,True,3,Negative,3,14,17
1230278,True,0,2 user reviews,1,1,2
1230279,True,7,Positive,37,1,38
1230280,True,0,No user reviews,0,0,0
1230290,True,0,No user reviews,0,0,0
1230300,True,0,2 user reviews,2,0,2
1230340,True,7,Positive,9,2,11
1230360,True,0,No user reviews,0,0,0
1230380,True,0,No user reviews,0,0,0
1230410,True,0,No user reviews,0,0,0
1230430,True,0,1 user reviews,1,0,1
1230440,True,0,No user reviews,0,0,0
1230441,True,0,No user reviews,0,0,0
1230442,True,0,No user reviews,0,0,0
1230470,True,0,No user reviews,0,0,0
1230480,True,0,1 user reviews,1,0,1
1230481,True,0,5 user reviews,3,2,5
1230482,True,0,No user reviews,0,0,0
1230483,True,0,1 user reviews,0,1,1
1230490,True,0,No user reviews,0,0,0
1230500,True,0,No user reviews,0,0,0
1230510,True,6,Mostly Positive,27,7,34
1230540,True,0,No user reviews,0,0,0
1230560,True,7,Positive,22,5,27
1230570,True,0,2 user reviews,1,1,2
1230580,True,0,1 user reviews,1,0,1
1230600,True,0,No user reviews,0,0,0
1230630,True,0,No user reviews,0,0,0
1230640,True,0,No user reviews,0,0,0
1230650,True,0,5 user reviews,5,0,5
1230660,True,0,2 user reviews,2,0,2
1230690,True,0,No user reviews,0,0,0
1230700,True,0,No user reviews,0,0,0
1230710,True,0,No user reviews,0,0,0
1230730,True,0,No user reviews,0,0,0
1230740,True,0,No user reviews,0,0,0
1230750,True,0,No user reviews,0,0,0
1230760,True,7,Positive,26,4,30
1230770,True,0,No user reviews,0,0,0
1230790,True,0,1 user reviews,0,1,1
1230800,True,8,Very Positive,51,4,55
1230830,True,0,3 user reviews,3,0,3
1230840,True,0,No user reviews,0,0,0
1230860,True,7,Positive,32,3,35
1230870,True,0,1 user reviews,0,1,1
1230880,True,0,No user reviews,0,0,0
1230910,True,0,No user reviews,0,0,0
1230930,True,0,No user reviews,0,0,0
1230940,True,0,No user reviews,0,0,0
1230950,True,0,No user reviews,0,0,0
1230960,True,0,No user reviews,0,0,0
1230970,True,0,No user reviews,0,0,0
1230980,True,0,No user reviews,0,0,0
1230990,True,0,7 user reviews,7,0,7
1231000,True,0,No user reviews,0,0,0
1231010,True,0,No user reviews,0,0,0
1231020,True,0,No user reviews,0,0,0
1231040,True,0,1 user reviews,0,1,1
1231060,True,0,No user reviews,0,0,0
1231080,True,0,No user reviews,0,0,0
1231090,True,0,2 user reviews,0,2,2
1231100,True,0,No user reviews,0,0,0
1231120,True,0,1 user reviews,1,0,1
1231130,True,0,1 user reviews,1,0,1
1231150,True,0,No user reviews,0,0,0
1231160,True,0,No user reviews,0,0,0
1231180,True,0,1 user reviews,0,1,1
1231190,True,0,1 user reviews,0,1,1
1231200,True,0,No user reviews,0,0,0
1231210,True,0,No user reviews,0,0,0
1231250,True,0,3 user reviews,3,0,3
1231270,True,0,1 user reviews,1,0,1
1231290,True,0,5 user reviews,5,0,5
1231320,True,0,No user reviews,0,0,0
1231340,True,0,No user reviews,0,0,0
1231440,True,0,No user reviews,0,0,0
1231450,True,0,No user reviews,0,0,0
1231460,True,0,No user reviews,0,0,0
1231500,True,0,No user reviews,0,0,0
1231510,True,0,No user reviews,0,0,0
1231520,True,6,Mostly Positive,14,4,18
1231530,True,0,No user reviews,0,0,0
1231560,True,0,No user reviews,0,0,0
1231570,True,0,No user reviews,0,0,0
1231580,True,0,8 user reviews,4,4,8
1231590,True,0,No user reviews,0,0,0
1231610,True,0,No user reviews,0,0,0
1231640,True,0,3 user reviews,3,0,3
1231660,True,0,2 user reviews,2,0,2
1231670,True,0,1 user reviews,1,0,1
1231690,True,0,2 user reviews,2,0,2
1231700,True,0,No user reviews,0,0,0
1231710,True,0,No user reviews,0,0,0
1231720,True,0,No user reviews,0,0,0
1231740,True,0,7 user reviews,6,1,7
1231750,True,0,4 user reviews,2,2,4
1231760,True,0,2 user reviews,0,2,2
1231770,True,0,No user reviews,0,0,0
1231780,True,0,No user reviews,0,0,0
1231790,True,0,No user reviews,0,0,0
1231800,True,0,1 user reviews,0,1,1
1231810,True,0,No user reviews,0,0,0
1231820,True,0,2 user reviews,0,2,2
1231830,True,0,No user reviews,0,0,0
1231840,True,0,No user reviews,0,0,0
1231850,True,0,No user reviews,0,0,0
1231860,True,0,No user reviews,0,0,0
1231870,True,0,No user reviews,0,0,0
1231880,True,0,No user reviews,0,0,0
1231900,True,0,No user reviews,0,0,0
1231910,True,0,No user reviews,0,0,0
1231920,True,0,No user reviews,0,0,0
1231930,True,0,No user reviews,0,0,0
1231940,True,0,4 user reviews,4,0,4
1231950,True,7,Positive,12,1,13
1231960,True,0,No user reviews,0,0,0
1231970,True,7,Positive,14,3,17
1231980,True,0,1 user reviews,1,0,1
1231990,True,0,No user reviews,0,0,0
1232010,True,7,Positive,16,0,16
1232030,True,0,2 user reviews,2,0,2
1232050,True,0,No user reviews,0,0,0
1232070,True,8,Very Positive,52,10,62
1232080,True,0,No user reviews,0,0,0
1232100,True,7,Positive,14,0,14
1232120,True,0,1 user reviews,0,1,1
1232130,True,7,Positive,43,4,47
1232140,True,6,Mostly Positive,10,3,13
1232150,True,0,No user reviews,0,0,0
1232170,True,0,No user reviews,0,0,0
1232180,True,8,Very Positive,419,7,426
1232190,True,0,No user reviews,0,0,0
1232200,True,0,No user reviews,0,0,0
1232210,True,0,No user reviews,0,0,0
1232230,True,0,1 user reviews,1,0,1
1232251,True,4,Mostly Negative,9,26,35
1232252,True,0,3 user reviews,0,3,3
1232253,True,5,Mixed,28,23,51
1232254,True,5,Mixed,18,24,42
1232255,True,2,Very Negative,11,67,78
1232256,True,8,Very Positive,181,16,197
1232257,True,6,Mostly Positive,234,87,321
1232260,True,0,3 user reviews,3,0,3
1232290,True,0,1 user reviews,1,0,1
1232310,True,0,4 user reviews,3,1,4
1232320,True,0,No user reviews,0,0,0
1232330,True,8,Very Positive,52,2,54
1232340,True,0,No user reviews,0,0,0
1232350,True,0,No user reviews,0,0,0
1232370,True,0,No user reviews,0,0,0
1232380,True,0,3 user reviews,1,2,3
1232390,True,0,2 user reviews,2,0,2
1232420,True,0,No user reviews,0,0,0
1232430,True,0,3 user reviews,3,0,3
1232450,True,0,No user reviews,0,0,0
1232460,True,6,Mostly Positive,37,14,51
1232470,True,0,No user reviews,0,0,0
1232500,True,0,2 user reviews,1,1,2
1232510,True,0,No user reviews,0,0,0
1232520,True,0,7 user reviews,7,0,7
1232530,True,0,No user reviews,0,0,0
1232540,True,0,1 user reviews,0,1,1
1232550,True,0,No user reviews,0,0,0
1232570,True,8,Very Positive,106,4,110
1232580,True,8,Very Positive,47,10,57
1232590,True,7,Positive,20,3,23
1232610,True,0,No user reviews,0,0,0
1232640,True,0,9 user reviews,8,1,9
1232650,True,0,No user reviews,0,0,0
1232670,True,0,1 user reviews,1,0,1
1232690,True,0,No user reviews,0,0,0
1232710,True,0,No user reviews,0,0,0
1232720,True,0,No user reviews,0,0,0
1232730,True,0,1 user reviews,0,1,1
1232740,True,0,6 user reviews,6,0,6
1232750,True,0,No user reviews,0,0,0
1232770,True,0,No user reviews,0,0,0
1232780,True,0,1 user reviews,1,0,1
1232800,True,0,No user reviews,0,0,0
1232810,True,0,8 user reviews,8,0,8
1232830,True,0,1 user reviews,1,0,1
1232870,True,0,No user reviews,0,0,0
1232880,True,0,No user reviews,0,0,0
1232890,True,0,No user reviews,0,0,0
1232900,True,0,No user reviews,0,0,0
1232910,True,0,2 user reviews,2,0,2
1232920,True,0,No user reviews,0,0,0
1232940,True,7,Positive,36,3,39
1232980,True,0,No user reviews,0,0,0
1232990,True,0,No user reviews,0,0,0
1233020,True,0,No user reviews,0,0,0
1233030,True,0,1 user reviews,1,0,1
1233040,True,0,No user reviews,0,0,0
1233050,True,0,No user reviews,0,0,0
1233060,True,5,Mixed,90,104,194
1233061,True,4,Mostly Negative,95,182,277
1233062,True,5,Mixed,45,29,74
1233070,True,0,No user reviews,0,0,0
1233080,True,0,No user reviews,0,0,0
1233090,True,0,No user reviews,0,0,0
1233100,True,0,7 user reviews,7,0,7
1233120,True,0,1 user reviews,0,1,1
1233170,True,5,Mixed,12,6,18
1233200,True,0,No user reviews,0,0,0
1233210,True,0,No user reviews,0,0,0
1233220,True,0,9 user reviews,9,0,9
1233230,True,0,5 user reviews,5,0,5
1233240,True,0,1 user reviews,1,0,1
1233250,True,0,5 user reviews,5,0,5
1233260,True,5,Mixed,302,142,444
1233270,True,8,Very Positive,82,7,89
1233280,True,0,1 user reviews,1,0,1
1233290,True,0,No user reviews,0,0,0
1233300,True,0,No user reviews,0,0,0
1233310,True,0,No user reviews,0,0,0
1233320,True,0,No user reviews,0,0,0
1233330,True,0,2 user reviews,2,0,2
1233340,True,0,1 user reviews,1,0,1
1233350,True,5,Mixed,8,4,12
1233360,True,0,No user reviews,0,0,0
1233370,True,0,7 user reviews,3,4,7
1233371,True,5,Mixed,7,5,12
1233380,True,0,8 user reviews,4,4,8
1233390,True,0,No user reviews,0,0,0
1233410,True,0,No user reviews,0,0,0
1233420,True,6,Mostly Positive,7,3,10
1233460,True,0,1 user reviews,1,0,1
1233490,True,0,No user reviews,0,0,0
1233500,True,0,No user reviews,0,0,0
1233510,True,0,No user reviews,0,0,0
1233520,True,0,No user reviews,0,0,0
1233540,True,7,Positive,33,0,33
1233550,True,6,Mostly Positive,262,85,347
1233560,True,0,No user reviews,0,0,0
1233570,True,8,Very Positive,761,164,925
1233580,True,0,3 user reviews,3,0,3
1233590,True,0,No user reviews,0,0,0
1233600,True,0,1 user reviews,0,1,1
1233610,True,0,No user reviews,0,0,0
1233640,True,0,No user reviews,0,0,0
1233650,True,0,No user reviews,0,0,0
1233690,True,7,Positive,43,2,45
1233710,True,5,Mixed,25,20,45
1233720,True,7,Positive,17,2,19
1233730,True,0,No user reviews,0,0,0
1233780,True,6,Mostly Positive,53,17,70
1233790,True,0,No user reviews,0,0,0
1233800,True,8,Very Positive,45,8,53
1233810,True,0,No user reviews,0,0,0
1233820,True,7,Positive,22,3,25
1233840,True,0,5 user reviews,3,2,5
1233850,True,0,7 user reviews,3,4,7
1233860,True,0,No user reviews,0,0,0
1233880,True,8,Very Positive,101,3,104
1233900,True,5,Mixed,13,12,25
1233950,True,8,Very Positive,96,2,98
1233960,True,0,No user reviews,0,0,0
1233990,True,0,1 user reviews,0,1,1
1234030,True,0,1 user reviews,1,0,1
1234070,True,0,No user reviews,0,0,0
1234120,True,0,2 user reviews,1,1,2
1234150,True,0,No user reviews,0,0,0
1234160,True,0,No user reviews,0,0,0
1234170,True,0,No user reviews,0,0,0
1234180,True,0,No user reviews,0,0,0
1234190,True,8,Very Positive,51,9,60
1234200,True,0,No user reviews,0,0,0
1234210,True,0,No user reviews,0,0,0
1234220,True,7,Positive,19,2,21
1234230,True,0,No user reviews,0,0,0
1234240,True,7,Positive,20,2,22
1234260,True,7,Positive,18,2,20
1234270,True,0,1 user reviews,1,0,1
1234280,True,0,No user reviews,0,0,0
1234290,True,0,No user reviews,0,0,0
1234320,True,0,No user reviews,0,0,0
1234340,True,0,No user reviews,0,0,0
1234360,True,0,No user reviews,0,0,0
1234380,True,0,3 user reviews,0,3,3
1234390,True,0,No user reviews,0,0,0
1234391,True,0,No user reviews,0,0,0
1234392,True,0,1 user reviews,0,1,1
1234393,True,0,No user reviews,0,0,0
1234400,True,0,No user reviews,0,0,0
1234410,True,0,No user reviews,0,0,0
1234450,True,5,Mixed,10,15,25
1234460,True,0,No user reviews,0,0,0
1234470,True,0,No user reviews,0,0,0
1234490,True,0,1 user reviews,1,0,1
1234510,True,0,No user reviews,0,0,0
1234520,True,8,Very Positive,285,12,297
1234540,True,0,2 user reviews,2,0,2
1234550,True,6,Mostly Positive,10,4,14
1234560,True,0,No user reviews,0,0,0
1234570,True,0,No user reviews,0,0,0
1234580,True,0,2 user reviews,2,0,2
1234590,True,0,No user reviews,0,0,0
1234600,True,0,No user reviews,0,0,0
1234610,True,0,No user reviews,0,0,0
1234620,True,8,Very Positive,64,7,71
1234630,True,0,No user reviews,0,0,0
1234680,True,0,No user reviews,0,0,0
1234690,True,0,No user reviews,0,0,0
1234700,True,0,5 user reviews,5,0,5
1234710,True,0,No user reviews,0,0,0
1234730,True,0,No user reviews,0,0,0
1234740,True,0,No user reviews,0,0,0
1234750,True,0,5 user reviews,4,1,5
1234760,True,0,4 user reviews,2,2,4
1234780,True,0,No user reviews,0,0,0
1234810,True,0,No user reviews,0,0,0
1234820,True,0,1 user reviews,0,1,1
1234830,True,0,9 user reviews,7,2,9
1234840,True,5,Mixed,7,4,11
1234850,True,0,3 user reviews,3,0,3
1234870,True,0,No user reviews,0,0,0
1234890,True,0,1 user reviews,1,0,1
1234900,True,0,2 user reviews,1,1,2
1234920,True,0,No user reviews,0,0,0
1234930,True,0,1 user reviews,1,0,1
1234940,True,7,Positive,12,0,12
1234950,True,6,Mostly Positive,10,4,14
1234960,True,0,No user reviews,0,0,0
1234970,True,0,No user reviews,0,0,0
1234980,True,0,2 user reviews,1,1,2
1235060,True,0,1 user reviews,1,0,1
1235070,True,0,No user reviews,0,0,0
1235080,True,0,1 user reviews,1,0,1
1235090,True,0,4 user reviews,3,1,4
1235100,True,0,No user reviews,0,0,0
1235110,True,7,Positive,40,4,44
1235120,True,7,Positive,28,4,32
1235130,True,0,3 user reviews,3,0,3
1235140,True,0,No user reviews,0,0,0
1235160,True,0,1 user reviews,1,0,1
1235220,True,0,No user reviews,0,0,0
1235260,True,0,No user reviews,0,0,0
1235320,True,0,No user reviews,0,0,0
1235330,True,0,1 user reviews,1,0,1
1235340,True,0,No user reviews,0,0,0
1235350,True,0,3 user reviews,3,0,3
1235360,True,8,Very Positive,60,3,63
1235370,True,0,No user reviews,0,0,0
1235380,True,0,No user reviews,0,0,0
1235400,True,0,2 user reviews,2,0,2
1235410,True,0,No user reviews,0,0,0
1235430,True,0,No user reviews,0,0,0
1235440,True,0,No user reviews,0,0,0
1235450,True,0,No user reviews,0,0,0
1235460,True,0,8 user reviews,5,3,8
1235480,True,0,2 user reviews,0,2,2
1235510,True,0,No user reviews,0,0,0
1235520,True,0,2 user reviews,1,1,2
1235530,True,0,No user reviews,0,0,0
1235570,True,0,2 user reviews,2,0,2
1235580,True,0,No user reviews,0,0,0
1235600,True,0,No user reviews,0,0,0
1235650,True,0,No user reviews,0,0,0
1235660,True,0,No user reviews,0,0,0
1235670,True,0,No user reviews,0,0,0
1235710,True,0,No user reviews,0,0,0
1235720,True,0,3 user reviews,3,0,3
1235721,True,5,Mixed,6,4,10
1235722,True,0,3 user reviews,1,2,3
1235730,True,0,1 user reviews,1,0,1
1235731,True,0,1 user reviews,1,0,1
1235732,True,0,4 user reviews,3,1,4
1235733,True,0,4 user reviews,3,1,4
1235734,True,0,3 user reviews,3,0,3
1235740,True,0,No user reviews,0,0,0
1235741,True,0,No user reviews,0,0,0
1235742,True,0,No user reviews,0,0,0
1235743,True,0,2 user reviews,1,1,2
1235744,True,0,No user reviews,0,0,0
1235745,True,0,No user reviews,0,0,0
1235746,True,0,2 user reviews,2,0,2
1235747,True,0,1 user reviews,0,1,1
1235750,True,0,No user reviews,0,0,0
1235751,True,0,1 user reviews,1,0,1
1235752,True,0,No user reviews,0,0,0
1235753,True,0,No user reviews,0,0,0
1235754,True,0,No user reviews,0,0,0
1235755,True,0,1 user reviews,0,1,1
1235756,True,0,No user reviews,0,0,0
1235757,True,0,1 user reviews,1,0,1
1235758,True,0,1 user reviews,1,0,1
1235759,True,0,1 user reviews,1,0,1
1235760,True,0,No user reviews,0,0,0
1235761,True,0,No user reviews,0,0,0
1235762,True,0,No user reviews,0,0,0
1235763,True,0,No user reviews,0,0,0
1235764,True,0,No user reviews,0,0,0
1235765,True,0,No user reviews,0,0,0
1235766,True,0,1 user reviews,1,0,1
1235767,True,0,No user reviews,0,0,0
1235770,True,0,1 user reviews,1,0,1
1235780,True,0,No user reviews,0,0,0
1235790,True,0,No user reviews,0,0,0
1235810,True,0,No user reviews,0,0,0
1235830,True,0,No user reviews,0,0,0
1235850,True,0,No user reviews,0,0,0
1235910,True,6,Mostly Positive,7,3,10
1235940,True,0,No user reviews,0,0,0
1235950,True,0,No user reviews,0,0,0
1235960,True,0,No user reviews,0,0,0
1235980,True,0,No user reviews,0,0,0
1235990,True,0,No user reviews,0,0,0
1236000,True,0,3 user reviews,2,1,3
1236010,True,0,No user reviews,0,0,0
1236020,True,0,No user reviews,0,0,0
1236040,True,7,Positive,10,2,12
1236050,True,0,No user reviews,0,0,0
1236070,True,0,No user reviews,0,0,0
1236100,True,0,No user reviews,0,0,0
1236140,True,0,2 user reviews,1,1,2
1236160,True,7,Positive,11,0,11
1236170,True,0,No user reviews,0,0,0
1236180,True,0,No user reviews,0,0,0
1236190,True,7,Positive,9,2,11
1236210,True,0,No user reviews,0,0,0
1236230,True,0,No user reviews,0,0,0
1236240,True,0,No user reviews,0,0,0
1236250,True,0,No user reviews,0,0,0
1236260,True,0,1 user reviews,1,0,1
1236270,True,0,No user reviews,0,0,0
1236320,True,0,4 user reviews,1,3,4
1236330,True,0,1 user reviews,0,1,1
1236350,True,0,No user reviews,0,0,0
1236360,True,5,Mixed,14,9,23
1236400,True,0,5 user reviews,2,3,5
1236450,True,0,1 user reviews,1,0,1
1236460,True,0,No user reviews,0,0,0
1236480,True,0,3 user reviews,1,2,3
1236490,True,0,No user reviews,0,0,0
1236500,True,5,Mixed,17,9,26
1236501,True,0,8 user reviews,6,2,8
1236520,True,0,No user reviews,0,0,0
1236530,True,0,6 user reviews,4,2,6
1236550,True,0,No user reviews,0,0,0
1236560,True,0,No user reviews,0,0,0
1236580,True,0,No user reviews,0,0,0
1236610,True,0,No user reviews,0,0,0
1236620,True,0,No user reviews,0,0,0
1236630,True,0,No user reviews,0,0,0
1236640,True,0,5 user reviews,5,0,5
1236650,True,0,No user reviews,0,0,0
1236660,True,0,No user reviews,0,0,0
1236670,True,0,3 user reviews,2,1,3
1236700,True,7,Positive,43,1,44
1236710,True,0,No user reviews,0,0,0
1236720,True,8,Very Positive,143,17,160
1236760,True,0,5 user reviews,3,2,5
1236790,True,0,1 user reviews,1,0,1
1236810,True,0,4 user reviews,4,0,4
1236820,True,0,No user reviews,0,0,0
1236860,True,0,5 user reviews,5,0,5
1236880,True,0,1 user reviews,1,0,1
1236890,True,7,Positive,16,0,16
1236900,True,0,9 user reviews,8,1,9
1236920,True,0,1 user reviews,0,1,1
1236930,True,0,No user reviews,0,0,0
1236940,True,0,No user reviews,0,0,0
1236960,True,0,1 user reviews,1,0,1
1236990,True,8,Very Positive,686,48,734
1237020,True,0,1 user reviews,1,0,1
1237030,True,0,No user reviews,0,0,0
1237040,True,0,No user reviews,0,0,0
1237050,True,0,No user reviews,0,0,0
1237060,True,0,No user reviews,0,0,0
1237080,True,5,Mixed,16,10,26
1237090,True,0,2 user reviews,2,0,2
1237100,True,0,1 user reviews,1,0,1
1237110,True,0,No user reviews,0,0,0
1237120,True,0,No user reviews,0,0,0
1237160,True,0,No user reviews,0,0,0
1237190,True,0,No user reviews,0,0,0
1237210,True,0,No user reviews,0,0,0
1237220,True,0,6 user reviews,3,3,6
1237230,True,0,No user reviews,0,0,0
1237240,True,0,No user reviews,0,0,0
1237250,True,0,No user reviews,0,0,0
1237260,True,0,3 user reviews,3,0,3
1237270,True,7,Positive,17,3,20
1237310,True,0,No user reviews,0,0,0
1237330,True,0,No user reviews,0,0,0
1237340,True,0,No user reviews,0,0,0
1237350,True,0,No user reviews,0,0,0
1237360,True,0,No user reviews,0,0,0
1237370,True,0,No user reviews,0,0,0
1237410,True,0,1 user reviews,0,1,1
1237420,True,0,2 user reviews,2,0,2
1237430,True,0,8 user reviews,8,0,8
1237450,True,0,No user reviews,0,0,0
1237460,True,0,No user reviews,0,0,0
1237470,True,0,No user reviews,0,0,0
1237480,True,0,1 user reviews,0,1,1
1237490,True,0,7 user reviews,6,1,7
1237510,True,0,No user reviews,0,0,0
1237523,True,0,9 user reviews,8,1,9
1237524,True,0,4 user reviews,4,0,4
1237530,True,7,Positive,10,1,11
1237540,True,5,Mixed,22,14,36
1237550,True,0,No user reviews,0,0,0
1237560,True,0,1 user reviews,1,0,1
1237570,True,0,5 user reviews,4,1,5
1237590,True,0,No user reviews,0,0,0
1237600,True,0,No user reviews,0,0,0
1237610,True,6,Mostly Positive,43,15,58
1237620,True,0,No user reviews,0,0,0
1237630,True,0,2 user reviews,1,1,2
1237650,True,0,No user reviews,0,0,0
1237660,True,0,No user reviews,0,0,0
1237670,True,0,1 user reviews,1,0,1
1237690,True,0,No user reviews,0,0,0
1237700,True,0,1 user reviews,1,0,1
1237720,True,0,5 user reviews,3,2,5
1237721,True,4,Mostly Negative,8,16,24
1237730,True,0,No user reviews,0,0,0
1237760,True,0,3 user reviews,2,1,3
1237770,True,0,2 user reviews,2,0,2
1237780,True,0,No user reviews,0,0,0
1237800,True,0,5 user reviews,3,2,5
1237820,True,0,2 user reviews,1,1,2
1237830,True,6,Mostly Positive,8,3,11
1237840,True,0,1 user reviews,0,1,1
1237850,True,0,No user reviews,0,0,0
1237860,True,0,1 user reviews,0,1,1
1237870,True,0,3 user reviews,3,0,3
1237880,True,0,5 user reviews,4,1,5
1237900,True,0,2 user reviews,2,0,2
1237910,True,0,No user reviews,0,0,0
1237930,True,0,No user reviews,0,0,0
1237940,True,0,No user reviews,0,0,0
1237950,True,8,Very Positive,2953,490,3443
1237970,True,9,Overwhelmingly Positive,13377,505,13882
1237980,True,6,Mostly Positive,154,66,220
1238000,True,6,Mostly Positive,664,180,844
1238011,True,0,No user reviews,0,0,0
1238012,True,0,No user reviews,0,0,0
1238013,True,0,No user reviews,0,0,0
1238014,True,0,No user reviews,0,0,0
1238020,True,5,Mixed,267,138,405
1238030,True,5,Mixed,7,6,13
1238040,True,6,Mostly Positive,215,61,276
1238050,True,5,Mixed,5,7,12
1238060,True,6,Mostly Positive,409,130,539
1238070,True,4,Mostly Negative,7,13,20
1238080,True,5,Mixed,492,323,815
1238090,True,0,5 user reviews,5,0,5
1238100,True,0,4 user reviews,4,0,4
1238101,True,3,Negative,0,27,27
1238102,True,0,1 user reviews,1,0,1
1238103,True,7,Positive,21,3,24
1238104,True,0,4 user reviews,3,1,4
1238105,True,0,4 user reviews,3,1,4
1238120,True,0,No user reviews,0,0,0
1238130,True,0,No user reviews,0,0,0
1238170,True,0,No user reviews,0,0,0
1238180,True,0,No user reviews,0,0,0
1238200,True,0,1 user reviews,1,0,1
1238210,True,0,No user reviews,0,0,0
1238220,True,0,1 user reviews,1,0,1
1238250,True,0,5 user reviews,5,0,5
1238270,True,0,No user reviews,0,0,0
1238280,True,0,No user reviews,0,0,0
1238290,True,0,No user reviews,0,0,0
1238310,True,0,No user reviews,0,0,0
1238320,True,6,Mostly Positive,9,3,12
1238330,True,7,Positive,14,1,15
1238340,True,0,1 user reviews,1,0,1
1238350,True,0,No user reviews,0,0,0
1238360,True,7,Positive,8,2,10
1238381,True,0,No user reviews,0,0,0
1238400,True,0,9 user reviews,7,2,9
1238410,True,0,No user reviews,0,0,0
1238430,True,0,3 user reviews,3,0,3
1238440,True,5,Mixed,97,64,161
1238450,True,0,No user reviews,0,0,0
1238460,True,0,No user reviews,0,0,0
1238470,True,0,No user reviews,0,0,0
1238480,True,0,No user reviews,0,0,0
1238490,True,0,No user reviews,0,0,0
1238520,True,0,5 user reviews,4,1,5
1238530,True,0,No user reviews,0,0,0
1238540,True,0,No user reviews,0,0,0
1238550,True,0,No user reviews,0,0,0
1238570,True,0,No user reviews,0,0,0
1238590,True,0,No user reviews,0,0,0
1238620,True,0,No user reviews,0,0,0
1238630,True,0,1 user reviews,0,1,1
1238640,True,0,No user reviews,0,0,0
1238650,True,0,No user reviews,0,0,0
1238660,True,0,2 user reviews,2,0,2
1238680,True,0,6 user reviews,6,0,6
1238710,True,0,1 user reviews,1,0,1
1238720,True,0,No user reviews,0,0,0
1238730,True,7,Positive,40,0,40
1238750,True,0,No user reviews,0,0,0
1238760,True,7,Positive,15,3,18
1238761,True,0,No user reviews,0,0,0
1238762,True,0,No user reviews,0,0,0
1238770,True,0,No user reviews,0,0,0
1238780,True,0,No user reviews,0,0,0
1238790,True,0,No user reviews,0,0,0
1238810,True,5,Mixed,925,505,1430
1238820,True,5,Mixed,441,412,853
1238830,True,0,No user reviews,0,0,0
1238831,True,0,1 user reviews,0,1,1
1238840,True,6,Mostly Positive,827,220,1047
1238850,True,0,No user reviews,0,0,0
1238851,True,0,2 user reviews,2,0,2
1238860,True,6,Mostly Positive,1820,456,2276
1238871,True,0,5 user reviews,3,2,5
1238880,True,5,Mixed,105,85,190
1238891,True,0,No user reviews,0,0,0
1238920,True,0,No user reviews,0,0,0
1238970,True,0,1 user reviews,1,0,1
1238980,True,0,No user reviews,0,0,0
1238990,True,0,No user reviews,0,0,0
1239000,True,7,Positive,9,2,11
1239010,True,0,4 user reviews,4,0,4
1239020,True,0,No user reviews,0,0,0
1239030,True,0,No user reviews,0,0,0
1239050,True,8,Very Positive,126,13,139
1239060,True,0,No user reviews,0,0,0
1239080,True,0,No user reviews,0,0,0
1239090,True,0,1 user reviews,0,1,1
1239100,True,0,No user reviews,0,0,0
1239110,True,0,1 user reviews,1,0,1
1239120,True,0,1 user reviews,1,0,1
1239130,True,0,5 user reviews,5,0,5
1239140,True,0,No user reviews,0,0,0
1239150,True,0,1 user reviews,1,0,1
1239170,True,0,No user reviews,0,0,0
1239180,True,0,No user reviews,0,0,0
1239190,True,0,No user reviews,0,0,0
1239210,True,0,No user reviews,0,0,0
1239250,True,0,3 user reviews,2,1,3
1239260,True,6,Mostly Positive,20,7,27
1239270,True,0,2 user reviews,1,1,2
1239290,True,0,No user reviews,0,0,0
1239300,True,0,No user reviews,0,0,0
1239310,True,0,No user reviews,0,0,0
1239320,True,0,No user reviews,0,0,0
1239340,True,0,No user reviews,0,0,0
1239360,True,0,No user reviews,0,0,0
1239390,True,0,No user reviews,0,0,0
1239400,True,0,1 user reviews,1,0,1
1239420,True,0,No user reviews,0,0,0
1239430,True,4,Mostly Negative,148,235,383
1239440,True,5,Mixed,51,26,77
1239450,True,7,Positive,38,0,38
1239470,True,0,3 user reviews,3,0,3
1239490,True,0,1 user reviews,1,0,1
1239510,True,0,6 user reviews,6,0,6
1239511,True,0,5 user reviews,5,0,5
1239512,True,0,3 user reviews,3,0,3
1239513,True,0,4 user reviews,4,0,4
1239514,True,7,Positive,13,0,13
1239520,True,5,Mixed,434,565,999
1239580,True,7,Positive,12,1,13
1239590,True,0,2 user reviews,0,2,2
1239600,True,0,No user reviews,0,0,0
1239640,True,0,No user reviews,0,0,0
1239650,True,0,No user reviews,0,0,0
1239660,True,5,Mixed,13,14,27
1239680,True,0,1 user reviews,1,0,1
1239690,True,9,Overwhelmingly Positive,1108,44,1152
1239700,True,8,Very Positive,445,21,466
1239710,True,0,No user reviews,0,0,0
1239720,True,0,No user reviews,0,0,0
1239740,True,0,No user reviews,0,0,0
1239770,True,0,No user reviews,0,0,0
1239780,True,0,No user reviews,0,0,0
1239820,True,0,No user reviews,0,0,0
1239830,True,0,No user reviews,0,0,0
1239870,True,0,No user reviews,0,0,0
1239890,True,0,4 user reviews,4,0,4
1239900,True,0,No user reviews,0,0,0
1239920,True,0,No user reviews,0,0,0
1239930,True,0,No user reviews,0,0,0
1239970,True,0,2 user reviews,1,1,2
1239980,True,0,No user reviews,0,0,0
1239990,True,0,2 user reviews,2,0,2
1240020,True,0,No user reviews,0,0,0
1240040,True,0,2 user reviews,2,0,2
1240050,True,7,Positive,35,8,43
1240090,True,0,3 user reviews,2,1,3
1240100,True,0,1 user reviews,1,0,1
1240120,True,0,No user reviews,0,0,0
1240130,True,0,No user reviews,0,0,0
1240140,True,0,No user reviews,0,0,0
1240151,True,0,No user reviews,0,0,0
1240180,True,0,No user reviews,0,0,0
1240200,True,0,1 user reviews,1,0,1
1240210,True,9,Overwhelmingly Positive,1486,36,1522
1240230,True,8,Very Positive,113,14,127
1240240,True,7,Positive,19,0,19
1240260,True,0,No user reviews,0,0,0
1240270,True,0,No user reviews,0,0,0
1240290,True,0,No user reviews,0,0,0
1240300,True,0,No user reviews,0,0,0
1240301,True,0,No user reviews,0,0,0
1240310,True,0,No user reviews,0,0,0
1240330,True,0,No user reviews,0,0,0
1240340,True,0,No user reviews,0,0,0
1240350,True,0,No user reviews,0,0,0
1240360,True,6,Mostly Positive,9,3,12
1240370,True,0,6 user reviews,6,0,6
1240380,True,0,No user reviews,0,0,0
1240390,True,0,9 user reviews,9,0,9
1240440,True,0,No user reviews,0,0,0
1240460,True,0,No user reviews,0,0,0
1240480,True,0,No user reviews,0,0,0
1240490,True,0,2 user reviews,0,2,2
1240510,True,0,No user reviews,0,0,0
1240530,True,0,No user reviews,0,0,0
1240540,True,0,No user reviews,0,0,0
1240550,True,0,No user reviews,0,0,0
1240580,True,0,No user reviews,0,0,0
1240590,True,0,No user reviews,0,0,0
1240600,True,0,1 user reviews,0,1,1
1240630,True,7,Positive,11,2,13
1240650,True,0,No user reviews,0,0,0
1240670,True,0,No user reviews,0,0,0
1240680,True,0,No user reviews,0,0,0
1240690,True,0,3 user reviews,3,0,3
1240730,True,0,8 user reviews,5,3,8
1240750,True,0,4 user reviews,4,0,4
1240760,True,0,1 user reviews,1,0,1
1240770,True,0,1 user reviews,1,0,1
1240790,True,0,No user reviews,0,0,0
1240810,True,0,No user reviews,0,0,0
1240830,True,0,1 user reviews,0,1,1
1240840,True,0,2 user reviews,2,0,2
1240870,True,0,No user reviews,0,0,0
1240890,True,0,3 user reviews,1,2,3
1240900,True,0,No user reviews,0,0,0
1240910,True,0,No user reviews,0,0,0
1240930,True,0,2 user reviews,2,0,2
1240940,True,0,No user reviews,0,0,0
1240950,True,0,No user reviews,0,0,0
1240960,True,0,No user reviews,0,0,0
1240970,True,0,No user reviews,0,0,0
1240980,True,0,No user reviews,0,0,0
1240990,True,0,No user reviews,0,0,0
1241000,True,0,No user reviews,0,0,0
1241010,True,0,No user reviews,0,0,0
1241020,True,5,Mixed,11,9,20
1241040,True,6,Mostly Positive,47,17,64
1241070,True,0,No user reviews,0,0,0
1241080,True,0,No user reviews,0,0,0
1241090,True,0,No user reviews,0,0,0
1241100,True,5,Mixed,15,7,22
1241110,True,0,3 user reviews,2,1,3
1241140,True,0,3 user reviews,2,1,3
1241160,True,0,No user reviews,0,0,0
1241170,True,0,No user reviews,0,0,0
1241180,True,0,No user reviews,0,0,0
1241190,True,0,No user reviews,0,0,0
1241210,True,0,No user reviews,0,0,0
1241230,True,0,No user reviews,0,0,0
1241240,True,0,No user reviews,0,0,0
1241250,True,0,No user reviews,0,0,0
1241260,True,0,1 user reviews,1,0,1
1241261,True,0,6 user reviews,4,2,6
1241262,True,0,5 user reviews,3,2,5
1241263,True,0,1 user reviews,1,0,1
1241264,True,0,2 user reviews,2,0,2
1241265,True,0,2 user reviews,2,0,2
1241266,True,0,2 user reviews,2,0,2
1241267,True,0,8 user reviews,8,0,8
1241268,True,0,4 user reviews,4,0,4
1241269,True,0,1 user reviews,1,0,1
1241270,True,0,No user reviews,0,0,0
1241271,True,7,Positive,30,1,31
1241272,True,0,1 user reviews,1,0,1
1241273,True,0,1 user reviews,1,0,1
1241274,True,0,1 user reviews,1,0,1
1241275,True,0,6 user reviews,6,0,6
1241276,True,0,3 user reviews,3,0,3
1241277,True,0,3 user reviews,3,0,3
1241278,True,0,2 user reviews,2,0,2
1241279,True,0,4 user reviews,4,0,4
1241280,True,0,1 user reviews,1,0,1
1241281,True,0,1 user reviews,1,0,1
1241282,True,0,1 user reviews,1,0,1
1241283,True,0,2 user reviews,2,0,2
1241284,True,0,3 user reviews,3,0,3
1241285,True,0,1 user reviews,1,0,1
1241286,True,0,2 user reviews,2,0,2
1241287,True,0,4 user reviews,4,0,4
1241288,True,0,2 user reviews,1,1,2
1241289,True,0,No user reviews,0,0,0
1241290,True,0,2 user reviews,2,0,2
1241291,True,0,1 user reviews,1,0,1
1241292,True,0,1 user reviews,1,0,1
1241293,True,0,1 user reviews,1,0,1
1241294,True,0,1 user reviews,1,0,1
1241295,True,0,2 user reviews,1,1,2
1241296,True,0,2 user reviews,2,0,2
1241297,True,0,1 user reviews,1,0,1
1241298,True,0,2 user reviews,2,0,2
1241299,True,0,1 user reviews,1,0,1
1241300,True,0,3 user reviews,3,0,3
1241340,True,0,3 user reviews,1,2,3
1241341,True,0,No user reviews,0,0,0
1241350,True,0,No user reviews,0,0,0
1241351,True,0,No user reviews,0,0,0
1241352,True,0,No user reviews,0,0,0
1241360,True,0,No user reviews,0,0,0
1241370,True,0,No user reviews,0,0,0
1241400,True,0,No user reviews,0,0,0
1241450,True,0,No user reviews,0,0,0
1241490,True,0,No user reviews,0,0,0
1241500,True,0,No user reviews,0,0,0
1241510,True,9,Overwhelmingly Positive,2448,113,2561
1241520,True,8,Very Positive,598,39,637
1241540,True,0,No user reviews,0,0,0
1241550,True,5,Mixed,90,54,144
1241570,True,0,8 user reviews,6,2,8
1241580,True,0,No user reviews,0,0,0
1241590,True,0,No user reviews,0,0,0
1241600,True,0,No user reviews,0,0,0
1241670,True,0,No user reviews,0,0,0
1241680,True,0,No user reviews,0,0,0
1241690,True,0,No user reviews,0,0,0
1241700,True,0,No user reviews,0,0,0
1241710,True,0,No user reviews,0,0,0
1241740,True,0,No user reviews,0,0,0
1241760,True,0,No user reviews,0,0,0
1241780,True,0,1 user reviews,1,0,1
1241810,True,0,No user reviews,0,0,0
1241820,True,0,No user reviews,0,0,0
1241830,True,0,No user reviews,0,0,0
1241850,True,0,No user reviews,0,0,0
1241860,True,0,1 user reviews,1,0,1
1241870,True,0,No user reviews,0,0,0
1241880,True,0,3 user reviews,3,0,3
1241910,True,6,Mostly Positive,31,12,43
1241920,True,0,No user reviews,0,0,0
1241950,True,0,No user reviews,0,0,0
1242620,True,0,No user reviews,0,0,0
1242630,True,0,No user reviews,0,0,0
1242650,True,0,No user reviews,0,0,0
1242670,True,0,5 user reviews,5,0,5
1242680,True,0,1 user reviews,0,1,1
1242690,True,0,No user reviews,0,0,0
1242700,True,0,No user reviews,0,0,0
1242710,True,0,1 user reviews,1,0,1
1242730,True,0,No user reviews,0,0,0
1242740,True,0,7 user reviews,7,0,7
1242741,True,0,No user reviews,0,0,0
1242742,True,0,No user reviews,0,0,0
1242743,True,0,No user reviews,0,0,0
1242744,True,0,No user reviews,0,0,0
1242745,True,0,No user reviews,0,0,0
1242746,True,0,No user reviews,0,0,0
1242747,True,0,No user reviews,0,0,0
1242748,True,0,2 user reviews,2,0,2
1242749,True,7,Positive,14,0,14
1242750,True,0,4 user reviews,4,0,4
1242751,True,0,5 user reviews,5,0,5
1242752,True,0,4 user reviews,4,0,4
1242753,True,7,Positive,45,0,45
1242754,True,7,Positive,35,0,35
1242755,True,0,4 user reviews,4,0,4
1242756,True,7,Positive,24,0,24
1242757,True,0,4 user reviews,4,0,4
1242758,True,0,3 user reviews,3,0,3
1242759,True,0,8 user reviews,8,0,8
1242760,True,0,8 user reviews,7,1,8
1242761,True,0,7 user reviews,7,0,7
1242762,True,0,1 user reviews,1,0,1
1242763,True,0,2 user reviews,2,0,2
1242764,True,0,1 user reviews,1,0,1
1242765,True,0,1 user reviews,1,0,1
1242766,True,0,1 user reviews,1,0,1
1242767,True,0,1 user reviews,1,0,1
1242768,True,0,2 user reviews,2,0,2
1242769,True,0,1 user reviews,1,0,1
1242770,True,0,3 user reviews,3,0,3
1242771,True,0,1 user reviews,1,0,1
1242777,True,0,3 user reviews,3,0,3
1242778,True,7,Positive,9,2,11
1242779,True,0,4 user reviews,4,0,4
1242790,True,0,No user reviews,0,0,0
1242800,True,0,No user reviews,0,0,0
1242810,True,0,No user reviews,0,0,0
1242820,True,0,4 user reviews,3,1,4
1242830,True,0,No user reviews,0,0,0
1242840,True,0,No user reviews,0,0,0
1242850,True,0,1 user reviews,1,0,1
1242910,True,5,Mixed,5,6,11
1242920,True,0,No user reviews,0,0,0
1242960,True,0,5 user reviews,5,0,5
1242970,True,0,1 user reviews,1,0,1
1242980,True,0,No user reviews,0,0,0
1242990,True,0,No user reviews,0,0,0
1243000,True,0,No user reviews,0,0,0
1243010,True,0,No user reviews,0,0,0
1243030,True,0,No user reviews,0,0,0
1243040,True,0,No user reviews,0,0,0
1243050,True,0,No user reviews,0,0,0
1243060,True,0,No user reviews,0,0,0
1243070,True,0,No user reviews,0,0,0
1243100,True,0,4 user reviews,1,3,4
1243130,True,0,No user reviews,0,0,0
1243140,True,0,No user reviews,0,0,0
1243150,True,0,2 user reviews,2,0,2
1243190,True,0,No user reviews,0,0,0
1243200,True,0,No user reviews,0,0,0
1243220,True,8,Very Positive,67,12,79
1243240,True,0,2 user reviews,0,2,2
1243260,True,0,No user reviews,0,0,0
1243270,True,0,3 user reviews,2,1,3
1243290,True,0,3 user reviews,3,0,3
1243310,True,0,No user reviews,0,0,0
1243320,True,0,7 user reviews,2,5,7
1243330,True,0,No user reviews,0,0,0
1243360,True,0,5 user reviews,5,0,5
1243370,True,0,2 user reviews,2,0,2
1243380,True,0,No user reviews,0,0,0
1243390,True,0,1 user reviews,0,1,1
1243400,True,0,No user reviews,0,0,0
1243410,True,0,1 user reviews,1,0,1
1243420,True,6,Mostly Positive,38,14,52
1243450,True,0,1 user reviews,0,1,1
1243520,True,0,No user reviews,0,0,0
1243530,True,0,6 user reviews,6,0,6
1243560,True,0,1 user reviews,1,0,1
1243570,True,0,No user reviews,0,0,0
1243580,True,0,No user reviews,0,0,0
1243640,True,0,No user reviews,0,0,0
1243670,True,8,Very Positive,75,6,81
1243680,True,0,No user reviews,0,0,0
1243681,True,0,No user reviews,0,0,0
1243682,True,0,No user reviews,0,0,0
1243700,True,0,No user reviews,0,0,0
1243710,True,0,4 user reviews,3,1,4
1243720,True,0,No user reviews,0,0,0
1243730,True,6,Mostly Positive,43,13,56
1243750,True,0,4 user reviews,2,2,4
1243770,True,7,Positive,19,0,19
1243780,True,0,No user reviews,0,0,0
1243790,True,7,Positive,13,0,13
1243800,True,0,No user reviews,0,0,0
1243820,True,0,2 user reviews,1,1,2
1243840,True,0,No user reviews,0,0,0
1243841,True,0,No user reviews,0,0,0
1243860,True,0,No user reviews,0,0,0
1243890,True,0,No user reviews,0,0,0
1243930,True,0,2 user reviews,2,0,2
1243960,True,7,Positive,12,0,12
1244020,True,0,No user reviews,0,0,0
1244040,True,7,Positive,29,3,32
1244050,True,0,No user reviews,0,0,0
1244080,True,0,No user reviews,0,0,0
1244090,True,0,No user reviews,0,0,0
1244150,True,0,No user reviews,0,0,0
1244160,True,7,Positive,19,0,19
1244180,True,0,No user reviews,0,0,0
1244190,True,0,6 user reviews,6,0,6
1244210,True,0,1 user reviews,1,0,1
1244230,True,0,2 user reviews,2,0,2
1244250,True,0,2 user reviews,2,0,2
1244260,True,7,Positive,14,0,14
1244270,True,7,Positive,11,0,11
1244300,True,0,1 user reviews,1,0,1
1244310,True,0,No user reviews,0,0,0
1244370,True,0,No user reviews,0,0,0
1244380,True,0,5 user reviews,2,3,5
1244390,True,0,3 user reviews,3,0,3
1244410,True,0,No user reviews,0,0,0
1244450,True,0,No user reviews,0,0,0
1244470,True,0,No user reviews,0,0,0
1244490,True,0,No user reviews,0,0,0
1244510,True,0,1 user reviews,1,0,1
1244520,True,0,No user reviews,0,0,0
1244530,True,0,9 user reviews,9,0,9
1244540,True,0,No user reviews,0,0,0
1244550,True,0,No user reviews,0,0,0
1244560,True,0,3 user reviews,3,0,3
1244600,True,0,No user reviews,0,0,0
1244620,True,0,No user reviews,0,0,0
1244630,True,0,No user reviews,0,0,0
1244640,True,0,No user reviews,0,0,0
1244690,True,0,3 user reviews,3,0,3
1244700,True,0,No user reviews,0,0,0
1244701,True,0,No user reviews,0,0,0
1244710,True,0,No user reviews,0,0,0
1244750,True,0,No user reviews,0,0,0
1244760,True,0,3 user reviews,1,2,3
1244770,True,0,No user reviews,0,0,0
1244780,True,0,No user reviews,0,0,0
1244781,True,4,Mostly Negative,26,47,73
1244800,True,0,No user reviews,0,0,0
1244820,True,0,No user reviews,0,0,0
1244830,True,0,No user reviews,0,0,0
1244840,True,0,1 user reviews,1,0,1
1244850,True,0,2 user reviews,1,1,2
1244860,True,0,3 user reviews,3,0,3
1244870,True,0,No user reviews,0,0,0
1244880,True,0,2 user reviews,2,0,2
1244890,True,0,1 user reviews,1,0,1
1244900,True,0,No user reviews,0,0,0
1244920,True,0,No user reviews,0,0,0
1244930,True,7,Positive,24,2,26
1244940,True,0,No user reviews,0,0,0
1244950,True,6,Mostly Positive,129,49,178
1244960,True,0,No user reviews,0,0,0
1245000,True,0,2 user reviews,2,0,2
1245020,True,0,No user reviews,0,0,0
1245030,True,0,1 user reviews,0,1,1
1245050,True,0,No user reviews,0,0,0
1245060,True,0,No user reviews,0,0,0
1245070,True,0,No user reviews,0,0,0
1245080,True,0,No user reviews,0,0,0
1245090,True,0,8 user reviews,7,1,8
1245100,True,0,No user reviews,0,0,0
1245110,True,0,7 user reviews,7,0,7
1245120,True,0,No user reviews,0,0,0
1245150,True,5,Mixed,166,112,278
1245170,True,0,1 user reviews,0,1,1
1245180,True,0,1 user reviews,0,1,1
1245190,True,0,No user reviews,0,0,0
1245200,True,0,No user reviews,0,0,0
1245220,True,0,No user reviews,0,0,0
1245230,True,0,1 user reviews,0,1,1
1245260,True,7,Positive,8,2,10
1245280,True,0,4 user reviews,2,2,4
1245300,True,0,1 user reviews,1,0,1
1245310,True,0,No user reviews,0,0,0
1245320,True,0,No user reviews,0,0,0
1245330,True,0,No user reviews,0,0,0
1245340,True,0,No user reviews,0,0,0
1245350,True,0,No user reviews,0,0,0
1245360,True,0,No user reviews,0,0,0
1245370,True,0,3 user reviews,3,0,3
1245380,True,0,2 user reviews,1,1,2
1245390,True,0,No user reviews,0,0,0
1245400,True,0,No user reviews,0,0,0
1245430,True,8,Very Positive,121,5,126
1245440,True,0,No user reviews,0,0,0
1245470,True,0,2 user reviews,0,2,2
1245500,True,0,4 user reviews,2,2,4
1245510,True,0,1 user reviews,1,0,1
1245540,True,7,Positive,18,0,18
1245550,True,0,No user reviews,0,0,0
1245560,True,0,No user reviews,0,0,0
1245570,True,0,No user reviews,0,0,0
1245580,True,0,No user reviews,0,0,0
1245590,True,0,No user reviews,0,0,0
1245600,True,0,3 user reviews,2,1,3
1245610,True,0,No user reviews,0,0,0
1245630,True,0,2 user reviews,1,1,2
1245640,True,0,No user reviews,0,0,0
1245660,True,0,3 user reviews,2,1,3
1245670,True,5,Mixed,11,7,18
1245680,True,0,No user reviews,0,0,0
1245700,True,0,No user reviews,0,0,0
1245710,True,0,No user reviews,0,0,0
1245730,True,0,1 user reviews,1,0,1
1245780,True,5,Mixed,36,16,52
1245810,True,0,3 user reviews,3,0,3
1245820,True,0,3 user reviews,3,0,3
1245830,True,0,No user reviews,0,0,0
1245880,True,0,No user reviews,0,0,0
1245900,True,0,4 user reviews,4,0,4
1245910,True,0,5 user reviews,1,4,5
1245920,True,0,No user reviews,0,0,0
1245930,True,0,1 user reviews,0,1,1
1245950,True,6,Mostly Positive,47,18,65
1245960,True,0,No user reviews,0,0,0
1245970,True,0,No user reviews,0,0,0
1245980,True,0,1 user reviews,0,1,1
1246010,True,0,No user reviews,0,0,0
1246020,True,0,No user reviews,0,0,0
1246030,True,0,1 user reviews,1,0,1
1246031,True,0,4 user reviews,3,1,4
1246032,True,0,2 user reviews,2,0,2
1246040,True,0,2 user reviews,2,0,2
1246050,True,0,No user reviews,0,0,0
1246060,True,0,No user reviews,0,0,0
1246110,True,0,No user reviews,0,0,0
1246120,True,0,No user reviews,0,0,0
1246140,True,0,3 user reviews,0,3,3
1246170,True,0,1 user reviews,1,0,1
1246180,True,0,No user reviews,0,0,0
1246181,True,0,No user reviews,0,0,0
1246182,True,0,No user reviews,0,0,0
1246183,True,0,No user reviews,0,0,0
1246184,True,0,No user reviews,0,0,0
1246185,True,0,No user reviews,0,0,0
1246186,True,0,No user reviews,0,0,0
1246187,True,0,No user reviews,0,0,0
1246188,True,0,No user reviews,0,0,0
1246189,True,0,No user reviews,0,0,0
1246200,True,0,No user reviews,0,0,0
1246210,True,0,No user reviews,0,0,0
1246230,True,0,1 user reviews,0,1,1
1246300,True,0,No user reviews,0,0,0
1246310,True,0,No user reviews,0,0,0
1246320,True,0,1 user reviews,1,0,1
1246330,True,0,No user reviews,0,0,0
1246370,True,0,No user reviews,0,0,0
1246390,True,0,No user reviews,0,0,0
1246400,True,0,5 user reviews,4,1,5
1246420,True,0,5 user reviews,4,1,5
1246430,True,0,No user reviews,0,0,0
1246460,True,0,No user reviews,0,0,0
1246490,True,7,Positive,9,2,11
1246500,True,0,No user reviews,0,0,0
1246520,True,5,Mixed,15,21,36
1246530,True,0,No user reviews,0,0,0
1246540,True,0,1 user reviews,1,0,1
1246550,True,0,No user reviews,0,0,0
1246570,True,0,4 user reviews,4,0,4
1246590,True,0,No user reviews,0,0,0
1246591,True,0,No user reviews,0,0,0
1246600,True,0,1 user reviews,1,0,1
1246610,True,0,1 user reviews,0,1,1
1246620,True,0,No user reviews,0,0,0
1246640,True,0,No user reviews,0,0,0
1246650,True,0,No user reviews,0,0,0
1246660,True,0,No user reviews,0,0,0
1246670,True,0,No user reviews,0,0,0
1246680,True,0,No user reviews,0,0,0
1246700,True,0,No user reviews,0,0,0
1246710,True,0,5 user reviews,4,1,5
1246730,True,0,No user reviews,0,0,0
1246740,True,0,No user reviews,0,0,0
1246750,True,0,No user reviews,0,0,0
1246760,True,0,No user reviews,0,0,0
1246780,True,0,4 user reviews,2,2,4
1246810,True,0,No user reviews,0,0,0
1246830,True,0,No user reviews,0,0,0
1246840,True,0,No user reviews,0,0,0
1246841,True,0,No user reviews,0,0,0
1246842,True,0,No user reviews,0,0,0
1246843,True,0,No user reviews,0,0,0
1246890,True,0,No user reviews,0,0,0
1246900,True,0,No user reviews,0,0,0
1246910,True,0,No user reviews,0,0,0
1246920,True,0,No user reviews,0,0,0
1246930,True,0,1 user reviews,1,0,1
1246940,True,0,No user reviews,0,0,0
1246950,True,6,Mostly Positive,10,4,14
1246990,True,0,No user reviews,0,0,0
1247000,True,0,No user reviews,0,0,0
1247010,True,0,5 user reviews,3,2,5
1247020,True,7,Positive,27,2,29
1247030,True,0,2 user reviews,2,0,2
1247040,True,0,4 user reviews,0,4,4
1247050,True,0,No user reviews,0,0,0
1247070,True,0,9 user reviews,7,2,9
1247080,True,0,No user reviews,0,0,0
1247090,True,0,No user reviews,0,0,0
1247100,True,0,No user reviews,0,0,0
1247110,True,0,1 user reviews,1,0,1
1247120,True,0,No user reviews,0,0,0
1247130,True,0,8 user reviews,7,1,8
1247140,True,0,3 user reviews,2,1,3
1247150,True,0,2 user reviews,1,1,2
1247170,True,7,Positive,19,2,21
1247180,True,0,No user reviews,0,0,0
1247190,True,6,Mostly Positive,10,3,13
1247210,True,0,1 user reviews,1,0,1
1247240,True,0,No user reviews,0,0,0
1247250,True,0,2 user reviews,0,2,2
1247270,True,0,7 user reviews,7,0,7
1247280,True,0,No user reviews,0,0,0
1247290,True,0,No user reviews,0,0,0
1247300,True,0,1 user reviews,1,0,1
1247320,True,0,No user reviews,0,0,0
1247340,True,0,8 user reviews,6,2,8
1247360,True,0,No user reviews,0,0,0
1247370,True,7,Positive,26,6,32
1247380,True,0,No user reviews,0,0,0
1247400,True,0,2 user reviews,2,0,2
1247460,True,0,No user reviews,0,0,0
1247480,True,0,No user reviews,0,0,0
1247490,True,0,No user reviews,0,0,0
1247560,True,0,No user reviews,0,0,0
1247570,True,0,No user reviews,0,0,0
1247600,True,0,No user reviews,0,0,0
1247610,True,0,No user reviews,0,0,0
1247611,True,0,No user reviews,0,0,0
1247612,True,0,1 user reviews,1,0,1
1247613,True,0,No user reviews,0,0,0
1247614,True,0,No user reviews,0,0,0
1247620,True,0,1 user reviews,1,0,1
1247640,True,7,Positive,22,4,26
1247650,True,0,No user reviews,0,0,0
1247700,True,0,No user reviews,0,0,0
1247711,True,0,No user reviews,0,0,0
1247720,True,7,Positive,32,3,35
1247730,True,0,2 user reviews,1,1,2
1247740,True,0,No user reviews,0,0,0
1247750,True,4,Mostly Negative,6,20,26
1247760,True,0,7 user reviews,7,0,7
1247830,True,0,4 user reviews,3,1,4
1247860,True,0,No user reviews,0,0,0
1247880,True,0,No user reviews,0,0,0
1247900,True,0,No user reviews,0,0,0
1247901,True,0,No user reviews,0,0,0
1247910,True,0,4 user reviews,3,1,4
1247920,True,0,2 user reviews,2,0,2
1247930,True,0,2 user reviews,1,1,2
1247940,True,7,Positive,28,1,29
1247950,True,0,2 user reviews,0,2,2
1247980,True,0,No user reviews,0,0,0
1247990,True,0,No user reviews,0,0,0
1248020,True,0,No user reviews,0,0,0
1248030,True,0,2 user reviews,2,0,2
1248050,True,0,No user reviews,0,0,0
1248060,True,0,No user reviews,0,0,0
1248070,True,0,No user reviews,0,0,0
1248080,True,0,No user reviews,0,0,0
1248100,True,0,1 user reviews,1,0,1
1248110,True,0,No user reviews,0,0,0
1248120,True,0,No user reviews,0,0,0
1248140,True,7,Positive,12,1,13
1248150,True,0,No user reviews,0,0,0
1248160,True,0,No user reviews,0,0,0
1248180,True,0,3 user reviews,2,1,3
1248181,True,0,No user reviews,0,0,0
1248182,True,0,No user reviews,0,0,0
1248183,True,0,No user reviews,0,0,0
1248200,True,0,No user reviews,0,0,0
1248220,True,0,No user reviews,0,0,0
1248230,True,0,No user reviews,0,0,0
1248240,True,0,No user reviews,0,0,0
1248270,True,0,No user reviews,0,0,0
1248290,True,0,No user reviews,0,0,0
1248310,True,0,No user reviews,0,0,0
1248330,True,0,5 user reviews,5,0,5
1248331,True,0,2 user reviews,1,1,2
1248332,True,0,1 user reviews,1,0,1
1248335,True,0,9 user reviews,4,5,9
1248340,True,0,No user reviews,0,0,0
1248350,True,0,No user reviews,0,0,0
1248360,True,0,No user reviews,0,0,0
1248370,True,0,1 user reviews,1,0,1
1248380,True,8,Very Positive,85,11,96
1248390,True,0,No user reviews,0,0,0
1248410,True,0,No user reviews,0,0,0
1248430,True,8,Very Positive,58,5,63
1248431,True,7,Positive,16,0,16
1248434,True,7,Positive,35,1,36
1248450,True,0,No user reviews,0,0,0
1248460,True,7,Positive,14,0,14
1248470,True,0,No user reviews,0,0,0
1248490,True,0,1 user reviews,1,0,1
1248510,True,0,No user reviews,0,0,0
1248520,True,0,No user reviews,0,0,0
1248530,True,0,No user reviews,0,0,0
1248540,True,0,No user reviews,0,0,0
1248570,True,0,1 user reviews,1,0,1
1248590,True,0,8 user reviews,2,6,8
1248600,True,0,No user reviews,0,0,0
1248650,True,0,No user reviews,0,0,0
1248670,True,0,No user reviews,0,0,0
1248680,True,0,1 user reviews,1,0,1
1248690,True,0,No user reviews,0,0,0
1248710,True,0,3 user reviews,2,1,3
1248730,True,0,No user reviews,0,0,0
1248740,True,0,No user reviews,0,0,0
1248790,True,0,No user reviews,0,0,0
1248800,True,0,6 user reviews,6,0,6
1248810,True,0,No user reviews,0,0,0
1248820,True,0,No user reviews,0,0,0
1248860,True,0,3 user reviews,3,0,3
1248870,True,0,No user reviews,0,0,0
1248880,True,0,1 user reviews,1,0,1
1248900,True,0,No user reviews,0,0,0
1248910,True,0,1 user reviews,1,0,1
1248960,True,0,2 user reviews,2,0,2
1248970,True,0,8 user reviews,7,1,8
1248980,True,0,No user reviews,0,0,0
1248990,True,0,5 user reviews,2,3,5
1249000,True,0,9 user reviews,5,4,9
1249010,True,0,5 user reviews,4,1,5
1249020,True,0,No user reviews,0,0,0
1249030,True,0,No user reviews,0,0,0
1249050,True,0,2 user reviews,2,0,2
1249060,True,0,3 user reviews,2,1,3
1249070,True,0,6 user reviews,6,0,6
1249080,True,0,No user reviews,0,0,0
1249100,True,0,No user reviews,0,0,0
1249110,True,0,6 user reviews,5,1,6
1249130,True,8,Very Positive,151,17,168
1249140,True,0,1 user reviews,1,0,1
1249150,True,0,No user reviews,0,0,0
1249160,True,0,No user reviews,0,0,0
1249170,True,7,Positive,10,0,10
1249200,True,0,No user reviews,0,0,0
1249250,True,0,No user reviews,0,0,0
1249251,True,0,No user reviews,0,0,0
1249260,True,7,Positive,35,3,38
1249280,True,0,2 user reviews,2,0,2
1249290,True,0,2 user reviews,2,0,2
1249300,True,0,No user reviews,0,0,0
1249310,True,0,2 user reviews,2,0,2
1249320,True,0,No user reviews,0,0,0
1249340,True,0,1 user reviews,1,0,1
1249350,True,0,No user reviews,0,0,0
1249360,True,0,No user reviews,0,0,0
1249390,True,0,No user reviews,0,0,0
1249400,True,0,No user reviews,0,0,0
1249410,True,0,5 user reviews,4,1,5
1249420,True,0,No user reviews,0,0,0
1249430,True,0,No user reviews,0,0,0
1249450,True,0,1 user reviews,1,0,1
1249480,True,0,No user reviews,0,0,0
1249500,True,0,8 user reviews,5,3,8
1249510,True,0,8 user reviews,8,0,8
1249520,True,0,No user reviews,0,0,0
1249570,True,0,No user reviews,0,0,0
1249600,True,0,No user reviews,0,0,0
1249620,True,0,1 user reviews,0,1,1
1249630,True,0,No user reviews,0,0,0
1249650,True,0,No user reviews,0,0,0
1249680,True,0,No user reviews,0,0,0
1249730,True,0,No user reviews,0,0,0
1249750,True,0,No user reviews,0,0,0
1249760,True,0,1 user reviews,1,0,1
1249770,True,0,No user reviews,0,0,0
1249780,True,0,No user reviews,0,0,0
1249800,True,7,Positive,42,5,47
1249810,True,0,1 user reviews,1,0,1
1249850,True,0,6 user reviews,4,2,6
1249880,True,0,No user reviews,0,0,0
1249890,True,0,2 user reviews,2,0,2
1249900,True,0,No user reviews,0,0,0
1249901,True,0,No user reviews,0,0,0
1249902,True,0,No user reviews,0,0,0
1249903,True,0,No user reviews,0,0,0
1249920,True,0,No user reviews,0,0,0
1249930,True,0,No user reviews,0,0,0
1249960,True,0,No user reviews,0,0,0
1249970,True,0,No user reviews,0,0,0
1249980,True,0,No user reviews,0,0,0
1249990,True,0,No user reviews,0,0,0
1250000,True,0,No user reviews,0,0,0
1250030,True,0,4 user reviews,4,0,4
1250040,True,0,No user reviews,0,0,0
1250060,True,0,No user reviews,0,0,0
1250070,True,0,3 user reviews,2,1,3
1250090,True,0,No user reviews,0,0,0
1250100,True,7,Positive,14,1,15
1250110,True,0,No user reviews,0,0,0
1250120,True,0,No user reviews,0,0,0
1250130,True,0,No user reviews,0,0,0
1250140,True,0,No user reviews,0,0,0
1250160,True,0,No user reviews,0,0,0
1250170,True,0,1 user reviews,1,0,1
1250180,True,0,5 user reviews,5,0,5
1250190,True,0,No user reviews,0,0,0
1250210,True,0,No user reviews,0,0,0
1250220,True,5,Mixed,16,15,31
1250240,True,0,No user reviews,0,0,0
1250250,True,7,Positive,11,0,11
1250260,True,0,No user reviews,0,0,0
1250270,True,0,No user reviews,0,0,0
1250290,True,0,No user reviews,0,0,0
1250300,True,7,Positive,9,1,10
1250350,True,0,No user reviews,0,0,0
1250410,True,6,Mostly Positive,7821,2673,10494
1250420,True,0,No user reviews,0,0,0
1250440,True,0,No user reviews,0,0,0
1250490,True,0,1 user reviews,1,0,1
1250500,True,0,No user reviews,0,0,0
1250510,True,0,No user reviews,0,0,0
1250520,True,7,Positive,39,2,41
1250540,True,0,No user reviews,0,0,0
1250550,True,0,3 user reviews,2,1,3
1250560,True,8,Very Positive,65,2,67
1250590,True,0,No user reviews,0,0,0
1250610,True,0,No user reviews,0,0,0
1250620,True,0,No user reviews,0,0,0
1250621,True,0,No user reviews,0,0,0
1250622,True,0,No user reviews,0,0,0
1250640,True,0,2 user reviews,1,1,2
1250650,True,6,Mostly Positive,182,72,254
1250660,True,0,No user reviews,0,0,0
1250670,True,0,No user reviews,0,0,0
1250690,True,7,Positive,12,1,13
1250700,True,0,No user reviews,0,0,0
1250710,True,0,No user reviews,0,0,0
1250720,True,0,5 user reviews,4,1,5
1250730,True,0,2 user reviews,1,1,2
1250740,True,0,2 user reviews,2,0,2
1250760,True,0,No user reviews,0,0,0
1250770,True,0,1 user reviews,1,0,1
1250790,True,0,No user reviews,0,0,0
1250810,True,0,No user reviews,0,0,0
1250830,True,0,1 user reviews,1,0,1
1250840,True,0,No user reviews,0,0,0
1250850,True,0,No user reviews,0,0,0
1250860,True,0,No user reviews,0,0,0
1250870,True,0,No user reviews,0,0,0
1250890,True,0,3 user reviews,3,0,3
1250910,True,0,4 user reviews,3,1,4
1250920,True,0,No user reviews,0,0,0
1250940,True,0,No user reviews,0,0,0
1250960,True,0,No user reviews,0,0,0
1250980,True,0,No user reviews,0,0,0
1250990,True,0,1 user reviews,1,0,1
1251000,True,6,Mostly Positive,124,33,157
1251050,True,0,No user reviews,0,0,0
1251060,True,0,No user reviews,0,0,0
1251090,True,0,No user reviews,0,0,0
1251130,True,0,No user reviews,0,0,0
1251180,True,0,No user reviews,0,0,0
1251190,True,0,No user reviews,0,0,0
1251200,True,0,No user reviews,0,0,0
1251210,True,0,No user reviews,0,0,0
1251220,True,0,No user reviews,0,0,0
1251230,True,0,No user reviews,0,0,0
1251240,True,0,No user reviews,0,0,0
1251260,True,0,No user reviews,0,0,0
1251270,True,0,No user reviews,0,0,0
1251290,True,0,2 user reviews,0,2,2
1251300,True,6,Mostly Positive,19,7,26
1251320,True,0,No user reviews,0,0,0
1251350,True,0,3 user reviews,3,0,3
1251380,True,0,1 user reviews,0,1,1
1251400,True,0,No user reviews,0,0,0
1251410,True,5,Mixed,11,6,17
1251420,True,0,No user reviews,0,0,0
1251430,True,0,5 user reviews,3,2,5
1251460,True,0,No user reviews,0,0,0
1251470,True,0,No user reviews,0,0,0
1251490,True,0,No user reviews,0,0,0
1251520,True,0,2 user reviews,2,0,2
1251530,True,0,9 user reviews,8,1,9
1251550,True,0,No user reviews,0,0,0
1251560,True,0,No user reviews,0,0,0
1251570,True,0,No user reviews,0,0,0
1251580,True,0,No user reviews,0,0,0
1251590,True,0,No user reviews,0,0,0
1251610,True,0,No user reviews,0,0,0
1251620,True,0,No user reviews,0,0,0
1251630,True,0,No user reviews,0,0,0
1251640,True,7,Positive,37,1,38
1251650,True,0,No user reviews,0,0,0
1251660,True,0,No user reviews,0,0,0
1251670,True,0,No user reviews,0,0,0
1251680,True,7,Positive,9,2,11
1251690,True,0,No user reviews,0,0,0
1251720,True,0,No user reviews,0,0,0
1251730,True,0,No user reviews,0,0,0
1251750,True,0,No user reviews,0,0,0
1251760,True,0,3 user reviews,1,2,3
1251770,True,0,No user reviews,0,0,0
1251780,True,0,No user reviews,0,0,0
1251790,True,0,No user reviews,0,0,0
1251800,True,0,No user reviews,0,0,0
1251810,True,0,No user reviews,0,0,0
1251820,True,0,No user reviews,0,0,0
1251840,True,0,2 user reviews,0,2,2
1251850,True,0,No user reviews,0,0,0
1251870,True,0,No user reviews,0,0,0
1251910,True,7,Positive,9,1,10
1251930,True,0,No user reviews,0,0,0
1251940,True,0,7 user reviews,7,0,7
1251950,True,0,No user reviews,0,0,0
1251970,True,0,No user reviews,0,0,0
1251980,True,7,Positive,12,3,15
1252010,True,5,Mixed,20,20,40
1252020,True,0,No user reviews,0,0,0
1252030,True,0,No user reviews,0,0,0
1252040,True,0,No user reviews,0,0,0
1252050,True,0,No user reviews,0,0,0
1252080,True,0,5 user reviews,3,2,5
1252100,True,0,4 user reviews,4,0,4
1252110,True,0,No user reviews,0,0,0
1252120,True,0,No user reviews,0,0,0
1252130,True,0,No user reviews,0,0,0
1252160,True,0,2 user reviews,2,0,2
1252170,True,0,4 user reviews,4,0,4
1252180,True,0,No user reviews,0,0,0
1252190,True,0,No user reviews,0,0,0
1252200,True,6,Mostly Positive,99,29,128
1252210,True,0,3 user reviews,3,0,3
1252230,True,0,No user reviews,0,0,0
1252240,True,0,No user reviews,0,0,0
1252260,True,0,No user reviews,0,0,0
1252280,True,0,No user reviews,0,0,0
1252290,True,0,1 user reviews,0,1,1
1252300,True,0,No user reviews,0,0,0
1252310,True,0,No user reviews,0,0,0
1252320,True,7,Positive,19,0,19
1252340,True,0,No user reviews,0,0,0
1252370,True,0,No user reviews,0,0,0
1252390,True,0,No user reviews,0,0,0
1252410,True,7,Positive,11,0,11
1252450,True,0,2 user reviews,2,0,2
1252460,True,0,No user reviews,0,0,0
1252500,True,0,No user reviews,0,0,0
1252510,True,0,No user reviews,0,0,0
1252560,True,7,Positive,25,1,26
1252580,True,0,No user reviews,0,0,0
1252590,True,0,1 user reviews,1,0,1
1252620,True,0,No user reviews,0,0,0
1252630,True,0,No user reviews,0,0,0
1252650,True,0,No user reviews,0,0,0
1252660,True,0,No user reviews,0,0,0
1252680,True,0,No user reviews,0,0,0
1252700,True,0,1 user reviews,1,0,1
1252710,True,8,Very Positive,42,10,52
1252720,True,0,No user reviews,0,0,0
1252730,True,0,4 user reviews,3,1,4
1252740,True,0,No user reviews,0,0,0
1252750,True,8,Very Positive,57,8,65
1252760,True,7,Positive,9,1,10
1252780,True,0,No user reviews,0,0,0
1252810,True,0,No user reviews,0,0,0
1252820,True,0,No user reviews,0,0,0
1252830,True,0,No user reviews,0,0,0
1252850,True,0,No user reviews,0,0,0
1252870,True,8,Very Positive,53,12,65
1252880,True,0,No user reviews,0,0,0
1252881,True,0,No user reviews,0,0,0
1252890,True,0,No user reviews,0,0,0
1252910,True,0,No user reviews,0,0,0
1252920,True,0,1 user reviews,0,1,1
1252980,True,0,2 user reviews,2,0,2
1252990,True,5,Mixed,28,15,43
1253000,True,0,No user reviews,0,0,0
1253020,True,0,No user reviews,0,0,0
1253030,True,0,No user reviews,0,0,0
1253050,True,0,1 user reviews,1,0,1
1253090,True,0,1 user reviews,1,0,1
1253091,True,0,3 user reviews,2,1,3
1253092,True,7,Positive,8,2,10
1253110,True,7,Positive,9,1,10
1253160,True,0,No user reviews,0,0,0
1253180,True,0,2 user reviews,0,2,2
1253230,True,0,No user reviews,0,0,0
1253240,True,0,1 user reviews,1,0,1
1253270,True,0,No user reviews,0,0,0
1253280,True,0,7 user reviews,7,0,7
1253290,True,0,No user reviews,0,0,0
1253310,True,0,No user reviews,0,0,0
1253320,True,0,No user reviews,0,0,0
1253350,True,0,No user reviews,0,0,0
1253390,True,7,Positive,12,1,13
1253400,True,0,No user reviews,0,0,0
1253420,True,0,No user reviews,0,0,0
1253450,True,0,No user reviews,0,0,0
1253460,True,0,2 user reviews,0,2,2
1253520,True,0,No user reviews,0,0,0
1253540,True,0,No user reviews,0,0,0
1253550,True,5,Mixed,11,7,18
1253560,True,0,No user reviews,0,0,0
1253570,True,0,No user reviews,0,0,0
1253580,True,0,6 user reviews,6,0,6
1253620,True,0,3 user reviews,0,3,3
1253660,True,0,No user reviews,0,0,0
1253680,True,6,Mostly Positive,19,5,24
1253690,True,0,No user reviews,0,0,0
1253700,True,0,4 user reviews,1,3,4
1253710,True,0,No user reviews,0,0,0
1253720,True,0,1 user reviews,0,1,1
1253750,True,0,No user reviews,0,0,0
1253751,True,0,No user reviews,0,0,0
1253752,True,0,No user reviews,0,0,0
1253753,True,0,No user reviews,0,0,0
1253754,True,0,No user reviews,0,0,0
1253755,True,0,No user reviews,0,0,0
1253760,True,0,1 user reviews,1,0,1
1253800,True,0,No user reviews,0,0,0
1253820,True,0,2 user reviews,1,1,2
1253830,True,0,No user reviews,0,0,0
1253850,True,0,No user reviews,0,0,0
1253860,True,0,No user reviews,0,0,0
1253870,True,8,Very Positive,321,42,363
1253880,True,0,No user reviews,0,0,0
1253890,True,0,No user reviews,0,0,0
1253900,True,0,5 user reviews,0,5,5
1253920,True,6,Mostly Positive,679,177,856
1253930,True,0,No user reviews,0,0,0
1253940,True,0,5 user reviews,4,1,5
1253950,True,7,Positive,16,0,16
1253960,True,0,No user reviews,0,0,0
1253970,True,0,No user reviews,0,0,0
1253990,True,4,Mostly Negative,43,83,126
1254030,True,0,No user reviews,0,0,0
1254070,True,0,2 user reviews,2,0,2
1254100,True,0,No user reviews,0,0,0
1254110,True,0,No user reviews,0,0,0
1254120,True,0,No user reviews,0,0,0
1254140,True,0,No user reviews,0,0,0
1254150,True,0,5 user reviews,4,1,5
1254160,True,0,4 user reviews,2,2,4
1254170,True,0,No user reviews,0,0,0
1254171,True,0,No user reviews,0,0,0
1254172,True,0,No user reviews,0,0,0
1254173,True,0,No user reviews,0,0,0
1254174,True,0,No user reviews,0,0,0
1254175,True,0,No user reviews,0,0,0
1254176,True,0,No user reviews,0,0,0
1254180,True,7,Positive,11,0,11
1254190,True,0,No user reviews,0,0,0
1254191,True,0,No user reviews,0,0,0
1254192,True,0,No user reviews,0,0,0
1254193,True,0,No user reviews,0,0,0
1254200,True,0,No user reviews,0,0,0
1254210,True,0,No user reviews,0,0,0
1254211,True,0,No user reviews,0,0,0
1254212,True,0,No user reviews,0,0,0
1254213,True,0,No user reviews,0,0,0
1254230,True,0,No user reviews,0,0,0
1254240,True,0,No user reviews,0,0,0
1254270,True,0,No user reviews,0,0,0
1254280,True,0,2 user reviews,1,1,2
1254300,True,0,No user reviews,0,0,0
1254340,True,0,No user reviews,0,0,0
1254350,True,0,5 user reviews,4,1,5
1254360,True,0,No user reviews,0,0,0
1254370,True,8,Very Positive,208,15,223
1254380,True,5,Mixed,6,4,10
1254390,True,0,No user reviews,0,0,0
1254400,True,5,Mixed,55,26,81
1254410,True,0,No user reviews,0,0,0
1254420,True,0,1 user reviews,0,1,1
1254430,True,0,No user reviews,0,0,0
1254440,True,0,No user reviews,0,0,0
1254480,True,0,7 user reviews,4,3,7
1254490,True,0,1 user reviews,0,1,1
1254500,True,7,Positive,17,3,20
1254530,True,0,No user reviews,0,0,0
1254540,True,0,No user reviews,0,0,0
1254550,True,0,No user reviews,0,0,0
1254570,True,5,Mixed,44,21,65
1254590,True,0,1 user reviews,1,0,1
1254600,True,0,No user reviews,0,0,0
1254610,True,0,No user reviews,0,0,0
1254620,True,0,5 user reviews,5,0,5
1254630,True,0,5 user reviews,3,2,5
1254650,True,0,No user reviews,0,0,0
1254670,True,0,No user reviews,0,0,0
1254680,True,0,2 user reviews,1,1,2
1254700,True,0,No user reviews,0,0,0
1254720,True,0,No user reviews,0,0,0
1254730,True,0,No user reviews,0,0,0
1254740,True,0,No user reviews,0,0,0
1254750,True,0,No user reviews,0,0,0
1254770,True,0,No user reviews,0,0,0
1254800,True,0,No user reviews,0,0,0
1254820,True,0,1 user reviews,0,1,1
1254850,True,0,No user reviews,0,0,0
1254851,True,0,No user reviews,0,0,0
1254860,True,0,5 user reviews,4,1,5
1254870,True,7,Positive,27,0,27
1254890,True,0,1 user reviews,1,0,1
1254900,True,0,7 user reviews,5,2,7
1254910,True,0,No user reviews,0,0,0
1254920,True,0,4 user reviews,4,0,4
1254921,True,0,8 user reviews,8,0,8
1254922,True,0,1 user reviews,1,0,1
1254923,True,7,Positive,10,2,12
1254930,True,0,3 user reviews,2,1,3
1254950,True,0,No user reviews,0,0,0
1254960,True,0,No user reviews,0,0,0
1254980,True,0,No user reviews,0,0,0
1254990,True,0,No user reviews,0,0,0
1254991,True,0,No user reviews,0,0,0
1255000,True,7,Positive,24,3,27
1255001,True,0,8 user reviews,8,0,8
1255010,True,0,No user reviews,0,0,0
1255030,True,0,No user reviews,0,0,0
1255040,True,7,Positive,13,1,14
1255050,True,0,7 user reviews,7,0,7
1255060,True,0,No user reviews,0,0,0
1255070,True,0,2 user reviews,2,0,2
1255071,True,0,1 user reviews,1,0,1
1255072,True,0,4 user reviews,4,0,4
1255073,True,0,1 user reviews,1,0,1
1255074,True,0,1 user reviews,1,0,1
1255075,True,0,2 user reviews,2,0,2
1255080,True,0,7 user reviews,5,2,7
1255081,True,0,5 user reviews,4,1,5
1255120,True,0,No user reviews,0,0,0
1255130,True,0,9 user reviews,8,1,9
1255140,True,0,3 user reviews,3,0,3
1255150,True,6,Mostly Positive,24,9,33
1255151,True,8,Very Positive,58,10,68
1255152,True,5,Mixed,40,20,60
1255160,True,0,No user reviews,0,0,0
1255170,True,0,No user reviews,0,0,0
1255190,True,0,No user reviews,0,0,0
1255220,True,4,Mostly Negative,3,7,10
1255230,True,0,No user reviews,0,0,0
1255250,True,0,1 user reviews,0,1,1
1255260,True,0,No user reviews,0,0,0
1255270,True,0,No user reviews,0,0,0
1255280,True,0,No user reviews,0,0,0
1255290,True,0,No user reviews,0,0,0
1255300,True,0,No user reviews,0,0,0
1255310,True,5,Mixed,13,11,24
1255311,True,0,8 user reviews,5,3,8
1255320,True,0,2 user reviews,1,1,2
1255340,True,0,No user reviews,0,0,0
1255341,True,0,No user reviews,0,0,0
1255342,True,0,No user reviews,0,0,0
1255343,True,0,No user reviews,0,0,0
1255344,True,0,No user reviews,0,0,0
1255345,True,0,No user reviews,0,0,0
1255346,True,0,No user reviews,0,0,0
1255347,True,0,No user reviews,0,0,0
1255348,True,0,No user reviews,0,0,0
1255370,True,0,1 user reviews,0,1,1
1255380,True,0,No user reviews,0,0,0
1255390,True,0,No user reviews,0,0,0
1255400,True,0,No user reviews,0,0,0
1255401,True,0,No user reviews,0,0,0
1255410,True,0,No user reviews,0,0,0
1255420,True,0,No user reviews,0,0,0
1255430,True,0,No user reviews,0,0,0
1255440,True,0,No user reviews,0,0,0
1255460,True,0,No user reviews,0,0,0
1255470,True,0,No user reviews,0,0,0
1255490,True,0,1 user reviews,1,0,1
1255520,True,0,2 user reviews,2,0,2
1255550,True,0,No user reviews,0,0,0
1255560,True,0,No user reviews,0,0,0
1255580,True,0,No user reviews,0,0,0
1255640,True,0,No user reviews,0,0,0
1255650,True,7,Positive,10,0,10
1255660,True,0,No user reviews,0,0,0
1255680,True,0,3 user reviews,3,0,3
1255690,True,0,No user reviews,0,0,0
1255720,True,0,No user reviews,0,0,0
1255730,True,0,1 user reviews,0,1,1
1255740,True,0,7 user reviews,6,1,7
1255760,True,0,No user reviews,0,0,0
1255800,True,0,No user reviews,0,0,0
1255810,True,0,No user reviews,0,0,0
1255820,True,0,No user reviews,0,0,0
1255830,True,0,1 user reviews,1,0,1
1255840,True,0,2 user reviews,2,0,2
1255850,True,0,1 user reviews,1,0,1
1255860,True,0,No user reviews,0,0,0
1255870,True,0,2 user reviews,2,0,2
1255880,True,0,2 user reviews,2,0,2
1255890,True,0,No user reviews,0,0,0
1255910,True,0,2 user reviews,2,0,2
1255920,True,0,No user reviews,0,0,0
1255950,True,0,3 user reviews,3,0,3
1255960,True,0,No user reviews,0,0,0
1255970,True,0,No user reviews,0,0,0
1255990,True,6,Mostly Positive,17,5,22
1256030,True,7,Positive,21,3,24
1256040,True,0,3 user reviews,3,0,3
1256050,True,0,No user reviews,0,0,0
1256060,True,0,No user reviews,0,0,0
1256130,True,0,No user reviews,0,0,0
1256160,True,0,No user reviews,0,0,0
1256190,True,0,8 user reviews,5,3,8
1256200,True,0,No user reviews,0,0,0
1256220,True,0,No user reviews,0,0,0
1256230,True,0,No user reviews,0,0,0
1256240,True,0,1 user reviews,0,1,1
1256260,True,0,No user reviews,0,0,0
1256310,True,0,4 user reviews,2,2,4
1256330,True,0,No user reviews,0,0,0
1256340,True,0,No user reviews,0,0,0
1256350,True,0,1 user reviews,0,1,1
1256360,True,0,1 user reviews,1,0,1
1256370,True,0,No user reviews,0,0,0
1256380,True,0,No user reviews,0,0,0
1256400,True,0,No user reviews,0,0,0
1256430,True,0,2 user reviews,2,0,2
1256440,True,0,1 user reviews,1,0,1
1256460,True,0,No user reviews,0,0,0
1256480,True,0,2 user reviews,0,2,2
1256490,True,0,2 user reviews,2,0,2
1256500,True,0,2 user reviews,0,2,2
1256510,True,7,Positive,13,1,14
1256520,True,7,Positive,16,0,16
1256530,True,7,Positive,23,1,24
1256540,True,0,No user reviews,0,0,0
1256550,True,0,No user reviews,0,0,0
1256570,True,0,No user reviews,0,0,0
1256580,True,0,No user reviews,0,0,0
1256590,True,0,No user reviews,0,0,0
1256610,True,7,Positive,14,3,17
1256620,True,0,No user reviews,0,0,0
1256621,True,0,No user reviews,0,0,0
1256650,True,0,No user reviews,0,0,0
1256660,True,7,Positive,11,0,11
1256670,True,8,Very Positive,465,21,486
1256680,True,0,No user reviews,0,0,0
1256690,True,5,Mixed,16,11,27
1256710,True,0,2 user reviews,1,1,2
1256740,True,0,8 user reviews,8,0,8
1256750,True,0,3 user reviews,1,2,3
1256760,True,0,No user reviews,0,0,0
1256770,True,0,1 user reviews,1,0,1
1256800,True,0,No user reviews,0,0,0
1256810,True,0,No user reviews,0,0,0
1256830,True,0,No user reviews,0,0,0
1256840,True,0,No user reviews,0,0,0
1256850,True,0,5 user reviews,1,4,5
1256870,True,0,No user reviews,0,0,0
1256880,True,0,No user reviews,0,0,0
1256900,True,0,No user reviews,0,0,0
1256910,True,0,2 user reviews,2,0,2
1256920,True,7,Positive,9,1,10
1256930,True,0,No user reviews,0,0,0
1256950,True,7,Positive,24,5,29
1256970,True,0,No user reviews,0,0,0
1256980,True,0,No user reviews,0,0,0
1256990,True,0,No user reviews,0,0,0
1257000,True,0,No user reviews,0,0,0
1257010,True,0,No user reviews,0,0,0
1257020,True,0,No user reviews,0,0,0
1257030,True,0,No user reviews,0,0,0
1257170,True,7,Positive,18,2,20
1257190,True,0,2 user reviews,2,0,2
1257200,True,0,No user reviews,0,0,0
1257210,True,7,Positive,9,1,10
1257250,True,0,4 user reviews,4,0,4
1257260,True,0,No user reviews,0,0,0
1257270,True,0,2 user reviews,1,1,2
1257280,True,0,No user reviews,0,0,0
1257290,True,0,No user reviews,0,0,0
1257310,True,0,3 user reviews,0,3,3
1257321,True,0,No user reviews,0,0,0
1257350,True,0,1 user reviews,1,0,1
1257351,True,0,No user reviews,0,0,0
1257352,True,0,No user reviews,0,0,0
1257360,True,8,Very Positive,222,41,263
1257370,True,0,No user reviews,0,0,0
1257410,True,7,Positive,47,2,49
1257420,True,0,No user reviews,0,0,0
1257430,True,7,Positive,13,1,14
1257440,True,7,Positive,12,2,14
1257450,True,0,No user reviews,0,0,0
1257460,True,0,No user reviews,0,0,0
1257480,True,0,No user reviews,0,0,0
1257490,True,0,No user reviews,0,0,0
1257510,True,0,No user reviews,0,0,0
1257520,True,0,No user reviews,0,0,0
1257540,True,0,1 user reviews,1,0,1
1257560,True,0,No user reviews,0,0,0
1257570,True,0,4 user reviews,4,0,4
1257600,True,0,6 user reviews,6,0,6
1257630,True,0,1 user reviews,1,0,1
1257660,True,0,No user reviews,0,0,0
1257670,True,0,3 user reviews,3,0,3
1257680,True,0,No user reviews,0,0,0
1257700,True,0,No user reviews,0,0,0
1257720,True,0,3 user reviews,0,3,3
1257730,True,0,No user reviews,0,0,0
1257740,True,0,2 user reviews,2,0,2
1257741,True,0,No user reviews,0,0,0
1257770,True,0,1 user reviews,1,0,1
1257790,True,0,No user reviews,0,0,0
1257800,True,0,No user reviews,0,0,0
1257810,True,0,7 user reviews,5,2,7
1257830,True,0,No user reviews,0,0,0
1257840,True,0,8 user reviews,4,4,8
1257850,True,0,No user reviews,0,0,0
1257860,True,0,No user reviews,0,0,0
1257870,True,0,No user reviews,0,0,0
1257890,True,0,3 user reviews,3,0,3
1257900,True,0,2 user reviews,1,1,2
1257910,True,0,8 user reviews,7,1,8
1257920,True,0,1 user reviews,1,0,1
1257930,True,0,3 user reviews,2,1,3
1257950,True,0,No user reviews,0,0,0
1257960,True,0,No user reviews,0,0,0
1258000,True,0,3 user reviews,3,0,3
1258020,True,0,6 user reviews,6,0,6
1258040,True,0,2 user reviews,1,1,2
1258060,True,0,4 user reviews,1,3,4
1258070,True,0,2 user reviews,2,0,2
1258080,True,0,No user reviews,0,0,0
1258090,True,0,No user reviews,0,0,0
1258120,True,0,No user reviews,0,0,0
1258140,True,0,3 user reviews,2,1,3
1258154,True,0,No user reviews,0,0,0
1258155,True,0,No user reviews,0,0,0
1258160,True,0,No user reviews,0,0,0
1258170,True,0,No user reviews,0,0,0
1258190,True,7,Positive,19,2,21
1258200,True,0,6 user reviews,3,3,6
1258220,True,0,No user reviews,0,0,0
1258230,True,0,No user reviews,0,0,0
1258280,True,0,1 user reviews,1,0,1
1258290,True,0,No user reviews,0,0,0
1258300,True,0,No user reviews,0,0,0
1258310,True,8,Very Positive,81,1,82
1258320,True,6,Mostly Positive,13341,5203,18544
1258330,True,0,No user reviews,0,0,0
1258340,True,8,Very Positive,51,3,54
1258370,True,0,No user reviews,0,0,0
1258380,True,0,No user reviews,0,0,0
1258410,True,0,No user reviews,0,0,0
1258420,True,0,No user reviews,0,0,0
1258440,True,0,1 user reviews,1,0,1
1258450,True,0,No user reviews,0,0,0
1258460,True,5,Mixed,36,18,54
1258480,True,0,7 user reviews,7,0,7
1258490,True,0,No user reviews,0,0,0
1258500,True,6,Mostly Positive,29,10,39
1258510,True,7,Positive,24,1,25
1258560,True,0,No user reviews,0,0,0
1258580,True,0,3 user reviews,3,0,3
1258590,True,8,Very Positive,87,17,104
1258600,True,0,No user reviews,0,0,0
1258610,True,0,No user reviews,0,0,0
1258620,True,0,1 user reviews,0,1,1
1258630,True,0,No user reviews,0,0,0
1258640,True,0,1 user reviews,0,1,1
1258650,True,0,No user reviews,0,0,0
1258680,True,0,No user reviews,0,0,0
1258690,True,0,No user reviews,0,0,0
1258700,True,0,No user reviews,0,0,0
1258701,True,0,No user reviews,0,0,0
1258710,True,7,Positive,18,3,21
1258730,True,0,9 user reviews,9,0,9
1258740,True,7,Positive,21,0,21
1258770,True,0,No user reviews,0,0,0
1258790,True,0,No user reviews,0,0,0
1258810,True,0,No user reviews,0,0,0
1258830,True,0,No user reviews,0,0,0
1258840,True,0,2 user reviews,2,0,2
1258860,True,0,No user reviews,0,0,0
1258870,True,0,No user reviews,0,0,0
1258880,True,0,No user reviews,0,0,0
1258900,True,0,No user reviews,0,0,0
1258910,True,0,2 user reviews,1,1,2
1258930,True,0,No user reviews,0,0,0
1258950,True,0,No user reviews,0,0,0
1258960,True,0,No user reviews,0,0,0
1258970,True,0,No user reviews,0,0,0
1258980,True,0,5 user reviews,4,1,5
1258990,True,0,No user reviews,0,0,0
1259000,True,0,No user reviews,0,0,0
1259010,True,0,No user reviews,0,0,0
1259050,True,0,No user reviews,0,0,0
1259110,True,0,1 user reviews,1,0,1
1259130,True,6,Mostly Positive,8,3,11
1259140,True,0,No user reviews,0,0,0
1259150,True,0,No user reviews,0,0,0
1259160,True,0,2 user reviews,0,2,2
1259170,True,0,No user reviews,0,0,0
1259180,True,0,No user reviews,0,0,0
1259200,True,0,No user reviews,0,0,0
1259220,True,0,No user reviews,0,0,0
1259230,True,0,No user reviews,0,0,0
1259270,True,0,No user reviews,0,0,0
1259280,True,0,No user reviews,0,0,0
1259290,True,0,1 user reviews,0,1,1
1259300,True,0,No user reviews,0,0,0
1259310,True,0,4 user reviews,4,0,4
1259320,True,0,No user reviews,0,0,0
1259330,True,0,2 user reviews,2,0,2
1259340,True,0,1 user reviews,1,0,1
1259360,True,5,Mixed,252,256,508
1259370,True,0,2 user reviews,2,0,2
1259380,True,7,Positive,28,6,34
1259390,True,0,No user reviews,0,0,0
1259400,True,0,No user reviews,0,0,0
1259410,True,0,No user reviews,0,0,0
1259430,True,0,No user reviews,0,0,0
1259460,True,0,No user reviews,0,0,0
1259470,True,0,1 user reviews,1,0,1
1259480,True,0,1 user reviews,1,0,1
1259490,True,0,No user reviews,0,0,0
1259491,True,0,No user reviews,0,0,0
1259492,True,0,No user reviews,0,0,0
1259493,True,0,No user reviews,0,0,0
1259494,True,0,No user reviews,0,0,0
1259495,True,0,No user reviews,0,0,0
1259496,True,0,No user reviews,0,0,0
1259497,True,0,No user reviews,0,0,0
1259498,True,0,No user reviews,0,0,0
1259499,True,0,No user reviews,0,0,0
1259510,True,7,Positive,13,2,15
1259520,True,0,1 user reviews,0,1,1
1259530,True,7,Positive,23,2,25
1259560,True,8,Very Positive,279,41,320
1259570,True,0,1 user reviews,1,0,1
1259600,True,7,Positive,9,1,10
1259610,True,0,9 user reviews,6,3,9
1259640,True,0,No user reviews,0,0,0
1259650,True,0,2 user reviews,2,0,2
1259680,True,0,No user reviews,0,0,0
1259720,True,0,No user reviews,0,0,0
1259730,True,0,No user reviews,0,0,0
1259740,True,0,No user reviews,0,0,0
1259750,True,5,Mixed,8,8,16
1259790,True,0,No user reviews,0,0,0
1259800,True,0,No user reviews,0,0,0
1259830,True,0,No user reviews,0,0,0
1259840,True,8,Very Positive,133,14,147
1259860,True,0,1 user reviews,1,0,1
1259870,True,0,1 user reviews,1,0,1
1259890,True,0,3 user reviews,3,0,3
1259900,True,0,No user reviews,0,0,0
1259910,True,0,No user reviews,0,0,0
1259930,True,5,Mixed,43,20,63
1259950,True,0,No user reviews,0,0,0
1259960,True,7,Positive,12,0,12
1259970,True,6,Mostly Positive,793,201,994
1259980,True,5,Mixed,180,101,281
1259990,True,0,No user reviews,0,0,0
1260030,True,0,No user reviews,0,0,0
1260070,True,0,1 user reviews,1,0,1
1260110,True,0,No user reviews,0,0,0
1260130,True,0,No user reviews,0,0,0
1260150,True,0,No user reviews,0,0,0
1260160,True,0,1 user reviews,0,1,1
1260170,True,0,2 user reviews,2,0,2
1260200,True,0,No user reviews,0,0,0
1260220,True,0,5 user reviews,5,0,5
1260230,True,0,No user reviews,0,0,0
1260240,True,0,3 user reviews,1,2,3
1260250,True,0,1 user reviews,0,1,1
1260260,True,0,No user reviews,0,0,0
1260270,True,0,No user reviews,0,0,0
1260290,True,0,No user reviews,0,0,0
1260300,True,0,2 user reviews,1,1,2
1260310,True,0,7 user reviews,5,2,7
1260320,True,0,No user reviews,0,0,0
1260340,True,0,No user reviews,0,0,0
1260350,True,0,No user reviews,0,0,0
1260370,True,0,No user reviews,0,0,0
1260390,True,8,Very Positive,64,16,80
1260400,True,0,No user reviews,0,0,0
1260430,True,0,No user reviews,0,0,0
1260440,True,4,Mostly Negative,4,7,11
1260470,True,0,No user reviews,0,0,0
1260490,True,0,3 user reviews,3,0,3
1260510,True,7,Positive,10,0,10
1260520,True,0,No user reviews,0,0,0
1260540,True,0,No user reviews,0,0,0
1260550,True,0,No user reviews,0,0,0
1260560,True,0,No user reviews,0,0,0
1260570,True,0,No user reviews,0,0,0
1260580,True,7,Positive,10,0,10
1260590,True,0,No user reviews,0,0,0
1260620,True,0,2 user reviews,2,0,2
1260630,True,0,No user reviews,0,0,0
1260640,True,0,No user reviews,0,0,0
1260650,True,0,No user reviews,0,0,0
1260670,True,7,Positive,21,2,23
1260680,True,0,2 user reviews,2,0,2
1260690,True,0,2 user reviews,2,0,2
1260700,True,0,8 user reviews,7,1,8
1260710,True,7,Positive,21,4,25
1260720,True,0,1 user reviews,0,1,1
1260760,True,0,No user reviews,0,0,0
1260770,True,0,4 user reviews,3,1,4
1260780,True,0,No user reviews,0,0,0
1260800,True,6,Mostly Positive,13,4,17
1260810,True,7,Positive,18,0,18
1260820,True,8,Very Positive,114,8,122
1260830,True,0,No user reviews,0,0,0
1260840,True,0,2 user reviews,1,1,2
1260860,True,0,4 user reviews,2,2,4
1260870,True,0,No user reviews,0,0,0
1260900,True,0,No user reviews,0,0,0
1260910,True,0,3 user reviews,1,2,3
1260930,True,0,No user reviews,0,0,0
1260940,True,0,No user reviews,0,0,0
1260950,True,0,No user reviews,0,0,0
1260960,True,0,No user reviews,0,0,0
1260970,True,0,No user reviews,0,0,0
1260980,True,0,No user reviews,0,0,0
1261000,True,0,No user reviews,0,0,0
1261010,True,0,8 user reviews,7,1,8
1261020,True,0,2 user reviews,2,0,2
1261040,True,8,Very Positive,186,39,225
1261050,True,0,No user reviews,0,0,0
1261060,True,0,9 user reviews,7,2,9
1261070,True,0,No user reviews,0,0,0
1261090,True,0,4 user reviews,3,1,4
1261120,True,0,3 user reviews,3,0,3
1261130,True,0,6 user reviews,4,2,6
1261160,True,0,No user reviews,0,0,0
1261170,True,0,3 user reviews,3,0,3
1261180,True,0,No user reviews,0,0,0
1261190,True,0,2 user reviews,2,0,2
1261240,True,0,No user reviews,0,0,0
1261250,True,0,2 user reviews,2,0,2
1261280,True,0,1 user reviews,1,0,1
1261290,True,0,No user reviews,0,0,0
1261300,True,0,No user reviews,0,0,0
1261310,True,0,No user reviews,0,0,0
1261330,True,0,No user reviews,0,0,0
1261380,True,0,No user reviews,0,0,0
1261390,True,0,No user reviews,0,0,0
1261420,True,0,No user reviews,0,0,0
1261460,True,0,No user reviews,0,0,0
1261490,True,0,No user reviews,0,0,0
1261500,True,0,2 user reviews,2,0,2
1261510,True,0,1 user reviews,0,1,1
1261520,True,0,9 user reviews,3,6,9
1261530,True,0,No user reviews,0,0,0
1261540,True,0,No user reviews,0,0,0
1261541,True,0,No user reviews,0,0,0
1261542,True,0,No user reviews,0,0,0
1261560,True,0,No user reviews,0,0,0
1261570,True,0,5 user reviews,4,1,5
1261600,True,0,No user reviews,0,0,0
1261630,True,0,4 user reviews,4,0,4
1261640,True,0,9 user reviews,8,1,9
1261650,True,0,No user reviews,0,0,0
1261660,True,0,1 user reviews,1,0,1
1261670,True,7,Positive,8,2,10
1261680,True,0,No user reviews,0,0,0
1261690,True,0,No user reviews,0,0,0
1261691,True,0,No user reviews,0,0,0
1261692,True,0,2 user reviews,2,0,2
1261693,True,0,No user reviews,0,0,0
1261700,True,7,Positive,38,0,38
1261710,True,0,No user reviews,0,0,0
1261711,True,0,No user reviews,0,0,0
1261712,True,0,No user reviews,0,0,0
1261713,True,0,No user reviews,0,0,0
1261714,True,0,No user reviews,0,0,0
1261715,True,0,No user reviews,0,0,0
1261716,True,0,No user reviews,0,0,0
1261717,True,0,No user reviews,0,0,0
1261720,True,0,No user reviews,0,0,0
1261750,True,0,3 user reviews,3,0,3
1261760,True,7,Positive,31,2,33
1261790,True,0,No user reviews,0,0,0
1261800,True,0,No user reviews,0,0,0
1261810,True,0,No user reviews,0,0,0
1261820,True,0,1 user reviews,1,0,1
1261840,True,0,No user reviews,0,0,0
1261860,True,0,4 user reviews,4,0,4
1261861,True,0,No user reviews,0,0,0
1261880,True,5,Mixed,15,11,26
1261890,True,0,No user reviews,0,0,0
1261900,True,0,2 user reviews,2,0,2
1261910,True,7,Positive,14,0,14
1261930,True,0,No user reviews,0,0,0
1261960,True,7,Positive,16,1,17
1261970,True,7,Positive,12,1,13
1261980,True,0,2 user reviews,2,0,2
1261990,True,5,Mixed,8,4,12
1262000,True,0,7 user reviews,6,1,7
1262010,True,0,No user reviews,0,0,0
1262040,True,0,No user reviews,0,0,0
1262060,True,0,6 user reviews,6,0,6
1262070,True,0,1 user reviews,1,0,1
1262080,True,0,No user reviews,0,0,0
1262090,True,0,No user reviews,0,0,0
1262100,True,0,1 user reviews,0,1,1
1262110,True,5,Mixed,7,7,14
1262120,True,0,5 user reviews,3,2,5
1262130,True,0,No user reviews,0,0,0
1262140,True,0,No user reviews,0,0,0
1262170,True,0,No user reviews,0,0,0
1262190,True,0,No user reviews,0,0,0
1262200,True,0,2 user reviews,1,1,2
1262220,True,0,1 user reviews,1,0,1
1262240,True,6,Mostly Positive,284,109,393
1262250,True,0,No user reviews,0,0,0
1262260,True,0,1 user reviews,1,0,1
1262302,True,0,No user reviews,0,0,0
1262303,True,0,No user reviews,0,0,0
1262304,True,0,No user reviews,0,0,0
1262340,True,0,No user reviews,0,0,0
1262341,True,0,No user reviews,0,0,0
1262342,True,0,No user reviews,0,0,0
1262343,True,0,No user reviews,0,0,0
1262344,True,0,No user reviews,0,0,0
1262345,True,0,No user reviews,0,0,0
1262346,True,0,No user reviews,0,0,0
1262347,True,0,No user reviews,0,0,0
1262348,True,0,No user reviews,0,0,0
1262349,True,0,No user reviews,0,0,0
1262350,True,0,No user reviews,0,0,0
1262370,True,0,No user reviews,0,0,0
1262371,True,0,No user reviews,0,0,0
1262372,True,0,No user reviews,0,0,0
1262373,True,0,No user reviews,0,0,0
1262374,True,0,No user reviews,0,0,0
1262375,True,0,No user reviews,0,0,0
1262376,True,0,No user reviews,0,0,0
1262377,True,0,No user reviews,0,0,0
1262378,True,0,No user reviews,0,0,0
1262379,True,0,No user reviews,0,0,0
1262380,True,0,No user reviews,0,0,0
1262390,True,0,No user reviews,0,0,0
1262391,True,0,No user reviews,0,0,0
1262392,True,0,No user reviews,0,0,0
1262393,True,0,No user reviews,0,0,0
1262394,True,0,No user reviews,0,0,0
1262395,True,0,No user reviews,0,0,0
1262396,True,0,No user reviews,0,0,0
1262397,True,0,1 user reviews,0,1,1
1262398,True,0,1 user reviews,0,1,1
1262399,True,0,No user reviews,0,0,0
1262400,True,0,No user reviews,0,0,0
1262401,True,0,No user reviews,0,0,0
1262402,True,0,No user reviews,0,0,0
1262403,True,0,No user reviews,0,0,0
1262404,True,0,No user reviews,0,0,0
1262405,True,0,No user reviews,0,0,0
1262406,True,0,No user reviews,0,0,0
1262407,True,0,No user reviews,0,0,0
1262408,True,0,No user reviews,0,0,0
1262409,True,0,No user reviews,0,0,0
1262410,True,0,1 user reviews,0,1,1
1262411,True,0,No user reviews,0,0,0
1262412,True,0,No user reviews,0,0,0
1262413,True,0,1 user reviews,0,1,1
1262414,True,0,No user reviews,0,0,0
1262415,True,0,No user reviews,0,0,0
1262416,True,0,No user reviews,0,0,0
1262417,True,0,1 user reviews,1,0,1
1262418,True,0,No user reviews,0,0,0
1262419,True,0,No user reviews,0,0,0
1262420,True,0,No user reviews,0,0,0
1262421,True,0,No user reviews,0,0,0
1262422,True,0,No user reviews,0,0,0
1262423,True,0,1 user reviews,1,0,1
1262424,True,0,No user reviews,0,0,0
1262425,True,0,No user reviews,0,0,0
1262426,True,0,No user reviews,0,0,0
1262427,True,0,No user reviews,0,0,0
1262428,True,0,No user reviews,0,0,0
1262429,True,0,No user reviews,0,0,0
1262430,True,0,No user reviews,0,0,0
1262431,True,0,No user reviews,0,0,0
1262432,True,0,No user reviews,0,0,0
1262433,True,0,No user reviews,0,0,0
1262434,True,0,No user reviews,0,0,0
1262435,True,0,No user reviews,0,0,0
1262436,True,0,No user reviews,0,0,0
1262437,True,0,No user reviews,0,0,0
1262438,True,0,No user reviews,0,0,0
1262439,True,0,1 user reviews,1,0,1
1262450,True,0,No user reviews,0,0,0
1262460,True,8,Very Positive,104,17,121
1262470,True,0,4 user reviews,1,3,4
1262480,True,0,No user reviews,0,0,0
1262500,True,0,No user reviews,0,0,0
1262540,True,5,Mixed,590,375,965
1262550,True,0,No user reviews,0,0,0
1262560,True,6,Mostly Positive,424,173,597
1262570,True,0,No user reviews,0,0,0
1262571,True,0,1 user reviews,1,0,1
1262572,True,0,1 user reviews,1,0,1
1262573,True,0,No user reviews,0,0,0
1262580,True,8,Very Positive,352,54,406
1262600,True,5,Mixed,200,88,288
1262610,True,0,No user reviews,0,0,0
1262640,True,5,Mixed,14,7,21
1262660,True,0,No user reviews,0,0,0
1262670,True,5,Mixed,11,8,19
1262680,True,0,No user reviews,0,0,0
1262700,True,0,No user reviews,0,0,0
1262710,True,0,No user reviews,0,0,0
1262720,True,0,No user reviews,0,0,0
1262730,True,0,No user reviews,0,0,0
1262740,True,0,No user reviews,0,0,0
1262741,True,0,No user reviews,0,0,0
1262742,True,0,No user reviews,0,0,0
1262743,True,0,No user reviews,0,0,0
1262760,True,0,No user reviews,0,0,0
1262770,True,0,3 user reviews,1,2,3
1262780,True,0,2 user reviews,2,0,2
1262790,True,0,No user reviews,0,0,0
1262800,True,0,No user reviews,0,0,0
1262820,True,0,1 user reviews,1,0,1
1262830,True,0,1 user reviews,0,1,1
1262880,True,0,No user reviews,0,0,0
1262890,True,0,5 user reviews,5,0,5
1262900,True,0,No user reviews,0,0,0
1262910,True,5,Mixed,10,12,22
1262920,True,0,No user reviews,0,0,0
1262950,True,0,No user reviews,0,0,0
1262980,True,0,No user reviews,0,0,0
1262981,True,0,No user reviews,0,0,0
1263000,True,0,No user reviews,0,0,0
1263020,True,0,No user reviews,0,0,0
1263030,True,0,No user reviews,0,0,0
1263040,True,0,No user reviews,0,0,0
1263050,True,0,No user reviews,0,0,0
1263070,True,6,Mostly Positive,210,82,292
1263080,True,0,5 user reviews,5,0,5
1263090,True,0,No user reviews,0,0,0
1263110,True,0,1 user reviews,0,1,1
1263120,True,0,3 user reviews,2,1,3
1263130,True,0,5 user reviews,1,4,5
1263160,True,8,Very Positive,71,3,74
1263170,True,0,No user reviews,0,0,0
1263200,True,0,7 user reviews,6,1,7
1263220,True,0,No user reviews,0,0,0
1263230,True,0,No user reviews,0,0,0
1263250,True,0,1 user reviews,1,0,1
1263260,True,0,No user reviews,0,0,0
1263270,True,0,No user reviews,0,0,0
1263280,True,0,No user reviews,0,0,0
1263290,True,0,No user reviews,0,0,0
1263300,True,0,No user reviews,0,0,0
1263310,True,0,No user reviews,0,0,0
1263360,True,0,No user reviews,0,0,0
1263370,True,5,Mixed,21,16,37
1263380,True,0,No user reviews,0,0,0
1263410,True,0,3 user reviews,2,1,3
1263450,True,0,No user reviews,0,0,0
1263470,True,0,No user reviews,0,0,0
1263480,True,0,No user reviews,0,0,0
1263490,True,0,3 user reviews,2,1,3
1263500,True,0,No user reviews,0,0,0
1263510,True,0,No user reviews,0,0,0
1263520,True,0,1 user reviews,1,0,1
1263550,True,0,No user reviews,0,0,0
1263590,True,0,No user reviews,0,0,0
1263610,True,0,No user reviews,0,0,0
1263620,True,0,No user reviews,0,0,0
1263630,True,0,No user reviews,0,0,0
1263670,True,0,No user reviews,0,0,0
1263680,True,0,2 user reviews,2,0,2
1263700,True,0,9 user reviews,8,1,9
1263720,True,0,3 user reviews,3,0,3
1263740,True,0,No user reviews,0,0,0
1263760,True,0,No user reviews,0,0,0
1263780,True,0,4 user reviews,0,4,4
1263800,True,0,No user reviews,0,0,0
1263810,True,0,No user reviews,0,0,0
1263820,True,7,Positive,9,1,10
1263830,True,7,Positive,46,1,47
1263840,True,7,Positive,9,2,11
1263870,True,0,No user reviews,0,0,0
1263910,True,0,No user reviews,0,0,0
1263920,True,0,2 user reviews,1,1,2
1263950,True,0,No user reviews,0,0,0
1263990,True,0,No user reviews,0,0,0
1264000,True,0,No user reviews,0,0,0
1264010,True,0,4 user reviews,4,0,4
1264040,True,0,2 user reviews,2,0,2
1264050,True,0,No user reviews,0,0,0
1264070,True,0,No user reviews,0,0,0
1264080,True,0,2 user reviews,1,1,2
1264090,True,0,3 user reviews,3,0,3
1264101,True,0,No user reviews,0,0,0
1264102,True,0,No user reviews,0,0,0
1264103,True,0,No user reviews,0,0,0
1264104,True,0,No user reviews,0,0,0
1264105,True,0,No user reviews,0,0,0
1264106,True,0,No user reviews,0,0,0
1264110,True,0,No user reviews,0,0,0
1264111,True,0,No user reviews,0,0,0
1264112,True,0,No user reviews,0,0,0
1264113,True,0,No user reviews,0,0,0
1264114,True,0,No user reviews,0,0,0
1264140,True,0,No user reviews,0,0,0
1264150,True,0,No user reviews,0,0,0
1264160,True,7,Positive,16,3,19
1264170,True,0,4 user reviews,4,0,4
1264171,True,0,2 user reviews,1,1,2
1264180,True,7,Positive,20,2,22
1264190,True,0,3 user reviews,2,1,3
1264220,True,0,No user reviews,0,0,0
1264230,True,0,No user reviews,0,0,0
1264240,True,0,No user reviews,0,0,0
1264250,True,5,Mixed,189,103,292
1264260,True,0,No user reviews,0,0,0
1264290,True,0,No user reviews,0,0,0
1264310,True,0,1 user reviews,1,0,1
1264340,True,5,Mixed,14,10,24
1264350,True,0,No user reviews,0,0,0
1264390,True,0,No user reviews,0,0,0
1264410,True,0,1 user reviews,1,0,1
1264470,True,0,No user reviews,0,0,0
1264500,True,0,No user reviews,0,0,0
1264510,True,0,1 user reviews,0,1,1
1264520,True,8,Very Positive,110,1,111
1264530,True,0,No user reviews,0,0,0
1264540,True,0,No user reviews,0,0,0
1264550,True,0,No user reviews,0,0,0
1264590,True,0,2 user reviews,1,1,2
1264610,True,0,No user reviews,0,0,0
1264620,True,0,No user reviews,0,0,0
1264630,True,0,1 user reviews,0,1,1
1264640,True,0,1 user reviews,0,1,1
1264670,True,6,Mostly Positive,51,13,64
1264690,True,0,No user reviews,0,0,0
1264700,True,0,1 user reviews,0,1,1
1264710,True,8,Very Positive,56,8,64
1264730,True,0,5 user reviews,5,0,5
1264740,True,0,No user reviews,0,0,0
1264760,True,0,6 user reviews,4,2,6
1264770,True,7,Positive,12,1,13
1264780,True,0,No user reviews,0,0,0
1264790,True,0,No user reviews,0,0,0
1264800,True,0,3 user reviews,1,2,3
1264810,True,0,No user reviews,0,0,0
1264820,True,0,1 user reviews,1,0,1
1264830,True,0,No user reviews,0,0,0
1264840,True,0,No user reviews,0,0,0
1264850,True,0,3 user reviews,3,0,3
1264860,True,0,No user reviews,0,0,0
1264890,True,0,1 user reviews,0,1,1
1264900,True,0,2 user reviews,2,0,2
1264920,True,0,No user reviews,0,0,0
1264930,True,0,6 user reviews,5,1,6
1264940,True,0,No user reviews,0,0,0
1264950,True,0,No user reviews,0,0,0
1264960,True,0,No user reviews,0,0,0
1264970,True,0,No user reviews,0,0,0
1264980,True,0,No user reviews,0,0,0
1264990,True,0,No user reviews,0,0,0
1265030,True,0,8 user reviews,3,5,8
1265060,True,0,No user reviews,0,0,0
1265061,True,0,No user reviews,0,0,0
1265070,True,0,3 user reviews,2,1,3
1265080,True,0,2 user reviews,2,0,2
1265090,True,0,No user reviews,0,0,0
1265100,True,0,No user reviews,0,0,0
1265110,True,0,No user reviews,0,0,0
1265120,True,0,6 user reviews,6,0,6
1265130,True,0,No user reviews,0,0,0
1265140,True,0,2 user reviews,2,0,2
1265170,True,0,2 user reviews,0,2,2
1265200,True,0,5 user reviews,4,1,5
1265220,True,7,Positive,23,2,25
1265230,True,0,No user reviews,0,0,0
1265240,True,0,8 user reviews,7,1,8
1265250,True,0,No user reviews,0,0,0
1265260,True,0,1 user reviews,1,0,1
1265270,True,0,No user reviews,0,0,0
1265280,True,0,No user reviews,0,0,0
1265300,True,0,No user reviews,0,0,0
1265310,True,0,No user reviews,0,0,0
1265330,True,0,No user reviews,0,0,0
1265350,True,0,No user reviews,0,0,0
1265360,True,0,9 user reviews,6,3,9
1265390,True,0,4 user reviews,2,2,4
1265400,True,0,No user reviews,0,0,0
1265410,True,0,6 user reviews,1,5,6
1265440,True,0,No user reviews,0,0,0
1265450,True,0,No user reviews,0,0,0
1265460,True,0,2 user reviews,2,0,2
1265470,True,0,6 user reviews,4,2,6
1265471,True,0,1 user reviews,1,0,1
1265472,True,0,2 user reviews,2,0,2
1265473,True,0,1 user reviews,1,0,1
1265474,True,0,1 user reviews,1,0,1
1265475,True,0,2 user reviews,2,0,2
1265476,True,0,2 user reviews,2,0,2
1265490,True,0,No user reviews,0,0,0
1265500,True,0,No user reviews,0,0,0
1265510,True,0,No user reviews,0,0,0
1265560,True,0,No user reviews,0,0,0
1265570,True,0,1 user reviews,0,1,1
1265580,True,0,1 user reviews,1,0,1
1265600,True,0,No user reviews,0,0,0
1265610,True,0,No user reviews,0,0,0
1265620,True,0,8 user reviews,6,2,8
1265640,True,7,Positive,16,2,18
1265650,True,0,No user reviews,0,0,0
1265660,True,0,No user reviews,0,0,0
1265670,True,0,No user reviews,0,0,0
1265680,True,0,No user reviews,0,0,0
1265690,True,0,5 user reviews,5,0,5
1265700,True,0,No user reviews,0,0,0
1265710,True,0,No user reviews,0,0,0
1265730,True,0,No user reviews,0,0,0
1265760,True,0,No user reviews,0,0,0
1265770,True,0,1 user reviews,1,0,1
1265810,True,0,No user reviews,0,0,0
1265820,True,0,No user reviews,0,0,0
1265840,True,0,No user reviews,0,0,0
1265850,True,7,Positive,38,1,39
1265860,True,5,Mixed,95,62,157
1265870,True,0,4 user reviews,2,2,4
1265880,True,0,No user reviews,0,0,0
1265960,True,0,8 user reviews,5,3,8
1265970,True,0,2 user reviews,2,0,2
1265990,True,0,No user reviews,0,0,0
1266000,True,0,No user reviews,0,0,0
1266010,True,0,No user reviews,0,0,0
1266020,True,0,No user reviews,0,0,0
1266050,True,0,1 user reviews,1,0,1
1266070,True,0,No user reviews,0,0,0
1266100,True,0,No user reviews,0,0,0
1266120,True,0,No user reviews,0,0,0
1266130,True,0,2 user reviews,2,0,2
1266140,True,6,Mostly Positive,8,3,11
1266210,True,0,No user reviews,0,0,0
1266220,True,5,Mixed,40,23,63
1266230,True,0,2 user reviews,2,0,2
1266250,True,0,No user reviews,0,0,0
1266260,True,0,No user reviews,0,0,0
1266370,True,7,Positive,8,2,10
1266380,True,0,3 user reviews,3,0,3
1266390,True,0,No user reviews,0,0,0
1266400,True,0,6 user reviews,5,1,6
1266410,True,0,1 user reviews,1,0,1
1266420,True,7,Positive,13,2,15
1266440,True,0,No user reviews,0,0,0
1266450,True,0,No user reviews,0,0,0
1266470,True,0,No user reviews,0,0,0
1266480,True,0,2 user reviews,2,0,2
1266500,True,0,No user reviews,0,0,0
1266501,True,0,No user reviews,0,0,0
1266502,True,0,No user reviews,0,0,0
1266503,True,0,No user reviews,0,0,0
1266510,True,0,No user reviews,0,0,0
1266520,True,0,No user reviews,0,0,0
1266560,True,0,No user reviews,0,0,0
1266580,True,0,1 user reviews,0,1,1
1266600,True,7,Positive,13,3,16
1266610,True,0,No user reviews,0,0,0
1266620,True,0,No user reviews,0,0,0
1266640,True,0,No user reviews,0,0,0
1266650,True,0,2 user reviews,1,1,2
1266660,True,0,No user reviews,0,0,0
1266670,True,0,1 user reviews,1,0,1
1266680,True,5,Mixed,8,4,12
1266690,True,0,No user reviews,0,0,0
1266710,True,0,No user reviews,0,0,0
1266711,True,0,No user reviews,0,0,0
1266712,True,0,No user reviews,0,0,0
1266713,True,0,No user reviews,0,0,0
1266714,True,0,No user reviews,0,0,0
1266715,True,0,No user reviews,0,0,0
1266716,True,0,No user reviews,0,0,0
1266717,True,0,No user reviews,0,0,0
1266718,True,0,No user reviews,0,0,0
1266719,True,0,No user reviews,0,0,0
1266720,True,0,No user reviews,0,0,0
1266740,True,0,No user reviews,0,0,0
1266750,True,0,No user reviews,0,0,0
1266760,True,0,No user reviews,0,0,0
1266770,True,0,No user reviews,0,0,0
1266800,True,7,Positive,32,2,34
1266820,True,0,No user reviews,0,0,0
1266840,True,0,No user reviews,0,0,0
1266860,True,7,Positive,11,0,11
1266890,True,0,No user reviews,0,0,0
1266900,True,0,No user reviews,0,0,0
1266940,True,0,No user reviews,0,0,0
1266970,True,0,No user reviews,0,0,0
1266980,True,0,No user reviews,0,0,0
1267010,True,0,6 user reviews,4,2,6
1267030,True,0,No user reviews,0,0,0
1267040,True,0,No user reviews,0,0,0
1267060,True,0,No user reviews,0,0,0
1267070,True,0,No user reviews,0,0,0
1267080,True,0,No user reviews,0,0,0
1267090,True,0,No user reviews,0,0,0
1267091,True,0,No user reviews,0,0,0
1267092,True,0,No user reviews,0,0,0
1267093,True,0,No user reviews,0,0,0
1267094,True,0,No user reviews,0,0,0
1267095,True,0,No user reviews,0,0,0
1267097,True,0,No user reviews,0,0,0
1267098,True,0,No user reviews,0,0,0
1267099,True,0,No user reviews,0,0,0
1267100,True,0,No user reviews,0,0,0
1267101,True,0,No user reviews,0,0,0
1267102,True,0,No user reviews,0,0,0
1267103,True,0,No user reviews,0,0,0
1267104,True,0,No user reviews,0,0,0
1267105,True,0,No user reviews,0,0,0
1267106,True,0,No user reviews,0,0,0
1267120,True,0,No user reviews,0,0,0
1267130,True,7,Positive,10,0,10
1267140,True,0,No user reviews,0,0,0
1267150,True,0,No user reviews,0,0,0
1267170,True,0,No user reviews,0,0,0
1267190,True,0,No user reviews,0,0,0
1267200,True,0,No user reviews,0,0,0
1267210,True,0,No user reviews,0,0,0
1267230,True,0,No user reviews,0,0,0
1267240,True,0,No user reviews,0,0,0
1267260,True,0,6 user reviews,6,0,6
1267270,True,0,2 user reviews,2,0,2
1267300,True,0,No user reviews,0,0,0
1267310,True,5,Mixed,15,7,22
1267320,True,0,No user reviews,0,0,0
1267330,True,0,No user reviews,0,0,0
1267340,True,0,2 user reviews,2,0,2
1267341,True,0,No user reviews,0,0,0
1267342,True,0,No user reviews,0,0,0
1267343,True,0,No user reviews,0,0,0
1267344,True,0,No user reviews,0,0,0
1267345,True,0,No user reviews,0,0,0
1267346,True,0,No user reviews,0,0,0
1267360,True,0,No user reviews,0,0,0
1267361,True,0,No user reviews,0,0,0
1267362,True,0,No user reviews,0,0,0
1267363,True,0,No user reviews,0,0,0
1267364,True,0,No user reviews,0,0,0
1267365,True,0,No user reviews,0,0,0
1267370,True,0,4 user reviews,3,1,4
1267380,True,0,No user reviews,0,0,0
1267381,True,0,No user reviews,0,0,0
1267382,True,0,No user reviews,0,0,0
1267383,True,0,No user reviews,0,0,0
1267384,True,0,No user reviews,0,0,0
1267400,True,0,2 user reviews,2,0,2
1267410,True,0,2 user reviews,2,0,2
1267420,True,0,No user reviews,0,0,0
1267430,True,0,No user reviews,0,0,0
1267440,True,0,No user reviews,0,0,0
1267450,True,0,No user reviews,0,0,0
1267460,True,0,No user reviews,0,0,0
1267470,True,8,Very Positive,70,4,74
1267480,True,0,No user reviews,0,0,0
1267490,True,0,No user reviews,0,0,0
1267500,True,0,1 user reviews,1,0,1
1267501,True,0,No user reviews,0,0,0
1267502,True,0,6 user reviews,6,0,6
1267503,True,0,4 user reviews,2,2,4
1267504,True,0,1 user reviews,1,0,1
1267505,True,0,1 user reviews,1,0,1
1267506,True,0,3 user reviews,1,2,3
1267507,True,0,9 user reviews,5,4,9
1267509,True,7,Positive,13,1,14
1267510,True,0,No user reviews,0,0,0
1267520,True,0,No user reviews,0,0,0
1267570,True,0,No user reviews,0,0,0
1267580,True,0,No user reviews,0,0,0
1267590,True,0,8 user reviews,2,6,8
1267591,True,0,4 user reviews,0,4,4
1267592,True,0,6 user reviews,2,4,6
1267593,True,0,4 user reviews,0,4,4
1267594,True,0,6 user reviews,1,5,6
1267600,True,0,No user reviews,0,0,0
1267610,True,0,No user reviews,0,0,0
1267670,True,0,No user reviews,0,0,0
1267680,True,0,No user reviews,0,0,0
1267690,True,0,No user reviews,0,0,0
1267710,True,0,No user reviews,0,0,0
1267770,True,0,No user reviews,0,0,0
1267780,True,0,No user reviews,0,0,0
1267790,True,0,1 user reviews,1,0,1
1267800,True,0,1 user reviews,1,0,1
1267801,True,0,1 user reviews,1,0,1
1267810,True,8,Very Positive,81,6,87
1267830,True,0,7 user reviews,5,2,7
1267860,True,0,6 user reviews,4,2,6
1267870,True,0,8 user reviews,8,0,8
1267880,True,0,No user reviews,0,0,0
1267900,True,0,1 user reviews,0,1,1
1267920,True,0,1 user reviews,1,0,1
1267940,True,0,2 user reviews,1,1,2
1267950,True,0,1 user reviews,1,0,1
1267960,True,0,No user reviews,0,0,0
1268000,True,0,No user reviews,0,0,0
1268010,True,0,No user reviews,0,0,0
1268040,True,6,Mostly Positive,23,7,30
1268050,True,0,No user reviews,0,0,0
1268060,True,0,No user reviews,0,0,0
1268080,True,0,No user reviews,0,0,0
1268090,True,0,No user reviews,0,0,0
1268100,True,0,1 user reviews,1,0,1
1268110,True,8,Very Positive,111,19,130
1268120,True,0,No user reviews,0,0,0
1268130,True,0,No user reviews,0,0,0
1268140,True,0,1 user reviews,1,0,1
1268150,True,0,5 user reviews,3,2,5
1268160,True,0,1 user reviews,0,1,1
1268170,True,0,No user reviews,0,0,0
1268190,True,0,1 user reviews,0,1,1
1268200,True,0,No user reviews,0,0,0
1268210,True,0,No user reviews,0,0,0
1268220,True,0,No user reviews,0,0,0
1268250,True,5,Mixed,10,5,15
1268270,True,0,No user reviews,0,0,0
1268280,True,0,1 user reviews,0,1,1
1268290,True,6,Mostly Positive,9,3,12
1268320,True,0,No user reviews,0,0,0
1268330,True,0,2 user reviews,1,1,2
1268350,True,7,Positive,23,5,28
1268360,True,0,No user reviews,0,0,0
1268370,True,7,Positive,31,2,33
1268380,True,7,Positive,8,2,10
1268390,True,0,No user reviews,0,0,0
1268391,True,0,No user reviews,0,0,0
1268400,True,0,4 user reviews,2,2,4
1268410,True,0,7 user reviews,2,5,7
1268440,True,0,No user reviews,0,0,0
1268450,True,0,No user reviews,0,0,0
1268460,True,0,1 user reviews,1,0,1
1268470,True,0,No user reviews,0,0,0
1268480,True,0,No user reviews,0,0,0
1268500,True,0,No user reviews,0,0,0
1268520,True,0,No user reviews,0,0,0
1268530,True,6,Mostly Positive,9,3,12
1268540,True,0,1 user reviews,1,0,1
1268570,True,0,3 user reviews,1,2,3
1268580,True,0,No user reviews,0,0,0
1268610,True,0,No user reviews,0,0,0
1268620,True,0,No user reviews,0,0,0
1268700,True,0,1 user reviews,1,0,1
1268710,True,0,No user reviews,0,0,0
1268720,True,0,No user reviews,0,0,0
1268730,True,0,No user reviews,0,0,0
1268740,True,0,No user reviews,0,0,0
1268790,True,0,No user reviews,0,0,0
1268800,True,0,No user reviews,0,0,0
1268810,True,0,No user reviews,0,0,0
1268820,True,0,No user reviews,0,0,0
1268821,True,0,No user reviews,0,0,0
1268830,True,0,1 user reviews,1,0,1
1268840,True,0,No user reviews,0,0,0
1268850,True,0,1 user reviews,1,0,1
1268860,True,0,7 user reviews,7,0,7
1268870,True,0,7 user reviews,6,1,7
1268880,True,0,No user reviews,0,0,0
1268890,True,0,No user reviews,0,0,0
1268900,True,0,No user reviews,0,0,0
1268930,True,0,No user reviews,0,0,0
1268940,True,0,No user reviews,0,0,0
1268950,True,0,No user reviews,0,0,0
1268960,True,0,No user reviews,0,0,0
1268970,True,0,No user reviews,0,0,0
1268980,True,0,No user reviews,0,0,0
1268990,True,0,No user reviews,0,0,0
1269000,True,0,No user reviews,0,0,0
1269010,True,0,3 user reviews,3,0,3
1269020,True,0,No user reviews,0,0,0
1269030,True,0,3 user reviews,3,0,3
1269050,True,0,1 user reviews,0,1,1
1269120,True,0,5 user reviews,3,2,5
1269150,True,0,No user reviews,0,0,0
1269160,True,0,No user reviews,0,0,0
1269170,True,0,No user reviews,0,0,0
1269180,True,0,2 user reviews,2,0,2
1269190,True,0,3 user reviews,3,0,3
1269210,True,0,No user reviews,0,0,0
1269220,True,0,1 user reviews,1,0,1
1269221,True,0,1 user reviews,1,0,1
1269230,True,0,No user reviews,0,0,0
1269240,True,0,3 user reviews,3,0,3
1269250,True,0,No user reviews,0,0,0
1269260,True,0,No user reviews,0,0,0
1269300,True,0,No user reviews,0,0,0
1269320,True,0,7 user reviews,5,2,7
1269330,True,0,No user reviews,0,0,0
1269340,True,0,No user reviews,0,0,0
1269350,True,7,Positive,9,2,11
1269360,True,0,1 user reviews,1,0,1
1269370,True,0,No user reviews,0,0,0
1269380,True,0,No user reviews,0,0,0
1269400,True,0,No user reviews,0,0,0
1269430,True,0,No user reviews,0,0,0
1269440,True,0,3 user reviews,3,0,3
1269450,True,0,No user reviews,0,0,0
1269460,True,0,No user reviews,0,0,0
1269470,True,0,No user reviews,0,0,0
1269490,True,0,No user reviews,0,0,0
1269500,True,0,No user reviews,0,0,0
1269510,True,0,No user reviews,0,0,0
1269520,True,0,No user reviews,0,0,0
1269540,True,0,3 user reviews,2,1,3
1269550,True,0,No user reviews,0,0,0
1269560,True,0,3 user reviews,2,1,3
1269590,True,0,6 user reviews,6,0,6
1269600,True,0,No user reviews,0,0,0
1269610,True,0,No user reviews,0,0,0
1269630,True,0,No user reviews,0,0,0
1269640,True,0,No user reviews,0,0,0
1269650,True,0,3 user reviews,1,2,3
1269670,True,0,No user reviews,0,0,0
1269680,True,0,No user reviews,0,0,0
1269700,True,0,No user reviews,0,0,0
1269710,True,0,No user reviews,0,0,0
1269730,True,0,No user reviews,0,0,0
1269742,True,0,No user reviews,0,0,0
1269743,True,0,No user reviews,0,0,0
1269745,True,0,No user reviews,0,0,0
1269746,True,0,No user reviews,0,0,0
1269748,True,0,No user reviews,0,0,0
1269755,True,0,No user reviews,0,0,0
1269770,True,0,No user reviews,0,0,0
1269810,True,6,Mostly Positive,26,10,36
1269820,True,7,Positive,18,1,19
1269830,True,7,Positive,17,4,21
1269840,True,7,Positive,14,1,15
1269850,True,0,No user reviews,0,0,0
1269860,True,0,No user reviews,0,0,0
1269880,True,0,3 user reviews,3,0,3
1269890,True,0,No user reviews,0,0,0
1269900,True,0,No user reviews,0,0,0
1269910,True,0,No user reviews,0,0,0
1269930,True,0,No user reviews,0,0,0
1269940,True,0,1 user reviews,1,0,1
1269950,True,0,No user reviews,0,0,0
1269960,True,0,No user reviews,0,0,0
1269980,True,0,No user reviews,0,0,0
1269990,True,0,No user reviews,0,0,0
1270000,True,0,1 user reviews,1,0,1
1270010,True,5,Mixed,16,12,28
1270030,True,0,No user reviews,0,0,0
1270040,True,0,No user reviews,0,0,0
1270050,True,0,No user reviews,0,0,0
1270060,True,0,No user reviews,0,0,0
1270070,True,0,No user reviews,0,0,0
1270080,True,0,No user reviews,0,0,0
1270100,True,0,1 user reviews,1,0,1
1270120,True,0,No user reviews,0,0,0
1270130,True,0,No user reviews,0,0,0
1270140,True,0,No user reviews,0,0,0
1270180,True,0,No user reviews,0,0,0
1270210,True,0,No user reviews,0,0,0
1270240,True,0,No user reviews,0,0,0
1270250,True,0,1 user reviews,1,0,1
1270260,True,0,No user reviews,0,0,0
1270280,True,0,No user reviews,0,0,0
1270290,True,0,6 user reviews,6,0,6
1270300,True,0,No user reviews,0,0,0
1270320,True,0,No user reviews,0,0,0
1270340,True,7,Positive,47,0,47
1270370,True,0,2 user reviews,1,1,2
1270390,True,0,9 user reviews,9,0,9
1270400,True,0,No user reviews,0,0,0
1270410,True,0,No user reviews,0,0,0
1270420,True,0,No user reviews,0,0,0
1270440,True,0,No user reviews,0,0,0
1270460,True,0,No user reviews,0,0,0
1270470,True,0,No user reviews,0,0,0
1270480,True,0,No user reviews,0,0,0
1270520,True,0,No user reviews,0,0,0
1270530,True,0,No user reviews,0,0,0
1270540,True,5,Mixed,20,13,33
1270570,True,7,Positive,10,0,10
1270590,True,7,Positive,27,1,28
1270600,True,0,No user reviews,0,0,0
1270620,True,7,Positive,11,0,11
1270630,True,0,No user reviews,0,0,0
1270640,True,0,No user reviews,0,0,0
1270650,True,0,2 user reviews,1,1,2
1270680,True,0,No user reviews,0,0,0
1270700,True,0,No user reviews,0,0,0
1270760,True,0,No user reviews,0,0,0
1270770,True,0,No user reviews,0,0,0
1270780,True,0,1 user reviews,1,0,1
1270790,True,0,No user reviews,0,0,0
1270820,True,0,1 user reviews,0,1,1
1270830,True,0,No user reviews,0,0,0
1270840,True,0,2 user reviews,0,2,2
1270850,True,7,Positive,17,1,18
1270860,True,0,1 user reviews,1,0,1
1270870,True,0,3 user reviews,3,0,3
1270930,True,8,Very Positive,47,3,50
1270950,True,0,2 user reviews,2,0,2
1270970,True,0,No user reviews,0,0,0
1270980,True,0,No user reviews,0,0,0
1271030,True,0,No user reviews,0,0,0
1271050,True,0,No user reviews,0,0,0
1271070,True,0,2 user reviews,1,1,2
1271080,True,5,Mixed,7,10,17
1271090,True,0,8 user reviews,8,0,8
1271110,True,0,No user reviews,0,0,0
1271130,True,0,No user reviews,0,0,0
1271131,True,0,No user reviews,0,0,0
1271132,True,0,No user reviews,0,0,0
1271133,True,0,No user reviews,0,0,0
1271140,True,0,No user reviews,0,0,0
1271170,True,0,No user reviews,0,0,0
1271190,True,5,Mixed,14,15,29
1271231,True,0,No user reviews,0,0,0
1271240,True,0,No user reviews,0,0,0
1271250,True,0,No user reviews,0,0,0
1271260,True,0,No user reviews,0,0,0
1271270,True,0,3 user reviews,3,0,3
1271280,True,7,Positive,39,2,41
1271300,True,0,2 user reviews,2,0,2
1271310,True,0,No user reviews,0,0,0
1271330,True,0,1 user reviews,1,0,1
1271340,True,0,No user reviews,0,0,0
1271350,True,0,No user reviews,0,0,0
1271360,True,0,No user reviews,0,0,0
1271370,True,0,No user reviews,0,0,0
1271371,True,0,No user reviews,0,0,0
1271380,True,0,No user reviews,0,0,0
1271400,True,0,No user reviews,0,0,0
1271420,True,0,1 user reviews,0,1,1
1271450,True,0,No user reviews,0,0,0
1271460,True,0,3 user reviews,2,1,3
1271470,True,0,No user reviews,0,0,0
1271490,True,0,No user reviews,0,0,0
1271500,True,0,1 user reviews,0,1,1
1271510,True,0,1 user reviews,1,0,1
1271520,True,0,No user reviews,0,0,0
1271530,True,0,6 user reviews,6,0,6
1271540,True,0,No user reviews,0,0,0
1271570,True,0,No user reviews,0,0,0
1271571,True,0,No user reviews,0,0,0
1271580,True,0,No user reviews,0,0,0
1271600,True,0,4 user reviews,3,1,4
1271620,True,0,4 user reviews,3,1,4
1271630,True,0,5 user reviews,4,1,5
1271670,True,0,9 user reviews,9,0,9
1271671,True,0,7 user reviews,7,0,7
1271680,True,0,1 user reviews,0,1,1
1271690,True,0,No user reviews,0,0,0
1271710,True,8,Very Positive,556,35,591
1271740,True,0,No user reviews,0,0,0
1271750,True,6,Mostly Positive,10,4,14
1271760,True,0,2 user reviews,2,0,2
1271780,True,0,No user reviews,0,0,0
1271792,True,7,Positive,11,1,12
1271793,True,0,No user reviews,0,0,0
1271794,True,0,No user reviews,0,0,0
1271800,True,0,No user reviews,0,0,0
1271820,True,0,No user reviews,0,0,0
1271840,True,0,1 user reviews,1,0,1
1271850,True,0,No user reviews,0,0,0
1271870,True,0,9 user reviews,0,9,9
1271880,True,0,No user reviews,0,0,0
1271900,True,0,No user reviews,0,0,0
1271910,True,0,1 user reviews,1,0,1
1271920,True,0,2 user reviews,1,1,2
1271930,True,0,No user reviews,0,0,0
1271950,True,0,No user reviews,0,0,0
1271980,True,0,5 user reviews,2,3,5
1271990,True,0,1 user reviews,1,0,1
1272000,True,0,No user reviews,0,0,0
1272010,True,0,No user reviews,0,0,0
1272020,True,0,No user reviews,0,0,0
1272030,True,0,No user reviews,0,0,0
1272040,True,0,No user reviews,0,0,0
1272050,True,0,No user reviews,0,0,0
1272060,True,0,2 user reviews,2,0,2
1272070,True,0,No user reviews,0,0,0
1272090,True,0,No user reviews,0,0,0
1272100,True,0,4 user reviews,4,0,4
1272110,True,0,9 user reviews,7,2,9
1272120,True,0,3 user reviews,3,0,3
1272130,True,0,8 user reviews,6,2,8
1272150,True,0,1 user reviews,1,0,1
1272160,True,0,No user reviews,0,0,0
1272170,True,0,No user reviews,0,0,0
1272180,True,0,No user reviews,0,0,0
1272200,True,0,No user reviews,0,0,0
1272210,True,0,1 user reviews,1,0,1
1272240,True,0,2 user reviews,2,0,2
1272270,True,0,No user reviews,0,0,0
1272280,True,0,No user reviews,0,0,0
1272290,True,0,No user reviews,0,0,0
1272300,True,0,No user reviews,0,0,0
1272310,True,0,No user reviews,0,0,0
1272320,True,0,No user reviews,0,0,0
1272330,True,0,1 user reviews,1,0,1
1272340,True,0,No user reviews,0,0,0
1272360,True,0,No user reviews,0,0,0
1272380,True,0,1 user reviews,0,1,1
1272381,True,0,1 user reviews,0,1,1
1272382,True,0,1 user reviews,1,0,1
1272383,True,0,1 user reviews,0,1,1
1272384,True,0,1 user reviews,1,0,1
1272385,True,0,1 user reviews,1,0,1
1272390,True,0,1 user reviews,0,1,1
1272430,True,0,No user reviews,0,0,0
1272440,True,0,2 user reviews,2,0,2
1272450,True,0,3 user reviews,2,1,3
1272460,True,0,No user reviews,0,0,0
1272480,True,0,No user reviews,0,0,0
1272481,True,0,No user reviews,0,0,0
1272490,True,0,No user reviews,0,0,0
1272500,True,0,No user reviews,0,0,0
1272520,True,0,No user reviews,0,0,0
1272530,True,0,2 user reviews,2,0,2
1272580,True,0,No user reviews,0,0,0
1272650,True,0,No user reviews,0,0,0
1272654,True,0,No user reviews,0,0,0
1272657,True,0,2 user reviews,1,1,2
1272660,True,0,No user reviews,0,0,0
1272680,True,0,2 user reviews,2,0,2
1272690,True,0,8 user reviews,7,1,8
1272710,True,0,No user reviews,0,0,0
1272720,True,0,No user reviews,0,0,0
1272730,True,0,No user reviews,0,0,0
1272750,True,0,No user reviews,0,0,0
1272770,True,0,No user reviews,0,0,0
1272790,True,0,1 user reviews,1,0,1
1272810,True,0,No user reviews,0,0,0
1272820,True,0,1 user reviews,0,1,1
1272830,True,0,No user reviews,0,0,0
1272840,True,0,No user reviews,0,0,0
1272850,True,0,1 user reviews,1,0,1
1272860,True,0,4 user reviews,4,0,4
1272880,True,0,No user reviews,0,0,0
1272900,True,0,No user reviews,0,0,0
1272910,True,0,No user reviews,0,0,0
1272920,True,0,2 user reviews,2,0,2
1272960,True,0,No user reviews,0,0,0
1272970,True,0,6 user reviews,5,1,6
1273000,True,0,No user reviews,0,0,0
1273010,True,0,No user reviews,0,0,0
1273020,True,0,3 user reviews,1,2,3
1273030,True,0,No user reviews,0,0,0
1273040,True,0,No user reviews,0,0,0
1273050,True,0,No user reviews,0,0,0
1273051,True,0,No user reviews,0,0,0
1273052,True,0,No user reviews,0,0,0
1273053,True,0,No user reviews,0,0,0
1273054,True,0,No user reviews,0,0,0
1273055,True,0,No user reviews,0,0,0
1273056,True,0,No user reviews,0,0,0
1273060,True,0,No user reviews,0,0,0
1273070,True,0,1 user reviews,1,0,1
1273080,True,0,No user reviews,0,0,0
1273090,True,0,No user reviews,0,0,0
1273100,True,0,No user reviews,0,0,0
1273120,True,0,No user reviews,0,0,0
1273130,True,0,No user reviews,0,0,0
1273140,True,0,No user reviews,0,0,0
1273150,True,0,1 user reviews,1,0,1
1273160,True,0,No user reviews,0,0,0
1273170,True,0,No user reviews,0,0,0
1273180,True,0,3 user reviews,1,2,3
1273190,True,0,No user reviews,0,0,0
1273200,True,0,No user reviews,0,0,0
1273220,True,0,No user reviews,0,0,0
1273250,True,7,Positive,27,0,27
1273270,True,0,No user reviews,0,0,0
1273290,True,0,No user reviews,0,0,0
1273300,True,0,No user reviews,0,0,0
1273320,True,0,6 user reviews,6,0,6
1273380,True,0,1 user reviews,0,1,1
1273390,True,6,Mostly Positive,9,3,12
1273430,True,0,1 user reviews,1,0,1
1273450,True,6,Mostly Positive,16,6,22
1273460,True,0,No user reviews,0,0,0
1273470,True,0,No user reviews,0,0,0
1273490,True,0,No user reviews,0,0,0
1273510,True,0,No user reviews,0,0,0
1273520,True,5,Mixed,8,4,12
1273530,True,0,No user reviews,0,0,0
1273540,True,0,No user reviews,0,0,0
1273550,True,0,No user reviews,0,0,0
1273570,True,0,No user reviews,0,0,0
1273580,True,0,No user reviews,0,0,0
1273590,True,0,7 user reviews,7,0,7
1273600,True,0,No user reviews,0,0,0
1273620,True,0,8 user reviews,5,3,8
1273630,True,0,3 user reviews,3,0,3
1273640,True,0,No user reviews,0,0,0
1273690,True,0,No user reviews,0,0,0
1273710,True,0,No user reviews,0,0,0
1273720,True,0,No user reviews,0,0,0
1273740,True,0,1 user reviews,1,0,1
1273750,True,0,No user reviews,0,0,0
1273780,True,7,Positive,9,1,10
1273790,True,6,Mostly Positive,22,9,31
1273800,True,0,8 user reviews,7,1,8
1273820,True,0,No user reviews,0,0,0
1273830,True,0,No user reviews,0,0,0
1273850,True,0,No user reviews,0,0,0
1273860,True,0,No user reviews,0,0,0
1273870,True,0,3 user reviews,1,2,3
1273880,True,0,No user reviews,0,0,0
1273890,True,0,1 user reviews,1,0,1
1273910,True,0,No user reviews,0,0,0
1273920,True,0,1 user reviews,1,0,1
1273930,True,0,2 user reviews,1,1,2
1273940,True,0,1 user reviews,0,1,1
1273960,True,0,No user reviews,0,0,0
1273961,True,0,No user reviews,0,0,0
1273962,True,0,No user reviews,0,0,0
1273963,True,0,No user reviews,0,0,0
1273970,True,0,4 user reviews,2,2,4
1273971,True,6,Mostly Positive,86,35,121
1274020,True,0,No user reviews,0,0,0
1274050,True,0,No user reviews,0,0,0
1274060,True,0,No user reviews,0,0,0
1274080,True,0,No user reviews,0,0,0
1274090,True,0,No user reviews,0,0,0
1274110,True,0,No user reviews,0,0,0
1274120,True,0,No user reviews,0,0,0
1274130,True,0,No user reviews,0,0,0
1274140,True,0,No user reviews,0,0,0
1274150,True,0,1 user reviews,1,0,1
1274180,True,0,No user reviews,0,0,0
1274190,True,0,1 user reviews,1,0,1
1274200,True,0,No user reviews,0,0,0
1274210,True,0,No user reviews,0,0,0
1274220,True,0,No user reviews,0,0,0
1274250,True,0,1 user reviews,0,1,1
1274280,True,0,No user reviews,0,0,0
1274290,True,0,No user reviews,0,0,0
1274300,True,5,Mixed,19,9,28
1274310,True,0,No user reviews,0,0,0
1274330,True,0,No user reviews,0,0,0
1274340,True,0,1 user reviews,1,0,1
1274360,True,0,No user reviews,0,0,0
1274380,True,0,No user reviews,0,0,0
1274390,True,0,No user reviews,0,0,0
1274400,True,0,1 user reviews,0,1,1
1274410,True,0,No user reviews,0,0,0
1274430,True,0,1 user reviews,1,0,1
1274440,True,0,3 user reviews,3,0,3
1274450,True,0,No user reviews,0,0,0
1274460,True,0,No user reviews,0,0,0
1274470,True,0,No user reviews,0,0,0
1274490,True,6,Mostly Positive,120,31,151
1274500,True,0,No user reviews,0,0,0
1274530,True,0,No user reviews,0,0,0
1274540,True,0,No user reviews,0,0,0
1274550,True,0,No user reviews,0,0,0
1274560,True,0,No user reviews,0,0,0
1274570,True,0,No user reviews,0,0,0
1274590,True,0,No user reviews,0,0,0
1274600,True,0,No user reviews,0,0,0
1274610,True,0,5 user reviews,3,2,5
1274630,True,0,7 user reviews,7,0,7
1274640,True,0,2 user reviews,2,0,2
1274660,True,0,1 user reviews,1,0,1
1274670,True,0,No user reviews,0,0,0
1274680,True,0,No user reviews,0,0,0
1274690,True,0,No user reviews,0,0,0
1274720,True,0,No user reviews,0,0,0
1274730,True,0,No user reviews,0,0,0
1274740,True,0,No user reviews,0,0,0
1274790,True,0,No user reviews,0,0,0
1274800,True,0,No user reviews,0,0,0
1274810,True,0,No user reviews,0,0,0
1274820,True,7,Positive,11,0,11
1274840,True,5,Mixed,6,4,10
1274850,True,0,No user reviews,0,0,0
1274910,True,0,2 user reviews,1,1,2
1274930,True,0,No user reviews,0,0,0
1274940,True,7,Positive,33,4,37
1274950,True,0,No user reviews,0,0,0
1274960,True,0,3 user reviews,0,3,3
1274970,True,0,3 user reviews,3,0,3
1274980,True,0,7 user reviews,6,1,7
1275020,True,0,3 user reviews,3,0,3
1275030,True,0,No user reviews,0,0,0
1275040,True,0,No user reviews,0,0,0
1275050,True,0,No user reviews,0,0,0
1275060,True,0,4 user reviews,4,0,4
1275070,True,0,No user reviews,0,0,0
1275100,True,0,No user reviews,0,0,0
1275140,True,0,No user reviews,0,0,0
1275180,True,0,No user reviews,0,0,0
1275190,True,0,6 user reviews,6,0,6
1275200,True,0,No user reviews,0,0,0
1275210,True,0,No user reviews,0,0,0
1275230,True,0,1 user reviews,0,1,1
1275240,True,0,No user reviews,0,0,0
1275250,True,0,6 user reviews,5,1,6
1275260,True,0,No user reviews,0,0,0
1275290,True,5,Mixed,9,4,13
1275300,True,0,No user reviews,0,0,0
1275320,True,0,1 user reviews,1,0,1
1275330,True,0,2 user reviews,2,0,2
1275350,True,0,No user reviews,0,0,0
1275360,True,0,1 user reviews,0,1,1
1275380,True,0,No user reviews,0,0,0
1275390,True,6,Mostly Positive,7,3,10
1275410,True,0,No user reviews,0,0,0
1275430,True,0,No user reviews,0,0,0
1275440,True,0,No user reviews,0,0,0
1275450,True,0,5 user reviews,1,4,5
1275460,True,0,No user reviews,0,0,0
1275470,True,0,No user reviews,0,0,0
1275490,True,0,No user reviews,0,0,0
1275500,True,0,1 user reviews,0,1,1
1275520,True,0,1 user reviews,1,0,1
1275530,True,0,No user reviews,0,0,0
1275540,True,0,No user reviews,0,0,0
1275570,True,0,3 user reviews,0,3,3
1275580,True,0,1 user reviews,0,1,1
1275590,True,0,No user reviews,0,0,0
1275600,True,0,No user reviews,0,0,0
1275630,True,0,No user reviews,0,0,0
1275640,True,0,No user reviews,0,0,0
1275660,True,0,No user reviews,0,0,0
1275670,True,0,No user reviews,0,0,0
1275730,True,0,4 user reviews,4,0,4
1275760,True,0,No user reviews,0,0,0
1275770,True,7,Positive,16,2,18
1275780,True,0,No user reviews,0,0,0
1275790,True,0,No user reviews,0,0,0
1275800,True,0,No user reviews,0,0,0
1275850,True,0,No user reviews,0,0,0
1275860,True,0,5 user reviews,4,1,5
1275880,True,0,1 user reviews,0,1,1
1275890,True,8,Very Positive,406,14,420
1275900,True,0,No user reviews,0,0,0
1275950,True,0,No user reviews,0,0,0
1275960,True,0,No user reviews,0,0,0
1275970,True,0,5 user reviews,3,2,5
1275980,True,0,5 user reviews,4,1,5
1276010,True,0,No user reviews,0,0,0
1276030,True,0,No user reviews,0,0,0
1276040,True,7,Positive,22,4,26
1276050,True,0,No user reviews,0,0,0
1276060,True,0,No user reviews,0,0,0
1276080,True,0,No user reviews,0,0,0
1276090,True,0,1 user reviews,0,1,1
1276100,True,0,No user reviews,0,0,0
1276110,True,0,No user reviews,0,0,0
1276140,True,0,2 user reviews,1,1,2
1276160,True,0,1 user reviews,1,0,1
1276170,True,0,1 user reviews,1,0,1
1276180,True,0,3 user reviews,3,0,3
1276200,True,0,No user reviews,0,0,0
1276210,True,0,No user reviews,0,0,0
1276220,True,0,No user reviews,0,0,0
1276230,True,0,No user reviews,0,0,0
1276240,True,0,No user reviews,0,0,0
1276250,True,0,No user reviews,0,0,0
1276260,True,0,No user reviews,0,0,0
1276280,True,0,No user reviews,0,0,0
1276290,True,0,No user reviews,0,0,0
1276300,True,0,No user reviews,0,0,0
1276320,True,0,1 user reviews,1,0,1
1276330,True,0,No user reviews,0,0,0
1276340,True,0,1 user reviews,1,0,1
1276350,True,0,2 user reviews,1,1,2
1276360,True,0,No user reviews,0,0,0
1276370,True,0,No user reviews,0,0,0
1276380,True,0,No user reviews,0,0,0
1276400,True,0,No user reviews,0,0,0
1276410,True,0,No user reviews,0,0,0
1276420,True,0,No user reviews,0,0,0
1276430,True,0,5 user reviews,5,0,5
1276440,True,0,No user reviews,0,0,0
1276450,True,0,6 user reviews,5,1,6
1276470,True,8,Very Positive,79,18,97
1276490,True,0,9 user reviews,5,4,9
1276500,True,0,No user reviews,0,0,0
1276501,True,0,No user reviews,0,0,0
1276502,True,0,No user reviews,0,0,0
1276503,True,0,No user reviews,0,0,0
1276510,True,0,No user reviews,0,0,0
1276520,True,0,No user reviews,0,0,0
1276521,True,0,No user reviews,0,0,0
1276522,True,0,No user reviews,0,0,0
1276523,True,0,No user reviews,0,0,0
1276524,True,0,No user reviews,0,0,0
1276525,True,0,No user reviews,0,0,0
1276530,True,0,2 user reviews,2,0,2
1276540,True,0,6 user reviews,4,2,6
1276550,True,0,No user reviews,0,0,0
1276560,True,0,No user reviews,0,0,0
1276580,True,0,No user reviews,0,0,0
1276590,True,0,1 user reviews,0,1,1
1276600,True,0,No user reviews,0,0,0
1276610,True,6,Mostly Positive,54,22,76
1276630,True,0,No user reviews,0,0,0
1276650,True,0,No user reviews,0,0,0
1276660,True,0,No user reviews,0,0,0
1276690,True,0,No user reviews,0,0,0
1276710,True,0,No user reviews,0,0,0
1276720,True,0,6 user reviews,3,3,6
1276730,True,0,No user reviews,0,0,0
1276740,True,0,No user reviews,0,0,0
1276750,True,0,No user reviews,0,0,0
1276770,True,0,No user reviews,0,0,0
1276780,True,0,1 user reviews,1,0,1
1276781,True,0,1 user reviews,1,0,1
1276810,True,0,No user reviews,0,0,0
1276820,True,0,No user reviews,0,0,0
1276850,True,0,No user reviews,0,0,0
1276860,True,0,No user reviews,0,0,0
1276890,True,0,No user reviews,0,0,0
1277090,True,0,2 user reviews,2,0,2
1277100,True,0,No user reviews,0,0,0
1277130,True,0,No user reviews,0,0,0
1277140,True,0,No user reviews,0,0,0
1277160,True,0,No user reviews,0,0,0
1277190,True,0,3 user reviews,3,0,3
1277200,True,0,No user reviews,0,0,0
1277210,True,0,8 user reviews,4,4,8
1277220,True,0,No user reviews,0,0,0
1277260,True,0,No user reviews,0,0,0
1277270,True,0,No user reviews,0,0,0
1277280,True,0,No user reviews,0,0,0
1277290,True,0,No user reviews,0,0,0
1277300,True,0,No user reviews,0,0,0
1277310,True,0,No user reviews,0,0,0
1277320,True,0,1 user reviews,1,0,1
1277340,True,0,No user reviews,0,0,0
1277360,True,0,No user reviews,0,0,0
1277370,True,0,No user reviews,0,0,0
1277380,True,0,No user reviews,0,0,0
1277390,True,0,3 user reviews,1,2,3
1277440,True,0,No user reviews,0,0,0
1277500,True,0,No user reviews,0,0,0
1277510,True,0,No user reviews,0,0,0
1277520,True,0,No user reviews,0,0,0
1277540,True,0,No user reviews,0,0,0
1277550,True,0,No user reviews,0,0,0
1277570,True,7,Positive,17,0,17
1277600,True,0,3 user reviews,3,0,3
1277610,True,0,No user reviews,0,0,0
1277630,True,0,No user reviews,0,0,0
1277640,True,0,No user reviews,0,0,0
1277650,True,0,1 user reviews,1,0,1
1277680,True,0,No user reviews,0,0,0
1277690,True,0,1 user reviews,1,0,1
1277700,True,0,No user reviews,0,0,0
1277710,True,0,4 user reviews,4,0,4
1277780,True,0,No user reviews,0,0,0
1277830,True,0,8 user reviews,7,1,8
1277840,True,0,3 user reviews,3,0,3
1277860,True,0,No user reviews,0,0,0
1277870,True,0,No user reviews,0,0,0
1277880,True,0,No user reviews,0,0,0
1277900,True,0,1 user reviews,1,0,1
1277920,True,0,No user reviews,0,0,0
1277930,True,0,No user reviews,0,0,0
1277950,True,0,5 user reviews,3,2,5
1277960,True,0,No user reviews,0,0,0
1277970,True,0,No user reviews,0,0,0
1277990,True,0,No user reviews,0,0,0
1278000,True,0,1 user reviews,1,0,1
1278040,True,0,2 user reviews,2,0,2
1278060,True,0,No user reviews,0,0,0
1278080,True,0,No user reviews,0,0,0
1278090,True,0,3 user reviews,2,1,3
1278100,True,0,No user reviews,0,0,0
1278110,True,0,1 user reviews,1,0,1
1278120,True,0,No user reviews,0,0,0
1278130,True,0,No user reviews,0,0,0
1278131,True,0,No user reviews,0,0,0
1278133,True,0,1 user reviews,1,0,1
1278134,True,0,No user reviews,0,0,0
1278140,True,0,No user reviews,0,0,0
1278190,True,0,No user reviews,0,0,0
1278200,True,0,8 user reviews,6,2,8
1278210,True,0,6 user reviews,6,0,6
1278230,True,0,3 user reviews,1,2,3
1278240,True,0,3 user reviews,3,0,3
1278250,True,0,1 user reviews,1,0,1
1278270,True,0,6 user reviews,5,1,6
1278280,True,0,No user reviews,0,0,0
1278290,True,0,6 user reviews,6,0,6
1278300,True,0,2 user reviews,2,0,2
1278310,True,0,No user reviews,0,0,0
1278311,True,0,No user reviews,0,0,0
1278312,True,0,No user reviews,0,0,0
1278313,True,0,No user reviews,0,0,0
1278314,True,0,No user reviews,0,0,0
1278315,True,0,No user reviews,0,0,0
1278340,True,0,No user reviews,0,0,0
1278350,True,0,4 user reviews,4,0,4
1278360,True,0,No user reviews,0,0,0
1278370,True,7,Positive,20,4,24
1278380,True,0,No user reviews,0,0,0
1278390,True,0,No user reviews,0,0,0
1278430,True,0,2 user reviews,2,0,2
1278460,True,0,No user reviews,0,0,0
1278471,True,0,No user reviews,0,0,0
1278472,True,0,1 user reviews,1,0,1
1278473,True,0,No user reviews,0,0,0
1278474,True,0,No user reviews,0,0,0
1278475,True,0,No user reviews,0,0,0
1278476,True,0,No user reviews,0,0,0
1278480,True,0,4 user reviews,1,3,4
1278500,True,7,Positive,10,2,12
1278510,True,0,No user reviews,0,0,0
1278520,True,0,No user reviews,0,0,0
1278560,True,0,No user reviews,0,0,0
1278570,True,0,No user reviews,0,0,0
1278580,True,0,No user reviews,0,0,0
1278590,True,0,3 user reviews,3,0,3
1278610,True,0,4 user reviews,4,0,4
1278630,True,0,No user reviews,0,0,0
1278640,True,0,No user reviews,0,0,0
1278650,True,5,Mixed,7,4,11
1278660,True,0,No user reviews,0,0,0
1278670,True,0,No user reviews,0,0,0
1278680,True,0,No user reviews,0,0,0
1278690,True,0,1 user reviews,0,1,1
1278700,True,0,No user reviews,0,0,0
1278710,True,0,2 user reviews,2,0,2
1278720,True,0,No user reviews,0,0,0
1278740,True,0,No user reviews,0,0,0
1278750,True,0,No user reviews,0,0,0
1278760,True,0,No user reviews,0,0,0
1278770,True,6,Mostly Positive,19,5,24
1278780,True,0,No user reviews,0,0,0
1278850,True,0,No user reviews,0,0,0
1278860,True,0,2 user reviews,1,1,2
1278870,True,0,No user reviews,0,0,0
1278880,True,0,No user reviews,0,0,0
1278930,True,0,3 user reviews,1,2,3
1278960,True,0,7 user reviews,7,0,7
1278980,True,0,No user reviews,0,0,0
1278990,True,0,No user reviews,0,0,0
1279000,True,0,No user reviews,0,0,0
1279020,True,0,4 user reviews,4,0,4
1279210,True,0,1 user reviews,1,0,1
1279211,True,0,1 user reviews,1,0,1
1279240,True,0,No user reviews,0,0,0
1279260,True,0,No user reviews,0,0,0
1279270,True,0,No user reviews,0,0,0
1279280,True,0,No user reviews,0,0,0
1279320,True,0,No user reviews,0,0,0
1279330,True,0,No user reviews,0,0,0
1279370,True,0,4 user reviews,4,0,4
1279380,True,0,7 user reviews,7,0,7
1279390,True,0,5 user reviews,3,2,5
1279400,True,0,5 user reviews,3,2,5
1279410,True,0,7 user reviews,7,0,7
1279420,True,0,6 user reviews,6,0,6
1279430,True,0,No user reviews,0,0,0
1279440,True,0,No user reviews,0,0,0
1279450,True,0,3 user reviews,3,0,3
1279460,True,0,No user reviews,0,0,0
1279480,True,0,2 user reviews,2,0,2
1279500,True,0,No user reviews,0,0,0
1279530,True,0,No user reviews,0,0,0
1279540,True,0,No user reviews,0,0,0
1279550,True,0,No user reviews,0,0,0
1279590,True,0,8 user reviews,5,3,8
1279600,True,0,No user reviews,0,0,0
1279610,True,0,No user reviews,0,0,0
1279620,True,0,3 user reviews,3,0,3
1279630,True,6,Mostly Positive,143,40,183
1279670,True,0,No user reviews,0,0,0
1279680,True,0,No user reviews,0,0,0
1279700,True,7,Positive,14,2,16
1279730,True,0,No user reviews,0,0,0
1279740,True,0,1 user reviews,1,0,1
1279770,True,0,2 user reviews,2,0,2
1279780,True,0,No user reviews,0,0,0
1279800,True,0,No user reviews,0,0,0
1279810,True,0,7 user reviews,7,0,7
1279840,True,0,No user reviews,0,0,0
1279850,True,0,No user reviews,0,0,0
1279870,True,0,No user reviews,0,0,0
1279900,True,0,No user reviews,0,0,0
1279960,True,0,No user reviews,0,0,0
1279970,True,0,3 user reviews,3,0,3
1280010,True,5,Mixed,7,4,11
1280020,True,0,No user reviews,0,0,0
1280050,True,0,No user reviews,0,0,0
1280070,True,0,No user reviews,0,0,0
1280080,True,0,No user reviews,0,0,0
1280090,True,0,1 user reviews,0,1,1
1280100,True,0,No user reviews,0,0,0
1280110,True,0,2 user reviews,1,1,2
1280120,True,0,No user reviews,0,0,0
1280121,True,0,1 user reviews,1,0,1
1280123,True,0,No user reviews,0,0,0
1280124,True,0,1 user reviews,1,0,1
1280125,True,0,No user reviews,0,0,0
1280126,True,0,No user reviews,0,0,0
1280127,True,0,No user reviews,0,0,0
1280128,True,0,No user reviews,0,0,0
1280129,True,0,No user reviews,0,0,0
1280140,True,0,No user reviews,0,0,0
1280160,True,0,No user reviews,0,0,0
1280170,True,0,No user reviews,0,0,0
1280180,True,0,No user reviews,0,0,0
1280190,True,0,No user reviews,0,0,0
1280210,True,0,No user reviews,0,0,0
1280220,True,0,No user reviews,0,0,0
1280260,True,7,Positive,22,5,27
1280270,True,0,No user reviews,0,0,0
1280290,True,0,No user reviews,0,0,0
1280300,True,0,No user reviews,0,0,0
1280310,True,0,1 user reviews,1,0,1
1280330,True,0,1 user reviews,0,1,1
1280340,True,0,3 user reviews,1,2,3
1280350,True,0,1 user reviews,0,1,1
1280360,True,0,3 user reviews,0,3,3
1280370,True,6,Mostly Positive,58,24,82
1280380,True,0,No user reviews,0,0,0
1280390,True,0,No user reviews,0,0,0
1280400,True,0,No user reviews,0,0,0
1280420,True,0,6 user reviews,6,0,6
1280440,True,0,No user reviews,0,0,0
1280450,True,0,No user reviews,0,0,0
1280490,True,0,1 user reviews,1,0,1
1280500,True,0,8 user reviews,5,3,8
1280510,True,0,2 user reviews,1,1,2
1280520,True,0,No user reviews,0,0,0
1280550,True,0,4 user reviews,1,3,4
1280570,True,0,No user reviews,0,0,0
1280580,True,0,No user reviews,0,0,0
1280610,True,0,No user reviews,0,0,0
1280630,True,0,5 user reviews,5,0,5
1280640,True,0,7 user reviews,7,0,7
1280660,True,0,No user reviews,0,0,0
1280670,True,0,1 user reviews,1,0,1
1280680,True,0,No user reviews,0,0,0
1280690,True,0,No user reviews,0,0,0
1280700,True,0,No user reviews,0,0,0
1280730,True,0,No user reviews,0,0,0
1280740,True,0,No user reviews,0,0,0
1280750,True,0,No user reviews,0,0,0
1280760,True,0,No user reviews,0,0,0
1280780,True,0,No user reviews,0,0,0
1280800,True,0,No user reviews,0,0,0
1280830,True,0,No user reviews,0,0,0
1280840,True,0,No user reviews,0,0,0
1280850,True,0,No user reviews,0,0,0
1280890,True,0,No user reviews,0,0,0
1280900,True,0,No user reviews,0,0,0
1280910,True,0,2 user reviews,0,2,2
1280930,True,0,No user reviews,0,0,0
1280940,True,0,6 user reviews,5,1,6
1280950,True,0,No user reviews,0,0,0
1280970,True,0,7 user reviews,7,0,7
1280980,True,0,1 user reviews,1,0,1
1280990,True,0,No user reviews,0,0,0
1281000,True,0,No user reviews,0,0,0
1281010,True,0,8 user reviews,8,0,8
1281060,True,0,No user reviews,0,0,0
1281070,True,0,No user reviews,0,0,0
1281080,True,0,No user reviews,0,0,0
1281090,True,0,No user reviews,0,0,0
1281100,True,0,1 user reviews,0,1,1
1281120,True,0,No user reviews,0,0,0
1281130,True,0,No user reviews,0,0,0
1281140,True,0,3 user reviews,3,0,3
1281160,True,0,No user reviews,0,0,0
1281170,True,7,Positive,34,2,36
1281180,True,0,No user reviews,0,0,0
1281190,True,0,No user reviews,0,0,0
1281200,True,8,Very Positive,104,9,113
1281210,True,0,No user reviews,0,0,0
1281220,True,0,No user reviews,0,0,0
1281250,True,0,No user reviews,0,0,0
1281270,True,7,Positive,47,2,49
1281280,True,0,3 user reviews,2,1,3
1281290,True,0,No user reviews,0,0,0
1281310,True,0,9 user reviews,4,5,9
1281320,True,0,No user reviews,0,0,0
1281330,True,0,5 user reviews,5,0,5
1281350,True,0,5 user reviews,5,0,5
1281360,True,0,1 user reviews,1,0,1
1281370,True,0,1 user reviews,1,0,1
1281380,True,0,No user reviews,0,0,0
1281390,True,7,Positive,16,0,16
1281400,True,0,No user reviews,0,0,0
1281410,True,0,2 user reviews,2,0,2
1281420,True,0,No user reviews,0,0,0
1281440,True,0,No user reviews,0,0,0
1281460,True,0,No user reviews,0,0,0
1281470,True,0,No user reviews,0,0,0
1281490,True,0,No user reviews,0,0,0
1281500,True,0,1 user reviews,1,0,1
1281510,True,0,1 user reviews,1,0,1
1281530,True,7,Positive,13,0,13
1281550,True,0,No user reviews,0,0,0
1281570,True,0,No user reviews,0,0,0
1281571,True,0,1 user reviews,1,0,1
1281580,True,0,5 user reviews,5,0,5
1281600,True,0,7 user reviews,4,3,7
1281610,True,0,1 user reviews,1,0,1
1281620,True,0,3 user reviews,2,1,3
1281630,True,6,Mostly Positive,58,23,81
1281640,True,0,No user reviews,0,0,0
1281700,True,0,3 user reviews,2,1,3
1281710,True,0,3 user reviews,0,3,3
1281790,True,7,Positive,35,1,36
1281800,True,0,No user reviews,0,0,0
1281810,True,0,3 user reviews,3,0,3
1281830,True,0,No user reviews,0,0,0
1281860,True,0,No user reviews,0,0,0
1281870,True,0,No user reviews,0,0,0
1281880,True,7,Positive,13,2,15
1281881,True,0,4 user reviews,3,1,4
1281890,True,7,Positive,8,2,10
1281920,True,0,No user reviews,0,0,0
1281930,True,0,No user reviews,0,0,0
1281960,True,0,No user reviews,0,0,0
1281980,True,0,3 user reviews,1,2,3
1281990,True,0,No user reviews,0,0,0
1282000,True,0,No user reviews,0,0,0
1282030,True,0,No user reviews,0,0,0
1282040,True,0,No user reviews,0,0,0
1282070,True,0,No user reviews,0,0,0
1282080,True,0,3 user reviews,3,0,3
1282090,True,7,Positive,13,1,14
1282110,True,0,No user reviews,0,0,0
1282120,True,0,No user reviews,0,0,0
1282140,True,0,7 user reviews,6,1,7
1282160,True,0,No user reviews,0,0,0
1282180,True,0,No user reviews,0,0,0
1282190,True,0,No user reviews,0,0,0
1282200,True,9,Overwhelmingly Positive,810,27,837
1282210,True,8,Very Positive,329,33,362
1282220,True,0,No user reviews,0,0,0
1282240,True,0,No user reviews,0,0,0
1282250,True,0,No user reviews,0,0,0
1282290,True,0,No user reviews,0,0,0
1282310,True,0,No user reviews,0,0,0
1282320,True,0,9 user reviews,9,0,9
1282350,True,7,Positive,9,2,11
1282370,True,0,1 user reviews,1,0,1
1282380,True,0,No user reviews,0,0,0
1282420,True,0,No user reviews,0,0,0
1282440,True,0,No user reviews,0,0,0
1282500,True,0,No user reviews,0,0,0
1282510,True,0,7 user reviews,7,0,7
1282540,True,0,No user reviews,0,0,0
1282550,True,7,Positive,35,1,36
1282580,True,0,No user reviews,0,0,0
1282590,True,6,Mostly Positive,340,115,455
1282600,True,0,No user reviews,0,0,0
1282610,True,0,No user reviews,0,0,0
1282620,True,0,No user reviews,0,0,0
1282630,True,0,No user reviews,0,0,0
1282640,True,0,No user reviews,0,0,0
1282650,True,7,Positive,18,1,19
1282660,True,0,No user reviews,0,0,0
1282680,True,0,No user reviews,0,0,0
1282681,True,0,No user reviews,0,0,0
1282690,True,8,Very Positive,422,85,507
1282700,True,0,No user reviews,0,0,0
1282710,True,0,1 user reviews,1,0,1
1282720,True,0,No user reviews,0,0,0
1282740,True,0,No user reviews,0,0,0
1282760,True,0,No user reviews,0,0,0
1282770,True,0,2 user reviews,0,2,2
1282781,True,0,2 user reviews,0,2,2
1282830,True,0,No user reviews,0,0,0
1282840,True,7,Positive,14,1,15
1282850,True,0,No user reviews,0,0,0
1282880,True,0,1 user reviews,1,0,1
1282890,True,0,6 user reviews,6,0,6
1282900,True,0,6 user reviews,5,1,6
1282920,True,0,No user reviews,0,0,0
1282930,True,0,8 user reviews,7,1,8
1282960,True,5,Mixed,9,11,20
1282980,True,0,No user reviews,0,0,0
1282990,True,0,No user reviews,0,0,0
1283000,True,7,Positive,16,0,16
1283050,True,0,3 user reviews,3,0,3
1283060,True,0,No user reviews,0,0,0
1283070,True,0,2 user reviews,2,0,2
1283090,True,8,Very Positive,65,6,71
1283091,True,8,Very Positive,63,3,66
1283110,True,0,2 user reviews,2,0,2
1283130,True,0,No user reviews,0,0,0
1283140,True,0,No user reviews,0,0,0
1283150,True,0,No user reviews,0,0,0
1283160,True,0,No user reviews,0,0,0
1283161,True,0,No user reviews,0,0,0
1283162,True,0,No user reviews,0,0,0
1283163,True,0,No user reviews,0,0,0
1283164,True,0,No user reviews,0,0,0
1283180,True,0,No user reviews,0,0,0
1283190,True,8,Very Positive,81,19,100
1283200,True,0,No user reviews,0,0,0
1283210,True,0,No user reviews,0,0,0
1283220,True,0,No user reviews,0,0,0
1283230,True,0,No user reviews,0,0,0
1283240,True,0,No user reviews,0,0,0
1283250,True,0,No user reviews,0,0,0
1283260,True,0,No user reviews,0,0,0
1283270,True,0,No user reviews,0,0,0
1283280,True,0,3 user reviews,3,0,3
1283320,True,0,5 user reviews,4,1,5
1283330,True,0,No user reviews,0,0,0
1283340,True,0,No user reviews,0,0,0
1283350,True,0,No user reviews,0,0,0
1283370,True,0,No user reviews,0,0,0
1283380,True,0,No user reviews,0,0,0
1283400,True,0,No user reviews,0,0,0
1283430,True,0,No user reviews,0,0,0
1283440,True,0,2 user reviews,2,0,2
1283450,True,0,No user reviews,0,0,0
1283500,True,7,Positive,18,0,18
1283520,True,0,3 user reviews,2,1,3
1283530,True,0,2 user reviews,2,0,2
1283570,True,0,No user reviews,0,0,0
1283580,True,7,Positive,17,0,17
1283590,True,0,No user reviews,0,0,0
1283610,True,0,No user reviews,0,0,0
1283620,True,0,No user reviews,0,0,0
1283630,True,0,No user reviews,0,0,0
1283640,True,0,No user reviews,0,0,0
1283660,True,0,No user reviews,0,0,0
1283670,True,0,No user reviews,0,0,0
1283680,True,0,1 user reviews,0,1,1
1283710,True,4,Mostly Negative,6,12,18
1283711,True,0,No user reviews,0,0,0
1283720,True,0,1 user reviews,1,0,1
1283740,True,0,No user reviews,0,0,0
1283760,True,0,2 user reviews,0,2,2
1283770,True,0,No user reviews,0,0,0
1283790,True,0,1 user reviews,0,1,1
1283800,True,0,1 user reviews,1,0,1
1283810,True,0,No user reviews,0,0,0
1283820,True,0,3 user reviews,3,0,3
1283830,True,0,No user reviews,0,0,0
1283850,True,0,3 user reviews,3,0,3
1283860,True,0,No user reviews,0,0,0
1283870,True,0,No user reviews,0,0,0
1283890,True,0,5 user reviews,5,0,5
1283900,True,0,No user reviews,0,0,0
1283920,True,0,No user reviews,0,0,0
1283930,True,0,No user reviews,0,0,0
1283960,True,0,6 user reviews,6,0,6
1283970,True,8,Very Positive,67,6,73
1283990,True,0,2 user reviews,1,1,2
1284010,True,0,No user reviews,0,0,0
1284050,True,0,2 user reviews,0,2,2
1284060,True,0,No user reviews,0,0,0
1284080,True,0,7 user reviews,7,0,7
1284100,True,0,No user reviews,0,0,0
1284110,True,0,7 user reviews,7,0,7
1284130,True,0,No user reviews,0,0,0
1284140,True,0,No user reviews,0,0,0
1284150,True,0,9 user reviews,9,0,9
1284160,True,0,No user reviews,0,0,0
1284180,True,0,9 user reviews,9,0,9
1284200,True,0,1 user reviews,1,0,1
1284210,True,0,No user reviews,0,0,0
1284220,True,0,No user reviews,0,0,0
1284230,True,0,No user reviews,0,0,0
1284240,True,0,No user reviews,0,0,0
1284250,True,0,No user reviews,0,0,0
1284260,True,0,2 user reviews,2,0,2
1284270,True,0,No user reviews,0,0,0
1284280,True,7,Positive,16,4,20
1284290,True,0,1 user reviews,1,0,1
1284300,True,0,3 user reviews,1,2,3
1284310,True,0,No user reviews,0,0,0
1284350,True,0,No user reviews,0,0,0
1284380,True,0,No user reviews,0,0,0
1284390,True,0,5 user reviews,2,3,5
1284410,True,0,No user reviews,0,0,0
1284430,True,0,1 user reviews,1,0,1
1284460,True,0,No user reviews,0,0,0
1284480,True,0,2 user reviews,2,0,2
1284500,True,0,No user reviews,0,0,0
1284510,True,0,3 user reviews,3,0,3
1284540,True,0,8 user reviews,8,0,8
1284550,True,7,Positive,23,2,25
1284560,True,0,No user reviews,0,0,0
1284630,True,0,No user reviews,0,0,0
1284640,True,0,No user reviews,0,0,0
1284660,True,0,No user reviews,0,0,0
1284680,True,0,No user reviews,0,0,0
1284690,True,0,No user reviews,0,0,0
1284700,True,0,2 user reviews,1,1,2
1284710,True,0,No user reviews,0,0,0
1284712,True,0,No user reviews,0,0,0
1284720,True,0,No user reviews,0,0,0
1284740,True,0,No user reviews,0,0,0
1284760,True,0,6 user reviews,4,2,6
1284790,True,7,Positive,11,1,12
1284800,True,0,9 user reviews,8,1,9
1284810,True,0,No user reviews,0,0,0
1284820,True,8,Very Positive,123,9,132
1284850,True,0,No user reviews,0,0,0
1284860,True,0,No user reviews,0,0,0
1284870,True,0,No user reviews,0,0,0
1284880,True,0,3 user reviews,3,0,3
1284890,True,0,1 user reviews,1,0,1
1284900,True,0,8 user reviews,8,0,8
1284910,True,0,No user reviews,0,0,0
1284920,True,0,No user reviews,0,0,0
1284921,True,0,No user reviews,0,0,0
1284930,True,0,No user reviews,0,0,0
1284950,True,7,Positive,10,0,10
1284970,True,0,No user reviews,0,0,0
1284990,True,0,No user reviews,0,0,0
1284991,True,0,No user reviews,0,0,0
1284992,True,0,No user reviews,0,0,0
1285000,True,5,Mixed,11,5,16
1285010,True,0,3 user reviews,3,0,3
1285020,True,0,7 user reviews,7,0,7
1285030,True,0,No user reviews,0,0,0
1285040,True,0,No user reviews,0,0,0
1285050,True,0,No user reviews,0,0,0
1285060,True,0,No user reviews,0,0,0
1285070,True,0,1 user reviews,1,0,1
1285080,True,7,Positive,33,0,33
1285090,True,0,6 user reviews,4,2,6
1285120,True,0,No user reviews,0,0,0
1285130,True,0,No user reviews,0,0,0
1285150,True,0,No user reviews,0,0,0
1285160,True,7,Positive,49,0,49
1285170,True,0,No user reviews,0,0,0
1285180,True,0,3 user reviews,3,0,3
1285200,True,0,No user reviews,0,0,0
1285210,True,0,No user reviews,0,0,0
1285270,True,0,No user reviews,0,0,0
1285290,True,0,No user reviews,0,0,0
1285300,True,0,No user reviews,0,0,0
1285310,True,0,1 user reviews,0,1,1
1285330,True,0,No user reviews,0,0,0
1285332,True,0,No user reviews,0,0,0
1285333,True,0,No user reviews,0,0,0
1285334,True,0,No user reviews,0,0,0
1285335,True,0,No user reviews,0,0,0
1285336,True,0,No user reviews,0,0,0
1285337,True,0,No user reviews,0,0,0
1285338,True,0,No user reviews,0,0,0
1285339,True,0,No user reviews,0,0,0
1285340,True,0,No user reviews,0,0,0
1285341,True,0,No user reviews,0,0,0
1285342,True,0,No user reviews,0,0,0
1285343,True,0,No user reviews,0,0,0
1285344,True,0,No user reviews,0,0,0
1285350,True,0,No user reviews,0,0,0
1285390,True,0,4 user reviews,3,1,4
1285440,True,0,No user reviews,0,0,0
1285450,True,0,No user reviews,0,0,0
1285470,True,0,No user reviews,0,0,0
1285490,True,0,No user reviews,0,0,0
1285500,True,0,No user reviews,0,0,0
1285510,True,7,Positive,14,0,14
1285520,True,0,No user reviews,0,0,0
1285530,True,0,2 user reviews,2,0,2
1285540,True,0,No user reviews,0,0,0
1285560,True,6,Mostly Positive,8,3,11
1285570,True,0,No user reviews,0,0,0
1285580,True,0,No user reviews,0,0,0
1285590,True,0,No user reviews,0,0,0
1285591,True,0,No user reviews,0,0,0
1285592,True,0,No user reviews,0,0,0
1285593,True,0,No user reviews,0,0,0
1285600,True,0,2 user reviews,2,0,2
1285610,True,0,2 user reviews,2,0,2
1285620,True,0,No user reviews,0,0,0
1285630,True,0,7 user reviews,7,0,7
1285660,True,0,3 user reviews,3,0,3
1285670,True,9,Overwhelmingly Positive,1146,22,1168
1285680,True,0,No user reviews,0,0,0
1285690,True,0,No user reviews,0,0,0
1285700,True,0,3 user reviews,1,2,3
1285710,True,0,No user reviews,0,0,0
1285740,True,0,1 user reviews,1,0,1
1285750,True,0,No user reviews,0,0,0
1285770,True,0,8 user reviews,8,0,8
1285800,True,0,No user reviews,0,0,0
1285810,True,8,Very Positive,77,5,82
1285820,True,0,No user reviews,0,0,0
1285830,True,0,No user reviews,0,0,0
1285840,True,0,No user reviews,0,0,0
1285850,True,0,7 user reviews,4,3,7
1285870,True,7,Positive,14,0,14
1285880,True,0,No user reviews,0,0,0
1285930,True,0,No user reviews,0,0,0
1285940,True,0,No user reviews,0,0,0
1285960,True,0,No user reviews,0,0,0
1285970,True,0,No user reviews,0,0,0
1285980,True,0,No user reviews,0,0,0
1285990,True,0,No user reviews,0,0,0
1286000,True,0,No user reviews,0,0,0
1286010,True,8,Very Positive,51,0,51
1286030,True,0,No user reviews,0,0,0
1286050,True,0,No user reviews,0,0,0
1286090,True,0,No user reviews,0,0,0
1286100,True,0,No user reviews,0,0,0
1286130,True,0,No user reviews,0,0,0
1286140,True,0,No user reviews,0,0,0
1286150,True,0,1 user reviews,1,0,1
1286160,True,0,1 user reviews,0,1,1
1286170,True,0,1 user reviews,0,1,1
1286180,True,0,6 user reviews,2,4,6
1286190,True,0,No user reviews,0,0,0
1286210,True,0,9 user reviews,9,0,9
1286220,True,0,No user reviews,0,0,0
1286250,True,0,No user reviews,0,0,0
1286251,True,0,No user reviews,0,0,0
1286252,True,0,No user reviews,0,0,0
1286253,True,0,No user reviews,0,0,0
1286254,True,0,No user reviews,0,0,0
1286255,True,0,No user reviews,0,0,0
1286256,True,0,No user reviews,0,0,0
1286280,True,0,No user reviews,0,0,0
1286290,True,0,No user reviews,0,0,0
1286330,True,0,No user reviews,0,0,0
1286340,True,0,9 user reviews,9,0,9
1286350,True,8,Very Positive,1588,148,1736
1286360,True,0,No user reviews,0,0,0
1286370,True,7,Positive,16,1,17
1286400,True,0,3 user reviews,3,0,3
1286420,True,0,No user reviews,0,0,0
1286440,True,0,No user reviews,0,0,0
1286450,True,0,No user reviews,0,0,0
1286470,True,0,4 user reviews,3,1,4
1286480,True,0,No user reviews,0,0,0
1286490,True,0,1 user reviews,0,1,1
1286510,True,0,1 user reviews,1,0,1
1286530,True,0,No user reviews,0,0,0
1286540,True,0,No user reviews,0,0,0
1286560,True,0,No user reviews,0,0,0
1286570,True,0,8 user reviews,1,7,8
1286590,True,0,No user reviews,0,0,0
1286600,True,0,2 user reviews,2,0,2
1286610,True,0,No user reviews,0,0,0
1286630,True,0,No user reviews,0,0,0
1286640,True,0,No user reviews,0,0,0
1286650,True,0,No user reviews,0,0,0
1286670,True,0,No user reviews,0,0,0
1286690,True,0,No user reviews,0,0,0
1286700,True,0,No user reviews,0,0,0
1286710,True,9,Overwhelmingly Positive,546,19,565
1286720,True,0,No user reviews,0,0,0
1286730,True,0,No user reviews,0,0,0
1286740,True,0,No user reviews,0,0,0
1286750,True,0,No user reviews,0,0,0
1286760,True,0,8 user reviews,8,0,8
1286800,True,0,1 user reviews,1,0,1
1286810,True,0,No user reviews,0,0,0
1286820,True,0,No user reviews,0,0,0
1286830,True,7,Positive,46,3,49
1286860,True,0,No user reviews,0,0,0
1286870,True,0,No user reviews,0,0,0
1286880,True,0,No user reviews,0,0,0
1286903,True,0,1 user reviews,1,0,1
1286905,True,0,No user reviews,0,0,0
1286912,True,0,No user reviews,0,0,0
1286913,True,0,No user reviews,0,0,0
1286914,True,0,No user reviews,0,0,0
1286915,True,0,No user reviews,0,0,0
1286916,True,0,No user reviews,0,0,0
1286930,True,0,No user reviews,0,0,0
1286940,True,0,No user reviews,0,0,0
1286950,True,0,5 user reviews,4,1,5
1286960,True,0,1 user reviews,1,0,1
1286980,True,0,4 user reviews,4,0,4
1286990,True,0,No user reviews,0,0,0
1287000,True,6,Mostly Positive,13,4,17
1287020,True,0,3 user reviews,3,0,3
1287050,True,7,Positive,25,0,25
1287051,True,0,4 user reviews,4,0,4
1287052,True,0,4 user reviews,4,0,4
1287053,True,0,2 user reviews,2,0,2
1287054,True,0,1 user reviews,1,0,1
1287055,True,0,2 user reviews,2,0,2
1287056,True,0,8 user reviews,7,1,8
1287057,True,0,3 user reviews,2,1,3
1287058,True,0,7 user reviews,7,0,7
1287059,True,0,8 user reviews,7,1,8
1287060,True,7,Positive,13,0,13
1287061,True,0,3 user reviews,3,0,3
1287062,True,0,2 user reviews,2,0,2
1287063,True,0,1 user reviews,1,0,1
1287064,True,0,2 user reviews,2,0,2
1287065,True,0,1 user reviews,1,0,1
1287066,True,0,1 user reviews,1,0,1
1287067,True,0,2 user reviews,2,0,2
1287068,True,0,1 user reviews,1,0,1
1287069,True,0,1 user reviews,1,0,1
1287070,True,0,2 user reviews,2,0,2
1287071,True,0,2 user reviews,2,0,2
1287072,True,0,2 user reviews,2,0,2
1287073,True,0,1 user reviews,1,0,1
1287074,True,0,1 user reviews,1,0,1
1287075,True,0,3 user reviews,1,2,3
1287076,True,0,1 user reviews,1,0,1
1287081,True,0,1 user reviews,1,0,1
1287082,True,0,6 user reviews,6,0,6
1287083,True,0,5 user reviews,5,0,5
1287100,True,0,No user reviews,0,0,0
1287130,True,0,No user reviews,0,0,0
1287140,True,0,No user reviews,0,0,0
1287150,True,0,No user reviews,0,0,0
1287170,True,0,No user reviews,0,0,0
1287180,True,0,1 user reviews,1,0,1
1287210,True,0,No user reviews,0,0,0
1287230,True,0,No user reviews,0,0,0
1287240,True,0,No user reviews,0,0,0
1287250,True,0,3 user reviews,1,2,3
1287260,True,0,No user reviews,0,0,0
1287280,True,0,No user reviews,0,0,0
1287300,True,0,No user reviews,0,0,0
1287310,True,0,No user reviews,0,0,0
1287320,True,0,No user reviews,0,0,0
1287321,True,0,No user reviews,0,0,0
1287322,True,0,No user reviews,0,0,0
1287323,True,0,No user reviews,0,0,0
1287324,True,0,No user reviews,0,0,0
1287330,True,0,No user reviews,0,0,0
1287370,True,0,No user reviews,0,0,0
1287380,True,0,No user reviews,0,0,0
1287420,True,0,1 user reviews,1,0,1
1287450,True,0,2 user reviews,2,0,2
1287480,True,0,No user reviews,0,0,0
1287490,True,0,No user reviews,0,0,0
1287500,True,0,9 user reviews,9,0,9
1287510,True,0,6 user reviews,6,0,6
1287530,True,0,No user reviews,0,0,0
1287540,True,0,No user reviews,0,0,0
1287570,True,0,No user reviews,0,0,0
1287580,True,0,No user reviews,0,0,0
1287581,True,0,No user reviews,0,0,0
1287582,True,0,No user reviews,0,0,0
1287590,True,6,Mostly Positive,10,3,13
1287600,True,0,7 user reviews,4,3,7
1287601,True,0,3 user reviews,3,0,3
1287710,True,0,1 user reviews,0,1,1
1287720,True,0,No user reviews,0,0,0
1287750,True,0,9 user reviews,5,4,9
1287760,True,0,No user reviews,0,0,0
1287770,True,0,1 user reviews,1,0,1
1287780,True,0,No user reviews,0,0,0
1287790,True,0,No user reviews,0,0,0
1287800,True,0,No user reviews,0,0,0
1287810,True,0,3 user reviews,3,0,3
1287830,True,0,4 user reviews,1,3,4
1287850,True,0,No user reviews,0,0,0
1287860,True,7,Positive,14,0,14
1287880,True,0,1 user reviews,0,1,1
1287890,True,0,No user reviews,0,0,0
1287910,True,0,No user reviews,0,0,0
1287960,True,0,No user reviews,0,0,0
1287970,True,0,1 user reviews,1,0,1
1287990,True,0,No user reviews,0,0,0
1288000,True,5,Mixed,26,13,39
1288010,True,0,No user reviews,0,0,0
1288030,True,0,No user reviews,0,0,0
1288040,True,0,No user reviews,0,0,0
1288050,True,0,1 user reviews,1,0,1
1288070,True,0,8 user reviews,8,0,8
1288080,True,0,No user reviews,0,0,0
1288090,True,0,2 user reviews,2,0,2
1288130,True,0,5 user reviews,5,0,5
1288150,True,0,No user reviews,0,0,0
1288170,True,0,No user reviews,0,0,0
1288240,True,0,4 user reviews,1,3,4
1288260,True,0,No user reviews,0,0,0
1288300,True,0,No user reviews,0,0,0
1288310,True,0,No user reviews,0,0,0
1288330,True,0,No user reviews,0,0,0
1288340,True,0,9 user reviews,3,6,9
1288370,True,0,1 user reviews,0,1,1
1288380,True,0,1 user reviews,0,1,1
1288400,True,0,No user reviews,0,0,0
1288420,True,0,No user reviews,0,0,0
1288430,True,0,No user reviews,0,0,0
1288440,True,0,No user reviews,0,0,0
1288460,True,0,No user reviews,0,0,0
1288490,True,0,No user reviews,0,0,0
1288510,True,0,No user reviews,0,0,0
1288520,True,0,No user reviews,0,0,0
1288540,True,0,No user reviews,0,0,0
1288550,True,0,1 user reviews,1,0,1
1288600,True,0,No user reviews,0,0,0
1288610,True,0,No user reviews,0,0,0
1288630,True,0,1 user reviews,1,0,1
1288650,True,0,No user reviews,0,0,0
1288670,True,0,3 user reviews,2,1,3
1288681,True,0,No user reviews,0,0,0
1288682,True,0,No user reviews,0,0,0
1288683,True,0,No user reviews,0,0,0
1288684,True,0,No user reviews,0,0,0
1288685,True,0,No user reviews,0,0,0
1288720,True,0,No user reviews,0,0,0
1288760,True,0,No user reviews,0,0,0
1288780,True,0,No user reviews,0,0,0
1288810,True,0,No user reviews,0,0,0
1288830,True,0,No user reviews,0,0,0
1288850,True,0,No user reviews,0,0,0
1288880,True,0,No user reviews,0,0,0
1288910,True,0,No user reviews,0,0,0
1288930,True,0,No user reviews,0,0,0
1288940,True,0,No user reviews,0,0,0
1288950,True,0,No user reviews,0,0,0
1288960,True,0,No user reviews,0,0,0
1289010,True,0,No user reviews,0,0,0
1289050,True,0,No user reviews,0,0,0
1289060,True,0,1 user reviews,1,0,1
1289100,True,0,No user reviews,0,0,0
1289110,True,0,No user reviews,0,0,0
1289120,True,0,No user reviews,0,0,0
1289170,True,0,No user reviews,0,0,0
1289180,True,0,No user reviews,0,0,0
1289190,True,0,No user reviews,0,0,0
1289191,True,0,No user reviews,0,0,0
1289234,True,0,No user reviews,0,0,0
1289240,True,0,1 user reviews,1,0,1
1289250,True,0,No user reviews,0,0,0
1289260,True,0,No user reviews,0,0,0
1289280,True,0,No user reviews,0,0,0
1289300,True,0,No user reviews,0,0,0
1289310,True,8,Very Positive,96,1,97
1289330,True,0,7 user reviews,6,1,7
1289340,True,0,No user reviews,0,0,0
1289360,True,0,No user reviews,0,0,0
1289390,True,7,Positive,10,0,10
1289400,True,0,No user reviews,0,0,0
1289440,True,0,7 user reviews,5,2,7
1289460,True,0,No user reviews,0,0,0
1289480,True,0,No user reviews,0,0,0
1289490,True,7,Positive,12,3,15
1289500,True,0,No user reviews,0,0,0
1289510,True,0,No user reviews,0,0,0
1289550,True,0,No user reviews,0,0,0
1289610,True,0,No user reviews,0,0,0
1289630,True,0,No user reviews,0,0,0
1289640,True,8,Very Positive,415,14,429
1289660,True,0,No user reviews,0,0,0
1289670,True,0,3 user reviews,2,1,3
1289690,True,0,1 user reviews,1,0,1
1289700,True,0,No user reviews,0,0,0
1289710,True,0,No user reviews,0,0,0
1289720,True,0,No user reviews,0,0,0
1289740,True,0,No user reviews,0,0,0
1289750,True,0,3 user reviews,3,0,3
1289760,True,0,2 user reviews,2,0,2
1289770,True,0,No user reviews,0,0,0
1289780,True,0,4 user reviews,2,2,4
1289810,True,0,No user reviews,0,0,0
1289850,True,0,1 user reviews,1,0,1
1289890,True,0,No user reviews,0,0,0
1289900,True,0,1 user reviews,0,1,1
1289910,True,0,2 user reviews,2,0,2
1289920,True,0,No user reviews,0,0,0
1289950,True,0,5 user reviews,5,0,5
1289960,True,0,4 user reviews,4,0,4
1289980,True,0,No user reviews,0,0,0
1290000,True,0,No user reviews,0,0,0
1290010,True,0,1 user reviews,1,0,1
1290020,True,0,No user reviews,0,0,0
1290030,True,0,No user reviews,0,0,0
1290040,True,0,1 user reviews,1,0,1
1290060,True,0,No user reviews,0,0,0
1290070,True,6,Mostly Positive,15,5,20
1290090,True,0,No user reviews,0,0,0
1290110,True,0,5 user reviews,3,2,5
1290160,True,0,5 user reviews,3,2,5
1290170,True,8,Very Positive,77,13,90
1290190,True,0,No user reviews,0,0,0
1290200,True,0,7 user reviews,7,0,7
1290210,True,0,No user reviews,0,0,0
1290220,True,8,Very Positive,58,0,58
1290230,True,0,No user reviews,0,0,0
1290240,True,0,No user reviews,0,0,0
1290250,True,7,Positive,15,1,16
1290260,True,0,No user reviews,0,0,0
1290270,True,8,Very Positive,102,15,117
1290280,True,0,No user reviews,0,0,0
1290290,True,7,Positive,8,2,10
1290300,True,0,No user reviews,0,0,0
1290350,True,0,No user reviews,0,0,0
1290380,True,0,No user reviews,0,0,0
1290390,True,0,1 user reviews,1,0,1
1290400,True,0,No user reviews,0,0,0
1290401,True,0,No user reviews,0,0,0
1290402,True,0,No user reviews,0,0,0
1290410,True,0,No user reviews,0,0,0
1290420,True,0,No user reviews,0,0,0
1290422,True,0,No user reviews,0,0,0
1290423,True,0,No user reviews,0,0,0
1290424,True,0,No user reviews,0,0,0
1290460,True,0,7 user reviews,5,2,7
1290470,True,0,No user reviews,0,0,0
1290480,True,0,1 user reviews,1,0,1
1290500,True,0,No user reviews,0,0,0
1290510,True,0,No user reviews,0,0,0
1290520,True,0,No user reviews,0,0,0
1290521,True,0,No user reviews,0,0,0
1290530,True,0,No user reviews,0,0,0
1290531,True,0,No user reviews,0,0,0
1290532,True,0,No user reviews,0,0,0
1290550,True,0,No user reviews,0,0,0
1290580,True,0,No user reviews,0,0,0
1290590,True,0,No user reviews,0,0,0
1290620,True,0,1 user reviews,1,0,1
1290630,True,0,No user reviews,0,0,0
1290650,True,0,No user reviews,0,0,0
1290660,True,0,No user reviews,0,0,0
1290670,True,0,4 user reviews,4,0,4
1290680,True,0,2 user reviews,2,0,2
1290690,True,0,No user reviews,0,0,0
1290700,True,0,No user reviews,0,0,0
1290710,True,0,No user reviews,0,0,0
1290720,True,0,5 user reviews,5,0,5
1290730,True,0,No user reviews,0,0,0
1290750,True,0,No user reviews,0,0,0
1290760,True,0,No user reviews,0,0,0
1290770,True,0,6 user reviews,6,0,6
1290780,True,0,No user reviews,0,0,0
1290790,True,0,6 user reviews,6,0,6
1290800,True,0,No user reviews,0,0,0
1290810,True,0,No user reviews,0,0,0
1290820,True,0,No user reviews,0,0,0
1290830,True,0,No user reviews,0,0,0
1290840,True,0,No user reviews,0,0,0
1290850,True,0,No user reviews,0,0,0
1290870,True,0,No user reviews,0,0,0
1290880,True,0,No user reviews,0,0,0
1290890,True,0,No user reviews,0,0,0
1290910,True,0,No user reviews,0,0,0
1290911,True,0,1 user reviews,1,0,1
1290912,True,0,No user reviews,0,0,0
1290913,True,0,1 user reviews,1,0,1
1290914,True,0,No user reviews,0,0,0
1290915,True,0,No user reviews,0,0,0
1290916,True,0,No user reviews,0,0,0
1290917,True,0,No user reviews,0,0,0
1290918,True,0,No user reviews,0,0,0
1290920,True,0,4 user reviews,4,0,4
1290950,True,0,No user reviews,0,0,0
1290960,True,0,No user reviews,0,0,0
1290970,True,0,No user reviews,0,0,0
1290980,True,0,No user reviews,0,0,0
1291000,True,0,No user reviews,0,0,0
1291010,True,0,No user reviews,0,0,0
1291020,True,0,4 user reviews,4,0,4
1291030,True,0,No user reviews,0,0,0
1291031,True,0,No user reviews,0,0,0
1291032,True,0,No user reviews,0,0,0
1291033,True,0,No user reviews,0,0,0
1291034,True,0,No user reviews,0,0,0
1291035,True,0,No user reviews,0,0,0
1291036,True,0,No user reviews,0,0,0
1291037,True,0,No user reviews,0,0,0
1291038,True,0,No user reviews,0,0,0
1291040,True,0,No user reviews,0,0,0
1291050,True,7,Positive,11,0,11
1291060,True,0,3 user reviews,3,0,3
1291080,True,0,No user reviews,0,0,0
1291090,True,0,3 user reviews,3,0,3
1291100,True,0,No user reviews,0,0,0
1291110,True,0,1 user reviews,0,1,1
1291140,True,0,No user reviews,0,0,0
1291150,True,0,No user reviews,0,0,0
1291170,True,7,Positive,31,4,35
1291180,True,0,No user reviews,0,0,0
1291210,True,0,No user reviews,0,0,0
1291220,True,0,No user reviews,0,0,0
1291230,True,0,No user reviews,0,0,0
1291240,True,0,No user reviews,0,0,0
1291250,True,0,1 user reviews,1,0,1
1291270,True,0,No user reviews,0,0,0
1291280,True,0,No user reviews,0,0,0
1291310,True,0,2 user reviews,2,0,2
1291320,True,0,No user reviews,0,0,0
1291330,True,6,Mostly Positive,17,6,23
1291340,True,9,Overwhelmingly Positive,2744,29,2773
1291360,True,0,No user reviews,0,0,0
1291370,True,0,1 user reviews,1,0,1
1291390,True,0,No user reviews,0,0,0
1291400,True,0,6 user reviews,6,0,6
1291430,True,0,No user reviews,0,0,0
1291470,True,0,No user reviews,0,0,0
1291480,True,0,No user reviews,0,0,0
1291500,True,0,No user reviews,0,0,0
1291530,True,0,No user reviews,0,0,0
1291540,True,7,Positive,19,0,19
1291580,True,0,No user reviews,0,0,0
1291600,True,0,No user reviews,0,0,0
1291610,True,0,3 user reviews,3,0,3
1291620,True,0,No user reviews,0,0,0
1291640,True,0,1 user reviews,1,0,1
1291650,True,0,No user reviews,0,0,0
1291660,True,0,No user reviews,0,0,0
1291670,True,0,No user reviews,0,0,0
1291680,True,0,No user reviews,0,0,0
1291690,True,0,No user reviews,0,0,0
1291700,True,0,No user reviews,0,0,0
1291710,True,0,No user reviews,0,0,0
1291720,True,0,1 user reviews,1,0,1
1291740,True,0,1 user reviews,1,0,1
1291760,True,0,No user reviews,0,0,0
1291780,True,0,No user reviews,0,0,0
1291781,True,0,No user reviews,0,0,0
1291790,True,0,No user reviews,0,0,0
1291800,True,0,No user reviews,0,0,0
1291810,True,0,No user reviews,0,0,0
1291820,True,0,No user reviews,0,0,0
1291830,True,0,3 user reviews,2,1,3
1291860,True,0,No user reviews,0,0,0
1291880,True,0,No user reviews,0,0,0
1291881,True,0,No user reviews,0,0,0
1291882,True,0,No user reviews,0,0,0
1291883,True,0,No user reviews,0,0,0
1291884,True,0,No user reviews,0,0,0
1291885,True,0,No user reviews,0,0,0
1291886,True,0,No user reviews,0,0,0
1291887,True,0,No user reviews,0,0,0
1291888,True,0,No user reviews,0,0,0
1291889,True,0,No user reviews,0,0,0
1291930,True,0,No user reviews,0,0,0
1291940,True,0,No user reviews,0,0,0
1291960,True,0,No user reviews,0,0,0
1291970,True,0,No user reviews,0,0,0
1291990,True,0,No user reviews,0,0,0
1292000,True,0,No user reviews,0,0,0
1292010,True,8,Very Positive,53,6,59
1292020,True,8,Very Positive,101,0,101
1292030,True,0,No user reviews,0,0,0
1292040,True,8,Very Positive,398,69,467
1292050,True,0,1 user reviews,1,0,1
1292060,True,0,No user reviews,0,0,0
1292070,True,0,2 user reviews,2,0,2
1292100,True,0,1 user reviews,1,0,1
1292120,True,0,No user reviews,0,0,0
1292140,True,0,2 user reviews,2,0,2
1292160,True,0,No user reviews,0,0,0
1292170,True,0,9 user reviews,8,1,9
1292180,True,6,Mostly Positive,21,6,27
1292200,True,0,No user reviews,0,0,0
1292220,True,0,1 user reviews,1,0,1
1292230,True,0,No user reviews,0,0,0
1292231,True,0,No user reviews,0,0,0
1292240,True,0,No user reviews,0,0,0
1292250,True,0,8 user reviews,8,0,8
1292260,True,0,No user reviews,0,0,0
1292270,True,0,1 user reviews,1,0,1
1292280,True,0,4 user reviews,3,1,4
1292290,True,0,4 user reviews,3,1,4
1292300,True,0,7 user reviews,7,0,7
1292301,True,0,3 user reviews,3,0,3
1292302,True,0,1 user reviews,1,0,1
1292303,True,0,1 user reviews,1,0,1
1292304,True,0,1 user reviews,1,0,1
1292310,True,0,No user reviews,0,0,0
1292320,True,0,No user reviews,0,0,0
1292330,True,0,No user reviews,0,0,0
1292350,True,0,No user reviews,0,0,0
1292360,True,0,No user reviews,0,0,0
1292370,True,0,No user reviews,0,0,0
1292380,True,0,No user reviews,0,0,0
1292400,True,0,No user reviews,0,0,0
1292410,True,0,No user reviews,0,0,0
1292430,True,0,No user reviews,0,0,0
1292440,True,0,No user reviews,0,0,0
1292460,True,0,No user reviews,0,0,0
1292470,True,0,No user reviews,0,0,0
1292480,True,0,No user reviews,0,0,0
1292490,True,0,9 user reviews,6,3,9
1292500,True,0,No user reviews,0,0,0
1292520,True,0,1 user reviews,1,0,1
1292530,True,0,No user reviews,0,0,0
1292540,True,6,Mostly Positive,30,8,38
1292550,True,0,2 user reviews,2,0,2
1292560,True,0,No user reviews,0,0,0
1292570,True,0,No user reviews,0,0,0
1292590,True,0,No user reviews,0,0,0
1292610,True,0,No user reviews,0,0,0
1292630,True,0,1 user reviews,1,0,1
1292640,True,0,No user reviews,0,0,0
1292660,True,0,No user reviews,0,0,0
1292690,True,8,Very Positive,240,4,244
1292700,True,0,No user reviews,0,0,0
1292710,True,0,No user reviews,0,0,0
1292720,True,0,No user reviews,0,0,0
1292750,True,0,5 user reviews,2,3,5
1292760,True,0,No user reviews,0,0,0
1292770,True,7,Positive,10,0,10
1292780,True,0,No user reviews,0,0,0
1292810,True,0,No user reviews,0,0,0
1292820,True,0,No user reviews,0,0,0
1292830,True,0,No user reviews,0,0,0
1292850,True,0,No user reviews,0,0,0
1292860,True,0,No user reviews,0,0,0
1292870,True,0,No user reviews,0,0,0
1292880,True,0,No user reviews,0,0,0
1292890,True,0,No user reviews,0,0,0
1292910,True,0,No user reviews,0,0,0
1292920,True,0,2 user reviews,2,0,2
1292930,True,0,No user reviews,0,0,0
1292940,True,8,Very Positive,133,0,133
1292950,True,0,No user reviews,0,0,0
1292960,True,0,1 user reviews,1,0,1
1292970,True,0,No user reviews,0,0,0
1292980,True,0,No user reviews,0,0,0
1292990,True,0,No user reviews,0,0,0
1293000,True,0,8 user reviews,8,0,8
1293010,True,0,No user reviews,0,0,0
1293020,True,0,No user reviews,0,0,0
1293030,True,0,No user reviews,0,0,0
1293040,True,0,No user reviews,0,0,0
1293050,True,0,No user reviews,0,0,0
1293080,True,0,No user reviews,0,0,0
1293090,True,0,No user reviews,0,0,0
1293110,True,0,No user reviews,0,0,0
1293120,True,0,No user reviews,0,0,0
1293160,True,0,No user reviews,0,0,0
1293170,True,0,No user reviews,0,0,0
1293180,True,0,No user reviews,0,0,0
1293190,True,0,No user reviews,0,0,0
1293200,True,0,No user reviews,0,0,0
1293210,True,0,No user reviews,0,0,0
1293220,True,0,No user reviews,0,0,0
1293230,True,8,Very Positive,262,27,289
1293240,True,0,No user reviews,0,0,0
1293250,True,0,No user reviews,0,0,0
1293270,True,0,No user reviews,0,0,0
1293280,True,0,9 user reviews,7,2,9
1293290,True,0,No user reviews,0,0,0
1293300,True,0,No user reviews,0,0,0
1293320,True,0,No user reviews,0,0,0
1293330,True,0,No user reviews,0,0,0
1293340,True,0,No user reviews,0,0,0
1293350,True,0,No user reviews,0,0,0
1293360,True,0,No user reviews,0,0,0
1293370,True,0,No user reviews,0,0,0
1293400,True,0,3 user reviews,2,1,3
1293410,True,0,No user reviews,0,0,0
1293420,True,0,No user reviews,0,0,0
1293430,True,0,1 user reviews,0,1,1
1293440,True,0,No user reviews,0,0,0
1293450,True,0,No user reviews,0,0,0
1293470,True,0,No user reviews,0,0,0
1293480,True,0,No user reviews,0,0,0
1293490,True,0,No user reviews,0,0,0
1293510,True,0,No user reviews,0,0,0
1293520,True,7,Positive,25,0,25
1293530,True,0,5 user reviews,3,2,5
1293550,True,0,No user reviews,0,0,0
1293580,True,0,No user reviews,0,0,0
1293590,True,0,No user reviews,0,0,0
1293591,True,0,No user reviews,0,0,0
1293610,True,0,No user reviews,0,0,0
1293620,True,0,4 user reviews,4,0,4
1293650,True,0,No user reviews,0,0,0
1293660,True,0,No user reviews,0,0,0
1293670,True,0,No user reviews,0,0,0
1293700,True,0,No user reviews,0,0,0
1293730,True,0,No user reviews,0,0,0
1293740,True,0,No user reviews,0,0,0
1293760,True,0,No user reviews,0,0,0
1293770,True,0,No user reviews,0,0,0
1293780,True,0,2 user reviews,2,0,2
1293790,True,0,No user reviews,0,0,0
1293810,True,0,No user reviews,0,0,0
1293820,True,8,Very Positive,324,10,334
1293850,True,0,1 user reviews,0,1,1
1293860,True,0,No user reviews,0,0,0
1293870,True,0,1 user reviews,1,0,1
1293880,True,0,No user reviews,0,0,0
1293890,True,0,No user reviews,0,0,0
1293891,True,0,No user reviews,0,0,0
1293892,True,0,No user reviews,0,0,0
1293893,True,0,1 user reviews,0,1,1
1293900,True,7,Positive,18,0,18
1293910,True,0,No user reviews,0,0,0
1293920,True,0,3 user reviews,2,1,3
1293940,True,0,4 user reviews,4,0,4
1293950,True,0,No user reviews,0,0,0
1293970,True,0,No user reviews,0,0,0
1293980,True,0,4 user reviews,2,2,4
1293990,True,7,Positive,14,0,14
1294000,True,0,1 user reviews,1,0,1
1294020,True,0,3 user reviews,3,0,3
1294030,True,0,No user reviews,0,0,0
1294040,True,0,3 user reviews,2,1,3
1294060,True,0,No user reviews,0,0,0
1294100,True,0,No user reviews,0,0,0
1294120,True,0,2 user reviews,2,0,2
1294130,True,0,No user reviews,0,0,0
1294131,True,0,No user reviews,0,0,0
1294140,True,0,No user reviews,0,0,0
1294141,True,0,No user reviews,0,0,0
1294143,True,0,No user reviews,0,0,0
1294150,True,0,No user reviews,0,0,0
1294160,True,0,No user reviews,0,0,0
1294170,True,0,No user reviews,0,0,0
1294220,True,0,No user reviews,0,0,0
1294230,True,7,Positive,15,0,15
1294250,True,0,No user reviews,0,0,0
1294260,True,0,No user reviews,0,0,0
1294280,True,0,5 user reviews,5,0,5
1294290,True,0,No user reviews,0,0,0
1294300,True,0,No user reviews,0,0,0
1294310,True,0,No user reviews,0,0,0
1294320,True,0,No user reviews,0,0,0
1294330,True,0,No user reviews,0,0,0
1294340,True,0,No user reviews,0,0,0
1294360,True,0,No user reviews,0,0,0
1294380,True,0,No user reviews,0,0,0
1294390,True,0,1 user reviews,1,0,1
1294400,True,0,No user reviews,0,0,0
1294410,True,0,No user reviews,0,0,0
1294430,True,0,No user reviews,0,0,0
1294440,True,0,No user reviews,0,0,0
1294460,True,0,1 user reviews,0,1,1
1294480,True,0,No user reviews,0,0,0
1294490,True,0,No user reviews,0,0,0
1294500,True,0,No user reviews,0,0,0
1294530,True,0,No user reviews,0,0,0
1294540,True,0,No user reviews,0,0,0
1294570,True,0,No user reviews,0,0,0
1294580,True,0,No user reviews,0,0,0
1294590,True,0,No user reviews,0,0,0
1294610,True,0,No user reviews,0,0,0
1294620,True,0,No user reviews,0,0,0
1294630,True,0,No user reviews,0,0,0
1294640,True,0,No user reviews,0,0,0
1294650,True,0,No user reviews,0,0,0
1294680,True,4,Mostly Negative,4,11,15
1294690,True,0,No user reviews,0,0,0
1294700,True,0,No user reviews,0,0,0
1294710,True,0,No user reviews,0,0,0
1294720,True,0,No user reviews,0,0,0
1294730,True,0,No user reviews,0,0,0
1294740,True,0,No user reviews,0,0,0
1294750,True,0,5 user reviews,5,0,5
1294760,True,6,Mostly Positive,26,10,36
1294780,True,7,Positive,19,0,19
1294840,True,0,No user reviews,0,0,0
1294850,True,0,No user reviews,0,0,0
1294880,True,0,No user reviews,0,0,0
1294900,True,0,No user reviews,0,0,0
1294910,True,0,No user reviews,0,0,0
1294920,True,0,5 user reviews,2,3,5
1294940,True,0,No user reviews,0,0,0
1294960,True,0,No user reviews,0,0,0
1294970,True,0,4 user reviews,3,1,4
1294980,True,0,No user reviews,0,0,0
1295000,True,0,No user reviews,0,0,0
1295030,True,0,1 user reviews,1,0,1
1295040,True,0,No user reviews,0,0,0
1295050,True,0,No user reviews,0,0,0
1295070,True,0,No user reviews,0,0,0
1295090,True,0,No user reviews,0,0,0
1295100,True,0,No user reviews,0,0,0
1295110,True,0,No user reviews,0,0,0
1295120,True,0,No user reviews,0,0,0
1295130,True,0,3 user reviews,3,0,3
1295140,True,0,No user reviews,0,0,0
1295150,True,0,No user reviews,0,0,0
1295160,True,0,2 user reviews,2,0,2
1295180,True,0,2 user reviews,2,0,2
1295200,True,0,No user reviews,0,0,0
1295210,True,0,No user reviews,0,0,0
1295220,True,0,No user reviews,0,0,0
1295230,True,0,1 user reviews,0,1,1
1295240,True,0,No user reviews,0,0,0
1295250,True,0,No user reviews,0,0,0
1295260,True,0,No user reviews,0,0,0
1295280,True,0,No user reviews,0,0,0
1295300,True,0,2 user reviews,0,2,2
1295310,True,0,No user reviews,0,0,0
1295330,True,0,1 user reviews,1,0,1
1295350,True,7,Positive,13,0,13
1295360,True,0,No user reviews,0,0,0
1295370,True,0,No user reviews,0,0,0
1295390,True,0,No user reviews,0,0,0
1295410,True,0,No user reviews,0,0,0
1295420,True,0,No user reviews,0,0,0
1295440,True,0,No user reviews,0,0,0
1295470,True,0,No user reviews,0,0,0
1295480,True,0,No user reviews,0,0,0
1295490,True,0,No user reviews,0,0,0
1295510,True,0,No user reviews,0,0,0
1295560,True,0,No user reviews,0,0,0
1295570,True,0,No user reviews,0,0,0
1295590,True,0,No user reviews,0,0,0
1295610,True,0,No user reviews,0,0,0
1295650,True,7,Positive,12,3,15
1295670,True,0,No user reviews,0,0,0
1295680,True,0,No user reviews,0,0,0
1295712,True,0,No user reviews,0,0,0
1295713,True,0,No user reviews,0,0,0
1295714,True,0,No user reviews,0,0,0
1295715,True,0,No user reviews,0,0,0
1295716,True,0,No user reviews,0,0,0
1295717,True,0,No user reviews,0,0,0
1295718,True,0,No user reviews,0,0,0
1295719,True,0,No user reviews,0,0,0
1295720,True,0,No user reviews,0,0,0
1295721,True,0,No user reviews,0,0,0
1295722,True,0,No user reviews,0,0,0
1295723,True,0,No user reviews,0,0,0
1295724,True,0,No user reviews,0,0,0
1295725,True,0,No user reviews,0,0,0
1295726,True,0,No user reviews,0,0,0
1295727,True,0,No user reviews,0,0,0
1295740,True,0,No user reviews,0,0,0
1295750,True,0,No user reviews,0,0,0
1295760,True,0,9 user reviews,8,1,9
1295770,True,0,No user reviews,0,0,0
1295780,True,0,No user reviews,0,0,0
1295800,True,0,8 user reviews,7,1,8
1295810,True,0,No user reviews,0,0,0
1295830,True,0,No user reviews,0,0,0
1295860,True,0,2 user reviews,0,2,2
1295880,True,0,1 user reviews,1,0,1
1295890,True,0,2 user reviews,2,0,2
1295900,True,0,No user reviews,0,0,0
1295910,True,0,No user reviews,0,0,0
1295920,True,0,No user reviews,0,0,0
1295940,True,0,No user reviews,0,0,0
1295960,True,0,No user reviews,0,0,0
1295970,True,0,No user reviews,0,0,0
1295980,True,0,No user reviews,0,0,0
1295990,True,0,No user reviews,0,0,0
1296000,True,0,No user reviews,0,0,0
1296180,True,0,1 user reviews,0,1,1
1296190,True,0,No user reviews,0,0,0
1296200,True,0,2 user reviews,1,1,2
1296210,True,0,No user reviews,0,0,0
1296230,True,0,No user reviews,0,0,0
1296240,True,0,No user reviews,0,0,0
1296260,True,0,3 user reviews,1,2,3
1296270,True,0,No user reviews,0,0,0
1296280,True,0,No user reviews,0,0,0
1296290,True,0,9 user reviews,4,5,9
1296310,True,0,No user reviews,0,0,0
1296340,True,0,No user reviews,0,0,0
1296350,True,0,No user reviews,0,0,0
1296370,True,0,1 user reviews,0,1,1
1296400,True,0,No user reviews,0,0,0
1296410,True,0,No user reviews,0,0,0
1296420,True,0,No user reviews,0,0,0
1296430,True,0,2 user reviews,2,0,2
1296440,True,0,No user reviews,0,0,0
1296470,True,0,No user reviews,0,0,0
1296480,True,0,1 user reviews,1,0,1
1296510,True,8,Very Positive,117,17,134
1296530,True,0,No user reviews,0,0,0
1296560,True,0,No user reviews,0,0,0
1296580,True,0,No user reviews,0,0,0
1296590,True,0,No user reviews,0,0,0
1296610,True,0,No user reviews,0,0,0
1296640,True,0,No user reviews,0,0,0
1296650,True,0,No user reviews,0,0,0
1296680,True,0,No user reviews,0,0,0
1296690,True,0,1 user reviews,1,0,1
1296700,True,0,No user reviews,0,0,0
1296710,True,0,No user reviews,0,0,0
1296711,True,0,No user reviews,0,0,0
1296712,True,0,2 user reviews,2,0,2
1296713,True,0,No user reviews,0,0,0
1296714,True,0,No user reviews,0,0,0
1296715,True,0,No user reviews,0,0,0
1296720,True,0,No user reviews,0,0,0
1296740,True,0,No user reviews,0,0,0
1296741,True,0,No user reviews,0,0,0
1296742,True,0,No user reviews,0,0,0
1296743,True,0,No user reviews,0,0,0
1296744,True,0,No user reviews,0,0,0
1296760,True,0,No user reviews,0,0,0
1296761,True,0,No user reviews,0,0,0
1296762,True,0,No user reviews,0,0,0
1296763,True,0,No user reviews,0,0,0
1296770,True,7,Positive,45,1,46
1296780,True,0,No user reviews,0,0,0
1296790,True,0,No user reviews,0,0,0
1296800,True,0,No user reviews,0,0,0
1296810,True,0,No user reviews,0,0,0
1296820,True,0,No user reviews,0,0,0
1296840,True,7,Positive,26,3,29
1296850,True,0,No user reviews,0,0,0
1296860,True,0,5 user reviews,5,0,5
1296880,True,0,1 user reviews,1,0,1
1296900,True,0,2 user reviews,2,0,2
1296910,True,0,No user reviews,0,0,0
1296950,True,0,No user reviews,0,0,0
1296980,True,0,No user reviews,0,0,0
1296990,True,0,No user reviews,0,0,0
1297000,True,0,No user reviews,0,0,0
1297010,True,0,8 user reviews,7,1,8
1297020,True,0,No user reviews,0,0,0
1297050,True,0,No user reviews,0,0,0
1297060,True,0,No user reviews,0,0,0
1297090,True,0,No user reviews,0,0,0
1297100,True,0,No user reviews,0,0,0
1297110,True,0,No user reviews,0,0,0
1297140,True,0,No user reviews,0,0,0
1297150,True,0,No user reviews,0,0,0
1297160,True,8,Very Positive,286,9,295
1297180,True,0,No user reviews,0,0,0
1297190,True,0,No user reviews,0,0,0
1297200,True,0,No user reviews,0,0,0
1297230,True,0,9 user reviews,9,0,9
1297240,True,0,No user reviews,0,0,0
1297250,True,0,No user reviews,0,0,0
1297270,True,0,No user reviews,0,0,0
1297280,True,0,No user reviews,0,0,0
1297290,True,0,No user reviews,0,0,0
1297300,True,0,No user reviews,0,0,0
1297320,True,0,No user reviews,0,0,0
1297330,True,0,No user reviews,0,0,0
1297370,True,0,5 user reviews,1,4,5
1297390,True,5,Mixed,6,4,10
1297410,True,0,No user reviews,0,0,0
1297420,True,0,No user reviews,0,0,0
1297440,True,0,No user reviews,0,0,0
1297460,True,0,3 user reviews,3,0,3
1297470,True,0,9 user reviews,5,4,9
1297480,True,0,No user reviews,0,0,0
1297500,True,0,No user reviews,0,0,0
1297510,True,0,No user reviews,0,0,0
1297520,True,0,No user reviews,0,0,0
1297530,True,0,No user reviews,0,0,0
1297540,True,0,No user reviews,0,0,0
1297560,True,0,No user reviews,0,0,0
1297570,True,0,No user reviews,0,0,0
1297580,True,0,No user reviews,0,0,0
1297600,True,0,4 user reviews,4,0,4
1297610,True,0,No user reviews,0,0,0
1297650,True,0,6 user reviews,4,2,6
1297660,True,0,No user reviews,0,0,0
1297680,True,0,No user reviews,0,0,0
1297690,True,0,No user reviews,0,0,0
1297700,True,0,No user reviews,0,0,0
1297720,True,0,No user reviews,0,0,0
1297730,True,0,No user reviews,0,0,0
1297770,True,0,No user reviews,0,0,0
1297790,True,7,Positive,30,0,30
1297800,True,0,No user reviews,0,0,0
1297810,True,0,No user reviews,0,0,0
1297850,True,0,1 user reviews,1,0,1
1297880,True,0,No user reviews,0,0,0
1297890,True,0,No user reviews,0,0,0
1297940,True,0,No user reviews,0,0,0
1297950,True,0,No user reviews,0,0,0
1297980,True,0,No user reviews,0,0,0
1298000,True,0,No user reviews,0,0,0
1298010,True,0,No user reviews,0,0,0
1298020,True,0,No user reviews,0,0,0
1298030,True,0,No user reviews,0,0,0
1298040,True,0,No user reviews,0,0,0
1298050,True,0,4 user reviews,4,0,4
1298080,True,0,No user reviews,0,0,0
1298090,True,0,1 user reviews,1,0,1
1298100,True,0,2 user reviews,2,0,2
1298110,True,0,No user reviews,0,0,0
1298120,True,0,No user reviews,0,0,0
1298130,True,0,No user reviews,0,0,0
1298140,True,0,No user reviews,0,0,0
1298150,True,0,No user reviews,0,0,0
1298170,True,0,No user reviews,0,0,0
1298180,True,0,1 user reviews,0,1,1
1298200,True,0,No user reviews,0,0,0
1298210,True,0,2 user reviews,2,0,2
1298220,True,0,No user reviews,0,0,0
1298230,True,0,No user reviews,0,0,0
1298250,True,0,No user reviews,0,0,0
1298260,True,0,7 user reviews,7,0,7
1298270,True,0,No user reviews,0,0,0
1298280,True,0,7 user reviews,7,0,7
1298290,True,0,No user reviews,0,0,0
1298310,True,0,8 user reviews,8,0,8
1298320,True,0,3 user reviews,3,0,3
1298330,True,0,No user reviews,0,0,0
1298340,True,0,2 user reviews,2,0,2
1298360,True,0,No user reviews,0,0,0
1298370,True,0,No user reviews,0,0,0
1298380,True,0,No user reviews,0,0,0
1298390,True,0,No user reviews,0,0,0
1298460,True,0,No user reviews,0,0,0
1298470,True,0,No user reviews,0,0,0
1298480,True,0,No user reviews,0,0,0
1298500,True,0,No user reviews,0,0,0
1298510,True,0,2 user reviews,2,0,2
1298520,True,0,1 user reviews,0,1,1
1298530,True,0,No user reviews,0,0,0
1298550,True,0,No user reviews,0,0,0
1298570,True,0,No user reviews,0,0,0
1298580,True,0,No user reviews,0,0,0
1298590,True,8,Very Positive,364,2,366
1298600,True,0,No user reviews,0,0,0
1298620,True,0,No user reviews,0,0,0
1298630,True,0,No user reviews,0,0,0
1298640,True,0,No user reviews,0,0,0
1298650,True,0,No user reviews,0,0,0
1298660,True,0,2 user reviews,2,0,2
1298670,True,0,4 user reviews,4,0,4
1298680,True,0,No user reviews,0,0,0
1298690,True,0,No user reviews,0,0,0
1298700,True,0,No user reviews,0,0,0
1298720,True,0,1 user reviews,1,0,1
1298740,True,0,No user reviews,0,0,0
1298760,True,0,No user reviews,0,0,0
1298780,True,0,No user reviews,0,0,0
1298800,True,0,No user reviews,0,0,0
1298810,True,0,No user reviews,0,0,0
1298820,True,0,3 user reviews,2,1,3
1298830,True,0,No user reviews,0,0,0
1298850,True,0,No user reviews,0,0,0
1298860,True,0,No user reviews,0,0,0
1298870,True,0,No user reviews,0,0,0
1298880,True,0,No user reviews,0,0,0
1298890,True,0,1 user reviews,1,0,1
1298910,True,0,No user reviews,0,0,0
1298920,True,0,No user reviews,0,0,0
1298940,True,0,No user reviews,0,0,0
1298970,True,0,No user reviews,0,0,0
1298980,True,0,No user reviews,0,0,0
1299010,True,0,1 user reviews,1,0,1
1299020,True,0,No user reviews,0,0,0
1299040,True,0,No user reviews,0,0,0
1299050,True,0,No user reviews,0,0,0
1299070,True,0,No user reviews,0,0,0
1299090,True,0,4 user reviews,4,0,4
1299120,True,8,Very Positive,50,1,51
1299150,True,0,No user reviews,0,0,0
1299170,True,0,No user reviews,0,0,0
1299190,True,0,1 user reviews,1,0,1
1299200,True,0,No user reviews,0,0,0
1299220,True,0,No user reviews,0,0,0
1299230,True,0,No user reviews,0,0,0
1299250,True,0,No user reviews,0,0,0
1299260,True,0,No user reviews,0,0,0
1299270,True,0,No user reviews,0,0,0
1299300,True,0,No user reviews,0,0,0
1299320,True,8,Very Positive,190,9,199
1299330,True,0,No user reviews,0,0,0
1299340,True,0,No user reviews,0,0,0
1299350,True,0,No user reviews,0,0,0
1299360,True,0,No user reviews,0,0,0
1299370,True,0,No user reviews,0,0,0
1299400,True,0,No user reviews,0,0,0
1299410,True,0,No user reviews,0,0,0
1299420,True,0,4 user reviews,4,0,4
1299430,True,0,No user reviews,0,0,0
1299440,True,0,No user reviews,0,0,0
1299470,True,0,No user reviews,0,0,0
1299480,True,0,No user reviews,0,0,0
1299490,True,0,No user reviews,0,0,0
1299530,True,8,Very Positive,84,14,98
1299540,True,0,No user reviews,0,0,0
1299570,True,0,No user reviews,0,0,0
1299580,True,0,No user reviews,0,0,0
1299590,True,0,No user reviews,0,0,0
1299600,True,6,Mostly Positive,10,4,14
1299610,True,0,1 user reviews,1,0,1
1299620,True,0,No user reviews,0,0,0
1299630,True,0,No user reviews,0,0,0
1299640,True,0,No user reviews,0,0,0
1299660,True,0,No user reviews,0,0,0
1299680,True,0,No user reviews,0,0,0
1299690,True,0,No user reviews,0,0,0
1299710,True,0,3 user reviews,3,0,3
1299720,True,0,No user reviews,0,0,0
1299730,True,0,No user reviews,0,0,0
1299740,True,0,1 user reviews,1,0,1
1299750,True,0,7 user reviews,6,1,7
1299760,True,0,No user reviews,0,0,0
1299770,True,0,2 user reviews,2,0,2
1299790,True,0,No user reviews,0,0,0
1299810,True,0,No user reviews,0,0,0
1299820,True,0,No user reviews,0,0,0
1299830,True,0,No user reviews,0,0,0
1299840,True,0,6 user reviews,4,2,6
1299890,True,0,1 user reviews,0,1,1
1299900,True,0,No user reviews,0,0,0
1299920,True,0,No user reviews,0,0,0
1299930,True,0,No user reviews,0,0,0
1299950,True,0,No user reviews,0,0,0
1299980,True,0,2 user reviews,0,2,2
1299990,True,0,No user reviews,0,0,0
1300000,True,0,2 user reviews,1,1,2
1300010,True,0,No user reviews,0,0,0
1300040,True,0,No user reviews,0,0,0
1300050,True,0,No user reviews,0,0,0
1300060,True,0,No user reviews,0,0,0
1300110,True,0,1 user reviews,0,1,1
1300120,True,0,No user reviews,0,0,0
1300140,True,0,No user reviews,0,0,0
1300160,True,0,4 user reviews,2,2,4
1300180,True,0,2 user reviews,2,0,2
1300190,True,0,7 user reviews,6,1,7
1300200,True,0,2 user reviews,2,0,2
1300210,True,7,Positive,11,2,13
1300211,True,0,6 user reviews,6,0,6
1300260,True,0,No user reviews,0,0,0
1300270,True,0,6 user reviews,4,2,6
1300290,True,0,No user reviews,0,0,0
1300310,True,0,5 user reviews,4,1,5
1300320,True,0,No user reviews,0,0,0
1300330,True,0,No user reviews,0,0,0
1300340,True,0,No user reviews,0,0,0
1300350,True,0,No user reviews,0,0,0
1300360,True,0,No user reviews,0,0,0
1300370,True,0,No user reviews,0,0,0
1300390,True,7,Positive,15,2,17
1300400,True,0,No user reviews,0,0,0
1300410,True,0,No user reviews,0,0,0
1300430,True,6,Mostly Positive,67,20,87
1300450,True,0,8 user reviews,0,8,8
1300490,True,0,4 user reviews,4,0,4
1300510,True,0,No user reviews,0,0,0
1300530,True,0,No user reviews,0,0,0
1300550,True,0,No user reviews,0,0,0
1300560,True,0,No user reviews,0,0,0
1300570,True,0,2 user reviews,1,1,2
1300580,True,0,1 user reviews,0,1,1
1300590,True,0,No user reviews,0,0,0
1300610,True,0,No user reviews,0,0,0
1300650,True,0,No user reviews,0,0,0
1300660,True,0,No user reviews,0,0,0
1300670,True,0,2 user reviews,2,0,2
1300680,True,0,7 user reviews,2,5,7
1300690,True,0,No user reviews,0,0,0
1300700,True,7,Positive,16,2,18
1300710,True,4,Mostly Negative,81,153,234
1300720,True,0,No user reviews,0,0,0
1300760,True,0,No user reviews,0,0,0
1300770,True,0,2 user reviews,2,0,2
1300780,True,0,No user reviews,0,0,0
1300790,True,0,1 user reviews,0,1,1
1300800,True,0,No user reviews,0,0,0
1300840,True,0,No user reviews,0,0,0
1300850,True,0,5 user reviews,5,0,5
1300851,True,0,4 user reviews,3,1,4
1300860,True,0,No user reviews,0,0,0
1300870,True,0,No user reviews,0,0,0
1300880,True,0,No user reviews,0,0,0
1300890,True,0,No user reviews,0,0,0
1300900,True,0,No user reviews,0,0,0
1300920,True,0,No user reviews,0,0,0
1300930,True,0,No user reviews,0,0,0
1300940,True,0,No user reviews,0,0,0
1300950,True,0,No user reviews,0,0,0
1300960,True,0,3 user reviews,3,0,3
1300980,True,0,No user reviews,0,0,0
1300990,True,0,No user reviews,0,0,0
1301020,True,0,No user reviews,0,0,0
1301021,True,5,Mixed,12,7,19
1301040,True,0,No user reviews,0,0,0
1301050,True,0,No user reviews,0,0,0
1301080,True,0,No user reviews,0,0,0
1301090,True,0,No user reviews,0,0,0
1301100,True,0,4 user reviews,4,0,4
1301220,True,0,No user reviews,0,0,0
1301230,True,0,No user reviews,0,0,0
1301240,True,0,No user reviews,0,0,0
1301250,True,0,3 user reviews,2,1,3
1301260,True,0,1 user reviews,1,0,1
1301270,True,0,No user reviews,0,0,0
1301310,True,0,No user reviews,0,0,0
1301340,True,0,No user reviews,0,0,0
1301350,True,0,No user reviews,0,0,0
1301370,True,0,3 user reviews,3,0,3
1301380,True,0,1 user reviews,1,0,1
1301390,True,0,5 user reviews,4,1,5
1301410,True,0,1 user reviews,1,0,1
1301430,True,0,No user reviews,0,0,0
1301440,True,0,No user reviews,0,0,0
1301450,True,0,No user reviews,0,0,0
1301470,True,0,9 user reviews,9,0,9
1301480,True,5,Mixed,6,4,10
1301490,True,0,No user reviews,0,0,0
1301500,True,0,No user reviews,0,0,0
1301520,True,0,No user reviews,0,0,0
1301540,True,0,2 user reviews,2,0,2
1301560,True,0,No user reviews,0,0,0
1301570,True,0,No user reviews,0,0,0
1301580,True,0,No user reviews,0,0,0
1301590,True,0,No user reviews,0,0,0
1301620,True,0,3 user reviews,2,1,3
1301650,True,0,No user reviews,0,0,0
1301700,True,0,No user reviews,0,0,0
1301710,True,0,No user reviews,0,0,0
1301720,True,0,No user reviews,0,0,0
1301730,True,0,1 user reviews,1,0,1
1301740,True,5,Mixed,17,18,35
1301750,True,0,No user reviews,0,0,0
1301770,True,0,No user reviews,0,0,0
1301800,True,0,No user reviews,0,0,0
1301820,True,0,No user reviews,0,0,0
1301830,True,0,No user reviews,0,0,0
1301850,True,0,No user reviews,0,0,0
1301860,True,0,No user reviews,0,0,0
1301870,True,0,6 user reviews,6,0,6
1301910,True,0,No user reviews,0,0,0
1301930,True,0,No user reviews,0,0,0
1301950,True,0,No user reviews,0,0,0
1301970,True,0,2 user reviews,2,0,2
1301980,True,0,No user reviews,0,0,0
1301990,True,0,No user reviews,0,0,0
1302000,True,0,2 user reviews,0,2,2
1302010,True,0,No user reviews,0,0,0
1302030,True,0,No user reviews,0,0,0
1302040,True,0,No user reviews,0,0,0
1302050,True,7,Positive,14,0,14
1302060,True,0,No user reviews,0,0,0
1302090,True,0,1 user reviews,0,1,1
1302100,True,0,No user reviews,0,0,0
1302110,True,0,No user reviews,0,0,0
1302140,True,0,No user reviews,0,0,0
1302160,True,0,3 user reviews,2,1,3
1302180,True,0,4 user reviews,4,0,4
1302190,True,0,No user reviews,0,0,0
1302200,True,0,No user reviews,0,0,0
1302210,True,0,No user reviews,0,0,0
1302220,True,0,No user reviews,0,0,0
1302230,True,0,No user reviews,0,0,0
1302240,True,0,9 user reviews,9,0,9
1302250,True,0,No user reviews,0,0,0
1302260,True,0,No user reviews,0,0,0
1302270,True,0,No user reviews,0,0,0
1302290,True,0,No user reviews,0,0,0
1302300,True,0,No user reviews,0,0,0
1302310,True,0,No user reviews,0,0,0
1302350,True,0,No user reviews,0,0,0
1302360,True,0,No user reviews,0,0,0
1302380,True,0,1 user reviews,1,0,1
1302390,True,0,No user reviews,0,0,0
1302400,True,0,1 user reviews,1,0,1
1302410,True,0,No user reviews,0,0,0
1302420,True,0,No user reviews,0,0,0
1302430,True,4,Mostly Negative,5,8,13
1302440,True,6,Mostly Positive,14,4,18
1302470,True,0,No user reviews,0,0,0
1302500,True,0,No user reviews,0,0,0
1302510,True,0,2 user reviews,1,1,2
1302520,True,0,No user reviews,0,0,0
1302521,True,0,No user reviews,0,0,0
1302522,True,0,No user reviews,0,0,0
1302530,True,0,No user reviews,0,0,0
1302540,True,0,No user reviews,0,0,0
1302550,True,0,2 user reviews,2,0,2
1302570,True,0,No user reviews,0,0,0
1302590,True,0,No user reviews,0,0,0
1302600,True,0,No user reviews,0,0,0
1302610,True,0,No user reviews,0,0,0
1302620,True,0,No user reviews,0,0,0
1302640,True,0,No user reviews,0,0,0
1302670,True,0,No user reviews,0,0,0
1302700,True,0,1 user reviews,0,1,1
1302720,True,0,No user reviews,0,0,0
1302730,True,0,1 user reviews,1,0,1
1302740,True,0,No user reviews,0,0,0
1302750,True,0,6 user reviews,5,1,6
1302760,True,0,No user reviews,0,0,0
1302770,True,0,No user reviews,0,0,0
1302780,True,6,Mostly Positive,9,3,12
1302800,True,8,Very Positive,120,5,125
1302810,True,0,1 user reviews,1,0,1
1302820,True,0,No user reviews,0,0,0
1302840,True,0,1 user reviews,1,0,1
1302860,True,7,Positive,25,1,26
1302880,True,0,No user reviews,0,0,0
1302920,True,0,No user reviews,0,0,0
1302930,True,5,Mixed,23,12,35
1302970,True,0,No user reviews,0,0,0
1302980,True,0,No user reviews,0,0,0
1302990,True,8,Very Positive,90,3,93
1303000,True,0,No user reviews,0,0,0
1303030,True,0,No user reviews,0,0,0
1303040,True,0,No user reviews,0,0,0
1303050,True,0,No user reviews,0,0,0
1303080,True,0,No user reviews,0,0,0
1303081,True,0,No user reviews,0,0,0
1303082,True,0,No user reviews,0,0,0
1303090,True,0,No user reviews,0,0,0
1303100,True,0,No user reviews,0,0,0
1303120,True,0,No user reviews,0,0,0
1303130,True,0,No user reviews,0,0,0
1303140,True,0,3 user reviews,3,0,3
1303150,True,0,No user reviews,0,0,0
1303160,True,0,No user reviews,0,0,0
1303170,True,0,No user reviews,0,0,0
1303190,True,0,No user reviews,0,0,0
1303191,True,0,1 user reviews,1,0,1
1303192,True,0,No user reviews,0,0,0
1303193,True,0,2 user reviews,2,0,2
1303194,True,0,No user reviews,0,0,0
1303195,True,0,No user reviews,0,0,0
1303196,True,0,1 user reviews,1,0,1
1303197,True,0,No user reviews,0,0,0
1303198,True,0,1 user reviews,1,0,1
1303199,True,0,No user reviews,0,0,0
1303200,True,0,No user reviews,0,0,0
1303201,True,0,No user reviews,0,0,0
1303210,True,0,No user reviews,0,0,0
1303260,True,0,7 user reviews,5,2,7
1303270,True,0,No user reviews,0,0,0
1303280,True,7,Positive,9,2,11
1303290,True,0,No user reviews,0,0,0
1303320,True,0,No user reviews,0,0,0
1303330,True,0,No user reviews,0,0,0
1303340,True,0,No user reviews,0,0,0
1303350,True,0,1 user reviews,1,0,1
1303370,True,0,No user reviews,0,0,0
1303400,True,0,No user reviews,0,0,0
1303420,True,0,2 user reviews,2,0,2
1303430,True,0,No user reviews,0,0,0
1303440,True,0,No user reviews,0,0,0
1303450,True,0,No user reviews,0,0,0
1303460,True,0,No user reviews,0,0,0
1303470,True,0,No user reviews,0,0,0
1303490,True,0,No user reviews,0,0,0
1303510,True,0,No user reviews,0,0,0
1303540,True,0,No user reviews,0,0,0
1303550,True,0,No user reviews,0,0,0
1303570,True,0,No user reviews,0,0,0
1303580,True,0,No user reviews,0,0,0
1303605,True,0,No user reviews,0,0,0
1303620,True,0,No user reviews,0,0,0
1303630,True,0,No user reviews,0,0,0
1303640,True,0,No user reviews,0,0,0
1303660,True,8,Very Positive,54,10,64
1303670,True,0,5 user reviews,5,0,5
1303680,True,0,No user reviews,0,0,0
1303710,True,0,No user reviews,0,0,0
1303720,True,0,No user reviews,0,0,0
1303740,True,8,Very Positive,48,3,51
1303750,True,0,No user reviews,0,0,0
1303760,True,0,No user reviews,0,0,0
1303780,True,0,No user reviews,0,0,0
1303790,True,0,3 user reviews,3,0,3
1303800,True,5,Mixed,14,8,22
1303820,True,0,2 user reviews,1,1,2
1303830,True,0,No user reviews,0,0,0
1303840,True,0,No user reviews,0,0,0
1303860,True,0,No user reviews,0,0,0
1303870,True,0,3 user reviews,2,1,3
1303880,True,0,No user reviews,0,0,0
1303891,True,0,6 user reviews,6,0,6
1303900,True,0,1 user reviews,1,0,1
1303910,True,0,No user reviews,0,0,0
1303920,True,0,No user reviews,0,0,0
1303930,True,0,No user reviews,0,0,0
1303940,True,0,No user reviews,0,0,0
1303950,True,0,No user reviews,0,0,0
1303990,True,7,Positive,37,1,38
1304020,True,0,No user reviews,0,0,0
1304040,True,0,No user reviews,0,0,0
1304050,True,0,No user reviews,0,0,0
1304070,True,0,No user reviews,0,0,0
1304090,True,7,Positive,21,1,22
1304100,True,0,1 user reviews,0,1,1
1304120,True,0,3 user reviews,3,0,3
1304130,True,0,No user reviews,0,0,0
1304140,True,7,Positive,38,2,40
1304150,True,0,6 user reviews,2,4,6
1304160,True,0,No user reviews,0,0,0
1304170,True,0,4 user reviews,4,0,4
1304190,True,0,No user reviews,0,0,0
1304200,True,0,No user reviews,0,0,0
1304220,True,0,4 user reviews,4,0,4
1304230,True,0,No user reviews,0,0,0
1304240,True,0,No user reviews,0,0,0
1304250,True,0,No user reviews,0,0,0
1304270,True,0,No user reviews,0,0,0
1304280,True,0,No user reviews,0,0,0
1304290,True,0,9 user reviews,9,0,9
1304300,True,0,No user reviews,0,0,0
1304310,True,0,2 user reviews,2,0,2
1304320,True,0,No user reviews,0,0,0
1304350,True,0,No user reviews,0,0,0
1304360,True,0,1 user reviews,1,0,1
1304370,True,0,No user reviews,0,0,0
1304380,True,0,No user reviews,0,0,0
1304390,True,0,No user reviews,0,0,0
1304400,True,0,No user reviews,0,0,0
1304411,True,0,1 user reviews,0,1,1
1304412,True,0,1 user reviews,0,1,1
1304413,True,0,1 user reviews,1,0,1
1304414,True,0,No user reviews,0,0,0
1304416,True,0,No user reviews,0,0,0
1304417,True,0,5 user reviews,2,3,5
1304418,True,0,1 user reviews,0,1,1
1304419,True,0,No user reviews,0,0,0
1304420,True,0,No user reviews,0,0,0
1304430,True,0,No user reviews,0,0,0
1304442,True,0,5 user reviews,4,1,5
1304444,True,0,4 user reviews,2,2,4
1304445,True,0,1 user reviews,1,0,1
1304446,True,0,1 user reviews,0,1,1
1304447,True,0,7 user reviews,5,2,7
1304448,True,0,3 user reviews,3,0,3
1304449,True,0,1 user reviews,0,1,1
1304450,True,0,No user reviews,0,0,0
1304460,True,0,2 user reviews,2,0,2
1304461,True,0,2 user reviews,2,0,2
1304462,True,0,1 user reviews,1,0,1
1304463,True,0,No user reviews,0,0,0
1304464,True,0,1 user reviews,1,0,1
1304467,True,5,Mixed,20,22,42
1304468,True,6,Mostly Positive,8,3,11
1304470,True,0,No user reviews,0,0,0
1304520,True,0,No user reviews,0,0,0
1304550,True,7,Positive,42,0,42
1304560,True,0,No user reviews,0,0,0
1304570,True,0,No user reviews,0,0,0
1304580,True,0,No user reviews,0,0,0
1304590,True,0,No user reviews,0,0,0
1304591,True,0,No user reviews,0,0,0
1304600,True,7,Positive,36,2,38
1304601,True,7,Positive,33,8,41
1304610,True,0,No user reviews,0,0,0
1304620,True,4,Mostly Negative,5,8,13
1304640,True,7,Positive,11,2,13
1304660,True,0,No user reviews,0,0,0
1304680,True,0,No user reviews,0,0,0
1304690,True,0,No user reviews,0,0,0
1304730,True,0,No user reviews,0,0,0
1304760,True,0,No user reviews,0,0,0
1304770,True,0,No user reviews,0,0,0
1304780,True,0,No user reviews,0,0,0
1304790,True,0,No user reviews,0,0,0
1304800,True,0,1 user reviews,1,0,1
1304850,True,0,No user reviews,0,0,0
1304860,True,0,No user reviews,0,0,0
1304870,True,0,2 user reviews,1,1,2
1304900,True,0,No user reviews,0,0,0
1304910,True,0,4 user reviews,4,0,4
1304930,True,0,No user reviews,0,0,0
1304950,True,0,No user reviews,0,0,0
1304960,True,0,No user reviews,0,0,0
1304970,True,0,No user reviews,0,0,0
1305000,True,0,No user reviews,0,0,0
1305010,True,0,1 user reviews,1,0,1
1305020,True,0,No user reviews,0,0,0
1305040,True,0,6 user reviews,6,0,6
1305050,True,0,No user reviews,0,0,0
1305060,True,0,9 user reviews,9,0,9
1305080,True,0,No user reviews,0,0,0
1305110,True,0,No user reviews,0,0,0
1305120,True,0,No user reviews,0,0,0
1305160,True,0,No user reviews,0,0,0
1305180,True,0,No user reviews,0,0,0
1305190,True,0,No user reviews,0,0,0
1305220,True,0,1 user reviews,1,0,1
1305260,True,0,No user reviews,0,0,0
1305270,True,0,No user reviews,0,0,0
1305280,True,0,No user reviews,0,0,0
1305310,True,8,Very Positive,47,5,52
1305320,True,0,No user reviews,0,0,0
1305360,True,0,No user reviews,0,0,0
1305370,True,0,2 user reviews,1,1,2
1305380,True,0,No user reviews,0,0,0
1305390,True,0,1 user reviews,1,0,1
1305400,True,0,No user reviews,0,0,0
1305420,True,5,Mixed,52,23,75
1305430,True,0,No user reviews,0,0,0
1305440,True,7,Positive,11,2,13
1305470,True,0,No user reviews,0,0,0
1305480,True,0,No user reviews,0,0,0
1305490,True,0,No user reviews,0,0,0
1305500,True,0,No user reviews,0,0,0
1305530,True,0,No user reviews,0,0,0
1305540,True,0,4 user reviews,2,2,4
1305550,True,0,No user reviews,0,0,0
1305560,True,0,No user reviews,0,0,0
1305570,True,0,No user reviews,0,0,0
1305590,True,0,1 user reviews,1,0,1
1305610,True,0,No user reviews,0,0,0
1305640,True,0,No user reviews,0,0,0
1305660,True,0,6 user reviews,6,0,6
1305670,True,0,No user reviews,0,0,0
1305680,True,0,No user reviews,0,0,0
1305690,True,0,No user reviews,0,0,0
1305700,True,0,No user reviews,0,0,0
1305710,True,0,No user reviews,0,0,0
1305720,True,0,No user reviews,0,0,0
1305730,True,0,No user reviews,0,0,0
1305760,True,7,Positive,13,1,14
1305770,True,0,No user reviews,0,0,0
1305780,True,0,No user reviews,0,0,0
1305790,True,0,No user reviews,0,0,0
1305820,True,0,No user reviews,0,0,0
1305830,True,0,No user reviews,0,0,0
1305880,True,0,No user reviews,0,0,0
1305960,True,0,No user reviews,0,0,0
1305970,True,0,No user reviews,0,0,0
1305980,True,0,No user reviews,0,0,0
1305990,True,0,No user reviews,0,0,0
1306000,True,0,No user reviews,0,0,0
1306001,True,0,No user reviews,0,0,0
1306010,True,0,No user reviews,0,0,0
1306020,True,0,1 user reviews,1,0,1
1306050,True,0,No user reviews,0,0,0
1306080,True,0,No user reviews,0,0,0
1306090,True,0,No user reviews,0,0,0
1306100,True,0,No user reviews,0,0,0
1306110,True,0,No user reviews,0,0,0
1306160,True,0,No user reviews,0,0,0
1306170,True,0,No user reviews,0,0,0
1306180,True,0,No user reviews,0,0,0
1306190,True,0,No user reviews,0,0,0
1306210,True,0,No user reviews,0,0,0
1306230,True,0,No user reviews,0,0,0
1306240,True,0,No user reviews,0,0,0
1306250,True,0,No user reviews,0,0,0
1306260,True,7,Positive,10,1,11
1306270,True,0,No user reviews,0,0,0
1306410,True,0,No user reviews,0,0,0
1306570,True,0,No user reviews,0,0,0
1306580,True,0,No user reviews,0,0,0
1306620,True,7,Positive,38,3,41
1306650,True,0,No user reviews,0,0,0
1306660,True,0,No user reviews,0,0,0
1306700,True,0,No user reviews,0,0,0
1306730,True,5,Mixed,14,16,30
1306750,True,0,No user reviews,0,0,0
1306760,True,0,No user reviews,0,0,0
1306780,True,6,Mostly Positive,21,9,30
1306790,True,7,Positive,12,1,13
1306800,True,0,No user reviews,0,0,0
1306810,True,0,No user reviews,0,0,0
1306830,True,0,No user reviews,0,0,0
1306840,True,0,No user reviews,0,0,0
1306850,True,0,No user reviews,0,0,0
1306860,True,0,3 user reviews,2,1,3
1306900,True,0,2 user reviews,2,0,2
1306910,True,0,No user reviews,0,0,0
1306950,True,0,No user reviews,0,0,0
1306960,True,0,No user reviews,0,0,0
1306970,True,0,No user reviews,0,0,0
1306980,True,0,No user reviews,0,0,0
1306990,True,0,No user reviews,0,0,0
1307000,True,0,No user reviews,0,0,0
1307010,True,0,No user reviews,0,0,0
1307020,True,0,No user reviews,0,0,0
1307040,True,0,No user reviews,0,0,0
1307050,True,0,No user reviews,0,0,0
1307060,True,0,No user reviews,0,0,0
1307070,True,7,Positive,14,0,14
1307080,True,0,No user reviews,0,0,0
1307090,True,0,6 user reviews,5,1,6
1307100,True,0,No user reviews,0,0,0
1307170,True,0,No user reviews,0,0,0
1307200,True,0,No user reviews,0,0,0
1307210,True,0,No user reviews,0,0,0
1307220,True,0,1 user reviews,0,1,1
1307240,True,0,3 user reviews,2,1,3
1307250,True,0,2 user reviews,2,0,2
1307290,True,0,No user reviews,0,0,0
1307300,True,0,No user reviews,0,0,0
1307310,True,0,No user reviews,0,0,0
1307330,True,0,No user reviews,0,0,0
1307350,True,0,No user reviews,0,0,0
1307360,True,0,No user reviews,0,0,0
1307380,True,0,1 user reviews,1,0,1
1307400,True,0,No user reviews,0,0,0
1307410,True,0,No user reviews,0,0,0
1307420,True,0,No user reviews,0,0,0
1307430,True,0,1 user reviews,1,0,1
1307440,True,7,Positive,12,1,13
1307450,True,0,3 user reviews,3,0,3
1307460,True,0,5 user reviews,4,1,5
1307480,True,0,7 user reviews,1,6,7
1307490,True,0,No user reviews,0,0,0
1307510,True,0,No user reviews,0,0,0
1307530,True,0,1 user reviews,1,0,1
1307540,True,0,2 user reviews,0,2,2
1307550,True,8,Very Positive,2139,279,2418
1307560,True,0,No user reviews,0,0,0
1307570,True,0,No user reviews,0,0,0
1307580,True,0,No user reviews,0,0,0
1307590,True,0,No user reviews,0,0,0
1307600,True,5,Mixed,12,11,23
1307610,True,0,No user reviews,0,0,0
1307640,True,0,1 user reviews,1,0,1
1307670,True,0,No user reviews,0,0,0
1307680,True,8,Very Positive,69,14,83
1307690,True,0,No user reviews,0,0,0
1307720,True,0,No user reviews,0,0,0
1307730,True,0,No user reviews,0,0,0
1307740,True,0,No user reviews,0,0,0
1307760,True,0,5 user reviews,3,2,5
1307780,True,0,No user reviews,0,0,0
1307790,True,0,No user reviews,0,0,0
1307800,True,0,No user reviews,0,0,0
1307810,True,0,1 user reviews,1,0,1
1307820,True,0,No user reviews,0,0,0
1307850,True,0,7 user reviews,7,0,7
1307870,True,7,Positive,28,1,29
1307880,True,0,No user reviews,0,0,0
1307890,True,0,No user reviews,0,0,0
1307900,True,0,4 user reviews,3,1,4
1307910,True,0,No user reviews,0,0,0
1307950,True,0,No user reviews,0,0,0
1307960,True,0,No user reviews,0,0,0
1307970,True,0,No user reviews,0,0,0
1308010,True,0,No user reviews,0,0,0
1308020,True,0,No user reviews,0,0,0
1308030,True,0,No user reviews,0,0,0
1308040,True,0,3 user reviews,3,0,3
1308060,True,0,1 user reviews,0,1,1
1308070,True,0,No user reviews,0,0,0
1308090,True,5,Mixed,142,159,301
1308110,True,0,2 user reviews,2,0,2
1308130,True,0,8 user reviews,1,7,8
1308140,True,0,2 user reviews,1,1,2
1308150,True,0,No user reviews,0,0,0
1308160,True,0,No user reviews,0,0,0
1308170,True,0,6 user reviews,4,2,6
1308180,True,5,Mixed,25,20,45
1308181,True,5,Mixed,21,25,46
1308182,True,8,Very Positive,59,9,68
1308183,True,8,Very Positive,59,4,63
1308200,True,0,No user reviews,0,0,0
1308210,True,0,No user reviews,0,0,0
1308240,True,0,6 user reviews,6,0,6
1308250,True,0,8 user reviews,8,0,8
1308260,True,0,No user reviews,0,0,0
1308270,True,0,1 user reviews,0,1,1
1308280,True,0,No user reviews,0,0,0
1308290,True,0,No user reviews,0,0,0
1308310,True,0,No user reviews,0,0,0
1308350,True,0,3 user reviews,2,1,3
1308360,True,0,No user reviews,0,0,0
1308410,True,0,No user reviews,0,0,0
1308430,True,0,No user reviews,0,0,0
1308450,True,0,No user reviews,0,0,0
1308470,True,0,No user reviews,0,0,0
1308500,True,0,No user reviews,0,0,0
1308510,True,0,1 user reviews,1,0,1
1308520,True,0,No user reviews,0,0,0
1308530,True,0,No user reviews,0,0,0
1308540,True,0,No user reviews,0,0,0
1308550,True,0,No user reviews,0,0,0
1308560,True,0,3 user reviews,0,3,3
1308570,True,0,No user reviews,0,0,0
1308630,True,0,No user reviews,0,0,0
1308640,True,0,No user reviews,0,0,0
1308650,True,0,No user reviews,0,0,0
1308660,True,0,No user reviews,0,0,0
1308670,True,0,3 user reviews,2,1,3
1308680,True,0,1 user reviews,1,0,1
1308710,True,0,No user reviews,0,0,0
1308740,True,5,Mixed,6,9,15
1308750,True,0,No user reviews,0,0,0
1308760,True,0,9 user reviews,8,1,9
1308770,True,0,1 user reviews,1,0,1
1308780,True,0,2 user reviews,1,1,2
1308790,True,0,1 user reviews,0,1,1
1308800,True,0,No user reviews,0,0,0
1308840,True,0,No user reviews,0,0,0
1308850,True,0,4 user reviews,4,0,4
1308870,True,0,No user reviews,0,0,0
1308880,True,0,No user reviews,0,0,0
1308890,True,0,No user reviews,0,0,0
1308900,True,0,No user reviews,0,0,0
1308910,True,7,Positive,15,0,15
1308920,True,0,1 user reviews,0,1,1
1308940,True,0,No user reviews,0,0,0
1308950,True,0,2 user reviews,0,2,2
1308960,True,0,No user reviews,0,0,0
1308970,True,0,No user reviews,0,0,0
1308980,True,0,3 user reviews,3,0,3
1309010,True,0,No user reviews,0,0,0
1309020,True,0,No user reviews,0,0,0
1309040,True,0,1 user reviews,1,0,1
1309070,True,0,No user reviews,0,0,0
1309080,True,0,No user reviews,0,0,0
1309100,True,0,No user reviews,0,0,0
1309101,True,0,No user reviews,0,0,0
1309110,True,0,No user reviews,0,0,0
1309120,True,0,No user reviews,0,0,0
1309130,True,7,Positive,28,0,28
1309140,True,0,No user reviews,0,0,0
1309150,True,0,No user reviews,0,0,0
1309151,True,0,No user reviews,0,0,0
1309152,True,0,No user reviews,0,0,0
1309153,True,0,No user reviews,0,0,0
1309154,True,0,No user reviews,0,0,0
1309155,True,0,No user reviews,0,0,0
1309156,True,0,No user reviews,0,0,0
1309159,True,0,No user reviews,0,0,0
1309160,True,0,No user reviews,0,0,0
1309170,True,0,1 user reviews,1,0,1
1309180,True,0,No user reviews,0,0,0
1309200,True,7,Positive,11,0,11
1309220,True,0,No user reviews,0,0,0
1309230,True,0,2 user reviews,2,0,2
1309240,True,0,No user reviews,0,0,0
1309250,True,0,No user reviews,0,0,0
1309280,True,0,No user reviews,0,0,0
1309290,True,7,Positive,10,1,11
1309310,True,0,No user reviews,0,0,0
1309340,True,0,No user reviews,0,0,0
1309350,True,0,1 user reviews,1,0,1
1309410,True,0,8 user reviews,6,2,8
1309430,True,0,1 user reviews,1,0,1
1309440,True,0,7 user reviews,6,1,7
1309480,True,0,No user reviews,0,0,0
1309500,True,0,1 user reviews,1,0,1
1309510,True,0,No user reviews,0,0,0
1309550,True,0,No user reviews,0,0,0
1309560,True,0,No user reviews,0,0,0
1309590,True,0,No user reviews,0,0,0
1309600,True,0,No user reviews,0,0,0
1309620,True,0,No user reviews,0,0,0
1309630,True,0,No user reviews,0,0,0
1309640,True,0,No user reviews,0,0,0
1309670,True,0,No user reviews,0,0,0
1309690,True,0,1 user reviews,0,1,1
1309700,True,0,5 user reviews,2,3,5
1309710,True,0,No user reviews,0,0,0
1309720,True,0,No user reviews,0,0,0
1309730,True,0,No user reviews,0,0,0
1309740,True,0,No user reviews,0,0,0
1309790,True,0,No user reviews,0,0,0
1309800,True,0,No user reviews,0,0,0
1309830,True,0,No user reviews,0,0,0
1309850,True,0,No user reviews,0,0,0
1309860,True,0,5 user reviews,5,0,5
1309870,True,0,No user reviews,0,0,0
1309890,True,0,2 user reviews,1,1,2
1309910,True,0,1 user reviews,1,0,1
1309930,True,0,No user reviews,0,0,0
1309940,True,0,9 user reviews,7,2,9
1309980,True,0,2 user reviews,2,0,2
1310000,True,0,No user reviews,0,0,0
1310010,True,5,Mixed,9,4,13
1310030,True,0,No user reviews,0,0,0
1310050,True,0,5 user reviews,4,1,5
1310060,True,0,No user reviews,0,0,0
1310070,True,0,No user reviews,0,0,0
1310080,True,0,No user reviews,0,0,0
1310090,True,0,No user reviews,0,0,0
1310120,True,0,2 user reviews,2,0,2
1310150,True,0,3 user reviews,0,3,3
1310200,True,0,No user reviews,0,0,0
1310210,True,0,6 user reviews,6,0,6
1310220,True,0,No user reviews,0,0,0
1310230,True,0,1 user reviews,1,0,1
1310240,True,0,No user reviews,0,0,0
1310250,True,0,No user reviews,0,0,0
1310260,True,0,No user reviews,0,0,0
1310270,True,0,No user reviews,0,0,0
1310280,True,0,No user reviews,0,0,0
1310290,True,0,9 user reviews,9,0,9
1310330,True,0,No user reviews,0,0,0
1310350,True,0,No user reviews,0,0,0
1310360,True,0,No user reviews,0,0,0
1310390,True,0,No user reviews,0,0,0
1310400,True,0,No user reviews,0,0,0
1310420,True,0,No user reviews,0,0,0
1310430,True,0,No user reviews,0,0,0
1310440,True,0,No user reviews,0,0,0
1310460,True,8,Very Positive,57,5,62
1310470,True,0,2 user reviews,1,1,2
1310480,True,0,1 user reviews,1,0,1
1310500,True,0,No user reviews,0,0,0
1310510,True,8,Very Positive,109,3,112
1310520,True,0,No user reviews,0,0,0
1310530,True,0,No user reviews,0,0,0
1310540,True,0,No user reviews,0,0,0
1310570,True,0,No user reviews,0,0,0
1310590,True,0,No user reviews,0,0,0
1310600,True,0,No user reviews,0,0,0
1310610,True,0,No user reviews,0,0,0
1310620,True,0,No user reviews,0,0,0
1310640,True,0,No user reviews,0,0,0
1310650,True,0,5 user reviews,4,1,5
1310660,True,0,No user reviews,0,0,0
1310680,True,0,No user reviews,0,0,0
1310690,True,0,5 user reviews,5,0,5
1310700,True,0,No user reviews,0,0,0
1310710,True,0,No user reviews,0,0,0
1310720,True,0,No user reviews,0,0,0
1310730,True,0,No user reviews,0,0,0
1310731,True,0,No user reviews,0,0,0
1310750,True,0,No user reviews,0,0,0
1310770,True,0,No user reviews,0,0,0
1310780,True,0,No user reviews,0,0,0
1310790,True,0,No user reviews,0,0,0
1310800,True,0,No user reviews,0,0,0
1310810,True,0,No user reviews,0,0,0
1310820,True,0,No user reviews,0,0,0
1310840,True,0,No user reviews,0,0,0
1310850,True,0,No user reviews,0,0,0
1310860,True,0,No user reviews,0,0,0
1310880,True,0,No user reviews,0,0,0
1310910,True,8,Very Positive,219,44,263
1310920,True,0,No user reviews,0,0,0
1310930,True,0,No user reviews,0,0,0
1310950,True,0,No user reviews,0,0,0
1310960,True,0,No user reviews,0,0,0
1310970,True,0,No user reviews,0,0,0
1310980,True,0,No user reviews,0,0,0
1311000,True,0,No user reviews,0,0,0
1311010,True,0,No user reviews,0,0,0
1311020,True,0,No user reviews,0,0,0
1311040,True,0,No user reviews,0,0,0
1311050,True,0,No user reviews,0,0,0
1311060,True,0,No user reviews,0,0,0
1311070,True,0,No user reviews,0,0,0
1311080,True,0,No user reviews,0,0,0
1311110,True,0,No user reviews,0,0,0
1311140,True,0,No user reviews,0,0,0
1311150,True,0,5 user reviews,3,2,5
1311160,True,0,No user reviews,0,0,0
1311180,True,0,No user reviews,0,0,0
1311190,True,0,3 user reviews,0,3,3
1311210,True,0,No user reviews,0,0,0
1311220,True,0,2 user reviews,1,1,2
1311240,True,0,No user reviews,0,0,0
1311250,True,0,No user reviews,0,0,0
1311260,True,0,No user reviews,0,0,0
1311300,True,0,No user reviews,0,0,0
1311310,True,6,Mostly Positive,8,3,11
1311320,True,0,No user reviews,0,0,0
1311330,True,0,No user reviews,0,0,0
1311400,True,0,1 user reviews,1,0,1
1311440,True,0,No user reviews,0,0,0
1311450,True,0,No user reviews,0,0,0
1311460,True,0,2 user reviews,2,0,2
1311480,True,0,No user reviews,0,0,0
1311500,True,0,No user reviews,0,0,0
1311510,True,0,8 user reviews,8,0,8
1311540,True,0,5 user reviews,3,2,5
1311610,True,0,No user reviews,0,0,0
1311640,True,0,No user reviews,0,0,0
1311650,True,0,4 user reviews,2,2,4
1311660,True,0,No user reviews,0,0,0
1311670,True,0,3 user reviews,3,0,3
1311690,True,0,No user reviews,0,0,0
1311700,True,0,No user reviews,0,0,0
1311730,True,0,No user reviews,0,0,0
1311740,True,7,Positive,15,3,18
1311750,True,0,No user reviews,0,0,0
1311770,True,0,No user reviews,0,0,0
1311780,True,0,No user reviews,0,0,0
1311790,True,0,No user reviews,0,0,0
1311800,True,0,No user reviews,0,0,0
1311810,True,0,No user reviews,0,0,0
1311820,True,0,No user reviews,0,0,0
1311830,True,0,No user reviews,0,0,0
1311850,True,0,No user reviews,0,0,0
1311860,True,0,No user reviews,0,0,0
1311870,True,0,No user reviews,0,0,0
1311890,True,0,No user reviews,0,0,0
1311900,True,0,No user reviews,0,0,0
1311920,True,0,No user reviews,0,0,0
1311930,True,0,No user reviews,0,0,0
1311950,True,0,No user reviews,0,0,0
1311960,True,0,3 user reviews,3,0,3
1311980,True,0,No user reviews,0,0,0
1311990,True,0,1 user reviews,0,1,1
1312000,True,0,No user reviews,0,0,0
1312010,True,0,3 user reviews,2,1,3
1312030,True,0,No user reviews,0,0,0
1312040,True,7,Positive,13,0,13
1312050,True,0,No user reviews,0,0,0
1312060,True,0,No user reviews,0,0,0
1312070,True,0,1 user reviews,0,1,1
1312100,True,0,No user reviews,0,0,0
1312110,True,0,No user reviews,0,0,0
1312120,True,0,No user reviews,0,0,0
1312150,True,0,No user reviews,0,0,0
1312190,True,0,No user reviews,0,0,0
1312210,True,0,No user reviews,0,0,0
1312220,True,0,No user reviews,0,0,0
1312230,True,0,No user reviews,0,0,0
1312250,True,7,Positive,11,2,13
1312270,True,0,No user reviews,0,0,0
1312280,True,0,No user reviews,0,0,0
1312300,True,0,No user reviews,0,0,0
1312310,True,0,No user reviews,0,0,0
1312330,True,0,No user reviews,0,0,0
1312340,True,0,No user reviews,0,0,0
1312350,True,0,No user reviews,0,0,0
1312380,True,0,No user reviews,0,0,0
1312390,True,0,No user reviews,0,0,0
1312400,True,0,No user reviews,0,0,0
1312410,True,0,No user reviews,0,0,0
1312411,True,0,No user reviews,0,0,0
1312412,True,0,No user reviews,0,0,0
1312413,True,0,No user reviews,0,0,0
1312414,True,0,No user reviews,0,0,0
1312420,True,0,No user reviews,0,0,0
1312450,True,0,No user reviews,0,0,0
1312470,True,0,No user reviews,0,0,0
1312510,True,0,No user reviews,0,0,0
1312520,True,0,No user reviews,0,0,0
1312530,True,0,No user reviews,0,0,0
1312540,True,0,No user reviews,0,0,0
1312560,True,0,No user reviews,0,0,0
1312570,True,0,No user reviews,0,0,0
1312580,True,0,No user reviews,0,0,0
1312590,True,0,No user reviews,0,0,0
1312620,True,0,No user reviews,0,0,0
1312640,True,0,No user reviews,0,0,0
1312650,True,0,No user reviews,0,0,0
1312660,True,0,No user reviews,0,0,0
1312680,True,0,No user reviews,0,0,0
1312690,True,0,No user reviews,0,0,0
1312700,True,0,No user reviews,0,0,0
1312710,True,0,No user reviews,0,0,0
1312720,True,0,No user reviews,0,0,0
1312730,True,0,No user reviews,0,0,0
1312740,True,0,No user reviews,0,0,0
1312760,True,0,1 user reviews,1,0,1
1312770,True,0,No user reviews,0,0,0
1312780,True,0,No user reviews,0,0,0
1312800,True,0,No user reviews,0,0,0
1312810,True,0,No user reviews,0,0,0
1312820,True,0,No user reviews,0,0,0
1312830,True,0,No user reviews,0,0,0
1312850,True,0,No user reviews,0,0,0
1312860,True,0,No user reviews,0,0,0
1312870,True,0,No user reviews,0,0,0
1312880,True,0,No user reviews,0,0,0
1312890,True,0,No user reviews,0,0,0
1312940,True,0,4 user reviews,4,0,4
1312950,True,0,3 user reviews,3,0,3
1312960,True,0,No user reviews,0,0,0
1312970,True,0,No user reviews,0,0,0
1312980,True,0,2 user reviews,1,1,2
1312990,True,5,Mixed,8,5,13
1313000,True,0,No user reviews,0,0,0
1313010,True,0,1 user reviews,1,0,1
1313050,True,6,Mostly Positive,7,3,10
1313080,True,0,No user reviews,0,0,0
1313090,True,0,No user reviews,0,0,0
1313100,True,0,No user reviews,0,0,0
1313110,True,0,No user reviews,0,0,0
1313120,True,0,1 user reviews,1,0,1
1313150,True,0,2 user reviews,1,1,2
1313170,True,0,No user reviews,0,0,0
1313190,True,0,No user reviews,0,0,0
1313200,True,0,No user reviews,0,0,0
1313220,True,0,No user reviews,0,0,0
1313230,True,0,No user reviews,0,0,0
1313250,True,0,No user reviews,0,0,0
1313290,True,0,No user reviews,0,0,0
1313300,True,0,No user reviews,0,0,0
1313310,True,0,4 user reviews,3,1,4
1313320,True,0,No user reviews,0,0,0
1313330,True,0,No user reviews,0,0,0
1313340,True,0,No user reviews,0,0,0
1313350,True,0,No user reviews,0,0,0
1313360,True,0,4 user reviews,0,4,4
1313380,True,0,No user reviews,0,0,0
1313390,True,0,No user reviews,0,0,0
1313400,True,0,2 user reviews,1,1,2
1313410,True,0,No user reviews,0,0,0
1313430,True,0,No user reviews,0,0,0
1313440,True,0,No user reviews,0,0,0
1313450,True,0,No user reviews,0,0,0
1313460,True,0,No user reviews,0,0,0
1313470,True,0,5 user reviews,4,1,5
1313480,True,0,No user reviews,0,0,0
1313490,True,7,Positive,14,0,14
1313500,True,0,No user reviews,0,0,0
1313510,True,0,No user reviews,0,0,0
1313530,True,6,Mostly Positive,15,5,20
1313550,True,0,No user reviews,0,0,0
1313560,True,0,5 user reviews,5,0,5
1313580,True,0,No user reviews,0,0,0
1313600,True,0,No user reviews,0,0,0
1313610,True,0,No user reviews,0,0,0
1313630,True,0,No user reviews,0,0,0
1313640,True,0,3 user reviews,3,0,3
1313650,True,0,No user reviews,0,0,0
1313660,True,0,No user reviews,0,0,0
1313680,True,0,No user reviews,0,0,0
1313690,True,0,No user reviews,0,0,0
1313700,True,0,3 user reviews,3,0,3
1313710,True,0,No user reviews,0,0,0
1313720,True,0,No user reviews,0,0,0
1313730,True,0,No user reviews,0,0,0
1313750,True,0,No user reviews,0,0,0
1313780,True,0,No user reviews,0,0,0
1313790,True,0,No user reviews,0,0,0
1313800,True,0,1 user reviews,0,1,1
1313810,True,7,Positive,14,0,14
1313830,True,0,No user reviews,0,0,0
1313840,True,0,No user reviews,0,0,0
1313850,True,0,No user reviews,0,0,0
1313860,True,6,Mostly Positive,956,302,1258
1313870,True,0,No user reviews,0,0,0
1313880,True,0,No user reviews,0,0,0
1313890,True,0,No user reviews,0,0,0
1313900,True,0,No user reviews,0,0,0
1313920,True,0,No user reviews,0,0,0
1313930,True,0,No user reviews,0,0,0
1313940,True,0,No user reviews,0,0,0
1313970,True,0,1 user reviews,1,0,1
1313980,True,0,No user reviews,0,0,0
1313990,True,0,No user reviews,0,0,0
1314010,True,0,No user reviews,0,0,0
1314020,True,0,No user reviews,0,0,0
1314030,True,0,No user reviews,0,0,0
1314040,True,0,No user reviews,0,0,0
1314060,True,0,No user reviews,0,0,0
1314061,True,0,No user reviews,0,0,0
1314062,True,0,No user reviews,0,0,0
1314090,True,0,1 user reviews,1,0,1
1314100,True,0,No user reviews,0,0,0
1314120,True,0,No user reviews,0,0,0
1314130,True,0,No user reviews,0,0,0
1314140,True,6,Mostly Positive,15,4,19
1314160,True,0,No user reviews,0,0,0
1314170,True,0,No user reviews,0,0,0
1314220,True,0,No user reviews,0,0,0
1314260,True,0,No user reviews,0,0,0
1314270,True,0,1 user reviews,1,0,1
1314280,True,0,No user reviews,0,0,0
1314290,True,0,9 user reviews,8,1,9
1314300,True,7,Positive,27,0,27
1314340,True,0,No user reviews,0,0,0
1314350,True,0,No user reviews,0,0,0
1314360,True,0,No user reviews,0,0,0
1314370,True,0,No user reviews,0,0,0
1314380,True,0,No user reviews,0,0,0
1314390,True,0,No user reviews,0,0,0
1314400,True,0,No user reviews,0,0,0
1314410,True,7,Positive,18,4,22
1314440,True,0,1 user reviews,1,0,1
1314460,True,0,No user reviews,0,0,0
1314470,True,0,9 user reviews,9,0,9
1314480,True,0,No user reviews,0,0,0
1314490,True,0,No user reviews,0,0,0
1314500,True,0,3 user reviews,3,0,3
1314540,True,0,1 user reviews,1,0,1
1314550,True,0,No user reviews,0,0,0
1314560,True,0,No user reviews,0,0,0
1314561,True,0,No user reviews,0,0,0
1314562,True,0,No user reviews,0,0,0
1314563,True,0,No user reviews,0,0,0
1314570,True,0,No user reviews,0,0,0
1314580,True,0,No user reviews,0,0,0
1314590,True,6,Mostly Positive,12,4,16
1314600,True,0,1 user reviews,0,1,1
1314610,True,0,No user reviews,0,0,0
1314620,True,0,4 user reviews,3,1,4
1314630,True,0,7 user reviews,5,2,7
1314640,True,0,No user reviews,0,0,0
1314660,True,0,2 user reviews,2,0,2
1314670,True,0,No user reviews,0,0,0
1314680,True,0,1 user reviews,1,0,1
1314690,True,0,No user reviews,0,0,0
1314720,True,0,No user reviews,0,0,0
1314730,True,0,No user reviews,0,0,0
1314740,True,0,No user reviews,0,0,0
1314750,True,0,No user reviews,0,0,0
1314760,True,0,No user reviews,0,0,0
1314761,True,0,No user reviews,0,0,0
1314762,True,0,No user reviews,0,0,0
1314763,True,0,No user reviews,0,0,0
1314764,True,0,No user reviews,0,0,0
1314765,True,0,No user reviews,0,0,0
1314810,True,0,No user reviews,0,0,0
1314820,True,7,Positive,8,2,10
1314830,True,0,2 user reviews,2,0,2
1314840,True,0,No user reviews,0,0,0
1314850,True,0,No user reviews,0,0,0
1314870,True,0,1 user reviews,1,0,1
1314880,True,0,No user reviews,0,0,0
1314900,True,0,No user reviews,0,0,0
1314910,True,0,No user reviews,0,0,0
1314920,True,0,No user reviews,0,0,0
1314930,True,6,Mostly Positive,19,7,26
1314960,True,0,No user reviews,0,0,0
1314970,True,0,No user reviews,0,0,0
1314980,True,0,9 user reviews,9,0,9
1315000,True,0,No user reviews,0,0,0
1315010,True,0,No user reviews,0,0,0
1315020,True,0,No user reviews,0,0,0
1315040,True,0,1 user reviews,1,0,1
1315060,True,0,No user reviews,0,0,0
1315100,True,0,No user reviews,0,0,0
1315120,True,0,No user reviews,0,0,0
1315130,True,0,No user reviews,0,0,0
1315140,True,0,2 user reviews,0,2,2
1315150,True,0,No user reviews,0,0,0
1315160,True,0,No user reviews,0,0,0
1315180,True,0,No user reviews,0,0,0
1315190,True,0,No user reviews,0,0,0
1315200,True,8,Very Positive,83,15,98
1315210,True,0,No user reviews,0,0,0
1315250,True,0,2 user reviews,2,0,2
1315260,True,0,6 user reviews,6,0,6
1315270,True,0,4 user reviews,3,1,4
1315280,True,0,No user reviews,0,0,0
1315290,True,0,No user reviews,0,0,0
1315300,True,7,Positive,43,0,43
1315320,True,0,No user reviews,0,0,0
1315340,True,0,No user reviews,0,0,0
1315350,True,0,5 user reviews,5,0,5
1315370,True,0,No user reviews,0,0,0
1315380,True,0,No user reviews,0,0,0
1315400,True,0,No user reviews,0,0,0
1315420,True,0,No user reviews,0,0,0
1315450,True,0,No user reviews,0,0,0
1315460,True,0,No user reviews,0,0,0
1315490,True,0,No user reviews,0,0,0
1315500,True,0,No user reviews,0,0,0
1315530,True,0,No user reviews,0,0,0
1315540,True,0,No user reviews,0,0,0
1315550,True,0,No user reviews,0,0,0
1315560,True,0,No user reviews,0,0,0
1315570,True,0,1 user reviews,1,0,1
1315580,True,0,No user reviews,0,0,0
1315590,True,0,No user reviews,0,0,0
1315600,True,0,No user reviews,0,0,0
1315610,True,0,No user reviews,0,0,0
1315620,True,0,No user reviews,0,0,0
1315630,True,0,1 user reviews,1,0,1
1315640,True,0,No user reviews,0,0,0
1315650,True,0,8 user reviews,5,3,8
1315660,True,0,3 user reviews,2,1,3
1315670,True,0,No user reviews,0,0,0
1315680,True,0,No user reviews,0,0,0
1315690,True,0,No user reviews,0,0,0
1315700,True,0,No user reviews,0,0,0
1315710,True,0,3 user reviews,3,0,3
1315760,True,0,No user reviews,0,0,0
1315780,True,0,No user reviews,0,0,0
1315800,True,0,No user reviews,0,0,0
1315801,True,0,No user reviews,0,0,0
1315802,True,0,No user reviews,0,0,0
1315803,True,0,No user reviews,0,0,0
1315804,True,0,No user reviews,0,0,0
1315805,True,0,No user reviews,0,0,0
1315806,True,0,No user reviews,0,0,0
1315807,True,0,2 user reviews,2,0,2
1315808,True,0,1 user reviews,1,0,1
1315809,True,0,4 user reviews,4,0,4
1315810,True,0,1 user reviews,1,0,1
1315820,True,0,No user reviews,0,0,0
1315830,True,0,No user reviews,0,0,0
1315850,True,0,No user reviews,0,0,0
1315860,True,0,5 user reviews,5,0,5
1315870,True,0,3 user reviews,3,0,3
1315871,True,0,4 user reviews,4,0,4
1315872,True,0,No user reviews,0,0,0
1315873,True,0,No user reviews,0,0,0
1315874,True,0,No user reviews,0,0,0
1315875,True,0,No user reviews,0,0,0
1315876,True,0,No user reviews,0,0,0
1315877,True,0,No user reviews,0,0,0
1315878,True,0,No user reviews,0,0,0
1315880,True,0,No user reviews,0,0,0
1315890,True,0,2 user reviews,1,1,2
1315900,True,0,1 user reviews,1,0,1
1315920,True,0,No user reviews,0,0,0
1315970,True,0,No user reviews,0,0,0
1315980,True,0,5 user reviews,5,0,5
1316000,True,0,7 user reviews,3,4,7
1316010,True,0,No user reviews,0,0,0
1316020,True,0,1 user reviews,1,0,1
1316021,True,0,5 user reviews,5,0,5
1316022,True,0,No user reviews,0,0,0
1316023,True,0,No user reviews,0,0,0
1316024,True,0,No user reviews,0,0,0
1316025,True,0,No user reviews,0,0,0
1316026,True,0,No user reviews,0,0,0
1316027,True,0,No user reviews,0,0,0
1316028,True,0,No user reviews,0,0,0
1316029,True,0,1 user reviews,1,0,1
1316050,True,7,Positive,11,0,11
1316060,True,0,1 user reviews,0,1,1
1316070,True,0,1 user reviews,1,0,1
1316071,True,0,No user reviews,0,0,0
1316072,True,0,No user reviews,0,0,0
1316073,True,0,No user reviews,0,0,0
1316074,True,0,No user reviews,0,0,0
1316075,True,0,1 user reviews,1,0,1
1316076,True,0,No user reviews,0,0,0
1316080,True,0,No user reviews,0,0,0
1316100,True,0,No user reviews,0,0,0
1316110,True,0,9 user reviews,9,0,9
1316120,True,0,No user reviews,0,0,0
1316130,True,0,1 user reviews,1,0,1
1316140,True,0,No user reviews,0,0,0
1316141,True,0,2 user reviews,2,0,2
1316142,True,0,No user reviews,0,0,0
1316143,True,0,No user reviews,0,0,0
1316144,True,0,1 user reviews,0,1,1
1316145,True,0,No user reviews,0,0,0
1316146,True,0,No user reviews,0,0,0
1316150,True,0,No user reviews,0,0,0
1316160,True,0,No user reviews,0,0,0
1316200,True,7,Positive,13,1,14
1316220,True,0,No user reviews,0,0,0
1316240,True,0,No user reviews,0,0,0
1316241,True,0,1 user reviews,1,0,1
1316242,True,0,No user reviews,0,0,0
1316250,True,0,No user reviews,0,0,0
1316260,True,0,No user reviews,0,0,0
1316261,True,0,No user reviews,0,0,0
1316262,True,0,No user reviews,0,0,0
1316263,True,0,No user reviews,0,0,0
1316264,True,0,1 user reviews,1,0,1
1316265,True,0,No user reviews,0,0,0
1316270,True,0,No user reviews,0,0,0
1316271,True,0,No user reviews,0,0,0
1316272,True,0,No user reviews,0,0,0
1316273,True,0,1 user reviews,1,0,1
1316274,True,0,1 user reviews,1,0,1
1316275,True,0,No user reviews,0,0,0
1316280,True,0,No user reviews,0,0,0
1316290,True,0,4 user reviews,4,0,4
1316310,True,0,No user reviews,0,0,0
1316320,True,0,No user reviews,0,0,0
1316330,True,0,No user reviews,0,0,0
1316340,True,0,No user reviews,0,0,0
1316350,True,0,No user reviews,0,0,0
1316390,True,8,Very Positive,63,2,65
1316410,True,0,No user reviews,0,0,0
1316420,True,0,No user reviews,0,0,0
1316440,True,0,No user reviews,0,0,0
1316450,True,0,No user reviews,0,0,0
1316470,True,0,No user reviews,0,0,0
1316520,True,0,No user reviews,0,0,0
1316540,True,0,No user reviews,0,0,0
1316550,True,0,2 user reviews,2,0,2
1316560,True,0,No user reviews,0,0,0
1316570,True,0,6 user reviews,5,1,6
1316580,True,0,No user reviews,0,0,0
1316590,True,0,No user reviews,0,0,0
1316600,True,0,1 user reviews,1,0,1
1316610,True,0,No user reviews,0,0,0
1316620,True,0,No user reviews,0,0,0
1316630,True,0,No user reviews,0,0,0
1316640,True,0,No user reviews,0,0,0
1316660,True,0,No user reviews,0,0,0
1316670,True,0,5 user reviews,4,1,5
1316680,True,0,No user reviews,0,0,0
1316690,True,0,No user reviews,0,0,0
1316700,True,7,Positive,37,1,38
1316710,True,0,No user reviews,0,0,0
1316740,True,7,Positive,19,2,21
1316750,True,0,No user reviews,0,0,0
1316760,True,5,Mixed,19,19,38
1316770,True,0,1 user reviews,1,0,1
1316790,True,0,No user reviews,0,0,0
1316800,True,7,Positive,14,1,15
1316810,True,0,No user reviews,0,0,0
1316820,True,0,No user reviews,0,0,0
1316830,True,0,1 user reviews,1,0,1
1316840,True,5,Mixed,93,48,141
1316870,True,0,5 user reviews,3,2,5
1316880,True,0,2 user reviews,2,0,2
1316890,True,0,No user reviews,0,0,0
1316900,True,0,No user reviews,0,0,0
1316920,True,0,No user reviews,0,0,0
1316930,True,0,No user reviews,0,0,0
1316940,True,0,No user reviews,0,0,0
1316950,True,0,No user reviews,0,0,0
1316960,True,0,No user reviews,0,0,0
1316970,True,0,No user reviews,0,0,0
1316980,True,0,No user reviews,0,0,0
1316990,True,0,No user reviews,0,0,0
1317030,True,0,No user reviews,0,0,0
1317050,True,0,No user reviews,0,0,0
1317070,True,0,2 user reviews,2,0,2
1317080,True,0,1 user reviews,0,1,1
1317090,True,0,No user reviews,0,0,0
1317110,True,0,No user reviews,0,0,0
1317120,True,0,No user reviews,0,0,0
1317130,True,0,No user reviews,0,0,0
1317140,True,0,No user reviews,0,0,0
1317160,True,7,Positive,41,0,41
1317170,True,0,No user reviews,0,0,0
1317190,True,0,No user reviews,0,0,0
1317200,True,6,Mostly Positive,17,5,22
1317220,True,0,No user reviews,0,0,0
1317230,True,5,Mixed,49,33,82
1317250,True,6,Mostly Positive,35,12,47
1317260,True,0,No user reviews,0,0,0
1317270,True,0,No user reviews,0,0,0
1317280,True,0,No user reviews,0,0,0
1317300,True,0,No user reviews,0,0,0
1317310,True,0,3 user reviews,3,0,3
1317320,True,0,No user reviews,0,0,0
1317350,True,0,No user reviews,0,0,0
1317360,True,0,No user reviews,0,0,0
1317370,True,0,No user reviews,0,0,0
1317380,True,0,No user reviews,0,0,0
1317410,True,0,No user reviews,0,0,0
1317430,True,0,No user reviews,0,0,0
1317440,True,0,No user reviews,0,0,0
1317470,True,0,No user reviews,0,0,0
1317471,True,0,No user reviews,0,0,0
1317472,True,0,No user reviews,0,0,0
1317473,True,0,No user reviews,0,0,0
1317474,True,0,No user reviews,0,0,0
1317475,True,0,No user reviews,0,0,0
1317476,True,0,No user reviews,0,0,0
1317481,True,0,No user reviews,0,0,0
1317482,True,0,No user reviews,0,0,0
1317483,True,0,No user reviews,0,0,0
1317484,True,0,No user reviews,0,0,0
1317485,True,0,No user reviews,0,0,0
1317486,True,0,No user reviews,0,0,0
1317487,True,0,No user reviews,0,0,0
1317488,True,0,No user reviews,0,0,0
1317489,True,0,No user reviews,0,0,0
1317490,True,0,No user reviews,0,0,0
1317491,True,0,No user reviews,0,0,0
1317493,True,0,No user reviews,0,0,0
1317494,True,0,No user reviews,0,0,0
1317495,True,0,No user reviews,0,0,0
1317500,True,0,No user reviews,0,0,0
1317510,True,0,No user reviews,0,0,0
1317520,True,0,No user reviews,0,0,0
1317540,True,0,No user reviews,0,0,0
1317800,True,0,1 user reviews,0,1,1
1317840,True,0,No user reviews,0,0,0
1317850,True,0,No user reviews,0,0,0
1317870,True,0,No user reviews,0,0,0
1317880,True,0,No user reviews,0,0,0
1317890,True,0,No user reviews,0,0,0
1317910,True,0,No user reviews,0,0,0
1317920,True,0,No user reviews,0,0,0
1317950,True,0,4 user reviews,4,0,4
1317970,True,0,5 user reviews,4,1,5
1317990,True,0,No user reviews,0,0,0
1318000,True,0,1 user reviews,1,0,1
1318010,True,0,No user reviews,0,0,0
1318020,True,0,No user reviews,0,0,0
1318030,True,0,9 user reviews,8,1,9
1318040,True,0,No user reviews,0,0,0
1318070,True,0,No user reviews,0,0,0
1318080,True,0,No user reviews,0,0,0
1318090,True,8,Very Positive,249,13,262
1318110,True,0,3 user reviews,3,0,3
1318130,True,0,1 user reviews,1,0,1
1318140,True,0,No user reviews,0,0,0
1318150,True,0,2 user reviews,0,2,2
1318160,True,0,No user reviews,0,0,0
1318170,True,0,1 user reviews,1,0,1
1318190,True,0,No user reviews,0,0,0
1318210,True,0,No user reviews,0,0,0
1318240,True,0,No user reviews,0,0,0
1318290,True,0,3 user reviews,1,2,3
1318300,True,0,2 user reviews,2,0,2
1318310,True,0,No user reviews,0,0,0
1318320,True,0,No user reviews,0,0,0
1318330,True,0,No user reviews,0,0,0
1318340,True,0,No user reviews,0,0,0
1318350,True,0,No user reviews,0,0,0
1318360,True,0,No user reviews,0,0,0
1318370,True,0,No user reviews,0,0,0
1318380,True,0,No user reviews,0,0,0
1318410,True,0,No user reviews,0,0,0
1318420,True,0,No user reviews,0,0,0
1318430,True,0,No user reviews,0,0,0
1318440,True,0,No user reviews,0,0,0
1318450,True,0,No user reviews,0,0,0
1318460,True,0,No user reviews,0,0,0
1318470,True,0,No user reviews,0,0,0
1318490,True,0,No user reviews,0,0,0
1318530,True,0,No user reviews,0,0,0
1318540,True,0,No user reviews,0,0,0
1318550,True,0,No user reviews,0,0,0
1318560,True,0,7 user reviews,7,0,7
1318610,True,0,No user reviews,0,0,0
1318640,True,0,No user reviews,0,0,0
1318650,True,0,No user reviews,0,0,0
1318690,True,9,Overwhelmingly Positive,1890,47,1937
1318710,True,0,No user reviews,0,0,0
1318720,True,0,No user reviews,0,0,0
1318730,True,0,No user reviews,0,0,0
1318740,True,0,No user reviews,0,0,0
1318760,True,0,No user reviews,0,0,0
1318770,True,0,No user reviews,0,0,0
1318800,True,7,Positive,22,0,22
1318810,True,0,No user reviews,0,0,0
1318820,True,0,No user reviews,0,0,0
1318830,True,0,No user reviews,0,0,0
1318840,True,0,No user reviews,0,0,0
1318850,True,0,No user reviews,0,0,0
1318870,True,0,1 user reviews,1,0,1
1318880,True,0,No user reviews,0,0,0
1318890,True,0,No user reviews,0,0,0
1318900,True,0,No user reviews,0,0,0
1318910,True,0,No user reviews,0,0,0
1318930,True,0,No user reviews,0,0,0
1318940,True,0,No user reviews,0,0,0
1318950,True,0,No user reviews,0,0,0
1318960,True,0,No user reviews,0,0,0
1318980,True,0,No user reviews,0,0,0
1318990,True,0,No user reviews,0,0,0
1319000,True,0,No user reviews,0,0,0
1319020,True,0,No user reviews,0,0,0
1319040,True,0,No user reviews,0,0,0
1319050,True,0,No user reviews,0,0,0
1319070,True,0,No user reviews,0,0,0
1319080,True,0,No user reviews,0,0,0
1319090,True,0,No user reviews,0,0,0
1319100,True,0,No user reviews,0,0,0
1319110,True,0,No user reviews,0,0,0
1319120,True,0,No user reviews,0,0,0
1319160,True,0,No user reviews,0,0,0
1319170,True,0,No user reviews,0,0,0
1319190,True,0,No user reviews,0,0,0
1319210,True,0,No user reviews,0,0,0
1319220,True,0,1 user reviews,1,0,1
1319240,True,0,No user reviews,0,0,0
1319260,True,0,No user reviews,0,0,0
1319270,True,0,No user reviews,0,0,0
1319290,True,0,5 user reviews,3,2,5
1319310,True,0,No user reviews,0,0,0
1319320,True,0,No user reviews,0,0,0
1319340,True,0,No user reviews,0,0,0
1319360,True,0,No user reviews,0,0,0
1319390,True,0,No user reviews,0,0,0
1319400,True,0,No user reviews,0,0,0
1319410,True,0,No user reviews,0,0,0
1319420,True,0,No user reviews,0,0,0
1319430,True,0,No user reviews,0,0,0
1319440,True,0,No user reviews,0,0,0
1319450,True,0,No user reviews,0,0,0
1319460,True,0,No user reviews,0,0,0
1319470,True,0,No user reviews,0,0,0
1319480,True,0,No user reviews,0,0,0
1319490,True,0,No user reviews,0,0,0
1319540,True,0,No user reviews,0,0,0
1319550,True,0,No user reviews,0,0,0
1319560,True,0,No user reviews,0,0,0
1319570,True,0,No user reviews,0,0,0
1319580,True,0,No user reviews,0,0,0
1319600,True,0,No user reviews,0,0,0
1319640,True,0,No user reviews,0,0,0
1319660,True,0,No user reviews,0,0,0
1319690,True,0,2 user reviews,2,0,2
1319720,True,0,No user reviews,0,0,0
1319740,True,0,No user reviews,0,0,0
1319750,True,0,5 user reviews,4,1,5
1319770,True,0,No user reviews,0,0,0
1319790,True,0,No user reviews,0,0,0
1319810,True,0,No user reviews,0,0,0
1319850,True,0,No user reviews,0,0,0
1319860,True,0,No user reviews,0,0,0
1319870,True,0,1 user reviews,0,1,1
1319880,True,0,1 user reviews,1,0,1
1319900,True,0,No user reviews,0,0,0
1319910,True,0,No user reviews,0,0,0
1319990,True,0,No user reviews,0,0,0
1320000,True,0,No user reviews,0,0,0
1320010,True,0,No user reviews,0,0,0
1320030,True,0,No user reviews,0,0,0
1320040,True,0,No user reviews,0,0,0
1320050,True,0,No user reviews,0,0,0
1320070,True,0,No user reviews,0,0,0
1320090,True,0,No user reviews,0,0,0
1320100,True,0,No user reviews,0,0,0
1320130,True,0,No user reviews,0,0,0
1320160,True,0,No user reviews,0,0,0
1320170,True,0,No user reviews,0,0,0
1320180,True,0,No user reviews,0,0,0
1320190,True,0,No user reviews,0,0,0
1320200,True,0,No user reviews,0,0,0
1320210,True,0,No user reviews,0,0,0
1320220,True,0,No user reviews,0,0,0
1320230,True,0,No user reviews,0,0,0
1320240,True,0,3 user reviews,3,0,3
1320270,True,0,No user reviews,0,0,0
1320290,True,0,No user reviews,0,0,0
1320300,True,0,No user reviews,0,0,0
1320330,True,0,No user reviews,0,0,0
1320340,True,0,No user reviews,0,0,0
1320350,True,0,No user reviews,0,0,0
1320370,True,0,No user reviews,0,0,0
1320380,True,0,No user reviews,0,0,0
1320390,True,0,No user reviews,0,0,0
1320400,True,0,2 user reviews,2,0,2
1320450,True,0,No user reviews,0,0,0
1320480,True,0,No user reviews,0,0,0
1320490,True,0,No user reviews,0,0,0
1320500,True,0,No user reviews,0,0,0
1320510,True,0,1 user reviews,1,0,1
1320520,True,0,1 user reviews,1,0,1
1320540,True,0,No user reviews,0,0,0
1320550,True,0,No user reviews,0,0,0
1320570,True,0,No user reviews,0,0,0
1320590,True,0,No user reviews,0,0,0
1320600,True,0,No user reviews,0,0,0
1320610,True,0,No user reviews,0,0,0
1320620,True,0,No user reviews,0,0,0
1320630,True,0,No user reviews,0,0,0
1320660,True,0,No user reviews,0,0,0
1320680,True,0,No user reviews,0,0,0
1320710,True,0,No user reviews,0,0,0
1320720,True,0,No user reviews,0,0,0
1320740,True,0,No user reviews,0,0,0
1320750,True,0,No user reviews,0,0,0
1320800,True,0,No user reviews,0,0,0
1320810,True,0,No user reviews,0,0,0
1320820,True,0,4 user reviews,4,0,4
1320830,True,0,1 user reviews,1,0,1
1320840,True,0,No user reviews,0,0,0
1320850,True,0,8 user reviews,7,1,8
1320860,True,0,No user reviews,0,0,0
1320870,True,0,No user reviews,0,0,0
1320900,True,0,No user reviews,0,0,0
1320920,True,0,No user reviews,0,0,0
1320930,True,0,No user reviews,0,0,0
1320940,True,0,1 user reviews,0,1,1
1320950,True,8,Very Positive,51,8,59
1320960,True,0,No user reviews,0,0,0
1320970,True,0,No user reviews,0,0,0
1320980,True,0,No user reviews,0,0,0
1320990,True,0,2 user reviews,1,1,2
1321000,True,0,No user reviews,0,0,0
1321010,True,0,4 user reviews,4,0,4
1321030,True,0,5 user reviews,5,0,5
1321040,True,0,No user reviews,0,0,0
1321050,True,0,No user reviews,0,0,0
1321060,True,0,No user reviews,0,0,0
1321070,True,8,Very Positive,99,18,117
1321080,True,0,No user reviews,0,0,0
1321100,True,0,No user reviews,0,0,0
1321110,True,0,1 user reviews,1,0,1
1321120,True,0,No user reviews,0,0,0
1321130,True,0,No user reviews,0,0,0
1321140,True,0,No user reviews,0,0,0
1321150,True,0,No user reviews,0,0,0
1321160,True,0,No user reviews,0,0,0
1321190,True,0,No user reviews,0,0,0
1321200,True,0,No user reviews,0,0,0
1321210,True,0,No user reviews,0,0,0
1321230,True,7,Positive,25,0,25
1321240,True,0,No user reviews,0,0,0
1321250,True,0,No user reviews,0,0,0
1321260,True,0,No user reviews,0,0,0
1321270,True,8,Very Positive,56,2,58
1321280,True,0,No user reviews,0,0,0
1321290,True,0,No user reviews,0,0,0
1321300,True,0,No user reviews,0,0,0
1321310,True,0,No user reviews,0,0,0
1321330,True,0,No user reviews,0,0,0
1321340,True,0,No user reviews,0,0,0
1321350,True,0,1 user reviews,1,0,1
1321360,True,0,No user reviews,0,0,0
1321370,True,0,No user reviews,0,0,0
1321380,True,0,No user reviews,0,0,0
1321390,True,0,No user reviews,0,0,0
1321400,True,0,4 user reviews,4,0,4
1321410,True,0,No user reviews,0,0,0
1321420,True,0,No user reviews,0,0,0
1321430,True,0,No user reviews,0,0,0
1321440,True,0,No user reviews,0,0,0
1321450,True,0,No user reviews,0,0,0
1321470,True,0,No user reviews,0,0,0
1321480,True,0,No user reviews,0,0,0
1321490,True,0,No user reviews,0,0,0
1321500,True,0,No user reviews,0,0,0
1321510,True,0,No user reviews,0,0,0
1321520,True,0,No user reviews,0,0,0
1321560,True,0,No user reviews,0,0,0
1321580,True,0,3 user reviews,3,0,3
1321590,True,0,1 user reviews,1,0,1
1321630,True,0,No user reviews,0,0,0
1321640,True,0,No user reviews,0,0,0
1321650,True,0,No user reviews,0,0,0
1321670,True,0,No user reviews,0,0,0
1321680,True,0,No user reviews,0,0,0
1321710,True,0,No user reviews,0,0,0
1321720,True,0,No user reviews,0,0,0
1321730,True,0,No user reviews,0,0,0
1321740,True,0,No user reviews,0,0,0
1321750,True,0,No user reviews,0,0,0
1321760,True,0,1 user reviews,1,0,1
1321770,True,0,6 user reviews,6,0,6
1321820,True,0,No user reviews,0,0,0
1321830,True,0,No user reviews,0,0,0
1321840,True,0,No user reviews,0,0,0
1321850,True,0,No user reviews,0,0,0
1321860,True,0,No user reviews,0,0,0
1321870,True,0,No user reviews,0,0,0
1321890,True,0,No user reviews,0,0,0
1321900,True,0,No user reviews,0,0,0
1321920,True,0,7 user reviews,3,4,7
1321930,True,0,No user reviews,0,0,0
1321950,True,0,No user reviews,0,0,0
1321960,True,0,No user reviews,0,0,0
1322010,True,0,7 user reviews,7,0,7
1322020,True,0,No user reviews,0,0,0
1322080,True,0,1 user reviews,1,0,1
1322090,True,0,No user reviews,0,0,0
1322130,True,0,No user reviews,0,0,0
1322140,True,0,No user reviews,0,0,0
1322150,True,0,No user reviews,0,0,0
1322170,True,7,Positive,37,2,39
1322180,True,0,8 user reviews,8,0,8
1322200,True,0,No user reviews,0,0,0
1322210,True,0,No user reviews,0,0,0
1322230,True,0,No user reviews,0,0,0
1322240,True,0,No user reviews,0,0,0
1322250,True,7,Positive,10,0,10
1322260,True,0,8 user reviews,7,1,8
1322270,True,0,8 user reviews,6,2,8
1322280,True,0,3 user reviews,1,2,3
1322290,True,0,1 user reviews,1,0,1
1322300,True,0,No user reviews,0,0,0
1322310,True,0,7 user reviews,6,1,7
1322320,True,0,No user reviews,0,0,0
1322330,True,0,1 user reviews,1,0,1
1322340,True,0,No user reviews,0,0,0
1322360,True,0,No user reviews,0,0,0
1322380,True,0,No user reviews,0,0,0
1322390,True,0,No user reviews,0,0,0
1322400,True,0,No user reviews,0,0,0
1322420,True,0,No user reviews,0,0,0
1322470,True,0,2 user reviews,2,0,2
1322480,True,0,No user reviews,0,0,0
1322490,True,0,1 user reviews,1,0,1
1322510,True,0,No user reviews,0,0,0
1322511,True,0,No user reviews,0,0,0
1322512,True,0,No user reviews,0,0,0
1322520,True,0,No user reviews,0,0,0
1322540,True,0,No user reviews,0,0,0
1322550,True,0,No user reviews,0,0,0
1322560,True,0,No user reviews,0,0,0
1322570,True,0,No user reviews,0,0,0
1322580,True,0,No user reviews,0,0,0
1322600,True,7,Positive,13,1,14
1322620,True,0,No user reviews,0,0,0
1322630,True,0,No user reviews,0,0,0
1322640,True,7,Positive,18,3,21
1322650,True,8,Very Positive,64,5,69
1322660,True,0,No user reviews,0,0,0
1322670,True,0,No user reviews,0,0,0
1322690,True,0,No user reviews,0,0,0
1322710,True,0,No user reviews,0,0,0
1322720,True,0,No user reviews,0,0,0
1322730,True,0,5 user reviews,4,1,5
1322740,True,0,No user reviews,0,0,0
1322750,True,0,No user reviews,0,0,0
1322760,True,0,No user reviews,0,0,0
1322790,True,0,1 user reviews,1,0,1
1322791,True,0,No user reviews,0,0,0
1322792,True,0,No user reviews,0,0,0
1322793,True,0,1 user reviews,1,0,1
1322794,True,0,1 user reviews,1,0,1
1322795,True,0,No user reviews,0,0,0
1322796,True,0,No user reviews,0,0,0
1322797,True,0,2 user reviews,1,1,2
1322798,True,0,No user reviews,0,0,0
1322800,True,0,No user reviews,0,0,0
1322810,True,0,No user reviews,0,0,0
1322840,True,0,No user reviews,0,0,0
1322850,True,0,No user reviews,0,0,0
1322860,True,0,No user reviews,0,0,0
1322870,True,0,No user reviews,0,0,0
1322880,True,0,No user reviews,0,0,0
1322890,True,0,No user reviews,0,0,0
1322920,True,0,No user reviews,0,0,0
1322930,True,0,No user reviews,0,0,0
1322940,True,0,No user reviews,0,0,0
1322950,True,0,No user reviews,0,0,0
1322980,True,0,No user reviews,0,0,0
1323000,True,7,Positive,20,0,20
1323010,True,0,No user reviews,0,0,0
1323020,True,0,No user reviews,0,0,0
1323040,True,0,No user reviews,0,0,0
1323060,True,0,No user reviews,0,0,0
1323070,True,0,No user reviews,0,0,0
1323080,True,0,No user reviews,0,0,0
1323090,True,0,No user reviews,0,0,0
1323110,True,0,No user reviews,0,0,0
1323120,True,0,No user reviews,0,0,0
1323140,True,0,No user reviews,0,0,0
1323150,True,0,No user reviews,0,0,0
1323160,True,0,No user reviews,0,0,0
1323170,True,0,No user reviews,0,0,0
1323190,True,0,No user reviews,0,0,0
1323200,True,0,No user reviews,0,0,0
1323210,True,0,7 user reviews,6,1,7
1323220,True,0,1 user reviews,1,0,1
1323240,True,0,3 user reviews,1,2,3
1323260,True,0,No user reviews,0,0,0
1323280,True,0,No user reviews,0,0,0
1323290,True,0,No user reviews,0,0,0
1323310,True,0,No user reviews,0,0,0
1323320,True,7,Positive,34,1,35
1323330,True,0,No user reviews,0,0,0
1323340,True,0,No user reviews,0,0,0
1323350,True,0,No user reviews,0,0,0
1323360,True,0,No user reviews,0,0,0
1323370,True,0,No user reviews,0,0,0
1323410,True,0,No user reviews,0,0,0
1323420,True,8,Very Positive,143,16,159
1323430,True,0,No user reviews,0,0,0
1323450,True,0,No user reviews,0,0,0
1323480,True,0,No user reviews,0,0,0
1323500,True,0,No user reviews,0,0,0
1323510,True,0,No user reviews,0,0,0
1323520,True,0,No user reviews,0,0,0
1323540,True,0,No user reviews,0,0,0
1323550,True,0,No user reviews,0,0,0
1323560,True,0,No user reviews,0,0,0
1323570,True,0,No user reviews,0,0,0
1323580,True,0,No user reviews,0,0,0
1323590,True,0,No user reviews,0,0,0
1323600,True,0,8 user reviews,8,0,8
1323610,True,0,5 user reviews,5,0,5
1323620,True,6,Mostly Positive,40,13,53
1323640,True,0,No user reviews,0,0,0
1323650,True,0,No user reviews,0,0,0
1323670,True,0,No user reviews,0,0,0
1323680,True,0,No user reviews,0,0,0
1323690,True,0,No user reviews,0,0,0
1323700,True,0,No user reviews,0,0,0
1323710,True,0,No user reviews,0,0,0
1323720,True,0,No user reviews,0,0,0
1323750,True,0,No user reviews,0,0,0
1323770,True,0,4 user reviews,4,0,4
1323780,True,0,No user reviews,0,0,0
1323800,True,0,No user reviews,0,0,0
1323810,True,0,No user reviews,0,0,0
1323830,True,0,No user reviews,0,0,0
1323850,True,0,No user reviews,0,0,0
1323860,True,0,2 user reviews,1,1,2
1323870,True,0,No user reviews,0,0,0
1323890,True,0,No user reviews,0,0,0
1323900,True,0,No user reviews,0,0,0
1323910,True,0,1 user reviews,1,0,1
1323930,True,0,No user reviews,0,0,0
1323950,True,0,No user reviews,0,0,0
1323970,True,0,No user reviews,0,0,0
1323980,True,0,No user reviews,0,0,0
1324000,True,7,Positive,15,0,15
1324010,True,0,3 user reviews,0,3,3
1324020,True,0,No user reviews,0,0,0
1324030,True,0,7 user reviews,7,0,7
1324040,True,0,1 user reviews,1,0,1
1324060,True,0,3 user reviews,2,1,3
1324070,True,0,No user reviews,0,0,0
1324100,True,0,No user reviews,0,0,0
1324140,True,5,Mixed,7,8,15
1324160,True,6,Mostly Positive,7,3,10
1324190,True,0,No user reviews,0,0,0
1324210,True,0,No user reviews,0,0,0
1324220,True,0,No user reviews,0,0,0
1324230,True,0,No user reviews,0,0,0
1324240,True,0,No user reviews,0,0,0
1324250,True,0,No user reviews,0,0,0
1324260,True,0,No user reviews,0,0,0
1324270,True,0,2 user reviews,1,1,2
1324280,True,0,No user reviews,0,0,0
1324290,True,0,No user reviews,0,0,0
1324300,True,0,No user reviews,0,0,0
1324310,True,0,No user reviews,0,0,0
1324320,True,0,No user reviews,0,0,0
1324360,True,0,7 user reviews,5,2,7
1324390,True,0,No user reviews,0,0,0
1324400,True,0,No user reviews,0,0,0
1324410,True,0,No user reviews,0,0,0
1324420,True,0,9 user reviews,7,2,9
1324430,True,0,No user reviews,0,0,0
1324440,True,0,No user reviews,0,0,0
1324470,True,7,Positive,9,1,10
1324480,True,0,No user reviews,0,0,0
1324490,True,0,1 user reviews,1,0,1
1324510,True,0,No user reviews,0,0,0
1324520,True,0,No user reviews,0,0,0
1324540,True,0,No user reviews,0,0,0
1324560,True,0,No user reviews,0,0,0
1324580,True,0,No user reviews,0,0,0
1324590,True,0,No user reviews,0,0,0
1324600,True,0,No user reviews,0,0,0
1324640,True,0,No user reviews,0,0,0
1324660,True,0,No user reviews,0,0,0
1324670,True,0,No user reviews,0,0,0
1324680,True,0,No user reviews,0,0,0
1324690,True,0,No user reviews,0,0,0
1324700,True,0,No user reviews,0,0,0
1324710,True,0,No user reviews,0,0,0
1324730,True,0,1 user reviews,0,1,1
1324740,True,0,No user reviews,0,0,0
1324741,True,0,No user reviews,0,0,0
1324760,True,0,No user reviews,0,0,0
1324780,True,0,No user reviews,0,0,0
1324800,True,0,No user reviews,0,0,0
1324830,True,0,No user reviews,0,0,0
1324850,True,0,No user reviews,0,0,0
1324860,True,0,No user reviews,0,0,0
1324870,True,0,8 user reviews,8,0,8
1324880,True,0,No user reviews,0,0,0
1324910,True,0,No user reviews,0,0,0
1324920,True,0,No user reviews,0,0,0
1324930,True,0,No user reviews,0,0,0
1324960,True,0,No user reviews,0,0,0
1324970,True,8,Very Positive,278,48,326
1324980,True,0,No user reviews,0,0,0
1324990,True,0,No user reviews,0,0,0
1325000,True,0,No user reviews,0,0,0
1325010,True,0,No user reviews,0,0,0
1325020,True,0,No user reviews,0,0,0
1325030,True,0,1 user reviews,0,1,1
1325040,True,0,No user reviews,0,0,0
1325050,True,0,No user reviews,0,0,0
1325060,True,0,No user reviews,0,0,0
1325080,True,0,No user reviews,0,0,0
1325090,True,0,No user reviews,0,0,0
1325100,True,0,No user reviews,0,0,0
1325110,True,0,No user reviews,0,0,0
1325150,True,0,No user reviews,0,0,0
1325160,True,0,No user reviews,0,0,0
1325220,True,0,No user reviews,0,0,0
1325230,True,0,No user reviews,0,0,0
1325240,True,0,No user reviews,0,0,0
1325250,True,0,No user reviews,0,0,0
1325270,True,0,No user reviews,0,0,0
1325310,True,0,No user reviews,0,0,0
1325330,True,0,No user reviews,0,0,0
1325340,True,0,No user reviews,0,0,0
1325350,True,0,No user reviews,0,0,0
1325360,True,0,No user reviews,0,0,0
1325370,True,0,1 user reviews,1,0,1
1325380,True,0,1 user reviews,1,0,1
1325390,True,0,No user reviews,0,0,0
1325400,True,0,2 user reviews,2,0,2
1325440,True,0,No user reviews,0,0,0
1325460,True,0,No user reviews,0,0,0
1325470,True,0,3 user reviews,3,0,3
1325490,True,0,No user reviews,0,0,0
1325510,True,0,No user reviews,0,0,0
1325520,True,0,1 user reviews,1,0,1
1325590,True,0,No user reviews,0,0,0
1325600,True,0,No user reviews,0,0,0
1325610,True,0,No user reviews,0,0,0
1325630,True,0,No user reviews,0,0,0
1325650,True,0,No user reviews,0,0,0
1325660,True,0,No user reviews,0,0,0
1325670,True,0,No user reviews,0,0,0
1325690,True,0,No user reviews,0,0,0
1325700,True,0,1 user reviews,1,0,1
1325710,True,0,No user reviews,0,0,0
1325730,True,0,2 user reviews,2,0,2
1325740,True,0,No user reviews,0,0,0
1325750,True,0,No user reviews,0,0,0
1325760,True,0,No user reviews,0,0,0
1325770,True,0,No user reviews,0,0,0
1325780,True,0,No user reviews,0,0,0
1325790,True,0,4 user reviews,4,0,4
1325800,True,5,Mixed,28,21,49
1325810,True,0,No user reviews,0,0,0
1325820,True,0,No user reviews,0,0,0
1325830,True,0,No user reviews,0,0,0
1325840,True,0,No user reviews,0,0,0
1325850,True,0,No user reviews,0,0,0
1325870,True,0,3 user reviews,3,0,3
1325900,True,0,No user reviews,0,0,0
1325940,True,0,No user reviews,0,0,0
1325960,True,0,4 user reviews,0,4,4
1325970,True,0,4 user reviews,3,1,4
1325980,True,0,No user reviews,0,0,0
1325990,True,0,No user reviews,0,0,0
1326000,True,7,Positive,19,4,23
1326010,True,0,No user reviews,0,0,0
1326020,True,0,No user reviews,0,0,0
1326040,True,0,No user reviews,0,0,0
1326070,True,0,No user reviews,0,0,0
1326080,True,0,No user reviews,0,0,0
1326090,True,0,No user reviews,0,0,0
1326100,True,0,No user reviews,0,0,0
1326120,True,0,No user reviews,0,0,0
1326130,True,0,No user reviews,0,0,0
1326140,True,0,No user reviews,0,0,0
1326150,True,0,No user reviews,0,0,0
1326160,True,0,No user reviews,0,0,0
1326170,True,0,No user reviews,0,0,0
1326180,True,0,No user reviews,0,0,0
1326200,True,0,No user reviews,0,0,0
1326210,True,0,No user reviews,0,0,0
1326220,True,0,No user reviews,0,0,0
1326230,True,0,No user reviews,0,0,0
1326250,True,0,No user reviews,0,0,0
1326270,True,0,No user reviews,0,0,0
1326280,True,0,No user reviews,0,0,0
1326290,True,0,No user reviews,0,0,0
1326300,True,0,No user reviews,0,0,0
1326310,True,0,No user reviews,0,0,0
1326320,True,0,No user reviews,0,0,0
1326330,True,0,No user reviews,0,0,0
1326350,True,0,No user reviews,0,0,0
1326370,True,0,No user reviews,0,0,0
1326380,True,0,No user reviews,0,0,0
1326390,True,0,No user reviews,0,0,0
1326400,True,0,No user reviews,0,0,0
1326410,True,0,No user reviews,0,0,0
1326430,True,0,No user reviews,0,0,0
1326440,True,0,No user reviews,0,0,0
1326450,True,0,No user reviews,0,0,0
1326460,True,0,No user reviews,0,0,0
1326480,True,0,No user reviews,0,0,0
1326490,True,0,No user reviews,0,0,0
1326530,True,0,No user reviews,0,0,0
1326540,True,0,No user reviews,0,0,0
1326550,True,0,No user reviews,0,0,0
1326560,True,0,No user reviews,0,0,0
1326570,True,0,No user reviews,0,0,0
1326580,True,0,No user reviews,0,0,0
1326590,True,0,No user reviews,0,0,0
1326620,True,0,No user reviews,0,0,0
1326630,True,0,No user reviews,0,0,0
1326650,True,0,No user reviews,0,0,0
1326660,True,0,4 user reviews,4,0,4
1326680,True,0,No user reviews,0,0,0
1326690,True,0,No user reviews,0,0,0
1326700,True,0,No user reviews,0,0,0
1326710,True,0,No user reviews,0,0,0
1326720,True,0,No user reviews,0,0,0
1326730,True,0,No user reviews,0,0,0
1326750,True,0,No user reviews,0,0,0
1326770,True,0,No user reviews,0,0,0
1326790,True,0,No user reviews,0,0,0
1326800,True,0,No user reviews,0,0,0
1326820,True,0,No user reviews,0,0,0
1326840,True,0,No user reviews,0,0,0
1326860,True,0,No user reviews,0,0,0
1326870,True,0,3 user reviews,3,0,3
1326880,True,0,No user reviews,0,0,0
1326900,True,0,No user reviews,0,0,0
1326920,True,0,1 user reviews,1,0,1
1326980,True,0,No user reviews,0,0,0
1327020,True,0,No user reviews,0,0,0
1327030,True,0,No user reviews,0,0,0
1327040,True,0,No user reviews,0,0,0
1327060,True,0,No user reviews,0,0,0
1327070,True,0,No user reviews,0,0,0
1327080,True,0,No user reviews,0,0,0
1327090,True,0,No user reviews,0,0,0
1327100,True,0,1 user reviews,1,0,1
1327110,True,0,No user reviews,0,0,0
1327120,True,0,No user reviews,0,0,0
1327140,True,0,No user reviews,0,0,0
1327160,True,0,No user reviews,0,0,0
1327170,True,0,No user reviews,0,0,0
1327180,True,0,No user reviews,0,0,0
1327200,True,0,No user reviews,0,0,0
1327220,True,0,No user reviews,0,0,0
1327240,True,0,No user reviews,0,0,0
1327250,True,0,No user reviews,0,0,0
1327260,True,0,3 user reviews,1,2,3
1327270,True,0,No user reviews,0,0,0
1327300,True,0,No user reviews,0,0,0
1327310,True,0,No user reviews,0,0,0
1327341,True,7,Positive,17,2,19
1327360,True,0,No user reviews,0,0,0
1327370,True,0,4 user reviews,4,0,4
1327380,True,0,No user reviews,0,0,0
1327390,True,0,3 user reviews,2,1,3
1327410,True,0,No user reviews,0,0,0
1327420,True,0,No user reviews,0,0,0
1327450,True,0,2 user reviews,0,2,2
1327460,True,0,No user reviews,0,0,0
1327480,True,0,No user reviews,0,0,0
1327490,True,0,No user reviews,0,0,0
1327500,True,0,No user reviews,0,0,0
1327520,True,0,No user reviews,0,0,0
1327530,True,0,No user reviews,0,0,0
1327540,True,0,3 user reviews,3,0,3
1327550,True,0,No user reviews,0,0,0
1327560,True,0,No user reviews,0,0,0
1327590,True,0,No user reviews,0,0,0
1327600,True,0,No user reviews,0,0,0
1327620,True,0,No user reviews,0,0,0
1327670,True,0,No user reviews,0,0,0
1327680,True,0,No user reviews,0,0,0
1327690,True,0,No user reviews,0,0,0
1327720,True,0,2 user reviews,2,0,2
1327750,True,0,No user reviews,0,0,0
1327770,True,0,No user reviews,0,0,0
1327790,True,0,No user reviews,0,0,0
1327800,True,0,No user reviews,0,0,0
1327810,True,0,3 user reviews,3,0,3
1327820,True,7,Positive,19,0,19
1327850,True,0,No user reviews,0,0,0
1327860,True,0,No user reviews,0,0,0
1327870,True,0,4 user reviews,4,0,4
1327890,True,0,No user reviews,0,0,0
1327891,True,0,No user reviews,0,0,0
1327900,True,0,No user reviews,0,0,0
1327910,True,0,No user reviews,0,0,0
1327970,True,0,No user reviews,0,0,0
1327990,True,0,No user reviews,0,0,0
1328010,True,0,No user reviews,0,0,0
1328020,True,0,No user reviews,0,0,0
1328030,True,0,No user reviews,0,0,0
1328031,True,0,No user reviews,0,0,0
1328032,True,0,No user reviews,0,0,0
1328050,True,0,No user reviews,0,0,0
1328080,True,0,No user reviews,0,0,0
1328160,True,0,No user reviews,0,0,0
1328170,True,0,8 user reviews,7,1,8
1328180,True,0,No user reviews,0,0,0
1328190,True,0,No user reviews,0,0,0
1328220,True,0,No user reviews,0,0,0
1328240,True,0,No user reviews,0,0,0
1328250,True,0,No user reviews,0,0,0
1328260,True,0,No user reviews,0,0,0
1328290,True,0,No user reviews,0,0,0
1328310,True,0,No user reviews,0,0,0
1328320,True,0,No user reviews,0,0,0
1328340,True,0,No user reviews,0,0,0
1328341,True,0,No user reviews,0,0,0
1328360,True,0,No user reviews,0,0,0
1328370,True,0,No user reviews,0,0,0
1328390,True,0,No user reviews,0,0,0
1328410,True,0,4 user reviews,4,0,4
1328420,True,0,No user reviews,0,0,0
1328421,True,0,1 user reviews,0,1,1
1328430,True,0,No user reviews,0,0,0
1328450,True,0,No user reviews,0,0,0
1328460,True,0,No user reviews,0,0,0
1328470,True,0,1 user reviews,1,0,1
1328490,True,0,No user reviews,0,0,0
1328500,True,0,1 user reviews,1,0,1
1328530,True,0,No user reviews,0,0,0
1328540,True,0,No user reviews,0,0,0
1328550,True,0,No user reviews,0,0,0
1328560,True,0,5 user reviews,5,0,5
1328570,True,7,Positive,15,0,15
1328580,True,0,No user reviews,0,0,0
1328590,True,0,No user reviews,0,0,0
1328600,True,0,No user reviews,0,0,0
1328610,True,0,No user reviews,0,0,0
1328620,True,0,No user reviews,0,0,0
1328640,True,0,No user reviews,0,0,0
1328650,True,0,No user reviews,0,0,0
1328660,True,0,No user reviews,0,0,0
1328680,True,0,No user reviews,0,0,0
1328690,True,0,No user reviews,0,0,0
1328710,True,0,No user reviews,0,0,0
1328720,True,0,No user reviews,0,0,0
1328750,True,0,2 user reviews,2,0,2
1328760,True,0,No user reviews,0,0,0
1328780,True,0,No user reviews,0,0,0
1328800,True,0,No user reviews,0,0,0
1328810,True,0,5 user reviews,5,0,5
1328830,True,0,2 user reviews,2,0,2
1328840,True,0,No user reviews,0,0,0
1328850,True,0,No user reviews,0,0,0
1328870,True,0,No user reviews,0,0,0
1328880,True,0,No user reviews,0,0,0
1328890,True,7,Positive,27,0,27
1328900,True,0,No user reviews,0,0,0
1328910,True,6,Mostly Positive,8,3,11
1328920,True,5,Mixed,8,5,13
1328930,True,0,No user reviews,0,0,0
1328950,True,0,No user reviews,0,0,0
1328960,True,0,No user reviews,0,0,0
1329020,True,0,No user reviews,0,0,0
1329050,True,0,No user reviews,0,0,0
1329060,True,0,No user reviews,0,0,0
1329070,True,0,No user reviews,0,0,0
1329080,True,0,4 user reviews,4,0,4
1329090,True,0,No user reviews,0,0,0
1329110,True,0,No user reviews,0,0,0
1329120,True,0,No user reviews,0,0,0
1329130,True,0,No user reviews,0,0,0
1329140,True,0,No user reviews,0,0,0
1329150,True,0,No user reviews,0,0,0
1329160,True,0,No user reviews,0,0,0
1329180,True,0,No user reviews,0,0,0
1329190,True,0,3 user reviews,3,0,3
1329210,True,0,No user reviews,0,0,0
1329240,True,0,No user reviews,0,0,0
1329250,True,0,No user reviews,0,0,0
1329270,True,0,No user reviews,0,0,0
1329280,True,0,No user reviews,0,0,0
1329310,True,0,No user reviews,0,0,0
1329320,True,0,3 user reviews,2,1,3
1329350,True,0,No user reviews,0,0,0
1329360,True,0,No user reviews,0,0,0
1329380,True,0,No user reviews,0,0,0
1329390,True,0,No user reviews,0,0,0
1329400,True,0,No user reviews,0,0,0
1329410,True,0,No user reviews,0,0,0
1329420,True,0,1 user reviews,1,0,1
1329430,True,0,No user reviews,0,0,0
1329440,True,0,1 user reviews,1,0,1
1329450,True,0,1 user reviews,0,1,1
1329460,True,0,No user reviews,0,0,0
1329470,True,0,2 user reviews,2,0,2
1329480,True,0,No user reviews,0,0,0
1329490,True,0,No user reviews,0,0,0
1329510,True,5,Mixed,46,28,74
1329530,True,0,4 user reviews,1,3,4
1329540,True,8,Very Positive,58,5,63
1329559,True,0,No user reviews,0,0,0
1329560,True,5,Mixed,11,11,22
1329570,True,0,No user reviews,0,0,0
1329571,True,0,No user reviews,0,0,0
1329572,True,0,No user reviews,0,0,0
1329573,True,0,3 user reviews,2,1,3
1329580,True,0,No user reviews,0,0,0
1329590,True,0,2 user reviews,2,0,2
1329600,True,7,Positive,24,5,29
1329630,True,0,1 user reviews,1,0,1
1329650,True,0,No user reviews,0,0,0
1329660,True,0,No user reviews,0,0,0
1329740,True,0,No user reviews,0,0,0
1329780,True,0,No user reviews,0,0,0
1329790,True,0,No user reviews,0,0,0
1329800,True,0,No user reviews,0,0,0
1329810,True,0,No user reviews,0,0,0
1329830,True,0,1 user reviews,0,1,1
1329850,True,0,2 user reviews,0,2,2
1329870,True,0,No user reviews,0,0,0
1329880,True,0,No user reviews,0,0,0
1329900,True,0,No user reviews,0,0,0
1329970,True,0,No user reviews,0,0,0
1329990,True,0,1 user reviews,0,1,1
1330000,True,0,No user reviews,0,0,0
1330010,True,0,2 user reviews,2,0,2
1330040,True,5,Mixed,144,90,234
1330070,True,0,No user reviews,0,0,0
1330080,True,0,No user reviews,0,0,0
1330090,True,0,No user reviews,0,0,0
1330100,True,0,No user reviews,0,0,0
1330110,True,0,No user reviews,0,0,0
1330120,True,0,No user reviews,0,0,0
1330130,True,0,1 user reviews,1,0,1
1330140,True,0,1 user reviews,1,0,1
1330150,True,0,1 user reviews,1,0,1
1330160,True,0,2 user reviews,2,0,2
1330170,True,0,4 user reviews,3,1,4
1330180,True,0,2 user reviews,1,1,2
1330190,True,7,Positive,20,1,21
1330210,True,0,No user reviews,0,0,0
1330211,True,0,No user reviews,0,0,0
1330212,True,0,1 user reviews,1,0,1
1330213,True,0,No user reviews,0,0,0
1330214,True,0,No user reviews,0,0,0
1330215,True,0,No user reviews,0,0,0
1330216,True,0,1 user reviews,1,0,1
1330217,True,0,No user reviews,0,0,0
1330218,True,0,No user reviews,0,0,0
1330219,True,0,No user reviews,0,0,0
1330240,True,0,No user reviews,0,0,0
1330250,True,0,No user reviews,0,0,0
1330290,True,0,No user reviews,0,0,0
1330300,True,0,1 user reviews,1,0,1
1330320,True,0,No user reviews,0,0,0
1330330,True,0,5 user reviews,5,0,5
1330360,True,0,No user reviews,0,0,0
1330370,True,0,No user reviews,0,0,0
1330380,True,0,4 user reviews,4,0,4
1330400,True,0,No user reviews,0,0,0
1330410,True,0,No user reviews,0,0,0
1330420,True,0,9 user reviews,9,0,9
1330430,True,0,No user reviews,0,0,0
1330450,True,0,No user reviews,0,0,0
1330460,True,0,No user reviews,0,0,0
1330470,True,0,No user reviews,0,0,0
1330480,True,7,Positive,12,1,13
1330500,True,0,No user reviews,0,0,0
1330510,True,0,No user reviews,0,0,0
1330550,True,7,Positive,25,0,25
1330560,True,0,No user reviews,0,0,0
1330570,True,0,2 user reviews,2,0,2
1330590,True,0,No user reviews,0,0,0
1330600,True,0,No user reviews,0,0,0
1330602,True,0,No user reviews,0,0,0
1330610,True,0,4 user reviews,3,1,4
1330620,True,0,No user reviews,0,0,0
1330630,True,0,6 user reviews,6,0,6
1330710,True,0,1 user reviews,0,1,1
1330720,True,0,1 user reviews,1,0,1
1330721,True,0,No user reviews,0,0,0
1330730,True,5,Mixed,13,6,19
1330750,True,0,No user reviews,0,0,0
1330760,True,0,1 user reviews,1,0,1
1330770,True,0,No user reviews,0,0,0
1330790,True,0,No user reviews,0,0,0
1330800,True,0,2 user reviews,1,1,2
1330810,True,0,No user reviews,0,0,0
1330820,True,0,No user reviews,0,0,0
1330840,True,0,No user reviews,0,0,0
1330850,True,0,No user reviews,0,0,0
1330890,True,8,Very Positive,50,2,52
1330900,True,0,No user reviews,0,0,0
1330910,True,0,No user reviews,0,0,0
1330920,True,0,1 user reviews,1,0,1
1330930,True,0,No user reviews,0,0,0
1330940,True,0,1 user reviews,1,0,1
1330960,True,0,No user reviews,0,0,0
1330970,True,0,No user reviews,0,0,0
1330990,True,0,No user reviews,0,0,0
1331000,True,0,1 user reviews,1,0,1
1331001,True,0,No user reviews,0,0,0
1331002,True,0,No user reviews,0,0,0
1331010,True,0,No user reviews,0,0,0
1331011,True,0,2 user reviews,2,0,2
1331020,True,0,2 user reviews,2,0,2
1331021,True,0,No user reviews,0,0,0
1331030,True,0,No user reviews,0,0,0
1331040,True,0,No user reviews,0,0,0
1331050,True,0,No user reviews,0,0,0
1331060,True,0,No user reviews,0,0,0
1331070,True,0,No user reviews,0,0,0
1331090,True,0,3 user reviews,3,0,3
1331110,True,0,No user reviews,0,0,0
1331111,True,0,No user reviews,0,0,0
1331112,True,0,No user reviews,0,0,0
1331113,True,0,No user reviews,0,0,0
1331114,True,0,No user reviews,0,0,0
1331115,True,0,No user reviews,0,0,0
1331120,True,0,No user reviews,0,0,0
1331130,True,0,No user reviews,0,0,0
1331140,True,0,No user reviews,0,0,0
1331150,True,0,No user reviews,0,0,0
1331160,True,0,No user reviews,0,0,0
1331170,True,0,No user reviews,0,0,0
1331200,True,0,No user reviews,0,0,0
1331210,True,0,No user reviews,0,0,0
1331220,True,0,1 user reviews,1,0,1
1331221,True,0,3 user reviews,0,3,3
1331240,True,0,No user reviews,0,0,0
1331260,True,0,No user reviews,0,0,0
1331270,True,7,Positive,10,0,10
1331280,True,0,No user reviews,0,0,0
1331290,True,0,No user reviews,0,0,0
1331330,True,0,8 user reviews,6,2,8
1331340,True,0,No user reviews,0,0,0
1331370,True,0,No user reviews,0,0,0
1331390,True,0,No user reviews,0,0,0
1331400,True,0,No user reviews,0,0,0
1331410,True,0,No user reviews,0,0,0
1331420,True,0,No user reviews,0,0,0
1331440,True,0,No user reviews,0,0,0
1331460,True,0,No user reviews,0,0,0
1331470,True,0,No user reviews,0,0,0
1331480,True,0,No user reviews,0,0,0
1331520,True,0,No user reviews,0,0,0
1331530,True,0,No user reviews,0,0,0
1331540,True,0,No user reviews,0,0,0
1331560,True,0,No user reviews,0,0,0
1331590,True,0,No user reviews,0,0,0
1331600,True,0,No user reviews,0,0,0
1331620,True,0,2 user reviews,2,0,2
1331650,True,0,3 user reviews,3,0,3
1331660,True,0,No user reviews,0,0,0
1331670,True,0,No user reviews,0,0,0
1331710,True,0,No user reviews,0,0,0
1331720,True,0,No user reviews,0,0,0
1331730,True,0,No user reviews,0,0,0
1331740,True,0,No user reviews,0,0,0
1331750,True,0,No user reviews,0,0,0
1331760,True,0,No user reviews,0,0,0
1331770,True,0,No user reviews,0,0,0
1331780,True,0,No user reviews,0,0,0
1331790,True,0,No user reviews,0,0,0
1331800,True,0,No user reviews,0,0,0
1331810,True,0,No user reviews,0,0,0
1331820,True,0,No user reviews,0,0,0
1331821,True,0,1 user reviews,1,0,1
1331830,True,0,No user reviews,0,0,0
1331860,True,0,No user reviews,0,0,0
1331880,True,0,No user reviews,0,0,0
1331900,True,0,No user reviews,0,0,0
1331930,True,0,No user reviews,0,0,0
1332010,True,0,No user reviews,0,0,0
1332020,True,0,No user reviews,0,0,0
1332040,True,0,No user reviews,0,0,0
1332120,True,0,2 user reviews,2,0,2
1332150,True,0,No user reviews,0,0,0
1332200,True,0,No user reviews,0,0,0
1332210,True,0,No user reviews,0,0,0
1332230,True,0,No user reviews,0,0,0
1332250,True,0,No user reviews,0,0,0
1332280,True,0,No user reviews,0,0,0
1332290,True,0,No user reviews,0,0,0
1332350,True,0,No user reviews,0,0,0
1332360,True,0,No user reviews,0,0,0
1332370,True,0,No user reviews,0,0,0
1332380,True,0,No user reviews,0,0,0
1332390,True,0,No user reviews,0,0,0
1332400,True,0,No user reviews,0,0,0
1332420,True,0,1 user reviews,0,1,1
1332440,True,0,No user reviews,0,0,0
1332450,True,0,No user reviews,0,0,0
1332470,True,0,No user reviews,0,0,0
1332480,True,0,No user reviews,0,0,0
1332530,True,0,No user reviews,0,0,0
1332540,True,0,1 user reviews,1,0,1
1332550,True,0,No user reviews,0,0,0
1332570,True,0,4 user reviews,3,1,4
1332580,True,0,No user reviews,0,0,0
1332590,True,0,6 user reviews,4,2,6
1332600,True,0,No user reviews,0,0,0
1332610,True,0,2 user reviews,0,2,2
1332620,True,6,Mostly Positive,8,3,11
1332630,True,0,2 user reviews,2,0,2
1332670,True,0,No user reviews,0,0,0
1332680,True,0,No user reviews,0,0,0
1332681,True,0,No user reviews,0,0,0
1332682,True,0,No user reviews,0,0,0
1332683,True,0,No user reviews,0,0,0
1332684,True,0,No user reviews,0,0,0
1332685,True,0,No user reviews,0,0,0
1332690,True,0,No user reviews,0,0,0
1332730,True,0,No user reviews,0,0,0
1332760,True,0,No user reviews,0,0,0
1332790,True,0,No user reviews,0,0,0
1332800,True,0,2 user reviews,2,0,2
1332810,True,0,No user reviews,0,0,0
1332840,True,0,No user reviews,0,0,0
1332850,True,0,No user reviews,0,0,0
1332860,True,7,Positive,22,1,23
1332890,True,7,Positive,9,1,10
1332940,True,0,1 user reviews,1,0,1
1332970,True,7,Positive,24,0,24
1332980,True,0,No user reviews,0,0,0
1333010,True,0,No user reviews,0,0,0
1333020,True,0,5 user reviews,5,0,5
1333030,True,0,No user reviews,0,0,0
1333050,True,0,No user reviews,0,0,0
1333060,True,0,No user reviews,0,0,0
1333070,True,0,No user reviews,0,0,0
1333090,True,0,No user reviews,0,0,0
1333140,True,0,No user reviews,0,0,0
1333173,True,0,4 user reviews,4,0,4
1333174,True,0,No user reviews,0,0,0
1333175,True,0,No user reviews,0,0,0
1333176,True,0,No user reviews,0,0,0
1333177,True,0,No user reviews,0,0,0
1333178,True,0,No user reviews,0,0,0
1333179,True,0,No user reviews,0,0,0
1333190,True,0,5 user reviews,5,0,5
1333210,True,0,No user reviews,0,0,0
1333220,True,5,Mixed,59,86,145
1333270,True,0,No user reviews,0,0,0
1333330,True,6,Mostly Positive,9,3,12
1333340,True,0,No user reviews,0,0,0
1333350,True,0,No user reviews,0,0,0
1333360,True,7,Positive,21,4,25
1333370,True,0,No user reviews,0,0,0
1333380,True,0,No user reviews,0,0,0
1333390,True,0,2 user reviews,2,0,2
1333400,True,0,No user reviews,0,0,0
1333410,True,0,No user reviews,0,0,0
1333420,True,0,No user reviews,0,0,0
1333430,True,0,No user reviews,0,0,0
1333460,True,7,Positive,13,0,13
1333470,True,0,No user reviews,0,0,0
1333480,True,0,No user reviews,0,0,0
1333500,True,0,No user reviews,0,0,0
1333510,True,0,2 user reviews,1,1,2
1333520,True,0,No user reviews,0,0,0
1333540,True,0,1 user reviews,0,1,1
1333550,True,0,No user reviews,0,0,0
1333570,True,0,1 user reviews,1,0,1
1333590,True,0,No user reviews,0,0,0
1333620,True,0,No user reviews,0,0,0
1333640,True,0,No user reviews,0,0,0
1333650,True,0,No user reviews,0,0,0
1333700,True,0,No user reviews,0,0,0
1333740,True,0,No user reviews,0,0,0
1333741,True,0,No user reviews,0,0,0
1333760,True,0,No user reviews,0,0,0
1333770,True,0,No user reviews,0,0,0
1333800,True,0,No user reviews,0,0,0
1333810,True,0,No user reviews,0,0,0
1333820,True,0,No user reviews,0,0,0
1333840,True,0,No user reviews,0,0,0
1333850,True,8,Very Positive,65,2,67
1333860,True,0,2 user reviews,2,0,2
1333870,True,0,No user reviews,0,0,0
1333890,True,7,Positive,15,0,15
1333900,True,0,1 user reviews,1,0,1
1333910,True,0,No user reviews,0,0,0
1333920,True,0,No user reviews,0,0,0
1333930,True,0,No user reviews,0,0,0
1333940,True,0,No user reviews,0,0,0
1333950,True,0,No user reviews,0,0,0
1333960,True,0,No user reviews,0,0,0
1333980,True,0,No user reviews,0,0,0
1333990,True,0,No user reviews,0,0,0
1334000,True,8,Very Positive,67,10,77
1334010,True,6,Mostly Positive,50,14,64
1334020,True,0,3 user reviews,2,1,3
1334030,True,0,No user reviews,0,0,0
1334040,True,6,Mostly Positive,17,5,22
1334050,True,0,No user reviews,0,0,0
1334070,True,0,6 user reviews,3,3,6
1334090,True,0,No user reviews,0,0,0
1334110,True,0,No user reviews,0,0,0
1334120,True,0,No user reviews,0,0,0
1334150,True,0,No user reviews,0,0,0
1334160,True,0,No user reviews,0,0,0
1334170,True,0,No user reviews,0,0,0
1334200,True,0,No user reviews,0,0,0
1334210,True,0,No user reviews,0,0,0
1334230,True,0,No user reviews,0,0,0
1334240,True,0,No user reviews,0,0,0
1334270,True,0,No user reviews,0,0,0
1334300,True,0,9 user reviews,9,0,9
1334310,True,0,No user reviews,0,0,0
1334330,True,0,3 user reviews,3,0,3
1334360,True,0,No user reviews,0,0,0
1334370,True,0,No user reviews,0,0,0
1334380,True,0,No user reviews,0,0,0
1334400,True,0,No user reviews,0,0,0
1334410,True,0,No user reviews,0,0,0
1334420,True,0,No user reviews,0,0,0
1334430,True,0,No user reviews,0,0,0
1334460,True,0,No user reviews,0,0,0
1334480,True,0,No user reviews,0,0,0
1334490,True,0,2 user reviews,2,0,2
1334510,True,0,2 user reviews,2,0,2
1334530,True,0,No user reviews,0,0,0
1334560,True,0,No user reviews,0,0,0
1334580,True,0,No user reviews,0,0,0
1334590,True,8,Very Positive,219,30,249
1334610,True,0,4 user reviews,4,0,4
1334620,True,0,No user reviews,0,0,0
1334630,True,0,No user reviews,0,0,0
1334650,True,0,No user reviews,0,0,0
1334680,True,0,No user reviews,0,0,0
1334700,True,7,Positive,17,0,17
1334710,True,0,No user reviews,0,0,0
1334730,True,0,No user reviews,0,0,0
1334750,True,0,1 user reviews,0,1,1
1334760,True,0,No user reviews,0,0,0
1334770,True,0,No user reviews,0,0,0
1334780,True,0,No user reviews,0,0,0
1334790,True,0,No user reviews,0,0,0
1334791,True,0,No user reviews,0,0,0
1334792,True,0,No user reviews,0,0,0
1334800,True,0,No user reviews,0,0,0
1334830,True,0,2 user reviews,2,0,2
1334840,True,5,Mixed,6,7,13
1334870,True,0,No user reviews,0,0,0
1334890,True,0,No user reviews,0,0,0
1334900,True,0,No user reviews,0,0,0
1334910,True,0,No user reviews,0,0,0
1334930,True,0,No user reviews,0,0,0
1334970,True,0,1 user reviews,1,0,1
1334990,True,0,No user reviews,0,0,0
1335020,True,0,No user reviews,0,0,0
1335030,True,0,No user reviews,0,0,0
1335050,True,0,No user reviews,0,0,0
1335070,True,0,1 user reviews,1,0,1
1335080,True,0,3 user reviews,3,0,3
1335090,True,0,8 user reviews,7,1,8
1335100,True,0,4 user reviews,4,0,4
1335110,True,0,7 user reviews,7,0,7
1335120,True,0,No user reviews,0,0,0
1335130,True,0,No user reviews,0,0,0
1335140,True,0,2 user reviews,2,0,2
1335150,True,0,1 user reviews,1,0,1
1335160,True,0,3 user reviews,3,0,3
1335170,True,0,2 user reviews,2,0,2
1335190,True,0,No user reviews,0,0,0
1335200,True,0,No user reviews,0,0,0
1335210,True,0,No user reviews,0,0,0
1335230,True,0,No user reviews,0,0,0
1335240,True,0,3 user reviews,2,1,3
1335270,True,0,No user reviews,0,0,0
1335290,True,0,9 user reviews,9,0,9
1335300,True,0,2 user reviews,1,1,2
1335340,True,0,No user reviews,0,0,0
1335350,True,0,1 user reviews,1,0,1
1335370,True,0,No user reviews,0,0,0
1335400,True,0,2 user reviews,1,1,2
1335410,True,0,2 user reviews,0,2,2
1335430,True,0,1 user reviews,1,0,1
1335440,True,7,Positive,10,1,11
1335470,True,0,No user reviews,0,0,0
1335480,True,0,No user reviews,0,0,0
1335510,True,0,2 user reviews,1,1,2
1335530,True,0,No user reviews,0,0,0
1335560,True,0,No user reviews,0,0,0
1335580,True,0,No user reviews,0,0,0
1335600,True,0,2 user reviews,2,0,2
1335620,True,0,No user reviews,0,0,0
1335650,True,0,No user reviews,0,0,0
1335680,True,0,No user reviews,0,0,0
1335690,True,0,No user reviews,0,0,0
1335700,True,0,No user reviews,0,0,0
1335740,True,0,No user reviews,0,0,0
1335750,True,0,No user reviews,0,0,0
1335790,True,0,No user reviews,0,0,0
1335800,True,0,No user reviews,0,0,0
1335810,True,7,Positive,16,2,18
1335820,True,0,8 user reviews,8,0,8
1335830,True,0,No user reviews,0,0,0
1335840,True,0,7 user reviews,7,0,7
1335870,True,0,No user reviews,0,0,0
1335880,True,0,4 user reviews,3,1,4
1335890,True,0,No user reviews,0,0,0
1335910,True,0,No user reviews,0,0,0
1335960,True,0,No user reviews,0,0,0
1335970,True,0,3 user reviews,2,1,3
1335980,True,0,No user reviews,0,0,0
1335990,True,0,No user reviews,0,0,0
1336020,True,0,No user reviews,0,0,0
1336040,True,0,1 user reviews,1,0,1
1336050,True,0,No user reviews,0,0,0
1336060,True,7,Positive,37,0,37
1336080,True,0,No user reviews,0,0,0
1336100,True,0,1 user reviews,1,0,1
1336110,True,0,No user reviews,0,0,0
1336120,True,0,No user reviews,0,0,0
1336130,True,0,1 user reviews,0,1,1
1336140,True,0,No user reviews,0,0,0
1336150,True,0,No user reviews,0,0,0
1336160,True,0,2 user reviews,2,0,2
1336170,True,0,1 user reviews,1,0,1
1336210,True,0,No user reviews,0,0,0
1336230,True,0,1 user reviews,1,0,1
1336240,True,0,No user reviews,0,0,0
1336260,True,0,No user reviews,0,0,0
1336270,True,0,No user reviews,0,0,0
1336290,True,0,No user reviews,0,0,0
1336340,True,7,Positive,23,0,23
1336350,True,0,No user reviews,0,0,0
1336380,True,0,No user reviews,0,0,0
1336390,True,0,No user reviews,0,0,0
1336400,True,0,No user reviews,0,0,0
1336410,True,0,No user reviews,0,0,0
1336420,True,0,1 user reviews,1,0,1
1336430,True,7,Positive,22,3,25
1336440,True,0,1 user reviews,1,0,1
1336450,True,0,No user reviews,0,0,0
1336460,True,0,1 user reviews,1,0,1
1336480,True,0,No user reviews,0,0,0
1336481,True,0,1 user reviews,1,0,1
1336482,True,0,4 user reviews,4,0,4
1336483,True,0,No user reviews,0,0,0
1336484,True,0,1 user reviews,1,0,1
1336490,True,0,No user reviews,0,0,0
1336500,True,0,No user reviews,0,0,0
1336540,True,0,No user reviews,0,0,0
1336550,True,0,No user reviews,0,0,0
1336560,True,5,Mixed,23,11,34
1336570,True,0,No user reviews,0,0,0
1336590,True,0,No user reviews,0,0,0
1336610,True,0,No user reviews,0,0,0
1336620,True,0,No user reviews,0,0,0
1336700,True,0,No user reviews,0,0,0
1336710,True,0,No user reviews,0,0,0
1336711,True,0,No user reviews,0,0,0
1336720,True,0,No user reviews,0,0,0
1336740,True,0,No user reviews,0,0,0
1336780,True,0,No user reviews,0,0,0
1336790,True,0,No user reviews,0,0,0
1336800,True,0,No user reviews,0,0,0
1336810,True,0,No user reviews,0,0,0
1336830,True,0,1 user reviews,1,0,1
1336840,True,0,No user reviews,0,0,0
1336850,True,0,No user reviews,0,0,0
1336870,True,0,No user reviews,0,0,0
1336880,True,0,No user reviews,0,0,0
1336900,True,0,No user reviews,0,0,0
1336901,True,0,No user reviews,0,0,0
1336910,True,0,No user reviews,0,0,0
1336930,True,0,No user reviews,0,0,0
1336940,True,0,No user reviews,0,0,0
1336950,True,0,2 user reviews,1,1,2
1336960,True,0,1 user reviews,1,0,1
1336970,True,0,2 user reviews,2,0,2
1337000,True,0,No user reviews,0,0,0
1337010,True,0,No user reviews,0,0,0
1337020,True,0,No user reviews,0,0,0
1337030,True,0,No user reviews,0,0,0
1337040,True,0,No user reviews,0,0,0
1337060,True,0,No user reviews,0,0,0
1337070,True,0,1 user reviews,1,0,1
1337080,True,0,3 user reviews,3,0,3
1337090,True,0,No user reviews,0,0,0
1337091,True,0,No user reviews,0,0,0
1337092,True,0,No user reviews,0,0,0
1337110,True,0,No user reviews,0,0,0
1337170,True,0,1 user reviews,1,0,1
1337180,True,0,No user reviews,0,0,0
1337181,True,0,No user reviews,0,0,0
1337182,True,0,No user reviews,0,0,0
1337200,True,0,No user reviews,0,0,0
1337210,True,0,No user reviews,0,0,0
1337220,True,0,No user reviews,0,0,0
1337240,True,0,No user reviews,0,0,0
1337250,True,0,No user reviews,0,0,0
1337260,True,0,No user reviews,0,0,0
1337270,True,7,Positive,15,1,16
1337280,True,7,Positive,12,0,12
1337300,True,0,No user reviews,0,0,0
1337330,True,0,3 user reviews,3,0,3
1337340,True,0,No user reviews,0,0,0
1337360,True,0,No user reviews,0,0,0
1337430,True,5,Mixed,10,5,15
1337450,True,0,No user reviews,0,0,0
1337460,True,0,1 user reviews,0,1,1
1337470,True,0,No user reviews,0,0,0
1337490,True,0,No user reviews,0,0,0
1337500,True,0,No user reviews,0,0,0
1337510,True,0,No user reviews,0,0,0
1337530,True,0,No user reviews,0,0,0
1337590,True,0,No user reviews,0,0,0
1337600,True,0,No user reviews,0,0,0
1337640,True,0,No user reviews,0,0,0
1337660,True,0,2 user reviews,2,0,2
1337690,True,0,No user reviews,0,0,0
1337700,True,0,No user reviews,0,0,0
1337710,True,0,No user reviews,0,0,0
1337720,True,0,No user reviews,0,0,0
1337750,True,0,No user reviews,0,0,0
1337760,True,0,No user reviews,0,0,0
1337780,True,0,No user reviews,0,0,0
1337810,True,0,No user reviews,0,0,0
1337820,True,0,No user reviews,0,0,0
1337860,True,8,Very Positive,109,7,116
1337870,True,0,1 user reviews,0,1,1
1337880,True,0,No user reviews,0,0,0
1337890,True,0,No user reviews,0,0,0
1337901,True,0,No user reviews,0,0,0
1337902,True,0,No user reviews,0,0,0
1337920,True,0,No user reviews,0,0,0
1337950,True,0,No user reviews,0,0,0
1337960,True,0,No user reviews,0,0,0
1337990,True,0,No user reviews,0,0,0
1338020,True,0,No user reviews,0,0,0
1338030,True,0,No user reviews,0,0,0
1338040,True,0,No user reviews,0,0,0
1338060,True,0,No user reviews,0,0,0
1338070,True,0,No user reviews,0,0,0
1338080,True,0,No user reviews,0,0,0
1338090,True,0,2 user reviews,2,0,2
1338120,True,0,No user reviews,0,0,0
1338130,True,0,6 user reviews,5,1,6
1338140,True,0,No user reviews,0,0,0
1338160,True,0,No user reviews,0,0,0
1338180,True,0,1 user reviews,1,0,1
1338200,True,0,No user reviews,0,0,0
1338220,True,0,No user reviews,0,0,0
1338250,True,0,No user reviews,0,0,0
1338270,True,0,No user reviews,0,0,0
1338300,True,0,No user reviews,0,0,0
1338310,True,0,No user reviews,0,0,0
1338320,True,0,No user reviews,0,0,0
1338330,True,0,No user reviews,0,0,0
1338360,True,0,No user reviews,0,0,0
1338370,True,0,No user reviews,0,0,0
1338390,True,0,6 user reviews,6,0,6
1338400,True,0,No user reviews,0,0,0
1338410,True,0,No user reviews,0,0,0
1338420,True,0,No user reviews,0,0,0
1338430,True,0,No user reviews,0,0,0
1338440,True,0,No user reviews,0,0,0
1338460,True,0,No user reviews,0,0,0
1338470,True,7,Positive,19,2,21
1338490,True,0,No user reviews,0,0,0
1338520,True,0,No user reviews,0,0,0
1338540,True,0,No user reviews,0,0,0
1338560,True,0,1 user reviews,0,1,1
1338570,True,0,2 user reviews,2,0,2
1338620,True,0,No user reviews,0,0,0
1338630,True,6,Mostly Positive,8,3,11
1338640,True,7,Positive,35,1,36
1338650,True,0,No user reviews,0,0,0
1338660,True,0,No user reviews,0,0,0
1338670,True,0,No user reviews,0,0,0
1338690,True,0,No user reviews,0,0,0
1338700,True,0,3 user reviews,3,0,3
1338740,True,0,No user reviews,0,0,0
1338760,True,0,No user reviews,0,0,0
1338770,True,0,No user reviews,0,0,0
1338780,True,0,No user reviews,0,0,0
1338790,True,0,1 user reviews,1,0,1
1338810,True,0,No user reviews,0,0,0
1338830,True,0,No user reviews,0,0,0
1338870,True,0,No user reviews,0,0,0
1338880,True,0,No user reviews,0,0,0
1338890,True,0,No user reviews,0,0,0
1338900,True,0,No user reviews,0,0,0
1338910,True,0,2 user reviews,1,1,2
1338920,True,0,No user reviews,0,0,0
1338930,True,0,No user reviews,0,0,0
1338940,True,0,No user reviews,0,0,0
1338950,True,0,No user reviews,0,0,0
1338960,True,0,No user reviews,0,0,0
1338961,True,0,No user reviews,0,0,0
1338962,True,0,No user reviews,0,0,0
1338963,True,0,No user reviews,0,0,0
1338964,True,0,No user reviews,0,0,0
1338980,True,7,Positive,34,2,36
1339000,True,0,No user reviews,0,0,0
1339010,True,0,No user reviews,0,0,0
1339011,True,0,No user reviews,0,0,0
1339012,True,0,No user reviews,0,0,0
1339030,True,0,1 user reviews,0,1,1
1339060,True,0,No user reviews,0,0,0
1339080,True,0,2 user reviews,1,1,2
1339120,True,0,No user reviews,0,0,0
1339140,True,0,No user reviews,0,0,0
1339170,True,0,1 user reviews,1,0,1
1339180,True,0,7 user reviews,7,0,7
1339190,True,0,No user reviews,0,0,0
1339200,True,0,No user reviews,0,0,0
1339220,True,0,No user reviews,0,0,0
1339260,True,0,No user reviews,0,0,0
1339270,True,0,No user reviews,0,0,0
1339290,True,0,No user reviews,0,0,0
1339310,True,0,No user reviews,0,0,0
1339330,True,0,No user reviews,0,0,0
1339340,True,0,No user reviews,0,0,0
1339350,True,0,1 user reviews,0,1,1
1339360,True,0,No user reviews,0,0,0
1339370,True,0,1 user reviews,1,0,1
1339380,True,0,5 user reviews,5,0,5
1339390,True,0,No user reviews,0,0,0
1339391,True,0,No user reviews,0,0,0
1339400,True,0,No user reviews,0,0,0
1339410,True,0,No user reviews,0,0,0
1339420,True,0,6 user reviews,5,1,6
1339430,True,0,1 user reviews,1,0,1
1339431,True,0,No user reviews,0,0,0
1339432,True,0,No user reviews,0,0,0
1339450,True,0,No user reviews,0,0,0
1339460,True,0,No user reviews,0,0,0
1339470,True,0,No user reviews,0,0,0
1339490,True,0,No user reviews,0,0,0
1339500,True,0,No user reviews,0,0,0
1339520,True,0,No user reviews,0,0,0
1339530,True,0,No user reviews,0,0,0
1339550,True,0,No user reviews,0,0,0
1339560,True,0,No user reviews,0,0,0
1339580,True,0,No user reviews,0,0,0
1339620,True,0,6 user reviews,6,0,6
1339640,True,0,No user reviews,0,0,0
1339650,True,0,3 user reviews,1,2,3
1339660,True,0,1 user reviews,0,1,1
1339670,True,0,1 user reviews,1,0,1
1339680,True,0,No user reviews,0,0,0
1339700,True,0,No user reviews,0,0,0
1339710,True,0,No user reviews,0,0,0
1339740,True,0,No user reviews,0,0,0
1339750,True,0,No user reviews,0,0,0
1339770,True,0,No user reviews,0,0,0
1339771,True,0,No user reviews,0,0,0
1339790,True,0,5 user reviews,3,2,5
1339800,True,0,No user reviews,0,0,0
1339810,True,0,No user reviews,0,0,0
1339820,True,0,1 user reviews,0,1,1
1339830,True,0,No user reviews,0,0,0
1339850,True,0,5 user reviews,5,0,5
1339860,True,0,No user reviews,0,0,0
1339870,True,0,No user reviews,0,0,0
1339880,True,0,1 user reviews,0,1,1
1339890,True,5,Mixed,13,7,20
1339900,True,7,Positive,39,1,40
1339910,True,0,No user reviews,0,0,0
1339920,True,7,Positive,19,1,20
1339930,True,0,No user reviews,0,0,0
1339940,True,0,No user reviews,0,0,0
1339950,True,0,No user reviews,0,0,0
1339990,True,0,No user reviews,0,0,0
1340020,True,0,1 user reviews,1,0,1
1340030,True,0,No user reviews,0,0,0
1340050,True,0,No user reviews,0,0,0
1340060,True,0,No user reviews,0,0,0
1340070,True,0,No user reviews,0,0,0
1340080,True,0,1 user reviews,1,0,1
1340120,True,8,Very Positive,50,2,52
1340130,True,0,No user reviews,0,0,0
1340160,True,0,No user reviews,0,0,0
1340180,True,0,No user reviews,0,0,0
1340190,True,0,No user reviews,0,0,0
1340210,True,0,No user reviews,0,0,0
1340240,True,0,No user reviews,0,0,0
1340260,True,0,No user reviews,0,0,0
1340270,True,0,No user reviews,0,0,0
1340300,True,0,6 user reviews,5,1,6
1340310,True,0,1 user reviews,1,0,1
1340320,True,0,3 user reviews,3,0,3
1340330,True,0,No user reviews,0,0,0
1340350,True,0,No user reviews,0,0,0
1340351,True,0,No user reviews,0,0,0
1340360,True,0,No user reviews,0,0,0
1340400,True,0,1 user reviews,0,1,1
1340410,True,0,No user reviews,0,0,0
1340420,True,0,2 user reviews,2,0,2
1340440,True,0,1 user reviews,0,1,1
1340461,True,0,No user reviews,0,0,0
1340462,True,0,No user reviews,0,0,0
1340463,True,0,No user reviews,0,0,0
1340464,True,0,No user reviews,0,0,0
1340470,True,0,No user reviews,0,0,0
1340490,True,0,1 user reviews,0,1,1
1340500,True,0,No user reviews,0,0,0
1340510,True,0,No user reviews,0,0,0
1340520,True,0,No user reviews,0,0,0
1340530,True,0,No user reviews,0,0,0
1340540,True,0,1 user reviews,1,0,1
1340570,True,0,8 user reviews,7,1,8
1340590,True,0,No user reviews,0,0,0
1340600,True,0,4 user reviews,2,2,4
1340610,True,0,1 user reviews,1,0,1
1340611,True,0,No user reviews,0,0,0
1340612,True,0,No user reviews,0,0,0
1340613,True,0,No user reviews,0,0,0
1340614,True,0,No user reviews,0,0,0
1340615,True,0,No user reviews,0,0,0
1340616,True,0,No user reviews,0,0,0
1340617,True,0,No user reviews,0,0,0
1340640,True,0,No user reviews,0,0,0
1340670,True,0,No user reviews,0,0,0
1340700,True,0,No user reviews,0,0,0
1340710,True,0,No user reviews,0,0,0
1340740,True,0,No user reviews,0,0,0
1340750,True,0,No user reviews,0,0,0
1340760,True,0,No user reviews,0,0,0
1340770,True,0,1 user reviews,1,0,1
1340810,True,0,No user reviews,0,0,0
1340820,True,0,No user reviews,0,0,0
1340850,True,0,1 user reviews,0,1,1
1340860,True,0,No user reviews,0,0,0
1340870,True,0,4 user reviews,4,0,4
1340880,True,0,No user reviews,0,0,0
1340890,True,0,No user reviews,0,0,0
1340910,True,0,No user reviews,0,0,0
1340940,True,0,2 user reviews,2,0,2
1340950,True,0,No user reviews,0,0,0
1340980,True,0,3 user reviews,3,0,3
1341000,True,0,No user reviews,0,0,0
1341020,True,0,No user reviews,0,0,0
1341050,True,0,No user reviews,0,0,0
1341060,True,0,No user reviews,0,0,0
1341080,True,0,3 user reviews,1,2,3
1341090,True,0,No user reviews,0,0,0
1341100,True,0,1 user reviews,1,0,1
1341140,True,0,No user reviews,0,0,0
1341160,True,7,Positive,17,3,20
1341170,True,0,No user reviews,0,0,0
1341180,True,0,No user reviews,0,0,0
1341190,True,7,Positive,10,1,11
1341220,True,7,Positive,34,1,35
1341230,True,0,No user reviews,0,0,0
1341240,True,0,1 user reviews,1,0,1
1341250,True,0,1 user reviews,1,0,1
1341270,True,0,No user reviews,0,0,0
1341280,True,0,No user reviews,0,0,0
1341330,True,0,No user reviews,0,0,0
1341340,True,0,No user reviews,0,0,0
1341350,True,0,No user reviews,0,0,0
1341351,True,0,No user reviews,0,0,0
1341380,True,0,No user reviews,0,0,0
1341400,True,0,No user reviews,0,0,0
1341410,True,0,No user reviews,0,0,0
1341411,True,0,No user reviews,0,0,0
1341412,True,0,No user reviews,0,0,0
1341413,True,0,No user reviews,0,0,0
1341414,True,0,No user reviews,0,0,0
1341440,True,0,No user reviews,0,0,0
1341450,True,0,No user reviews,0,0,0
1341470,True,0,3 user reviews,3,0,3
1341500,True,0,No user reviews,0,0,0
1341520,True,6,Mostly Positive,51,20,71
1341550,True,0,6 user reviews,2,4,6
1341580,True,0,1 user reviews,1,0,1
1341590,True,0,No user reviews,0,0,0
1341620,True,0,2 user reviews,1,1,2
1341630,True,0,1 user reviews,1,0,1
1341640,True,0,4 user reviews,4,0,4
1341650,True,0,No user reviews,0,0,0
1341660,True,0,2 user reviews,1,1,2
1341690,True,0,No user reviews,0,0,0
1341710,True,0,No user reviews,0,0,0
1341720,True,0,2 user reviews,0,2,2
1341730,True,0,No user reviews,0,0,0
1341740,True,0,No user reviews,0,0,0
1341780,True,0,1 user reviews,1,0,1
1341790,True,0,1 user reviews,1,0,1
1341810,True,0,No user reviews,0,0,0
1341830,True,0,No user reviews,0,0,0
1341860,True,0,No user reviews,0,0,0
1341900,True,0,No user reviews,0,0,0
1341910,True,0,No user reviews,0,0,0
1341920,True,0,No user reviews,0,0,0
1341930,True,7,Positive,10,1,11
1341950,True,0,No user reviews,0,0,0
1341960,True,0,8 user reviews,7,1,8
1341970,True,0,No user reviews,0,0,0
1341980,True,0,No user reviews,0,0,0
1341990,True,0,No user reviews,0,0,0
1342040,True,0,No user reviews,0,0,0
1342050,True,0,No user reviews,0,0,0
1342070,True,0,No user reviews,0,0,0
1342130,True,0,2 user reviews,1,1,2
1342150,True,0,No user reviews,0,0,0
1342160,True,0,No user reviews,0,0,0
1342180,True,0,No user reviews,0,0,0
1342190,True,0,No user reviews,0,0,0
1342210,True,0,No user reviews,0,0,0
1342220,True,0,No user reviews,0,0,0
1342270,True,0,1 user reviews,1,0,1
1342280,True,0,No user reviews,0,0,0
1342290,True,7,Positive,11,0,11
1342330,True,0,No user reviews,0,0,0
1342340,True,0,No user reviews,0,0,0
1342350,True,0,No user reviews,0,0,0
1342360,True,0,No user reviews,0,0,0
1342370,True,0,No user reviews,0,0,0
1342420,True,0,No user reviews,0,0,0
1342440,True,0,No user reviews,0,0,0
1342460,True,0,No user reviews,0,0,0
1342480,True,0,7 user reviews,6,1,7
1342500,True,0,4 user reviews,3,1,4
1342510,True,0,No user reviews,0,0,0
1342540,True,0,No user reviews,0,0,0
1342550,True,0,No user reviews,0,0,0
1342560,True,0,No user reviews,0,0,0
1342570,True,0,No user reviews,0,0,0
1342580,True,0,No user reviews,0,0,0
1342600,True,0,2 user reviews,2,0,2
1342610,True,0,No user reviews,0,0,0
1342620,True,8,Very Positive,118,13,131
1342640,True,0,No user reviews,0,0,0
1342670,True,0,No user reviews,0,0,0
1342680,True,0,No user reviews,0,0,0
1342710,True,0,No user reviews,0,0,0
1342711,True,0,No user reviews,0,0,0
1342712,True,0,No user reviews,0,0,0
1342713,True,0,No user reviews,0,0,0
1342720,True,0,No user reviews,0,0,0
1342730,True,0,4 user reviews,4,0,4
1342740,True,7,Positive,42,0,42
1342760,True,0,No user reviews,0,0,0
1342770,True,0,No user reviews,0,0,0
1342780,True,0,No user reviews,0,0,0
1342790,True,0,No user reviews,0,0,0
1342830,True,0,No user reviews,0,0,0
1342831,True,0,No user reviews,0,0,0
1342840,True,0,No user reviews,0,0,0
1342850,True,7,Positive,15,1,16
1342870,True,0,No user reviews,0,0,0
1342880,True,0,No user reviews,0,0,0
1342881,True,0,No user reviews,0,0,0
1342882,True,0,No user reviews,0,0,0
1342883,True,0,No user reviews,0,0,0
1342890,True,0,No user reviews,0,0,0
1342900,True,0,No user reviews,0,0,0
1342910,True,0,No user reviews,0,0,0
1342940,True,0,No user reviews,0,0,0
1342950,True,0,No user reviews,0,0,0
1342980,True,0,No user reviews,0,0,0
1343000,True,0,No user reviews,0,0,0
1343050,True,0,No user reviews,0,0,0
1343060,True,0,No user reviews,0,0,0
1343090,True,7,Positive,17,0,17
1343100,True,0,No user reviews,0,0,0
1343110,True,0,No user reviews,0,0,0
1343130,True,0,8 user reviews,8,0,8
1343140,True,0,No user reviews,0,0,0
1343150,True,7,Positive,12,3,15
1343160,True,0,No user reviews,0,0,0
1343161,True,0,No user reviews,0,0,0
1343170,True,0,No user reviews,0,0,0
1343180,True,0,No user reviews,0,0,0
1343181,True,0,No user reviews,0,0,0
1343182,True,0,No user reviews,0,0,0
1343220,True,0,6 user reviews,6,0,6
1343250,True,0,2 user reviews,2,0,2
1343260,True,7,Positive,11,0,11
1343310,True,0,1 user reviews,1,0,1
1343320,True,0,6 user reviews,6,0,6
1343330,True,0,1 user reviews,0,1,1
1343340,True,0,No user reviews,0,0,0
1343360,True,0,No user reviews,0,0,0
1343390,True,0,2 user reviews,2,0,2
1343400,True,7,Positive,9,2,11
1343410,True,0,1 user reviews,1,0,1
1343450,True,0,No user reviews,0,0,0
1343490,True,0,No user reviews,0,0,0
1343500,True,6,Mostly Positive,263,88,351
1343510,True,0,No user reviews,0,0,0
1343520,True,0,No user reviews,0,0,0
1343530,True,0,No user reviews,0,0,0
1343540,True,0,No user reviews,0,0,0
1343550,True,0,3 user reviews,3,0,3
1343580,True,0,1 user reviews,0,1,1
1343612,True,5,Mixed,253,145,398
1343620,True,0,No user reviews,0,0,0
1343640,True,0,No user reviews,0,0,0
1343650,True,0,No user reviews,0,0,0
1343660,True,0,1 user reviews,1,0,1
1343670,True,0,No user reviews,0,0,0
1343680,True,0,No user reviews,0,0,0
1343690,True,0,No user reviews,0,0,0
1343700,True,0,3 user reviews,3,0,3
1343750,True,0,No user reviews,0,0,0
1343760,True,0,No user reviews,0,0,0
1343770,True,7,Positive,16,4,20
1343780,True,0,No user reviews,0,0,0
1343790,True,0,No user reviews,0,0,0
1343800,True,0,No user reviews,0,0,0
1343830,True,0,No user reviews,0,0,0
1343840,True,0,No user reviews,0,0,0
1343850,True,0,2 user reviews,1,1,2
1343860,True,0,No user reviews,0,0,0
1343880,True,0,No user reviews,0,0,0
1343920,True,7,Positive,14,3,17
1343970,True,0,No user reviews,0,0,0
1343980,True,0,No user reviews,0,0,0
1343990,True,0,3 user reviews,3,0,3
1344000,True,0,No user reviews,0,0,0
1344040,True,0,No user reviews,0,0,0
1344050,True,0,2 user reviews,2,0,2
1344060,True,0,No user reviews,0,0,0
1344070,True,0,4 user reviews,3,1,4
1344100,True,0,No user reviews,0,0,0
1344110,True,0,2 user reviews,1,1,2
1344120,True,0,No user reviews,0,0,0
1344140,True,0,1 user reviews,1,0,1
1344160,True,0,No user reviews,0,0,0
1344170,True,0,No user reviews,0,0,0
1344190,True,0,No user reviews,0,0,0
1344191,True,0,No user reviews,0,0,0
1344192,True,0,No user reviews,0,0,0
1344193,True,0,No user reviews,0,0,0
1344194,True,0,No user reviews,0,0,0
1344280,True,0,No user reviews,0,0,0
1344310,True,0,6 user reviews,4,2,6
1344320,True,0,No user reviews,0,0,0
1344350,True,0,No user reviews,0,0,0
1344420,True,0,No user reviews,0,0,0
1344430,True,0,No user reviews,0,0,0
1344440,True,0,4 user reviews,4,0,4
1344450,True,0,2 user reviews,2,0,2
1344500,True,0,No user reviews,0,0,0
1344520,True,0,2 user reviews,1,1,2
1344530,True,8,Very Positive,56,9,65
1344560,True,0,No user reviews,0,0,0
1344570,True,0,No user reviews,0,0,0
1344580,True,0,1 user reviews,0,1,1
1344600,True,0,1 user reviews,1,0,1
1344610,True,0,No user reviews,0,0,0
1344620,True,0,1 user reviews,1,0,1
1344630,True,0,1 user reviews,0,1,1
1344660,True,0,No user reviews,0,0,0
1344680,True,6,Mostly Positive,176,61,237
1344690,True,0,No user reviews,0,0,0
1344700,True,0,No user reviews,0,0,0
1344740,True,8,Very Positive,79,3,82
1344760,True,0,1 user reviews,1,0,1
1344780,True,0,No user reviews,0,0,0
1344790,True,0,No user reviews,0,0,0
1344800,True,0,No user reviews,0,0,0
1344810,True,0,No user reviews,0,0,0
1344820,True,0,No user reviews,0,0,0
1344830,True,0,1 user reviews,1,0,1
1344840,True,0,No user reviews,0,0,0
1344850,True,0,No user reviews,0,0,0
1344860,True,0,No user reviews,0,0,0
1344870,True,0,3 user reviews,1,2,3
1344880,True,0,No user reviews,0,0,0
1344890,True,0,No user reviews,0,0,0
1344900,True,0,No user reviews,0,0,0
1344930,True,0,No user reviews,0,0,0
1344950,True,0,No user reviews,0,0,0
1344970,True,0,No user reviews,0,0,0
1344980,True,0,No user reviews,0,0,0
1344990,True,0,No user reviews,0,0,0
1345040,True,7,Positive,14,1,15
1345050,True,0,No user reviews,0,0,0
1345060,True,0,No user reviews,0,0,0
1345070,True,0,No user reviews,0,0,0
1345080,True,0,No user reviews,0,0,0
1345110,True,0,No user reviews,0,0,0
1345120,True,0,4 user reviews,3,1,4
1345140,True,0,No user reviews,0,0,0
1345150,True,0,2 user reviews,1,1,2
1345190,True,0,3 user reviews,3,0,3
1345200,True,0,1 user reviews,1,0,1
1345220,True,0,3 user reviews,3,0,3
1345230,True,0,No user reviews,0,0,0
1345231,True,0,No user reviews,0,0,0
1345232,True,0,No user reviews,0,0,0
1345233,True,0,No user reviews,0,0,0
1345240,True,0,1 user reviews,1,0,1
1345280,True,0,No user reviews,0,0,0
1345300,True,0,No user reviews,0,0,0
1345310,True,0,No user reviews,0,0,0
1345320,True,0,No user reviews,0,0,0
1345340,True,0,No user reviews,0,0,0
1345350,True,0,6 user reviews,6,0,6
1345360,True,0,5 user reviews,3,2,5
1345370,True,7,Positive,18,2,20
1345380,True,5,Mixed,12,8,20
1345400,True,0,No user reviews,0,0,0
1345430,True,0,No user reviews,0,0,0
1345440,True,0,No user reviews,0,0,0
1345450,True,0,No user reviews,0,0,0
1345470,True,7,Positive,25,0,25
1345500,True,0,No user reviews,0,0,0
1345510,True,0,No user reviews,0,0,0
1345560,True,0,No user reviews,0,0,0
1345580,True,0,No user reviews,0,0,0
1345610,True,0,2 user reviews,2,0,2
1345620,True,0,No user reviews,0,0,0
1345630,True,0,No user reviews,0,0,0
1345720,True,0,No user reviews,0,0,0
1345740,True,0,No user reviews,0,0,0
1345750,True,0,1 user reviews,1,0,1
1345770,True,0,3 user reviews,1,2,3
1345780,True,0,No user reviews,0,0,0
1345790,True,0,No user reviews,0,0,0
1345800,True,7,Positive,13,0,13
1345810,True,0,No user reviews,0,0,0
1345820,True,0,No user reviews,0,0,0
1345830,True,0,1 user reviews,0,1,1
1345840,True,0,No user reviews,0,0,0
1345920,True,0,No user reviews,0,0,0
1345950,True,0,9 user reviews,9,0,9
1345960,True,0,2 user reviews,2,0,2
1345961,True,0,No user reviews,0,0,0
1345962,True,0,No user reviews,0,0,0
1345970,True,0,No user reviews,0,0,0
1345980,True,0,1 user reviews,1,0,1
1345990,True,5,Mixed,87,67,154
1346030,True,0,No user reviews,0,0,0
1346040,True,0,No user reviews,0,0,0
1346050,True,0,No user reviews,0,0,0
1346060,True,0,No user reviews,0,0,0
1346070,True,5,Mixed,57,50,107
1346080,True,0,No user reviews,0,0,0
1346090,True,7,Positive,17,4,21
1346100,True,0,No user reviews,0,0,0
1346110,True,0,3 user reviews,3,0,3
1346120,True,0,3 user reviews,1,2,3
1346130,True,0,1 user reviews,0,1,1
1346140,True,0,No user reviews,0,0,0
1346150,True,0,No user reviews,0,0,0
1346160,True,0,No user reviews,0,0,0
1346170,True,0,2 user reviews,1,1,2
1346210,True,0,No user reviews,0,0,0
1346220,True,0,No user reviews,0,0,0
1346240,True,7,Positive,19,2,21
1346250,True,0,7 user reviews,7,0,7
1346260,True,0,6 user reviews,4,2,6
1346270,True,0,7 user reviews,5,2,7
1346280,True,0,No user reviews,0,0,0
1346290,True,0,No user reviews,0,0,0
1346300,True,0,No user reviews,0,0,0
1346310,True,0,No user reviews,0,0,0
1346330,True,0,No user reviews,0,0,0
1346350,True,0,No user reviews,0,0,0
1346400,True,0,9 user reviews,7,2,9
1346420,True,0,No user reviews,0,0,0
1346430,True,0,No user reviews,0,0,0
1346490,True,0,No user reviews,0,0,0
1346500,True,0,1 user reviews,1,0,1
1346510,True,0,1 user reviews,1,0,1
1346520,True,0,2 user reviews,2,0,2
1346540,True,0,1 user reviews,1,0,1
1346541,True,0,4 user reviews,3,1,4
1346580,True,0,No user reviews,0,0,0
1346590,True,0,2 user reviews,2,0,2
1346600,True,0,5 user reviews,5,0,5
1346620,True,0,No user reviews,0,0,0
1346630,True,0,7 user reviews,7,0,7
1346640,True,0,No user reviews,0,0,0
1346660,True,0,No user reviews,0,0,0
1346680,True,0,2 user reviews,1,1,2
1346700,True,0,No user reviews,0,0,0
1346730,True,0,No user reviews,0,0,0
1346760,True,0,No user reviews,0,0,0
1346790,True,0,No user reviews,0,0,0
1346800,True,0,7 user reviews,6,1,7
1346810,True,0,No user reviews,0,0,0
1346820,True,0,No user reviews,0,0,0
1346850,True,0,No user reviews,0,0,0
1346860,True,0,1 user reviews,0,1,1
1346870,True,0,1 user reviews,0,1,1
1346880,True,0,No user reviews,0,0,0
1346890,True,0,8 user reviews,5,3,8
1346910,True,0,No user reviews,0,0,0
1346920,True,0,No user reviews,0,0,0
1346930,True,0,1 user reviews,1,0,1
1346960,True,7,Positive,19,3,22
1346970,True,6,Mostly Positive,16,6,22
1346980,True,7,Positive,33,1,34
1347010,True,0,No user reviews,0,0,0
1347070,True,0,No user reviews,0,0,0
1347090,True,6,Mostly Positive,8,3,11
1347100,True,0,No user reviews,0,0,0
1347110,True,0,No user reviews,0,0,0
1347130,True,0,No user reviews,0,0,0
1347140,True,0,No user reviews,0,0,0
1347170,True,0,2 user reviews,2,0,2
1347270,True,0,1 user reviews,1,0,1
1347280,True,0,No user reviews,0,0,0
1347310,True,0,No user reviews,0,0,0
1347340,True,0,No user reviews,0,0,0
1347341,True,0,No user reviews,0,0,0
1347350,True,0,3 user reviews,2,1,3
1347360,True,0,No user reviews,0,0,0
1347370,True,0,No user reviews,0,0,0
1347390,True,0,No user reviews,0,0,0
1347420,True,7,Positive,17,3,20
1347430,True,8,Very Positive,172,34,206
1347450,True,0,1 user reviews,1,0,1
1347460,True,0,1 user reviews,1,0,1
1347490,True,0,No user reviews,0,0,0
1347520,True,0,No user reviews,0,0,0
1347540,True,0,No user reviews,0,0,0
1347580,True,0,No user reviews,0,0,0
1347590,True,0,No user reviews,0,0,0
1347610,True,0,4 user reviews,4,0,4
1347611,True,0,2 user reviews,1,1,2
1347630,True,0,No user reviews,0,0,0
1347640,True,0,3 user reviews,3,0,3
1347690,True,0,No user reviews,0,0,0
1347700,True,0,No user reviews,0,0,0
1347720,True,0,4 user reviews,3,1,4
1347740,True,0,No user reviews,0,0,0
1347750,True,5,Mixed,64,48,112
1347751,True,7,Positive,43,3,46
1347780,True,8,Very Positive,293,11,304
1347800,True,5,Mixed,24,21,45
1347810,True,0,No user reviews,0,0,0
1347830,True,0,No user reviews,0,0,0
1347870,True,0,No user reviews,0,0,0
1347880,True,0,8 user reviews,8,0,8
1347890,True,0,No user reviews,0,0,0
1347910,True,0,No user reviews,0,0,0
1347920,True,0,No user reviews,0,0,0
1347930,True,0,No user reviews,0,0,0
1347960,True,0,No user reviews,0,0,0
1347970,True,0,No user reviews,0,0,0
1347980,True,0,No user reviews,0,0,0
1347990,True,0,No user reviews,0,0,0
1348010,True,0,No user reviews,0,0,0
1348020,True,0,No user reviews,0,0,0
1348030,True,0,2 user reviews,1,1,2
1348040,True,0,No user reviews,0,0,0
1348060,True,0,No user reviews,0,0,0
1348140,True,0,7 user reviews,7,0,7
1348150,True,0,No user reviews,0,0,0
1348160,True,7,Positive,14,0,14
1348180,True,0,No user reviews,0,0,0
1348190,True,0,No user reviews,0,0,0
1348210,True,0,No user reviews,0,0,0
1348220,True,0,No user reviews,0,0,0
1348240,True,0,3 user reviews,3,0,3
1348250,True,0,No user reviews,0,0,0
1348260,True,0,No user reviews,0,0,0
1348270,True,7,Positive,16,1,17
1348300,True,0,4 user reviews,3,1,4
1348310,True,0,No user reviews,0,0,0
1348330,True,0,No user reviews,0,0,0
1348380,True,0,2 user reviews,1,1,2
1348390,True,6,Mostly Positive,8,3,11
1348400,True,0,4 user reviews,4,0,4
1348420,True,0,No user reviews,0,0,0
1348430,True,0,1 user reviews,1,0,1
1348440,True,0,No user reviews,0,0,0
1348470,True,0,1 user reviews,1,0,1
1348480,True,0,No user reviews,0,0,0
1348500,True,0,No user reviews,0,0,0
1348510,True,0,No user reviews,0,0,0
1348520,True,0,No user reviews,0,0,0
1348580,True,0,No user reviews,0,0,0
1348590,True,0,No user reviews,0,0,0
1348600,True,0,No user reviews,0,0,0
1348650,True,0,No user reviews,0,0,0
1348660,True,5,Mixed,258,272,530
1348670,True,5,Mixed,6,6,12
1348680,True,0,No user reviews,0,0,0
1348700,True,0,No user reviews,0,0,0
1348720,True,0,No user reviews,0,0,0
1348740,True,0,No user reviews,0,0,0
1348750,True,0,No user reviews,0,0,0
1348770,True,0,No user reviews,0,0,0
1348780,True,0,No user reviews,0,0,0
1348800,True,0,No user reviews,0,0,0
1348810,True,0,No user reviews,0,0,0
1348850,True,0,No user reviews,0,0,0
1348880,True,0,7 user reviews,0,7,7
1348920,True,6,Mostly Positive,14,4,18
1348930,True,0,No user reviews,0,0,0
1348940,True,0,No user reviews,0,0,0
1348960,True,0,1 user reviews,1,0,1
1348970,True,0,No user reviews,0,0,0
1348980,True,0,5 user reviews,5,0,5
1348990,True,0,No user reviews,0,0,0
1349000,True,0,4 user reviews,4,0,4
1349010,True,0,5 user reviews,5,0,5
1349060,True,7,Positive,21,0,21
1349070,True,0,No user reviews,0,0,0
1349100,True,0,No user reviews,0,0,0
1349120,True,0,No user reviews,0,0,0
1349130,True,0,4 user reviews,4,0,4
1349170,True,0,No user reviews,0,0,0
1349180,True,0,No user reviews,0,0,0
1349230,True,9,Overwhelmingly Positive,973,37,1010
1349240,True,0,No user reviews,0,0,0
1349250,True,0,No user reviews,0,0,0
1349290,True,0,No user reviews,0,0,0
1349300,True,0,No user reviews,0,0,0
1349310,True,0,No user reviews,0,0,0
1349330,True,0,No user reviews,0,0,0
1349340,True,0,No user reviews,0,0,0
1349350,True,0,No user reviews,0,0,0
1349360,True,0,No user reviews,0,0,0
1349370,True,0,No user reviews,0,0,0
1349380,True,0,No user reviews,0,0,0
1349390,True,0,4 user reviews,4,0,4
1349400,True,5,Mixed,42,21,63
1349420,True,0,No user reviews,0,0,0
1349460,True,0,No user reviews,0,0,0
1349480,True,0,No user reviews,0,0,0
1349490,True,0,No user reviews,0,0,0
1349491,True,0,1 user reviews,1,0,1
1349492,True,0,No user reviews,0,0,0
1349520,True,0,No user reviews,0,0,0
1349521,True,0,No user reviews,0,0,0
1349522,True,0,No user reviews,0,0,0
1349523,True,0,No user reviews,0,0,0
1349540,True,0,No user reviews,0,0,0
1349580,True,0,No user reviews,0,0,0
1349600,True,0,No user reviews,0,0,0
1349620,True,0,No user reviews,0,0,0
1349640,True,0,No user reviews,0,0,0
1349680,True,0,No user reviews,0,0,0
1349700,True,0,No user reviews,0,0,0
1349710,True,7,Positive,19,1,20
1349720,True,0,2 user reviews,0,2,2
1349730,True,0,No user reviews,0,0,0
1349740,True,0,3 user reviews,0,3,3
1349760,True,0,No user reviews,0,0,0
1349790,True,0,1 user reviews,1,0,1
1349820,True,0,No user reviews,0,0,0
1349830,True,0,No user reviews,0,0,0
1349840,True,0,No user reviews,0,0,0
1349860,True,0,No user reviews,0,0,0
1349890,True,0,No user reviews,0,0,0
1349900,True,0,No user reviews,0,0,0
1349910,True,0,No user reviews,0,0,0
1349920,True,0,No user reviews,0,0,0
1349940,True,0,4 user reviews,4,0,4
1349960,True,7,Positive,27,5,32
1349970,True,0,No user reviews,0,0,0
1350010,True,0,1 user reviews,0,1,1
1350030,True,0,No user reviews,0,0,0
1350040,True,0,1 user reviews,1,0,1
1350050,True,0,No user reviews,0,0,0
1350060,True,0,1 user reviews,0,1,1
1350080,True,0,No user reviews,0,0,0
1350120,True,0,No user reviews,0,0,0
1350130,True,0,No user reviews,0,0,0
1350170,True,0,1 user reviews,0,1,1
1350200,True,0,No user reviews,0,0,0
1350210,True,0,No user reviews,0,0,0
1350280,True,0,3 user reviews,3,0,3
1350300,True,0,1 user reviews,1,0,1
1350340,True,7,Positive,22,3,25
1350350,True,0,No user reviews,0,0,0
1350390,True,0,No user reviews,0,0,0
1350400,True,0,No user reviews,0,0,0
1350420,True,0,No user reviews,0,0,0
1350430,True,0,No user reviews,0,0,0
1350460,True,0,No user reviews,0,0,0
1350470,True,0,No user reviews,0,0,0
1350480,True,0,2 user reviews,1,1,2
1350500,True,0,No user reviews,0,0,0
1350530,True,0,No user reviews,0,0,0
1350540,True,0,3 user reviews,3,0,3
1350560,True,0,1 user reviews,1,0,1
1350570,True,0,5 user reviews,5,0,5
1350580,True,0,No user reviews,0,0,0
1350590,True,0,No user reviews,0,0,0
1350600,True,0,No user reviews,0,0,0
1350601,True,0,No user reviews,0,0,0
1350602,True,0,No user reviews,0,0,0
1350603,True,0,No user reviews,0,0,0
1350604,True,0,No user reviews,0,0,0
1350610,True,0,No user reviews,0,0,0
1350630,True,0,No user reviews,0,0,0
1350640,True,0,No user reviews,0,0,0
1350660,True,0,1 user reviews,1,0,1
1350680,True,0,No user reviews,0,0,0
1350700,True,0,No user reviews,0,0,0
1350710,True,0,No user reviews,0,0,0
1350750,True,0,No user reviews,0,0,0
1350780,True,0,No user reviews,0,0,0
1350800,True,0,1 user reviews,0,1,1
1350820,True,0,No user reviews,0,0,0
1350830,True,0,No user reviews,0,0,0
1350850,True,0,1 user reviews,1,0,1
1350860,True,0,No user reviews,0,0,0
1350870,True,0,No user reviews,0,0,0
1350880,True,0,No user reviews,0,0,0
1350900,True,0,No user reviews,0,0,0
1350910,True,0,No user reviews,0,0,0
1350920,True,0,1 user reviews,1,0,1
1350930,True,0,No user reviews,0,0,0
1350940,True,0,No user reviews,0,0,0
1350960,True,0,No user reviews,0,0,0
1350970,True,0,No user reviews,0,0,0
1350980,True,0,No user reviews,0,0,0
1350990,True,0,3 user reviews,2,1,3
1351010,True,0,8 user reviews,6,2,8
1351020,True,0,3 user reviews,2,1,3
1351030,True,0,3 user reviews,2,1,3
1351060,True,8,Very Positive,55,7,62
1351070,True,0,No user reviews,0,0,0
1351080,True,0,No user reviews,0,0,0
1351100,True,0,1 user reviews,1,0,1
1351120,True,0,No user reviews,0,0,0
1351140,True,0,No user reviews,0,0,0
1351170,True,0,No user reviews,0,0,0
1351180,True,0,No user reviews,0,0,0
1351200,True,0,No user reviews,0,0,0
1351220,True,0,2 user reviews,1,1,2
1351230,True,0,No user reviews,0,0,0
1351250,True,0,No user reviews,0,0,0
1351260,True,0,6 user reviews,5,1,6
1351261,True,5,Mixed,18,12,30
1351270,True,0,1 user reviews,0,1,1
1351271,True,0,1 user reviews,0,1,1
1351280,True,0,No user reviews,0,0,0
1351290,True,0,1 user reviews,0,1,1
1351300,True,0,1 user reviews,1,0,1
1351310,True,0,1 user reviews,1,0,1
1351320,True,0,No user reviews,0,0,0
1351350,True,0,4 user reviews,4,0,4
1351360,True,7,Positive,12,1,13
1351370,True,0,4 user reviews,2,2,4
1351390,True,0,8 user reviews,8,0,8
1351400,True,7,Positive,11,0,11
1351420,True,0,No user reviews,0,0,0
1351450,True,5,Mixed,18,8,26
1351480,True,0,No user reviews,0,0,0
1351500,True,0,No user reviews,0,0,0
1351550,True,0,3 user reviews,3,0,3
1351560,True,0,3 user reviews,3,0,3
1351600,True,0,No user reviews,0,0,0
1351601,True,0,No user reviews,0,0,0
1351602,True,0,No user reviews,0,0,0
1351603,True,0,No user reviews,0,0,0
1351604,True,0,No user reviews,0,0,0
1351610,True,0,No user reviews,0,0,0
1351630,True,0,No user reviews,0,0,0
1351650,True,0,1 user reviews,1,0,1
1351670,True,0,No user reviews,0,0,0
1351710,True,0,No user reviews,0,0,0
1351720,True,0,1 user reviews,1,0,1
1351760,True,0,No user reviews,0,0,0
1351790,True,0,No user reviews,0,0,0
1351810,True,0,7 user reviews,7,0,7
1351820,True,0,6 user reviews,6,0,6
1351830,True,7,Positive,9,2,11
1351840,True,0,No user reviews,0,0,0
1351860,True,0,9 user reviews,8,1,9
1351861,True,0,2 user reviews,2,0,2
1351870,True,0,No user reviews,0,0,0
1351880,True,0,4 user reviews,1,3,4
1351900,True,7,Positive,17,0,17
1351910,True,0,No user reviews,0,0,0
1351920,True,0,No user reviews,0,0,0
1351940,True,0,No user reviews,0,0,0
1351950,True,7,Positive,18,4,22
1351960,True,0,2 user reviews,2,0,2
1351970,True,0,6 user reviews,5,1,6
1351980,True,0,1 user reviews,1,0,1
1351990,True,0,1 user reviews,0,1,1
1352000,True,0,1 user reviews,0,1,1
1352010,True,0,1 user reviews,0,1,1
1352020,True,7,Positive,24,0,24
1352030,True,0,8 user reviews,8,0,8
1352040,True,0,No user reviews,0,0,0
1352050,True,0,No user reviews,0,0,0
1352070,True,0,No user reviews,0,0,0
1352110,True,0,No user reviews,0,0,0
1352130,True,0,2 user reviews,2,0,2
1352160,True,0,No user reviews,0,0,0
1352170,True,0,No user reviews,0,0,0
1352171,True,0,No user reviews,0,0,0
1352172,True,0,No user reviews,0,0,0
1352173,True,0,No user reviews,0,0,0
1352200,True,0,No user reviews,0,0,0
1352230,True,0,No user reviews,0,0,0
1352300,True,0,No user reviews,0,0,0
1352320,True,0,No user reviews,0,0,0
1352330,True,0,No user reviews,0,0,0
1352340,True,0,No user reviews,0,0,0
1352360,True,0,No user reviews,0,0,0
1352380,True,0,No user reviews,0,0,0
1352390,True,0,No user reviews,0,0,0
1352440,True,0,No user reviews,0,0,0
1352450,True,0,No user reviews,0,0,0
1352470,True,0,No user reviews,0,0,0
1352480,True,0,No user reviews,0,0,0
1352520,True,0,No user reviews,0,0,0
1352530,True,0,No user reviews,0,0,0
1352550,True,0,No user reviews,0,0,0
1352560,True,0,No user reviews,0,0,0
1352581,True,0,7 user reviews,5,2,7
1352582,True,0,5 user reviews,5,0,5
1352583,True,0,9 user reviews,2,7,9
1352584,True,0,5 user reviews,5,0,5
1352590,True,0,1 user reviews,1,0,1
1352640,True,0,No user reviews,0,0,0
1352650,True,0,No user reviews,0,0,0
1352680,True,7,Positive,10,2,12
1352690,True,0,No user reviews,0,0,0
1352720,True,0,No user reviews,0,0,0
1352721,True,0,No user reviews,0,0,0
1352740,True,0,No user reviews,0,0,0
1352750,True,0,No user reviews,0,0,0
1352760,True,0,No user reviews,0,0,0
1352770,True,0,No user reviews,0,0,0
1352780,True,0,No user reviews,0,0,0
1352850,True,0,No user reviews,0,0,0
1352870,True,0,No user reviews,0,0,0
1352880,True,0,No user reviews,0,0,0
1352910,True,0,No user reviews,0,0,0
1352930,True,7,Positive,16,1,17
1352940,True,0,1 user reviews,1,0,1
1352980,True,0,No user reviews,0,0,0
1352990,True,0,No user reviews,0,0,0
1353000,True,0,No user reviews,0,0,0
1353040,True,0,No user reviews,0,0,0
1353050,True,0,1 user reviews,1,0,1
1353060,True,8,Very Positive,217,9,226
1353070,True,0,1 user reviews,1,0,1
1353080,True,7,Positive,12,2,14
1353100,True,0,No user reviews,0,0,0
1353110,True,0,No user reviews,0,0,0
1353120,True,7,Positive,14,0,14
1353130,True,0,1 user reviews,0,1,1
1353140,True,0,No user reviews,0,0,0
1353150,True,0,No user reviews,0,0,0
1353160,True,0,No user reviews,0,0,0
1353170,True,7,Positive,16,1,17
1353180,True,0,2 user reviews,1,1,2
1353210,True,0,No user reviews,0,0,0
1353230,True,0,No user reviews,0,0,0
1353250,True,0,No user reviews,0,0,0
1353260,True,0,No user reviews,0,0,0
1353270,True,0,No user reviews,0,0,0
1353290,True,0,No user reviews,0,0,0
1353300,True,5,Mixed,18,8,26
1353310,True,0,No user reviews,0,0,0
1353320,True,0,No user reviews,0,0,0
1353340,True,0,No user reviews,0,0,0
1353350,True,0,No user reviews,0,0,0
1353370,True,0,No user reviews,0,0,0
1353380,True,0,No user reviews,0,0,0
1353420,True,8,Very Positive,62,9,71
1353470,True,0,1 user reviews,1,0,1
1353480,True,0,No user reviews,0,0,0
1353490,True,0,No user reviews,0,0,0
1353520,True,7,Positive,29,0,29
1353521,True,8,Very Positive,46,4,50
1353540,True,0,No user reviews,0,0,0
1353550,True,0,2 user reviews,2,0,2
1353560,True,0,2 user reviews,2,0,2
1353600,True,0,No user reviews,0,0,0
1353630,True,0,No user reviews,0,0,0
1353650,True,0,No user reviews,0,0,0
1353660,True,0,No user reviews,0,0,0
1353670,True,0,No user reviews,0,0,0
1353680,True,0,No user reviews,0,0,0
1353690,True,0,1 user reviews,1,0,1
1353700,True,0,No user reviews,0,0,0
1353701,True,0,No user reviews,0,0,0
1353710,True,0,1 user reviews,1,0,1
1353730,True,0,No user reviews,0,0,0
1353750,True,0,No user reviews,0,0,0
1353770,True,0,1 user reviews,1,0,1
1353780,True,0,No user reviews,0,0,0
1353790,True,0,No user reviews,0,0,0
1353810,True,0,No user reviews,0,0,0
1353830,True,0,No user reviews,0,0,0
1353840,True,0,No user reviews,0,0,0
1353850,True,0,No user reviews,0,0,0
1353860,True,0,No user reviews,0,0,0
1353870,True,0,1 user reviews,0,1,1
1353880,True,0,1 user reviews,0,1,1
1353900,True,0,9 user reviews,7,2,9
1353920,True,0,No user reviews,0,0,0
1353950,True,0,No user reviews,0,0,0
1353960,True,0,No user reviews,0,0,0
1353980,True,0,3 user reviews,3,0,3
1353990,True,0,1 user reviews,1,0,1
1354000,True,0,1 user reviews,0,1,1
1354010,True,0,4 user reviews,4,0,4
1354020,True,0,No user reviews,0,0,0
1354030,True,0,No user reviews,0,0,0
1354070,True,0,No user reviews,0,0,0
1354080,True,0,2 user reviews,1,1,2
1354100,True,0,6 user reviews,6,0,6
1354110,True,0,1 user reviews,0,1,1
1354111,True,0,No user reviews,0,0,0
1354120,True,0,1 user reviews,1,0,1
1354130,True,0,No user reviews,0,0,0
1354160,True,0,No user reviews,0,0,0
1354200,True,0,No user reviews,0,0,0
1354220,True,0,No user reviews,0,0,0
1354230,True,0,No user reviews,0,0,0
1354240,True,0,No user reviews,0,0,0
1354250,True,0,1 user reviews,1,0,1
1354280,True,0,No user reviews,0,0,0
1354290,True,0,No user reviews,0,0,0
1354300,True,0,No user reviews,0,0,0
1354310,True,0,No user reviews,0,0,0
1354312,True,0,No user reviews,0,0,0
1354320,True,0,No user reviews,0,0,0
1354350,True,0,No user reviews,0,0,0
1354370,True,0,No user reviews,0,0,0
1354380,True,0,No user reviews,0,0,0
1354410,True,0,1 user reviews,0,1,1
1354420,True,0,No user reviews,0,0,0
1354430,True,0,No user reviews,0,0,0
1354431,True,0,No user reviews,0,0,0
1354460,True,0,No user reviews,0,0,0
1354510,True,0,2 user reviews,2,0,2
1354520,True,0,5 user reviews,3,2,5
1354540,True,0,No user reviews,0,0,0
1354560,True,0,No user reviews,0,0,0
1354561,True,0,No user reviews,0,0,0
1354580,True,0,1 user reviews,1,0,1
1354600,True,0,1 user reviews,1,0,1
1354620,True,0,No user reviews,0,0,0
1354630,True,0,No user reviews,0,0,0
1354631,True,0,No user reviews,0,0,0
1354650,True,0,No user reviews,0,0,0
1354670,True,0,No user reviews,0,0,0
1354690,True,0,No user reviews,0,0,0
1354740,True,0,No user reviews,0,0,0
1354741,True,0,No user reviews,0,0,0
1354750,True,0,2 user reviews,2,0,2
1354760,True,7,Positive,21,4,25
1354770,True,0,No user reviews,0,0,0
1354780,True,0,No user reviews,0,0,0
1354790,True,0,1 user reviews,1,0,1
1354800,True,0,No user reviews,0,0,0
1354810,True,0,No user reviews,0,0,0
1354811,True,0,No user reviews,0,0,0
1354812,True,0,No user reviews,0,0,0
1354813,True,0,No user reviews,0,0,0
1354814,True,0,No user reviews,0,0,0
1354815,True,0,No user reviews,0,0,0
1354816,True,0,1 user reviews,1,0,1
1354817,True,0,No user reviews,0,0,0
1354818,True,0,No user reviews,0,0,0
1354819,True,0,1 user reviews,1,0,1
1354830,True,0,No user reviews,0,0,0
1354840,True,0,No user reviews,0,0,0
1354860,True,0,No user reviews,0,0,0
1354861,True,0,No user reviews,0,0,0
1354862,True,0,No user reviews,0,0,0
1354870,True,0,No user reviews,0,0,0
1354880,True,0,No user reviews,0,0,0
1354910,True,0,No user reviews,0,0,0
1354950,True,0,No user reviews,0,0,0
1354960,True,6,Mostly Positive,19,7,26
1354970,True,0,No user reviews,0,0,0
1354990,True,0,No user reviews,0,0,0
1355010,True,0,2 user reviews,1,1,2
1355040,True,0,No user reviews,0,0,0
1355050,True,0,No user reviews,0,0,0
1355060,True,0,No user reviews,0,0,0
1355070,True,0,No user reviews,0,0,0
1355080,True,0,No user reviews,0,0,0
1355130,True,0,No user reviews,0,0,0
1355140,True,7,Positive,8,2,10
1355150,True,0,No user reviews,0,0,0
1355151,True,0,2 user reviews,2,0,2
1355160,True,0,No user reviews,0,0,0
1355180,True,0,No user reviews,0,0,0
1355210,True,0,No user reviews,0,0,0
1355230,True,0,No user reviews,0,0,0
1355240,True,0,No user reviews,0,0,0
1355270,True,0,No user reviews,0,0,0
1355280,True,0,No user reviews,0,0,0
1355281,True,0,No user reviews,0,0,0
1355282,True,0,No user reviews,0,0,0
1355283,True,0,No user reviews,0,0,0
1355290,True,0,No user reviews,0,0,0
1355300,True,0,2 user reviews,1,1,2
1355310,True,0,6 user reviews,6,0,6
1355360,True,0,No user reviews,0,0,0
1355370,True,0,7 user reviews,6,1,7
1355390,True,0,No user reviews,0,0,0
1355400,True,0,No user reviews,0,0,0
1355410,True,0,1 user reviews,1,0,1
1355420,True,0,3 user reviews,3,0,3
1355430,True,0,No user reviews,0,0,0
1355450,True,0,2 user reviews,1,1,2
1355470,True,0,No user reviews,0,0,0
1355500,True,0,No user reviews,0,0,0
1355510,True,0,4 user reviews,3,1,4
1355540,True,0,No user reviews,0,0,0
1355560,True,0,No user reviews,0,0,0
1355570,True,0,8 user reviews,8,0,8
1355590,True,0,No user reviews,0,0,0
1355600,True,0,No user reviews,0,0,0
1355610,True,0,1 user reviews,1,0,1
1355620,True,0,3 user reviews,3,0,3
1355630,True,0,1 user reviews,1,0,1
1355640,True,0,No user reviews,0,0,0
1355650,True,0,No user reviews,0,0,0
1355700,True,0,No user reviews,0,0,0
1355720,True,0,No user reviews,0,0,0
1355730,True,0,No user reviews,0,0,0
1355740,True,0,No user reviews,0,0,0
1355741,True,0,No user reviews,0,0,0
1355750,True,0,No user reviews,0,0,0
1355751,True,0,No user reviews,0,0,0
1355752,True,0,No user reviews,0,0,0
1355753,True,0,No user reviews,0,0,0
1355754,True,0,No user reviews,0,0,0
1355760,True,0,No user reviews,0,0,0
1355780,True,0,No user reviews,0,0,0
1355810,True,0,1 user reviews,1,0,1
1355820,True,0,No user reviews,0,0,0
1355830,True,0,No user reviews,0,0,0
1355840,True,0,No user reviews,0,0,0
1355850,True,0,No user reviews,0,0,0
1355851,True,0,No user reviews,0,0,0
1355852,True,0,No user reviews,0,0,0
1355853,True,0,No user reviews,0,0,0
1355854,True,0,No user reviews,0,0,0
1355855,True,0,No user reviews,0,0,0
1355856,True,0,No user reviews,0,0,0
1355857,True,0,No user reviews,0,0,0
1355858,True,0,No user reviews,0,0,0
1355859,True,0,No user reviews,0,0,0
1355870,True,0,No user reviews,0,0,0
1355871,True,0,No user reviews,0,0,0
1355872,True,0,No user reviews,0,0,0
1355880,True,0,No user reviews,0,0,0
1355890,True,0,No user reviews,0,0,0
1355910,True,0,1 user reviews,0,1,1
1355920,True,0,No user reviews,0,0,0
1355930,True,0,No user reviews,0,0,0
1355940,True,0,No user reviews,0,0,0
1355970,True,0,No user reviews,0,0,0
1355980,True,0,9 user reviews,9,0,9
1355990,True,0,No user reviews,0,0,0
1356000,True,0,No user reviews,0,0,0
1356001,True,0,No user reviews,0,0,0
1356010,True,0,No user reviews,0,0,0
1356030,True,0,No user reviews,0,0,0
1356040,True,0,No user reviews,0,0,0
1356070,True,0,No user reviews,0,0,0
1356080,True,0,No user reviews,0,0,0
1356110,True,0,No user reviews,0,0,0
1356130,True,0,No user reviews,0,0,0
1356140,True,0,No user reviews,0,0,0
1356150,True,0,No user reviews,0,0,0
1356160,True,0,No user reviews,0,0,0
1356180,True,6,Mostly Positive,25,7,32
1356190,True,5,Mixed,6,6,12
1356200,True,0,No user reviews,0,0,0
1356210,True,0,No user reviews,0,0,0
1356220,True,7,Positive,17,3,20
1356221,True,6,Mostly Positive,24,7,31
1356222,True,0,No user reviews,0,0,0
1356230,True,0,No user reviews,0,0,0
1356240,True,0,8 user reviews,3,5,8
1356250,True,0,No user reviews,0,0,0
1356260,True,0,No user reviews,0,0,0
1356270,True,0,No user reviews,0,0,0
1356280,True,0,No user reviews,0,0,0
1356300,True,0,No user reviews,0,0,0
1356330,True,0,No user reviews,0,0,0
1356331,True,0,No user reviews,0,0,0
1356340,True,0,No user reviews,0,0,0
1356360,True,0,1 user reviews,0,1,1
1356370,True,0,No user reviews,0,0,0
1356371,True,0,No user reviews,0,0,0
1356380,True,0,2 user reviews,1,1,2
1356400,True,0,No user reviews,0,0,0
1356410,True,0,3 user reviews,3,0,3
1356411,True,0,5 user reviews,5,0,5
1356420,True,0,No user reviews,0,0,0
1356430,True,0,No user reviews,0,0,0
1356440,True,4,Mostly Negative,6,10,16
1356450,True,0,No user reviews,0,0,0
1356460,True,0,No user reviews,0,0,0
1356470,True,0,No user reviews,0,0,0
1356480,True,7,Positive,31,1,32
1356490,True,0,No user reviews,0,0,0
1356500,True,0,No user reviews,0,0,0
1356510,True,0,No user reviews,0,0,0
1356530,True,0,5 user reviews,5,0,5
1356560,True,0,No user reviews,0,0,0
1356570,True,0,No user reviews,0,0,0
1356580,True,0,No user reviews,0,0,0
1356590,True,0,No user reviews,0,0,0
1356610,True,0,1 user reviews,1,0,1
1356670,True,0,No user reviews,0,0,0
1356710,True,0,5 user reviews,5,0,5
1356730,True,0,1 user reviews,1,0,1
1356731,True,0,1 user reviews,1,0,1
1356732,True,0,2 user reviews,2,0,2
1356733,True,0,1 user reviews,1,0,1
1356760,True,0,4 user reviews,4,0,4
1356790,True,0,No user reviews,0,0,0
1356800,True,0,No user reviews,0,0,0
1356830,True,0,No user reviews,0,0,0
1356850,True,0,No user reviews,0,0,0
1356860,True,0,No user reviews,0,0,0
1356880,True,0,No user reviews,0,0,0
1356890,True,0,1 user reviews,0,1,1
1356900,True,0,No user reviews,0,0,0
1356920,True,0,1 user reviews,1,0,1
1356930,True,0,2 user reviews,1,1,2
1356940,True,0,No user reviews,0,0,0
1356970,True,0,No user reviews,0,0,0
1356980,True,0,No user reviews,0,0,0
1357000,True,0,No user reviews,0,0,0
1357020,True,0,No user reviews,0,0,0
1357040,True,0,No user reviews,0,0,0
1357070,True,5,Mixed,6,6,12
1357080,True,0,No user reviews,0,0,0
1357090,True,0,No user reviews,0,0,0
1357150,True,0,No user reviews,0,0,0
1357160,True,0,No user reviews,0,0,0
1357170,True,0,No user reviews,0,0,0
1357171,True,0,No user reviews,0,0,0
1357180,True,0,No user reviews,0,0,0
1357190,True,0,1 user reviews,0,1,1
1357200,True,0,1 user reviews,1,0,1
1357220,True,0,No user reviews,0,0,0
1357230,True,0,No user reviews,0,0,0
1357250,True,0,No user reviews,0,0,0
1357260,True,0,No user reviews,0,0,0
1357270,True,0,1 user reviews,0,1,1
1357280,True,0,1 user reviews,1,0,1
1357310,True,0,No user reviews,0,0,0
1357311,True,0,No user reviews,0,0,0
1357312,True,0,No user reviews,0,0,0
1357330,True,0,6 user reviews,2,4,6
1357350,True,0,No user reviews,0,0,0
1357400,True,0,No user reviews,0,0,0
1357410,True,0,4 user reviews,4,0,4
1357470,True,0,No user reviews,0,0,0
1357490,True,0,1 user reviews,1,0,1
1357520,True,0,No user reviews,0,0,0
1357540,True,0,No user reviews,0,0,0
1357550,True,0,No user reviews,0,0,0
1357560,True,0,No user reviews,0,0,0
1357570,True,0,No user reviews,0,0,0
1357580,True,0,No user reviews,0,0,0
1357590,True,0,No user reviews,0,0,0
1357610,True,7,Positive,40,7,47
1357640,True,0,No user reviews,0,0,0
1357670,True,8,Very Positive,57,13,70
1357690,True,0,1 user reviews,1,0,1
1357700,True,0,No user reviews,0,0,0
1357710,True,0,No user reviews,0,0,0
1357730,True,0,No user reviews,0,0,0
1357740,True,0,2 user reviews,1,1,2
1357750,True,0,5 user reviews,5,0,5
1357830,True,7,Positive,15,0,15
1357840,True,0,4 user reviews,4,0,4
1357870,True,0,3 user reviews,3,0,3
1357880,True,0,No user reviews,0,0,0
1357890,True,0,No user reviews,0,0,0
1357900,True,0,1 user reviews,1,0,1
1357910,True,0,2 user reviews,2,0,2
1357930,True,0,4 user reviews,4,0,4
1357940,True,4,Mostly Negative,5,9,14
1357950,True,0,No user reviews,0,0,0
1357960,True,0,No user reviews,0,0,0
1357970,True,0,No user reviews,0,0,0
1357990,True,0,No user reviews,0,0,0
1358000,True,0,No user reviews,0,0,0
1358010,True,0,No user reviews,0,0,0
1358020,True,0,No user reviews,0,0,0
1358030,True,7,Positive,15,0,15
1358050,True,0,No user reviews,0,0,0
1358070,True,0,1 user reviews,1,0,1
1358090,True,7,Positive,47,0,47
1358100,True,0,No user reviews,0,0,0
1358110,True,0,No user reviews,0,0,0
1358120,True,0,No user reviews,0,0,0
1358140,True,0,No user reviews,0,0,0
1358150,True,0,No user reviews,0,0,0
1358160,True,0,No user reviews,0,0,0
1358161,True,0,No user reviews,0,0,0
1358162,True,0,No user reviews,0,0,0
1358180,True,0,No user reviews,0,0,0
1358200,True,0,No user reviews,0,0,0
1358220,True,0,No user reviews,0,0,0
1358240,True,0,No user reviews,0,0,0
1358250,True,8,Very Positive,289,11,300
1358260,True,0,No user reviews,0,0,0
1358270,True,0,8 user reviews,3,5,8
1358280,True,0,No user reviews,0,0,0
1358300,True,0,No user reviews,0,0,0
1358320,True,0,No user reviews,0,0,0
1358350,True,0,No user reviews,0,0,0
1358360,True,0,No user reviews,0,0,0
1358430,True,0,1 user reviews,1,0,1
1358470,True,0,No user reviews,0,0,0
1358480,True,0,No user reviews,0,0,0
1358500,True,0,No user reviews,0,0,0
1358510,True,0,No user reviews,0,0,0
1358530,True,0,No user reviews,0,0,0
1358540,True,0,1 user reviews,1,0,1
1358560,True,0,No user reviews,0,0,0
1358570,True,0,3 user reviews,3,0,3
1358590,True,0,No user reviews,0,0,0
1358610,True,0,No user reviews,0,0,0
1358630,True,0,No user reviews,0,0,0
1358640,True,0,2 user reviews,2,0,2
1358650,True,0,2 user reviews,1,1,2
1358720,True,0,No user reviews,0,0,0
1358730,True,0,No user reviews,0,0,0
1358760,True,0,No user reviews,0,0,0
1358770,True,0,No user reviews,0,0,0
1358800,True,0,No user reviews,0,0,0
1358830,True,0,No user reviews,0,0,0
1358860,True,0,No user reviews,0,0,0
1358890,True,0,No user reviews,0,0,0
1358900,True,0,No user reviews,0,0,0
1358930,True,0,No user reviews,0,0,0
1358940,True,0,No user reviews,0,0,0
1358970,True,0,No user reviews,0,0,0
1358980,True,0,No user reviews,0,0,0
1358990,True,0,1 user reviews,1,0,1
1359000,True,0,No user reviews,0,0,0
1359020,True,0,No user reviews,0,0,0
1359050,True,0,No user reviews,0,0,0
1359080,True,0,No user reviews,0,0,0
1359090,True,6,Mostly Positive,601,210,811
1359110,True,0,No user reviews,0,0,0
1359120,True,7,Positive,17,2,19
1359160,True,0,1 user reviews,0,1,1
1359170,True,0,2 user reviews,2,0,2
1359180,True,0,No user reviews,0,0,0
1359200,True,0,No user reviews,0,0,0
1359210,True,0,No user reviews,0,0,0
1359230,True,0,No user reviews,0,0,0
1359240,True,0,No user reviews,0,0,0
1359260,True,0,No user reviews,0,0,0
1359270,True,0,No user reviews,0,0,0
1359280,True,0,3 user reviews,1,2,3
1359290,True,0,No user reviews,0,0,0
1359300,True,0,No user reviews,0,0,0
1359310,True,7,Positive,11,0,11
1359340,True,0,1 user reviews,1,0,1
1359440,True,0,No user reviews,0,0,0
1359450,True,0,No user reviews,0,0,0
1359460,True,0,No user reviews,0,0,0
1359470,True,0,3 user reviews,1,2,3
1359490,True,0,No user reviews,0,0,0
1359520,True,5,Mixed,17,15,32
1359550,True,0,No user reviews,0,0,0
1359560,True,0,No user reviews,0,0,0
1359590,True,0,3 user reviews,3,0,3
1359610,True,0,1 user reviews,0,1,1
1359650,True,8,Very Positive,171,33,204
1359660,True,0,2 user reviews,2,0,2
1359670,True,0,No user reviews,0,0,0
1359720,True,0,No user reviews,0,0,0
1359760,True,0,7 user reviews,7,0,7
1359780,True,0,No user reviews,0,0,0
1359800,True,0,No user reviews,0,0,0
1359820,True,0,3 user reviews,2,1,3
1359840,True,0,1 user reviews,0,1,1
1359850,True,0,1 user reviews,1,0,1
1359870,True,0,7 user reviews,1,6,7
1359880,True,0,No user reviews,0,0,0
1359890,True,0,No user reviews,0,0,0
1359900,True,0,No user reviews,0,0,0
1359910,True,0,1 user reviews,0,1,1
1359920,True,0,No user reviews,0,0,0
1359950,True,0,No user reviews,0,0,0
1359970,True,0,No user reviews,0,0,0
1359980,True,0,No user reviews,0,0,0
1359990,True,0,No user reviews,0,0,0
1360000,True,8,Very Positive,338,42,380
1360010,True,0,No user reviews,0,0,0
1360020,True,0,No user reviews,0,0,0
1360040,True,0,No user reviews,0,0,0
1360060,True,0,No user reviews,0,0,0
1360080,True,0,4 user reviews,4,0,4
1360090,True,0,No user reviews,0,0,0
1360130,True,0,No user reviews,0,0,0
1360140,True,0,No user reviews,0,0,0
1360150,True,0,No user reviews,0,0,0
1360160,True,0,No user reviews,0,0,0
1360190,True,0,No user reviews,0,0,0
1360220,True,0,No user reviews,0,0,0
1360240,True,0,No user reviews,0,0,0
1360250,True,0,No user reviews,0,0,0
1360260,True,0,1 user reviews,1,0,1
1360270,True,0,No user reviews,0,0,0
1360280,True,0,No user reviews,0,0,0
1360290,True,0,2 user reviews,2,0,2
1360300,True,0,No user reviews,0,0,0
1360310,True,0,No user reviews,0,0,0
1360311,True,0,No user reviews,0,0,0
1360312,True,0,No user reviews,0,0,0
1360313,True,0,No user reviews,0,0,0
1360314,True,0,No user reviews,0,0,0
1360315,True,0,No user reviews,0,0,0
1360316,True,0,No user reviews,0,0,0
1360317,True,0,No user reviews,0,0,0
1360318,True,0,No user reviews,0,0,0
1360319,True,0,No user reviews,0,0,0
1360320,True,0,No user reviews,0,0,0
1360321,True,0,No user reviews,0,0,0
1360322,True,0,No user reviews,0,0,0
1360323,True,0,No user reviews,0,0,0
1360324,True,0,No user reviews,0,0,0
1360325,True,0,No user reviews,0,0,0
1360326,True,0,No user reviews,0,0,0
1360327,True,0,No user reviews,0,0,0
1360328,True,0,No user reviews,0,0,0
1360329,True,0,No user reviews,0,0,0
1360330,True,0,No user reviews,0,0,0
1360331,True,0,No user reviews,0,0,0
1360332,True,0,No user reviews,0,0,0
1360333,True,0,No user reviews,0,0,0
1360334,True,0,No user reviews,0,0,0
1360335,True,0,No user reviews,0,0,0
1360340,True,0,No user reviews,0,0,0
1360341,True,0,No user reviews,0,0,0
1360342,True,0,No user reviews,0,0,0
1360343,True,0,No user reviews,0,0,0
1360344,True,0,No user reviews,0,0,0
1360345,True,0,No user reviews,0,0,0
1360346,True,0,No user reviews,0,0,0
1360347,True,0,No user reviews,0,0,0
1360348,True,0,No user reviews,0,0,0
1360349,True,0,No user reviews,0,0,0
1360350,True,0,No user reviews,0,0,0
1360351,True,0,No user reviews,0,0,0
1360352,True,0,No user reviews,0,0,0
1360353,True,0,No user reviews,0,0,0
1360354,True,0,No user reviews,0,0,0
1360355,True,0,No user reviews,0,0,0
1360356,True,0,No user reviews,0,0,0
1360357,True,0,No user reviews,0,0,0
1360360,True,0,1 user reviews,0,1,1
1360370,True,0,No user reviews,0,0,0
1360390,True,0,No user reviews,0,0,0
1360400,True,0,No user reviews,0,0,0
1360430,True,0,No user reviews,0,0,0
1360440,True,0,No user reviews,0,0,0
1360480,True,0,No user reviews,0,0,0
1360490,True,0,No user reviews,0,0,0
1360500,True,0,No user reviews,0,0,0
1360510,True,0,2 user reviews,2,0,2
1360530,True,0,6 user reviews,4,2,6
1360540,True,0,No user reviews,0,0,0
1360550,True,0,No user reviews,0,0,0
1360560,True,0,1 user reviews,0,1,1
1360570,True,0,No user reviews,0,0,0
1360580,True,0,No user reviews,0,0,0
1360620,True,0,No user reviews,0,0,0
1360630,True,0,No user reviews,0,0,0
1360650,True,0,No user reviews,0,0,0
1360660,True,0,No user reviews,0,0,0
1360670,True,0,4 user reviews,3,1,4
1360680,True,0,No user reviews,0,0,0
1360720,True,0,No user reviews,0,0,0
1360760,True,0,No user reviews,0,0,0
1360790,True,0,No user reviews,0,0,0
1360810,True,0,No user reviews,0,0,0
1360820,True,0,No user reviews,0,0,0
1360850,True,0,No user reviews,0,0,0
1360870,True,0,1 user reviews,1,0,1
1360880,True,0,No user reviews,0,0,0
1360890,True,0,No user reviews,0,0,0
1360900,True,0,No user reviews,0,0,0
1360910,True,0,No user reviews,0,0,0
1360920,True,0,No user reviews,0,0,0
1360950,True,0,No user reviews,0,0,0
1360970,True,0,No user reviews,0,0,0
1360980,True,8,Very Positive,125,22,147
1361000,True,8,Very Positive,516,87,603
1361010,True,0,No user reviews,0,0,0
1361020,True,0,4 user reviews,4,0,4
1361030,True,0,No user reviews,0,0,0
1361060,True,0,No user reviews,0,0,0
1361070,True,0,No user reviews,0,0,0
1361080,True,0,No user reviews,0,0,0
1361110,True,8,Very Positive,75,5,80
1361120,True,0,3 user reviews,3,0,3
1361150,True,0,1 user reviews,1,0,1
1361170,True,0,No user reviews,0,0,0
1361180,True,0,1 user reviews,1,0,1
1361190,True,0,3 user reviews,3,0,3
1361200,True,0,No user reviews,0,0,0
1361210,True,0,No user reviews,0,0,0
1361230,True,0,No user reviews,0,0,0
1361240,True,0,No user reviews,0,0,0
1361250,True,0,No user reviews,0,0,0
1361260,True,0,2 user reviews,2,0,2
1361270,True,0,No user reviews,0,0,0
1361280,True,8,Very Positive,120,18,138
1361310,True,0,No user reviews,0,0,0
1361311,True,0,No user reviews,0,0,0
1361330,True,0,No user reviews,0,0,0
1361340,True,0,No user reviews,0,0,0
1361350,True,0,No user reviews,0,0,0
1361360,True,0,No user reviews,0,0,0
1361370,True,0,No user reviews,0,0,0
1361390,True,0,2 user reviews,2,0,2
1361420,True,0,No user reviews,0,0,0
1361430,True,0,1 user reviews,1,0,1
1361440,True,0,1 user reviews,1,0,1
1361450,True,0,No user reviews,0,0,0
1361470,True,0,1 user reviews,1,0,1
1361480,True,0,No user reviews,0,0,0
1361490,True,0,No user reviews,0,0,0
1361500,True,0,No user reviews,0,0,0
1361520,True,0,6 user reviews,6,0,6
1361530,True,0,No user reviews,0,0,0
1361540,True,0,1 user reviews,1,0,1
1361560,True,0,1 user reviews,0,1,1
1361580,True,0,No user reviews,0,0,0
1361590,True,0,No user reviews,0,0,0
1361591,True,0,1 user reviews,0,1,1
1361610,True,0,No user reviews,0,0,0
1361620,True,0,No user reviews,0,0,0
1361630,True,0,No user reviews,0,0,0
1361660,True,0,No user reviews,0,0,0
1361680,True,0,No user reviews,0,0,0
1361700,True,8,Very Positive,458,19,477
1361720,True,0,No user reviews,0,0,0
1361740,True,0,2 user reviews,2,0,2
1361760,True,0,7 user reviews,6,1,7
1361770,True,0,No user reviews,0,0,0
1361790,True,0,No user reviews,0,0,0
1361810,True,0,No user reviews,0,0,0
1361840,True,0,No user reviews,0,0,0
1361860,True,7,Positive,14,3,17
1361870,True,0,No user reviews,0,0,0
1361890,True,0,No user reviews,0,0,0
1361900,True,0,No user reviews,0,0,0
1361920,True,7,Positive,17,2,19
1361930,True,0,No user reviews,0,0,0
1361940,True,0,No user reviews,0,0,0
1361950,True,0,1 user reviews,1,0,1
1361960,True,0,No user reviews,0,0,0
1361980,True,0,No user reviews,0,0,0
1361990,True,0,No user reviews,0,0,0
1362000,True,0,No user reviews,0,0,0
1362040,True,0,No user reviews,0,0,0
1362060,True,0,No user reviews,0,0,0
1362070,True,0,No user reviews,0,0,0
1362080,True,0,No user reviews,0,0,0
1362100,True,0,No user reviews,0,0,0
1362101,True,0,No user reviews,0,0,0
1362102,True,0,No user reviews,0,0,0
1362103,True,0,No user reviews,0,0,0
1362104,True,0,No user reviews,0,0,0
1362105,True,0,No user reviews,0,0,0
1362106,True,0,No user reviews,0,0,0
1362107,True,0,No user reviews,0,0,0
1362108,True,0,No user reviews,0,0,0
1362109,True,0,No user reviews,0,0,0
1362110,True,0,No user reviews,0,0,0
1362111,True,0,No user reviews,0,0,0
1362112,True,0,No user reviews,0,0,0
1362113,True,0,No user reviews,0,0,0
1362114,True,0,No user reviews,0,0,0
1362115,True,0,No user reviews,0,0,0
1362116,True,0,1 user reviews,0,1,1
1362117,True,0,1 user reviews,1,0,1
1362118,True,0,1 user reviews,1,0,1
1362119,True,0,No user reviews,0,0,0
1362120,True,0,No user reviews,0,0,0
1362130,True,0,4 user reviews,3,1,4
1362140,True,0,No user reviews,0,0,0
1362150,True,0,1 user reviews,0,1,1
1362151,True,0,No user reviews,0,0,0
1362152,True,0,No user reviews,0,0,0
1362153,True,0,No user reviews,0,0,0
1362154,True,0,No user reviews,0,0,0
1362155,True,0,No user reviews,0,0,0
1362156,True,0,No user reviews,0,0,0
1362157,True,0,No user reviews,0,0,0
1362158,True,0,No user reviews,0,0,0
1362159,True,0,No user reviews,0,0,0
1362160,True,0,No user reviews,0,0,0
1362161,True,0,No user reviews,0,0,0
1362162,True,0,1 user reviews,0,1,1
1362163,True,0,No user reviews,0,0,0
1362164,True,0,No user reviews,0,0,0
1362165,True,0,No user reviews,0,0,0
1362166,True,0,No user reviews,0,0,0
1362168,True,0,No user reviews,0,0,0
1362169,True,0,No user reviews,0,0,0
1362170,True,0,No user reviews,0,0,0
1362171,True,0,No user reviews,0,0,0
1362172,True,0,No user reviews,0,0,0
1362173,True,0,No user reviews,0,0,0
1362174,True,0,No user reviews,0,0,0
1362175,True,0,No user reviews,0,0,0
1362176,True,0,No user reviews,0,0,0
1362177,True,0,No user reviews,0,0,0
1362178,True,0,No user reviews,0,0,0
1362179,True,0,No user reviews,0,0,0
1362180,True,0,1 user reviews,1,0,1
1362190,True,0,1 user reviews,1,0,1
1362210,True,0,No user reviews,0,0,0
1362220,True,0,No user reviews,0,0,0
1362221,True,0,No user reviews,0,0,0
1362222,True,0,No user reviews,0,0,0
1362223,True,0,No user reviews,0,0,0
1362224,True,0,No user reviews,0,0,0
1362230,True,0,No user reviews,0,0,0
1362260,True,0,No user reviews,0,0,0
1362270,True,0,1 user reviews,1,0,1
1362290,True,0,No user reviews,0,0,0
1362310,True,0,No user reviews,0,0,0
1362330,True,0,4 user reviews,4,0,4
1362340,True,0,No user reviews,0,0,0
1362350,True,0,No user reviews,0,0,0
1362370,True,0,No user reviews,0,0,0
1362390,True,0,No user reviews,0,0,0
1362400,True,0,No user reviews,0,0,0
1362410,True,0,No user reviews,0,0,0
1362420,True,0,No user reviews,0,0,0
1362430,True,5,Mixed,10,6,16
1362450,True,0,1 user reviews,0,1,1
1362460,True,0,3 user reviews,2,1,3
1362470,True,0,No user reviews,0,0,0
1362510,True,0,No user reviews,0,0,0
1362520,True,0,No user reviews,0,0,0
1362580,True,0,No user reviews,0,0,0
1362600,True,0,1 user reviews,1,0,1
1362601,True,0,1 user reviews,1,0,1
1362602,True,0,No user reviews,0,0,0
1362620,True,0,No user reviews,0,0,0
1362640,True,0,No user reviews,0,0,0
1362650,True,0,No user reviews,0,0,0
1362660,True,8,Very Positive,247,58,305
1362670,True,0,1 user reviews,1,0,1
1362700,True,0,2 user reviews,0,2,2
1362720,True,0,1 user reviews,1,0,1
1362730,True,0,No user reviews,0,0,0
1362750,True,0,1 user reviews,1,0,1
1362760,True,0,No user reviews,0,0,0
1362780,True,0,No user reviews,0,0,0
1362790,True,0,No user reviews,0,0,0
1362820,True,0,No user reviews,0,0,0
1362840,True,0,No user reviews,0,0,0
1362850,True,0,No user reviews,0,0,0
1362860,True,0,2 user reviews,2,0,2
1362890,True,0,No user reviews,0,0,0
1362910,True,0,No user reviews,0,0,0
1362930,True,0,No user reviews,0,0,0
1362980,True,0,1 user reviews,0,1,1
1362990,True,0,3 user reviews,0,3,3
1363010,True,0,No user reviews,0,0,0
1363020,True,0,1 user reviews,1,0,1
1363080,True,0,No user reviews,0,0,0
1363090,True,0,1 user reviews,1,0,1
1363120,True,0,No user reviews,0,0,0
1363140,True,0,8 user reviews,7,1,8
1363170,True,0,1 user reviews,1,0,1
1363200,True,0,2 user reviews,2,0,2
1363210,True,0,No user reviews,0,0,0
1363240,True,0,No user reviews,0,0,0
1363250,True,0,1 user reviews,0,1,1
1363270,True,0,No user reviews,0,0,0
1363280,True,0,No user reviews,0,0,0
1363290,True,0,4 user reviews,0,4,4
1363310,True,0,No user reviews,0,0,0
1363350,True,0,No user reviews,0,0,0
1363360,True,0,No user reviews,0,0,0
1363370,True,0,No user reviews,0,0,0
1363390,True,0,1 user reviews,0,1,1
1363400,True,0,No user reviews,0,0,0
1363410,True,0,No user reviews,0,0,0
1363430,True,0,No user reviews,0,0,0
1363450,True,0,3 user reviews,1,2,3
1363470,True,0,No user reviews,0,0,0
1363490,True,0,No user reviews,0,0,0
1363500,True,0,No user reviews,0,0,0
1363560,True,0,4 user reviews,4,0,4
1363600,True,0,7 user reviews,7,0,7
1363620,True,0,No user reviews,0,0,0
1363640,True,0,No user reviews,0,0,0
1363650,True,0,No user reviews,0,0,0
1363660,True,0,6 user reviews,3,3,6
1363680,True,0,No user reviews,0,0,0
1363690,True,0,3 user reviews,2,1,3
1363730,True,0,No user reviews,0,0,0
1363750,True,0,No user reviews,0,0,0
1363770,True,6,Mostly Positive,34,10,44
1363790,True,0,No user reviews,0,0,0
1363810,True,0,No user reviews,0,0,0
1363840,True,0,No user reviews,0,0,0
1363850,True,7,Positive,12,0,12
1363860,True,0,No user reviews,0,0,0
1363880,True,0,1 user reviews,1,0,1
1363910,True,0,No user reviews,0,0,0
1363960,True,0,No user reviews,0,0,0
1363980,True,0,4 user reviews,4,0,4
1364000,True,0,2 user reviews,2,0,2
1364010,True,0,9 user reviews,8,1,9
1364020,True,0,No user reviews,0,0,0
1364030,True,0,1 user reviews,1,0,1
1364032,True,0,1 user reviews,1,0,1
1364033,True,4,Mostly Negative,15,41,56
1364034,True,7,Positive,11,2,13
1364035,True,0,1 user reviews,1,0,1
1364040,True,0,No user reviews,0,0,0
1364080,True,0,No user reviews,0,0,0
1364100,True,0,No user reviews,0,0,0
1364110,True,0,3 user reviews,1,2,3
1364111,True,0,4 user reviews,3,1,4
1364130,True,7,Positive,14,3,17
1364140,True,5,Mixed,34,35,69
1364150,True,0,No user reviews,0,0,0
1364160,True,0,No user reviews,0,0,0
1364170,True,0,No user reviews,0,0,0
1364180,True,0,No user reviews,0,0,0
1364190,True,0,1 user reviews,1,0,1
1364240,True,0,No user reviews,0,0,0
1364280,True,0,No user reviews,0,0,0
1364330,True,0,1 user reviews,1,0,1
1364340,True,0,No user reviews,0,0,0
1364350,True,0,No user reviews,0,0,0
1364360,True,0,No user reviews,0,0,0
1364390,True,0,No user reviews,0,0,0
1364400,True,0,1 user reviews,1,0,1
1364410,True,0,No user reviews,0,0,0
1364430,True,0,1 user reviews,1,0,1
1364440,True,0,No user reviews,0,0,0
1364450,True,0,No user reviews,0,0,0
1364460,True,0,No user reviews,0,0,0
1364470,True,0,2 user reviews,2,0,2
1364480,True,0,No user reviews,0,0,0
1364490,True,0,No user reviews,0,0,0
1364500,True,0,No user reviews,0,0,0
1364510,True,0,No user reviews,0,0,0
1364520,True,0,No user reviews,0,0,0
1364521,True,0,No user reviews,0,0,0
1364530,True,0,No user reviews,0,0,0
1364550,True,0,No user reviews,0,0,0
1364570,True,0,No user reviews,0,0,0
1364580,True,0,No user reviews,0,0,0
1364590,True,0,No user reviews,0,0,0
1364620,True,0,No user reviews,0,0,0
1364650,True,0,No user reviews,0,0,0
1364660,True,0,No user reviews,0,0,0
1364661,True,0,No user reviews,0,0,0
1364662,True,0,No user reviews,0,0,0
1364663,True,0,No user reviews,0,0,0
1364664,True,0,No user reviews,0,0,0
1364690,True,0,No user reviews,0,0,0
1364710,True,0,No user reviews,0,0,0
1364730,True,7,Positive,17,0,17
1364740,True,0,No user reviews,0,0,0
1364750,True,0,No user reviews,0,0,0
1364800,True,0,No user reviews,0,0,0
1364830,True,0,No user reviews,0,0,0
1364840,True,0,5 user reviews,2,3,5
1364880,True,0,No user reviews,0,0,0
1364890,True,0,No user reviews,0,0,0
1364910,True,0,No user reviews,0,0,0
1364920,True,0,No user reviews,0,0,0
1364940,True,0,No user reviews,0,0,0
1364950,True,0,7 user reviews,6,1,7
1364960,True,0,No user reviews,0,0,0
1364971,True,0,3 user reviews,2,1,3
1364980,True,0,9 user reviews,8,1,9
1365000,True,0,No user reviews,0,0,0
1365010,True,7,Positive,19,0,19
1365020,True,0,1 user reviews,1,0,1
1365030,True,7,Positive,21,0,21
1365050,True,0,No user reviews,0,0,0
1365060,True,0,1 user reviews,1,0,1
1365140,True,0,No user reviews,0,0,0
1365380,True,0,No user reviews,0,0,0
1365390,True,0,3 user reviews,2,1,3
1365410,True,0,No user reviews,0,0,0
1365420,True,0,2 user reviews,1,1,2
1365450,True,0,No user reviews,0,0,0
1365490,True,0,5 user reviews,5,0,5
1365510,True,0,No user reviews,0,0,0
1365520,True,0,No user reviews,0,0,0
1365530,True,0,No user reviews,0,0,0
1365550,True,0,2 user reviews,2,0,2
1365560,True,0,5 user reviews,2,3,5
1365580,True,0,No user reviews,0,0,0
1365590,True,0,No user reviews,0,0,0
1365600,True,0,No user reviews,0,0,0
1365620,True,0,4 user reviews,2,2,4
1365630,True,0,2 user reviews,2,0,2
1365640,True,0,No user reviews,0,0,0
1365650,True,0,No user reviews,0,0,0
1365660,True,0,1 user reviews,0,1,1
1365680,True,0,No user reviews,0,0,0
1365700,True,0,1 user reviews,0,1,1
1365710,True,0,No user reviews,0,0,0
1365720,True,0,No user reviews,0,0,0
1365750,True,0,No user reviews,0,0,0
1365780,True,0,No user reviews,0,0,0
1365810,True,0,No user reviews,0,0,0
1365820,True,0,No user reviews,0,0,0
1365870,True,0,No user reviews,0,0,0
1365900,True,0,No user reviews,0,0,0
1365910,True,0,No user reviews,0,0,0
1365930,True,7,Positive,25,0,25
1365940,True,0,No user reviews,0,0,0
1365950,True,0,1 user reviews,1,0,1
1365990,True,0,No user reviews,0,0,0
1366000,True,0,No user reviews,0,0,0
1366010,True,0,No user reviews,0,0,0
1366040,True,0,No user reviews,0,0,0
1366050,True,0,No user reviews,0,0,0
1366060,True,0,No user reviews,0,0,0
1366090,True,0,5 user reviews,5,0,5
1366091,True,8,Very Positive,116,5,121
1366110,True,0,No user reviews,0,0,0
1366120,True,0,No user reviews,0,0,0
1366130,True,0,No user reviews,0,0,0
1366140,True,0,No user reviews,0,0,0
1366150,True,0,7 user reviews,7,0,7
1366160,True,0,No user reviews,0,0,0
1366180,True,0,No user reviews,0,0,0
1366200,True,0,No user reviews,0,0,0
1366220,True,0,No user reviews,0,0,0
1366230,True,0,No user reviews,0,0,0
1366270,True,0,No user reviews,0,0,0
1366290,True,0,No user reviews,0,0,0
1366310,True,0,No user reviews,0,0,0
1366320,True,0,No user reviews,0,0,0
1366360,True,7,Positive,12,0,12
1366370,True,0,No user reviews,0,0,0
1366420,True,0,4 user reviews,3,1,4
1366470,True,0,No user reviews,0,0,0
1366510,True,0,No user reviews,0,0,0
1366530,True,0,No user reviews,0,0,0
1366540,True,0,No user reviews,0,0,0
1366550,True,0,2 user reviews,1,1,2
1366560,True,0,No user reviews,0,0,0
1366570,True,0,2 user reviews,2,0,2
1366600,True,0,No user reviews,0,0,0
1366610,True,0,3 user reviews,3,0,3
1366620,True,0,No user reviews,0,0,0
1366640,True,0,No user reviews,0,0,0
1366650,True,0,No user reviews,0,0,0
1366680,True,0,No user reviews,0,0,0
1366700,True,0,1 user reviews,1,0,1
1366710,True,0,1 user reviews,1,0,1
1366720,True,0,No user reviews,0,0,0
1366740,True,0,No user reviews,0,0,0
1366750,True,0,1 user reviews,1,0,1
1366800,True,0,No user reviews,0,0,0
1366810,True,0,3 user reviews,3,0,3
1366830,True,0,No user reviews,0,0,0
1366840,True,0,No user reviews,0,0,0
1366890,True,0,No user reviews,0,0,0
1366900,True,5,Mixed,40,21,61
1366910,True,0,No user reviews,0,0,0
1366920,True,0,No user reviews,0,0,0
1366930,True,0,No user reviews,0,0,0
1366940,True,0,No user reviews,0,0,0
1366970,True,0,No user reviews,0,0,0
1367000,True,0,No user reviews,0,0,0
1367030,True,0,No user reviews,0,0,0
1367040,True,0,No user reviews,0,0,0
1367050,True,0,No user reviews,0,0,0
1367110,True,0,2 user reviews,2,0,2
1367130,True,0,1 user reviews,1,0,1
1367140,True,0,No user reviews,0,0,0
1367150,True,0,No user reviews,0,0,0
1367180,True,0,No user reviews,0,0,0
1367190,True,0,No user reviews,0,0,0
1367220,True,0,No user reviews,0,0,0
1367230,True,0,1 user reviews,1,0,1
1367250,True,0,3 user reviews,3,0,3
1367270,True,0,No user reviews,0,0,0
1367300,True,0,No user reviews,0,0,0
1367320,True,0,1 user reviews,1,0,1
1367340,True,0,1 user reviews,0,1,1
1367350,True,0,1 user reviews,1,0,1
1367360,True,0,No user reviews,0,0,0
1367380,True,0,No user reviews,0,0,0
1367390,True,0,No user reviews,0,0,0
1367400,True,0,No user reviews,0,0,0
1367420,True,0,No user reviews,0,0,0
1367430,True,0,4 user reviews,3,1,4
1367440,True,0,No user reviews,0,0,0
1367470,True,0,No user reviews,0,0,0
1367480,True,0,1 user reviews,1,0,1
1367500,True,0,No user reviews,0,0,0
1367510,True,0,No user reviews,0,0,0
1367520,True,0,6 user reviews,6,0,6
1367550,True,8,Very Positive,228,17,245
1367570,True,0,No user reviews,0,0,0
1367580,True,0,No user reviews,0,0,0
1367590,True,0,No user reviews,0,0,0
1367610,True,0,No user reviews,0,0,0
1367620,True,0,1 user reviews,0,1,1
1367630,True,0,No user reviews,0,0,0
1367640,True,0,No user reviews,0,0,0
1367650,True,0,No user reviews,0,0,0
1367660,True,0,No user reviews,0,0,0
1367670,True,0,No user reviews,0,0,0
1367690,True,6,Mostly Positive,39,10,49
1367720,True,0,No user reviews,0,0,0
1367740,True,0,No user reviews,0,0,0
1367750,True,0,8 user reviews,6,2,8
1367770,True,0,1 user reviews,1,0,1
1367780,True,0,No user reviews,0,0,0
1367800,True,0,No user reviews,0,0,0
1367801,True,0,No user reviews,0,0,0
1367810,True,0,No user reviews,0,0,0
1367850,True,0,No user reviews,0,0,0
1367860,True,0,No user reviews,0,0,0
1367870,True,0,No user reviews,0,0,0
1367880,True,0,No user reviews,0,0,0
1367890,True,0,No user reviews,0,0,0
1367930,True,0,1 user reviews,1,0,1
1367940,True,0,No user reviews,0,0,0
1367950,True,0,2 user reviews,0,2,2
1367960,True,0,No user reviews,0,0,0
1367970,True,0,2 user reviews,1,1,2
1367980,True,0,No user reviews,0,0,0
1368000,True,0,No user reviews,0,0,0
1368030,True,0,No user reviews,0,0,0
1368040,True,0,No user reviews,0,0,0
1368060,True,0,3 user reviews,1,2,3
1368090,True,0,No user reviews,0,0,0
1368110,True,0,1 user reviews,0,1,1
1368120,True,0,2 user reviews,2,0,2
1368210,True,7,Positive,18,1,19
1368240,True,0,No user reviews,0,0,0
1368250,True,0,No user reviews,0,0,0
1368260,True,0,No user reviews,0,0,0
1368290,True,0,No user reviews,0,0,0
1368330,True,0,No user reviews,0,0,0
1368340,True,0,No user reviews,0,0,0
1368350,True,0,No user reviews,0,0,0
1368360,True,0,No user reviews,0,0,0
1368370,True,0,No user reviews,0,0,0
1368380,True,0,No user reviews,0,0,0
1368390,True,0,No user reviews,0,0,0
1368400,True,0,No user reviews,0,0,0
1368420,True,0,No user reviews,0,0,0
1368430,True,0,No user reviews,0,0,0
1368440,True,0,No user reviews,0,0,0
1368450,True,0,No user reviews,0,0,0
1368460,True,0,No user reviews,0,0,0
1368520,True,0,No user reviews,0,0,0
1368530,True,0,No user reviews,0,0,0
1368560,True,0,1 user reviews,1,0,1
1368570,True,0,1 user reviews,1,0,1
1368572,True,0,No user reviews,0,0,0
1368580,True,0,No user reviews,0,0,0
1368600,True,0,No user reviews,0,0,0
1368610,True,0,No user reviews,0,0,0
1368620,True,0,No user reviews,0,0,0
1368630,True,0,1 user reviews,1,0,1
1368640,True,0,1 user reviews,1,0,1
1368670,True,0,No user reviews,0,0,0
1368680,True,0,No user reviews,0,0,0
1368700,True,0,No user reviews,0,0,0
1368740,True,0,2 user reviews,2,0,2
1368750,True,0,2 user reviews,2,0,2
1368760,True,0,No user reviews,0,0,0
1368770,True,0,5 user reviews,2,3,5
1368790,True,0,No user reviews,0,0,0
1368800,True,0,3 user reviews,1,2,3
1368801,True,0,1 user reviews,1,0,1
1368810,True,5,Mixed,8,5,13
1368820,True,8,Very Positive,67,13,80
1368830,True,0,No user reviews,0,0,0
1368850,True,0,No user reviews,0,0,0
1368860,True,0,No user reviews,0,0,0
1368870,True,0,No user reviews,0,0,0
1368880,True,0,No user reviews,0,0,0
1368920,True,0,No user reviews,0,0,0
1368950,True,0,No user reviews,0,0,0
1368970,True,0,No user reviews,0,0,0
1368980,True,0,No user reviews,0,0,0
1368981,True,0,No user reviews,0,0,0
1368982,True,0,No user reviews,0,0,0
1368983,True,0,No user reviews,0,0,0
1368984,True,0,No user reviews,0,0,0
1369020,True,0,No user reviews,0,0,0
1369100,True,0,No user reviews,0,0,0
1369280,True,0,No user reviews,0,0,0
1369310,True,0,No user reviews,0,0,0
1369320,True,0,No user reviews,0,0,0
1369340,True,8,Very Positive,65,2,67
1369350,True,0,No user reviews,0,0,0
1369370,True,8,Very Positive,102,23,125
1369380,True,0,No user reviews,0,0,0
1369390,True,0,No user reviews,0,0,0
1369400,True,0,No user reviews,0,0,0
1369410,True,0,No user reviews,0,0,0
1369420,True,0,No user reviews,0,0,0
1369430,True,0,No user reviews,0,0,0
1369440,True,0,No user reviews,0,0,0
1369450,True,0,No user reviews,0,0,0
1369451,True,0,No user reviews,0,0,0
1369452,True,0,No user reviews,0,0,0
1369453,True,0,1 user reviews,0,1,1
1369454,True,0,No user reviews,0,0,0
1369455,True,0,No user reviews,0,0,0
1369456,True,0,2 user reviews,0,2,2
1369470,True,0,No user reviews,0,0,0
1369480,True,0,No user reviews,0,0,0
1369490,True,0,No user reviews,0,0,0
1369520,True,0,No user reviews,0,0,0
1369530,True,0,No user reviews,0,0,0
1369560,True,0,2 user reviews,2,0,2
1369570,True,0,No user reviews,0,0,0
1369580,True,0,No user reviews,0,0,0
1369610,True,0,No user reviews,0,0,0
1369630,True,0,No user reviews,0,0,0
1369680,True,0,No user reviews,0,0,0
1369700,True,0,No user reviews,0,0,0
1369720,True,0,No user reviews,0,0,0
1369740,True,0,1 user reviews,1,0,1
1369770,True,0,No user reviews,0,0,0
1369780,True,0,No user reviews,0,0,0
1369800,True,0,No user reviews,0,0,0
1369830,True,0,No user reviews,0,0,0
1369930,True,0,No user reviews,0,0,0
1369940,True,0,No user reviews,0,0,0
1369950,True,0,2 user reviews,2,0,2
1369980,True,0,No user reviews,0,0,0
1369990,True,0,No user reviews,0,0,0
1370000,True,0,No user reviews,0,0,0
1370040,True,0,No user reviews,0,0,0
1370080,True,0,1 user reviews,0,1,1
1370100,True,0,No user reviews,0,0,0
1370130,True,0,No user reviews,0,0,0
1370140,True,0,No user reviews,0,0,0
1370170,True,0,No user reviews,0,0,0
1370180,True,0,No user reviews,0,0,0
1370190,True,0,No user reviews,0,0,0
1370220,True,0,No user reviews,0,0,0
1370230,True,0,1 user reviews,0,1,1
1370240,True,0,No user reviews,0,0,0
1370250,True,0,1 user reviews,1,0,1
1370260,True,0,1 user reviews,1,0,1
1370280,True,0,No user reviews,0,0,0
1370300,True,0,2 user reviews,2,0,2
1370310,True,0,No user reviews,0,0,0
1370370,True,0,No user reviews,0,0,0
1370390,True,0,9 user reviews,9,0,9
1370400,True,0,No user reviews,0,0,0
1370410,True,0,No user reviews,0,0,0
1370420,True,0,No user reviews,0,0,0
1370470,True,0,2 user reviews,0,2,2
1370510,True,0,No user reviews,0,0,0
1370550,True,0,2 user reviews,2,0,2
1370560,True,0,No user reviews,0,0,0
1370570,True,0,No user reviews,0,0,0
1370580,True,0,1 user reviews,0,1,1
1370610,True,0,2 user reviews,1,1,2
1370620,True,0,3 user reviews,3,0,3
1370630,True,0,4 user reviews,4,0,4
1370640,True,0,6 user reviews,6,0,6
1370650,True,0,2 user reviews,1,1,2
1370660,True,0,3 user reviews,2,1,3
1370670,True,0,No user reviews,0,0,0
1370680,True,0,No user reviews,0,0,0
1370710,True,0,No user reviews,0,0,0
1370720,True,0,4 user reviews,3,1,4
1370740,True,0,No user reviews,0,0,0
1370770,True,0,No user reviews,0,0,0
1370780,True,0,No user reviews,0,0,0
1370790,True,0,No user reviews,0,0,0
1370800,True,0,No user reviews,0,0,0
1370810,True,0,No user reviews,0,0,0
1370820,True,0,No user reviews,0,0,0
1370850,True,0,2 user reviews,2,0,2
1370890,True,0,No user reviews,0,0,0
1370900,True,0,No user reviews,0,0,0
1370901,True,0,No user reviews,0,0,0
1370902,True,0,No user reviews,0,0,0
1370930,True,0,No user reviews,0,0,0
1370940,True,0,No user reviews,0,0,0
1370950,True,0,5 user reviews,3,2,5
1370970,True,0,No user reviews,0,0,0
1370980,True,0,No user reviews,0,0,0
1371000,True,0,No user reviews,0,0,0
1371030,True,0,No user reviews,0,0,0
1371040,True,0,1 user reviews,1,0,1
1371050,True,0,No user reviews,0,0,0
1371090,True,0,2 user reviews,1,1,2
1371110,True,0,2 user reviews,2,0,2
1371120,True,0,No user reviews,0,0,0
1371150,True,0,No user reviews,0,0,0
1371160,True,0,1 user reviews,1,0,1
1371170,True,0,No user reviews,0,0,0
1371180,True,0,No user reviews,0,0,0
1371210,True,0,No user reviews,0,0,0
1371220,True,0,3 user reviews,2,1,3
1371230,True,0,No user reviews,0,0,0
1371250,True,0,No user reviews,0,0,0
1371270,True,0,No user reviews,0,0,0
1371280,True,0,No user reviews,0,0,0
1371300,True,0,No user reviews,0,0,0
1371320,True,0,No user reviews,0,0,0
1371330,True,0,No user reviews,0,0,0
1371340,True,0,5 user reviews,1,4,5
1371350,True,0,No user reviews,0,0,0
1371360,True,0,No user reviews,0,0,0
1371380,True,0,No user reviews,0,0,0
1371400,True,7,Positive,13,0,13
1371401,True,0,1 user reviews,1,0,1
1371402,True,0,2 user reviews,2,0,2
1371403,True,0,2 user reviews,2,0,2
1371404,True,7,Positive,10,0,10
1371405,True,0,No user reviews,0,0,0
1371406,True,0,No user reviews,0,0,0
1371407,True,0,5 user reviews,5,0,5
1371408,True,0,2 user reviews,2,0,2
1371409,True,0,1 user reviews,1,0,1
1371420,True,0,2 user reviews,1,1,2
1371421,True,0,1 user reviews,1,0,1
1371422,True,0,1 user reviews,1,0,1
1371423,True,0,1 user reviews,1,0,1
1371424,True,0,1 user reviews,1,0,1
1371425,True,0,2 user reviews,2,0,2
1371426,True,0,1 user reviews,1,0,1
1371427,True,0,2 user reviews,2,0,2
1371428,True,0,1 user reviews,1,0,1
1371429,True,0,1 user reviews,1,0,1
1371460,True,0,No user reviews,0,0,0
1371470,True,0,No user reviews,0,0,0
1371480,True,0,No user reviews,0,0,0
1371500,True,0,No user reviews,0,0,0
1371510,True,0,1 user reviews,0,1,1
1371520,True,0,No user reviews,0,0,0
1371540,True,0,1 user reviews,1,0,1
1371550,True,0,No user reviews,0,0,0
1371570,True,0,No user reviews,0,0,0
1371600,True,0,1 user reviews,0,1,1
1371610,True,0,No user reviews,0,0,0
1371620,True,0,No user reviews,0,0,0
1371630,True,0,No user reviews,0,0,0
1371640,True,0,No user reviews,0,0,0
1371660,True,0,No user reviews,0,0,0
1371690,True,0,No user reviews,0,0,0
1371700,True,0,No user reviews,0,0,0
1371710,True,0,2 user reviews,2,0,2
1371720,True,0,No user reviews,0,0,0
1371730,True,0,2 user reviews,1,1,2
1371740,True,0,No user reviews,0,0,0
1371760,True,0,No user reviews,0,0,0
1371770,True,0,6 user reviews,6,0,6
1371780,True,0,No user reviews,0,0,0
1371790,True,0,No user reviews,0,0,0
1371800,True,0,1 user reviews,1,0,1
1371810,True,0,No user reviews,0,0,0
1371830,True,0,No user reviews,0,0,0
1371840,True,0,No user reviews,0,0,0
1371860,True,0,No user reviews,0,0,0
1371880,True,0,No user reviews,0,0,0
1371900,True,0,No user reviews,0,0,0
1371910,True,0,1 user reviews,1,0,1
1371930,True,0,No user reviews,0,0,0
1371940,True,0,2 user reviews,2,0,2
1372010,True,0,2 user reviews,2,0,2
1372020,True,0,No user reviews,0,0,0
1372021,True,0,No user reviews,0,0,0
1372090,True,0,8 user reviews,3,5,8
1372120,True,0,No user reviews,0,0,0
1372130,True,0,No user reviews,0,0,0
1372180,True,0,3 user reviews,3,0,3
1372210,True,0,No user reviews,0,0,0
1372220,True,0,No user reviews,0,0,0
1372240,True,0,No user reviews,0,0,0
1372260,True,0,No user reviews,0,0,0
1372270,True,0,No user reviews,0,0,0
1372300,True,7,Positive,11,0,11
1372310,True,0,4 user reviews,3,1,4
1372320,True,8,Very Positive,251,3,254
1372340,True,0,No user reviews,0,0,0
1372350,True,0,No user reviews,0,0,0
1372380,True,0,1 user reviews,1,0,1
1372390,True,0,No user reviews,0,0,0
1372400,True,0,No user reviews,0,0,0
1372410,True,0,No user reviews,0,0,0
1372440,True,0,No user reviews,0,0,0
1372450,True,0,No user reviews,0,0,0
1372480,True,0,No user reviews,0,0,0
1372490,True,0,1 user reviews,1,0,1
1372540,True,0,No user reviews,0,0,0
1372550,True,0,6 user reviews,2,4,6
1372560,True,0,No user reviews,0,0,0
1372570,True,0,4 user reviews,4,0,4
1372580,True,0,No user reviews,0,0,0
1372630,True,0,2 user reviews,2,0,2
1372640,True,0,No user reviews,0,0,0
1372650,True,0,No user reviews,0,0,0
1372670,True,0,No user reviews,0,0,0
1372680,True,0,No user reviews,0,0,0
1372690,True,0,No user reviews,0,0,0
1372700,True,0,No user reviews,0,0,0
1372710,True,0,No user reviews,0,0,0
1372740,True,0,No user reviews,0,0,0
1372760,True,0,No user reviews,0,0,0
1372770,True,0,No user reviews,0,0,0
1372780,True,0,No user reviews,0,0,0
1372790,True,0,No user reviews,0,0,0
1372791,True,0,No user reviews,0,0,0
1372800,True,0,No user reviews,0,0,0
1372820,True,0,No user reviews,0,0,0
1372840,True,0,No user reviews,0,0,0
1372870,True,0,No user reviews,0,0,0
1372910,True,0,No user reviews,0,0,0
1372970,True,0,No user reviews,0,0,0
1372980,True,0,No user reviews,0,0,0
1372990,True,0,4 user reviews,3,1,4
1373010,True,0,No user reviews,0,0,0
1373020,True,0,No user reviews,0,0,0
1373080,True,0,2 user reviews,2,0,2
1373100,True,0,No user reviews,0,0,0
1373110,True,0,No user reviews,0,0,0
1373120,True,0,No user reviews,0,0,0
1373130,True,0,No user reviews,0,0,0
1373150,True,0,No user reviews,0,0,0
1373160,True,0,No user reviews,0,0,0
1373170,True,0,3 user reviews,3,0,3
1373180,True,0,2 user reviews,2,0,2
1373220,True,5,Mixed,39,17,56
1373230,True,0,No user reviews,0,0,0
1373240,True,0,No user reviews,0,0,0
1373260,True,0,No user reviews,0,0,0
1373270,True,0,No user reviews,0,0,0
1373280,True,0,No user reviews,0,0,0
1373290,True,0,No user reviews,0,0,0
1373300,True,0,No user reviews,0,0,0
1373310,True,0,No user reviews,0,0,0
1373320,True,0,No user reviews,0,0,0
1373330,True,0,No user reviews,0,0,0
1373340,True,0,1 user reviews,1,0,1
1373370,True,0,No user reviews,0,0,0
1373380,True,0,2 user reviews,2,0,2
1373410,True,0,No user reviews,0,0,0
1373420,True,0,No user reviews,0,0,0
1373430,True,6,Mostly Positive,31,8,39
1373440,True,0,5 user reviews,5,0,5
1373450,True,0,No user reviews,0,0,0
1373500,True,0,No user reviews,0,0,0
1373530,True,0,No user reviews,0,0,0
1373570,True,0,No user reviews,0,0,0
1373580,True,0,No user reviews,0,0,0
1373600,True,0,No user reviews,0,0,0
1373630,True,0,3 user reviews,3,0,3
1373660,True,0,No user reviews,0,0,0
1373700,True,0,2 user reviews,2,0,2
1373710,True,0,No user reviews,0,0,0
1373730,True,0,No user reviews,0,0,0
1373740,True,0,4 user reviews,2,2,4
1373750,True,0,No user reviews,0,0,0
1373760,True,0,1 user reviews,1,0,1
1373770,True,0,No user reviews,0,0,0
1373780,True,0,4 user reviews,3,1,4
1373810,True,0,1 user reviews,0,1,1
1373820,True,0,3 user reviews,3,0,3
1373830,True,0,No user reviews,0,0,0
1373860,True,0,No user reviews,0,0,0
1373870,True,0,7 user reviews,6,1,7
1373890,True,0,No user reviews,0,0,0
1373920,True,0,No user reviews,0,0,0
1373930,True,0,No user reviews,0,0,0
1373950,True,0,No user reviews,0,0,0
1373960,True,0,No user reviews,0,0,0
1373980,True,0,No user reviews,0,0,0
1374010,True,0,No user reviews,0,0,0
1374040,True,0,No user reviews,0,0,0
1374050,True,7,Positive,10,0,10
1374090,True,0,No user reviews,0,0,0
1374150,True,0,No user reviews,0,0,0
1374170,True,0,No user reviews,0,0,0
1374180,True,0,No user reviews,0,0,0
1374190,True,0,No user reviews,0,0,0
1374200,True,0,6 user reviews,6,0,6
1374210,True,0,No user reviews,0,0,0
1374220,True,0,No user reviews,0,0,0
1374260,True,0,No user reviews,0,0,0
1374280,True,0,No user reviews,0,0,0
1374290,True,7,Positive,23,1,24
1374330,True,0,No user reviews,0,0,0
1374340,True,6,Mostly Positive,7,3,10
1374370,True,0,No user reviews,0,0,0
1374380,True,0,No user reviews,0,0,0
1374400,True,0,No user reviews,0,0,0
1374410,True,0,No user reviews,0,0,0
1374420,True,0,No user reviews,0,0,0
1374430,True,0,No user reviews,0,0,0
1374440,True,0,No user reviews,0,0,0
1374460,True,0,No user reviews,0,0,0
1374470,True,0,5 user reviews,4,1,5
1374500,True,0,1 user reviews,1,0,1
1374520,True,0,No user reviews,0,0,0
1374530,True,0,No user reviews,0,0,0
1374590,True,0,No user reviews,0,0,0
1374620,True,0,No user reviews,0,0,0
1374630,True,0,1 user reviews,1,0,1
1374640,True,0,No user reviews,0,0,0
1374650,True,0,No user reviews,0,0,0
1374660,True,0,No user reviews,0,0,0
1374700,True,0,No user reviews,0,0,0
1374710,True,0,No user reviews,0,0,0
1374720,True,7,Positive,34,6,40
1374730,True,0,No user reviews,0,0,0
1374731,True,0,No user reviews,0,0,0
1374732,True,0,No user reviews,0,0,0
1374733,True,0,No user reviews,0,0,0
1374734,True,0,No user reviews,0,0,0
1374735,True,0,No user reviews,0,0,0
1374740,True,0,3 user reviews,0,3,3
1374750,True,0,No user reviews,0,0,0
1374780,True,0,No user reviews,0,0,0
1374810,True,0,No user reviews,0,0,0
1374820,True,0,4 user reviews,2,2,4
1374860,True,0,No user reviews,0,0,0
1374890,True,0,No user reviews,0,0,0
1374900,True,0,3 user reviews,3,0,3
1374920,True,0,No user reviews,0,0,0
1374940,True,0,2 user reviews,2,0,2
1374980,True,0,No user reviews,0,0,0
1374990,True,0,No user reviews,0,0,0
1375000,True,0,No user reviews,0,0,0
1375020,True,0,No user reviews,0,0,0
1375030,True,0,No user reviews,0,0,0
1375040,True,0,No user reviews,0,0,0
1375090,True,0,No user reviews,0,0,0
1375100,True,0,No user reviews,0,0,0
1375110,True,0,No user reviews,0,0,0
1375120,True,0,No user reviews,0,0,0
1375160,True,0,No user reviews,0,0,0
1375190,True,0,1 user reviews,0,1,1
1375200,True,0,No user reviews,0,0,0
1375220,True,0,No user reviews,0,0,0
1375250,True,0,2 user reviews,2,0,2
1375270,True,0,3 user reviews,3,0,3
1375300,True,0,No user reviews,0,0,0
1375350,True,0,No user reviews,0,0,0
1375360,True,5,Mixed,7,6,13
1375361,True,0,4 user reviews,2,2,4
1375362,True,0,6 user reviews,3,3,6
1375363,True,5,Mixed,5,7,12
1375364,True,0,6 user reviews,4,2,6
1375365,True,0,2 user reviews,2,0,2
1375366,True,0,4 user reviews,3,1,4
1375367,True,0,2 user reviews,2,0,2
1375368,True,0,5 user reviews,1,4,5
1375369,True,0,5 user reviews,2,3,5
1375370,True,0,8 user reviews,3,5,8
1375420,True,0,No user reviews,0,0,0
1375430,True,0,No user reviews,0,0,0
1375440,True,0,No user reviews,0,0,0
1375450,True,0,5 user reviews,5,0,5
1375460,True,0,No user reviews,0,0,0
1375470,True,0,No user reviews,0,0,0
1375471,True,0,No user reviews,0,0,0
1375480,True,0,No user reviews,0,0,0
1375510,True,0,1 user reviews,1,0,1
1375520,True,0,1 user reviews,0,1,1
1375530,True,0,No user reviews,0,0,0
1375540,True,0,No user reviews,0,0,0
1375550,True,0,No user reviews,0,0,0
1375560,True,0,3 user reviews,3,0,3
1375590,True,0,No user reviews,0,0,0
1375600,True,0,No user reviews,0,0,0
1375610,True,0,3 user reviews,3,0,3
1375640,True,0,No user reviews,0,0,0
1375650,True,0,4 user reviews,4,0,4
1375670,True,0,No user reviews,0,0,0
1375680,True,0,No user reviews,0,0,0
1375690,True,0,2 user reviews,2,0,2
1375700,True,0,No user reviews,0,0,0
1375740,True,0,No user reviews,0,0,0
1375750,True,0,No user reviews,0,0,0
1375760,True,0,No user reviews,0,0,0
1375780,True,0,No user reviews,0,0,0
1375800,True,0,No user reviews,0,0,0
1375810,True,0,1 user reviews,1,0,1
1375820,True,0,No user reviews,0,0,0
1375850,True,0,No user reviews,0,0,0
1375870,True,6,Mostly Positive,13,4,17
1375880,True,0,3 user reviews,3,0,3
1375890,True,0,No user reviews,0,0,0
1375920,True,0,1 user reviews,1,0,1
1375930,True,0,3 user reviews,2,1,3
1375940,True,0,No user reviews,0,0,0
1375950,True,0,No user reviews,0,0,0
1375970,True,0,No user reviews,0,0,0
1375980,True,0,No user reviews,0,0,0
1376000,True,0,No user reviews,0,0,0
1376010,True,0,2 user reviews,1,1,2
1376020,True,0,No user reviews,0,0,0
1376040,True,0,5 user reviews,3,2,5
1376050,True,0,No user reviews,0,0,0
1376060,True,0,2 user reviews,2,0,2
1376070,True,0,No user reviews,0,0,0
1376090,True,0,No user reviews,0,0,0
1376100,True,0,No user reviews,0,0,0
1376130,True,0,No user reviews,0,0,0
1376140,True,0,No user reviews,0,0,0
1376170,True,0,No user reviews,0,0,0
1376180,True,0,No user reviews,0,0,0
1376190,True,0,No user reviews,0,0,0
1376220,True,0,2 user reviews,2,0,2
1376240,True,0,No user reviews,0,0,0
1376250,True,0,No user reviews,0,0,0
1376260,True,0,No user reviews,0,0,0
1376270,True,0,1 user reviews,1,0,1
1376280,True,0,No user reviews,0,0,0
1376290,True,0,No user reviews,0,0,0
1376300,True,0,2 user reviews,2,0,2
1376310,True,0,No user reviews,0,0,0
1376330,True,0,No user reviews,0,0,0
1376340,True,0,No user reviews,0,0,0
1376350,True,0,1 user reviews,1,0,1
1376360,True,0,3 user reviews,2,1,3
1376370,True,0,No user reviews,0,0,0
1376380,True,0,No user reviews,0,0,0
1376400,True,0,No user reviews,0,0,0
1376410,True,0,No user reviews,0,0,0
1376420,True,0,No user reviews,0,0,0
1376440,True,0,No user reviews,0,0,0
1376470,True,0,2 user reviews,0,2,2
1376480,True,0,No user reviews,0,0,0
1376490,True,0,No user reviews,0,0,0
1376500,True,0,No user reviews,0,0,0
1376510,True,0,No user reviews,0,0,0
1376520,True,0,6 user reviews,6,0,6
1376530,True,0,No user reviews,0,0,0
1376550,True,0,No user reviews,0,0,0
1376570,True,0,1 user reviews,1,0,1
1376590,True,0,No user reviews,0,0,0
1376600,True,0,No user reviews,0,0,0
1376630,True,0,No user reviews,0,0,0
1376640,True,0,5 user reviews,5,0,5
1376680,True,0,No user reviews,0,0,0
1376690,True,0,2 user reviews,2,0,2
1376720,True,0,No user reviews,0,0,0
1376730,True,0,No user reviews,0,0,0
1376750,True,0,No user reviews,0,0,0
1376760,True,0,No user reviews,0,0,0
1376770,True,0,No user reviews,0,0,0
1376780,True,0,No user reviews,0,0,0
1376800,True,0,No user reviews,0,0,0
1376820,True,0,1 user reviews,1,0,1
1376830,True,0,7 user reviews,6,1,7
1376840,True,0,No user reviews,0,0,0
1376870,True,0,No user reviews,0,0,0
1376890,True,0,No user reviews,0,0,0
1376900,True,0,No user reviews,0,0,0
1376910,True,0,No user reviews,0,0,0
1376920,True,0,2 user reviews,0,2,2
1376930,True,0,No user reviews,0,0,0
1376940,True,0,3 user reviews,3,0,3
1376950,True,0,No user reviews,0,0,0
1376970,True,0,No user reviews,0,0,0
1376971,True,0,No user reviews,0,0,0
1376972,True,0,No user reviews,0,0,0
1376973,True,0,No user reviews,0,0,0
1376974,True,0,No user reviews,0,0,0
1377000,True,0,No user reviews,0,0,0
1377010,True,0,No user reviews,0,0,0
1377030,True,0,No user reviews,0,0,0
1377060,True,0,No user reviews,0,0,0
1377080,True,0,4 user reviews,4,0,4
1377090,True,0,No user reviews,0,0,0
1377100,True,0,2 user reviews,2,0,2
1377110,True,0,No user reviews,0,0,0
1377120,True,0,No user reviews,0,0,0
1377140,True,0,2 user reviews,0,2,2
1377150,True,0,No user reviews,0,0,0
1377160,True,0,No user reviews,0,0,0
1377200,True,0,No user reviews,0,0,0
1377210,True,0,No user reviews,0,0,0
1377220,True,0,No user reviews,0,0,0
1377240,True,0,3 user reviews,3,0,3
1377260,True,7,Positive,45,2,47
1377280,True,0,2 user reviews,1,1,2
1377300,True,0,No user reviews,0,0,0
1377320,True,0,No user reviews,0,0,0
1377330,True,0,3 user reviews,3,0,3
1377340,True,0,No user reviews,0,0,0
1377350,True,0,No user reviews,0,0,0
1377360,True,7,Positive,37,1,38
1377370,True,0,No user reviews,0,0,0
1377380,True,8,Very Positive,797,120,917
1377400,True,0,No user reviews,0,0,0
1377420,True,0,1 user reviews,1,0,1
1377430,True,0,No user reviews,0,0,0
1377450,True,0,No user reviews,0,0,0
1377460,True,0,No user reviews,0,0,0
1377530,True,0,7 user reviews,7,0,7
1377540,True,7,Positive,35,5,40
1377550,True,0,No user reviews,0,0,0
1377560,True,0,No user reviews,0,0,0
1377570,True,0,No user reviews,0,0,0
1377580,True,0,No user reviews,0,0,0
1377590,True,0,3 user reviews,2,1,3
1377600,True,0,No user reviews,0,0,0
1377650,True,0,6 user reviews,6,0,6
1377660,True,0,No user reviews,0,0,0
1377670,True,0,No user reviews,0,0,0
1377680,True,0,2 user reviews,2,0,2
1377690,True,0,2 user reviews,2,0,2
1377710,True,0,No user reviews,0,0,0
1377720,True,0,No user reviews,0,0,0
1377730,True,0,No user reviews,0,0,0
1377740,True,0,No user reviews,0,0,0
1377750,True,0,No user reviews,0,0,0
1377780,True,0,No user reviews,0,0,0
1377790,True,0,No user reviews,0,0,0
1377830,True,0,No user reviews,0,0,0
1377850,True,0,3 user reviews,2,1,3
1377860,True,0,No user reviews,0,0,0
1377870,True,0,No user reviews,0,0,0
1377880,True,0,No user reviews,0,0,0
1377900,True,0,3 user reviews,3,0,3
1377910,True,0,No user reviews,0,0,0
1377920,True,0,2 user reviews,2,0,2
1377930,True,0,3 user reviews,3,0,3
1377950,True,0,No user reviews,0,0,0
1377960,True,0,No user reviews,0,0,0
1377970,True,0,1 user reviews,1,0,1
1377980,True,0,No user reviews,0,0,0
1378010,True,0,No user reviews,0,0,0
1378040,True,0,No user reviews,0,0,0
1378080,True,0,No user reviews,0,0,0
1378100,True,0,No user reviews,0,0,0
1378120,True,0,1 user reviews,1,0,1
1378130,True,0,No user reviews,0,0,0
1378140,True,0,7 user reviews,6,1,7
1378170,True,0,8 user reviews,5,3,8
1378180,True,0,No user reviews,0,0,0
1378190,True,0,No user reviews,0,0,0
1378191,True,0,No user reviews,0,0,0
1378192,True,0,No user reviews,0,0,0
1378193,True,0,No user reviews,0,0,0
1378194,True,0,No user reviews,0,0,0
1378195,True,0,1 user reviews,1,0,1
1378196,True,0,No user reviews,0,0,0
1378197,True,0,No user reviews,0,0,0
1378198,True,0,No user reviews,0,0,0
1378200,True,0,No user reviews,0,0,0
1378230,True,0,No user reviews,0,0,0
1378250,True,0,1 user reviews,1,0,1
1378270,True,0,No user reviews,0,0,0
1378280,True,0,No user reviews,0,0,0
1378290,True,8,Very Positive,116,16,132
1378300,True,0,No user reviews,0,0,0
1378320,True,0,1 user reviews,0,1,1
1378330,True,0,6 user reviews,6,0,6
1378340,True,0,No user reviews,0,0,0
1378341,True,0,No user reviews,0,0,0
1378342,True,0,No user reviews,0,0,0
1378343,True,0,No user reviews,0,0,0
1378344,True,0,No user reviews,0,0,0
1378350,True,0,No user reviews,0,0,0
1378360,True,0,No user reviews,0,0,0
1378370,True,0,No user reviews,0,0,0
1378390,True,0,No user reviews,0,0,0
1378420,True,0,No user reviews,0,0,0
1378430,True,0,No user reviews,0,0,0
1378440,True,0,No user reviews,0,0,0
1378450,True,0,No user reviews,0,0,0
1378460,True,0,No user reviews,0,0,0
1378470,True,0,No user reviews,0,0,0
1378490,True,0,No user reviews,0,0,0
1378510,True,0,No user reviews,0,0,0
1378520,True,0,No user reviews,0,0,0
1378530,True,0,No user reviews,0,0,0
1378540,True,0,No user reviews,0,0,0
1378560,True,0,2 user reviews,2,0,2
1378580,True,0,No user reviews,0,0,0
1378600,True,0,No user reviews,0,0,0
1378610,True,0,No user reviews,0,0,0
1378620,True,0,No user reviews,0,0,0
1378640,True,0,No user reviews,0,0,0
1378650,True,0,5 user reviews,4,1,5
1378660,True,0,No user reviews,0,0,0
1378680,True,0,No user reviews,0,0,0
1378690,True,0,No user reviews,0,0,0
1378700,True,0,3 user reviews,1,2,3
1378720,True,0,No user reviews,0,0,0
1378730,True,0,No user reviews,0,0,0
1378740,True,0,No user reviews,0,0,0
1378750,True,0,No user reviews,0,0,0
1378760,True,0,1 user reviews,1,0,1
1378770,True,0,No user reviews,0,0,0
1378780,True,0,No user reviews,0,0,0
1378800,True,0,No user reviews,0,0,0
1378810,True,0,1 user reviews,0,1,1
1378820,True,0,1 user reviews,1,0,1
1378840,True,0,1 user reviews,1,0,1
1378850,True,0,1 user reviews,0,1,1
1378860,True,6,Mostly Positive,9,3,12
1378870,True,0,No user reviews,0,0,0
1378890,True,0,No user reviews,0,0,0
1378940,True,0,5 user reviews,5,0,5
1378960,True,0,No user reviews,0,0,0
1378970,True,0,No user reviews,0,0,0
1378980,True,0,No user reviews,0,0,0
1379010,True,0,No user reviews,0,0,0
1379020,True,8,Very Positive,166,9,175
1379040,True,0,No user reviews,0,0,0
1379050,True,0,No user reviews,0,0,0
1379070,True,0,No user reviews,0,0,0
1379080,True,0,No user reviews,0,0,0
1379090,True,0,No user reviews,0,0,0
1379100,True,0,No user reviews,0,0,0
1379110,True,7,Positive,15,3,18
1379130,True,0,No user reviews,0,0,0
1379150,True,0,1 user reviews,0,1,1
1379160,True,0,No user reviews,0,0,0
1379170,True,0,3 user reviews,3,0,3
1379180,True,0,No user reviews,0,0,0
1379200,True,7,Positive,9,2,11
1379220,True,0,No user reviews,0,0,0
1379221,True,0,No user reviews,0,0,0
1379222,True,0,1 user reviews,1,0,1
1379250,True,0,No user reviews,0,0,0
1379261,True,0,No user reviews,0,0,0
1379270,True,0,No user reviews,0,0,0
1379280,True,0,No user reviews,0,0,0
1379300,True,0,No user reviews,0,0,0
1379310,True,0,No user reviews,0,0,0
1379311,True,0,No user reviews,0,0,0
1379330,True,0,1 user reviews,1,0,1
1379340,True,0,No user reviews,0,0,0
1379350,True,0,No user reviews,0,0,0
1379370,True,0,2 user reviews,2,0,2
1379380,True,7,Positive,12,0,12
1379390,True,0,No user reviews,0,0,0
1379420,True,0,1 user reviews,1,0,1
1379440,True,0,No user reviews,0,0,0
1379450,True,0,1 user reviews,1,0,1
1379460,True,0,No user reviews,0,0,0
1379470,True,0,1 user reviews,1,0,1
1379480,True,0,No user reviews,0,0,0
1379550,True,0,No user reviews,0,0,0
1379570,True,0,1 user reviews,1,0,1
1379580,True,0,No user reviews,0,0,0
1379590,True,0,No user reviews,0,0,0
1379600,True,0,No user reviews,0,0,0
1379630,True,0,No user reviews,0,0,0
1379640,True,0,No user reviews,0,0,0
1379660,True,0,9 user reviews,9,0,9
1379670,True,0,No user reviews,0,0,0
1379680,True,0,No user reviews,0,0,0
1379690,True,0,No user reviews,0,0,0
1379700,True,0,No user reviews,0,0,0
1379720,True,0,No user reviews,0,0,0
1379740,True,0,No user reviews,0,0,0
1379800,True,0,No user reviews,0,0,0
1379830,True,0,No user reviews,0,0,0
1379840,True,0,No user reviews,0,0,0
1379860,True,0,No user reviews,0,0,0
1379870,True,0,No user reviews,0,0,0
1379900,True,0,No user reviews,0,0,0
1379910,True,0,No user reviews,0,0,0
1379920,True,0,No user reviews,0,0,0
1379930,True,5,Mixed,21,12,33
1379940,True,0,No user reviews,0,0,0
1379950,True,0,No user reviews,0,0,0
1379960,True,0,No user reviews,0,0,0
1379970,True,5,Mixed,10,8,18
1379980,True,0,No user reviews,0,0,0
1380010,True,7,Positive,22,1,23
1380020,True,0,No user reviews,0,0,0
1380021,True,0,No user reviews,0,0,0
1380022,True,0,No user reviews,0,0,0
1380023,True,0,No user reviews,0,0,0
1380024,True,0,No user reviews,0,0,0
1380025,True,0,No user reviews,0,0,0
1380030,True,0,1 user reviews,1,0,1
1380040,True,0,3 user reviews,3,0,3
1380080,True,0,No user reviews,0,0,0
1380090,True,0,No user reviews,0,0,0
1380100,True,0,No user reviews,0,0,0
1380110,True,0,1 user reviews,0,1,1
1380120,True,0,No user reviews,0,0,0
1380140,True,0,No user reviews,0,0,0
1380150,True,0,No user reviews,0,0,0
1380170,True,0,2 user reviews,2,0,2
1380210,True,0,No user reviews,0,0,0
1380220,True,0,No user reviews,0,0,0
1380240,True,0,No user reviews,0,0,0
1380250,True,0,1 user reviews,0,1,1
1380260,True,0,2 user reviews,2,0,2
1380270,True,0,No user reviews,0,0,0
1380290,True,0,No user reviews,0,0,0
1380310,True,0,No user reviews,0,0,0
1380320,True,0,No user reviews,0,0,0
1380340,True,0,No user reviews,0,0,0
1380360,True,0,2 user reviews,2,0,2
1380390,True,8,Very Positive,133,4,137
1380400,True,0,No user reviews,0,0,0
1380430,True,0,No user reviews,0,0,0
1380470,True,0,No user reviews,0,0,0
1380490,True,0,No user reviews,0,0,0
1380500,True,0,No user reviews,0,0,0
1380510,True,0,No user reviews,0,0,0
1380520,True,0,No user reviews,0,0,0
1380550,True,0,No user reviews,0,0,0
1380570,True,0,No user reviews,0,0,0
1380580,True,0,No user reviews,0,0,0
1380590,True,0,No user reviews,0,0,0
1380600,True,0,No user reviews,0,0,0
1380620,True,0,7 user reviews,2,5,7
1380630,True,0,No user reviews,0,0,0
1380640,True,0,No user reviews,0,0,0
1380650,True,0,No user reviews,0,0,0
1380660,True,0,No user reviews,0,0,0
1380720,True,0,No user reviews,0,0,0
1380760,True,0,No user reviews,0,0,0
1380780,True,0,No user reviews,0,0,0
1380820,True,0,1 user reviews,1,0,1
1380840,True,0,4 user reviews,4,0,4
1380850,True,0,No user reviews,0,0,0
1380860,True,0,No user reviews,0,0,0
1380870,True,0,No user reviews,0,0,0
1380890,True,0,No user reviews,0,0,0
1380910,True,0,No user reviews,0,0,0
1380920,True,0,No user reviews,0,0,0
1380930,True,0,No user reviews,0,0,0
1380950,True,0,No user reviews,0,0,0
1380960,True,0,No user reviews,0,0,0
1380980,True,0,No user reviews,0,0,0
1380990,True,0,No user reviews,0,0,0
1381070,True,0,8 user reviews,7,1,8
1381140,True,0,No user reviews,0,0,0
1381150,True,0,1 user reviews,0,1,1
1381160,True,0,No user reviews,0,0,0
1381170,True,0,No user reviews,0,0,0
1381180,True,0,No user reviews,0,0,0
1381250,True,0,No user reviews,0,0,0
1381260,True,0,No user reviews,0,0,0
1381270,True,0,No user reviews,0,0,0
1381280,True,0,1 user reviews,1,0,1
1381290,True,0,8 user reviews,7,1,8
1381300,True,0,No user reviews,0,0,0
1381330,True,0,No user reviews,0,0,0
1381340,True,0,No user reviews,0,0,0
1381350,True,0,No user reviews,0,0,0
1381370,True,0,No user reviews,0,0,0
1381390,True,0,No user reviews,0,0,0
1381410,True,0,No user reviews,0,0,0
1381420,True,0,No user reviews,0,0,0
1381450,True,0,No user reviews,0,0,0
1381460,True,0,No user reviews,0,0,0
1381480,True,0,3 user reviews,1,2,3
1381500,True,0,4 user reviews,4,0,4
1381520,True,0,No user reviews,0,0,0
1381530,True,0,No user reviews,0,0,0
1381540,True,0,No user reviews,0,0,0
1381570,True,0,No user reviews,0,0,0
1381580,True,0,No user reviews,0,0,0
1381590,True,0,No user reviews,0,0,0
1381610,True,0,2 user reviews,0,2,2
1381620,True,0,No user reviews,0,0,0
1381630,True,0,No user reviews,0,0,0
1381640,True,0,4 user reviews,4,0,4
1381690,True,0,1 user reviews,0,1,1
1381700,True,0,No user reviews,0,0,0
1381720,True,0,No user reviews,0,0,0
1381730,True,0,No user reviews,0,0,0
1381750,True,0,No user reviews,0,0,0
1381770,True,0,1 user reviews,1,0,1
1381780,True,0,No user reviews,0,0,0
1381790,True,0,1 user reviews,1,0,1
1381791,True,0,1 user reviews,1,0,1
1381800,True,0,1 user reviews,1,0,1
1381820,True,0,No user reviews,0,0,0
1381850,True,0,No user reviews,0,0,0
1381860,True,0,1 user reviews,1,0,1
1381870,True,0,No user reviews,0,0,0
1381880,True,0,5 user reviews,5,0,5
1381890,True,0,No user reviews,0,0,0
1381900,True,0,No user reviews,0,0,0
1381910,True,0,No user reviews,0,0,0
1381920,True,0,No user reviews,0,0,0
1381940,True,0,No user reviews,0,0,0
1381960,True,0,No user reviews,0,0,0
1381980,True,7,Positive,40,5,45
1382020,True,0,No user reviews,0,0,0
1382040,True,0,2 user reviews,0,2,2
1382050,True,0,No user reviews,0,0,0
1382060,True,0,No user reviews,0,0,0
1382140,True,7,Positive,10,0,10
1382150,True,0,No user reviews,0,0,0
1382180,True,0,1 user reviews,1,0,1
1382200,True,0,No user reviews,0,0,0
1382210,True,5,Mixed,11,5,16
1382220,True,6,Mostly Positive,10,3,13
1382230,True,0,No user reviews,0,0,0
1382241,True,5,Mixed,11,7,18
1382260,True,0,No user reviews,0,0,0
1382290,True,0,No user reviews,0,0,0
1382310,True,0,No user reviews,0,0,0
1382320,True,0,No user reviews,0,0,0
1382340,True,0,No user reviews,0,0,0
1382350,True,0,No user reviews,0,0,0
1382370,True,0,4 user reviews,4,0,4
1382380,True,0,No user reviews,0,0,0
1382390,True,0,No user reviews,0,0,0
1382400,True,0,No user reviews,0,0,0
1382420,True,0,No user reviews,0,0,0
1382440,True,0,No user reviews,0,0,0
1382450,True,0,No user reviews,0,0,0
1382470,True,0,No user reviews,0,0,0
1382490,True,0,No user reviews,0,0,0
1382520,True,0,No user reviews,0,0,0
1382530,True,0,7 user reviews,4,3,7
1382550,True,0,No user reviews,0,0,0
1382560,True,0,4 user reviews,4,0,4
1382580,True,0,No user reviews,0,0,0
1382590,True,0,No user reviews,0,0,0
1382591,True,0,No user reviews,0,0,0
1382592,True,0,No user reviews,0,0,0
1382593,True,0,No user reviews,0,0,0
1382600,True,0,No user reviews,0,0,0
1382610,True,0,No user reviews,0,0,0
1382611,True,0,No user reviews,0,0,0
1382612,True,0,No user reviews,0,0,0
1382613,True,0,No user reviews,0,0,0
1382630,True,0,No user reviews,0,0,0
1382670,True,0,No user reviews,0,0,0
1382700,True,0,1 user reviews,1,0,1
1382710,True,0,No user reviews,0,0,0
1382730,True,0,4 user reviews,4,0,4
1382740,True,0,No user reviews,0,0,0
1382760,True,0,No user reviews,0,0,0
1382770,True,0,No user reviews,0,0,0
1382780,True,0,No user reviews,0,0,0
1382800,True,0,No user reviews,0,0,0
1382820,True,0,No user reviews,0,0,0
1382840,True,0,7 user reviews,4,3,7
1382860,True,0,No user reviews,0,0,0
1382890,True,0,No user reviews,0,0,0
1382900,True,0,No user reviews,0,0,0
1382910,True,0,No user reviews,0,0,0
1382920,True,0,1 user reviews,0,1,1
1382930,True,0,No user reviews,0,0,0
1382940,True,0,9 user reviews,7,2,9
1382960,True,0,No user reviews,0,0,0
1382980,True,0,No user reviews,0,0,0
1383000,True,0,No user reviews,0,0,0
1383010,True,0,1 user reviews,1,0,1
1383030,True,0,6 user reviews,1,5,6
1383050,True,7,Positive,31,2,33
1383060,True,0,No user reviews,0,0,0
1383120,True,0,1 user reviews,0,1,1
1383130,True,0,No user reviews,0,0,0
1383140,True,0,No user reviews,0,0,0
1383170,True,0,1 user reviews,1,0,1
1383180,True,0,6 user reviews,6,0,6
1383200,True,0,No user reviews,0,0,0
1383210,True,0,No user reviews,0,0,0
1383220,True,0,No user reviews,0,0,0
1383230,True,0,4 user reviews,3,1,4
1383260,True,0,No user reviews,0,0,0
1383270,True,0,No user reviews,0,0,0
1383280,True,0,No user reviews,0,0,0
1383290,True,0,No user reviews,0,0,0
1383310,True,0,No user reviews,0,0,0
1383320,True,0,No user reviews,0,0,0
1383340,True,0,3 user reviews,2,1,3
1383350,True,0,No user reviews,0,0,0
1383360,True,0,No user reviews,0,0,0
1383370,True,0,No user reviews,0,0,0
1383380,True,0,No user reviews,0,0,0
1383400,True,0,No user reviews,0,0,0
1383410,True,0,2 user reviews,2,0,2
1383420,True,0,No user reviews,0,0,0
1383440,True,0,No user reviews,0,0,0
1383450,True,0,2 user reviews,1,1,2
1383460,True,0,No user reviews,0,0,0
1383480,True,0,No user reviews,0,0,0
1383490,True,0,No user reviews,0,0,0
1383500,True,0,No user reviews,0,0,0
1383510,True,0,No user reviews,0,0,0
1383530,True,0,No user reviews,0,0,0
1383560,True,0,No user reviews,0,0,0
1383590,True,0,No user reviews,0,0,0
1383600,True,0,No user reviews,0,0,0
1383610,True,0,No user reviews,0,0,0
1383630,True,7,Positive,18,1,19
1383660,True,0,No user reviews,0,0,0
1383670,True,0,No user reviews,0,0,0
1383690,True,0,No user reviews,0,0,0
1383710,True,0,No user reviews,0,0,0
1383720,True,7,Positive,19,0,19
1383730,True,0,No user reviews,0,0,0
1383740,True,0,6 user reviews,5,1,6
1383770,True,0,No user reviews,0,0,0
1383780,True,0,2 user reviews,0,2,2
1383790,True,0,No user reviews,0,0,0
1383791,True,0,No user reviews,0,0,0
1383792,True,0,No user reviews,0,0,0
1383802,True,0,No user reviews,0,0,0
1383803,True,0,No user reviews,0,0,0
1383804,True,0,No user reviews,0,0,0
1383820,True,0,No user reviews,0,0,0
1383830,True,0,1 user reviews,1,0,1
1383850,True,0,1 user reviews,1,0,1
1383880,True,7,Positive,11,0,11
1383900,True,0,1 user reviews,1,0,1
1383920,True,0,3 user reviews,3,0,3
1383930,True,0,No user reviews,0,0,0
1383950,True,0,No user reviews,0,0,0
1383960,True,0,No user reviews,0,0,0
1383990,True,0,6 user reviews,1,5,6
1384000,True,0,No user reviews,0,0,0
1384010,True,0,No user reviews,0,0,0
1384030,True,0,No user reviews,0,0,0
1384050,True,0,No user reviews,0,0,0
1384060,True,0,No user reviews,0,0,0
1384090,True,0,1 user reviews,1,0,1
1384100,True,0,No user reviews,0,0,0
1384110,True,0,No user reviews,0,0,0
1384130,True,0,No user reviews,0,0,0
1384140,True,0,No user reviews,0,0,0
1384150,True,0,No user reviews,0,0,0
1384230,True,0,No user reviews,0,0,0
1384240,True,0,No user reviews,0,0,0
1384270,True,0,No user reviews,0,0,0
1384280,True,0,No user reviews,0,0,0
1384290,True,0,No user reviews,0,0,0
1384320,True,0,No user reviews,0,0,0
1384330,True,0,No user reviews,0,0,0
1384340,True,0,No user reviews,0,0,0
1384350,True,0,No user reviews,0,0,0
1384380,True,0,1 user reviews,1,0,1
1384390,True,0,4 user reviews,2,2,4
1384400,True,0,No user reviews,0,0,0
1384410,True,0,No user reviews,0,0,0
1384440,True,0,1 user reviews,0,1,1
1384450,True,0,No user reviews,0,0,0
1384460,True,0,No user reviews,0,0,0
1384470,True,0,No user reviews,0,0,0
1384480,True,0,1 user reviews,1,0,1
1384490,True,0,No user reviews,0,0,0
1384500,True,0,1 user reviews,1,0,1
1384510,True,0,No user reviews,0,0,0
1384520,True,0,No user reviews,0,0,0
1384540,True,0,7 user reviews,4,3,7
1384550,True,0,No user reviews,0,0,0
1384570,True,0,No user reviews,0,0,0
1384610,True,0,No user reviews,0,0,0
1384620,True,0,No user reviews,0,0,0
1384630,True,5,Mixed,37,23,60
1384640,True,0,No user reviews,0,0,0
1384670,True,0,1 user reviews,1,0,1
1384680,True,0,No user reviews,0,0,0
1384700,True,7,Positive,9,2,11
1384730,True,0,No user reviews,0,0,0
1384740,True,0,No user reviews,0,0,0
1384760,True,0,No user reviews,0,0,0
1384770,True,8,Very Positive,275,34,309
1384780,True,0,7 user reviews,7,0,7
1384790,True,0,8 user reviews,4,4,8
1384820,True,0,No user reviews,0,0,0
1384840,True,0,No user reviews,0,0,0
1384850,True,0,No user reviews,0,0,0
1384870,True,0,No user reviews,0,0,0
1384880,True,0,No user reviews,0,0,0
1384890,True,0,No user reviews,0,0,0
1384910,True,0,No user reviews,0,0,0
1384960,True,7,Positive,13,1,14
1384970,True,0,No user reviews,0,0,0
1384990,True,0,No user reviews,0,0,0
1385000,True,0,No user reviews,0,0,0
1385010,True,0,No user reviews,0,0,0
1385020,True,0,No user reviews,0,0,0
1385040,True,0,No user reviews,0,0,0
1385050,True,0,1 user reviews,1,0,1
1385060,True,0,No user reviews,0,0,0
1385070,True,0,No user reviews,0,0,0
1385090,True,0,1 user reviews,0,1,1
1385100,True,0,No user reviews,0,0,0
1385110,True,4,Mostly Negative,6,10,16
1385180,True,0,No user reviews,0,0,0
1385190,True,0,No user reviews,0,0,0
1385200,True,0,No user reviews,0,0,0
1385210,True,0,No user reviews,0,0,0
1385230,True,0,No user reviews,0,0,0
1385240,True,0,No user reviews,0,0,0
1385280,True,0,No user reviews,0,0,0
1385290,True,0,No user reviews,0,0,0
1385310,True,0,No user reviews,0,0,0
1385320,True,0,No user reviews,0,0,0
1385350,True,0,No user reviews,0,0,0
1385360,True,0,No user reviews,0,0,0
1385370,True,0,No user reviews,0,0,0
1385380,True,0,No user reviews,0,0,0
1385400,True,0,No user reviews,0,0,0
1385460,True,0,No user reviews,0,0,0
1385470,True,0,No user reviews,0,0,0
1385480,True,0,1 user reviews,0,1,1
1385490,True,0,No user reviews,0,0,0
1385510,True,0,No user reviews,0,0,0
1385520,True,0,No user reviews,0,0,0
1385540,True,0,No user reviews,0,0,0
1385570,True,0,1 user reviews,1,0,1
1385580,True,0,No user reviews,0,0,0
1385590,True,0,No user reviews,0,0,0
1385620,True,0,No user reviews,0,0,0
1385650,True,0,No user reviews,0,0,0
1385670,True,0,3 user reviews,3,0,3
1385690,True,0,No user reviews,0,0,0
1385700,True,0,No user reviews,0,0,0
1385730,True,7,Positive,19,0,19
1385740,True,0,No user reviews,0,0,0
1385750,True,0,No user reviews,0,0,0
1385760,True,0,1 user reviews,0,1,1
1385780,True,0,4 user reviews,3,1,4
1385790,True,0,No user reviews,0,0,0
1385810,True,0,3 user reviews,3,0,3
1385820,True,0,No user reviews,0,0,0
1385830,True,0,No user reviews,0,0,0
1385840,True,0,No user reviews,0,0,0
1385850,True,0,3 user reviews,3,0,3
1385860,True,0,No user reviews,0,0,0
1385870,True,0,No user reviews,0,0,0
1385880,True,0,No user reviews,0,0,0
1385920,True,0,No user reviews,0,0,0
1385930,True,0,2 user reviews,0,2,2
1385931,True,0,No user reviews,0,0,0
1385950,True,0,No user reviews,0,0,0
1385960,True,0,5 user reviews,5,0,5
1385970,True,0,3 user reviews,2,1,3
1385980,True,0,No user reviews,0,0,0
1385990,True,0,1 user reviews,1,0,1
1386000,True,0,No user reviews,0,0,0
1386010,True,0,No user reviews,0,0,0
1386020,True,0,No user reviews,0,0,0
1386040,True,0,No user reviews,0,0,0
1386070,True,0,No user reviews,0,0,0
1386090,True,0,No user reviews,0,0,0
1386110,True,0,No user reviews,0,0,0
1386120,True,0,No user reviews,0,0,0
1386140,True,0,No user reviews,0,0,0
1386160,True,0,No user reviews,0,0,0
1386190,True,0,2 user reviews,2,0,2
1386200,True,0,5 user reviews,5,0,5
1386210,True,0,No user reviews,0,0,0
1386220,True,0,No user reviews,0,0,0
1386240,True,0,No user reviews,0,0,0
1386250,True,0,No user reviews,0,0,0
1386260,True,0,No user reviews,0,0,0
1386270,True,0,No user reviews,0,0,0
1386280,True,0,No user reviews,0,0,0
1386300,True,0,No user reviews,0,0,0
1386320,True,0,No user reviews,0,0,0
1386330,True,0,2 user reviews,1,1,2
1386360,True,0,No user reviews,0,0,0
1386370,True,0,No user reviews,0,0,0
1386390,True,0,No user reviews,0,0,0
1386420,True,0,No user reviews,0,0,0
1386440,True,7,Positive,15,2,17
1386460,True,0,No user reviews,0,0,0
1386470,True,0,No user reviews,0,0,0
1386500,True,0,No user reviews,0,0,0
1386510,True,0,No user reviews,0,0,0
1386530,True,0,No user reviews,0,0,0
1386540,True,0,3 user reviews,3,0,3
1386550,True,0,No user reviews,0,0,0
1386560,True,0,No user reviews,0,0,0
1386600,True,7,Positive,11,0,11
1386610,True,0,1 user reviews,1,0,1
1386611,True,0,2 user reviews,2,0,2
1386612,True,0,4 user reviews,4,0,4
1386613,True,0,No user reviews,0,0,0
1386614,True,0,No user reviews,0,0,0
1386615,True,0,No user reviews,0,0,0
1386616,True,0,No user reviews,0,0,0
1386620,True,0,No user reviews,0,0,0
1386630,True,0,No user reviews,0,0,0
1386640,True,0,No user reviews,0,0,0
1386660,True,0,No user reviews,0,0,0
1386680,True,0,No user reviews,0,0,0
1386690,True,0,No user reviews,0,0,0
1386700,True,0,1 user reviews,1,0,1
1386710,True,0,2 user reviews,2,0,2
1386730,True,7,Positive,29,1,30
1386740,True,0,No user reviews,0,0,0
1386770,True,0,No user reviews,0,0,0
1386780,True,0,No user reviews,0,0,0
1386790,True,0,No user reviews,0,0,0
1386810,True,0,1 user reviews,1,0,1
1386820,True,0,No user reviews,0,0,0
1386830,True,0,No user reviews,0,0,0
1386840,True,0,2 user reviews,1,1,2
1386870,True,0,No user reviews,0,0,0
1386900,True,0,No user reviews,0,0,0
1386910,True,0,2 user reviews,1,1,2
1386930,True,0,1 user reviews,1,0,1
1386950,True,0,No user reviews,0,0,0
1386960,True,0,No user reviews,0,0,0
1386980,True,5,Mixed,17,17,34
1386990,True,0,5 user reviews,4,1,5
1387000,True,0,No user reviews,0,0,0
1387010,True,0,5 user reviews,5,0,5
1387030,True,0,4 user reviews,4,0,4
1387060,True,0,4 user reviews,3,1,4
1387105,True,0,No user reviews,0,0,0
1387110,True,0,No user reviews,0,0,0
1387150,True,0,3 user reviews,2,1,3
1387170,True,0,5 user reviews,3,2,5
1387190,True,0,No user reviews,0,0,0
1387200,True,0,No user reviews,0,0,0
1387250,True,0,1 user reviews,1,0,1
1387290,True,5,Mixed,10,8,18
1387310,True,0,No user reviews,0,0,0
1387320,True,0,No user reviews,0,0,0
1387330,True,0,No user reviews,0,0,0
1387340,True,0,1 user reviews,1,0,1
1387350,True,0,No user reviews,0,0,0
1387380,True,0,No user reviews,0,0,0
1387390,True,0,No user reviews,0,0,0
1387400,True,0,No user reviews,0,0,0
1387410,True,0,No user reviews,0,0,0
1387430,True,0,No user reviews,0,0,0
1387450,True,0,No user reviews,0,0,0
1387460,True,0,No user reviews,0,0,0
1387470,True,0,No user reviews,0,0,0
1387480,True,0,No user reviews,0,0,0
1387500,True,0,No user reviews,0,0,0
1387510,True,0,No user reviews,0,0,0
1387540,True,0,No user reviews,0,0,0
1387550,True,0,No user reviews,0,0,0
1387560,True,0,1 user reviews,1,0,1
1387570,True,0,No user reviews,0,0,0
1387580,True,0,No user reviews,0,0,0
1387590,True,0,No user reviews,0,0,0
1387610,True,0,5 user reviews,4,1,5
1387620,True,0,1 user reviews,1,0,1
1387640,True,0,No user reviews,0,0,0
1387660,True,0,No user reviews,0,0,0
1387670,True,0,No user reviews,0,0,0
1387680,True,0,No user reviews,0,0,0
1387690,True,0,No user reviews,0,0,0
1387700,True,0,No user reviews,0,0,0
1387710,True,0,No user reviews,0,0,0
1387720,True,0,No user reviews,0,0,0
1387730,True,0,No user reviews,0,0,0
1387740,True,0,No user reviews,0,0,0
1387750,True,0,No user reviews,0,0,0
1387760,True,0,No user reviews,0,0,0
1387830,True,0,2 user reviews,0,2,2
1387850,True,0,1 user reviews,0,1,1
1387870,True,0,No user reviews,0,0,0
1387890,True,0,No user reviews,0,0,0
1387900,True,0,No user reviews,0,0,0
1387910,True,0,No user reviews,0,0,0
1387920,True,0,No user reviews,0,0,0
1387921,True,0,No user reviews,0,0,0
1387940,True,0,No user reviews,0,0,0
1387950,True,0,No user reviews,0,0,0
1387960,True,0,No user reviews,0,0,0
1387970,True,0,No user reviews,0,0,0
1387980,True,0,1 user reviews,1,0,1
1387990,True,0,No user reviews,0,0,0
1388010,True,0,No user reviews,0,0,0
1388030,True,0,2 user reviews,1,1,2
1388090,True,0,2 user reviews,2,0,2
1388110,True,0,No user reviews,0,0,0
1388120,True,0,No user reviews,0,0,0
1388130,True,0,1 user reviews,0,1,1
1388140,True,0,No user reviews,0,0,0
1388150,True,0,No user reviews,0,0,0
1388160,True,0,6 user reviews,6,0,6
1388170,True,0,No user reviews,0,0,0
1388230,True,0,4 user reviews,4,0,4
1388260,True,0,No user reviews,0,0,0
1388270,True,0,No user reviews,0,0,0
1388290,True,0,No user reviews,0,0,0
1388310,True,0,2 user reviews,2,0,2
1388330,True,0,No user reviews,0,0,0
1388350,True,0,No user reviews,0,0,0
1388360,True,0,No user reviews,0,0,0
1388370,True,5,Mixed,6,4,10
1388380,True,0,2 user reviews,0,2,2
1388390,True,0,1 user reviews,1,0,1
1388430,True,0,No user reviews,0,0,0
1388440,True,0,No user reviews,0,0,0
1388490,True,0,1 user reviews,0,1,1
1388500,True,0,No user reviews,0,0,0
1388570,True,0,No user reviews,0,0,0
1388610,True,0,No user reviews,0,0,0
1388620,True,0,No user reviews,0,0,0
1388630,True,0,No user reviews,0,0,0
1388650,True,0,No user reviews,0,0,0
1388670,True,0,No user reviews,0,0,0
1388680,True,0,No user reviews,0,0,0
1388690,True,0,No user reviews,0,0,0
1388700,True,0,No user reviews,0,0,0
1388720,True,0,No user reviews,0,0,0
1388730,True,0,1 user reviews,1,0,1
1388760,True,0,1 user reviews,1,0,1
1388770,True,0,No user reviews,0,0,0
1388790,True,0,No user reviews,0,0,0
1388800,True,0,No user reviews,0,0,0
1388820,True,0,No user reviews,0,0,0
1388840,True,0,No user reviews,0,0,0
1388860,True,0,2 user reviews,2,0,2
1388890,True,0,No user reviews,0,0,0
1388900,True,0,No user reviews,0,0,0
1388910,True,0,No user reviews,0,0,0
1388940,True,0,No user reviews,0,0,0
1388980,True,0,No user reviews,0,0,0
1389010,True,0,2 user reviews,2,0,2
1389030,True,0,No user reviews,0,0,0
1389040,True,0,No user reviews,0,0,0
1389060,True,0,No user reviews,0,0,0
1389070,True,0,4 user reviews,4,0,4
1389090,True,0,No user reviews,0,0,0
1389120,True,0,No user reviews,0,0,0
1389150,True,0,No user reviews,0,0,0
1389160,True,0,No user reviews,0,0,0
1389170,True,0,No user reviews,0,0,0
1389180,True,0,No user reviews,0,0,0
1389190,True,0,No user reviews,0,0,0
1389200,True,0,No user reviews,0,0,0
1389220,True,0,No user reviews,0,0,0
1389250,True,0,No user reviews,0,0,0
1389260,True,0,No user reviews,0,0,0
1389270,True,0,3 user reviews,3,0,3
1389290,True,0,1 user reviews,1,0,1
1389300,True,0,No user reviews,0,0,0
1389310,True,0,No user reviews,0,0,0
1389340,True,0,No user reviews,0,0,0
1389370,True,0,No user reviews,0,0,0
1389380,True,0,No user reviews,0,0,0
1389400,True,0,No user reviews,0,0,0
1389410,True,0,No user reviews,0,0,0
1389420,True,0,No user reviews,0,0,0
1389430,True,0,No user reviews,0,0,0
1389440,True,0,No user reviews,0,0,0
1389470,True,0,1 user reviews,0,1,1
1389490,True,0,No user reviews,0,0,0
1389491,True,0,No user reviews,0,0,0
1389510,True,0,No user reviews,0,0,0
1389530,True,0,No user reviews,0,0,0
1389540,True,0,No user reviews,0,0,0
1389550,True,0,No user reviews,0,0,0
1389560,True,7,Positive,14,0,14
1389580,True,0,No user reviews,0,0,0
1389590,True,0,No user reviews,0,0,0
1389610,True,7,Positive,11,0,11
1389630,True,0,No user reviews,0,0,0
1389650,True,0,No user reviews,0,0,0
1389660,True,0,No user reviews,0,0,0
1389680,True,6,Mostly Positive,13,5,18
1389700,True,0,5 user reviews,5,0,5
1389710,True,0,No user reviews,0,0,0
1389730,True,0,No user reviews,0,0,0
1389740,True,0,No user reviews,0,0,0
1389750,True,0,3 user reviews,3,0,3
1389770,True,0,No user reviews,0,0,0
1389800,True,0,No user reviews,0,0,0
1389820,True,0,No user reviews,0,0,0
1389830,True,0,No user reviews,0,0,0
1389850,True,0,No user reviews,0,0,0
1389880,True,0,No user reviews,0,0,0
1389890,True,7,Positive,19,0,19
1389900,True,0,No user reviews,0,0,0
1389910,True,0,No user reviews,0,0,0
1389911,True,0,1 user reviews,1,0,1
1389940,True,0,No user reviews,0,0,0
1389980,True,0,No user reviews,0,0,0
1390000,True,0,No user reviews,0,0,0
1390010,True,8,Very Positive,73,12,85
1390040,True,0,1 user reviews,1,0,1
1390060,True,0,No user reviews,0,0,0
1390070,True,0,No user reviews,0,0,0
1390080,True,0,No user reviews,0,0,0
1390100,True,0,No user reviews,0,0,0
1390110,True,0,6 user reviews,6,0,6
1390130,True,0,3 user reviews,3,0,3
1390131,True,0,1 user reviews,1,0,1
1390132,True,0,1 user reviews,1,0,1
1390150,True,0,No user reviews,0,0,0
1390190,True,0,No user reviews,0,0,0
1390210,True,0,No user reviews,0,0,0
1390211,True,0,3 user reviews,3,0,3
1390213,True,0,No user reviews,0,0,0
1390214,True,0,No user reviews,0,0,0
1390240,True,0,No user reviews,0,0,0
1390300,True,7,Positive,15,0,15
1390330,True,0,No user reviews,0,0,0
1390340,True,0,4 user reviews,1,3,4
1390350,True,0,No user reviews,0,0,0
1390370,True,0,No user reviews,0,0,0
1390380,True,0,No user reviews,0,0,0
1390410,True,0,No user reviews,0,0,0
1390480,True,0,No user reviews,0,0,0
1390490,True,7,Positive,11,1,12
1390520,True,0,No user reviews,0,0,0
1390550,True,0,No user reviews,0,0,0
1390560,True,0,No user reviews,0,0,0
1390580,True,0,No user reviews,0,0,0
1390590,True,0,No user reviews,0,0,0
1390610,True,0,No user reviews,0,0,0
1390620,True,0,No user reviews,0,0,0
1390650,True,0,No user reviews,0,0,0
1390660,True,0,No user reviews,0,0,0
1390670,True,0,No user reviews,0,0,0
1390680,True,0,No user reviews,0,0,0
1390710,True,0,1 user reviews,0,1,1
1390740,True,7,Positive,33,8,41
1390750,True,0,No user reviews,0,0,0
1390760,True,0,No user reviews,0,0,0
1390770,True,7,Positive,14,0,14
1390780,True,0,No user reviews,0,0,0
1390810,True,0,No user reviews,0,0,0
1390830,True,0,No user reviews,0,0,0
1390840,True,7,Positive,35,2,37
1390850,True,0,No user reviews,0,0,0
1390870,True,0,No user reviews,0,0,0
1390880,True,0,No user reviews,0,0,0
1390900,True,0,No user reviews,0,0,0
1390920,True,0,No user reviews,0,0,0
1390930,True,0,No user reviews,0,0,0
1390940,True,0,No user reviews,0,0,0
1390950,True,0,No user reviews,0,0,0
1390970,True,0,No user reviews,0,0,0
1391000,True,0,No user reviews,0,0,0
1391010,True,0,No user reviews,0,0,0
1391030,True,0,No user reviews,0,0,0
1391060,True,0,No user reviews,0,0,0
1391070,True,0,No user reviews,0,0,0
1391090,True,0,No user reviews,0,0,0
1391130,True,0,No user reviews,0,0,0
1391160,True,0,No user reviews,0,0,0
1391220,True,0,No user reviews,0,0,0
1391230,True,0,No user reviews,0,0,0
1391250,True,0,No user reviews,0,0,0
1391280,True,4,Mostly Negative,4,7,11
1391290,True,0,No user reviews,0,0,0
1391320,True,0,No user reviews,0,0,0
1391340,True,0,No user reviews,0,0,0
1391350,True,0,No user reviews,0,0,0
1391380,True,0,No user reviews,0,0,0
1391400,True,0,4 user reviews,2,2,4
1391430,True,0,No user reviews,0,0,0
1391440,True,0,No user reviews,0,0,0
1391450,True,0,7 user reviews,6,1,7
1391480,True,0,No user reviews,0,0,0
1391540,True,0,No user reviews,0,0,0
1391570,True,0,No user reviews,0,0,0
1391600,True,0,No user reviews,0,0,0
1391610,True,0,No user reviews,0,0,0
1391620,True,0,No user reviews,0,0,0
1391630,True,0,1 user reviews,1,0,1
1391650,True,0,No user reviews,0,0,0
1391680,True,0,No user reviews,0,0,0
1391690,True,0,No user reviews,0,0,0
1391720,True,0,No user reviews,0,0,0
1391740,True,0,No user reviews,0,0,0
1391770,True,0,No user reviews,0,0,0
1391780,True,0,No user reviews,0,0,0
1391790,True,0,3 user reviews,2,1,3
1391800,True,0,5 user reviews,3,2,5
1391810,True,0,No user reviews,0,0,0
1391820,True,0,No user reviews,0,0,0
1391830,True,0,No user reviews,0,0,0
1391840,True,0,No user reviews,0,0,0
1391850,True,0,No user reviews,0,0,0
1391860,True,0,No user reviews,0,0,0
1391870,True,0,No user reviews,0,0,0
1391880,True,0,No user reviews,0,0,0
1391890,True,0,No user reviews,0,0,0
1391900,True,0,No user reviews,0,0,0
1391910,True,0,No user reviews,0,0,0
1391920,True,0,No user reviews,0,0,0
1391930,True,0,No user reviews,0,0,0
1391940,True,0,No user reviews,0,0,0
1391950,True,0,No user reviews,0,0,0
1391960,True,0,2 user reviews,2,0,2
1391990,True,0,No user reviews,0,0,0
1392000,True,0,No user reviews,0,0,0
1392010,True,0,No user reviews,0,0,0
1392020,True,0,No user reviews,0,0,0
1392030,True,0,6 user reviews,4,2,6
1392040,True,0,No user reviews,0,0,0
1392050,True,0,No user reviews,0,0,0
1392060,True,0,No user reviews,0,0,0
1392070,True,0,No user reviews,0,0,0
1392080,True,0,1 user reviews,1,0,1
1392100,True,0,No user reviews,0,0,0
1392110,True,0,No user reviews,0,0,0
1392120,True,0,No user reviews,0,0,0
1392130,True,0,2 user reviews,2,0,2
1392140,True,0,No user reviews,0,0,0
1392160,True,0,No user reviews,0,0,0
1392170,True,6,Mostly Positive,7,3,10
1392180,True,0,No user reviews,0,0,0
1392190,True,0,2 user reviews,0,2,2
1392210,True,0,No user reviews,0,0,0
1392220,True,0,No user reviews,0,0,0
1392240,True,0,No user reviews,0,0,0
1392250,True,0,No user reviews,0,0,0
1392270,True,0,No user reviews,0,0,0
1392271,True,0,No user reviews,0,0,0
1392280,True,0,No user reviews,0,0,0
1392410,True,0,No user reviews,0,0,0
1392430,True,0,1 user reviews,0,1,1
1392440,True,0,No user reviews,0,0,0
1392450,True,0,No user reviews,0,0,0
1392460,True,0,No user reviews,0,0,0
1392480,True,0,No user reviews,0,0,0
1392490,True,0,3 user reviews,3,0,3
1392500,True,0,No user reviews,0,0,0
1392510,True,0,No user reviews,0,0,0
1392520,True,0,No user reviews,0,0,0
1392540,True,0,No user reviews,0,0,0
1392560,True,0,No user reviews,0,0,0
1392570,True,0,No user reviews,0,0,0
1392590,True,0,No user reviews,0,0,0
1392600,True,0,9 user reviews,8,1,9
1392610,True,0,No user reviews,0,0,0
1392620,True,0,No user reviews,0,0,0
1392630,True,0,No user reviews,0,0,0
1392640,True,0,No user reviews,0,0,0
1392650,True,0,No user reviews,0,0,0
1392660,True,0,No user reviews,0,0,0
1392670,True,0,No user reviews,0,0,0
1392690,True,0,No user reviews,0,0,0
1392700,True,5,Mixed,12,8,20
1392750,True,0,No user reviews,0,0,0
1392760,True,0,5 user reviews,3,2,5
1392770,True,0,No user reviews,0,0,0
1392780,True,0,No user reviews,0,0,0
1392790,True,0,1 user reviews,1,0,1
1392810,True,0,No user reviews,0,0,0
1392820,True,8,Very Positive,145,4,149
1392830,True,0,No user reviews,0,0,0
1392850,True,0,No user reviews,0,0,0
1392870,True,0,No user reviews,0,0,0
1392880,True,0,No user reviews,0,0,0
1392890,True,0,No user reviews,0,0,0
1392900,True,0,No user reviews,0,0,0
1392930,True,0,No user reviews,0,0,0
1392950,True,0,No user reviews,0,0,0
1392980,True,0,No user reviews,0,0,0
1392990,True,0,No user reviews,0,0,0
1393000,True,0,No user reviews,0,0,0
1393010,True,0,No user reviews,0,0,0
1393020,True,0,No user reviews,0,0,0
1393040,True,0,No user reviews,0,0,0
1393080,True,0,1 user reviews,1,0,1
1393100,True,0,No user reviews,0,0,0
1393110,True,0,5 user reviews,4,1,5
1393120,True,0,8 user reviews,8,0,8
1393150,True,0,No user reviews,0,0,0
1393180,True,0,No user reviews,0,0,0
1393190,True,0,No user reviews,0,0,0
1393210,True,0,No user reviews,0,0,0
1393220,True,0,1 user reviews,0,1,1
1393270,True,0,No user reviews,0,0,0
1393310,True,0,No user reviews,0,0,0
1393320,True,0,No user reviews,0,0,0
1393340,True,0,No user reviews,0,0,0
1393350,True,0,5 user reviews,5,0,5
1393360,True,0,No user reviews,0,0,0
1393410,True,7,Positive,16,4,20
1393420,True,0,No user reviews,0,0,0
1393430,True,0,No user reviews,0,0,0
1393440,True,0,No user reviews,0,0,0
1393460,True,0,No user reviews,0,0,0
1393470,True,0,No user reviews,0,0,0
1393480,True,0,2 user reviews,2,0,2
1393490,True,0,No user reviews,0,0,0
1393500,True,7,Positive,17,1,18
1393510,True,0,No user reviews,0,0,0
1393550,True,0,No user reviews,0,0,0
1393560,True,0,No user reviews,0,0,0
1393570,True,0,No user reviews,0,0,0
1393580,True,0,No user reviews,0,0,0
1393590,True,0,No user reviews,0,0,0
1393591,True,0,No user reviews,0,0,0
1393600,True,0,No user reviews,0,0,0
1393610,True,0,No user reviews,0,0,0
1393630,True,0,No user reviews,0,0,0
1393640,True,0,No user reviews,0,0,0
1393650,True,0,No user reviews,0,0,0
1393660,True,0,No user reviews,0,0,0
1393690,True,0,No user reviews,0,0,0
1393700,True,0,No user reviews,0,0,0
1393720,True,0,No user reviews,0,0,0
1393730,True,0,No user reviews,0,0,0
1393740,True,0,No user reviews,0,0,0
1393750,True,0,No user reviews,0,0,0
1393770,True,0,No user reviews,0,0,0
1393780,True,0,1 user reviews,1,0,1
1393790,True,0,1 user reviews,1,0,1
1393800,True,0,4 user reviews,2,2,4
1393810,True,0,No user reviews,0,0,0
1393820,True,7,Positive,18,0,18
1393830,True,0,No user reviews,0,0,0
1393850,True,0,1 user reviews,0,1,1
1393870,True,0,No user reviews,0,0,0
1393890,True,0,No user reviews,0,0,0
1393910,True,0,No user reviews,0,0,0
1393930,True,0,1 user reviews,0,1,1
1393960,True,0,No user reviews,0,0,0
1393970,True,0,1 user reviews,1,0,1
1394020,True,0,No user reviews,0,0,0
1394040,True,0,No user reviews,0,0,0
1394060,True,0,2 user reviews,0,2,2
1394080,True,0,No user reviews,0,0,0
1394090,True,0,No user reviews,0,0,0
1394100,True,0,No user reviews,0,0,0
1394130,True,0,No user reviews,0,0,0
1394140,True,0,4 user reviews,3,1,4
1394150,True,0,No user reviews,0,0,0
1394160,True,7,Positive,12,1,13
1394200,True,0,No user reviews,0,0,0
1394210,True,0,1 user reviews,0,1,1
1394220,True,0,No user reviews,0,0,0
1394230,True,0,No user reviews,0,0,0
1394232,True,0,No user reviews,0,0,0
1394240,True,0,No user reviews,0,0,0
1394270,True,0,No user reviews,0,0,0
1394300,True,0,No user reviews,0,0,0
1394310,True,0,No user reviews,0,0,0
1394340,True,0,No user reviews,0,0,0
1394350,True,0,No user reviews,0,0,0
1394400,True,0,No user reviews,0,0,0
1394410,True,0,1 user reviews,1,0,1
1394420,True,0,No user reviews,0,0,0
1394440,True,0,No user reviews,0,0,0
1394480,True,0,No user reviews,0,0,0
1394490,True,0,No user reviews,0,0,0
1394500,True,0,No user reviews,0,0,0
1394510,True,0,No user reviews,0,0,0
1394520,True,7,Positive,17,1,18
1394530,True,0,No user reviews,0,0,0
1394540,True,0,No user reviews,0,0,0
1394560,True,0,No user reviews,0,0,0
1394570,True,0,No user reviews,0,0,0
1394580,True,0,No user reviews,0,0,0
1394600,True,0,5 user reviews,5,0,5
1394640,True,0,No user reviews,0,0,0
1394670,True,0,No user reviews,0,0,0
1394680,True,0,1 user reviews,1,0,1
1394690,True,0,No user reviews,0,0,0
1394700,True,0,1 user reviews,1,0,1
1394710,True,0,No user reviews,0,0,0
1394730,True,0,No user reviews,0,0,0
1394750,True,0,No user reviews,0,0,0
1394760,True,0,No user reviews,0,0,0
1394770,True,0,No user reviews,0,0,0
1394800,True,5,Mixed,53,37,90
1394820,True,0,No user reviews,0,0,0
1394830,True,0,7 user reviews,7,0,7
1394840,True,0,No user reviews,0,0,0
1394850,True,0,No user reviews,0,0,0
1394870,True,0,No user reviews,0,0,0
1394880,True,0,2 user reviews,2,0,2
1394890,True,7,Positive,10,1,11
1394910,True,0,No user reviews,0,0,0
1394950,True,0,8 user reviews,5,3,8
1394960,True,0,No user reviews,0,0,0
1394980,True,0,1 user reviews,1,0,1
1394990,True,0,No user reviews,0,0,0
1395000,True,0,1 user reviews,0,1,1
1395010,True,0,No user reviews,0,0,0
1395020,True,0,No user reviews,0,0,0
1395050,True,0,No user reviews,0,0,0
1395060,True,0,No user reviews,0,0,0
1395080,True,0,1 user reviews,1,0,1
1395100,True,0,3 user reviews,3,0,3
1395110,True,0,No user reviews,0,0,0
1395120,True,0,No user reviews,0,0,0
1395130,True,0,No user reviews,0,0,0
1395140,True,0,No user reviews,0,0,0
1395170,True,0,3 user reviews,2,1,3
1395180,True,0,No user reviews,0,0,0
1395190,True,0,No user reviews,0,0,0
1395210,True,0,No user reviews,0,0,0
1395230,True,0,No user reviews,0,0,0
1395250,True,0,No user reviews,0,0,0
1395270,True,0,No user reviews,0,0,0
1395280,True,0,2 user reviews,1,1,2
1395300,True,0,No user reviews,0,0,0
1395310,True,0,No user reviews,0,0,0
1395330,True,0,No user reviews,0,0,0
1395340,True,0,No user reviews,0,0,0
1395350,True,0,No user reviews,0,0,0
1395400,True,0,No user reviews,0,0,0
1395410,True,0,No user reviews,0,0,0
1395420,True,0,2 user reviews,1,1,2
1395450,True,0,No user reviews,0,0,0
1395470,True,0,1 user reviews,1,0,1
1395510,True,0,No user reviews,0,0,0
1395540,True,7,Positive,19,1,20
1395550,True,0,No user reviews,0,0,0
1395560,True,7,Positive,27,4,31
1395590,True,0,1 user reviews,1,0,1
1395620,True,0,No user reviews,0,0,0
1395630,True,0,No user reviews,0,0,0
1395650,True,0,No user reviews,0,0,0
1395660,True,0,No user reviews,0,0,0
1395710,True,0,No user reviews,0,0,0
1395720,True,0,1 user reviews,1,0,1
1395730,True,0,8 user reviews,8,0,8
1395760,True,0,No user reviews,0,0,0
1395780,True,0,No user reviews,0,0,0
1395800,True,0,No user reviews,0,0,0
1395801,True,0,No user reviews,0,0,0
1395802,True,0,No user reviews,0,0,0
1395803,True,0,No user reviews,0,0,0
1395804,True,0,No user reviews,0,0,0
1395805,True,0,No user reviews,0,0,0
1395806,True,0,No user reviews,0,0,0
1395807,True,0,No user reviews,0,0,0
1395808,True,0,No user reviews,0,0,0
1395809,True,0,No user reviews,0,0,0
1395820,True,0,No user reviews,0,0,0
1395830,True,0,No user reviews,0,0,0
1395850,True,0,1 user reviews,1,0,1
1395880,True,0,No user reviews,0,0,0
1395890,True,0,No user reviews,0,0,0
1395900,True,0,No user reviews,0,0,0
1395910,True,0,No user reviews,0,0,0
1395920,True,0,No user reviews,0,0,0
1395950,True,0,3 user reviews,2,1,3
1395970,True,0,No user reviews,0,0,0
1396010,True,0,No user reviews,0,0,0
1396020,True,0,No user reviews,0,0,0
1396040,True,0,No user reviews,0,0,0
1396050,True,0,No user reviews,0,0,0
1396090,True,0,No user reviews,0,0,0
1396140,True,0,No user reviews,0,0,0
1396160,True,0,No user reviews,0,0,0
1396170,True,0,No user reviews,0,0,0
1396200,True,0,No user reviews,0,0,0
1396220,True,0,No user reviews,0,0,0
1396240,True,0,No user reviews,0,0,0
1396260,True,7,Positive,11,2,13
1396270,True,0,No user reviews,0,0,0
1396310,True,0,No user reviews,0,0,0
1396320,True,0,No user reviews,0,0,0
1396350,True,0,1 user reviews,1,0,1
1396360,True,0,No user reviews,0,0,0
1396380,True,0,2 user reviews,1,1,2
1396400,True,0,No user reviews,0,0,0
1396410,True,0,No user reviews,0,0,0
1396420,True,0,1 user reviews,0,1,1
1396430,True,0,No user reviews,0,0,0
1396440,True,0,No user reviews,0,0,0
1396450,True,0,No user reviews,0,0,0
1396480,True,0,No user reviews,0,0,0
1396490,True,0,No user reviews,0,0,0
1396570,True,0,1 user reviews,1,0,1
1396580,True,0,1 user reviews,0,1,1
1396610,True,0,1 user reviews,1,0,1
1396620,True,0,No user reviews,0,0,0
1396630,True,0,No user reviews,0,0,0
1396670,True,0,No user reviews,0,0,0
1396750,True,0,No user reviews,0,0,0
1396780,True,0,No user reviews,0,0,0
1396800,True,0,No user reviews,0,0,0
1396820,True,0,No user reviews,0,0,0
1396840,True,0,No user reviews,0,0,0
1396860,True,0,No user reviews,0,0,0
1396870,True,0,No user reviews,0,0,0
1396900,True,0,No user reviews,0,0,0
1396920,True,0,No user reviews,0,0,0
1396930,True,0,1 user reviews,0,1,1
1396940,True,0,No user reviews,0,0,0
1396950,True,0,No user reviews,0,0,0
1396970,True,0,No user reviews,0,0,0
1396980,True,0,No user reviews,0,0,0
1397010,True,0,No user reviews,0,0,0
1397020,True,0,No user reviews,0,0,0
1397030,True,8,Very Positive,83,2,85
1397040,True,0,No user reviews,0,0,0
1397050,True,0,1 user reviews,1,0,1
1397080,True,0,No user reviews,0,0,0
1397090,True,0,No user reviews,0,0,0
1397100,True,0,No user reviews,0,0,0
1397110,True,0,6 user reviews,6,0,6
1397120,True,0,No user reviews,0,0,0
1397130,True,0,No user reviews,0,0,0
1397140,True,0,No user reviews,0,0,0
1397150,True,0,No user reviews,0,0,0
1397160,True,0,No user reviews,0,0,0
1397170,True,5,Mixed,6,4,10
1397200,True,0,No user reviews,0,0,0
1397220,True,0,No user reviews,0,0,0
1397230,True,0,1 user reviews,1,0,1
1397240,True,0,9 user reviews,9,0,9
1397250,True,0,1 user reviews,1,0,1
1397270,True,0,No user reviews,0,0,0
1397280,True,0,4 user reviews,4,0,4
1397290,True,0,No user reviews,0,0,0
1397310,True,0,No user reviews,0,0,0
1397320,True,0,No user reviews,0,0,0
1397350,True,0,4 user reviews,4,0,4
1397360,True,0,No user reviews,0,0,0
1397400,True,0,No user reviews,0,0,0
1397410,True,0,No user reviews,0,0,0
1397420,True,0,No user reviews,0,0,0
1397430,True,0,No user reviews,0,0,0
1397470,True,0,6 user reviews,6,0,6
1397480,True,0,No user reviews,0,0,0
1397490,True,5,Mixed,9,5,14
1397530,True,0,No user reviews,0,0,0
1397540,True,0,4 user reviews,4,0,4
1397610,True,0,No user reviews,0,0,0
1397620,True,0,No user reviews,0,0,0
1397670,True,0,No user reviews,0,0,0
1397680,True,0,No user reviews,0,0,0
1397690,True,0,1 user reviews,0,1,1
1397700,True,0,No user reviews,0,0,0
1397710,True,0,No user reviews,0,0,0
1397720,True,0,2 user reviews,2,0,2
1397730,True,0,No user reviews,0,0,0
1397760,True,0,No user reviews,0,0,0
1397780,True,0,No user reviews,0,0,0
1397800,True,0,No user reviews,0,0,0
1397810,True,0,1 user reviews,1,0,1
1397850,True,0,No user reviews,0,0,0
1397880,True,0,No user reviews,0,0,0
1397920,True,0,No user reviews,0,0,0
1397940,True,0,No user reviews,0,0,0
1397950,True,0,No user reviews,0,0,0
1397960,True,0,1 user reviews,1,0,1
1397980,True,0,No user reviews,0,0,0
1397990,True,0,No user reviews,0,0,0
1398030,True,0,No user reviews,0,0,0
1398050,True,0,2 user reviews,2,0,2
1398060,True,0,No user reviews,0,0,0
1398080,True,0,No user reviews,0,0,0
1398090,True,0,No user reviews,0,0,0
1398100,True,0,No user reviews,0,0,0
1398120,True,0,1 user reviews,0,1,1
1398130,True,0,No user reviews,0,0,0
1398140,True,0,No user reviews,0,0,0
1398150,True,0,No user reviews,0,0,0
1398160,True,0,No user reviews,0,0,0
1398180,True,0,7 user reviews,6,1,7
1398200,True,0,No user reviews,0,0,0
1398210,True,0,No user reviews,0,0,0
1398220,True,0,No user reviews,0,0,0
1398240,True,0,No user reviews,0,0,0
1398250,True,0,No user reviews,0,0,0
1398270,True,0,5 user reviews,5,0,5
1398290,True,0,No user reviews,0,0,0
1398320,True,0,1 user reviews,0,1,1
1398390,True,0,1 user reviews,1,0,1
1398400,True,0,No user reviews,0,0,0
1398440,True,0,No user reviews,0,0,0
1398460,True,0,No user reviews,0,0,0
1398470,True,0,No user reviews,0,0,0
1398490,True,0,No user reviews,0,0,0
1398500,True,0,No user reviews,0,0,0
1398510,True,0,No user reviews,0,0,0
1398520,True,0,No user reviews,0,0,0
1398570,True,0,7 user reviews,6,1,7
1398580,True,0,No user reviews,0,0,0
1398590,True,0,No user reviews,0,0,0
1398600,True,0,No user reviews,0,0,0
1398610,True,0,No user reviews,0,0,0
1398620,True,0,No user reviews,0,0,0
1398640,True,0,No user reviews,0,0,0
1398740,True,0,No user reviews,0,0,0
1398750,True,0,1 user reviews,1,0,1
1398770,True,0,6 user reviews,6,0,6
1398780,True,0,No user reviews,0,0,0
1398790,True,0,2 user reviews,2,0,2
1398820,True,0,2 user reviews,2,0,2
1398830,True,0,No user reviews,0,0,0
1398860,True,0,No user reviews,0,0,0
1398890,True,0,No user reviews,0,0,0
1398900,True,0,No user reviews,0,0,0
1398920,True,0,No user reviews,0,0,0
1398950,True,0,No user reviews,0,0,0
1398990,True,0,No user reviews,0,0,0
1399010,True,0,No user reviews,0,0,0
1399020,True,0,1 user reviews,1,0,1
1399030,True,0,No user reviews,0,0,0
1399040,True,0,1 user reviews,1,0,1
1399090,True,0,No user reviews,0,0,0
1399140,True,0,9 user reviews,7,2,9
1399150,True,0,1 user reviews,1,0,1
1399180,True,0,No user reviews,0,0,0
1399210,True,0,No user reviews,0,0,0
1399230,True,0,No user reviews,0,0,0
1399250,True,0,No user reviews,0,0,0
1399290,True,0,No user reviews,0,0,0
1399300,True,0,2 user reviews,2,0,2
1399310,True,0,No user reviews,0,0,0
1399350,True,0,No user reviews,0,0,0
1399370,True,6,Mostly Positive,33,10,43
1399380,True,0,6 user reviews,6,0,6
1399400,True,0,1 user reviews,1,0,1
1399420,True,0,2 user reviews,2,0,2
1399440,True,0,No user reviews,0,0,0
1399450,True,0,No user reviews,0,0,0
1399460,True,0,1 user reviews,0,1,1
1399480,True,0,3 user reviews,2,1,3
1399490,True,0,1 user reviews,1,0,1
1399500,True,0,3 user reviews,3,0,3
1399510,True,0,No user reviews,0,0,0
1399520,True,0,No user reviews,0,0,0
1399540,True,0,No user reviews,0,0,0
1399560,True,0,No user reviews,0,0,0
1399590,True,0,4 user reviews,3,1,4
1399610,True,0,1 user reviews,1,0,1
1399620,True,0,No user reviews,0,0,0
1399630,True,0,No user reviews,0,0,0
1399650,True,0,No user reviews,0,0,0
1399660,True,7,Positive,24,0,24
1399680,True,0,No user reviews,0,0,0
1399740,True,0,No user reviews,0,0,0
1399750,True,0,No user reviews,0,0,0
1399760,True,0,No user reviews,0,0,0
1399770,True,0,No user reviews,0,0,0
1399790,True,0,2 user reviews,2,0,2
1399791,True,0,No user reviews,0,0,0
1399810,True,0,No user reviews,0,0,0
1399820,True,0,No user reviews,0,0,0
1399830,True,0,No user reviews,0,0,0
1399850,True,0,3 user reviews,3,0,3
1399890,True,0,No user reviews,0,0,0
1399910,True,0,2 user reviews,2,0,2
1399920,True,0,No user reviews,0,0,0
1399940,True,0,No user reviews,0,0,0
1399950,True,0,No user reviews,0,0,0
1399960,True,7,Positive,14,2,16
1399970,True,0,No user reviews,0,0,0
1399990,True,0,No user reviews,0,0,0
1400000,True,0,No user reviews,0,0,0
1400030,True,0,No user reviews,0,0,0
1400040,True,0,No user reviews,0,0,0
1400050,True,0,No user reviews,0,0,0
1400051,True,0,1 user reviews,0,1,1
1400060,True,0,No user reviews,0,0,0
1400070,True,0,No user reviews,0,0,0
1400100,True,0,2 user reviews,0,2,2
1400110,True,0,No user reviews,0,0,0
1400140,True,0,No user reviews,0,0,0
1400150,True,0,3 user reviews,2,1,3
1400160,True,0,No user reviews,0,0,0
1400170,True,0,No user reviews,0,0,0
1400180,True,0,6 user reviews,4,2,6
1400190,True,0,4 user reviews,4,0,4
1400200,True,0,3 user reviews,2,1,3
1400210,True,0,4 user reviews,4,0,4
1400260,True,0,7 user reviews,7,0,7
1400270,True,0,No user reviews,0,0,0
1400280,True,0,No user reviews,0,0,0
1400290,True,0,No user reviews,0,0,0
1400300,True,0,7 user reviews,6,1,7
1400301,True,7,Positive,10,0,10
1400302,True,0,5 user reviews,5,0,5
1400307,True,0,No user reviews,0,0,0
1400308,True,0,No user reviews,0,0,0
1400309,True,0,No user reviews,0,0,0
1400320,True,0,No user reviews,0,0,0
1400350,True,0,No user reviews,0,0,0
1400360,True,0,1 user reviews,0,1,1
1400370,True,0,No user reviews,0,0,0
1400380,True,0,No user reviews,0,0,0
1400390,True,0,No user reviews,0,0,0
1400400,True,0,No user reviews,0,0,0
1400410,True,0,No user reviews,0,0,0
1400420,True,0,No user reviews,0,0,0
1400440,True,0,No user reviews,0,0,0
1400460,True,0,No user reviews,0,0,0
1400470,True,0,No user reviews,0,0,0
1400480,True,0,No user reviews,0,0,0
1400490,True,0,No user reviews,0,0,0
1400500,True,0,No user reviews,0,0,0
1400510,True,0,1 user reviews,1,0,1
1400520,True,0,No user reviews,0,0,0
1400530,True,0,No user reviews,0,0,0
1400551,True,0,No user reviews,0,0,0
1400570,True,0,No user reviews,0,0,0
1400590,True,0,1 user reviews,1,0,1
1400600,True,0,No user reviews,0,0,0
1400610,True,0,No user reviews,0,0,0
1400620,True,0,No user reviews,0,0,0
1400630,True,0,No user reviews,0,0,0
1400650,True,0,1 user reviews,0,1,1
1400680,True,0,1 user reviews,1,0,1
1400720,True,0,2 user reviews,2,0,2
1400740,True,0,No user reviews,0,0,0
1400770,True,0,No user reviews,0,0,0
1400860,True,0,No user reviews,0,0,0
1400870,True,0,No user reviews,0,0,0
1400900,True,0,4 user reviews,3,1,4
1400910,True,0,No user reviews,0,0,0
1400920,True,0,1 user reviews,1,0,1
1400930,True,0,No user reviews,0,0,0
1400940,True,0,No user reviews,0,0,0
1400980,True,0,No user reviews,0,0,0
1401020,True,0,No user reviews,0,0,0
1401070,True,0,No user reviews,0,0,0
1401080,True,0,No user reviews,0,0,0
1401130,True,0,No user reviews,0,0,0
1401140,True,0,No user reviews,0,0,0
1401150,True,6,Mostly Positive,7,3,10
1401170,True,0,No user reviews,0,0,0
1401180,True,0,No user reviews,0,0,0
1401190,True,0,No user reviews,0,0,0
1401220,True,0,No user reviews,0,0,0
1401260,True,0,No user reviews,0,0,0
1401310,True,0,No user reviews,0,0,0
1401320,True,0,No user reviews,0,0,0
1401340,True,0,No user reviews,0,0,0
1401350,True,0,No user reviews,0,0,0
1401360,True,0,1 user reviews,1,0,1
1401370,True,0,No user reviews,0,0,0
1401450,True,0,8 user reviews,8,0,8
1401451,True,0,6 user reviews,5,1,6
1401452,True,7,Positive,12,1,13
1401470,True,0,No user reviews,0,0,0
1401490,True,5,Mixed,13,12,25
1401520,True,0,No user reviews,0,0,0
1401530,True,0,No user reviews,0,0,0
1401540,True,0,No user reviews,0,0,0
1401550,True,0,No user reviews,0,0,0
1401600,True,0,No user reviews,0,0,0
1401610,True,0,No user reviews,0,0,0
1401620,True,0,No user reviews,0,0,0
1401630,True,0,No user reviews,0,0,0
1401660,True,0,No user reviews,0,0,0
1401670,True,0,1 user reviews,1,0,1
1401680,True,0,No user reviews,0,0,0
1401750,True,0,No user reviews,0,0,0
1401760,True,0,No user reviews,0,0,0
1401770,True,0,No user reviews,0,0,0
1401840,True,6,Mostly Positive,9,3,12
1401850,True,0,No user reviews,0,0,0
1401860,True,8,Very Positive,82,5,87
1401861,True,0,No user reviews,0,0,0
1401870,True,0,No user reviews,0,0,0
1401880,True,0,5 user reviews,5,0,5
1401890,True,0,No user reviews,0,0,0
1401900,True,0,No user reviews,0,0,0
1401920,True,0,No user reviews,0,0,0
1401940,True,0,No user reviews,0,0,0
1401960,True,0,No user reviews,0,0,0
1401970,True,0,No user reviews,0,0,0
1401990,True,0,No user reviews,0,0,0
1402000,True,0,No user reviews,0,0,0
1402010,True,0,No user reviews,0,0,0
1402020,True,0,No user reviews,0,0,0
1402030,True,0,No user reviews,0,0,0
1402040,True,0,No user reviews,0,0,0
1402060,True,0,No user reviews,0,0,0
1402070,True,0,No user reviews,0,0,0
1402090,True,7,Positive,9,2,11
1402100,True,0,No user reviews,0,0,0
1402140,True,0,No user reviews,0,0,0
1402150,True,0,No user reviews,0,0,0
1402170,True,0,1 user reviews,1,0,1
1402180,True,0,No user reviews,0,0,0
1402210,True,0,No user reviews,0,0,0
1402220,True,0,No user reviews,0,0,0
1402240,True,0,No user reviews,0,0,0
1402260,True,0,No user reviews,0,0,0
1402300,True,0,No user reviews,0,0,0
1402310,True,0,No user reviews,0,0,0
1402320,True,0,No user reviews,0,0,0
1402330,True,0,No user reviews,0,0,0
1402340,True,0,No user reviews,0,0,0
1402350,True,0,No user reviews,0,0,0
1402360,True,0,No user reviews,0,0,0
1402380,True,0,1 user reviews,1,0,1
1402390,True,0,No user reviews,0,0,0
1402400,True,0,No user reviews,0,0,0
1402410,True,0,8 user reviews,6,2,8
1402420,True,0,No user reviews,0,0,0
1402460,True,0,No user reviews,0,0,0
1402470,True,0,No user reviews,0,0,0
1402490,True,0,No user reviews,0,0,0
1402560,True,0,No user reviews,0,0,0
1402570,True,0,No user reviews,0,0,0
1402580,True,0,No user reviews,0,0,0
1402590,True,0,No user reviews,0,0,0
1402600,True,0,No user reviews,0,0,0
1402620,True,0,No user reviews,0,0,0
1402630,True,0,4 user reviews,4,0,4
1402640,True,0,2 user reviews,2,0,2
1402650,True,0,No user reviews,0,0,0
1402680,True,0,No user reviews,0,0,0
1402690,True,0,No user reviews,0,0,0
1402710,True,0,No user reviews,0,0,0
1402720,True,0,No user reviews,0,0,0
1402730,True,0,No user reviews,0,0,0
1402740,True,0,No user reviews,0,0,0
1402750,True,0,No user reviews,0,0,0
1402790,True,0,1 user reviews,1,0,1
1402810,True,0,No user reviews,0,0,0
1402820,True,0,No user reviews,0,0,0
1402840,True,0,No user reviews,0,0,0
1402860,True,0,No user reviews,0,0,0
1402880,True,0,No user reviews,0,0,0
1402890,True,0,No user reviews,0,0,0
1402900,True,0,No user reviews,0,0,0
1402920,True,0,7 user reviews,3,4,7
1402930,True,0,3 user reviews,2,1,3
1403010,True,0,1 user reviews,1,0,1
1403070,True,0,No user reviews,0,0,0
1403090,True,0,3 user reviews,3,0,3
1403110,True,0,3 user reviews,3,0,3
1403130,True,0,1 user reviews,1,0,1
1403180,True,0,No user reviews,0,0,0
1403190,True,7,Positive,17,1,18
1403200,True,0,No user reviews,0,0,0
1403220,True,0,No user reviews,0,0,0
1403230,True,0,No user reviews,0,0,0
1403250,True,0,No user reviews,0,0,0
1403260,True,0,No user reviews,0,0,0
1403280,True,0,No user reviews,0,0,0
1403290,True,0,No user reviews,0,0,0
1403350,True,0,3 user reviews,3,0,3
1403360,True,0,No user reviews,0,0,0
1403370,True,0,No user reviews,0,0,0
1403380,True,0,No user reviews,0,0,0
1403400,True,0,No user reviews,0,0,0
1403410,True,0,No user reviews,0,0,0
1403420,True,0,No user reviews,0,0,0
1403440,True,0,No user reviews,0,0,0
1403450,True,0,No user reviews,0,0,0
1403460,True,0,No user reviews,0,0,0
1403470,True,0,No user reviews,0,0,0
1403490,True,0,No user reviews,0,0,0
1403500,True,0,No user reviews,0,0,0
1403510,True,0,No user reviews,0,0,0
1403520,True,0,No user reviews,0,0,0
1403540,True,0,1 user reviews,0,1,1
1403550,True,0,No user reviews,0,0,0
1403560,True,0,No user reviews,0,0,0
1403570,True,0,No user reviews,0,0,0
1403590,True,0,No user reviews,0,0,0
1403600,True,0,No user reviews,0,0,0
1403620,True,0,No user reviews,0,0,0
1403630,True,0,1 user reviews,1,0,1
1403650,True,0,No user reviews,0,0,0
1403670,True,0,No user reviews,0,0,0
1403680,True,0,1 user reviews,0,1,1
1403690,True,0,No user reviews,0,0,0
1403710,True,0,No user reviews,0,0,0
1403720,True,0,No user reviews,0,0,0
1403730,True,0,No user reviews,0,0,0
1403740,True,0,No user reviews,0,0,0
1403750,True,0,No user reviews,0,0,0
1403770,True,0,No user reviews,0,0,0
1403780,True,0,No user reviews,0,0,0
1403800,True,0,No user reviews,0,0,0
1403830,True,0,8 user reviews,8,0,8
1403840,True,0,1 user reviews,1,0,1
1403850,True,0,No user reviews,0,0,0
1403860,True,0,No user reviews,0,0,0
1403870,True,0,No user reviews,0,0,0
1403880,True,0,No user reviews,0,0,0
1403890,True,0,5 user reviews,5,0,5
1403900,True,0,No user reviews,0,0,0
1403910,True,0,No user reviews,0,0,0
1403920,True,0,No user reviews,0,0,0
1403930,True,0,No user reviews,0,0,0
1403950,True,0,No user reviews,0,0,0
1403960,True,0,No user reviews,0,0,0
1403970,True,0,No user reviews,0,0,0
1403990,True,0,No user reviews,0,0,0
1404000,True,0,No user reviews,0,0,0
1404010,True,0,No user reviews,0,0,0
1404020,True,0,No user reviews,0,0,0
1404030,True,0,No user reviews,0,0,0
1404050,True,0,4 user reviews,4,0,4
1404060,True,0,No user reviews,0,0,0
1404070,True,0,2 user reviews,2,0,2
1404080,True,0,No user reviews,0,0,0
1404090,True,0,7 user reviews,7,0,7
1404100,True,0,No user reviews,0,0,0
1404130,True,0,9 user reviews,9,0,9
1404140,True,0,No user reviews,0,0,0
1404150,True,0,9 user reviews,9,0,9
1404160,True,0,No user reviews,0,0,0
1404180,True,0,No user reviews,0,0,0
1404190,True,7,Positive,10,0,10
1404200,True,0,No user reviews,0,0,0
1404230,True,0,No user reviews,0,0,0
1404231,True,0,No user reviews,0,0,0
1404240,True,0,No user reviews,0,0,0
1404300,True,0,No user reviews,0,0,0
1404330,True,0,No user reviews,0,0,0
1404360,True,7,Positive,15,0,15
1404370,True,0,No user reviews,0,0,0
1404420,True,0,No user reviews,0,0,0
1404440,True,0,No user reviews,0,0,0
1404460,True,0,No user reviews,0,0,0
1404470,True,0,No user reviews,0,0,0
1404520,True,0,No user reviews,0,0,0
1404530,True,7,Positive,17,0,17
1404550,True,0,1 user reviews,0,1,1
1404620,True,0,No user reviews,0,0,0
1404640,True,0,No user reviews,0,0,0
1404641,True,0,No user reviews,0,0,0
1404650,True,0,No user reviews,0,0,0
1404670,True,0,No user reviews,0,0,0
1404690,True,0,No user reviews,0,0,0
1404710,True,0,No user reviews,0,0,0
1404750,True,0,No user reviews,0,0,0
1404760,True,0,No user reviews,0,0,0
1404770,True,0,No user reviews,0,0,0
1404790,True,0,No user reviews,0,0,0
1404810,True,0,No user reviews,0,0,0
1404850,True,0,No user reviews,0,0,0
1404860,True,0,No user reviews,0,0,0
1404870,True,0,No user reviews,0,0,0
1404880,True,0,No user reviews,0,0,0
1404900,True,0,No user reviews,0,0,0
1404901,True,0,No user reviews,0,0,0
1404910,True,0,No user reviews,0,0,0
1404930,True,0,No user reviews,0,0,0
1404950,True,0,8 user reviews,8,0,8
1404960,True,0,No user reviews,0,0,0
1404970,True,0,2 user reviews,2,0,2
1404980,True,7,Positive,13,0,13
1405030,True,0,No user reviews,0,0,0
1405050,True,0,No user reviews,0,0,0
1405080,True,0,No user reviews,0,0,0
1405090,True,0,No user reviews,0,0,0
1405120,True,0,No user reviews,0,0,0
1405130,True,0,No user reviews,0,0,0
1405160,True,0,No user reviews,0,0,0
1405170,True,0,1 user reviews,1,0,1
1405180,True,0,No user reviews,0,0,0
1405190,True,0,No user reviews,0,0,0
1405210,True,0,No user reviews,0,0,0
1405211,True,0,No user reviews,0,0,0
1405212,True,0,No user reviews,0,0,0
1405213,True,0,No user reviews,0,0,0
1405214,True,0,No user reviews,0,0,0
1405215,True,0,No user reviews,0,0,0
1405216,True,0,No user reviews,0,0,0
1405217,True,0,No user reviews,0,0,0
1405218,True,0,No user reviews,0,0,0
1405219,True,0,No user reviews,0,0,0
1405220,True,0,2 user reviews,2,0,2
1405230,True,0,No user reviews,0,0,0
1405240,True,0,2 user reviews,0,2,2
1405241,True,7,Positive,8,2,10
1405250,True,0,No user reviews,0,0,0
1405260,True,0,No user reviews,0,0,0
1405270,True,0,No user reviews,0,0,0
1405290,True,0,No user reviews,0,0,0
1405300,True,0,No user reviews,0,0,0
1405320,True,0,No user reviews,0,0,0
1405370,True,0,No user reviews,0,0,0
1405380,True,0,No user reviews,0,0,0
1405400,True,0,No user reviews,0,0,0
1405401,True,0,No user reviews,0,0,0
1405410,True,0,No user reviews,0,0,0
1405440,True,7,Positive,15,0,15
1405460,True,0,No user reviews,0,0,0
1405470,True,0,No user reviews,0,0,0
1405490,True,0,No user reviews,0,0,0
1405500,True,0,No user reviews,0,0,0
1405510,True,0,No user reviews,0,0,0
1405520,True,0,No user reviews,0,0,0
1405530,True,0,No user reviews,0,0,0
1405540,True,0,No user reviews,0,0,0
1405541,True,0,No user reviews,0,0,0
1405542,True,0,No user reviews,0,0,0
1405543,True,0,No user reviews,0,0,0
1405550,True,0,No user reviews,0,0,0
1405551,True,0,No user reviews,0,0,0
1405552,True,0,No user reviews,0,0,0
1405553,True,0,No user reviews,0,0,0
1405554,True,0,No user reviews,0,0,0
1405555,True,0,No user reviews,0,0,0
1405556,True,0,No user reviews,0,0,0
1405557,True,0,No user reviews,0,0,0
1405560,True,0,No user reviews,0,0,0
1405570,True,0,No user reviews,0,0,0
1405580,True,0,No user reviews,0,0,0
1405590,True,0,No user reviews,0,0,0
1405600,True,0,No user reviews,0,0,0
1405610,True,0,1 user reviews,1,0,1
1405620,True,0,No user reviews,0,0,0
1405630,True,0,No user reviews,0,0,0
1405640,True,0,No user reviews,0,0,0
1405650,True,0,3 user reviews,3,0,3
1405660,True,7,Positive,8,2,10
1405670,True,0,No user reviews,0,0,0
1405690,True,0,No user reviews,0,0,0
1405710,True,0,No user reviews,0,0,0
1405720,True,0,No user reviews,0,0,0
1405730,True,0,No user reviews,0,0,0
1405740,True,0,No user reviews,0,0,0
1405750,True,0,No user reviews,0,0,0
1405770,True,0,No user reviews,0,0,0
1405780,True,0,No user reviews,0,0,0
1405790,True,0,No user reviews,0,0,0
1405840,True,0,No user reviews,0,0,0
1405850,True,0,No user reviews,0,0,0
1405860,True,0,No user reviews,0,0,0
1405870,True,0,No user reviews,0,0,0
1405871,True,0,No user reviews,0,0,0
1405872,True,0,No user reviews,0,0,0
1405873,True,0,No user reviews,0,0,0
1405874,True,0,No user reviews,0,0,0
1405875,True,0,1 user reviews,1,0,1
1405880,True,0,No user reviews,0,0,0
1405900,True,0,No user reviews,0,0,0
1405910,True,0,No user reviews,0,0,0
1405920,True,0,No user reviews,0,0,0
1405950,True,0,No user reviews,0,0,0
1405960,True,0,1 user reviews,1,0,1
1405970,True,0,No user reviews,0,0,0
1405980,True,0,1 user reviews,0,1,1
1405990,True,0,1 user reviews,1,0,1
1406000,True,0,No user reviews,0,0,0
1406010,True,0,2 user reviews,2,0,2
1406020,True,0,No user reviews,0,0,0
1406030,True,0,No user reviews,0,0,0
1406040,True,0,No user reviews,0,0,0
1406050,True,0,No user reviews,0,0,0
1406060,True,0,No user reviews,0,0,0
1406070,True,0,No user reviews,0,0,0
1406080,True,0,No user reviews,0,0,0
1406090,True,0,No user reviews,0,0,0
1406100,True,0,No user reviews,0,0,0
1406110,True,0,1 user reviews,1,0,1
1406130,True,0,No user reviews,0,0,0
1406140,True,0,8 user reviews,8,0,8
1406150,True,0,No user reviews,0,0,0
1406160,True,0,No user reviews,0,0,0
1406180,True,0,No user reviews,0,0,0
1406190,True,0,No user reviews,0,0,0
1406200,True,0,No user reviews,0,0,0
1406220,True,0,No user reviews,0,0,0
1406230,True,0,No user reviews,0,0,0
1406240,True,0,No user reviews,0,0,0
1406260,True,0,No user reviews,0,0,0
1406270,True,0,6 user reviews,6,0,6
1406280,True,0,No user reviews,0,0,0
1406330,True,0,No user reviews,0,0,0
1406350,True,0,2 user reviews,2,0,2
1406380,True,0,No user reviews,0,0,0
1406450,True,0,No user reviews,0,0,0
1406460,True,0,No user reviews,0,0,0
1406480,True,0,No user reviews,0,0,0
1406500,True,0,No user reviews,0,0,0
1406560,True,0,No user reviews,0,0,0
1406570,True,0,No user reviews,0,0,0
1406610,True,0,4 user reviews,1,3,4
1406670,True,0,No user reviews,0,0,0
1406690,True,0,7 user reviews,7,0,7
1406740,True,0,No user reviews,0,0,0
1406750,True,0,No user reviews,0,0,0
1406770,True,0,No user reviews,0,0,0
1406780,True,0,No user reviews,0,0,0
1406790,True,0,No user reviews,0,0,0
1406840,True,0,1 user reviews,1,0,1
1406850,True,0,No user reviews,0,0,0
1406860,True,0,No user reviews,0,0,0
1406870,True,0,No user reviews,0,0,0
1406900,True,0,1 user reviews,1,0,1
1406930,True,0,No user reviews,0,0,0
1406940,True,0,No user reviews,0,0,0
1406970,True,0,No user reviews,0,0,0
1406980,True,0,No user reviews,0,0,0
1406990,True,0,No user reviews,0,0,0
1407010,True,0,No user reviews,0,0,0
1407020,True,0,No user reviews,0,0,0
1407050,True,0,No user reviews,0,0,0
1407060,True,0,5 user reviews,4,1,5
1407080,True,0,No user reviews,0,0,0
1407110,True,0,No user reviews,0,0,0
1407150,True,0,No user reviews,0,0,0
1407160,True,0,No user reviews,0,0,0
1407180,True,0,No user reviews,0,0,0
1407210,True,0,No user reviews,0,0,0
1407220,True,0,No user reviews,0,0,0
1407230,True,0,No user reviews,0,0,0
1407240,True,0,1 user reviews,1,0,1
1407250,True,0,No user reviews,0,0,0
1407260,True,0,No user reviews,0,0,0
1407270,True,0,No user reviews,0,0,0
1407290,True,0,1 user reviews,1,0,1
1407340,True,0,No user reviews,0,0,0
1407400,True,0,No user reviews,0,0,0
1407420,True,0,No user reviews,0,0,0
1407430,True,0,No user reviews,0,0,0
1407450,True,0,No user reviews,0,0,0
1407460,True,0,No user reviews,0,0,0
1407510,True,0,No user reviews,0,0,0
1407520,True,0,No user reviews,0,0,0
1407530,True,0,1 user reviews,0,1,1
1407540,True,0,No user reviews,0,0,0
1407570,True,0,No user reviews,0,0,0
1407620,True,0,No user reviews,0,0,0
1407650,True,0,No user reviews,0,0,0
1407700,True,0,No user reviews,0,0,0
1407701,True,0,No user reviews,0,0,0
1407740,True,0,No user reviews,0,0,0
1407760,True,0,No user reviews,0,0,0
1407770,True,0,No user reviews,0,0,0
1407790,True,0,No user reviews,0,0,0
1407800,True,0,No user reviews,0,0,0
1407850,True,0,No user reviews,0,0,0
1407860,True,0,No user reviews,0,0,0
1407870,True,0,1 user reviews,1,0,1
1407900,True,0,No user reviews,0,0,0
1407930,True,0,No user reviews,0,0,0
1407940,True,0,No user reviews,0,0,0
1407950,True,0,No user reviews,0,0,0
1407980,True,0,No user reviews,0,0,0
1408000,True,0,1 user reviews,0,1,1
1408010,True,0,No user reviews,0,0,0
1408020,True,6,Mostly Positive,118,38,156
1408050,True,0,No user reviews,0,0,0
1408060,True,0,8 user reviews,8,0,8
1408100,True,0,No user reviews,0,0,0
1408110,True,0,No user reviews,0,0,0
1408160,True,0,No user reviews,0,0,0
1408180,True,0,No user reviews,0,0,0
1408181,True,0,No user reviews,0,0,0
1408182,True,0,No user reviews,0,0,0
1408183,True,0,No user reviews,0,0,0
1408184,True,0,No user reviews,0,0,0
1408185,True,0,No user reviews,0,0,0
1408186,True,0,No user reviews,0,0,0
1408187,True,0,No user reviews,0,0,0
1408188,True,0,No user reviews,0,0,0
1408189,True,0,No user reviews,0,0,0
1408190,True,0,No user reviews,0,0,0
1408200,True,0,2 user reviews,0,2,2
1408220,True,0,No user reviews,0,0,0
1408230,True,0,No user reviews,0,0,0
1408260,True,0,8 user reviews,8,0,8
1408270,True,0,No user reviews,0,0,0
1408280,True,0,No user reviews,0,0,0
1408290,True,0,No user reviews,0,0,0
1408300,True,0,No user reviews,0,0,0
1408310,True,0,No user reviews,0,0,0
1408320,True,0,No user reviews,0,0,0
1408330,True,0,No user reviews,0,0,0
1408350,True,0,1 user reviews,1,0,1
1408370,True,0,No user reviews,0,0,0
1408380,True,0,No user reviews,0,0,0
1408400,True,0,No user reviews,0,0,0
1408410,True,0,2 user reviews,2,0,2
1408420,True,0,No user reviews,0,0,0
1408430,True,0,No user reviews,0,0,0
1408440,True,0,No user reviews,0,0,0
1408450,True,0,No user reviews,0,0,0
1408460,True,0,No user reviews,0,0,0
1408470,True,0,No user reviews,0,0,0
1408480,True,0,No user reviews,0,0,0
1408490,True,0,No user reviews,0,0,0
1408510,True,0,No user reviews,0,0,0
1408520,True,0,No user reviews,0,0,0
1408550,True,0,No user reviews,0,0,0
1408570,True,0,No user reviews,0,0,0
1408580,True,0,No user reviews,0,0,0
1408590,True,0,No user reviews,0,0,0
1408630,True,0,3 user reviews,2,1,3
1408640,True,0,1 user reviews,1,0,1
1408650,True,0,No user reviews,0,0,0
1408670,True,0,No user reviews,0,0,0
1408690,True,0,No user reviews,0,0,0
1408700,True,0,1 user reviews,1,0,1
1408710,True,0,No user reviews,0,0,0
1408730,True,0,No user reviews,0,0,0
1408740,True,0,No user reviews,0,0,0
1408750,True,0,No user reviews,0,0,0
1408770,True,0,No user reviews,0,0,0
1408780,True,0,No user reviews,0,0,0
1408790,True,0,No user reviews,0,0,0
1408800,True,0,No user reviews,0,0,0
1408810,True,0,No user reviews,0,0,0
1408860,True,0,No user reviews,0,0,0
1408870,True,0,No user reviews,0,0,0
1408880,True,0,No user reviews,0,0,0
1408910,True,0,No user reviews,0,0,0
1408950,True,0,4 user reviews,4,0,4
1408960,True,0,1 user reviews,1,0,1
1408980,True,0,No user reviews,0,0,0
1408990,True,0,No user reviews,0,0,0
1409000,True,7,Positive,8,2,10
1409030,True,0,No user reviews,0,0,0
1409060,True,0,No user reviews,0,0,0
1409070,True,0,No user reviews,0,0,0
1409080,True,0,No user reviews,0,0,0
1409110,True,0,No user reviews,0,0,0
1409120,True,0,No user reviews,0,0,0
1409140,True,7,Positive,21,3,24
1409141,True,7,Positive,16,0,16
1409142,True,7,Positive,36,2,38
1409143,True,7,Positive,32,7,39
1409200,True,0,No user reviews,0,0,0
1409220,True,0,No user reviews,0,0,0
1409221,True,0,No user reviews,0,0,0
1409222,True,0,No user reviews,0,0,0
1409223,True,0,No user reviews,0,0,0
1409224,True,0,No user reviews,0,0,0
1409225,True,0,No user reviews,0,0,0
1409226,True,0,No user reviews,0,0,0
1409227,True,0,No user reviews,0,0,0
1409228,True,0,No user reviews,0,0,0
1409229,True,0,No user reviews,0,0,0
1409250,True,0,1 user reviews,1,0,1
1409260,True,0,No user reviews,0,0,0
1409270,True,0,No user reviews,0,0,0
1409280,True,0,No user reviews,0,0,0
1409300,True,0,No user reviews,0,0,0
1409310,True,0,1 user reviews,1,0,1
1409320,True,0,1 user reviews,1,0,1
1409330,True,0,1 user reviews,1,0,1
1409370,True,0,No user reviews,0,0,0
1409380,True,0,No user reviews,0,0,0
1409410,True,0,No user reviews,0,0,0
1409460,True,0,No user reviews,0,0,0
1409470,True,0,No user reviews,0,0,0
1409510,True,0,No user reviews,0,0,0
1409570,True,0,No user reviews,0,0,0
1409580,True,0,No user reviews,0,0,0
1409590,True,0,No user reviews,0,0,0
1409600,True,0,No user reviews,0,0,0
1409610,True,0,No user reviews,0,0,0
1409630,True,0,No user reviews,0,0,0
1409640,True,0,4 user reviews,4,0,4
1409670,True,0,No user reviews,0,0,0
1409680,True,0,2 user reviews,2,0,2
1409690,True,0,No user reviews,0,0,0
1409700,True,0,No user reviews,0,0,0
1409710,True,0,No user reviews,0,0,0
1409720,True,0,No user reviews,0,0,0
1409721,True,0,1 user reviews,1,0,1
1409730,True,7,Positive,15,3,18
1409740,True,7,Positive,12,3,15
1409750,True,0,No user reviews,0,0,0
1409760,True,0,No user reviews,0,0,0
1409790,True,0,No user reviews,0,0,0
1409830,True,0,No user reviews,0,0,0
1409840,True,0,No user reviews,0,0,0
1409850,True,0,No user reviews,0,0,0
1409860,True,0,No user reviews,0,0,0
1409910,True,0,No user reviews,0,0,0
1409920,True,0,No user reviews,0,0,0
1409930,True,0,1 user reviews,0,1,1
1410010,True,0,No user reviews,0,0,0
1410050,True,0,No user reviews,0,0,0
1410070,True,0,No user reviews,0,0,0
1410080,True,0,3 user reviews,2,1,3
1410090,True,0,No user reviews,0,0,0
1410110,True,0,No user reviews,0,0,0
1410130,True,0,No user reviews,0,0,0
1410140,True,0,No user reviews,0,0,0
1410160,True,0,No user reviews,0,0,0
1410170,True,0,No user reviews,0,0,0
1410190,True,0,No user reviews,0,0,0
1410200,True,0,No user reviews,0,0,0
1410210,True,0,1 user reviews,0,1,1
1410220,True,0,No user reviews,0,0,0
1410320,True,0,No user reviews,0,0,0
1410330,True,0,No user reviews,0,0,0
1410340,True,0,No user reviews,0,0,0
1410350,True,0,No user reviews,0,0,0
1410370,True,0,No user reviews,0,0,0
1410380,True,0,1 user reviews,1,0,1
1410430,True,0,No user reviews,0,0,0
1410490,True,0,No user reviews,0,0,0
1410500,True,0,1 user reviews,1,0,1
1410510,True,0,No user reviews,0,0,0
1410520,True,0,No user reviews,0,0,0
1410580,True,0,3 user reviews,2,1,3
1410590,True,0,No user reviews,0,0,0
1410600,True,0,No user reviews,0,0,0
1410620,True,0,No user reviews,0,0,0
1410650,True,0,No user reviews,0,0,0
1410680,True,0,No user reviews,0,0,0
1410690,True,0,No user reviews,0,0,0
1410700,True,0,No user reviews,0,0,0
1410710,True,8,Very Positive,218,50,268
1410760,True,0,No user reviews,0,0,0
1410780,True,0,No user reviews,0,0,0
1410790,True,0,1 user reviews,1,0,1
1410820,True,0,No user reviews,0,0,0
1410900,True,0,No user reviews,0,0,0
1410910,True,0,No user reviews,0,0,0
1410930,True,0,No user reviews,0,0,0
1410940,True,0,No user reviews,0,0,0
1410970,True,0,No user reviews,0,0,0
1410990,True,0,No user reviews,0,0,0
1411000,True,0,No user reviews,0,0,0
1411030,True,0,No user reviews,0,0,0
1411040,True,0,No user reviews,0,0,0
1411060,True,0,No user reviews,0,0,0
1411070,True,0,No user reviews,0,0,0
1411080,True,0,1 user reviews,1,0,1
1411090,True,0,No user reviews,0,0,0
1411100,True,0,No user reviews,0,0,0
1411110,True,0,No user reviews,0,0,0
1411120,True,0,No user reviews,0,0,0
1411140,True,0,No user reviews,0,0,0
1411150,True,0,No user reviews,0,0,0
1411160,True,0,No user reviews,0,0,0
1411170,True,0,2 user reviews,1,1,2
1411200,True,0,No user reviews,0,0,0
1411210,True,0,No user reviews,0,0,0
1411250,True,0,No user reviews,0,0,0
1411260,True,0,No user reviews,0,0,0
1411300,True,0,No user reviews,0,0,0
1411310,True,0,No user reviews,0,0,0
1411330,True,0,No user reviews,0,0,0
1411360,True,0,No user reviews,0,0,0
1411380,True,0,No user reviews,0,0,0
1411390,True,0,No user reviews,0,0,0
1411400,True,0,No user reviews,0,0,0
1411410,True,0,1 user reviews,1,0,1
1411420,True,0,2 user reviews,2,0,2
1411430,True,0,No user reviews,0,0,0
1411490,True,0,1 user reviews,0,1,1
1411510,True,0,No user reviews,0,0,0
1411520,True,0,No user reviews,0,0,0
1411530,True,0,No user reviews,0,0,0
1411540,True,0,No user reviews,0,0,0
1411550,True,0,No user reviews,0,0,0
1411600,True,0,No user reviews,0,0,0
1411610,True,0,No user reviews,0,0,0
1411620,True,0,No user reviews,0,0,0
1411630,True,0,No user reviews,0,0,0
1411660,True,0,No user reviews,0,0,0
1411670,True,0,No user reviews,0,0,0
1411680,True,0,No user reviews,0,0,0
1411690,True,0,No user reviews,0,0,0
1411710,True,0,No user reviews,0,0,0
1411750,True,0,No user reviews,0,0,0
1411760,True,0,No user reviews,0,0,0
1411770,True,0,No user reviews,0,0,0
1411790,True,0,No user reviews,0,0,0
1411800,True,0,No user reviews,0,0,0
1411840,True,0,1 user reviews,1,0,1
1411850,True,0,No user reviews,0,0,0
1411860,True,0,3 user reviews,2,1,3
1411870,True,0,No user reviews,0,0,0
1411880,True,0,1 user reviews,0,1,1
1411890,True,0,No user reviews,0,0,0
1411900,True,0,No user reviews,0,0,0
1411910,True,0,No user reviews,0,0,0
1411920,True,0,No user reviews,0,0,0
1411930,True,0,No user reviews,0,0,0
1411940,True,0,No user reviews,0,0,0
1411960,True,0,No user reviews,0,0,0
1412000,True,0,4 user reviews,1,3,4
1412040,True,0,5 user reviews,4,1,5
1412050,True,0,No user reviews,0,0,0
1412060,True,0,No user reviews,0,0,0
1412080,True,0,No user reviews,0,0,0
1412090,True,0,No user reviews,0,0,0
1412120,True,0,No user reviews,0,0,0
1412140,True,0,No user reviews,0,0,0
1412170,True,0,No user reviews,0,0,0
1412180,True,0,No user reviews,0,0,0
1412190,True,0,No user reviews,0,0,0
1412200,True,0,No user reviews,0,0,0
1412220,True,0,No user reviews,0,0,0
1412230,True,0,No user reviews,0,0,0
1412240,True,0,No user reviews,0,0,0
1412250,True,0,No user reviews,0,0,0
1412280,True,0,No user reviews,0,0,0
1412281,True,0,No user reviews,0,0,0
1412282,True,0,No user reviews,0,0,0
1412283,True,0,No user reviews,0,0,0
1412300,True,0,1 user reviews,1,0,1
1412310,True,0,No user reviews,0,0,0
1412320,True,0,No user reviews,0,0,0
1412330,True,0,No user reviews,0,0,0
1412350,True,0,No user reviews,0,0,0
1412370,True,0,No user reviews,0,0,0
1412380,True,0,No user reviews,0,0,0
1412420,True,0,No user reviews,0,0,0
1412430,True,0,No user reviews,0,0,0
1412440,True,0,No user reviews,0,0,0
1412450,True,0,2 user reviews,2,0,2
1412470,True,0,No user reviews,0,0,0
1412490,True,0,No user reviews,0,0,0
1412500,True,0,No user reviews,0,0,0
1412510,True,0,No user reviews,0,0,0
1412520,True,0,4 user reviews,4,0,4
1412530,True,0,9 user reviews,7,2,9
1412540,True,0,No user reviews,0,0,0
1412560,True,0,No user reviews,0,0,0
1412590,True,0,No user reviews,0,0,0
1412610,True,0,2 user reviews,2,0,2
1412630,True,0,2 user reviews,2,0,2
1412640,True,0,No user reviews,0,0,0
1412660,True,0,9 user reviews,9,0,9
1412680,True,0,No user reviews,0,0,0
1412690,True,0,1 user reviews,1,0,1
1412700,True,0,No user reviews,0,0,0
1412710,True,0,No user reviews,0,0,0
1412730,True,0,No user reviews,0,0,0
1412750,True,0,No user reviews,0,0,0
1412760,True,0,No user reviews,0,0,0
1412780,True,6,Mostly Positive,60,16,76
1412790,True,0,No user reviews,0,0,0
1412800,True,0,No user reviews,0,0,0
1412830,True,0,No user reviews,0,0,0
1412850,True,0,No user reviews,0,0,0
1412870,True,0,No user reviews,0,0,0
1412880,True,0,No user reviews,0,0,0
1412900,True,0,1 user reviews,1,0,1
1412920,True,0,No user reviews,0,0,0
1412930,True,0,No user reviews,0,0,0
1412940,True,0,No user reviews,0,0,0
1412980,True,0,4 user reviews,4,0,4
1413010,True,0,7 user reviews,5,2,7
1413020,True,7,Positive,20,2,22
1413060,True,0,No user reviews,0,0,0
1413070,True,0,9 user reviews,6,3,9
1413080,True,0,No user reviews,0,0,0
1413130,True,0,No user reviews,0,0,0
1413170,True,0,1 user reviews,1,0,1
1413210,True,0,3 user reviews,3,0,3
1413230,True,0,1 user reviews,1,0,1
1413240,True,0,2 user reviews,2,0,2
1413250,True,0,No user reviews,0,0,0
1413260,True,0,No user reviews,0,0,0
1413280,True,0,No user reviews,0,0,0
1413300,True,0,2 user reviews,2,0,2
1413310,True,0,No user reviews,0,0,0
1413340,True,0,No user reviews,0,0,0
1413350,True,0,1 user reviews,1,0,1
1413370,True,0,No user reviews,0,0,0
1413410,True,0,No user reviews,0,0,0
1413440,True,0,No user reviews,0,0,0
1413450,True,7,Positive,19,3,22
1413470,True,0,No user reviews,0,0,0
1413490,True,0,No user reviews,0,0,0
1413500,True,0,1 user reviews,1,0,1
1413510,True,0,No user reviews,0,0,0
1413520,True,0,1 user reviews,1,0,1
1413530,True,0,No user reviews,0,0,0
1413540,True,0,No user reviews,0,0,0
1413550,True,0,No user reviews,0,0,0
1413560,True,0,1 user reviews,1,0,1
1413580,True,0,No user reviews,0,0,0
1413590,True,0,No user reviews,0,0,0
1413620,True,0,No user reviews,0,0,0
1413630,True,0,2 user reviews,2,0,2
1413640,True,0,No user reviews,0,0,0
1413650,True,0,No user reviews,0,0,0
1413660,True,0,No user reviews,0,0,0
1413670,True,0,No user reviews,0,0,0
1413690,True,0,No user reviews,0,0,0
1413700,True,0,No user reviews,0,0,0
1413750,True,0,No user reviews,0,0,0
1413780,True,0,No user reviews,0,0,0
1413790,True,0,6 user reviews,5,1,6
1413800,True,0,1 user reviews,1,0,1
1413810,True,0,No user reviews,0,0,0
1413820,True,0,No user reviews,0,0,0
1413880,True,0,No user reviews,0,0,0
1413890,True,0,1 user reviews,0,1,1
1413900,True,0,No user reviews,0,0,0
1413920,True,0,No user reviews,0,0,0
1413930,True,0,No user reviews,0,0,0
1414020,True,0,No user reviews,0,0,0
1414050,True,5,Mixed,6,5,11
1414060,True,0,1 user reviews,1,0,1
1414070,True,0,No user reviews,0,0,0
1414080,True,0,No user reviews,0,0,0
1414090,True,0,No user reviews,0,0,0
1414100,True,0,No user reviews,0,0,0
1414130,True,0,No user reviews,0,0,0
1414131,True,0,No user reviews,0,0,0
1414170,True,0,No user reviews,0,0,0
1414180,True,0,No user reviews,0,0,0
1414190,True,0,No user reviews,0,0,0
1414200,True,0,No user reviews,0,0,0
1414210,True,0,No user reviews,0,0,0
1414220,True,0,No user reviews,0,0,0
1414240,True,0,No user reviews,0,0,0
1414270,True,0,No user reviews,0,0,0
1414280,True,0,No user reviews,0,0,0
1414290,True,0,No user reviews,0,0,0
1414300,True,0,No user reviews,0,0,0
1414320,True,0,No user reviews,0,0,0
1414330,True,0,No user reviews,0,0,0
1414340,True,0,No user reviews,0,0,0
1414370,True,0,No user reviews,0,0,0
1414380,True,0,No user reviews,0,0,0
1414450,True,0,No user reviews,0,0,0
1414460,True,0,No user reviews,0,0,0
1414470,True,0,No user reviews,0,0,0
1414480,True,0,1 user reviews,1,0,1
1414490,True,0,No user reviews,0,0,0
1414500,True,0,1 user reviews,0,1,1
1414540,True,0,No user reviews,0,0,0
1414570,True,0,No user reviews,0,0,0
1414590,True,0,No user reviews,0,0,0
1414600,True,0,No user reviews,0,0,0
1414640,True,0,No user reviews,0,0,0
1414680,True,0,1 user reviews,1,0,1
1414690,True,0,1 user reviews,1,0,1
1414700,True,0,No user reviews,0,0,0
1414710,True,0,No user reviews,0,0,0
1414720,True,0,4 user reviews,4,0,4
1414770,True,0,No user reviews,0,0,0
1414790,True,0,No user reviews,0,0,0
1414800,True,0,No user reviews,0,0,0
1414810,True,0,No user reviews,0,0,0
1414820,True,0,2 user reviews,1,1,2
1414840,True,0,3 user reviews,3,0,3
1414860,True,0,No user reviews,0,0,0
1414870,True,0,No user reviews,0,0,0
1414900,True,0,No user reviews,0,0,0
1414910,True,0,No user reviews,0,0,0
1414920,True,0,No user reviews,0,0,0
1414930,True,0,No user reviews,0,0,0
1414990,True,0,4 user reviews,4,0,4
1415010,True,0,No user reviews,0,0,0
1415020,True,0,No user reviews,0,0,0
1415030,True,0,No user reviews,0,0,0
1415040,True,0,No user reviews,0,0,0
1415060,True,0,No user reviews,0,0,0
1415110,True,0,1 user reviews,1,0,1
1415140,True,0,7 user reviews,6,1,7
1415200,True,0,No user reviews,0,0,0
1415250,True,0,7 user reviews,7,0,7
1415270,True,0,No user reviews,0,0,0
1415280,True,0,No user reviews,0,0,0
1415290,True,0,No user reviews,0,0,0
1415300,True,0,No user reviews,0,0,0
1415320,True,0,No user reviews,0,0,0
1415330,True,0,No user reviews,0,0,0
1415340,True,0,No user reviews,0,0,0
1415370,True,0,3 user reviews,2,1,3
1415410,True,0,No user reviews,0,0,0
1415420,True,0,3 user reviews,3,0,3
1415470,True,0,No user reviews,0,0,0
1415480,True,0,2 user reviews,1,1,2
1415490,True,0,No user reviews,0,0,0
1415500,True,0,No user reviews,0,0,0
1415510,True,7,Positive,10,0,10
1415530,True,0,3 user reviews,0,3,3
1415550,True,0,No user reviews,0,0,0
1415590,True,0,No user reviews,0,0,0
1415600,True,0,No user reviews,0,0,0
1415610,True,0,No user reviews,0,0,0
1415620,True,0,No user reviews,0,0,0
1415630,True,0,2 user reviews,2,0,2
1415640,True,0,No user reviews,0,0,0
1415660,True,0,No user reviews,0,0,0
1415670,True,0,No user reviews,0,0,0
1415691,True,7,Positive,45,4,49
1415700,True,7,Positive,16,0,16
1415750,True,0,4 user reviews,4,0,4
1415830,True,0,2 user reviews,1,1,2
1415870,True,0,No user reviews,0,0,0
1415900,True,0,No user reviews,0,0,0
1415940,True,0,No user reviews,0,0,0
1415950,True,0,No user reviews,0,0,0
1415970,True,0,No user reviews,0,0,0
1416000,True,0,6 user reviews,6,0,6
1416010,True,0,No user reviews,0,0,0
1416020,True,0,No user reviews,0,0,0
1416090,True,0,1 user reviews,1,0,1
1416120,True,0,No user reviews,0,0,0
1416130,True,0,No user reviews,0,0,0
1416150,True,0,No user reviews,0,0,0
1416160,True,0,No user reviews,0,0,0
1416170,True,0,No user reviews,0,0,0
1416180,True,0,No user reviews,0,0,0
1416190,True,0,No user reviews,0,0,0
1416200,True,0,No user reviews,0,0,0
1416210,True,0,1 user reviews,1,0,1
1416220,True,0,No user reviews,0,0,0
1416230,True,7,Positive,14,1,15
1416240,True,0,No user reviews,0,0,0
1416250,True,0,No user reviews,0,0,0
1416290,True,0,No user reviews,0,0,0
1416300,True,0,No user reviews,0,0,0
1416310,True,0,No user reviews,0,0,0
1416320,True,0,No user reviews,0,0,0
1416340,True,0,No user reviews,0,0,0
1416350,True,0,No user reviews,0,0,0
1416360,True,0,No user reviews,0,0,0
1416370,True,0,No user reviews,0,0,0
1416430,True,0,1 user reviews,1,0,1
1416450,True,0,3 user reviews,2,1,3
1416460,True,0,No user reviews,0,0,0
1416480,True,0,No user reviews,0,0,0
1416520,True,0,No user reviews,0,0,0
1416560,True,0,No user reviews,0,0,0
1416590,True,0,No user reviews,0,0,0
1416600,True,0,No user reviews,0,0,0
1416620,True,0,No user reviews,0,0,0
1416630,True,0,No user reviews,0,0,0
1416640,True,0,No user reviews,0,0,0
1416660,True,0,No user reviews,0,0,0
1416690,True,0,3 user reviews,3,0,3
1416700,True,0,No user reviews,0,0,0
1416710,True,0,1 user reviews,0,1,1
1416720,True,0,No user reviews,0,0,0
1416730,True,0,No user reviews,0,0,0
1416740,True,0,No user reviews,0,0,0
1416760,True,0,No user reviews,0,0,0
1416770,True,0,No user reviews,0,0,0
1416790,True,0,No user reviews,0,0,0
1416820,True,0,No user reviews,0,0,0
1416840,True,0,No user reviews,0,0,0
1416850,True,0,1 user reviews,1,0,1
1416880,True,0,No user reviews,0,0,0
1416900,True,0,No user reviews,0,0,0
1416930,True,0,No user reviews,0,0,0
1416960,True,0,No user reviews,0,0,0
1416980,True,0,No user reviews,0,0,0
1416990,True,0,No user reviews,0,0,0
1417010,True,0,No user reviews,0,0,0
1417090,True,0,No user reviews,0,0,0
1417100,True,0,No user reviews,0,0,0
1417170,True,0,No user reviews,0,0,0
1417190,True,0,No user reviews,0,0,0
1417230,True,0,1 user reviews,1,0,1
1417250,True,0,1 user reviews,0,1,1
1417260,True,7,Positive,23,0,23
1417270,True,0,1 user reviews,1,0,1
1417280,True,0,No user reviews,0,0,0
1417290,True,0,No user reviews,0,0,0
1417310,True,0,No user reviews,0,0,0
1417340,True,0,1 user reviews,1,0,1
1417360,True,0,No user reviews,0,0,0
1417410,True,0,No user reviews,0,0,0
1417420,True,0,4 user reviews,3,1,4
1417430,True,0,No user reviews,0,0,0
1417440,True,0,No user reviews,0,0,0
1417450,True,0,No user reviews,0,0,0
1417460,True,0,No user reviews,0,0,0
1417470,True,0,No user reviews,0,0,0
1417480,True,0,No user reviews,0,0,0
1417490,True,0,No user reviews,0,0,0
1417500,True,6,Mostly Positive,12,4,16
1417510,True,0,No user reviews,0,0,0
1417530,True,0,No user reviews,0,0,0
1417540,True,0,8 user reviews,8,0,8
1417560,True,0,No user reviews,0,0,0
1417580,True,0,1 user reviews,1,0,1
1417590,True,0,No user reviews,0,0,0
1417600,True,7,Positive,16,4,20
1417610,True,0,4 user reviews,3,1,4
1417630,True,0,No user reviews,0,0,0
1417640,True,0,1 user reviews,1,0,1
1417650,True,0,No user reviews,0,0,0
1417670,True,0,7 user reviews,6,1,7
1417680,True,0,1 user reviews,0,1,1
1417690,True,0,No user reviews,0,0,0
1417710,True,0,No user reviews,0,0,0
1417720,True,7,Positive,16,0,16
1417740,True,0,No user reviews,0,0,0
1417770,True,0,1 user reviews,1,0,1
1417800,True,0,No user reviews,0,0,0
1417840,True,0,No user reviews,0,0,0
1417850,True,0,No user reviews,0,0,0
1417880,True,0,No user reviews,0,0,0
1417920,True,0,No user reviews,0,0,0
1417940,True,0,No user reviews,0,0,0
1417960,True,0,No user reviews,0,0,0
1417980,True,0,No user reviews,0,0,0
1418000,True,0,No user reviews,0,0,0
1418010,True,0,4 user reviews,4,0,4
1418070,True,0,No user reviews,0,0,0
1418080,True,0,No user reviews,0,0,0
1418090,True,0,4 user reviews,4,0,4
1418120,True,0,No user reviews,0,0,0
1418130,True,0,No user reviews,0,0,0
1418140,True,0,No user reviews,0,0,0
1418150,True,0,No user reviews,0,0,0
1418160,True,0,No user reviews,0,0,0
1418170,True,0,4 user reviews,2,2,4
1418200,True,0,No user reviews,0,0,0
1418240,True,0,No user reviews,0,0,0
1418260,True,0,No user reviews,0,0,0
1418290,True,0,No user reviews,0,0,0
1418300,True,0,1 user reviews,1,0,1
1418310,True,7,Positive,10,1,11
1418320,True,0,No user reviews,0,0,0
1418330,True,0,1 user reviews,1,0,1
1418350,True,0,No user reviews,0,0,0
1418360,True,0,No user reviews,0,0,0
1418370,True,0,No user reviews,0,0,0
1418380,True,0,No user reviews,0,0,0
1418400,True,0,1 user reviews,1,0,1
1418410,True,0,No user reviews,0,0,0
1418420,True,0,No user reviews,0,0,0
1418430,True,0,No user reviews,0,0,0
1418440,True,0,No user reviews,0,0,0
1418460,True,0,4 user reviews,4,0,4
1418480,True,0,No user reviews,0,0,0
1418490,True,0,1 user reviews,1,0,1
1418500,True,0,No user reviews,0,0,0
1418520,True,0,No user reviews,0,0,0
1418530,True,0,No user reviews,0,0,0
1418550,True,0,No user reviews,0,0,0
1418560,True,0,No user reviews,0,0,0
1418570,True,7,Positive,10,0,10
1418600,True,0,No user reviews,0,0,0
1418610,True,0,No user reviews,0,0,0
1418640,True,0,No user reviews,0,0,0
1418650,True,0,No user reviews,0,0,0
1418660,True,0,No user reviews,0,0,0
1418670,True,0,No user reviews,0,0,0
1418680,True,0,3 user reviews,3,0,3
1418720,True,7,Positive,16,1,17
1418770,True,0,No user reviews,0,0,0
1418790,True,0,No user reviews,0,0,0
1418800,True,0,No user reviews,0,0,0
1418820,True,0,No user reviews,0,0,0
1418860,True,0,2 user reviews,2,0,2
1418910,True,0,No user reviews,0,0,0
1418920,True,0,No user reviews,0,0,0
1418930,True,0,No user reviews,0,0,0
1418940,True,0,No user reviews,0,0,0
1418950,True,0,No user reviews,0,0,0
1418980,True,7,Positive,16,0,16
1419010,True,0,No user reviews,0,0,0
1419060,True,0,No user reviews,0,0,0
1419070,True,0,No user reviews,0,0,0
1419080,True,0,No user reviews,0,0,0
1419090,True,0,No user reviews,0,0,0
1419100,True,0,No user reviews,0,0,0
1419110,True,0,1 user reviews,1,0,1
1419120,True,0,No user reviews,0,0,0
1419121,True,0,No user reviews,0,0,0
1419122,True,0,No user reviews,0,0,0
1419140,True,0,No user reviews,0,0,0
1419150,True,0,No user reviews,0,0,0
1419190,True,0,3 user reviews,2,1,3
1419200,True,0,1 user reviews,0,1,1
1419210,True,0,No user reviews,0,0,0
1419220,True,0,No user reviews,0,0,0
1419240,True,0,No user reviews,0,0,0
1419250,True,0,No user reviews,0,0,0
1419270,True,0,No user reviews,0,0,0
1419310,True,0,No user reviews,0,0,0
1419320,True,0,No user reviews,0,0,0
1419370,True,0,1 user reviews,1,0,1
1419380,True,0,No user reviews,0,0,0
1419400,True,0,No user reviews,0,0,0
1419420,True,0,No user reviews,0,0,0
1419430,True,0,No user reviews,0,0,0
1419440,True,0,No user reviews,0,0,0
1419480,True,0,3 user reviews,3,0,3
1419490,True,0,No user reviews,0,0,0
1419540,True,0,No user reviews,0,0,0
1419580,True,0,No user reviews,0,0,0
1419670,True,0,No user reviews,0,0,0
1419710,True,0,No user reviews,0,0,0
1419720,True,0,No user reviews,0,0,0
1419730,True,7,Positive,23,3,26
1419740,True,0,No user reviews,0,0,0
1419770,True,0,No user reviews,0,0,0
1419790,True,0,No user reviews,0,0,0
1419810,True,0,No user reviews,0,0,0
1419820,True,0,No user reviews,0,0,0
1419830,True,0,No user reviews,0,0,0
1419840,True,0,No user reviews,0,0,0
1419870,True,0,No user reviews,0,0,0
1419880,True,0,No user reviews,0,0,0
1419900,True,0,1 user reviews,0,1,1
1419940,True,0,No user reviews,0,0,0
1419950,True,0,No user reviews,0,0,0
1419960,True,0,No user reviews,0,0,0
1420030,True,0,No user reviews,0,0,0
1420050,True,0,No user reviews,0,0,0
1420060,True,0,No user reviews,0,0,0
1420070,True,0,No user reviews,0,0,0
1420071,True,0,No user reviews,0,0,0
1420100,True,0,No user reviews,0,0,0
1420110,True,0,No user reviews,0,0,0
1420140,True,0,No user reviews,0,0,0
1420160,True,0,No user reviews,0,0,0
1420250,True,0,No user reviews,0,0,0
1420320,True,0,No user reviews,0,0,0
1420330,True,0,2 user reviews,2,0,2
1420360,True,0,No user reviews,0,0,0
1420370,True,0,No user reviews,0,0,0
1420380,True,0,No user reviews,0,0,0
1420390,True,0,1 user reviews,1,0,1
1420410,True,0,No user reviews,0,0,0
1420420,True,0,No user reviews,0,0,0
1420470,True,0,No user reviews,0,0,0
1420471,True,0,No user reviews,0,0,0
1420490,True,0,No user reviews,0,0,0
1420510,True,0,No user reviews,0,0,0
1420520,True,0,No user reviews,0,0,0
1420540,True,0,No user reviews,0,0,0
1420580,True,0,No user reviews,0,0,0
1420620,True,0,No user reviews,0,0,0
1420630,True,0,No user reviews,0,0,0
1420640,True,0,No user reviews,0,0,0
1420670,True,0,No user reviews,0,0,0
1420690,True,0,1 user reviews,1,0,1
1420710,True,0,No user reviews,0,0,0
1420720,True,0,No user reviews,0,0,0
1420730,True,0,No user reviews,0,0,0
1420740,True,7,Positive,21,4,25
1420830,True,7,Positive,32,1,33
1420850,True,0,No user reviews,0,0,0
1420860,True,0,No user reviews,0,0,0
1420870,True,0,No user reviews,0,0,0
1420880,True,0,No user reviews,0,0,0
1420890,True,0,1 user reviews,0,1,1
1420930,True,0,No user reviews,0,0,0
1420940,True,0,No user reviews,0,0,0
1420950,True,0,4 user reviews,4,0,4
1420960,True,0,1 user reviews,1,0,1
1420970,True,0,No user reviews,0,0,0
1420980,True,0,No user reviews,0,0,0
1420990,True,0,No user reviews,0,0,0
1421010,True,0,No user reviews,0,0,0
1421020,True,0,3 user reviews,3,0,3
1421040,True,0,No user reviews,0,0,0
1421050,True,0,No user reviews,0,0,0
1421060,True,0,No user reviews,0,0,0
1421070,True,0,No user reviews,0,0,0
1421090,True,0,No user reviews,0,0,0
1421100,True,0,No user reviews,0,0,0
1421110,True,0,No user reviews,0,0,0
1421120,True,0,1 user reviews,1,0,1
1421130,True,0,No user reviews,0,0,0
1421150,True,0,No user reviews,0,0,0
1421160,True,0,No user reviews,0,0,0
1421190,True,0,No user reviews,0,0,0
1421230,True,0,No user reviews,0,0,0
1421280,True,0,No user reviews,0,0,0
1421310,True,0,1 user reviews,0,1,1
1421320,True,0,1 user reviews,1,0,1
1421370,True,0,No user reviews,0,0,0
1421420,True,0,No user reviews,0,0,0
1421460,True,0,No user reviews,0,0,0
1421480,True,0,7 user reviews,7,0,7
1421500,True,0,No user reviews,0,0,0
1421560,True,0,No user reviews,0,0,0
1421580,True,0,1 user reviews,1,0,1
1421630,True,0,No user reviews,0,0,0
1421640,True,0,No user reviews,0,0,0
1421650,True,0,No user reviews,0,0,0
1421651,True,0,No user reviews,0,0,0
1421652,True,0,No user reviews,0,0,0
1421653,True,0,No user reviews,0,0,0
1421680,True,0,No user reviews,0,0,0
1421690,True,0,No user reviews,0,0,0
1421760,True,0,No user reviews,0,0,0
1421770,True,0,No user reviews,0,0,0
1421780,True,0,No user reviews,0,0,0
1421781,True,0,No user reviews,0,0,0
1421782,True,0,No user reviews,0,0,0
1421783,True,0,No user reviews,0,0,0
1421784,True,0,No user reviews,0,0,0
1421785,True,0,No user reviews,0,0,0
1421786,True,0,No user reviews,0,0,0
1421787,True,0,No user reviews,0,0,0
1421788,True,0,No user reviews,0,0,0
1421790,True,0,No user reviews,0,0,0
1421800,True,0,No user reviews,0,0,0
1421801,True,0,No user reviews,0,0,0
1421802,True,0,No user reviews,0,0,0
1421803,True,0,No user reviews,0,0,0
1421804,True,0,No user reviews,0,0,0
1421805,True,0,No user reviews,0,0,0
1421806,True,0,No user reviews,0,0,0
1421807,True,0,No user reviews,0,0,0
1421808,True,0,No user reviews,0,0,0
1421809,True,0,No user reviews,0,0,0
1421810,True,0,No user reviews,0,0,0
1421811,True,0,No user reviews,0,0,0
1421812,True,0,No user reviews,0,0,0
1421813,True,0,No user reviews,0,0,0
1421814,True,0,No user reviews,0,0,0
1421830,True,0,No user reviews,0,0,0
1421831,True,0,No user reviews,0,0,0
1421832,True,0,No user reviews,0,0,0
1421833,True,0,No user reviews,0,0,0
1421834,True,0,No user reviews,0,0,0
1421835,True,0,No user reviews,0,0,0
1421836,True,0,No user reviews,0,0,0
1421837,True,0,No user reviews,0,0,0
1421838,True,0,No user reviews,0,0,0
1421839,True,0,No user reviews,0,0,0
1421840,True,0,No user reviews,0,0,0
1421841,True,0,No user reviews,0,0,0
1421842,True,0,No user reviews,0,0,0
1421843,True,0,No user reviews,0,0,0
1421844,True,0,No user reviews,0,0,0
1421845,True,0,No user reviews,0,0,0
1421846,True,0,No user reviews,0,0,0
1421847,True,0,No user reviews,0,0,0
1421848,True,0,No user reviews,0,0,0
1421849,True,0,No user reviews,0,0,0
1421850,True,0,No user reviews,0,0,0
1421851,True,0,No user reviews,0,0,0
1421852,True,0,No user reviews,0,0,0
1421853,True,0,No user reviews,0,0,0
1421854,True,0,No user reviews,0,0,0
1421855,True,0,No user reviews,0,0,0
1421856,True,0,No user reviews,0,0,0
1421857,True,0,No user reviews,0,0,0
1421858,True,0,No user reviews,0,0,0
1421859,True,0,No user reviews,0,0,0
1421860,True,0,No user reviews,0,0,0
1421861,True,0,No user reviews,0,0,0
1421862,True,0,No user reviews,0,0,0
1421863,True,0,No user reviews,0,0,0
1421864,True,0,No user reviews,0,0,0
1421865,True,0,No user reviews,0,0,0
1421866,True,0,No user reviews,0,0,0
1421867,True,0,No user reviews,0,0,0
1421868,True,0,No user reviews,0,0,0
1421870,True,0,No user reviews,0,0,0
1421871,True,0,No user reviews,0,0,0
1421872,True,0,No user reviews,0,0,0
1421873,True,0,No user reviews,0,0,0
1421874,True,0,No user reviews,0,0,0
1421875,True,0,No user reviews,0,0,0
1421876,True,0,No user reviews,0,0,0
1421877,True,0,No user reviews,0,0,0
1421878,True,0,No user reviews,0,0,0
1421880,True,0,No user reviews,0,0,0
1421881,True,0,No user reviews,0,0,0
1421882,True,0,No user reviews,0,0,0
1421883,True,0,No user reviews,0,0,0
1421884,True,0,No user reviews,0,0,0
1421885,True,0,No user reviews,0,0,0
1421886,True,0,No user reviews,0,0,0
1421887,True,0,No user reviews,0,0,0
1421888,True,0,No user reviews,0,0,0
1421890,True,0,No user reviews,0,0,0
1421891,True,0,No user reviews,0,0,0
1421892,True,0,No user reviews,0,0,0
1421893,True,0,No user reviews,0,0,0
1421894,True,0,No user reviews,0,0,0
1421895,True,0,No user reviews,0,0,0
1421896,True,0,No user reviews,0,0,0
1421897,True,0,No user reviews,0,0,0
1421898,True,0,No user reviews,0,0,0
1421910,True,0,No user reviews,0,0,0
1421911,True,0,No user reviews,0,0,0
1421912,True,0,No user reviews,0,0,0
1421913,True,0,No user reviews,0,0,0
1421914,True,0,No user reviews,0,0,0
1421915,True,0,No user reviews,0,0,0
1421950,True,0,No user reviews,0,0,0
1421960,True,0,No user reviews,0,0,0
1421990,True,0,No user reviews,0,0,0
1422020,True,0,No user reviews,0,0,0
1422030,True,0,No user reviews,0,0,0
1422050,True,0,No user reviews,0,0,0
1422060,True,0,No user reviews,0,0,0
1422070,True,0,No user reviews,0,0,0
1422080,True,0,2 user reviews,1,1,2
1422090,True,0,4 user reviews,4,0,4
1422130,True,0,No user reviews,0,0,0
1422140,True,0,No user reviews,0,0,0
1422150,True,0,No user reviews,0,0,0
1422170,True,0,No user reviews,0,0,0
1422190,True,0,No user reviews,0,0,0
1422200,True,0,4 user reviews,4,0,4
1422210,True,7,Positive,12,0,12
1422240,True,0,3 user reviews,3,0,3
1422250,True,0,No user reviews,0,0,0
1422260,True,0,No user reviews,0,0,0
1422300,True,0,No user reviews,0,0,0
1422310,True,0,No user reviews,0,0,0
1422320,True,0,No user reviews,0,0,0
1422350,True,0,No user reviews,0,0,0
1422360,True,0,No user reviews,0,0,0
1422380,True,0,No user reviews,0,0,0
1422470,True,0,No user reviews,0,0,0
1422520,True,0,No user reviews,0,0,0
1422530,True,0,No user reviews,0,0,0
1422540,True,0,No user reviews,0,0,0
1422550,True,0,No user reviews,0,0,0
1422580,True,0,No user reviews,0,0,0
1422600,True,0,No user reviews,0,0,0
1422610,True,0,No user reviews,0,0,0
1422620,True,0,No user reviews,0,0,0
1422630,True,0,No user reviews,0,0,0
1422670,True,0,No user reviews,0,0,0
1422680,True,0,1 user reviews,1,0,1
1422720,True,0,No user reviews,0,0,0
1422740,True,0,1 user reviews,1,0,1
1422750,True,7,Positive,16,3,19
1422780,True,0,No user reviews,0,0,0
1422790,True,0,No user reviews,0,0,0
1422800,True,0,No user reviews,0,0,0
1422810,True,0,2 user reviews,1,1,2
1422820,True,0,No user reviews,0,0,0
1422830,True,0,No user reviews,0,0,0
1422870,True,0,No user reviews,0,0,0
1422880,True,0,No user reviews,0,0,0
1422890,True,0,No user reviews,0,0,0
1422900,True,0,No user reviews,0,0,0
1422910,True,0,No user reviews,0,0,0
1422920,True,0,No user reviews,0,0,0
1422950,True,0,No user reviews,0,0,0
1423040,True,0,No user reviews,0,0,0
1423060,True,0,No user reviews,0,0,0
1423070,True,0,No user reviews,0,0,0
1423090,True,0,No user reviews,0,0,0
1423130,True,0,No user reviews,0,0,0
1423140,True,0,No user reviews,0,0,0
1423180,True,0,No user reviews,0,0,0
1423200,True,0,2 user reviews,1,1,2
1423210,True,0,No user reviews,0,0,0
1423240,True,0,No user reviews,0,0,0
1423241,True,0,No user reviews,0,0,0
1423242,True,0,No user reviews,0,0,0
1423243,True,0,No user reviews,0,0,0
1423244,True,0,No user reviews,0,0,0
1423245,True,0,No user reviews,0,0,0
1423246,True,0,No user reviews,0,0,0
1423247,True,0,No user reviews,0,0,0
1423248,True,0,No user reviews,0,0,0
1423249,True,0,No user reviews,0,0,0
1423250,True,0,No user reviews,0,0,0
1423251,True,0,No user reviews,0,0,0
1423260,True,0,No user reviews,0,0,0
1423270,True,0,No user reviews,0,0,0
1423320,True,0,No user reviews,0,0,0
1423360,True,0,1 user reviews,1,0,1
1423370,True,0,No user reviews,0,0,0
1423390,True,0,No user reviews,0,0,0
1423400,True,0,No user reviews,0,0,0
1423410,True,0,No user reviews,0,0,0
1423420,True,0,No user reviews,0,0,0
1423440,True,0,1 user reviews,1,0,1
1423460,True,0,No user reviews,0,0,0
1423480,True,0,No user reviews,0,0,0
1423490,True,0,No user reviews,0,0,0
1423500,True,0,1 user reviews,0,1,1
1423510,True,0,No user reviews,0,0,0
1423520,True,0,No user reviews,0,0,0
1423530,True,0,No user reviews,0,0,0
1423540,True,0,1 user reviews,1,0,1
1423580,True,0,No user reviews,0,0,0
1423590,True,0,No user reviews,0,0,0
1423610,True,0,1 user reviews,0,1,1
1423620,True,0,No user reviews,0,0,0
1423640,True,0,No user reviews,0,0,0
1423650,True,0,No user reviews,0,0,0
1423680,True,0,1 user reviews,1,0,1
1423700,True,0,No user reviews,0,0,0
1423710,True,0,No user reviews,0,0,0
1423720,True,0,No user reviews,0,0,0
1423750,True,0,No user reviews,0,0,0
1423760,True,0,No user reviews,0,0,0
1423770,True,0,No user reviews,0,0,0
1423780,True,0,1 user reviews,1,0,1
1423790,True,0,No user reviews,0,0,0
1423800,True,0,No user reviews,0,0,0
1423820,True,0,No user reviews,0,0,0
1423830,True,0,1 user reviews,1,0,1
1423840,True,0,No user reviews,0,0,0
1423850,True,0,No user reviews,0,0,0
1423880,True,0,No user reviews,0,0,0
1423900,True,0,8 user reviews,7,1,8
1423970,True,0,No user reviews,0,0,0
1423980,True,0,No user reviews,0,0,0
1424000,True,0,No user reviews,0,0,0
1424010,True,0,No user reviews,0,0,0
1424020,True,0,1 user reviews,1,0,1
1424050,True,0,No user reviews,0,0,0
1424060,True,0,No user reviews,0,0,0
1424070,True,0,No user reviews,0,0,0
1424080,True,0,No user reviews,0,0,0
1424090,True,0,No user reviews,0,0,0
1424120,True,0,1 user reviews,1,0,1
1424140,True,0,No user reviews,0,0,0
1424160,True,0,No user reviews,0,0,0
1424230,True,0,No user reviews,0,0,0
1424240,True,0,No user reviews,0,0,0
1424260,True,0,No user reviews,0,0,0
1424270,True,0,2 user reviews,2,0,2
1424280,True,0,No user reviews,0,0,0
1424290,True,0,No user reviews,0,0,0
1424300,True,0,No user reviews,0,0,0
1424310,True,0,1 user reviews,0,1,1
1424350,True,0,9 user reviews,9,0,9
1424360,True,0,No user reviews,0,0,0
1424380,True,0,2 user reviews,2,0,2
1424390,True,0,No user reviews,0,0,0
1424400,True,0,No user reviews,0,0,0
1424410,True,0,No user reviews,0,0,0
1424420,True,0,No user reviews,0,0,0
1424460,True,0,No user reviews,0,0,0
1424490,True,0,No user reviews,0,0,0
1424500,True,0,3 user reviews,3,0,3
1424520,True,0,No user reviews,0,0,0
1424570,True,0,No user reviews,0,0,0
1424580,True,0,No user reviews,0,0,0
1424590,True,0,No user reviews,0,0,0
1424600,True,0,No user reviews,0,0,0
1424610,True,0,No user reviews,0,0,0
1424630,True,0,5 user reviews,5,0,5
1424640,True,0,No user reviews,0,0,0
1424650,True,0,No user reviews,0,0,0
1424670,True,0,No user reviews,0,0,0
1424700,True,0,1 user reviews,0,1,1
1424710,True,0,No user reviews,0,0,0
1424760,True,0,No user reviews,0,0,0
1424770,True,0,9 user reviews,7,2,9
1424780,True,0,No user reviews,0,0,0
1424790,True,0,No user reviews,0,0,0
1424810,True,0,No user reviews,0,0,0
1424830,True,0,1 user reviews,1,0,1
1424850,True,0,No user reviews,0,0,0
1424880,True,0,No user reviews,0,0,0
1424890,True,0,No user reviews,0,0,0
1424900,True,0,No user reviews,0,0,0
1424920,True,0,No user reviews,0,0,0
1424940,True,0,No user reviews,0,0,0
1424950,True,0,No user reviews,0,0,0
1424960,True,0,No user reviews,0,0,0
1424980,True,8,Very Positive,261,23,284
1425010,True,0,No user reviews,0,0,0
1425020,True,0,No user reviews,0,0,0
1425030,True,0,No user reviews,0,0,0
1425040,True,0,No user reviews,0,0,0
1425060,True,0,No user reviews,0,0,0
1425090,True,0,No user reviews,0,0,0
1425110,True,0,2 user reviews,1,1,2
1425120,True,0,2 user reviews,2,0,2
1425140,True,0,4 user reviews,4,0,4
1425160,True,0,No user reviews,0,0,0
1425170,True,0,No user reviews,0,0,0
1425180,True,0,No user reviews,0,0,0
1425210,True,0,No user reviews,0,0,0
1425220,True,0,No user reviews,0,0,0
1425240,True,0,No user reviews,0,0,0
1425250,True,0,1 user reviews,1,0,1
1425270,True,0,No user reviews,0,0,0
1425280,True,0,5 user reviews,5,0,5
1425290,True,0,1 user reviews,1,0,1
1425300,True,0,3 user reviews,1,2,3
1425310,True,0,No user reviews,0,0,0
1425360,True,0,No user reviews,0,0,0
1425380,True,7,Positive,21,0,21
1425390,True,0,1 user reviews,1,0,1
1425400,True,0,No user reviews,0,0,0
1425430,True,0,4 user reviews,3,1,4
1425450,True,0,2 user reviews,2,0,2
1425520,True,0,No user reviews,0,0,0
1425530,True,0,No user reviews,0,0,0
1425550,True,0,No user reviews,0,0,0
1425570,True,0,No user reviews,0,0,0
1425610,True,0,No user reviews,0,0,0
1425620,True,0,No user reviews,0,0,0
1425640,True,0,No user reviews,0,0,0
1425650,True,0,No user reviews,0,0,0
1425680,True,0,No user reviews,0,0,0
1425690,True,0,No user reviews,0,0,0
1425720,True,0,1 user reviews,0,1,1
1425760,True,0,No user reviews,0,0,0
1425770,True,0,No user reviews,0,0,0
1425790,True,0,No user reviews,0,0,0
1425830,True,0,No user reviews,0,0,0
1425840,True,0,No user reviews,0,0,0
1425860,True,0,No user reviews,0,0,0
1425880,True,0,No user reviews,0,0,0
1425900,True,0,No user reviews,0,0,0
1425920,True,0,No user reviews,0,0,0
1425950,True,0,No user reviews,0,0,0
1425990,True,0,No user reviews,0,0,0
1426020,True,0,No user reviews,0,0,0
1426030,True,0,No user reviews,0,0,0
1426050,True,0,No user reviews,0,0,0
1426060,True,0,No user reviews,0,0,0
1426090,True,0,7 user reviews,5,2,7
1426110,True,0,No user reviews,0,0,0
1426120,True,0,No user reviews,0,0,0
1426130,True,0,No user reviews,0,0,0
1426150,True,0,No user reviews,0,0,0
1426160,True,0,2 user reviews,2,0,2
1426190,True,0,1 user reviews,1,0,1
1426230,True,0,No user reviews,0,0,0
1426240,True,6,Mostly Positive,98,41,139
1426280,True,6,Mostly Positive,7,3,10
1426300,True,0,No user reviews,0,0,0
1426310,True,0,No user reviews,0,0,0
1426330,True,0,No user reviews,0,0,0
1426350,True,0,No user reviews,0,0,0
1426380,True,0,No user reviews,0,0,0
1426400,True,0,No user reviews,0,0,0
1426420,True,0,No user reviews,0,0,0
1426480,True,0,No user reviews,0,0,0
1426510,True,0,No user reviews,0,0,0
1426520,True,0,No user reviews,0,0,0
1426550,True,0,No user reviews,0,0,0
1426660,True,0,No user reviews,0,0,0
1426740,True,0,No user reviews,0,0,0
1426750,True,0,No user reviews,0,0,0
1426770,True,0,No user reviews,0,0,0
1426800,True,0,No user reviews,0,0,0
1426810,True,0,No user reviews,0,0,0
1426870,True,0,No user reviews,0,0,0
1426880,True,0,2 user reviews,0,2,2
1426900,True,0,No user reviews,0,0,0
1426910,True,5,Mixed,186,117,303
1426920,True,0,No user reviews,0,0,0
1426921,True,0,No user reviews,0,0,0
1426930,True,0,No user reviews,0,0,0
1426950,True,0,No user reviews,0,0,0
1426980,True,0,No user reviews,0,0,0
1426990,True,0,No user reviews,0,0,0
1427000,True,0,No user reviews,0,0,0
1427010,True,0,No user reviews,0,0,0
1427020,True,0,No user reviews,0,0,0
1427030,True,0,No user reviews,0,0,0
1427040,True,0,No user reviews,0,0,0
1427100,True,0,No user reviews,0,0,0
1427110,True,0,No user reviews,0,0,0
1427120,True,0,No user reviews,0,0,0
1427140,True,0,No user reviews,0,0,0
1427150,True,0,No user reviews,0,0,0
1427170,True,0,No user reviews,0,0,0
1427180,True,0,No user reviews,0,0,0
1427190,True,0,No user reviews,0,0,0
1427220,True,0,No user reviews,0,0,0
1427221,True,0,No user reviews,0,0,0
1427230,True,0,No user reviews,0,0,0
1427250,True,0,No user reviews,0,0,0
1427260,True,0,No user reviews,0,0,0
1427280,True,0,No user reviews,0,0,0
1427290,True,0,2 user reviews,1,1,2
1427310,True,0,No user reviews,0,0,0
1427330,True,0,No user reviews,0,0,0
1427360,True,0,No user reviews,0,0,0
1427370,True,0,No user reviews,0,0,0
1427380,True,0,No user reviews,0,0,0
1427400,True,0,No user reviews,0,0,0
1427420,True,0,No user reviews,0,0,0
1427430,True,0,No user reviews,0,0,0
1427470,True,0,No user reviews,0,0,0
1427480,True,0,No user reviews,0,0,0
1427490,True,0,No user reviews,0,0,0
1427500,True,0,No user reviews,0,0,0
1427540,True,0,No user reviews,0,0,0
1427590,True,0,No user reviews,0,0,0
1427591,True,0,No user reviews,0,0,0
1427592,True,0,No user reviews,0,0,0
1427610,True,0,No user reviews,0,0,0
1427620,True,0,No user reviews,0,0,0
1427640,True,0,No user reviews,0,0,0
1427680,True,0,No user reviews,0,0,0
1427700,True,0,No user reviews,0,0,0
1427710,True,0,No user reviews,0,0,0
1427720,True,0,No user reviews,0,0,0
1427740,True,0,No user reviews,0,0,0
1427750,True,0,2 user reviews,2,0,2
1427760,True,0,No user reviews,0,0,0
1427770,True,0,No user reviews,0,0,0
1427780,True,0,No user reviews,0,0,0
1427810,True,0,No user reviews,0,0,0
1427850,True,0,No user reviews,0,0,0
1427860,True,0,No user reviews,0,0,0
1427880,True,0,No user reviews,0,0,0
1427890,True,0,No user reviews,0,0,0
1428000,True,0,No user reviews,0,0,0
1428010,True,0,No user reviews,0,0,0
1428020,True,0,No user reviews,0,0,0
1428021,True,0,No user reviews,0,0,0
1428022,True,0,No user reviews,0,0,0
1428023,True,0,No user reviews,0,0,0
1428024,True,0,No user reviews,0,0,0
1428030,True,0,No user reviews,0,0,0
1428040,True,0,No user reviews,0,0,0
1428050,True,0,No user reviews,0,0,0
1428110,True,0,5 user reviews,1,4,5
1428120,True,0,No user reviews,0,0,0
1428121,True,0,No user reviews,0,0,0
1428130,True,0,No user reviews,0,0,0
1428140,True,0,No user reviews,0,0,0
1428160,True,0,1 user reviews,0,1,1
1428220,True,0,4 user reviews,4,0,4
1428250,True,0,No user reviews,0,0,0
1428270,True,0,No user reviews,0,0,0
1428280,True,0,No user reviews,0,0,0
1428290,True,0,No user reviews,0,0,0
1428310,True,8,Very Positive,239,8,247
1428320,True,0,No user reviews,0,0,0
1428330,True,0,1 user reviews,1,0,1
1428340,True,0,No user reviews,0,0,0
1428350,True,0,No user reviews,0,0,0
1428380,True,0,No user reviews,0,0,0
1428420,True,0,No user reviews,0,0,0
1428430,True,0,No user reviews,0,0,0
1428440,True,0,No user reviews,0,0,0
1428450,True,0,No user reviews,0,0,0
1428460,True,7,Positive,32,0,32
1428470,True,0,No user reviews,0,0,0
1428480,True,0,No user reviews,0,0,0
1428510,True,0,No user reviews,0,0,0
1428520,True,0,No user reviews,0,0,0
1428560,True,0,No user reviews,0,0,0
1428580,True,0,2 user reviews,1,1,2
1428610,True,0,No user reviews,0,0,0
1428620,True,0,No user reviews,0,0,0
1428630,True,0,No user reviews,0,0,0
1428640,True,0,No user reviews,0,0,0
1428680,True,0,No user reviews,0,0,0
1428690,True,0,No user reviews,0,0,0
1428710,True,0,No user reviews,0,0,0
1428720,True,0,No user reviews,0,0,0
1428780,True,0,No user reviews,0,0,0
1428790,True,0,No user reviews,0,0,0
1428820,True,7,Positive,39,5,44
1428830,True,0,No user reviews,0,0,0
1428840,True,0,4 user reviews,4,0,4
1428850,True,0,No user reviews,0,0,0
1428890,True,0,No user reviews,0,0,0
1428910,True,0,No user reviews,0,0,0
1428920,True,0,No user reviews,0,0,0
1428930,True,0,No user reviews,0,0,0
1428940,True,0,No user reviews,0,0,0
1428980,True,0,4 user reviews,4,0,4
1429010,True,0,1 user reviews,1,0,1
1429050,True,0,No user reviews,0,0,0
1429090,True,0,No user reviews,0,0,0
1429100,True,0,No user reviews,0,0,0
1429110,True,0,No user reviews,0,0,0
1429120,True,0,No user reviews,0,0,0
1429130,True,0,No user reviews,0,0,0
1429150,True,0,No user reviews,0,0,0
1429160,True,0,No user reviews,0,0,0
1429210,True,0,No user reviews,0,0,0
1429220,True,0,No user reviews,0,0,0
1429250,True,0,No user reviews,0,0,0
1429260,True,0,No user reviews,0,0,0
1429270,True,0,1 user reviews,1,0,1
1429280,True,0,No user reviews,0,0,0
1429290,True,0,No user reviews,0,0,0
1429300,True,0,1 user reviews,0,1,1
1429400,True,0,1 user reviews,1,0,1
1429420,True,0,No user reviews,0,0,0
1429430,True,0,No user reviews,0,0,0
1429440,True,0,No user reviews,0,0,0
1429460,True,0,No user reviews,0,0,0
1429480,True,7,Positive,10,0,10
1429560,True,0,No user reviews,0,0,0
1429590,True,0,No user reviews,0,0,0
1429610,True,0,No user reviews,0,0,0
1429620,True,0,No user reviews,0,0,0
1429640,True,0,No user reviews,0,0,0
1429650,True,0,No user reviews,0,0,0
1429670,True,0,No user reviews,0,0,0
1429680,True,0,No user reviews,0,0,0
1429690,True,0,No user reviews,0,0,0
1429740,True,0,No user reviews,0,0,0
1429770,True,0,No user reviews,0,0,0
1429780,True,0,No user reviews,0,0,0
1429860,True,0,No user reviews,0,0,0
1429870,True,0,No user reviews,0,0,0
1429900,True,0,No user reviews,0,0,0
1429920,True,0,No user reviews,0,0,0
1429930,True,0,No user reviews,0,0,0
1429940,True,0,No user reviews,0,0,0
1429950,True,0,No user reviews,0,0,0
1429990,True,0,No user reviews,0,0,0
1430000,True,0,No user reviews,0,0,0
1430010,True,0,No user reviews,0,0,0
1430040,True,0,1 user reviews,1,0,1
1430070,True,0,3 user reviews,1,2,3
1430080,True,0,No user reviews,0,0,0
1430100,True,0,No user reviews,0,0,0
1430110,True,0,No user reviews,0,0,0
1430120,True,0,2 user reviews,2,0,2
1430130,True,0,No user reviews,0,0,0
1430140,True,0,1 user reviews,1,0,1
1430160,True,0,No user reviews,0,0,0
1430200,True,0,1 user reviews,1,0,1
1430240,True,0,No user reviews,0,0,0
1430260,True,0,No user reviews,0,0,0
1430300,True,0,No user reviews,0,0,0
1430310,True,0,No user reviews,0,0,0
1430320,True,0,No user reviews,0,0,0
1430340,True,0,No user reviews,0,0,0
1430350,True,0,No user reviews,0,0,0
1430370,True,0,No user reviews,0,0,0
1430420,True,8,Very Positive,94,1,95
1430430,True,0,No user reviews,0,0,0
1430490,True,0,No user reviews,0,0,0
1430510,True,0,No user reviews,0,0,0
1430520,True,0,No user reviews,0,0,0
1430550,True,0,No user reviews,0,0,0
1430560,True,0,No user reviews,0,0,0
1430580,True,0,No user reviews,0,0,0
1430610,True,8,Very Positive,66,0,66
1430650,True,0,No user reviews,0,0,0
1430660,True,0,No user reviews,0,0,0
1430700,True,0,No user reviews,0,0,0
1430740,True,0,3 user reviews,1,2,3
1430750,True,0,No user reviews,0,0,0
1430760,True,0,No user reviews,0,0,0
1430770,True,0,No user reviews,0,0,0
1430780,True,0,No user reviews,0,0,0
1430820,True,0,1 user reviews,1,0,1
1430830,True,0,No user reviews,0,0,0
1430840,True,0,No user reviews,0,0,0
1430850,True,0,No user reviews,0,0,0
1430860,True,0,No user reviews,0,0,0
1430870,True,0,No user reviews,0,0,0
1430940,True,7,Positive,14,1,15
1430960,True,0,No user reviews,0,0,0
1430980,True,0,2 user reviews,0,2,2
1430990,True,7,Positive,12,0,12
1431000,True,0,No user reviews,0,0,0
1431020,True,0,No user reviews,0,0,0
1431030,True,7,Positive,14,2,16
1431040,True,0,No user reviews,0,0,0
1431080,True,0,No user reviews,0,0,0
1431090,True,0,No user reviews,0,0,0
1431100,True,0,No user reviews,0,0,0
1431150,True,0,No user reviews,0,0,0
1431180,True,0,No user reviews,0,0,0
1431190,True,7,Positive,10,0,10
1431200,True,0,No user reviews,0,0,0
1431210,True,0,1 user reviews,1,0,1
1431220,True,0,5 user reviews,5,0,5
1431230,True,0,No user reviews,0,0,0
1431240,True,0,No user reviews,0,0,0
1431260,True,0,No user reviews,0,0,0
1431310,True,0,No user reviews,0,0,0
1431330,True,0,No user reviews,0,0,0
1431360,True,0,No user reviews,0,0,0
1431370,True,0,No user reviews,0,0,0
1431380,True,0,No user reviews,0,0,0
1431390,True,0,No user reviews,0,0,0
1431420,True,0,6 user reviews,6,0,6
1431450,True,0,No user reviews,0,0,0
1431470,True,0,No user reviews,0,0,0
1431500,True,0,No user reviews,0,0,0
1431520,True,0,No user reviews,0,0,0
1431550,True,0,No user reviews,0,0,0
1431560,True,0,No user reviews,0,0,0
1431580,True,0,No user reviews,0,0,0
1431600,True,0,No user reviews,0,0,0
1431610,True,0,No user reviews,0,0,0
1431620,True,0,1 user reviews,0,1,1
1431630,True,0,No user reviews,0,0,0
1431640,True,0,No user reviews,0,0,0
1431660,True,0,No user reviews,0,0,0
1431670,True,0,No user reviews,0,0,0
1431690,True,0,No user reviews,0,0,0
1431702,True,0,1 user reviews,1,0,1
1431710,True,0,1 user reviews,1,0,1
1431730,True,0,No user reviews,0,0,0
1431750,True,0,No user reviews,0,0,0
1431770,True,0,No user reviews,0,0,0
1431780,True,0,9 user reviews,9,0,9
1431790,True,0,No user reviews,0,0,0
1431810,True,0,No user reviews,0,0,0
1431820,True,0,No user reviews,0,0,0
1431840,True,0,1 user reviews,1,0,1
1431910,True,0,No user reviews,0,0,0
1431930,True,0,No user reviews,0,0,0
1431960,True,0,No user reviews,0,0,0
1432000,True,0,No user reviews,0,0,0
1432010,True,0,No user reviews,0,0,0
1432030,True,0,No user reviews,0,0,0
1432040,True,0,No user reviews,0,0,0
1432200,True,0,No user reviews,0,0,0
1432240,True,0,No user reviews,0,0,0
1432270,True,7,Positive,28,2,30
1432280,True,0,No user reviews,0,0,0
1432290,True,0,No user reviews,0,0,0
1432310,True,0,No user reviews,0,0,0
1432330,True,0,No user reviews,0,0,0
1432340,True,0,No user reviews,0,0,0
1432350,True,0,No user reviews,0,0,0
1432370,True,0,No user reviews,0,0,0
1432380,True,0,No user reviews,0,0,0
1432390,True,0,No user reviews,0,0,0
1432400,True,0,2 user reviews,2,0,2
1432450,True,0,No user reviews,0,0,0
1432460,True,0,No user reviews,0,0,0
1432470,True,0,7 user reviews,7,0,7
1432480,True,0,No user reviews,0,0,0
1432500,True,0,No user reviews,0,0,0
1432530,True,0,No user reviews,0,0,0
1432540,True,0,No user reviews,0,0,0
1432570,True,0,No user reviews,0,0,0
1432590,True,0,No user reviews,0,0,0
1432600,True,0,No user reviews,0,0,0
1432610,True,0,No user reviews,0,0,0
1432620,True,0,No user reviews,0,0,0
1432630,True,0,No user reviews,0,0,0
1432650,True,0,7 user reviews,7,0,7
1432670,True,0,No user reviews,0,0,0
1432680,True,0,No user reviews,0,0,0
1432690,True,0,No user reviews,0,0,0
1432700,True,0,No user reviews,0,0,0
1432710,True,0,No user reviews,0,0,0
1432720,True,0,No user reviews,0,0,0
1432730,True,0,No user reviews,0,0,0
1432740,True,0,No user reviews,0,0,0
1432750,True,7,Positive,10,0,10
1432760,True,0,No user reviews,0,0,0
1432790,True,0,No user reviews,0,0,0
1432800,True,0,No user reviews,0,0,0
1432820,True,0,No user reviews,0,0,0
1432830,True,0,No user reviews,0,0,0
1432850,True,0,No user reviews,0,0,0
1432870,True,0,No user reviews,0,0,0
1432880,True,0,No user reviews,0,0,0
1432900,True,0,No user reviews,0,0,0
1432920,True,0,No user reviews,0,0,0
1432930,True,0,No user reviews,0,0,0
1432940,True,0,1 user reviews,0,1,1
1432960,True,0,No user reviews,0,0,0
1432990,True,0,No user reviews,0,0,0
1433060,True,0,No user reviews,0,0,0
1433090,True,0,No user reviews,0,0,0
1433100,True,0,No user reviews,0,0,0
1433150,True,0,No user reviews,0,0,0
1433160,True,0,No user reviews,0,0,0
1433200,True,0,No user reviews,0,0,0
1433210,True,0,No user reviews,0,0,0
1433220,True,0,No user reviews,0,0,0
1433230,True,0,No user reviews,0,0,0
1433240,True,0,No user reviews,0,0,0
1433260,True,0,No user reviews,0,0,0
1433310,True,0,No user reviews,0,0,0
1433320,True,0,5 user reviews,5,0,5
1433330,True,0,No user reviews,0,0,0
1433360,True,0,No user reviews,0,0,0
1433370,True,0,No user reviews,0,0,0
1433380,True,0,No user reviews,0,0,0
1433420,True,0,No user reviews,0,0,0
1433430,True,0,7 user reviews,7,0,7
1433440,True,0,No user reviews,0,0,0
1433460,True,0,No user reviews,0,0,0
1433470,True,0,No user reviews,0,0,0
1433510,True,0,No user reviews,0,0,0
1433540,True,0,No user reviews,0,0,0
1433570,True,0,No user reviews,0,0,0
1433580,True,0,No user reviews,0,0,0
1433582,True,0,No user reviews,0,0,0
1433590,True,0,No user reviews,0,0,0
1433600,True,0,No user reviews,0,0,0
1433601,True,0,No user reviews,0,0,0
1433602,True,0,No user reviews,0,0,0
1433604,True,0,No user reviews,0,0,0
1433605,True,0,No user reviews,0,0,0
1433630,True,0,No user reviews,0,0,0
1433640,True,0,No user reviews,0,0,0
1433650,True,0,No user reviews,0,0,0
1433660,True,0,No user reviews,0,0,0
1433670,True,0,No user reviews,0,0,0
1433710,True,0,No user reviews,0,0,0
1433720,True,0,No user reviews,0,0,0
1433730,True,0,No user reviews,0,0,0
1433760,True,0,No user reviews,0,0,0
1433770,True,0,No user reviews,0,0,0
1433780,True,0,No user reviews,0,0,0
1433790,True,0,No user reviews,0,0,0
1433800,True,0,No user reviews,0,0,0
1433810,True,0,No user reviews,0,0,0
1433820,True,0,No user reviews,0,0,0
1433890,True,7,Positive,13,0,13
1433910,True,0,No user reviews,0,0,0
1433920,True,0,No user reviews,0,0,0
1433930,True,0,1 user reviews,1,0,1
1433940,True,0,No user reviews,0,0,0
1433950,True,0,2 user reviews,2,0,2
1433970,True,0,No user reviews,0,0,0
1433980,True,0,No user reviews,0,0,0
1434000,True,0,No user reviews,0,0,0
1434010,True,0,No user reviews,0,0,0
1434100,True,0,No user reviews,0,0,0
1434110,True,0,No user reviews,0,0,0
1434140,True,0,No user reviews,0,0,0
1434160,True,0,No user reviews,0,0,0
1434210,True,0,No user reviews,0,0,0
1434220,True,0,No user reviews,0,0,0
1434230,True,0,No user reviews,0,0,0
1434240,True,0,No user reviews,0,0,0
1434250,True,0,No user reviews,0,0,0
1434280,True,0,No user reviews,0,0,0
1434281,True,0,No user reviews,0,0,0
1434282,True,0,No user reviews,0,0,0
1434283,True,0,No user reviews,0,0,0
1434284,True,0,No user reviews,0,0,0
1434285,True,0,No user reviews,0,0,0
1434286,True,0,No user reviews,0,0,0
1434287,True,0,No user reviews,0,0,0
1434288,True,0,No user reviews,0,0,0
1434289,True,0,No user reviews,0,0,0
1434290,True,0,No user reviews,0,0,0
1434300,True,0,No user reviews,0,0,0
1434340,True,0,No user reviews,0,0,0
1434360,True,0,No user reviews,0,0,0
1434400,True,0,No user reviews,0,0,0
1434420,True,0,No user reviews,0,0,0
1434450,True,0,No user reviews,0,0,0
1434470,True,0,No user reviews,0,0,0
1434480,True,0,No user reviews,0,0,0
1434510,True,0,No user reviews,0,0,0
1434550,True,0,No user reviews,0,0,0
1434560,True,0,No user reviews,0,0,0
1434570,True,0,No user reviews,0,0,0
1434580,True,0,No user reviews,0,0,0
1434590,True,0,No user reviews,0,0,0
1434600,True,0,No user reviews,0,0,0
1434620,True,0,1 user reviews,0,1,1
1434640,True,0,No user reviews,0,0,0
1434680,True,0,No user reviews,0,0,0
1434700,True,0,No user reviews,0,0,0
1434710,True,0,No user reviews,0,0,0
1434720,True,0,3 user reviews,2,1,3
1434730,True,0,No user reviews,0,0,0
1434740,True,0,No user reviews,0,0,0
1434780,True,0,No user reviews,0,0,0
1434870,True,0,No user reviews,0,0,0
1434880,True,0,2 user reviews,2,0,2
1434890,True,0,No user reviews,0,0,0
1434910,True,0,No user reviews,0,0,0
1434920,True,0,No user reviews,0,0,0
1435020,True,0,No user reviews,0,0,0
1435030,True,0,No user reviews,0,0,0
1435050,True,0,No user reviews,0,0,0
1435060,True,0,No user reviews,0,0,0
1435090,True,0,No user reviews,0,0,0
1435120,True,0,No user reviews,0,0,0
1435130,True,0,No user reviews,0,0,0
1435140,True,0,No user reviews,0,0,0
1435160,True,0,No user reviews,0,0,0
1435190,True,0,No user reviews,0,0,0
1435200,True,0,No user reviews,0,0,0
1435230,True,0,No user reviews,0,0,0
1435260,True,0,No user reviews,0,0,0
1435290,True,0,No user reviews,0,0,0
1435310,True,0,No user reviews,0,0,0
1435330,True,0,No user reviews,0,0,0
1435340,True,0,No user reviews,0,0,0
1435350,True,0,No user reviews,0,0,0
1435360,True,0,No user reviews,0,0,0
1435380,True,0,No user reviews,0,0,0
1435390,True,0,No user reviews,0,0,0
1435410,True,0,No user reviews,0,0,0
1435420,True,0,1 user reviews,0,1,1
1435430,True,0,No user reviews,0,0,0
1435440,True,0,No user reviews,0,0,0
1435470,True,0,No user reviews,0,0,0
1435480,True,0,6 user reviews,3,3,6
1435510,True,0,1 user reviews,1,0,1
1435540,True,0,No user reviews,0,0,0
1435560,True,0,No user reviews,0,0,0
1435570,True,0,No user reviews,0,0,0
1435610,True,0,No user reviews,0,0,0
1435630,True,0,No user reviews,0,0,0
1435650,True,0,3 user reviews,3,0,3
1435660,True,0,2 user reviews,2,0,2
1435680,True,0,2 user reviews,2,0,2
1435690,True,0,3 user reviews,2,1,3
1435740,True,0,No user reviews,0,0,0
1435760,True,0,No user reviews,0,0,0
1435770,True,0,No user reviews,0,0,0
1435830,True,0,No user reviews,0,0,0
1435840,True,0,No user reviews,0,0,0
1435890,True,0,No user reviews,0,0,0
1435900,True,0,No user reviews,0,0,0
1435930,True,0,No user reviews,0,0,0
1435980,True,0,No user reviews,0,0,0
1436000,True,0,No user reviews,0,0,0
1436010,True,0,No user reviews,0,0,0
1436020,True,0,No user reviews,0,0,0
1436030,True,0,No user reviews,0,0,0
1436040,True,0,No user reviews,0,0,0
1436060,True,0,No user reviews,0,0,0
1436130,True,0,No user reviews,0,0,0
1436140,True,0,No user reviews,0,0,0
1436180,True,0,No user reviews,0,0,0
1436190,True,0,3 user reviews,3,0,3
1436220,True,0,No user reviews,0,0,0
1436230,True,0,No user reviews,0,0,0
1436250,True,0,No user reviews,0,0,0
1436260,True,0,No user reviews,0,0,0
1436270,True,0,No user reviews,0,0,0
1436280,True,0,No user reviews,0,0,0
1436330,True,0,No user reviews,0,0,0
1436350,True,0,No user reviews,0,0,0
1436360,True,0,No user reviews,0,0,0
1436380,True,0,No user reviews,0,0,0
1436390,True,0,No user reviews,0,0,0
1436410,True,0,No user reviews,0,0,0
1436430,True,0,No user reviews,0,0,0
1436440,True,0,No user reviews,0,0,0
1436450,True,0,No user reviews,0,0,0
1436460,True,0,No user reviews,0,0,0
1436490,True,0,7 user reviews,7,0,7
1436500,True,0,No user reviews,0,0,0
1436560,True,0,No user reviews,0,0,0
1436570,True,0,2 user reviews,1,1,2
1436590,True,0,No user reviews,0,0,0
1436600,True,0,No user reviews,0,0,0
1436620,True,0,No user reviews,0,0,0
1436630,True,0,No user reviews,0,0,0
1436650,True,0,No user reviews,0,0,0
1436670,True,0,No user reviews,0,0,0
1436680,True,0,No user reviews,0,0,0
1436690,True,0,No user reviews,0,0,0
1436710,True,0,1 user reviews,1,0,1
1436720,True,0,No user reviews,0,0,0
1436730,True,0,No user reviews,0,0,0
1436740,True,0,No user reviews,0,0,0
1436800,True,0,No user reviews,0,0,0
1436810,True,0,No user reviews,0,0,0
1436820,True,0,No user reviews,0,0,0
1436850,True,0,2 user reviews,2,0,2
1436870,True,0,No user reviews,0,0,0
1436910,True,0,No user reviews,0,0,0
1436920,True,0,No user reviews,0,0,0
1436930,True,0,1 user reviews,1,0,1
1436940,True,0,No user reviews,0,0,0
1437050,True,0,No user reviews,0,0,0
1437070,True,0,No user reviews,0,0,0
1437071,True,0,No user reviews,0,0,0
1437072,True,0,No user reviews,0,0,0
1437073,True,0,No user reviews,0,0,0
1437074,True,0,No user reviews,0,0,0
1437075,True,0,No user reviews,0,0,0
1437100,True,0,No user reviews,0,0,0
1437110,True,0,No user reviews,0,0,0
1437120,True,0,No user reviews,0,0,0
1437140,True,0,No user reviews,0,0,0
1437170,True,0,3 user reviews,2,1,3
1437210,True,0,No user reviews,0,0,0
1437220,True,0,No user reviews,0,0,0
1437230,True,0,No user reviews,0,0,0
1437260,True,0,No user reviews,0,0,0
1437270,True,0,No user reviews,0,0,0
1437290,True,0,No user reviews,0,0,0
1437300,True,0,No user reviews,0,0,0
1437310,True,0,No user reviews,0,0,0
1437330,True,0,No user reviews,0,0,0
1437331,True,0,No user reviews,0,0,0
1437340,True,0,No user reviews,0,0,0
1437360,True,0,No user reviews,0,0,0
1437410,True,0,4 user reviews,4,0,4
1437420,True,0,7 user reviews,7,0,7
1437430,True,0,No user reviews,0,0,0
1437440,True,0,No user reviews,0,0,0
1437470,True,0,No user reviews,0,0,0
1437480,True,0,1 user reviews,1,0,1
1437490,True,0,No user reviews,0,0,0
1437500,True,8,Very Positive,53,2,55
1437510,True,0,No user reviews,0,0,0
1437520,True,0,No user reviews,0,0,0
1437530,True,0,No user reviews,0,0,0
1437540,True,0,No user reviews,0,0,0
1437590,True,0,No user reviews,0,0,0
1437600,True,0,No user reviews,0,0,0
1437610,True,0,No user reviews,0,0,0
1437611,True,0,No user reviews,0,0,0
1437630,True,0,No user reviews,0,0,0
1437650,True,0,1 user reviews,1,0,1
1437670,True,0,No user reviews,0,0,0
1437680,True,0,No user reviews,0,0,0
1437700,True,0,1 user reviews,1,0,1
1437710,True,0,No user reviews,0,0,0
1437720,True,0,No user reviews,0,0,0
1437730,True,0,No user reviews,0,0,0
1437740,True,0,No user reviews,0,0,0
1437770,True,0,No user reviews,0,0,0
1437800,True,0,No user reviews,0,0,0
1437810,True,0,1 user reviews,1,0,1
1437900,True,0,No user reviews,0,0,0
1437910,True,0,No user reviews,0,0,0
1437920,True,0,No user reviews,0,0,0
1437930,True,0,No user reviews,0,0,0
1437940,True,0,No user reviews,0,0,0
1437980,True,0,No user reviews,0,0,0
1438000,True,0,1 user reviews,0,1,1
1438010,True,0,No user reviews,0,0,0
1438020,True,0,6 user reviews,6,0,6
1438030,True,0,No user reviews,0,0,0
1438050,True,0,2 user reviews,2,0,2
1438060,True,0,No user reviews,0,0,0
1438080,True,0,No user reviews,0,0,0
1438090,True,0,No user reviews,0,0,0
1438100,True,0,No user reviews,0,0,0
1438110,True,0,No user reviews,0,0,0
1438150,True,0,No user reviews,0,0,0
1438160,True,0,No user reviews,0,0,0
1438170,True,0,No user reviews,0,0,0
1438190,True,0,No user reviews,0,0,0
1438200,True,0,No user reviews,0,0,0
1438260,True,6,Mostly Positive,12,4,16
1438280,True,0,No user reviews,0,0,0
1438300,True,0,No user reviews,0,0,0
1438310,True,0,No user reviews,0,0,0
1438320,True,0,No user reviews,0,0,0
1438360,True,0,No user reviews,0,0,0
1438380,True,0,No user reviews,0,0,0
1438400,True,0,No user reviews,0,0,0
1438420,True,0,No user reviews,0,0,0
1438460,True,0,No user reviews,0,0,0
1438490,True,0,No user reviews,0,0,0
1438500,True,0,No user reviews,0,0,0
1438520,True,0,No user reviews,0,0,0
1438540,True,0,No user reviews,0,0,0
1438550,True,0,No user reviews,0,0,0
1438560,True,0,No user reviews,0,0,0
1438580,True,0,No user reviews,0,0,0
1438600,True,0,No user reviews,0,0,0
1438640,True,0,No user reviews,0,0,0
1438670,True,0,No user reviews,0,0,0
1438690,True,0,No user reviews,0,0,0
1438710,True,0,No user reviews,0,0,0
1438720,True,0,No user reviews,0,0,0
1438730,True,0,No user reviews,0,0,0
1438740,True,0,No user reviews,0,0,0
1438750,True,0,No user reviews,0,0,0
1438760,True,0,No user reviews,0,0,0
1438770,True,0,No user reviews,0,0,0
1438790,True,0,No user reviews,0,0,0
1438820,True,0,No user reviews,0,0,0
1438830,True,0,No user reviews,0,0,0
1438840,True,0,No user reviews,0,0,0
1438850,True,0,No user reviews,0,0,0
1438870,True,0,No user reviews,0,0,0
1438880,True,0,No user reviews,0,0,0
1438890,True,0,No user reviews,0,0,0
1438900,True,0,No user reviews,0,0,0
1438910,True,0,No user reviews,0,0,0
1438920,True,0,No user reviews,0,0,0
1438950,True,0,No user reviews,0,0,0
1438980,True,0,4 user reviews,4,0,4
1438990,True,0,No user reviews,0,0,0
1439000,True,0,3 user reviews,2,1,3
1439001,True,0,No user reviews,0,0,0
1439020,True,0,No user reviews,0,0,0
1439030,True,0,No user reviews,0,0,0
1439050,True,0,No user reviews,0,0,0
1439060,True,0,2 user reviews,2,0,2
1439080,True,0,No user reviews,0,0,0
1439090,True,0,1 user reviews,0,1,1
1439100,True,0,No user reviews,0,0,0
1439110,True,0,No user reviews,0,0,0
1439120,True,0,No user reviews,0,0,0
1439130,True,0,No user reviews,0,0,0
1439140,True,0,No user reviews,0,0,0
1439200,True,0,No user reviews,0,0,0
1439230,True,0,No user reviews,0,0,0
1439250,True,0,No user reviews,0,0,0
1439320,True,0,No user reviews,0,0,0
1439360,True,0,No user reviews,0,0,0
1439410,True,0,No user reviews,0,0,0
1439430,True,7,Positive,10,0,10
1439460,True,0,No user reviews,0,0,0
1439510,True,0,No user reviews,0,0,0
1439550,True,0,No user reviews,0,0,0
1439560,True,0,No user reviews,0,0,0
1439580,True,0,No user reviews,0,0,0
1439640,True,0,No user reviews,0,0,0
1439650,True,0,No user reviews,0,0,0
1439670,True,0,No user reviews,0,0,0
1439700,True,0,No user reviews,0,0,0
1439720,True,0,No user reviews,0,0,0
1439721,True,0,No user reviews,0,0,0
1439722,True,0,No user reviews,0,0,0
1439723,True,0,No user reviews,0,0,0
1439724,True,0,No user reviews,0,0,0
1439725,True,0,No user reviews,0,0,0
1439730,True,0,No user reviews,0,0,0
1439770,True,0,No user reviews,0,0,0
1439800,True,0,No user reviews,0,0,0
1439820,True,0,No user reviews,0,0,0
1439830,True,0,No user reviews,0,0,0
1439840,True,0,No user reviews,0,0,0
1439850,True,0,No user reviews,0,0,0
1439870,True,0,No user reviews,0,0,0
1439880,True,0,No user reviews,0,0,0
1439890,True,0,No user reviews,0,0,0
1439900,True,0,No user reviews,0,0,0
1439910,True,0,No user reviews,0,0,0
1439920,True,0,No user reviews,0,0,0
1439940,True,0,No user reviews,0,0,0
1439960,True,0,No user reviews,0,0,0
1440000,True,0,No user reviews,0,0,0
1440020,True,0,No user reviews,0,0,0
1440030,True,0,No user reviews,0,0,0
1440060,True,0,No user reviews,0,0,0
1440080,True,0,No user reviews,0,0,0
1440110,True,0,No user reviews,0,0,0
1440120,True,0,No user reviews,0,0,0
1440130,True,0,9 user reviews,8,1,9
1440170,True,0,No user reviews,0,0,0
1440180,True,0,No user reviews,0,0,0
1440200,True,0,No user reviews,0,0,0
1440250,True,0,No user reviews,0,0,0
1440270,True,0,No user reviews,0,0,0
1440280,True,0,1 user reviews,1,0,1
1440290,True,0,No user reviews,0,0,0
1440330,True,0,No user reviews,0,0,0
1440350,True,0,No user reviews,0,0,0
1440370,True,0,No user reviews,0,0,0
1440400,True,0,No user reviews,0,0,0
1440460,True,0,No user reviews,0,0,0
1440480,True,0,No user reviews,0,0,0
1440490,True,0,No user reviews,0,0,0
1440530,True,0,No user reviews,0,0,0
1440540,True,0,No user reviews,0,0,0
1440580,True,0,No user reviews,0,0,0
1440590,True,0,No user reviews,0,0,0
1440610,True,0,No user reviews,0,0,0
1440650,True,0,No user reviews,0,0,0
1440660,True,0,No user reviews,0,0,0
1440670,True,0,No user reviews,0,0,0
1440690,True,0,No user reviews,0,0,0
1440710,True,0,No user reviews,0,0,0
1440750,True,0,No user reviews,0,0,0
1440760,True,0,No user reviews,0,0,0
1440770,True,0,No user reviews,0,0,0
1440780,True,0,2 user reviews,2,0,2
1440810,True,0,No user reviews,0,0,0
1440820,True,0,No user reviews,0,0,0
1440850,True,0,No user reviews,0,0,0
1440870,True,6,Mostly Positive,9,3,12
1440890,True,0,No user reviews,0,0,0
1440900,True,0,No user reviews,0,0,0
1440960,True,0,No user reviews,0,0,0
1440970,True,0,No user reviews,0,0,0
1441010,True,0,No user reviews,0,0,0
1441030,True,0,No user reviews,0,0,0
1441070,True,0,No user reviews,0,0,0
1441080,True,0,No user reviews,0,0,0
1441090,True,0,No user reviews,0,0,0
1441100,True,0,No user reviews,0,0,0
1441120,True,0,No user reviews,0,0,0
1441130,True,0,No user reviews,0,0,0
1441150,True,0,No user reviews,0,0,0
1441170,True,0,No user reviews,0,0,0
1441180,True,0,8 user reviews,7,1,8
1441220,True,0,No user reviews,0,0,0
1441260,True,0,No user reviews,0,0,0
1441270,True,0,No user reviews,0,0,0
1441280,True,0,No user reviews,0,0,0
1441290,True,0,No user reviews,0,0,0
1441310,True,0,No user reviews,0,0,0
1441340,True,0,No user reviews,0,0,0
1441380,True,0,No user reviews,0,0,0
1441390,True,0,No user reviews,0,0,0
1441400,True,0,No user reviews,0,0,0
1441420,True,0,No user reviews,0,0,0
1441450,True,0,No user reviews,0,0,0
1441490,True,0,No user reviews,0,0,0
1441500,True,0,No user reviews,0,0,0
1441510,True,0,No user reviews,0,0,0
1441530,True,0,No user reviews,0,0,0
1441540,True,0,No user reviews,0,0,0
1441570,True,0,No user reviews,0,0,0
1441580,True,0,No user reviews,0,0,0
1441590,True,0,1 user reviews,1,0,1
1441600,True,0,No user reviews,0,0,0
1441620,True,0,No user reviews,0,0,0
1441640,True,0,No user reviews,0,0,0
1441660,True,0,No user reviews,0,0,0
1441680,True,0,No user reviews,0,0,0
1441690,True,0,No user reviews,0,0,0
1441700,True,0,No user reviews,0,0,0
1441780,True,0,No user reviews,0,0,0
1441810,True,0,No user reviews,0,0,0
1441820,True,0,No user reviews,0,0,0
1441830,True,0,No user reviews,0,0,0
1441860,True,0,No user reviews,0,0,0
1441910,True,0,No user reviews,0,0,0
1441920,True,0,No user reviews,0,0,0
1441930,True,0,No user reviews,0,0,0
1441940,True,0,No user reviews,0,0,0
1441960,True,0,No user reviews,0,0,0
1441980,True,0,No user reviews,0,0,0
1442000,True,0,No user reviews,0,0,0
1442030,True,0,No user reviews,0,0,0
1442060,True,0,No user reviews,0,0,0
1442070,True,0,No user reviews,0,0,0
1442100,True,0,No user reviews,0,0,0
1442110,True,0,No user reviews,0,0,0
1442180,True,0,No user reviews,0,0,0
1442190,True,0,No user reviews,0,0,0
1442200,True,0,No user reviews,0,0,0
1442210,True,0,No user reviews,0,0,0
1442220,True,0,No user reviews,0,0,0
1442240,True,0,No user reviews,0,0,0
1442260,True,0,No user reviews,0,0,0
1442280,True,0,No user reviews,0,0,0
1442281,True,0,No user reviews,0,0,0
1442300,True,0,No user reviews,0,0,0
1442310,True,0,No user reviews,0,0,0
1442320,True,0,No user reviews,0,0,0
1442330,True,0,No user reviews,0,0,0
1442340,True,0,No user reviews,0,0,0
1442350,True,0,No user reviews,0,0,0
1442370,True,0,No user reviews,0,0,0
1442380,True,0,No user reviews,0,0,0
1442390,True,0,2 user reviews,1,1,2
1442400,True,0,No user reviews,0,0,0
1442420,True,0,No user reviews,0,0,0
1442430,True,0,No user reviews,0,0,0
1442440,True,0,No user reviews,0,0,0
1442450,True,0,No user reviews,0,0,0
1442460,True,0,No user reviews,0,0,0
1442480,True,0,No user reviews,0,0,0
1442500,True,0,No user reviews,0,0,0
1442520,True,0,No user reviews,0,0,0
1442560,True,0,No user reviews,0,0,0
1442570,True,0,No user reviews,0,0,0
1442580,True,0,No user reviews,0,0,0
1442600,True,0,No user reviews,0,0,0
1442630,True,0,No user reviews,0,0,0
1442690,True,0,No user reviews,0,0,0
1442730,True,0,No user reviews,0,0,0
1442731,True,0,No user reviews,0,0,0
1442732,True,0,No user reviews,0,0,0
1442733,True,0,No user reviews,0,0,0
1442734,True,0,No user reviews,0,0,0
1442735,True,0,No user reviews,0,0,0
1442736,True,0,No user reviews,0,0,0
1442737,True,0,No user reviews,0,0,0
1442738,True,0,No user reviews,0,0,0
1442739,True,0,No user reviews,0,0,0
1442760,True,0,No user reviews,0,0,0
1442770,True,0,No user reviews,0,0,0
1442790,True,0,No user reviews,0,0,0
1442810,True,0,1 user reviews,1,0,1
1442811,True,0,No user reviews,0,0,0
1442820,True,0,No user reviews,0,0,0
1442830,True,0,No user reviews,0,0,0
1442850,True,0,No user reviews,0,0,0
1442860,True,0,No user reviews,0,0,0
1442900,True,0,No user reviews,0,0,0
1442920,True,0,No user reviews,0,0,0
1442960,True,0,No user reviews,0,0,0
1443030,True,0,No user reviews,0,0,0
1443120,True,0,No user reviews,0,0,0
1443140,True,0,No user reviews,0,0,0
1443160,True,0,2 user reviews,2,0,2
1443190,True,0,No user reviews,0,0,0
1443230,True,0,No user reviews,0,0,0
1443260,True,0,4 user reviews,4,0,4
1443300,True,0,No user reviews,0,0,0
1443330,True,0,No user reviews,0,0,0
1443360,True,0,5 user reviews,3,2,5
1443370,True,0,No user reviews,0,0,0
1443390,True,0,No user reviews,0,0,0
1443400,True,0,No user reviews,0,0,0
1443430,True,8,Very Positive,76,3,79
1443450,True,0,No user reviews,0,0,0
1443470,True,0,No user reviews,0,0,0
1443480,True,0,No user reviews,0,0,0
1443490,True,0,No user reviews,0,0,0
1443520,True,0,No user reviews,0,0,0
1443530,True,0,No user reviews,0,0,0
1443531,True,0,No user reviews,0,0,0
1443532,True,0,No user reviews,0,0,0
1443533,True,0,No user reviews,0,0,0
1443630,True,0,No user reviews,0,0,0
1443640,True,0,1 user reviews,1,0,1
1443650,True,0,No user reviews,0,0,0
1443670,True,0,No user reviews,0,0,0
1443770,True,0,1 user reviews,1,0,1
1443800,True,0,No user reviews,0,0,0
1443810,True,0,No user reviews,0,0,0
1443820,True,0,No user reviews,0,0,0
1443870,True,0,No user reviews,0,0,0
1443900,True,0,1 user reviews,0,1,1
1443950,True,0,No user reviews,0,0,0
1443970,True,0,2 user reviews,1,1,2
1443980,True,0,No user reviews,0,0,0
1443990,True,0,No user reviews,0,0,0
1444020,True,0,No user reviews,0,0,0
1444090,True,7,Positive,27,0,27
1444100,True,0,No user reviews,0,0,0
1444110,True,0,No user reviews,0,0,0
1444140,True,0,1 user reviews,0,1,1
1444170,True,0,No user reviews,0,0,0
1444200,True,0,No user reviews,0,0,0
1444201,True,0,No user reviews,0,0,0
1444202,True,0,No user reviews,0,0,0
1444203,True,0,No user reviews,0,0,0
1444280,True,0,No user reviews,0,0,0
1444300,True,0,No user reviews,0,0,0
1444320,True,7,Positive,16,0,16
1444330,True,0,No user reviews,0,0,0
1444340,True,0,No user reviews,0,0,0
1444350,True,0,No user reviews,0,0,0
1444360,True,0,No user reviews,0,0,0
1444370,True,0,No user reviews,0,0,0
1444380,True,0,No user reviews,0,0,0
1444400,True,0,No user reviews,0,0,0
1444430,True,0,No user reviews,0,0,0
1444440,True,0,No user reviews,0,0,0
1444460,True,0,No user reviews,0,0,0
1444490,True,0,No user reviews,0,0,0
1444500,True,0,No user reviews,0,0,0
1444520,True,0,No user reviews,0,0,0
1444540,True,0,No user reviews,0,0,0
1444580,True,0,No user reviews,0,0,0
1444610,True,0,No user reviews,0,0,0
1444670,True,0,No user reviews,0,0,0
1444700,True,0,No user reviews,0,0,0
1444730,True,0,4 user reviews,4,0,4
1444740,True,0,No user reviews,0,0,0
1444760,True,0,No user reviews,0,0,0
1444800,True,0,No user reviews,0,0,0
1444820,True,0,No user reviews,0,0,0
1444860,True,0,No user reviews,0,0,0
1444870,True,0,No user reviews,0,0,0
1444890,True,0,5 user reviews,5,0,5
1444930,True,0,No user reviews,0,0,0
1444950,True,0,1 user reviews,0,1,1
1444960,True,0,No user reviews,0,0,0
1445010,True,0,No user reviews,0,0,0
1445050,True,0,No user reviews,0,0,0
1445070,True,0,No user reviews,0,0,0
1445110,True,0,No user reviews,0,0,0
1445120,True,0,3 user reviews,2,1,3
1445170,True,0,No user reviews,0,0,0
1445180,True,0,2 user reviews,2,0,2
1445190,True,0,No user reviews,0,0,0
1445200,True,0,No user reviews,0,0,0
1445210,True,0,No user reviews,0,0,0
1445220,True,0,No user reviews,0,0,0
1445310,True,0,No user reviews,0,0,0
1445350,True,0,No user reviews,0,0,0
1445360,True,0,No user reviews,0,0,0
1445380,True,0,No user reviews,0,0,0
1445400,True,0,3 user reviews,3,0,3
1445410,True,0,No user reviews,0,0,0
1445450,True,0,No user reviews,0,0,0
1445460,True,0,No user reviews,0,0,0
1445480,True,0,No user reviews,0,0,0
1445500,True,0,No user reviews,0,0,0
1445540,True,0,No user reviews,0,0,0
1445580,True,0,No user reviews,0,0,0
1445630,True,0,No user reviews,0,0,0
1445640,True,0,No user reviews,0,0,0
1445670,True,0,No user reviews,0,0,0
1445710,True,0,No user reviews,0,0,0
1445720,True,0,No user reviews,0,0,0
1445750,True,0,No user reviews,0,0,0
1445770,True,0,No user reviews,0,0,0
1445800,True,0,7 user reviews,7,0,7
1445870,True,0,No user reviews,0,0,0
1445970,True,0,No user reviews,0,0,0
1446000,True,0,1 user reviews,1,0,1
1446020,True,0,No user reviews,0,0,0
1446090,True,0,No user reviews,0,0,0
1446100,True,0,No user reviews,0,0,0
1446120,True,0,No user reviews,0,0,0
1446190,True,0,No user reviews,0,0,0
1446230,True,0,No user reviews,0,0,0
1446310,True,0,No user reviews,0,0,0
1446330,True,0,No user reviews,0,0,0
1446350,True,0,No user reviews,0,0,0
1446360,True,0,No user reviews,0,0,0
1446370,True,0,No user reviews,0,0,0
1446420,True,0,No user reviews,0,0,0
1446470,True,0,No user reviews,0,0,0
1446490,True,0,1 user reviews,1,0,1
1446510,True,0,No user reviews,0,0,0
1446570,True,0,No user reviews,0,0,0
1446640,True,0,No user reviews,0,0,0
1446740,True,0,No user reviews,0,0,0
1446760,True,0,No user reviews,0,0,0
1446770,True,0,No user reviews,0,0,0
1446820,True,0,No user reviews,0,0,0
1446830,True,0,No user reviews,0,0,0
1446860,True,0,No user reviews,0,0,0
1446910,True,0,No user reviews,0,0,0
1446960,True,0,No user reviews,0,0,0
1446970,True,0,No user reviews,0,0,0
1446980,True,0,No user reviews,0,0,0
1447020,True,0,No user reviews,0,0,0
1447050,True,0,No user reviews,0,0,0
1447060,True,0,2 user reviews,2,0,2
1447070,True,0,1 user reviews,1,0,1
1447080,True,0,No user reviews,0,0,0
1447160,True,0,No user reviews,0,0,0
1447210,True,0,No user reviews,0,0,0
1447220,True,0,No user reviews,0,0,0
1447240,True,0,No user reviews,0,0,0
1447270,True,0,No user reviews,0,0,0
1447320,True,0,No user reviews,0,0,0
1447360,True,0,No user reviews,0,0,0
1447400,True,0,No user reviews,0,0,0
1447410,True,0,No user reviews,0,0,0
1447440,True,0,No user reviews,0,0,0
1447450,True,0,No user reviews,0,0,0
1447490,True,0,No user reviews,0,0,0
1447540,True,0,No user reviews,0,0,0
1447570,True,0,No user reviews,0,0,0
1447660,True,0,No user reviews,0,0,0
1447680,True,0,No user reviews,0,0,0
1447720,True,0,No user reviews,0,0,0
1447730,True,0,No user reviews,0,0,0
1447830,True,0,No user reviews,0,0,0
1447840,True,0,No user reviews,0,0,0
1447850,True,0,No user reviews,0,0,0
1447870,True,0,No user reviews,0,0,0
1447900,True,0,No user reviews,0,0,0
1447920,True,0,No user reviews,0,0,0
1447930,True,0,No user reviews,0,0,0
1448030,True,0,No user reviews,0,0,0
1448050,True,0,No user reviews,0,0,0
1448070,True,0,No user reviews,0,0,0
1448100,True,0,No user reviews,0,0,0
1448101,True,0,No user reviews,0,0,0
1448110,True,0,No user reviews,0,0,0
1448210,True,0,No user reviews,0,0,0
1448220,True,0,No user reviews,0,0,0
1448290,True,0,No user reviews,0,0,0
1448300,True,0,No user reviews,0,0,0
1448380,True,0,No user reviews,0,0,0
1448400,True,0,No user reviews,0,0,0
1448420,True,0,No user reviews,0,0,0
1448480,True,0,No user reviews,0,0,0
1448500,True,0,No user reviews,0,0,0
1448590,True,0,No user reviews,0,0,0
1448650,True,0,No user reviews,0,0,0
1448660,True,0,No user reviews,0,0,0
1448670,True,0,No user reviews,0,0,0
1448680,True,0,1 user reviews,1,0,1
1448720,True,0,No user reviews,0,0,0
1448750,True,0,No user reviews,0,0,0
1448850,True,0,No user reviews,0,0,0
1448900,True,0,No user reviews,0,0,0
1448920,True,0,No user reviews,0,0,0
1448930,True,0,No user reviews,0,0,0
1448940,True,0,No user reviews,0,0,0
1448950,True,0,No user reviews,0,0,0
1449080,True,0,No user reviews,0,0,0
1449120,True,0,No user reviews,0,0,0
1449140,True,0,No user reviews,0,0,0
1449300,True,0,No user reviews,0,0,0
1449340,True,0,No user reviews,0,0,0
1449370,True,0,No user reviews,0,0,0
1449380,True,0,No user reviews,0,0,0
1449390,True,0,No user reviews,0,0,0
1449400,True,0,No user reviews,0,0,0
1449430,True,0,No user reviews,0,0,0
1449470,True,0,No user reviews,0,0,0
1449510,True,0,No user reviews,0,0,0
1449550,True,0,No user reviews,0,0,0
1449580,True,0,No user reviews,0,0,0
1449610,True,0,No user reviews,0,0,0
1449720,True,0,No user reviews,0,0,0
1449750,True,0,No user reviews,0,0,0
1449780,True,0,No user reviews,0,0,0
1449800,True,0,No user reviews,0,0,0
1449820,True,0,No user reviews,0,0,0
1449860,True,0,No user reviews,0,0,0
1449870,True,0,No user reviews,0,0,0
1449930,True,0,No user reviews,0,0,0
1449940,True,0,No user reviews,0,0,0
1449980,True,0,No user reviews,0,0,0
1450010,True,0,No user reviews,0,0,0
1450030,True,0,No user reviews,0,0,0
1450040,True,0,No user reviews,0,0,0
1450070,True,0,No user reviews,0,0,0
1450140,True,0,No user reviews,0,0,0
1450220,True,5,Mixed,11,6,17
1450240,True,0,No user reviews,0,0,0
1450310,True,0,No user reviews,0,0,0
1450330,True,0,No user reviews,0,0,0
1450370,True,0,No user reviews,0,0,0
1450410,True,0,No user reviews,0,0,0
1450440,True,0,No user reviews,0,0,0
1450450,True,0,No user reviews,0,0,0
1450490,True,0,No user reviews,0,0,0
1450510,True,0,No user reviews,0,0,0
1450530,True,0,No user reviews,0,0,0
1450540,True,0,No user reviews,0,0,0
1450550,True,0,No user reviews,0,0,0
1450610,True,0,No user reviews,0,0,0
1450630,True,0,No user reviews,0,0,0
1450660,True,0,No user reviews,0,0,0
1450680,True,0,No user reviews,0,0,0
1450700,True,0,3 user reviews,3,0,3
1450720,True,0,No user reviews,0,0,0
1450750,True,0,No user reviews,0,0,0
1450760,True,0,No user reviews,0,0,0
1450820,True,0,No user reviews,0,0,0
1450840,True,0,No user reviews,0,0,0
1451040,True,0,No user reviews,0,0,0
1451110,True,0,No user reviews,0,0,0
1451170,True,0,No user reviews,0,0,0
1451270,True,0,No user reviews,0,0,0
1451300,True,0,No user reviews,0,0,0
1451310,True,0,No user reviews,0,0,0
1451370,True,0,No user reviews,0,0,0
1451410,True,0,No user reviews,0,0,0
1451440,True,0,No user reviews,0,0,0
1451490,True,0,No user reviews,0,0,0
1451520,True,0,No user reviews,0,0,0
1451560,True,0,No user reviews,0,0,0
1451580,True,0,No user reviews,0,0,0
1451620,True,0,No user reviews,0,0,0
1451650,True,0,No user reviews,0,0,0
1451720,True,0,No user reviews,0,0,0
1451770,True,0,No user reviews,0,0,0
1451800,True,0,No user reviews,0,0,0
1451850,True,0,No user reviews,0,0,0
1451890,True,0,No user reviews,0,0,0
1451910,True,0,No user reviews,0,0,0
1452000,True,0,No user reviews,0,0,0
1452040,True,0,No user reviews,0,0,0
1452050,True,0,No user reviews,0,0,0
1452110,True,0,No user reviews,0,0,0
1452140,True,0,No user reviews,0,0,0
1452150,True,0,3 user reviews,3,0,3
1452210,True,0,No user reviews,0,0,0
1452220,True,0,No user reviews,0,0,0
1452260,True,0,No user reviews,0,0,0
1452270,True,0,No user reviews,0,0,0
1452300,True,0,No user reviews,0,0,0
1452340,True,0,No user reviews,0,0,0
1452360,True,0,No user reviews,0,0,0
1452440,True,0,No user reviews,0,0,0
1452480,True,0,No user reviews,0,0,0
1452560,True,0,No user reviews,0,0,0
1452570,True,0,No user reviews,0,0,0
1452580,True,0,No user reviews,0,0,0
1452590,True,0,No user reviews,0,0,0
1452610,True,0,No user reviews,0,0,0
1452620,True,0,No user reviews,0,0,0
1452700,True,0,No user reviews,0,0,0
1452710,True,0,No user reviews,0,0,0
1452740,True,0,No user reviews,0,0,0
1452750,True,0,No user reviews,0,0,0
1452770,True,0,No user reviews,0,0,0
1452860,True,0,No user reviews,0,0,0
1452930,True,0,No user reviews,0,0,0
1453000,True,0,No user reviews,0,0,0
1453030,True,0,No user reviews,0,0,0
1453060,True,0,No user reviews,0,0,0
1453070,True,0,No user reviews,0,0,0
1453100,True,0,No user reviews,0,0,0
1453180,True,0,No user reviews,0,0,0
1453290,True,0,No user reviews,0,0,0
1453440,True,0,No user reviews,0,0,0
1453450,True,0,No user reviews,0,0,0
1453460,True,0,No user reviews,0,0,0
1453500,True,0,No user reviews,0,0,0
1453510,True,0,No user reviews,0,0,0
1453580,True,0,No user reviews,0,0,0
1453581,True,0,No user reviews,0,0,0
1453582,True,0,No user reviews,0,0,0
1453583,True,0,No user reviews,0,0,0
1453584,True,0,No user reviews,0,0,0
1453585,True,0,No user reviews,0,0,0
1453590,True,0,No user reviews,0,0,0
1453600,True,0,No user reviews,0,0,0
1453610,True,0,No user reviews,0,0,0
1453840,True,0,No user reviews,0,0,0
1453880,True,0,No user reviews,0,0,0
1453940,True,0,No user reviews,0,0,0
1453990,True,0,No user reviews,0,0,0
1454070,True,0,No user reviews,0,0,0
1454110,True,0,No user reviews,0,0,0
1454140,True,0,No user reviews,0,0,0
1454240,True,0,No user reviews,0,0,0
1454320,True,0,No user reviews,0,0,0
1454340,True,0,No user reviews,0,0,0
1454510,True,0,No user reviews,0,0,0
1454920,True,0,3 user reviews,3,0,3
1455010,True,0,No user reviews,0,0,0
1455060,True,0,No user reviews,0,0,0
1455090,True,0,No user reviews,0,0,0
1455160,True,0,No user reviews,0,0,0
1455260,True,0,No user reviews,0,0,0
1455420,True,0,No user reviews,0,0,0
1455430,True,0,No user reviews,0,0,0
1455480,True,0,No user reviews,0,0,0
1455570,True,0,No user reviews,0,0,0
1455600,True,0,No user reviews,0,0,0
1455940,True,0,No user reviews,0,0,0
1455960,True,0,No user reviews,0,0,0
1455981,True,0,No user reviews,0,0,0
1455982,True,0,No user reviews,0,0,0
1456070,True,0,No user reviews,0,0,0
1456110,True,0,No user reviews,0,0,0
1456111,True,0,No user reviews,0,0,0
1456112,True,0,No user reviews,0,0,0
1456113,True,0,No user reviews,0,0,0
1456114,True,0,No user reviews,0,0,0
1456115,True,0,No user reviews,0,0,0
1456160,True,0,No user reviews,0,0,0
1456240,True,0,No user reviews,0,0,0
1456430,True,0,No user reviews,0,0,0
1456450,True,0,No user reviews,0,0,0
1456530,True,0,No user reviews,0,0,0
1456550,True,0,No user reviews,0,0,0
1456850,True,0,No user reviews,0,0,0
1457260,True,0,No user reviews,0,0,0
1457270,True,0,No user reviews,0,0,0
2028850,True,5,Mixed,19,10,29
